,Unnamed: 0,id,grid,start_hour,end_hour,duration,lon,lat,gps2id
10,10,85E6B4DC96BFA3920E08895C266F386F,13121,1,7,6,38,46,1946
11,11,85E6B4DC96BFA3920E08895C266F386F,11701,11,12,1,43,48,2198
12,12,85E6B4DC96BFA3920E08895C266F386F,43621,14,15,1,46,48,2348
13,13,85E6B4DC96BFA3920E08895C266F386F,13681,19,23,4,38,47,1947
21,21,2C92D9A1E7726DE0B07E3A3E97221DE4,10901,0,3,3,35,48,1798
22,22,2C92D9A1E7726DE0B07E3A3E97221DE4,11491,3,13,10,36,47,1847
23,23,2C92D9A1E7726DE0B07E3A3E97221DE4,11771,16,17,1,39,49,1999
24,24,2C92D9A1E7726DE0B07E3A3E97221DE4,10191,18,19,1,40,48,2048
25,25,2C92D9A1E7726DE0B07E3A3E97221DE4,10901,20,23,3,35,48,1798
29,29,872BD86EB5634CC7A619827DD15029E6,11161,0,8,8,32,48,1648
30,30,872BD86EB5634CC7A619827DD15029E6,11381,10,12,2,30,47,1547
31,31,872BD86EB5634CC7A619827DD15029E6,11161,15,16,1,32,48,1648
32,32,872BD86EB5634CC7A619827DD15029E6,11631,19,20,1,12,49,649
36,36,33825114014E22B38BE13400DBE8B281,42871,0,8,8,30,45,1545
37,37,33825114014E22B38BE13400DBE8B281,13511,10,11,1,34,48,1748
38,38,33825114014E22B38BE13400DBE8B281,42871,12,23,11,30,45,1545
39,39,5832F798017EC944959971DE10E6C76B,13911,1,4,3,39,46,1996
40,40,5832F798017EC944959971DE10E6C76B,42351,4,5,1,38,45,1945
41,41,5832F798017EC944959971DE10E6C76B,13911,8,14,6,39,46,1996
42,42,5832F798017EC944959971DE10E6C76B,12211,16,19,3,41,44,2094
43,43,5832F798017EC944959971DE10E6C76B,11261,19,21,2,36,46,1846
47,47,44AA91905A7E8DBC24B0A51CC88C9204,42151,0,4,4,35,45,1795
48,48,44AA91905A7E8DBC24B0A51CC88C9204,42531,5,11,6,31,45,1595
49,49,44AA91905A7E8DBC24B0A51CC88C9204,42151,11,13,2,35,45,1795
50,50,44AA91905A7E8DBC24B0A51CC88C9204,42531,14,17,3,31,45,1595
51,51,44AA91905A7E8DBC24B0A51CC88C9204,42151,18,22,4,35,45,1795
52,52,DC84219A18D205A834F01D7743EEEE79,42021,0,5,5,33,47,1697
53,53,DC84219A18D205A834F01D7743EEEE79,10471,9,18,9,37,48,1898
54,54,DC84219A18D205A834F01D7743EEEE79,42021,18,22,4,33,47,1697
58,58,0A4DEAAE87BBCD0C04DEB057F69A322D,10901,0,1,1,35,48,1798
59,59,0A4DEAAE87BBCD0C04DEB057F69A322D,11381,2,17,15,30,47,1547
60,60,0A4DEAAE87BBCD0C04DEB057F69A322D,11061,18,21,3,29,48,1498
68,68,C3931C36187A2560C13A52F43DBA110A,12491,0,6,6,36,43,1843
69,69,C3931C36187A2560C13A52F43DBA110A,42151,6,12,6,35,45,1795
70,70,C3931C36187A2560C13A52F43DBA110A,12491,13,21,8,36,43,1843
71,71,C3931C36187A2560C13A52F43DBA110A,13381,22,23,1,39,47,1997
75,75,74EBB90FA1C414F58477B49370E7F73F,11861,0,6,6,32,47,1647
76,76,74EBB90FA1C414F58477B49370E7F73F,12311,7,17,10,30,44,1544
77,77,74EBB90FA1C414F58477B49370E7F73F,11861,18,23,5,32,47,1647
78,78,FEA865DCCC374F062F7FD8F2AE9FF342,11021,0,7,7,36,49,1849
79,79,FEA865DCCC374F062F7FD8F2AE9FF342,11324,8,10,2,31,46,1596
80,80,FEA865DCCC374F062F7FD8F2AE9FF342,11021,11,23,12,36,49,1849
81,81,ED2CF25F0EF4BC22192736D554862394,12841,2,11,9,37,47,1897
82,82,ED2CF25F0EF4BC22192736D554862394,43761,15,16,1,32,47,1647
83,83,ED2CF25F0EF4BC22192736D554862394,10107,19,23,4,38,49,1949
84,84,4442F4779857F254B3128B4BDEABAE8D,11061,0,17,17,29,48,1498
85,85,4442F4779857F254B3128B4BDEABAE8D,11211,17,18,1,34,49,1749
86,86,4442F4779857F254B3128B4BDEABAE8D,11061,20,23,3,29,48,1498
94,94,CFB5B91AB0CD7543884ADBE535AD19D6,43021,0,4,4,16,43,843
95,95,CFB5B91AB0CD7543884ADBE535AD19D6,12641,6,8,2,10,43,543
96,96,CFB5B91AB0CD7543884ADBE535AD19D6,43021,11,17,6,16,43,843
97,97,CFB5B91AB0CD7543884ADBE535AD19D6,12921,20,21,1,9,41,491
98,98,E6EB0FFE7655FB9A9B77EC908104A8C3,11381,0,6,6,30,47,1547
99,99,E6EB0FFE7655FB9A9B77EC908104A8C3,13511,6,18,12,34,48,1748
100,100,E6EB0FFE7655FB9A9B77EC908104A8C3,11381,19,23,4,30,47,1547
111,111,751637010376FF10A15374FA98F99F38,11861,0,15,15,32,47,1647
112,112,751637010376FF10A15374FA98F99F38,42864,16,17,1,38,44,1944
113,113,751637010376FF10A15374FA98F99F38,11861,19,23,4,32,47,1647
114,114,2FB9B4671D70EAA841884AE3AD828EC1,13341,4,7,3,44,45,2245
115,115,2FB9B4671D70EAA841884AE3AD828EC1,11061,9,14,5,29,48,1498
116,116,2FB9B4671D70EAA841884AE3AD828EC1,13341,14,16,2,44,45,2245
117,117,2FB9B4671D70EAA841884AE3AD828EC1,11061,19,22,3,29,48,1498
118,118,A30C3A4D08AE45D5E2F0083CE1F142DF,13111,0,8,8,42,46,2146
119,119,A30C3A4D08AE45D5E2F0083CE1F142DF,43061,8,9,1,43,46,2196
120,120,A30C3A4D08AE45D5E2F0083CE1F142DF,13111,11,15,4,42,46,2146
121,121,A30C3A4D08AE45D5E2F0083CE1F142DF,43001,15,16,1,47,47,2397
122,122,A30C3A4D08AE45D5E2F0083CE1F142DF,43061,16,20,4,43,46,2196
123,123,6B2AEB7B29673E8E9DC34C4EDEAF065B,13091,0,12,12,20,42,1042
124,124,6B2AEB7B29673E8E9DC34C4EDEAF065B,43021,14,15,1,16,43,843
125,125,6B2AEB7B29673E8E9DC34C4EDEAF065B,12921,16,18,2,9,41,491
126,126,6B2AEB7B29673E8E9DC34C4EDEAF065B,13091,22,23,1,20,42,1042
127,127,3BA5FA710EA7575C057415E520D57C01,40101,1,3,2,34,49,1749
128,128,3BA5FA710EA7575C057415E520D57C01,11461,4,5,1,37,49,1899
129,129,3BA5FA710EA7575C057415E520D57C01,10111,6,18,12,37,47,1897
133,133,644074FAED2D07B771DBBC3C2ED7ABF4,13411,0,6,6,49,42,2492
134,134,644074FAED2D07B771DBBC3C2ED7ABF4,12561,8,9,1,45,43,2293
135,135,644074FAED2D07B771DBBC3C2ED7ABF4,43951,10,11,1,49,41,2491
136,136,644074FAED2D07B771DBBC3C2ED7ABF4,13411,12,13,1,49,42,2492
137,137,644074FAED2D07B771DBBC3C2ED7ABF4,43951,14,19,5,49,41,2491
138,138,644074FAED2D07B771DBBC3C2ED7ABF4,13411,19,23,4,49,42,2492
151,151,68DDCF4E5E82DB72287BDEDDF8F05C96,43341,0,1,1,41,46,2096
152,152,68DDCF4E5E82DB72287BDEDDF8F05C96,10431,14,16,2,33,49,1699
153,153,68DDCF4E5E82DB72287BDEDDF8F05C96,11531,16,17,1,34,49,1749
154,154,68DDCF4E5E82DB72287BDEDDF8F05C96,11231,21,23,2,37,49,1899
161,161,80779C982E47128931C5479B9B9DAF80,11651,0,1,1,33,47,1697
162,162,80779C982E47128931C5479B9B9DAF80,11861,1,8,7,32,47,1647
163,163,80779C982E47128931C5479B9B9DAF80,41101,9,11,2,32,48,1648
164,164,80779C982E47128931C5479B9B9DAF80,11861,12,17,5,32,47,1647
165,165,80779C982E47128931C5479B9B9DAF80,10251,21,23,2,35,47,1797
169,169,9B628FEA6BCA8EB97BB3F7B5F63CD306,13911,0,6,6,39,46,1996
170,170,9B628FEA6BCA8EB97BB3F7B5F63CD306,10351,9,18,9,28,45,1445
171,171,9B628FEA6BCA8EB97BB3F7B5F63CD306,13911,18,23,5,39,46,1996
179,179,52A3E1CE4491060F392925C38B78647A,11074,0,14,14,37,47,1897
180,180,52A3E1CE4491060F392925C38B78647A,12381,16,17,1,32,48,1648
181,181,52A3E1CE4491060F392925C38B78647A,10841,18,20,2,37,47,1897
182,182,52A3E1CE4491060F392925C38B78647A,11791,21,22,1,38,49,1949
186,186,D157013D3488A5412F8F2595D1038B6C,10716,0,7,7,30,46,1546
187,187,D157013D3488A5412F8F2595D1038B6C,13601,9,13,4,34,47,1747
188,188,D157013D3488A5412F8F2595D1038B6C,40611,13,15,2,35,47,1797
189,189,D157013D3488A5412F8F2595D1038B6C,12311,15,18,3,30,44,1544
190,190,D157013D3488A5412F8F2595D1038B6C,11875,21,23,2,30,46,1546
191,191,7604F2540715D6DF51E797251548A37E,11861,0,13,13,32,47,1647
192,192,7604F2540715D6DF51E797251548A37E,40341,14,16,2,23,49,1199
193,193,7604F2540715D6DF51E797251548A37E,43731,18,19,1,34,47,1747
194,194,7604F2540715D6DF51E797251548A37E,11861,20,21,1,32,47,1647
198,198,1D9293BBBEC3848167A05BBAFE105FD9,11061,1,8,7,29,48,1498
199,199,1D9293BBBEC3848167A05BBAFE105FD9,42071,8,9,1,31,49,1599
200,200,1D9293BBBEC3848167A05BBAFE105FD9,42381,13,14,1,39,41,1991
201,201,1D9293BBBEC3848167A05BBAFE105FD9,11061,17,21,4,29,48,1498
202,202,1D9293BBBEC3848167A05BBAFE105FD9,13651,22,23,1,30,47,1547
206,206,6DFA48F81EF42083077B44FC80706865,10971,0,14,14,35,47,1797
207,207,6DFA48F81EF42083077B44FC80706865,43731,15,17,2,34,47,1747
208,208,6DFA48F81EF42083077B44FC80706865,11301,17,21,4,41,49,2099
215,215,091497AD7ED956A0C3F93F46CFB651F5,43021,0,16,16,16,43,843
216,216,091497AD7ED956A0C3F93F46CFB651F5,12921,19,20,1,9,41,491
217,217,091497AD7ED956A0C3F93F46CFB651F5,43021,22,23,1,16,43,843
218,218,BF29A9480BAB7B58A18F76AD129514BD,42301,0,8,8,36,47,1847
219,219,BF29A9480BAB7B58A18F76AD129514BD,10531,11,12,1,34,46,1746
220,220,BF29A9480BAB7B58A18F76AD129514BD,10111,13,14,1,37,47,1897
221,221,BF29A9480BAB7B58A18F76AD129514BD,42521,16,18,2,31,47,1597
222,222,BF29A9480BAB7B58A18F76AD129514BD,10111,19,23,4,37,47,1897
229,229,40712183BC9EFC505F343959D0497D3F,12561,0,2,2,45,43,2293
230,230,40712183BC9EFC505F343959D0497D3F,13411,6,7,1,49,42,2492
231,231,40712183BC9EFC505F343959D0497D3F,43951,11,12,1,49,41,2491
232,232,40712183BC9EFC505F343959D0497D3F,13411,13,19,6,49,42,2492
233,233,40712183BC9EFC505F343959D0497D3F,43951,19,21,2,49,41,2491
237,237,1834E19F94E005AFC306AA67190EF410,42141,0,6,6,32,47,1647
238,238,1834E19F94E005AFC306AA67190EF410,13711,7,8,1,38,46,1946
239,239,1834E19F94E005AFC306AA67190EF410,42141,21,23,2,32,47,1647
240,240,C5ED324891B8B95E257970408E8D4150,13911,0,1,1,39,46,1996
241,241,C5ED324891B8B95E257970408E8D4150,12491,1,5,4,36,43,1843
242,242,C5ED324891B8B95E257970408E8D4150,11261,6,12,6,36,46,1846
243,243,C5ED324891B8B95E257970408E8D4150,13911,15,21,6,39,46,1996
244,244,C5ED324891B8B95E257970408E8D4150,12491,22,23,1,36,43,1843
251,251,C69E0CA9901BB33595EAB544526AEF15,11001,0,13,13,42,47,2147
252,252,C69E0CA9901BB33595EAB544526AEF15,13121,15,16,1,38,46,1946
253,253,C69E0CA9901BB33595EAB544526AEF15,11001,18,22,4,42,47,2147
264,264,A96E2E9F5CBC6618C051218D31E72217,10281,1,14,13,33,48,1698
265,265,A96E2E9F5CBC6618C051218D31E72217,42623,16,17,1,22,49,1149
266,266,A96E2E9F5CBC6618C051218D31E72217,10431,18,19,1,33,49,1699
267,267,A96E2E9F5CBC6618C051218D31E72217,11061,20,21,1,29,48,1498
268,268,4B1D7C3F5ACC5B0F371E26D283095EE1,10411,7,8,1,36,48,1848
269,269,4B1D7C3F5ACC5B0F371E26D283095EE1,11481,9,10,1,41,48,2098
270,270,4B1D7C3F5ACC5B0F371E26D283095EE1,40341,11,13,2,23,49,1199
271,271,4B1D7C3F5ACC5B0F371E26D283095EE1,40673,15,17,2,36,48,1848
272,272,4B1D7C3F5ACC5B0F371E26D283095EE1,10731,17,20,3,33,47,1697
276,276,28EBDF129D422CC62555B67FAF051D3A,43761,0,7,7,32,47,1647
277,277,28EBDF129D422CC62555B67FAF051D3A,11231,9,10,1,37,49,1899
278,278,28EBDF129D422CC62555B67FAF051D3A,10901,12,15,3,35,48,1798
279,279,28EBDF129D422CC62555B67FAF051D3A,11231,16,17,1,37,49,1899
280,280,28EBDF129D422CC62555B67FAF051D3A,13071,19,20,1,41,41,2091
281,281,28EBDF129D422CC62555B67FAF051D3A,12831,21,23,2,34,38,1738
282,282,82E214886D875E0665198A70E3379757,42551,0,5,5,14,48,748
283,283,82E214886D875E0665198A70E3379757,42681,6,7,1,24,48,1248
284,284,82E214886D875E0665198A70E3379757,40341,9,11,2,23,49,1199
285,285,82E214886D875E0665198A70E3379757,42681,12,19,7,24,48,1248
286,286,01A28DB017B1469D0D144CB2323D1ED0,12521,7,8,1,35,41,1791
287,287,01A28DB017B1469D0D144CB2323D1ED0,43671,9,12,3,35,48,1798
288,288,01A28DB017B1469D0D144CB2323D1ED0,12521,15,18,3,35,41,1791
289,289,A567BE5B1DACD6E00CC2FAA52D5DB6DF,13941,0,8,8,41,47,2097
290,290,A567BE5B1DACD6E00CC2FAA52D5DB6DF,12311,10,13,3,30,44,1544
291,291,A567BE5B1DACD6E00CC2FAA52D5DB6DF,42531,13,15,2,31,45,1595
292,292,A567BE5B1DACD6E00CC2FAA52D5DB6DF,12311,16,17,1,30,44,1544
293,293,A567BE5B1DACD6E00CC2FAA52D5DB6DF,10401,18,19,1,33,49,1699
294,294,A567BE5B1DACD6E00CC2FAA52D5DB6DF,40833,21,23,2,41,47,2097
298,298,8E6F323BA70C6AFB89E795BE6C3D0D4B,10721,0,9,9,31,48,1598
299,299,8E6F323BA70C6AFB89E795BE6C3D0D4B,43471,10,12,2,31,49,1599
300,300,8E6F323BA70C6AFB89E795BE6C3D0D4B,10721,12,14,2,31,48,1598
301,301,8E6F323BA70C6AFB89E795BE6C3D0D4B,42623,19,20,1,22,49,1149
302,302,1EB04427525F10341252640184FA621A,42471,9,10,1,35,49,1799
303,303,1EB04427525F10341252640184FA621A,13091,13,14,1,20,42,1042
304,304,1EB04427525F10341252640184FA621A,43041,18,19,1,41,46,2096
308,308,F6947486712885EDC02BCA122A5A6DB5,15061,0,8,8,41,25,2075
309,309,F6947486712885EDC02BCA122A5A6DB5,12881,9,11,2,47,22,2372
310,310,F6947486712885EDC02BCA122A5A6DB5,15061,11,23,12,41,25,2075
314,314,64429B389DA39AA89BDA9504E35D4355,13941,0,15,15,41,47,2097
315,315,64429B389DA39AA89BDA9504E35D4355,13711,16,17,1,38,46,1946
316,316,64429B389DA39AA89BDA9504E35D4355,11231,18,22,4,37,49,1899
317,317,3EEFB7BDF8C8012BA246A804A35191A0,12611,1,5,4,41,29,2079
318,318,3EEFB7BDF8C8012BA246A804A35191A0,12792,6,8,2,34,30,1730
319,319,3EEFB7BDF8C8012BA246A804A35191A0,15191,8,18,10,36,27,1827
320,320,3EEFB7BDF8C8012BA246A804A35191A0,15671,21,23,2,37,26,1876
321,321,B0B36057F46B4664CBCA7B3A3FC6EBDD,19021,0,6,6,10,45,545
322,322,B0B36057F46B4664CBCA7B3A3FC6EBDD,43021,9,12,3,16,43,843
323,323,B0B36057F46B4664CBCA7B3A3FC6EBDD,19021,13,14,1,10,45,545
324,324,B0B36057F46B4664CBCA7B3A3FC6EBDD,43021,15,16,1,16,43,843
325,325,B0B36057F46B4664CBCA7B3A3FC6EBDD,19021,16,20,4,10,45,545
326,326,6AA41B84CB33A922FFCBD7C059C1E8E3,10721,0,8,8,31,48,1598
327,327,6AA41B84CB33A922FFCBD7C059C1E8E3,11801,9,11,2,42,48,2148
328,328,6AA41B84CB33A922FFCBD7C059C1E8E3,10121,14,23,9,36,49,1849
329,329,CE17A391725DA64890DF44713AF877C7,11101,0,14,14,18,48,948
330,330,CE17A391725DA64890DF44713AF877C7,15651,15,16,1,39,25,1975
331,331,CE17A391725DA64890DF44713AF877C7,10381,18,19,1,31,49,1599
332,332,CE17A391725DA64890DF44713AF877C7,11151,20,21,1,30,48,1548
337,337,76E54C1AE53118A77BF3D39757FEEE68,10251,0,14,14,35,47,1797
338,338,76E54C1AE53118A77BF3D39757FEEE68,40341,14,16,2,23,49,1199
339,339,76E54C1AE53118A77BF3D39757FEEE68,42161,17,23,6,36,47,1847
344,344,97F3C4C847ED1961BA2625F974BDB249,40637,0,7,7,36,47,1847
345,345,97F3C4C847ED1961BA2625F974BDB249,43731,12,14,2,34,47,1747
346,346,97F3C4C847ED1961BA2625F974BDB249,11771,15,17,2,39,49,1999
347,347,97F3C4C847ED1961BA2625F974BDB249,11271,18,21,3,37,48,1898
348,348,791B88A47599C4AA49B70831477381D4,42111,0,2,2,44,46,2246
349,349,791B88A47599C4AA49B70831477381D4,42201,2,9,7,43,46,2196
350,350,791B88A47599C4AA49B70831477381D4,42111,9,14,5,44,46,2246
351,351,791B88A47599C4AA49B70831477381D4,42461,15,16,1,45,47,2297
352,352,791B88A47599C4AA49B70831477381D4,42201,16,17,1,43,46,2196
353,353,791B88A47599C4AA49B70831477381D4,11271,19,21,2,37,48,1898
354,354,81F2E20D701C7343DFFCFF71F686BC20,11771,0,8,8,39,49,1999
355,355,81F2E20D701C7343DFFCFF71F686BC20,13351,9,17,8,48,48,2448
356,356,81F2E20D701C7343DFFCFF71F686BC20,41601,18,19,1,39,49,1999
357,357,81F2E20D701C7343DFFCFF71F686BC20,11954,21,22,1,32,49,1649
358,358,20806559F9E602745DBC97D78FDA70A0,42511,0,8,8,37,47,1897
359,359,20806559F9E602745DBC97D78FDA70A0,42161,12,13,1,36,47,1847
360,360,20806559F9E602745DBC97D78FDA70A0,10841,14,15,1,37,47,1897
361,361,20806559F9E602745DBC97D78FDA70A0,10151,16,18,2,34,47,1747
362,362,20806559F9E602745DBC97D78FDA70A0,10841,21,23,2,37,47,1897
363,363,6328F7CDE1FD4A3418797D65E47142EC,11151,0,8,8,30,48,1548
364,364,6328F7CDE1FD4A3418797D65E47142EC,12051,8,10,2,20,47,1047
365,365,6328F7CDE1FD4A3418797D65E47142EC,11151,11,12,1,30,48,1548
366,366,6328F7CDE1FD4A3418797D65E47142EC,11361,13,15,2,22,48,1148
367,367,6328F7CDE1FD4A3418797D65E47142EC,11151,16,23,7,30,48,1548
371,371,261E578A9ADD5DB5F1BF8D1F93100799,11261,0,1,1,36,46,1846
372,372,261E578A9ADD5DB5F1BF8D1F93100799,42864,5,6,1,38,44,1944
373,373,261E578A9ADD5DB5F1BF8D1F93100799,11261,6,10,4,36,46,1846
374,374,261E578A9ADD5DB5F1BF8D1F93100799,42864,11,12,1,38,44,1944
375,375,261E578A9ADD5DB5F1BF8D1F93100799,11261,15,16,1,36,46,1846
376,376,261E578A9ADD5DB5F1BF8D1F93100799,42864,17,19,2,38,44,1944
377,377,261E578A9ADD5DB5F1BF8D1F93100799,11261,19,21,2,36,46,1846
378,378,495339FD97B50D8105C4A93A90CE4FFA,11301,0,7,7,41,49,2099
379,379,495339FD97B50D8105C4A93A90CE4FFA,11151,9,13,4,30,48,1548
380,380,495339FD97B50D8105C4A93A90CE4FFA,11061,18,19,1,29,48,1498
381,381,495339FD97B50D8105C4A93A90CE4FFA,40302,21,22,1,40,49,2049
385,385,577BD4C36A03690EAC6E6C3193E9FF99,11741,0,3,3,42,49,2149
386,386,577BD4C36A03690EAC6E6C3193E9FF99,40302,4,6,2,40,49,2049
387,387,577BD4C36A03690EAC6E6C3193E9FF99,11741,6,11,5,42,49,2149
388,388,577BD4C36A03690EAC6E6C3193E9FF99,10107,12,15,3,38,49,1949
389,389,577BD4C36A03690EAC6E6C3193E9FF99,40341,16,18,2,23,49,1199
390,390,577BD4C36A03690EAC6E6C3193E9FF99,42931,21,22,1,41,49,2099
394,394,26CB7197E081F66AA0D7DD9E572720E4,11741,0,9,9,42,49,2149
395,395,26CB7197E081F66AA0D7DD9E572720E4,11561,10,11,1,32,49,1649
396,396,26CB7197E081F66AA0D7DD9E572720E4,11201,12,20,8,35,49,1799
397,397,26CB7197E081F66AA0D7DD9E572720E4,11741,21,23,2,42,49,2149
401,401,0DAFED6DA217D81CEC95BF49695A0A10,11381,0,15,15,30,47,1547
402,402,0DAFED6DA217D81CEC95BF49695A0A10,10841,17,20,3,37,47,1897
403,403,0DAFED6DA217D81CEC95BF49695A0A10,11381,21,23,2,30,47,1547
404,404,7779D5C4E5073D864A9050EB76A5AC64,11261,0,1,1,36,46,1846
405,405,7779D5C4E5073D864A9050EB76A5AC64,43341,3,5,2,41,46,2096
406,406,7779D5C4E5073D864A9050EB76A5AC64,11261,7,9,2,36,46,1846
407,407,7779D5C4E5073D864A9050EB76A5AC64,42864,9,11,2,38,44,1944
408,408,7779D5C4E5073D864A9050EB76A5AC64,11261,12,23,11,36,46,1846
432,432,24CACD73BA8D75767DDD668E5EA165E2,40171,0,6,6,38,48,1948
433,433,24CACD73BA8D75767DDD668E5EA165E2,11914,7,8,1,37,48,1898
434,434,24CACD73BA8D75767DDD668E5EA165E2,42581,9,13,4,38,48,1948
435,435,24CACD73BA8D75767DDD668E5EA165E2,11914,13,18,5,37,48,1898
436,436,24CACD73BA8D75767DDD668E5EA165E2,40171,18,19,1,38,48,1948
437,437,24CACD73BA8D75767DDD668E5EA165E2,42191,22,23,1,38,49,1949
438,438,16D2341D8DA1F61C52A8D060D4FBB345,10801,0,9,9,42,47,2147
439,439,16D2341D8DA1F61C52A8D060D4FBB345,11021,11,12,1,36,49,1849
440,440,16D2341D8DA1F61C52A8D060D4FBB345,10801,16,18,2,42,47,2147
441,441,16D2341D8DA1F61C52A8D060D4FBB345,40691,19,20,1,42,48,2148
442,442,16D2341D8DA1F61C52A8D060D4FBB345,10801,21,23,2,42,47,2147
443,443,2AF43C5AD18802056DDB97F11B48E696,42511,0,1,1,37,47,1897
444,444,2AF43C5AD18802056DDB97F11B48E696,13681,2,5,3,38,47,1947
445,445,2AF43C5AD18802056DDB97F11B48E696,42511,5,8,3,37,47,1897
446,446,2AF43C5AD18802056DDB97F11B48E696,13681,11,12,1,38,47,1947
447,447,2AF43C5AD18802056DDB97F11B48E696,42511,13,18,5,37,47,1897
448,448,2AF43C5AD18802056DDB97F11B48E696,12514,19,20,1,38,47,1947
449,449,3E1EE5C3B3EA02D05BA98946F054AD5C,42341,2,7,5,43,49,2199
450,450,3E1EE5C3B3EA02D05BA98946F054AD5C,12083,18,21,3,36,49,1849
451,451,3E1EE5C3B3EA02D05BA98946F054AD5C,11781,21,23,2,38,49,1949
452,452,760E5496C7CBF2B23EC48D1163A2AA2C,15321,0,1,1,29,26,1476
453,453,760E5496C7CBF2B23EC48D1163A2AA2C,43121,1,3,2,25,27,1277
454,454,760E5496C7CBF2B23EC48D1163A2AA2C,15321,3,4,1,29,26,1476
455,455,760E5496C7CBF2B23EC48D1163A2AA2C,12792,6,9,3,34,30,1730
456,456,760E5496C7CBF2B23EC48D1163A2AA2C,12791,13,18,5,31,29,1579
457,457,760E5496C7CBF2B23EC48D1163A2AA2C,43081,20,22,2,27,28,1378
458,458,1FA24F76587DEEEE9ED93C46D3D68950,42371,1,7,6,34,46,1746
459,459,1FA24F76587DEEEE9ED93C46D3D68950,12491,8,13,5,36,43,1843
460,460,1FA24F76587DEEEE9ED93C46D3D68950,42371,16,20,4,34,46,1746
461,461,25F92E535CC418A921B30C55748AADEA,43151,0,9,9,40,49,2049
462,462,25F92E535CC418A921B30C55748AADEA,42523,10,17,7,31,47,1597
463,463,25F92E535CC418A921B30C55748AADEA,10716,17,23,6,30,46,1546
467,467,F69C08279BA16EB75288509ECD032B43,42401,0,9,9,36,47,1847
468,468,F69C08279BA16EB75288509ECD032B43,10501,13,14,1,22,46,1146
469,469,F69C08279BA16EB75288509ECD032B43,40341,14,17,3,23,49,1199
470,470,F69C08279BA16EB75288509ECD032B43,42301,20,23,3,36,47,1847
477,477,39A12A7E8C423731CE90191A15A5C3F4,43021,0,4,4,16,43,843
478,478,39A12A7E8C423731CE90191A15A5C3F4,12921,7,16,9,9,41,491
479,479,39A12A7E8C423731CE90191A15A5C3F4,12641,17,18,1,10,43,543
489,489,A192DB3225F77F05B56B73364F126A31,12661,0,5,5,32,45,1645
490,490,A192DB3225F77F05B56B73364F126A31,10634,6,10,4,27,45,1395
491,491,A192DB3225F77F05B56B73364F126A31,12661,11,23,12,32,45,1645
492,492,3EE21C82096056103395982F3BA140C7,10251,0,1,1,35,47,1797
493,493,3EE21C82096056103395982F3BA140C7,13511,1,5,4,34,48,1748
494,494,3EE21C82096056103395982F3BA140C7,10251,7,8,1,35,47,1797
495,495,3EE21C82096056103395982F3BA140C7,42161,11,12,1,36,47,1847
496,496,3EE21C82096056103395982F3BA140C7,10251,14,23,9,35,47,1797
503,503,4A1E2DF13E9399DEAE7966E1EFE6FC6B,13941,0,4,4,41,47,2097
504,504,4A1E2DF13E9399DEAE7966E1EFE6FC6B,10634,6,15,9,27,45,1395
505,505,4A1E2DF13E9399DEAE7966E1EFE6FC6B,12311,15,17,2,30,44,1544
506,506,4A1E2DF13E9399DEAE7966E1EFE6FC6B,13941,20,21,1,41,47,2097
507,507,4A1E2DF13E9399DEAE7966E1EFE6FC6B,11481,22,23,1,41,48,2098
508,508,00ED2280FB2BEC22D8FB36F8A7AFB1A5,42791,0,6,6,35,45,1795
509,509,00ED2280FB2BEC22D8FB36F8A7AFB1A5,10271,9,13,4,37,46,1896
510,510,00ED2280FB2BEC22D8FB36F8A7AFB1A5,13121,13,16,3,38,46,1946
511,511,00ED2280FB2BEC22D8FB36F8A7AFB1A5,10271,16,18,2,37,46,1896
512,512,00ED2280FB2BEC22D8FB36F8A7AFB1A5,42791,19,23,4,35,45,1795
513,513,D523B4CC9C9CF3421E66C004792D242D,12514,0,2,2,38,47,1947
514,514,D523B4CC9C9CF3421E66C004792D242D,11481,3,8,5,41,48,2098
515,515,D523B4CC9C9CF3421E66C004792D242D,42511,10,12,2,37,47,1897
516,516,D523B4CC9C9CF3421E66C004792D242D,10531,14,17,3,34,46,1746
517,517,D523B4CC9C9CF3421E66C004792D242D,11481,18,23,5,41,48,2098
518,518,7B7EC78C492826B1A2F98257774A5C01,11061,3,8,5,29,48,1498
519,519,7B7EC78C492826B1A2F98257774A5C01,40171,9,18,9,38,48,1948
520,520,7B7EC78C492826B1A2F98257774A5C01,11061,18,23,5,29,48,1498
521,521,11199AC9322CB1D62821B7265EEE1673,11911,0,8,8,37,48,1898
522,522,11199AC9322CB1D62821B7265EEE1673,42161,9,14,5,36,47,1847
523,523,11199AC9322CB1D62821B7265EEE1673,43161,15,16,1,35,47,1797
524,524,11199AC9322CB1D62821B7265EEE1673,42161,17,19,2,36,47,1847
525,525,11199AC9322CB1D62821B7265EEE1673,11911,21,23,2,37,48,1898
526,526,409EAD533DBB4CABE595F1357EB3A959,12141,0,7,7,42,45,2145
527,527,409EAD533DBB4CABE595F1357EB3A959,42631,9,11,2,43,45,2195
528,528,409EAD533DBB4CABE595F1357EB3A959,12141,12,13,1,42,45,2145
529,529,409EAD533DBB4CABE595F1357EB3A959,12211,14,17,3,41,44,2094
530,530,409EAD533DBB4CABE595F1357EB3A959,12141,18,22,4,42,45,2145
531,531,9C17C707743AE50FBFFE4446783207FB,10381,1,11,10,31,49,1599
532,532,9C17C707743AE50FBFFE4446783207FB,40347,12,17,5,25,49,1299
533,533,9C17C707743AE50FBFFE4446783207FB,11201,20,22,2,35,49,1799
534,534,5FAEC0134B85CE1B9BA20CA254329CA1,42521,1,8,7,31,47,1597
535,535,5FAEC0134B85CE1B9BA20CA254329CA1,40341,9,10,1,23,49,1199
536,536,5FAEC0134B85CE1B9BA20CA254329CA1,42521,15,18,3,31,47,1597
537,537,5FAEC0134B85CE1B9BA20CA254329CA1,43761,19,20,1,32,47,1647
538,538,CC1D3C2DA42F1EBED6688749C3DA1D87,11381,2,6,4,30,47,1547
539,539,CC1D3C2DA42F1EBED6688749C3DA1D87,11261,8,18,10,36,46,1846
540,540,CC1D3C2DA42F1EBED6688749C3DA1D87,11381,22,23,1,30,47,1547
551,551,D7349708A10855AEF98FEB8D22C33E59,40833,0,7,7,41,47,2097
552,552,D7349708A10855AEF98FEB8D22C33E59,11231,9,10,1,37,49,1899
553,553,D7349708A10855AEF98FEB8D22C33E59,13271,12,16,4,41,47,2097
554,554,D7349708A10855AEF98FEB8D22C33E59,13701,18,23,5,21,38,1088
562,562,96509F010CBB32F495B38C2E043F1A98,43451,3,5,2,37,40,1890
563,563,96509F010CBB32F495B38C2E043F1A98,43011,7,9,2,40,42,2042
564,564,96509F010CBB32F495B38C2E043F1A98,12141,14,16,2,42,45,2145
565,565,96509F010CBB32F495B38C2E043F1A98,43451,18,19,1,37,40,1890
566,566,96509F010CBB32F495B38C2E043F1A98,43011,20,22,2,40,42,2042
567,567,96509F010CBB32F495B38C2E043F1A98,42151,22,23,1,35,45,1795
568,568,B9593B6551A775E63140069F2A62C943,10281,0,7,7,33,48,1698
569,569,B9593B6551A775E63140069F2A62C943,10681,8,9,1,30,48,1548
570,570,B9593B6551A775E63140069F2A62C943,11061,11,12,1,29,48,1498
571,571,B9593B6551A775E63140069F2A62C943,10681,13,20,7,30,48,1548
572,572,B9593B6551A775E63140069F2A62C943,10281,21,23,2,33,48,1698
579,579,DD7DD5F8674DC4B5BF72B1D64558520C,12671,0,1,1,21,43,1093
580,580,DD7DD5F8674DC4B5BF72B1D64558520C,13094,2,5,3,21,42,1092
581,581,DD7DD5F8674DC4B5BF72B1D64558520C,10351,7,8,1,28,45,1445
582,582,DD7DD5F8674DC4B5BF72B1D64558520C,12671,10,14,4,21,43,1093
583,583,DD7DD5F8674DC4B5BF72B1D64558520C,13094,14,16,2,21,42,1092
584,584,DD7DD5F8674DC4B5BF72B1D64558520C,12671,16,23,7,21,43,1093
585,585,ACD04627348D28EB014FAB46490D4B92,10351,0,15,15,28,45,1445
586,586,ACD04627348D28EB014FAB46490D4B92,12671,18,19,1,21,43,1093
587,587,ACD04627348D28EB014FAB46490D4B92,10351,21,22,1,28,45,1445
588,588,0910F80498ECB893DE64FE27C977BF87,42051,0,2,2,42,48,2148
589,589,0910F80498ECB893DE64FE27C977BF87,10661,3,9,6,37,49,1899
590,590,0910F80498ECB893DE64FE27C977BF87,10421,16,18,2,41,48,2098
613,613,B5C7142939A2E6ED4C5CA8232F2EC9F9,19741,0,6,6,5,44,294
614,614,B5C7142939A2E6ED4C5CA8232F2EC9F9,12641,6,8,2,10,43,543
615,615,B5C7142939A2E6ED4C5CA8232F2EC9F9,19114,11,12,1,7,43,393
616,616,B5C7142939A2E6ED4C5CA8232F2EC9F9,12641,13,14,1,10,43,543
617,617,B5C7142939A2E6ED4C5CA8232F2EC9F9,19114,15,18,3,7,43,393
618,618,B5C7142939A2E6ED4C5CA8232F2EC9F9,19741,19,23,4,5,44,294
622,622,4EAEA07A12B611EF65EDB5896F86C5E3,11074,2,4,2,37,47,1897
623,623,4EAEA07A12B611EF65EDB5896F86C5E3,42221,7,8,1,38,48,1948
624,624,4EAEA07A12B611EF65EDB5896F86C5E3,42531,11,12,1,31,45,1595
625,625,4EAEA07A12B611EF65EDB5896F86C5E3,11281,15,16,1,27,40,1390
626,626,4EAEA07A12B611EF65EDB5896F86C5E3,42531,20,21,1,31,45,1595
630,630,F3632CEFCEB99C36253996BED876A313,10341,0,7,7,31,47,1597
631,631,F3632CEFCEB99C36253996BED876A313,10351,8,13,5,28,45,1445
632,632,F3632CEFCEB99C36253996BED876A313,12601,13,15,2,25,47,1297
633,633,F3632CEFCEB99C36253996BED876A313,43501,18,22,4,27,48,1398
637,637,3D50CF8DA80A4761FAF974D4CBB0A177,43751,0,7,7,19,48,998
638,638,3D50CF8DA80A4761FAF974D4CBB0A177,19114,11,13,2,7,43,393
639,639,3D50CF8DA80A4761FAF974D4CBB0A177,12641,17,18,1,10,43,543
640,640,3D50CF8DA80A4761FAF974D4CBB0A177,19114,21,23,2,7,43,393
641,641,5A45F00505D10CE6F80144DAC647FEEE,19741,0,7,7,5,44,294
642,642,5A45F00505D10CE6F80144DAC647FEEE,12921,7,8,1,9,41,491
643,643,5A45F00505D10CE6F80144DAC647FEEE,19741,11,13,2,5,44,294
644,644,5A45F00505D10CE6F80144DAC647FEEE,12921,15,20,5,9,41,491
645,645,5A45F00505D10CE6F80144DAC647FEEE,19024,21,23,2,9,45,495
646,646,F49EE04071D0B4FCCD4263F4C2BBEA7A,11151,0,6,6,30,48,1548
647,647,F49EE04071D0B4FCCD4263F4C2BBEA7A,11061,7,16,9,29,48,1498
648,648,F49EE04071D0B4FCCD4263F4C2BBEA7A,11161,18,19,1,32,48,1648
649,649,F49EE04071D0B4FCCD4263F4C2BBEA7A,43761,19,20,1,32,47,1647
650,650,F49EE04071D0B4FCCD4263F4C2BBEA7A,11061,22,23,1,29,48,1498
651,651,5DCDEE86AFA2D68FD07F31A3CA76F70F,11661,0,15,15,40,49,2049
652,652,5DCDEE86AFA2D68FD07F31A3CA76F70F,42511,18,20,2,37,47,1897
653,653,5DCDEE86AFA2D68FD07F31A3CA76F70F,43151,20,22,2,40,49,2049
654,654,A6EF3AA52D2C883DD4C8A6E9BED0EE14,19901,0,5,5,7,44,394
655,655,A6EF3AA52D2C883DD4C8A6E9BED0EE14,19821,6,10,4,4,46,246
656,656,A6EF3AA52D2C883DD4C8A6E9BED0EE14,12921,13,19,6,9,41,491
660,660,1C0548F40841AD0870DAD8EC7BECCBC6,13314,0,6,6,31,39,1589
661,661,1C0548F40841AD0870DAD8EC7BECCBC6,12521,7,10,3,35,41,1791
662,662,1C0548F40841AD0870DAD8EC7BECCBC6,13314,10,23,13,31,39,1589
663,663,4A510AC249994E423A2606C1458F04D5,10716,0,7,7,30,46,1546
664,664,4A510AC249994E423A2606C1458F04D5,11794,11,16,5,38,49,1949
665,665,4A510AC249994E423A2606C1458F04D5,42871,19,21,2,30,45,1545
666,666,098FE8401B48D35D8F8F23ACB7575A2C,43021,0,19,19,16,43,843
667,667,098FE8401B48D35D8F8F23ACB7575A2C,12641,21,22,1,10,43,543
668,668,098FE8401B48D35D8F8F23ACB7575A2C,12921,22,23,1,9,41,491
679,679,9C853A4D5C7B5210EB733E5032A36376,11021,0,9,9,36,49,1849
680,680,9C853A4D5C7B5210EB733E5032A36376,42541,13,15,2,25,47,1297
681,681,9C853A4D5C7B5210EB733E5032A36376,10281,20,21,1,33,48,1698
682,682,9C853A4D5C7B5210EB733E5032A36376,11021,22,23,1,36,49,1849
690,690,6BBD6DE4A5CAFEB85DA0DC89AB1002CF,42151,0,10,10,35,45,1795
691,691,6BBD6DE4A5CAFEB85DA0DC89AB1002CF,42531,11,12,1,31,45,1595
692,692,6BBD6DE4A5CAFEB85DA0DC89AB1002CF,42523,17,19,2,31,47,1597
693,693,6BBD6DE4A5CAFEB85DA0DC89AB1002CF,42491,19,20,1,32,46,1646
694,694,A796809FFC26797F0B17A0B66E102B15,13314,0,7,7,31,39,1589
695,695,A796809FFC26797F0B17A0B66E102B15,12521,7,11,4,35,41,1791
696,696,A796809FFC26797F0B17A0B66E102B15,13314,12,13,1,31,39,1589
697,697,A796809FFC26797F0B17A0B66E102B15,12521,13,16,3,35,41,1791
698,698,A796809FFC26797F0B17A0B66E102B15,13314,18,23,5,31,39,1589
702,702,649CA0B4C9C73F10630BCAC6C100E533,42151,0,6,6,35,45,1795
703,703,649CA0B4C9C73F10630BCAC6C100E533,12311,6,19,13,30,44,1544
704,704,649CA0B4C9C73F10630BCAC6C100E533,42151,20,23,3,35,45,1795
705,705,A882EFB75C6AB9B26B1D5C49145A1144,42221,1,5,4,38,48,1948
706,706,A882EFB75C6AB9B26B1D5C49145A1144,10951,9,12,3,29,48,1498
707,707,A882EFB75C6AB9B26B1D5C49145A1144,11074,16,17,1,37,47,1897
708,708,A882EFB75C6AB9B26B1D5C49145A1144,42221,18,23,5,38,48,1948
709,709,12D74476F053068F7D2533ADA7E34270,11911,0,9,9,37,48,1898
710,710,12D74476F053068F7D2533ADA7E34270,40951,10,11,1,36,49,1849
711,711,12D74476F053068F7D2533ADA7E34270,11751,12,14,2,35,48,1798
712,712,12D74476F053068F7D2533ADA7E34270,40951,14,17,3,36,49,1849
713,713,12D74476F053068F7D2533ADA7E34270,11911,18,20,2,37,48,1898
714,714,FA0C4CA4021C0DDC268260533289E286,19441,0,8,8,8,46,446
715,715,FA0C4CA4021C0DDC268260533289E286,11631,10,12,2,12,49,649
716,716,FA0C4CA4021C0DDC268260533289E286,11381,13,23,10,30,47,1547
724,724,A2322C7E82C506086C86C7A37D702773,12381,0,8,8,32,48,1648
725,725,A2322C7E82C506086C86C7A37D702773,42583,9,10,1,40,48,2048
726,726,A2322C7E82C506086C86C7A37D702773,11801,11,12,1,42,48,2148
727,727,A2322C7E82C506086C86C7A37D702773,12381,13,23,10,32,48,1648
732,732,41650392AF136767D47A4E5C67F6032A,42151,0,7,7,35,45,1795
733,733,41650392AF136767D47A4E5C67F6032A,12491,7,8,1,36,43,1843
734,734,41650392AF136767D47A4E5C67F6032A,42864,9,19,10,38,44,1944
735,735,41650392AF136767D47A4E5C67F6032A,40697,21,23,2,43,48,2198
736,736,AE9DABC8C76DE8782FA56379E8CBF939,43501,0,7,7,27,48,1398
737,737,AE9DABC8C76DE8782FA56379E8CBF939,10544,7,10,3,28,48,1448
738,738,AE9DABC8C76DE8782FA56379E8CBF939,43501,13,16,3,27,48,1398
739,739,AE9DABC8C76DE8782FA56379E8CBF939,10107,18,20,2,38,49,1949
740,740,AE9DABC8C76DE8782FA56379E8CBF939,11531,20,22,2,34,49,1749
741,741,C06A2B736F0C9DE7AE001761CE315949,15191,7,10,3,36,27,1827
742,742,C06A2B736F0C9DE7AE001761CE315949,12792,11,15,4,34,30,1730
743,743,C06A2B736F0C9DE7AE001761CE315949,15191,17,18,1,36,27,1827
747,747,D6B662C0D72BBB94314A69A6BE13D66E,43761,0,8,8,32,47,1647
748,748,D6B662C0D72BBB94314A69A6BE13D66E,19111,12,14,2,9,45,495
749,749,D6B662C0D72BBB94314A69A6BE13D66E,12083,15,17,2,36,49,1849
750,750,D6B662C0D72BBB94314A69A6BE13D66E,43761,18,23,5,32,47,1647
758,758,00C91B80C871DC21060F6574F41A1AD0,11631,0,8,8,12,49,649
759,759,00C91B80C871DC21060F6574F41A1AD0,40951,13,15,2,36,49,1849
760,760,00C91B80C871DC21060F6574F41A1AD0,40094,17,19,2,29,48,1498
761,761,00C91B80C871DC21060F6574F41A1AD0,11631,21,23,2,12,49,649
769,769,39E9477CFB7A739ED25E5621F7D2A965,10821,0,10,10,40,47,2047
770,770,39E9477CFB7A739ED25E5621F7D2A965,12571,14,19,5,48,39,2439
771,771,39E9477CFB7A739ED25E5621F7D2A965,42301,20,23,3,36,47,1847
783,783,EC2E4190CFDDB56DE2AFF479F9CFD055,15391,0,1,1,35,26,1776
784,784,EC2E4190CFDDB56DE2AFF479F9CFD055,15191,1,6,5,36,27,1827
785,785,EC2E4190CFDDB56DE2AFF479F9CFD055,12792,6,7,1,34,30,1730
786,786,EC2E4190CFDDB56DE2AFF479F9CFD055,15411,7,9,2,44,27,2227
787,787,EC2E4190CFDDB56DE2AFF479F9CFD055,15191,12,23,11,36,27,1827
788,788,43D5A4B21D49F330FF46E8A3E900BDBD,10721,0,7,7,31,48,1598
789,789,43D5A4B21D49F330FF46E8A3E900BDBD,11231,12,19,7,37,49,1899
790,790,43D5A4B21D49F330FF46E8A3E900BDBD,11431,20,21,1,29,47,1497
791,791,D5C29F54FD64D9CE1AEFE2D9CA4F33A5,13101,0,7,7,40,47,2047
792,792,D5C29F54FD64D9CE1AEFE2D9CA4F33A5,11806,9,11,2,41,48,2098
793,793,D5C29F54FD64D9CE1AEFE2D9CA4F33A5,13101,13,14,1,40,47,2047
794,794,D5C29F54FD64D9CE1AEFE2D9CA4F33A5,10591,14,16,2,39,48,1998
795,795,D5C29F54FD64D9CE1AEFE2D9CA4F33A5,11301,19,22,3,41,49,2099
796,796,360BDCD136FC688F810014C7E068DDA6,43761,6,14,8,32,47,1647
797,797,360BDCD136FC688F810014C7E068DDA6,10107,16,19,3,38,49,1949
798,798,360BDCD136FC688F810014C7E068DDA6,43761,20,22,2,32,47,1647
799,799,AC9A35D001464E087369411DD671E08D,42941,0,5,5,37,47,1897
800,800,AC9A35D001464E087369411DD671E08D,13481,7,10,3,26,31,1331
801,801,AC9A35D001464E087369411DD671E08D,42941,16,21,5,37,47,1897
802,802,AC9A35D001464E087369411DD671E08D,42301,21,23,2,36,47,1847
806,806,3AA7789035AB4DEC2E97E3010F171B32,42921,0,6,6,33,47,1697
807,807,3AA7789035AB4DEC2E97E3010F171B32,11021,13,20,7,36,49,1849
808,808,3AA7789035AB4DEC2E97E3010F171B32,43051,21,23,2,46,45,2345
812,812,2770DAF26F856B8C604C0FF1601A7902,12641,2,3,1,10,43,543
813,813,2770DAF26F856B8C604C0FF1601A7902,19181,5,9,4,8,40,440
814,814,2770DAF26F856B8C604C0FF1601A7902,12921,14,22,8,9,41,491
815,815,94DF6D416CC5B92A0E5062ABBAC5B786,12971,0,2,2,32,48,1648
816,816,94DF6D416CC5B92A0E5062ABBAC5B786,12514,5,6,1,38,47,1947
817,817,94DF6D416CC5B92A0E5062ABBAC5B786,42071,9,18,9,31,49,1599
818,818,60CFE6F39934A2741B2415485629B1BD,12211,0,1,1,41,44,2094
819,819,60CFE6F39934A2741B2415485629B1BD,10751,2,6,4,47,43,2393
820,820,60CFE6F39934A2741B2415485629B1BD,12211,7,13,6,41,44,2094
821,821,60CFE6F39934A2741B2415485629B1BD,13941,18,19,1,41,47,2097
822,822,FFF922208F67B5BD9EDED2D3A3D83727,43471,1,10,9,31,49,1599
823,823,FFF922208F67B5BD9EDED2D3A3D83727,40341,15,18,3,23,49,1199
824,824,FFF922208F67B5BD9EDED2D3A3D83727,43471,19,20,1,31,49,1599
825,825,FFF922208F67B5BD9EDED2D3A3D83727,40341,22,23,1,23,49,1199
826,826,09D4E4AC27B1C2BD71280354244F178D,11081,0,9,9,35,46,1796
827,827,09D4E4AC27B1C2BD71280354244F178D,42461,10,17,7,45,47,2297
828,828,09D4E4AC27B1C2BD71280354244F178D,11271,19,21,2,37,48,1898
829,829,09D4E4AC27B1C2BD71280354244F178D,11651,21,22,1,33,47,1697
830,830,2295C74F0BD2BB081A3FCDFFDED68B9C,12641,3,11,8,10,43,543
831,831,2295C74F0BD2BB081A3FCDFFDED68B9C,43021,12,13,1,16,43,843
832,832,2295C74F0BD2BB081A3FCDFFDED68B9C,12641,15,17,2,10,43,543
833,833,2295C74F0BD2BB081A3FCDFFDED68B9C,12921,20,21,1,9,41,491
834,834,89C5F5C036761FD2C32F64BC4CDE2E5B,19441,0,10,10,8,46,446
835,835,89C5F5C036761FD2C32F64BC4CDE2E5B,19024,13,14,1,9,45,495
836,836,89C5F5C036761FD2C32F64BC4CDE2E5B,13601,14,15,1,34,47,1747
837,837,89C5F5C036761FD2C32F64BC4CDE2E5B,11551,17,18,1,39,49,1999
838,838,89C5F5C036761FD2C32F64BC4CDE2E5B,12021,18,20,2,37,49,1899
839,839,705DFE0F0CF99753368D655C68C21E78,12221,1,2,1,43,44,2194
840,840,705DFE0F0CF99753368D655C68C21E78,12561,3,4,1,45,43,2293
841,841,705DFE0F0CF99753368D655C68C21E78,12221,4,6,2,43,44,2194
842,842,705DFE0F0CF99753368D655C68C21E78,12561,7,8,1,45,43,2293
843,843,705DFE0F0CF99753368D655C68C21E78,12221,10,23,13,43,44,2194
847,847,E111EB9E95CE72E91F7DBA6E9882DD11,43581,0,8,8,33,48,1698
848,848,E111EB9E95CE72E91F7DBA6E9882DD11,12584,15,18,3,24,48,1248
849,849,E111EB9E95CE72E91F7DBA6E9882DD11,43581,21,23,2,33,48,1698
858,858,7FFEC1E9277242F2E239475246D58946,13791,0,5,5,42,47,2147
859,859,7FFEC1E9277242F2E239475246D58946,10471,5,12,7,37,48,1898
860,860,7FFEC1E9277242F2E239475246D58946,40171,13,19,6,38,48,1948
861,861,7FFEC1E9277242F2E239475246D58946,13791,20,22,2,42,47,2147
862,862,4A775C6F9F7FED0E03EC3E2B16AE34C8,11324,1,6,5,31,46,1596
863,863,4A775C6F9F7FED0E03EC3E2B16AE34C8,11481,7,8,1,41,48,2098
864,864,4A775C6F9F7FED0E03EC3E2B16AE34C8,10721,11,18,7,31,48,1598
865,865,4A775C6F9F7FED0E03EC3E2B16AE34C8,11324,19,20,1,31,46,1596
886,886,7E2B090073D5B7202042DFCA26CF9DE6,42141,0,7,7,32,47,1647
887,887,7E2B090073D5B7202042DFCA26CF9DE6,10292,7,9,2,30,47,1547
888,888,7E2B090073D5B7202042DFCA26CF9DE6,42501,9,14,5,28,47,1447
889,889,7E2B090073D5B7202042DFCA26CF9DE6,10292,15,18,3,30,47,1547
890,890,7E2B090073D5B7202042DFCA26CF9DE6,40261,22,23,1,35,49,1799
891,891,DD295DE566AAA9C59DEFFE23B30C8780,10191,0,2,2,40,48,2048
892,892,DD295DE566AAA9C59DEFFE23B30C8780,12514,3,6,3,38,47,1947
893,893,DD295DE566AAA9C59DEFFE23B30C8780,41601,7,10,3,39,49,1999
894,894,DD295DE566AAA9C59DEFFE23B30C8780,10191,11,14,3,40,48,2048
895,895,DD295DE566AAA9C59DEFFE23B30C8780,10431,18,20,2,33,49,1699
896,896,5FCB5592966B4932B491E98CACBAAF37,40882,0,1,1,34,49,1749
897,897,5FCB5592966B4932B491E98CACBAAF37,10431,2,4,2,33,49,1699
898,898,5FCB5592966B4932B491E98CACBAAF37,40882,5,7,2,34,49,1749
899,899,5FCB5592966B4932B491E98CACBAAF37,11861,7,17,10,32,47,1647
900,900,5FCB5592966B4932B491E98CACBAAF37,40882,18,20,2,34,49,1749
901,901,5FCB5592966B4932B491E98CACBAAF37,10491,21,23,2,33,48,1698
902,902,1F899C425E1D44BC86781F60DDEF728E,43021,0,6,6,16,43,843
903,903,1F899C425E1D44BC86781F60DDEF728E,12921,7,19,12,9,41,491
904,904,1F899C425E1D44BC86781F60DDEF728E,43021,19,20,1,16,43,843
905,905,1F899C425E1D44BC86781F60DDEF728E,12921,21,22,1,9,41,491
906,906,B3E3F7F4BB39DF4D783E592F9F0BB965,10281,0,8,8,33,48,1698
907,907,B3E3F7F4BB39DF4D783E592F9F0BB965,43731,9,10,1,34,47,1747
908,908,B3E3F7F4BB39DF4D783E592F9F0BB965,42521,14,16,2,31,47,1597
909,909,B3E3F7F4BB39DF4D783E592F9F0BB965,10281,17,21,4,33,48,1698
910,910,B3E3F7F4BB39DF4D783E592F9F0BB965,11861,22,23,1,32,47,1647
918,918,0402782E5F21E7429EB7E07EFCF9314E,10301,0,8,8,31,45,1595
919,919,0402782E5F21E7429EB7E07EFCF9314E,12601,10,11,1,25,47,1297
920,920,0402782E5F21E7429EB7E07EFCF9314E,10301,13,15,2,31,45,1595
921,921,0402782E5F21E7429EB7E07EFCF9314E,12121,16,17,1,29,47,1497
922,922,0402782E5F21E7429EB7E07EFCF9314E,10061,20,21,1,20,46,1046
926,926,CDA1EB7B89E47C48A7CAC823B0773234,12661,0,9,9,32,45,1645
927,927,CDA1EB7B89E47C48A7CAC823B0773234,11541,10,12,2,35,49,1799
928,928,CDA1EB7B89E47C48A7CAC823B0773234,10221,12,14,2,34,49,1749
929,929,CDA1EB7B89E47C48A7CAC823B0773234,11751,22,23,1,35,48,1798
933,933,04DA073551B2B36368829872415CFF4C,10214,0,6,6,15,49,799
934,934,04DA073551B2B36368829872415CFF4C,19441,7,16,9,8,46,446
935,935,04DA073551B2B36368829872415CFF4C,10214,21,23,2,15,49,799
939,939,975688BDD7D3B41B53C460B57B5AC58A,42691,0,10,10,24,48,1248
940,940,975688BDD7D3B41B53C460B57B5AC58A,43751,12,14,2,19,48,998
941,941,975688BDD7D3B41B53C460B57B5AC58A,42691,17,18,1,24,48,1248
942,942,975688BDD7D3B41B53C460B57B5AC58A,43751,20,22,2,19,48,998
952,952,601A51EA671623E5E466F858B3908746,13231,0,9,9,39,46,1996
953,953,601A51EA671623E5E466F858B3908746,13651,13,15,2,30,47,1547
954,954,601A51EA671623E5E466F858B3908746,13231,18,22,4,39,46,1996
958,958,4DA21EF09DE00955AFF28F16D2698178,15391,0,3,3,35,26,1776
959,959,4DA21EF09DE00955AFF28F16D2698178,12792,7,10,3,34,30,1730
960,960,4DA21EF09DE00955AFF28F16D2698178,15661,13,18,5,36,26,1826
961,961,4DA21EF09DE00955AFF28F16D2698178,15391,19,21,2,35,26,1776
962,962,4DA21EF09DE00955AFF28F16D2698178,12792,22,23,1,34,30,1730
963,963,D159D7E2120F2A31F888B2ED598E06C3,13314,0,7,7,31,39,1589
964,964,D159D7E2120F2A31F888B2ED598E06C3,12521,8,11,3,35,41,1791
965,965,D159D7E2120F2A31F888B2ED598E06C3,13314,11,13,2,31,39,1589
966,966,D159D7E2120F2A31F888B2ED598E06C3,12521,13,16,3,35,41,1791
967,967,D159D7E2120F2A31F888B2ED598E06C3,13314,19,23,4,31,39,1589
968,968,1F49E26C341B3738FA1E54F232E557D3,11074,0,5,5,37,47,1897
969,969,1F49E26C341B3738FA1E54F232E557D3,11291,15,17,2,40,49,2049
970,970,1F49E26C341B3738FA1E54F232E557D3,42511,17,21,4,37,47,1897
981,981,FA6B5E90B9F0883F6243A19B217CFD71,13251,0,6,6,48,28,2428
982,982,FA6B5E90B9F0883F6243A19B217CFD71,10191,11,12,1,40,48,2048
983,983,FA6B5E90B9F0883F6243A19B217CFD71,40951,13,14,1,36,49,1849
984,984,FA6B5E90B9F0883F6243A19B217CFD71,10221,20,23,3,34,49,1749
985,985,8E40002F81F3E2D9E9A7BA534961DD21,19114,0,6,6,7,43,393
986,986,8E40002F81F3E2D9E9A7BA534961DD21,12601,10,11,1,25,47,1297
987,987,8E40002F81F3E2D9E9A7BA534961DD21,19114,12,18,6,7,43,393
988,988,69A2BE2C8E8C7C266144086560BD5BC9,15321,0,6,6,29,26,1476
989,989,69A2BE2C8E8C7C266144086560BD5BC9,43121,7,11,4,25,27,1277
990,990,69A2BE2C8E8C7C266144086560BD5BC9,15321,13,23,10,29,26,1476
991,991,7B34C273E34CE1CA5EC462EE747405EC,42031,0,7,7,40,46,2046
992,992,7B34C273E34CE1CA5EC462EE747405EC,49201,9,17,8,7,41,391
993,993,7B34C273E34CE1CA5EC462EE747405EC,19111,19,20,1,9,45,495
994,994,5FE1FAD559F6843700A0AA1D01D08561,13441,0,2,2,39,39,1989
995,995,5FE1FAD559F6843700A0AA1D01D08561,43011,2,5,3,40,42,2042
996,996,5FE1FAD559F6843700A0AA1D01D08561,13441,6,8,2,39,39,1989
997,997,5FE1FAD559F6843700A0AA1D01D08561,43011,9,15,6,40,42,2042
998,998,5FE1FAD559F6843700A0AA1D01D08561,13071,16,17,1,41,41,2091
999,999,5FE1FAD559F6843700A0AA1D01D08561,13441,17,18,1,39,39,1989
1000,1000,5FE1FAD559F6843700A0AA1D01D08561,13071,18,20,2,41,41,2091
1001,1001,5FE1FAD559F6843700A0AA1D01D08561,13441,21,22,1,39,39,1989
1002,1002,49A34F402FCE81DD1DBD6F44C81A6104,10971,0,9,9,35,47,1797
1003,1003,49A34F402FCE81DD1DBD6F44C81A6104,40951,12,15,3,36,49,1849
1004,1004,49A34F402FCE81DD1DBD6F44C81A6104,10971,16,17,1,35,47,1797
1005,1005,49A34F402FCE81DD1DBD6F44C81A6104,42941,17,19,2,37,47,1897
1006,1006,49A34F402FCE81DD1DBD6F44C81A6104,10971,21,23,2,35,47,1797
1016,1016,E3F3AF6F008B4C5B1C579511A05E6192,15391,6,9,3,35,26,1776
1017,1017,E3F3AF6F008B4C5B1C579511A05E6192,12792,11,17,6,34,30,1730
1018,1018,E3F3AF6F008B4C5B1C579511A05E6192,15391,18,19,1,35,26,1776
1019,1019,E3F3AF6F008B4C5B1C579511A05E6192,12792,21,23,2,34,30,1730
1020,1020,179C9FE89AB1A0E7249FE171F554F068,42523,0,7,7,31,47,1597
1021,1021,179C9FE89AB1A0E7249FE171F554F068,42381,10,12,2,39,41,1991
1022,1022,179C9FE89AB1A0E7249FE171F554F068,10341,13,23,10,31,47,1597
1023,1023,E3950B228FF57BC4F70CD2EC3D90B5FF,11941,0,8,8,37,46,1896
1024,1024,E3950B228FF57BC4F70CD2EC3D90B5FF,13711,9,10,1,38,46,1946
1025,1025,E3950B228FF57BC4F70CD2EC3D90B5FF,42151,11,13,2,35,45,1795
1026,1026,E3950B228FF57BC4F70CD2EC3D90B5FF,40691,14,15,1,42,48,2148
1027,1027,E3950B228FF57BC4F70CD2EC3D90B5FF,42151,16,18,2,35,45,1795
1028,1028,E3950B228FF57BC4F70CD2EC3D90B5FF,13711,19,20,1,38,46,1946
1029,1029,CD5F8D7604C7020A19DDE3C48998E9F5,12831,2,5,3,34,38,1738
1030,1030,CD5F8D7604C7020A19DDE3C48998E9F5,12521,6,8,2,35,41,1791
1031,1031,CD5F8D7604C7020A19DDE3C48998E9F5,13041,8,9,1,30,37,1537
1032,1032,CD5F8D7604C7020A19DDE3C48998E9F5,12521,9,12,3,35,41,1791
1033,1033,CD5F8D7604C7020A19DDE3C48998E9F5,13314,12,13,1,31,39,1589
1034,1034,CD5F8D7604C7020A19DDE3C48998E9F5,12521,14,18,4,35,41,1791
1035,1035,CD5F8D7604C7020A19DDE3C48998E9F5,13041,21,22,1,30,37,1537
1036,1036,57E38E75C3154FA28FE7B22CE29AF775,10107,1,13,12,38,49,1949
1037,1037,57E38E75C3154FA28FE7B22CE29AF775,42621,14,17,3,24,49,1249
1038,1038,57E38E75C3154FA28FE7B22CE29AF775,11151,18,22,4,30,48,1548
1042,1042,2FD7CB563CD330B8757D30F36F5DB42E,13111,0,8,8,42,46,2146
1043,1043,2FD7CB563CD330B8757D30F36F5DB42E,43951,8,10,2,49,41,2491
1044,1044,2FD7CB563CD330B8757D30F36F5DB42E,13111,13,16,3,42,46,2146
1045,1045,2FD7CB563CD330B8757D30F36F5DB42E,13951,20,22,2,47,45,2395
1053,1053,9951832C875ED15346443116F8C6A7D1,10331,0,8,8,39,46,1996
1054,1054,9951832C875ED15346443116F8C6A7D1,10191,8,10,2,40,48,2048
1055,1055,9951832C875ED15346443116F8C6A7D1,11921,10,11,1,38,48,1948
1056,1056,9951832C875ED15346443116F8C6A7D1,41601,11,13,2,39,49,1999
1057,1057,9951832C875ED15346443116F8C6A7D1,11921,14,15,1,38,48,1948
1058,1058,9951832C875ED15346443116F8C6A7D1,10811,20,23,3,38,46,1946
1066,1066,8E1DB9D4ECEC1F108A151A8D21BA1A04,42231,0,5,5,37,46,1896
1067,1067,8E1DB9D4ECEC1F108A151A8D21BA1A04,13911,5,9,4,39,46,1996
1068,1068,8E1DB9D4ECEC1F108A151A8D21BA1A04,42231,10,11,1,37,46,1896
1069,1069,8E1DB9D4ECEC1F108A151A8D21BA1A04,13911,15,16,1,39,46,1996
1070,1070,8E1DB9D4ECEC1F108A151A8D21BA1A04,42231,20,23,3,37,46,1896
1071,1071,1D750A272F60A85ED371A8258184C1BA,43061,0,10,10,43,46,2196
1072,1072,1D750A272F60A85ED371A8258184C1BA,40691,11,13,2,42,48,2148
1073,1073,1D750A272F60A85ED371A8258184C1BA,42201,13,14,1,43,46,2196
1074,1074,1D750A272F60A85ED371A8258184C1BA,11211,18,20,2,34,49,1749
1075,1075,1D750A272F60A85ED371A8258184C1BA,11541,20,22,2,35,49,1799
1076,1076,55BBC75385962FF803942CBCA7456F03,43751,0,6,6,19,48,998
1077,1077,55BBC75385962FF803942CBCA7456F03,42681,6,10,4,24,48,1248
1078,1078,55BBC75385962FF803942CBCA7456F03,43751,11,23,12,19,48,998
1079,1079,89AA8EF97A33EF0508FD3C292BDBEDE1,10431,0,9,9,33,49,1699
1080,1080,89AA8EF97A33EF0508FD3C292BDBEDE1,10107,11,12,1,38,49,1949
1081,1081,89AA8EF97A33EF0508FD3C292BDBEDE1,40341,13,16,3,23,49,1199
1082,1082,89AA8EF97A33EF0508FD3C292BDBEDE1,12131,16,17,1,32,47,1647
1083,1083,89AA8EF97A33EF0508FD3C292BDBEDE1,11171,18,21,3,33,48,1698
1084,1084,89AA8EF97A33EF0508FD3C292BDBEDE1,10431,22,23,1,33,49,1699
1085,1085,E68B00932BD6C763DC5F461B8F052E37,10251,0,8,8,35,47,1797
1086,1086,E68B00932BD6C763DC5F461B8F052E37,16211,12,13,1,4,3,203
1087,1087,E68B00932BD6C763DC5F461B8F052E37,16241,14,16,2,3,3,153
1088,1088,E68B00932BD6C763DC5F461B8F052E37,16184,17,20,3,1,1,51
1089,1089,E68B00932BD6C763DC5F461B8F052E37,16261,21,22,1,3,3,153
1090,1090,4B7092D05C3CD9127C6866294222B5BD,13071,6,8,2,41,41,2091
1091,1091,4B7092D05C3CD9127C6866294222B5BD,43051,11,15,4,46,45,2345
1092,1092,4B7092D05C3CD9127C6866294222B5BD,12561,15,16,1,45,43,2293
1093,1093,4B7092D05C3CD9127C6866294222B5BD,10221,18,20,2,34,49,1749
1094,1094,4B7092D05C3CD9127C6866294222B5BD,43051,21,23,2,46,45,2345
1095,1095,F4F868B9360D29EF169CCB1C386B42DC,12601,0,10,10,25,47,1297
1096,1096,F4F868B9360D29EF169CCB1C386B42DC,42291,11,12,1,29,48,1498
1097,1097,F4F868B9360D29EF169CCB1C386B42DC,12601,13,23,10,25,47,1297
1098,1098,BB9D5727CC0B529A73D48CE433191734,11861,0,11,11,32,47,1647
1099,1099,BB9D5727CC0B529A73D48CE433191734,10731,11,14,3,33,47,1697
1100,1100,BB9D5727CC0B529A73D48CE433191734,11491,15,17,2,36,47,1847
1101,1101,BB9D5727CC0B529A73D48CE433191734,43731,18,21,3,34,47,1747
1102,1102,BB9D5727CC0B529A73D48CE433191734,10251,22,23,1,35,47,1797
1103,1103,C2726A41F3A62761FF0F2054B8B1C32C,11061,1,2,1,29,48,1498
1104,1104,C2726A41F3A62761FF0F2054B8B1C32C,11201,3,13,10,35,49,1799
1105,1105,C2726A41F3A62761FF0F2054B8B1C32C,11381,15,18,3,30,47,1547
1106,1106,C2726A41F3A62761FF0F2054B8B1C32C,41101,21,23,2,32,48,1648
1128,1128,790457C5143568F0FC168A94781493E9,19114,0,5,5,7,43,393
1129,1129,790457C5143568F0FC168A94781493E9,12921,6,10,4,9,41,491
1130,1130,790457C5143568F0FC168A94781493E9,12641,11,13,2,10,43,543
1131,1131,790457C5143568F0FC168A94781493E9,12921,15,17,2,9,41,491
1132,1132,790457C5143568F0FC168A94781493E9,19114,18,20,2,7,43,393
1139,1139,D64DF2C2FAB80CB42859AD7194DBB705,11921,0,11,11,38,48,1948
1140,1140,D64DF2C2FAB80CB42859AD7194DBB705,40341,14,16,2,23,49,1199
1141,1141,D64DF2C2FAB80CB42859AD7194DBB705,42621,17,18,1,24,49,1249
1142,1142,D64DF2C2FAB80CB42859AD7194DBB705,11921,21,22,1,38,48,1948
1143,1143,65DD2A645A87F3CA0C9A291B8442571C,13441,0,6,6,39,39,1989
1144,1144,65DD2A645A87F3CA0C9A291B8442571C,12521,9,14,5,35,41,1791
1145,1145,65DD2A645A87F3CA0C9A291B8442571C,13441,18,19,1,39,39,1989
1149,1149,A00BC5B5000B986C70EA1A50458DBEB0,43241,0,7,7,36,46,1846
1150,1150,A00BC5B5000B986C70EA1A50458DBEB0,42271,8,9,1,40,47,2047
1151,1151,A00BC5B5000B986C70EA1A50458DBEB0,42281,10,11,1,40,48,2048
1152,1152,A00BC5B5000B986C70EA1A50458DBEB0,11806,16,17,1,41,48,2098
1153,1153,A00BC5B5000B986C70EA1A50458DBEB0,13121,20,22,2,38,46,1946
1154,1154,A4FB94489FDF267071B531D740AF8A43,42401,0,9,9,36,47,1847
1155,1155,A4FB94489FDF267071B531D740AF8A43,10501,12,13,1,22,46,1146
1156,1156,A4FB94489FDF267071B531D740AF8A43,40341,14,17,3,23,49,1199
1157,1157,A4FB94489FDF267071B531D740AF8A43,42301,20,23,3,36,47,1847
1158,1158,F7A01C0C2D7C70FD8B57D216EF0464EE,13371,0,8,8,41,47,2097
1159,1159,F7A01C0C2D7C70FD8B57D216EF0464EE,42161,9,17,8,36,47,1847
1160,1160,F7A01C0C2D7C70FD8B57D216EF0464EE,13371,21,23,2,41,47,2097
1191,1191,D5204D56FD9ED613A2BC70F1D9D554B7,11701,1,8,7,43,48,2198
1192,1192,D5204D56FD9ED613A2BC70F1D9D554B7,42021,12,16,4,33,47,1697
1193,1193,D5204D56FD9ED613A2BC70F1D9D554B7,19441,20,22,2,8,46,446
1194,1194,BC71A128CC1D1FD204F1FA3A371EA53A,43021,0,6,6,16,43,843
1195,1195,BC71A128CC1D1FD204F1FA3A371EA53A,12921,6,11,5,9,41,491
1196,1196,BC71A128CC1D1FD204F1FA3A371EA53A,43021,12,13,1,16,43,843
1197,1197,BC71A128CC1D1FD204F1FA3A371EA53A,12921,15,18,3,9,41,491
1198,1198,BC71A128CC1D1FD204F1FA3A371EA53A,43021,19,23,4,16,43,843
1199,1199,1B550A18B0397F926248F9A2C7B0A9DE,10921,1,8,7,43,48,2198
1200,1200,1B550A18B0397F926248F9A2C7B0A9DE,10411,15,17,2,36,48,1848
1201,1201,1B550A18B0397F926248F9A2C7B0A9DE,42341,18,23,5,43,49,2199
1208,1208,5AF7A250F769DD424B6F153B49B360AA,10901,0,7,7,35,48,1798
1209,1209,5AF7A250F769DD424B6F153B49B360AA,12601,9,12,3,25,47,1297
1210,1210,5AF7A250F769DD424B6F153B49B360AA,10901,17,23,6,35,48,1798
1211,1211,A8B9B56D11151A486AB04AC310F20A5D,42231,0,7,7,37,46,1896
1212,1212,A8B9B56D11151A486AB04AC310F20A5D,11861,8,11,3,32,47,1647
1213,1213,A8B9B56D11151A486AB04AC310F20A5D,42231,12,16,4,37,46,1896
1214,1214,A8B9B56D11151A486AB04AC310F20A5D,11861,17,18,1,32,47,1647
1215,1215,A8B9B56D11151A486AB04AC310F20A5D,42231,21,23,2,37,46,1896
1216,1216,F4415BF40021B32E97A34E5D78C19455,10801,0,6,6,42,47,2147
1217,1217,F4415BF40021B32E97A34E5D78C19455,13711,9,10,1,38,46,1946
1218,1218,F4415BF40021B32E97A34E5D78C19455,11331,11,13,2,37,48,1898
1219,1219,F4415BF40021B32E97A34E5D78C19455,11521,18,19,1,41,48,2098
1220,1220,C5FAF90C34968999A63CFDAD0562DDBD,10841,0,7,7,37,47,1897
1221,1221,C5FAF90C34968999A63CFDAD0562DDBD,43731,8,10,2,34,47,1747
1222,1222,C5FAF90C34968999A63CFDAD0562DDBD,10841,11,12,1,37,47,1897
1223,1223,C5FAF90C34968999A63CFDAD0562DDBD,43731,13,15,2,34,47,1747
1224,1224,C5FAF90C34968999A63CFDAD0562DDBD,11201,18,20,2,35,49,1799
1225,1225,BFAE23973D1D12AA72304A85BCFE3A0D,42151,0,1,1,35,45,1795
1226,1226,BFAE23973D1D12AA72304A85BCFE3A0D,13671,2,12,10,27,43,1393
1227,1227,BFAE23973D1D12AA72304A85BCFE3A0D,11381,14,16,2,30,47,1547
1228,1228,BFAE23973D1D12AA72304A85BCFE3A0D,11861,21,22,1,32,47,1647
1229,1229,AED0ED039F466570C62D264F2A529145,43041,0,8,8,41,46,2096
1230,1230,AED0ED039F466570C62D264F2A529145,10211,9,10,1,16,49,849
1231,1231,AED0ED039F466570C62D264F2A529145,43061,12,14,2,43,46,2196
1232,1232,AED0ED039F466570C62D264F2A529145,43751,16,17,1,19,48,998
1233,1233,AED0ED039F466570C62D264F2A529145,43041,18,23,5,41,46,2096
1234,1234,F5CAB8F803ECE6BB91E5E9B3677179B2,11731,0,1,1,36,48,1848
1235,1235,F5CAB8F803ECE6BB91E5E9B3677179B2,42301,2,8,6,36,47,1847
1236,1236,F5CAB8F803ECE6BB91E5E9B3677179B2,10111,11,16,5,37,47,1897
1237,1237,F5CAB8F803ECE6BB91E5E9B3677179B2,43341,19,21,2,41,46,2096
1238,1238,F5CAB8F803ECE6BB91E5E9B3677179B2,13381,21,23,2,39,47,1997
1243,1243,AF85AB0F84B58F4A12483525349C1572,43121,0,5,5,25,27,1277
1244,1244,AF85AB0F84B58F4A12483525349C1572,15191,8,11,3,36,27,1827
1245,1245,AF85AB0F84B58F4A12483525349C1572,43121,11,14,3,25,27,1277
1246,1246,AF85AB0F84B58F4A12483525349C1572,15191,15,19,4,36,27,1827
1247,1247,AF85AB0F84B58F4A12483525349C1572,43121,22,23,1,25,27,1277
1251,1251,1788FF83230593384DFEF88881720D90,13551,0,9,9,45,38,2288
1252,1252,1788FF83230593384DFEF88881720D90,43101,10,12,2,46,40,2340
1253,1253,1788FF83230593384DFEF88881720D90,13551,13,15,2,45,38,2288
1254,1254,1788FF83230593384DFEF88881720D90,43101,16,21,5,46,40,2340
1255,1255,1788FF83230593384DFEF88881720D90,13551,21,23,2,45,38,2288
1256,1256,6A374E00137D245879D87467BBBF649C,12311,0,1,1,30,44,1544
1257,1257,6A374E00137D245879D87467BBBF649C,42871,1,7,6,30,45,1545
1258,1258,6A374E00137D245879D87467BBBF649C,10611,10,19,9,32,48,1648
1259,1259,6A374E00137D245879D87467BBBF649C,12661,20,21,1,32,45,1645
1267,1267,895178A7C4631A70E81256690FBFBF91,11331,0,5,5,37,48,1898
1268,1268,895178A7C4631A70E81256690FBFBF91,42091,9,16,7,43,46,2196
1269,1269,895178A7C4631A70E81256690FBFBF91,13371,19,21,2,41,47,2097
1270,1270,8AAB69D996EBB24431643CD2E8734388,43061,0,8,8,43,46,2196
1271,1271,8AAB69D996EBB24431643CD2E8734388,11381,9,11,2,30,47,1547
1272,1272,8AAB69D996EBB24431643CD2E8734388,11061,12,15,3,29,48,1498
1273,1273,8AAB69D996EBB24431643CD2E8734388,43971,17,20,3,30,48,1548
1274,1274,4D4E482DE77E19D1B2EC549782E6CF3D,10161,0,2,2,35,49,1799
1275,1275,4D4E482DE77E19D1B2EC549782E6CF3D,40055,2,8,6,31,49,1599
1276,1276,4D4E482DE77E19D1B2EC549782E6CF3D,12601,11,12,1,25,47,1297
1277,1277,4D4E482DE77E19D1B2EC549782E6CF3D,40055,17,18,1,31,49,1599
1278,1278,4D4E482DE77E19D1B2EC549782E6CF3D,10161,20,21,1,35,49,1799
1279,1279,A54E2D91DE43C921227859DCF122BDAD,42501,0,3,3,28,47,1447
1280,1280,A54E2D91DE43C921227859DCF122BDAD,10171,6,7,1,26,47,1347
1281,1281,A54E2D91DE43C921227859DCF122BDAD,10511,10,11,1,35,46,1796
1282,1282,A54E2D91DE43C921227859DCF122BDAD,10151,12,13,1,34,47,1747
1283,1283,A54E2D91DE43C921227859DCF122BDAD,40637,13,16,3,36,47,1847
1284,1284,A54E2D91DE43C921227859DCF122BDAD,10531,17,18,1,34,46,1746
1285,1285,A54E2D91DE43C921227859DCF122BDAD,42501,22,23,1,28,47,1447
1286,1286,D3EF141BDC81929D7A3D2C86A2B15366,15411,5,11,6,44,27,2227
1287,1287,D3EF141BDC81929D7A3D2C86A2B15366,12611,11,14,3,41,29,2079
1288,1288,D3EF141BDC81929D7A3D2C86A2B15366,15411,14,19,5,44,27,2227
1292,1292,0EC1D2502267B7D6F36C8EA9D8EC3DDA,10171,0,8,8,26,47,1347
1293,1293,0EC1D2502267B7D6F36C8EA9D8EC3DDA,11001,11,17,6,42,47,2147
1294,1294,0EC1D2502267B7D6F36C8EA9D8EC3DDA,10171,20,23,3,26,47,1347
1295,1295,296F38404D3B270043D5A0AC41012D74,10411,0,2,2,36,48,1848
1296,1296,296F38404D3B270043D5A0AC41012D74,11271,2,14,12,37,48,1898
1297,1297,296F38404D3B270043D5A0AC41012D74,40341,16,20,4,23,49,1199
1302,1302,586F3AD64B483C4FDBF6963F85B66D9A,11481,0,8,8,41,48,2098
1303,1303,586F3AD64B483C4FDBF6963F85B66D9A,11381,9,10,1,30,47,1547
1304,1304,586F3AD64B483C4FDBF6963F85B66D9A,11481,11,23,12,41,48,2098
1308,1308,CC641F0BEEAF913DA1AE8ACC2C85589D,13511,0,7,7,34,48,1748
1309,1309,CC641F0BEEAF913DA1AE8ACC2C85589D,10501,10,12,2,22,46,1146
1310,1310,CC641F0BEEAF913DA1AE8ACC2C85589D,40951,13,14,1,36,49,1849
1311,1311,CC641F0BEEAF913DA1AE8ACC2C85589D,13511,15,17,2,34,48,1748
1312,1312,CC641F0BEEAF913DA1AE8ACC2C85589D,13951,18,20,2,47,45,2395
1313,1313,CC641F0BEEAF913DA1AE8ACC2C85589D,13511,21,23,2,34,48,1748
1317,1317,A53DAA006542212C0F792E33874BF547,10231,1,3,2,39,49,1999
1318,1318,A53DAA006542212C0F792E33874BF547,42801,3,8,5,40,49,2049
1319,1319,A53DAA006542212C0F792E33874BF547,43161,10,14,4,35,47,1797
1320,1320,A53DAA006542212C0F792E33874BF547,11291,15,16,1,40,49,2049
1321,1321,A53DAA006542212C0F792E33874BF547,10781,16,19,3,35,47,1797
1322,1322,B8627A46DE68E9C2A1E6A2CBF3FCB1C4,11074,0,12,12,37,47,1897
1323,1323,B8627A46DE68E9C2A1E6A2CBF3FCB1C4,40341,14,18,4,23,49,1199
1324,1324,B8627A46DE68E9C2A1E6A2CBF3FCB1C4,11074,20,21,1,37,47,1897
1325,1325,38972EDB30F90372204B09C9E02BB849,15661,0,11,11,36,26,1826
1326,1326,38972EDB30F90372204B09C9E02BB849,40341,14,16,2,23,49,1199
1327,1327,38972EDB30F90372204B09C9E02BB849,11061,20,23,3,29,48,1498
1332,1332,1B6F3845CF9B33669E95093F20B19BF3,15661,0,3,3,36,26,1826
1333,1333,1B6F3845CF9B33669E95093F20B19BF3,15191,5,7,2,36,27,1827
1334,1334,1B6F3845CF9B33669E95093F20B19BF3,15661,8,9,1,36,26,1826
1335,1335,1B6F3845CF9B33669E95093F20B19BF3,10251,11,20,9,35,47,1797
1336,1336,1B6F3845CF9B33669E95093F20B19BF3,15661,21,22,1,36,26,1826
1340,1340,D1B134FECA3DB6C7BE84FCB03A2CF8F7,10661,0,9,9,37,49,1899
1341,1341,D1B134FECA3DB6C7BE84FCB03A2CF8F7,16151,13,15,2,13,11,661
1342,1342,D1B134FECA3DB6C7BE84FCB03A2CF8F7,42511,17,18,1,37,47,1897
1343,1343,D1B134FECA3DB6C7BE84FCB03A2CF8F7,42071,18,21,3,31,49,1599
1344,1344,D1B134FECA3DB6C7BE84FCB03A2CF8F7,10661,22,23,1,37,49,1899
1352,1352,906075D6233195F1F9099F6FBB81286D,11861,0,6,6,32,47,1647
1353,1353,906075D6233195F1F9099F6FBB81286D,11481,9,11,2,41,48,2098
1354,1354,906075D6233195F1F9099F6FBB81286D,10341,15,16,1,31,47,1597
1355,1355,906075D6233195F1F9099F6FBB81286D,43761,19,21,2,32,47,1647
1356,1356,50933B0C1EFBC39FDACBBA6BAFD901F2,15391,0,3,3,35,26,1776
1357,1357,50933B0C1EFBC39FDACBBA6BAFD901F2,12792,4,7,3,34,30,1730
1358,1358,50933B0C1EFBC39FDACBBA6BAFD901F2,15391,7,11,4,35,26,1776
1359,1359,50933B0C1EFBC39FDACBBA6BAFD901F2,15661,12,16,4,36,26,1826
1360,1360,50933B0C1EFBC39FDACBBA6BAFD901F2,15391,20,23,3,35,26,1776
1365,1365,E70BF879B017F8D0E478B68B605173BC,42231,2,4,2,37,46,1896
1366,1366,E70BF879B017F8D0E478B68B605173BC,13251,9,10,1,48,28,2428
1367,1367,E70BF879B017F8D0E478B68B605173BC,13711,14,21,7,38,46,1946
1368,1368,E70BF879B017F8D0E478B68B605173BC,40261,22,23,1,35,49,1799
1372,1372,3E98933C589157FCDDD2AEF7643E6F5D,12083,0,1,1,36,49,1849
1373,1373,3E98933C589157FCDDD2AEF7643E6F5D,42961,3,5,2,35,49,1799
1374,1374,3E98933C589157FCDDD2AEF7643E6F5D,11231,7,8,1,37,49,1899
1375,1375,3E98933C589157FCDDD2AEF7643E6F5D,10121,9,13,4,36,49,1849
1376,1376,3E98933C589157FCDDD2AEF7643E6F5D,42961,14,17,3,35,49,1799
1377,1377,3E98933C589157FCDDD2AEF7643E6F5D,10121,21,22,1,36,49,1849
1378,1378,B855E84BF722A366F6E79AEB62045285,10271,0,7,7,37,46,1896
1379,1379,B855E84BF722A366F6E79AEB62045285,13121,8,10,2,38,46,1946
1380,1380,B855E84BF722A366F6E79AEB62045285,10271,10,15,5,37,46,1896
1381,1381,B855E84BF722A366F6E79AEB62045285,13711,17,18,1,38,46,1946
1382,1382,B855E84BF722A366F6E79AEB62045285,10821,21,23,2,40,47,2047
1383,1383,FA215D037E3ED3281544DD70764B37AD,11021,0,7,7,36,49,1849
1384,1384,FA215D037E3ED3281544DD70764B37AD,10531,10,11,1,34,46,1746
1385,1385,FA215D037E3ED3281544DD70764B37AD,11021,16,23,7,36,49,1849
1386,1386,2F749DF3B0CEC4E6F0FC2DDD85B13162,13221,0,11,11,40,47,2047
1387,1387,2F749DF3B0CEC4E6F0FC2DDD85B13162,11381,13,16,3,30,47,1547
1388,1388,2F749DF3B0CEC4E6F0FC2DDD85B13162,11631,20,23,3,12,49,649
1389,1389,C7B2C2AE2DF954A69981F5A4F94159CA,42151,1,7,6,35,45,1795
1390,1390,C7B2C2AE2DF954A69981F5A4F94159CA,13671,8,9,1,27,43,1393
1391,1391,C7B2C2AE2DF954A69981F5A4F94159CA,42351,11,13,2,38,45,1945
1392,1392,C7B2C2AE2DF954A69981F5A4F94159CA,13671,14,17,3,27,43,1393
1393,1393,C7B2C2AE2DF954A69981F5A4F94159CA,42351,18,21,3,38,45,1945
1394,1394,C7B2C2AE2DF954A69981F5A4F94159CA,11261,21,22,1,36,46,1846
1398,1398,922F428483332F7C93907B784665E98A,12311,0,8,8,30,44,1544
1399,1399,922F428483332F7C93907B784665E98A,40341,14,16,2,23,49,1199
1400,1400,922F428483332F7C93907B784665E98A,12311,22,23,1,30,44,1544
1401,1401,C242AD7A1BE8FEA8853CCDF59C1941FF,10801,0,1,1,42,47,2147
1402,1402,C242AD7A1BE8FEA8853CCDF59C1941FF,10841,2,13,11,37,47,1897
1403,1403,C242AD7A1BE8FEA8853CCDF59C1941FF,13941,15,18,3,41,47,2097
1404,1404,C242AD7A1BE8FEA8853CCDF59C1941FF,12151,19,21,2,41,33,2083
1408,1408,70E36A4B82878626B569C66E46C7827C,11271,0,2,2,37,48,1898
1409,1409,70E36A4B82878626B569C66E46C7827C,11731,2,4,2,36,48,1848
1410,1410,70E36A4B82878626B569C66E46C7827C,42961,5,8,3,35,49,1799
1411,1411,70E36A4B82878626B569C66E46C7827C,12521,15,16,1,35,41,1791
1412,1412,70E36A4B82878626B569C66E46C7827C,42961,20,21,1,35,49,1799
1413,1413,70E36A4B82878626B569C66E46C7827C,43161,22,23,1,35,47,1797
1414,1414,7A0B4F3CB6766242F70774B1FFE5DFB8,11541,0,15,15,35,49,1799
1415,1415,7A0B4F3CB6766242F70774B1FFE5DFB8,40341,16,18,2,23,49,1199
1416,1416,7A0B4F3CB6766242F70774B1FFE5DFB8,40611,19,21,2,35,47,1797
1417,1417,891D05F5E4245C44547035C2001A9429,11211,10,11,1,34,49,1749
1418,1418,891D05F5E4245C44547035C2001A9429,40341,12,16,4,23,49,1199
1419,1419,891D05F5E4245C44547035C2001A9429,11021,20,23,3,36,49,1849
1433,1433,A7D513AF501AE69E3238D68C3958B4B4,43061,0,9,9,43,46,2196
1434,1434,A7D513AF501AE69E3238D68C3958B4B4,10811,10,20,10,38,46,1946
1435,1435,A7D513AF501AE69E3238D68C3958B4B4,42621,20,21,1,24,49,1249
1436,1436,AA287F8A16E3C6D2A36C9A5BC3AEF07D,11061,2,3,1,29,48,1498
1437,1437,AA287F8A16E3C6D2A36C9A5BC3AEF07D,42831,3,4,1,27,48,1398
1438,1438,AA287F8A16E3C6D2A36C9A5BC3AEF07D,11061,5,13,8,29,48,1498
1439,1439,AA287F8A16E3C6D2A36C9A5BC3AEF07D,11381,14,16,2,30,47,1547
1440,1440,AA287F8A16E3C6D2A36C9A5BC3AEF07D,11061,18,23,5,29,48,1498
1444,1444,E9DAAA2EB4F2385F16C3D2B77BA49D0B,13711,0,1,1,38,46,1946
1445,1445,E9DAAA2EB4F2385F16C3D2B77BA49D0B,42231,2,6,4,37,46,1896
1446,1446,E9DAAA2EB4F2385F16C3D2B77BA49D0B,13711,6,8,2,38,46,1946
1447,1447,E9DAAA2EB4F2385F16C3D2B77BA49D0B,42231,14,15,1,37,46,1896
1448,1448,E9DAAA2EB4F2385F16C3D2B77BA49D0B,13711,17,22,5,38,46,1946
1452,1452,5E6AB6B686A00A7ED3B8EAE75C21937D,42864,1,7,6,38,44,1944
1453,1453,5E6AB6B686A00A7ED3B8EAE75C21937D,11261,10,12,2,36,46,1846
1454,1454,5E6AB6B686A00A7ED3B8EAE75C21937D,42864,12,15,3,38,44,1944
1455,1455,5E6AB6B686A00A7ED3B8EAE75C21937D,11261,17,18,1,36,46,1846
1456,1456,5E6AB6B686A00A7ED3B8EAE75C21937D,11074,19,21,2,37,47,1897
1457,1457,5E6AB6B686A00A7ED3B8EAE75C21937D,11261,22,23,1,36,46,1846
1458,1458,2C3A1C890B30FB06A95DD4A9EF742265,19801,0,13,13,19,26,976
1459,1459,2C3A1C890B30FB06A95DD4A9EF742265,43121,13,15,2,25,27,1277
1460,1460,2C3A1C890B30FB06A95DD4A9EF742265,19801,15,18,3,19,26,976
1461,1461,2C3A1C890B30FB06A95DD4A9EF742265,43121,18,21,3,25,27,1277
1468,1468,A2EA2AB82A45207E1BCB502B97AEA982,10381,0,9,9,31,49,1599
1469,1469,A2EA2AB82A45207E1BCB502B97AEA982,10161,9,11,2,35,49,1799
1470,1470,A2EA2AB82A45207E1BCB502B97AEA982,11011,13,17,4,39,49,1999
1471,1471,A2EA2AB82A45207E1BCB502B97AEA982,10381,19,22,3,31,49,1599
1472,1472,A5A090591E63A367211B3058D6F881BC,12921,1,8,7,9,41,491
1473,1473,A5A090591E63A367211B3058D6F881BC,43021,13,16,3,16,43,843
1474,1474,A5A090591E63A367211B3058D6F881BC,12921,18,21,3,9,41,491
1478,1478,6657340E3E8EAFBE8630D734C7DFAA0A,19181,0,7,7,8,40,440
1479,1479,6657340E3E8EAFBE8630D734C7DFAA0A,19021,9,17,8,10,45,545
1480,1480,6657340E3E8EAFBE8630D734C7DFAA0A,19821,19,20,1,4,46,246
1481,1481,FC0CD45324135074215FA2F4C233A757,11151,0,9,9,30,48,1548
1482,1482,FC0CD45324135074215FA2F4C233A757,40341,14,16,2,23,49,1199
1483,1483,FC0CD45324135074215FA2F4C233A757,11061,16,22,6,29,48,1498
1494,1494,1C9EFFB1F74C70AE7732B9E5A532D9DE,42471,0,10,10,35,49,1799
1495,1495,1C9EFFB1F74C70AE7732B9E5A532D9DE,40341,11,16,5,23,49,1199
1496,1496,1C9EFFB1F74C70AE7732B9E5A532D9DE,11541,16,19,3,35,49,1799
1497,1497,1C9EFFB1F74C70AE7732B9E5A532D9DE,11631,20,23,3,12,49,649
1498,1498,C5AC3744EA191771220A3FE471A7FACC,42161,0,7,7,36,47,1847
1499,1499,C5AC3744EA191771220A3FE471A7FACC,19024,8,17,9,9,45,495
1500,1500,C5AC3744EA191771220A3FE471A7FACC,42161,19,23,4,36,47,1847
1501,1501,177791B1BD9F9F1A23D0B9EF068F9A10,10281,1,6,5,33,48,1698
1502,1502,177791B1BD9F9F1A23D0B9EF068F9A10,11161,6,8,2,32,48,1648
1503,1503,177791B1BD9F9F1A23D0B9EF068F9A10,10281,11,13,2,33,48,1698
1504,1504,177791B1BD9F9F1A23D0B9EF068F9A10,11861,17,18,1,32,47,1647
1505,1505,177791B1BD9F9F1A23D0B9EF068F9A10,11161,19,20,1,32,48,1648
1506,1506,75219378BBB10FFE07C7301517B53FE1,11806,0,4,4,41,48,2098
1507,1507,75219378BBB10FFE07C7301517B53FE1,42271,4,15,11,40,47,2047
1508,1508,75219378BBB10FFE07C7301517B53FE1,11074,17,22,5,37,47,1897
1509,1509,302A21F756E231005359926361A27DCA,11001,0,6,6,42,47,2147
1510,1510,302A21F756E231005359926361A27DCA,12521,7,9,2,35,41,1791
1511,1511,302A21F756E231005359926361A27DCA,10801,18,19,1,42,47,2147
1512,1512,6C7DE4B4696563CBDA9D3C6E4FCAB652,42523,1,8,7,31,47,1597
1513,1513,6C7DE4B4696563CBDA9D3C6E4FCAB652,10292,9,10,1,30,47,1547
1514,1514,6C7DE4B4696563CBDA9D3C6E4FCAB652,42521,12,13,1,31,47,1597
1515,1515,6C7DE4B4696563CBDA9D3C6E4FCAB652,10292,13,15,2,30,47,1547
1516,1516,6C7DE4B4696563CBDA9D3C6E4FCAB652,10341,16,20,4,31,47,1597
1520,1520,4FA50ACEDD30F1F921CEE6F85693AFFB,42161,0,6,6,36,47,1847
1521,1521,4FA50ACEDD30F1F921CEE6F85693AFFB,10111,6,8,2,37,47,1897
1522,1522,4FA50ACEDD30F1F921CEE6F85693AFFB,10471,11,13,2,37,48,1898
1523,1523,4FA50ACEDD30F1F921CEE6F85693AFFB,10251,18,19,1,35,47,1797
1524,1524,4FA50ACEDD30F1F921CEE6F85693AFFB,42161,20,22,2,36,47,1847
1525,1525,A847C99BCF3FA2F2462B28662C04DEC1,15143,1,10,9,18,7,907
1526,1526,A847C99BCF3FA2F2462B28662C04DEC1,15661,13,15,2,36,26,1826
1527,1527,A847C99BCF3FA2F2462B28662C04DEC1,15191,19,20,1,36,27,1827
1531,1531,36BD94283960F3FA7F12C7E16BBE1044,11571,0,3,3,13,46,696
1532,1532,36BD94283960F3FA7F12C7E16BBE1044,42041,3,13,10,10,47,547
1533,1533,36BD94283960F3FA7F12C7E16BBE1044,19441,14,17,3,8,46,446
1534,1534,36BD94283960F3FA7F12C7E16BBE1044,42041,18,21,3,10,47,547
1544,1544,D66DDB1AF696D6DDB044E124EA6B793E,43311,0,3,3,31,48,1598
1545,1545,D66DDB1AF696D6DDB044E124EA6B793E,13941,4,14,10,41,47,2097
1546,1546,D66DDB1AF696D6DDB044E124EA6B793E,11771,18,21,3,39,49,1999
1547,1547,34F6BCC7F351376FAC374AF22AADC0FB,10716,0,8,8,30,46,1546
1548,1548,34F6BCC7F351376FAC374AF22AADC0FB,10471,11,16,5,37,48,1898
1549,1549,34F6BCC7F351376FAC374AF22AADC0FB,10107,20,21,1,38,49,1949
1550,1550,EE1248EF56B7A594536EA1F6FA619381,42161,1,2,1,36,47,1847
1551,1551,EE1248EF56B7A594536EA1F6FA619381,13561,4,6,2,37,49,1899
1552,1552,EE1248EF56B7A594536EA1F6FA619381,11751,6,13,7,35,48,1798
1553,1553,EE1248EF56B7A594536EA1F6FA619381,40341,22,23,1,23,49,1199
1557,1557,6FABDBFAF0AF1E3F7BEFD8EAEFD476CB,10251,0,7,7,35,47,1797
1558,1558,6FABDBFAF0AF1E3F7BEFD8EAEFD476CB,42351,9,11,2,38,45,1945
1559,1559,6FABDBFAF0AF1E3F7BEFD8EAEFD476CB,42231,11,12,1,37,46,1896
1560,1560,6FABDBFAF0AF1E3F7BEFD8EAEFD476CB,13911,12,14,2,39,46,1996
1561,1561,6FABDBFAF0AF1E3F7BEFD8EAEFD476CB,42231,16,19,3,37,46,1896
1562,1562,6FABDBFAF0AF1E3F7BEFD8EAEFD476CB,11201,20,23,3,35,49,1799
1563,1563,878DD44EE8FA6A43A619DDA4A892D760,11806,4,5,1,41,48,2098
1564,1564,878DD44EE8FA6A43A619DDA4A892D760,42271,10,12,2,40,47,2047
1565,1565,878DD44EE8FA6A43A619DDA4A892D760,11806,14,15,1,41,48,2098
1566,1566,878DD44EE8FA6A43A619DDA4A892D760,42271,15,17,2,40,47,2047
1567,1567,878DD44EE8FA6A43A619DDA4A892D760,11806,22,23,1,41,48,2098
1568,1568,566A98F570A1628E8F6EFD9CFCC9370E,12491,0,6,6,36,43,1843
1569,1569,566A98F570A1628E8F6EFD9CFCC9370E,19264,11,15,4,10,36,536
1570,1570,566A98F570A1628E8F6EFD9CFCC9370E,12661,18,20,2,32,45,1645
1575,1575,734BE21864A3611A04F28278A72C8D0B,42151,0,5,5,35,45,1795
1576,1576,734BE21864A3611A04F28278A72C8D0B,13461,7,9,2,39,44,1994
1577,1577,734BE21864A3611A04F28278A72C8D0B,42151,9,12,3,35,45,1795
1578,1578,734BE21864A3611A04F28278A72C8D0B,42031,14,16,2,40,46,2046
1579,1579,734BE21864A3611A04F28278A72C8D0B,42151,17,21,4,35,45,1795
1580,1580,8B6448FD7DB9F8E2F8F73AFDDD5BFD38,19021,0,2,2,10,45,545
1581,1581,8B6448FD7DB9F8E2F8F73AFDDD5BFD38,43021,2,5,3,16,43,843
1582,1582,8B6448FD7DB9F8E2F8F73AFDDD5BFD38,12921,6,18,12,9,41,491
1583,1583,8B6448FD7DB9F8E2F8F73AFDDD5BFD38,12641,18,19,1,10,43,543
1584,1584,BA02C3BCEE7A48A5C905C95BDC29D4FD,12792,6,11,5,34,30,1730
1585,1585,BA02C3BCEE7A48A5C905C95BDC29D4FD,15391,11,13,2,35,26,1776
1586,1586,BA02C3BCEE7A48A5C905C95BDC29D4FD,12792,16,18,2,34,30,1730
1587,1587,BA02C3BCEE7A48A5C905C95BDC29D4FD,15391,19,23,4,35,26,1776
1588,1588,8ACC50A8C55036CCB5F5CED9121C61C8,12792,1,3,2,34,30,1730
1589,1589,8ACC50A8C55036CCB5F5CED9121C61C8,15191,5,8,3,36,27,1827
1590,1590,8ACC50A8C55036CCB5F5CED9121C61C8,12792,8,9,1,34,30,1730
1591,1591,8ACC50A8C55036CCB5F5CED9121C61C8,12791,11,13,2,31,29,1579
1592,1592,8ACC50A8C55036CCB5F5CED9121C61C8,15191,14,20,6,36,27,1827
1593,1593,8ACC50A8C55036CCB5F5CED9121C61C8,12791,21,22,1,31,29,1579
1597,1597,CE83884CFD17B5073DAD15A75E54F414,12521,0,12,12,35,41,1791
1598,1598,CE83884CFD17B5073DAD15A75E54F414,11231,13,16,3,37,49,1899
1599,1599,CE83884CFD17B5073DAD15A75E54F414,12521,20,21,1,35,41,1791
1600,1600,82F56B09E86EBDC3CC6E0A02A6F030B6,42121,0,2,2,26,49,1349
1601,1601,82F56B09E86EBDC3CC6E0A02A6F030B6,10451,3,5,2,25,48,1298
1602,1602,82F56B09E86EBDC3CC6E0A02A6F030B6,42121,5,7,2,26,49,1349
1603,1603,82F56B09E86EBDC3CC6E0A02A6F030B6,42623,9,11,2,22,49,1149
1604,1604,82F56B09E86EBDC3CC6E0A02A6F030B6,42081,14,15,1,24,49,1249
1605,1605,82F56B09E86EBDC3CC6E0A02A6F030B6,42121,17,23,6,26,49,1349
1609,1609,97EED02186157B67ACCA35C5CC13851D,11731,0,2,2,36,48,1848
1610,1610,97EED02186157B67ACCA35C5CC13851D,43161,3,8,5,35,47,1797
1611,1611,97EED02186157B67ACCA35C5CC13851D,10544,10,13,3,28,48,1448
1612,1612,97EED02186157B67ACCA35C5CC13851D,11331,14,20,6,37,48,1898
1613,1613,97EED02186157B67ACCA35C5CC13851D,43161,22,23,1,35,47,1797
1614,1614,CE609F9A3F19D534B803960C84F7425C,12401,1,3,2,39,49,1999
1615,1615,CE609F9A3F19D534B803960C84F7425C,11741,6,8,2,42,49,2149
1616,1616,CE609F9A3F19D534B803960C84F7425C,42221,9,10,1,38,48,1948
1617,1617,CE609F9A3F19D534B803960C84F7425C,40341,17,20,3,23,49,1199
1618,1618,CE609F9A3F19D534B803960C84F7425C,11231,21,23,2,37,49,1899
1619,1619,78A4AA9407E763ED8D1652A4AFF74DAE,12921,0,1,1,9,41,491
1620,1620,78A4AA9407E763ED8D1652A4AFF74DAE,12641,2,12,10,10,43,543
1621,1621,78A4AA9407E763ED8D1652A4AFF74DAE,19114,12,17,5,7,43,393
1622,1622,78A4AA9407E763ED8D1652A4AFF74DAE,12641,18,19,1,10,43,543
1623,1623,78A4AA9407E763ED8D1652A4AFF74DAE,12921,20,23,3,9,41,491
1624,1624,A6BBFE7886A6BFC52F86E58BBD2C0899,12871,0,1,1,22,33,1133
1625,1625,A6BBFE7886A6BFC52F86E58BBD2C0899,19281,2,3,1,16,32,832
1626,1626,A6BBFE7886A6BFC52F86E58BBD2C0899,12871,4,7,3,22,33,1133
1627,1627,A6BBFE7886A6BFC52F86E58BBD2C0899,19281,8,19,11,16,32,832
1628,1628,A6BBFE7886A6BFC52F86E58BBD2C0899,15344,21,22,1,35,11,1761
1643,1643,05DDFE46ADF8C6EAEDC2AEAF48B46410,10691,0,6,6,33,48,1698
1644,1644,05DDFE46ADF8C6EAEDC2AEAF48B46410,10401,9,10,1,33,49,1699
1645,1645,05DDFE46ADF8C6EAEDC2AEAF48B46410,43731,12,14,2,34,47,1747
1646,1646,05DDFE46ADF8C6EAEDC2AEAF48B46410,42941,16,18,2,37,47,1897
1647,1647,05DDFE46ADF8C6EAEDC2AEAF48B46410,10691,21,23,2,33,48,1698
1659,1659,0BE3958594512027D474EB64B10DCF88,12841,0,6,6,37,47,1897
1660,1660,0BE3958594512027D474EB64B10DCF88,11331,7,9,2,37,48,1898
1661,1661,0BE3958594512027D474EB64B10DCF88,11074,11,12,1,37,47,1897
1662,1662,0BE3958594512027D474EB64B10DCF88,13511,15,16,1,34,48,1748
1663,1663,0BE3958594512027D474EB64B10DCF88,10221,17,19,2,34,49,1749
1664,1664,0BE3958594512027D474EB64B10DCF88,13511,20,21,1,34,48,1748
1669,1669,49A7B666AF734389ABAE16E534AD97F5,11491,1,11,10,36,47,1847
1670,1670,49A7B666AF734389ABAE16E534AD97F5,42381,12,13,1,39,41,1991
1671,1671,49A7B666AF734389ABAE16E534AD97F5,40341,14,17,3,23,49,1199
1672,1672,49A7B666AF734389ABAE16E534AD97F5,11491,17,19,2,36,47,1847
1673,1673,6D2C11DB3E76C2943C7F716A3AF725C0,12921,2,6,4,9,41,491
1674,1674,6D2C11DB3E76C2943C7F716A3AF725C0,19114,7,10,3,7,43,393
1675,1675,6D2C11DB3E76C2943C7F716A3AF725C0,12921,10,19,9,9,41,491
1676,1676,6D2C11DB3E76C2943C7F716A3AF725C0,49201,19,20,1,7,41,391
1677,1677,6D2C11DB3E76C2943C7F716A3AF725C0,12921,22,23,1,9,41,491
1697,1697,DA4A6840A03404C3E0A1735C5E8D9551,10841,1,11,10,37,47,1897
1698,1698,DA4A6840A03404C3E0A1735C5E8D9551,10691,17,19,2,33,48,1698
1699,1699,DA4A6840A03404C3E0A1735C5E8D9551,10841,22,23,1,37,47,1897
1700,1700,3B843905DBA028028A69F37DCACAA60A,10211,5,6,1,16,49,849
1701,1701,3B843905DBA028028A69F37DCACAA60A,19621,10,12,2,5,46,296
1702,1702,3B843905DBA028028A69F37DCACAA60A,11381,16,21,5,30,47,1547
1703,1703,3B843905DBA028028A69F37DCACAA60A,11861,21,23,2,32,47,1647
1704,1704,89C16223EF6BC39B2E4A2C39EB812C55,13941,0,10,10,41,47,2097
1705,1705,89C16223EF6BC39B2E4A2C39EB812C55,12481,18,21,3,37,49,1899
1706,1706,89C16223EF6BC39B2E4A2C39EB812C55,11021,22,23,1,36,49,1849
1707,1707,7D108BFB051387A341F75FDC13929BC0,10381,0,9,9,31,49,1599
1708,1708,7D108BFB051387A341F75FDC13929BC0,10781,10,15,5,35,47,1797
1709,1709,7D108BFB051387A341F75FDC13929BC0,10381,15,18,3,31,49,1599
1710,1710,7D108BFB051387A341F75FDC13929BC0,43061,21,23,2,43,46,2196
1711,1711,C58E4B7620ABC1BF159367984D672C5E,10971,2,7,5,35,47,1797
1712,1712,C58E4B7620ABC1BF159367984D672C5E,13511,8,13,5,34,48,1748
1713,1713,C58E4B7620ABC1BF159367984D672C5E,13101,13,16,3,40,47,2047
1714,1714,C58E4B7620ABC1BF159367984D672C5E,11751,19,21,2,35,48,1798
1715,1715,C58E4B7620ABC1BF159367984D672C5E,10161,22,23,1,35,49,1799
1716,1716,54869B905D9FE5BDC4D6EE5F69644AAC,42321,0,3,3,43,47,2197
1717,1717,54869B905D9FE5BDC4D6EE5F69644AAC,10421,4,5,1,41,48,2098
1718,1718,54869B905D9FE5BDC4D6EE5F69644AAC,42321,6,8,2,43,47,2197
1719,1719,54869B905D9FE5BDC4D6EE5F69644AAC,43621,10,11,1,46,48,2348
1720,1720,54869B905D9FE5BDC4D6EE5F69644AAC,42321,12,17,5,43,47,2197
1721,1721,54869B905D9FE5BDC4D6EE5F69644AAC,42601,19,20,1,44,48,2248
1725,1725,F276DA0C0E39AE3BAD5B91AE46CB6EA8,10471,3,5,2,37,48,1898
1726,1726,F276DA0C0E39AE3BAD5B91AE46CB6EA8,11231,5,17,12,37,49,1899
1727,1727,F276DA0C0E39AE3BAD5B91AE46CB6EA8,10621,18,19,1,41,49,2099
1728,1728,F276DA0C0E39AE3BAD5B91AE46CB6EA8,11771,20,23,3,39,49,1999
1736,1736,EA0660F7C6162C67CDE294149B22D06F,11491,0,8,8,36,47,1847
1737,1737,EA0660F7C6162C67CDE294149B22D06F,40341,12,17,5,23,49,1199
1738,1738,EA0660F7C6162C67CDE294149B22D06F,11491,18,20,2,36,47,1847
1745,1745,3D99EB7860A1886FCC43DDBA4A5D23A2,12083,5,8,3,36,49,1849
1746,1746,3D99EB7860A1886FCC43DDBA4A5D23A2,11201,12,13,1,35,49,1799
1747,1747,3D99EB7860A1886FCC43DDBA4A5D23A2,40341,14,17,3,23,49,1199
1748,1748,3D99EB7860A1886FCC43DDBA4A5D23A2,11231,18,22,4,37,49,1899
1752,1752,69C834810CF6013D091E0B9EA99E4EF4,40637,2,6,4,36,47,1847
1753,1753,69C834810CF6013D091E0B9EA99E4EF4,10881,7,10,3,34,48,1748
1754,1754,69C834810CF6013D091E0B9EA99E4EF4,40637,11,13,2,36,47,1847
1755,1755,69C834810CF6013D091E0B9EA99E4EF4,43021,14,19,5,16,43,843
1756,1756,69C834810CF6013D091E0B9EA99E4EF4,40637,20,23,3,36,47,1847
1760,1760,149D536EDCDCEF843E1402F6CD8FF6BD,13331,0,1,1,38,47,1947
1761,1761,149D536EDCDCEF843E1402F6CD8FF6BD,42271,2,13,11,40,47,2047
1762,1762,149D536EDCDCEF843E1402F6CD8FF6BD,13331,14,15,1,38,47,1947
1763,1763,149D536EDCDCEF843E1402F6CD8FF6BD,13271,16,18,2,41,47,2097
1764,1764,149D536EDCDCEF843E1402F6CD8FF6BD,13101,18,19,1,40,47,2047
1785,1785,5B005239AD91B224060A740123F8C94E,13231,0,6,6,39,46,1996
1786,1786,5B005239AD91B224060A740123F8C94E,42231,9,10,1,37,46,1896
1787,1787,5B005239AD91B224060A740123F8C94E,13231,11,13,2,39,46,1996
1788,1788,5B005239AD91B224060A740123F8C94E,42231,14,16,2,37,46,1896
1789,1789,5B005239AD91B224060A740123F8C94E,13231,21,23,2,39,46,1996
1790,1790,384DFF9F4EC9F66B0D32D11AEF340F73,11231,0,7,7,37,49,1899
1791,1791,384DFF9F4EC9F66B0D32D11AEF340F73,11951,10,11,1,31,49,1599
1792,1792,384DFF9F4EC9F66B0D32D11AEF340F73,10601,13,15,2,39,47,1997
1793,1793,384DFF9F4EC9F66B0D32D11AEF340F73,11231,16,22,6,37,49,1899
1794,1794,384DFF9F4EC9F66B0D32D11AEF340F73,10601,22,23,1,39,47,1997
1802,1802,567F0D17FECEF9CCF0140B978699D5BD,10061,0,7,7,20,46,1046
1803,1803,567F0D17FECEF9CCF0140B978699D5BD,10501,10,12,2,22,46,1146
1804,1804,567F0D17FECEF9CCF0140B978699D5BD,12601,13,14,1,25,47,1297
1805,1805,567F0D17FECEF9CCF0140B978699D5BD,10061,18,19,1,20,46,1046
1806,1806,567F0D17FECEF9CCF0140B978699D5BD,10501,21,23,2,22,46,1146
1807,1807,0AB3FB3A5BD0A79F217BD5A37B334853,11061,0,8,8,29,48,1498
1808,1808,0AB3FB3A5BD0A79F217BD5A37B334853,43361,9,10,1,38,48,1948
1809,1809,0AB3FB3A5BD0A79F217BD5A37B334853,11061,11,17,6,29,48,1498
1810,1810,0AB3FB3A5BD0A79F217BD5A37B334853,11731,19,20,1,36,48,1848
1811,1811,0AB3FB3A5BD0A79F217BD5A37B334853,11061,21,23,2,29,48,1498
1812,1812,7C3D8D6A0621EB24608684305ED7A7E5,11361,0,9,9,22,48,1148
1813,1813,7C3D8D6A0621EB24608684305ED7A7E5,10107,9,11,2,38,49,1949
1814,1814,7C3D8D6A0621EB24608684305ED7A7E5,43581,13,14,1,33,48,1698
1815,1815,7C3D8D6A0621EB24608684305ED7A7E5,11361,16,23,7,22,48,1148
1822,1822,76C25A6940E69B611EAF6BE1171DA0DE,43191,0,8,8,40,49,2049
1823,1823,76C25A6940E69B611EAF6BE1171DA0DE,13481,11,14,3,26,31,1331
1824,1824,76C25A6940E69B611EAF6BE1171DA0DE,10107,19,22,3,38,49,1949
1828,1828,E7A499EFF2705CCA8F4C4AD8B684EDF4,10221,0,9,9,34,49,1749
1829,1829,E7A499EFF2705CCA8F4C4AD8B684EDF4,10501,10,12,2,22,46,1146
1830,1830,E7A499EFF2705CCA8F4C4AD8B684EDF4,11201,18,23,5,35,49,1799
1841,1841,1DDBA4173A1A82CE4A25CA162B8D11CB,42381,0,5,5,39,41,1991
1842,1842,1DDBA4173A1A82CE4A25CA162B8D11CB,43451,7,8,1,37,40,1890
1843,1843,1DDBA4173A1A82CE4A25CA162B8D11CB,42381,12,14,2,39,41,1991
1844,1844,1DDBA4173A1A82CE4A25CA162B8D11CB,13071,14,17,3,41,41,2091
1845,1845,1DDBA4173A1A82CE4A25CA162B8D11CB,43451,17,18,1,37,40,1890
1846,1846,1DDBA4173A1A82CE4A25CA162B8D11CB,42381,20,22,2,39,41,1991
1847,1847,08B6161A63F0BFCCF67BFC0EA5B81E44,42621,0,8,8,24,49,1249
1848,1848,08B6161A63F0BFCCF67BFC0EA5B81E44,40341,8,10,2,23,49,1199
1849,1849,08B6161A63F0BFCCF67BFC0EA5B81E44,42081,10,15,5,24,49,1249
1850,1850,08B6161A63F0BFCCF67BFC0EA5B81E44,40341,15,18,3,23,49,1199
1851,1851,08B6161A63F0BFCCF67BFC0EA5B81E44,42621,19,23,4,24,49,1249
1855,1855,005411917405CE9A9BEB9B8C44549076,11701,0,3,3,43,48,2198
1856,1856,005411917405CE9A9BEB9B8C44549076,42321,3,6,3,43,47,2197
1857,1857,005411917405CE9A9BEB9B8C44549076,11701,7,13,6,43,48,2198
1858,1858,005411917405CE9A9BEB9B8C44549076,42321,15,18,3,43,47,2197
1859,1859,005411917405CE9A9BEB9B8C44549076,11701,18,19,1,43,48,2198
1863,1863,431306F18633740CEB29047249126782,10721,0,12,12,31,48,1598
1864,1864,431306F18633740CEB29047249126782,11061,12,13,1,29,48,1498
1865,1865,431306F18633740CEB29047249126782,40341,14,19,5,23,49,1199
1866,1866,431306F18633740CEB29047249126782,11631,21,23,2,12,49,649
1871,1871,DAE97FB0BCA7A931E79901DF80B6F76E,19901,0,7,7,7,44,394
1872,1872,DAE97FB0BCA7A931E79901DF80B6F76E,12921,10,11,1,9,41,491
1873,1873,DAE97FB0BCA7A931E79901DF80B6F76E,49201,14,15,1,7,41,391
1874,1874,DAE97FB0BCA7A931E79901DF80B6F76E,19901,19,23,4,7,44,394
1875,1875,1EF76DFE853AD639FAB86DF33C7661E7,10221,0,13,13,34,49,1749
1876,1876,1EF76DFE853AD639FAB86DF33C7661E7,40341,15,17,2,23,49,1199
1877,1877,1EF76DFE853AD639FAB86DF33C7661E7,13511,19,23,4,34,48,1748
1878,1878,539DF1D84ADD37AC2B3BA6270F0753F6,10341,0,8,8,31,47,1597
1879,1879,539DF1D84ADD37AC2B3BA6270F0753F6,11914,9,19,10,37,48,1898
1880,1880,539DF1D84ADD37AC2B3BA6270F0753F6,10341,20,23,3,31,47,1597
1881,1881,675E14475BB1E43D277D9A5E27CBF03A,19114,0,1,1,7,43,393
1882,1882,675E14475BB1E43D277D9A5E27CBF03A,19441,2,3,1,8,46,446
1883,1883,675E14475BB1E43D277D9A5E27CBF03A,42041,4,5,1,10,47,547
1884,1884,675E14475BB1E43D277D9A5E27CBF03A,19441,21,22,1,8,46,446
1888,1888,F5E0C70CE2CD1012FF3E8451810FE376,43161,0,8,8,35,47,1797
1889,1889,F5E0C70CE2CD1012FF3E8451810FE376,16211,12,13,1,4,3,203
1890,1890,F5E0C70CE2CD1012FF3E8451810FE376,16241,14,16,2,3,3,153
1891,1891,F5E0C70CE2CD1012FF3E8451810FE376,16184,17,19,2,1,1,51
1892,1892,F5E0C70CE2CD1012FF3E8451810FE376,16211,21,22,1,4,3,203
1893,1893,04FC279D8763FD0D52EBF8F599CB8F45,11021,0,8,8,36,49,1849
1894,1894,04FC279D8763FD0D52EBF8F599CB8F45,42301,10,12,2,36,47,1847
1895,1895,04FC279D8763FD0D52EBF8F599CB8F45,42511,13,14,1,37,47,1897
1896,1896,04FC279D8763FD0D52EBF8F599CB8F45,11021,14,15,1,36,49,1849
1897,1897,04FC279D8763FD0D52EBF8F599CB8F45,42511,15,18,3,37,47,1897
1898,1898,04FC279D8763FD0D52EBF8F599CB8F45,11021,19,20,1,36,49,1849
1902,1902,F5288A19EACF8E6E221F9323ACDE3A86,19051,0,17,17,16,23,823
1903,1903,F5288A19EACF8E6E221F9323ACDE3A86,15181,18,19,1,26,24,1324
1904,1904,F5288A19EACF8E6E221F9323ACDE3A86,19051,19,23,4,16,23,823
1905,1905,B1CA398CBCC08726B10214389CB30840,42161,7,12,5,36,47,1847
1906,1906,B1CA398CBCC08726B10214389CB30840,12601,15,17,2,25,47,1297
1907,1907,B1CA398CBCC08726B10214389CB30840,40171,18,19,1,38,48,1948
1908,1908,B1CA398CBCC08726B10214389CB30840,43731,20,23,3,34,47,1747
1909,1909,64FF3E93355E6DCA29977E04D316EABA,13111,4,9,5,42,46,2146
1910,1910,64FF3E93355E6DCA29977E04D316EABA,10621,12,14,2,41,49,2099
1911,1911,64FF3E93355E6DCA29977E04D316EABA,11271,16,19,3,37,48,1898
1912,1912,64FF3E93355E6DCA29977E04D316EABA,11541,19,20,1,35,49,1799
1913,1913,64FF3E93355E6DCA29977E04D316EABA,10107,21,22,1,38,49,1949
1917,1917,EF70B819C0B2D97BD4189E099D0FE5A9,10281,0,9,9,33,48,1698
1918,1918,EF70B819C0B2D97BD4189E099D0FE5A9,11861,9,10,1,32,47,1647
1919,1919,EF70B819C0B2D97BD4189E099D0FE5A9,12481,15,17,2,37,49,1899
1920,1920,EF70B819C0B2D97BD4189E099D0FE5A9,11861,20,23,3,32,47,1647
1927,1927,FADBD24FB94D9388BE2E59D5F595D57D,40431,0,8,8,36,47,1847
1928,1928,FADBD24FB94D9388BE2E59D5F595D57D,42461,9,10,1,45,47,2297
1929,1929,FADBD24FB94D9388BE2E59D5F595D57D,42161,12,14,2,36,47,1847
1930,1930,FADBD24FB94D9388BE2E59D5F595D57D,42461,15,18,3,45,47,2297
1940,1940,736956556204FAE56BD8312C9BE93E54,11861,0,13,13,32,47,1647
1941,1941,736956556204FAE56BD8312C9BE93E54,40341,14,16,2,23,49,1199
1942,1942,736956556204FAE56BD8312C9BE93E54,43731,18,19,1,34,47,1747
1943,1943,736956556204FAE56BD8312C9BE93E54,11861,21,23,2,32,47,1647
1944,1944,AF77E83C33BBDAC9BE49E19DF29439BD,42871,0,7,7,30,45,1545
1945,1945,AF77E83C33BBDAC9BE49E19DF29439BD,13711,8,17,9,38,46,1946
1946,1946,AF77E83C33BBDAC9BE49E19DF29439BD,42871,21,23,2,30,45,1545
1947,1947,0F71932005DEDDB2CACBDF450463440D,42301,0,5,5,36,47,1847
1948,1948,0F71932005DEDDB2CACBDF450463440D,42071,7,8,1,31,49,1599
1949,1949,0F71932005DEDDB2CACBDF450463440D,11061,10,12,2,29,48,1498
1950,1950,0F71932005DEDDB2CACBDF450463440D,42301,16,23,7,36,47,1847
1951,1951,0277E6ABE6E23FB8B51E9078601CBBC1,42491,0,7,7,32,46,1646
1952,1952,0277E6ABE6E23FB8B51E9078601CBBC1,42523,8,14,6,31,47,1597
1953,1953,0277E6ABE6E23FB8B51E9078601CBBC1,10292,14,15,1,30,47,1547
1954,1954,0277E6ABE6E23FB8B51E9078601CBBC1,42523,17,19,2,31,47,1597
1955,1955,0277E6ABE6E23FB8B51E9078601CBBC1,42491,20,22,2,32,46,1646
1976,1976,DCF0E7A2CF6CF01600CEB25103C20FCF,11061,0,9,9,29,48,1498
1977,1977,DCF0E7A2CF6CF01600CEB25103C20FCF,42381,10,11,1,39,41,1991
1978,1978,DCF0E7A2CF6CF01600CEB25103C20FCF,11061,13,23,10,29,48,1498
1986,1986,9AB51B34B196732B57B0B63652E5E3C6,11281,0,4,4,27,40,1390
1987,1987,9AB51B34B196732B57B0B63652E5E3C6,12731,4,10,6,22,40,1140
1988,1988,9AB51B34B196732B57B0B63652E5E3C6,13314,11,12,1,31,39,1589
1989,1989,9AB51B34B196732B57B0B63652E5E3C6,13671,13,19,6,27,43,1393
1990,1990,5507179083B5F01EF4086E9B59332C6E,42161,2,12,10,36,47,1847
1991,1991,5507179083B5F01EF4086E9B59332C6E,13671,14,16,2,27,43,1393
1992,1992,5507179083B5F01EF4086E9B59332C6E,42301,20,23,3,36,47,1847
1993,1993,BE4FF2028F2F1B225B6A514FCAAD119A,42201,0,8,8,43,46,2196
1994,1994,BE4FF2028F2F1B225B6A514FCAAD119A,42501,12,14,2,28,47,1447
1995,1995,BE4FF2028F2F1B225B6A514FCAAD119A,10971,15,16,1,35,47,1797
1996,1996,BE4FF2028F2F1B225B6A514FCAAD119A,11271,18,20,2,37,48,1898
1997,1997,E40FF661B4F3DA89AB28D734DF463F41,12921,8,12,4,9,41,491
1998,1998,E40FF661B4F3DA89AB28D734DF463F41,12641,13,16,3,10,43,543
1999,1999,E40FF661B4F3DA89AB28D734DF463F41,12921,16,17,1,9,41,491
2000,2000,E40FF661B4F3DA89AB28D734DF463F41,43021,21,23,2,16,43,843
2001,2001,F031FD2F854EE78DC74B73079D5A136F,12121,0,7,7,29,47,1497
2002,2002,F031FD2F854EE78DC74B73079D5A136F,13911,8,9,1,39,46,1996
2003,2003,F031FD2F854EE78DC74B73079D5A136F,10681,10,17,7,30,48,1548
2004,2004,F031FD2F854EE78DC74B73079D5A136F,42521,18,23,5,31,47,1597
2021,2021,35C7DEE52FA47B8400055A63F2463516,10801,0,10,10,42,47,2147
2022,2022,35C7DEE52FA47B8400055A63F2463516,43731,12,13,1,34,47,1747
2023,2023,35C7DEE52FA47B8400055A63F2463516,10971,17,18,1,35,47,1797
2024,2024,9A7DDF7206C87183C5ADD45F01E4890C,10771,1,11,10,41,46,2096
2025,2025,9A7DDF7206C87183C5ADD45F01E4890C,12021,16,17,1,37,49,1899
2026,2026,9A7DDF7206C87183C5ADD45F01E4890C,10771,21,23,2,41,46,2096
2027,2027,EF9C99EE076D9702EF73224BC1A91C21,43621,0,3,3,46,48,2348
2028,2028,EF9C99EE076D9702EF73224BC1A91C21,11701,5,11,6,43,48,2198
2029,2029,EF9C99EE076D9702EF73224BC1A91C21,13471,15,16,1,47,49,2399
2030,2030,EF9C99EE076D9702EF73224BC1A91C21,42601,16,18,2,44,48,2248
2031,2031,EF9C99EE076D9702EF73224BC1A91C21,43621,18,23,5,46,48,2348
2032,2032,0E002027D741B8AED4EE58E469659344,12601,0,1,1,25,47,1297
2033,2033,0E002027D741B8AED4EE58E469659344,10061,6,7,1,20,46,1046
2034,2034,0E002027D741B8AED4EE58E469659344,12584,8,13,5,24,48,1248
2035,2035,0E002027D741B8AED4EE58E469659344,10061,15,19,4,20,46,1046
2036,2036,89313D14D4AEEAD368F822E4A0AA83FD,42041,1,3,2,10,47,547
2037,2037,89313D14D4AEEAD368F822E4A0AA83FD,11851,4,5,1,13,47,697
2038,2038,89313D14D4AEEAD368F822E4A0AA83FD,19441,6,10,4,8,46,446
2039,2039,89313D14D4AEEAD368F822E4A0AA83FD,42041,12,13,1,10,47,547
2040,2040,89313D14D4AEEAD368F822E4A0AA83FD,19441,15,18,3,8,46,446
2041,2041,89313D14D4AEEAD368F822E4A0AA83FD,42041,21,23,2,10,47,547
2052,2052,39179060954ADF536A44D5CDC3D7ADA4,10921,0,5,5,43,48,2198
2053,2053,39179060954ADF536A44D5CDC3D7ADA4,42351,5,10,5,38,45,1945
2054,2054,39179060954ADF536A44D5CDC3D7ADA4,11261,10,18,8,36,46,1846
2055,2055,39179060954ADF536A44D5CDC3D7ADA4,13911,18,21,3,39,46,1996
2056,2056,BE6556F4F32DDBE17FA5A6143CEC24DA,12481,8,12,4,37,49,1899
2057,2057,BE6556F4F32DDBE17FA5A6143CEC24DA,42921,13,14,1,33,47,1697
2058,2058,BE6556F4F32DDBE17FA5A6143CEC24DA,12481,15,18,3,37,49,1899
2059,2059,BE6556F4F32DDBE17FA5A6143CEC24DA,42921,19,21,2,33,47,1697
2060,2060,6F56DCCCA49704FE0EF89D218610398B,13341,0,8,8,44,45,2245
2061,2061,6F56DCCCA49704FE0EF89D218610398B,12601,9,13,4,25,47,1297
2062,2062,6F56DCCCA49704FE0EF89D218610398B,13341,14,17,3,44,45,2245
2063,2063,6F56DCCCA49704FE0EF89D218610398B,43181,19,21,2,39,48,1998
2064,2064,59C9891991D18AB42F5CA2A676EAFEE0,11781,0,8,8,38,49,1949
2065,2065,59C9891991D18AB42F5CA2A676EAFEE0,19441,9,12,3,8,46,446
2066,2066,59C9891991D18AB42F5CA2A676EAFEE0,42041,13,14,1,10,47,547
2067,2067,59C9891991D18AB42F5CA2A676EAFEE0,19441,14,18,4,8,46,446
2068,2068,59C9891991D18AB42F5CA2A676EAFEE0,42521,19,21,2,31,47,1597
2069,2069,224C21C34F87AA32040CA84D9C67D1DF,13314,1,8,7,31,39,1589
2070,2070,224C21C34F87AA32040CA84D9C67D1DF,12021,11,13,2,37,49,1899
2071,2071,224C21C34F87AA32040CA84D9C67D1DF,42381,18,20,2,39,41,1991
2072,2072,224C21C34F87AA32040CA84D9C67D1DF,13314,21,23,2,31,39,1589
2076,2076,5139512673C22760B7A2539C09B8404A,43041,0,7,7,41,46,2096
2077,2077,5139512673C22760B7A2539C09B8404A,13911,8,9,1,39,46,1996
2078,2078,5139512673C22760B7A2539C09B8404A,40951,13,19,6,36,49,1849
2079,2079,AF45D7FF91ADC8A42EE1BE638B4AB9CE,13271,0,8,8,41,47,2097
2080,2080,AF45D7FF91ADC8A42EE1BE638B4AB9CE,12381,11,12,1,32,48,1648
2081,2081,AF45D7FF91ADC8A42EE1BE638B4AB9CE,13271,16,18,2,41,47,2097
2082,2082,AF45D7FF91ADC8A42EE1BE638B4AB9CE,41392,18,23,5,43,48,2198
2083,2083,EEEA464AD5C6037BE1D5470F72E2E9C2,10331,0,9,9,39,46,1996
2084,2084,EEEA464AD5C6037BE1D5470F72E2E9C2,15411,10,13,3,44,27,2227
2085,2085,EEEA464AD5C6037BE1D5470F72E2E9C2,10331,15,22,7,39,46,1996
2089,2089,6DFBF28C4BB1FC2BFED5E053C4C14307,43581,0,7,7,33,48,1698
2090,2090,6DFBF28C4BB1FC2BFED5E053C4C14307,19441,9,13,4,8,46,446
2091,2091,6DFBF28C4BB1FC2BFED5E053C4C14307,43581,16,17,1,33,48,1698
2092,2092,6DFBF28C4BB1FC2BFED5E053C4C14307,10781,18,20,2,35,47,1797
2093,2093,6DFBF28C4BB1FC2BFED5E053C4C14307,43581,21,23,2,33,48,1698
2101,2101,E89F56AD5A93714B53D26D204A21FEB5,42471,0,14,14,35,49,1799
2102,2102,E89F56AD5A93714B53D26D204A21FEB5,42583,15,16,1,40,48,2048
2103,2103,E89F56AD5A93714B53D26D204A21FEB5,40951,19,21,2,36,49,1849
2104,2104,E89F56AD5A93714B53D26D204A21FEB5,42471,21,23,2,35,49,1799
2105,2105,B4A3F2FDD0BF4FBAD32A94FBF9A29AAE,10601,0,7,7,39,47,1997
2106,2106,B4A3F2FDD0BF4FBAD32A94FBF9A29AAE,13371,7,8,1,41,47,2097
2107,2107,B4A3F2FDD0BF4FBAD32A94FBF9A29AAE,12083,9,10,1,36,49,1849
2108,2108,B4A3F2FDD0BF4FBAD32A94FBF9A29AAE,11231,11,22,11,37,49,1899
2112,2112,E1DD7EC86E7282DDD85335B7F6FA4A39,12083,0,2,2,36,49,1849
2113,2113,E1DD7EC86E7282DDD85335B7F6FA4A39,10841,4,13,9,37,47,1897
2114,2114,E1DD7EC86E7282DDD85335B7F6FA4A39,40341,18,20,2,23,49,1199
2115,2115,A0D0A92258D9DAF7EDCF60BEFD3CB622,42861,0,7,7,37,44,1894
2116,2116,A0D0A92258D9DAF7EDCF60BEFD3CB622,19441,8,10,2,8,46,446
2117,2117,A0D0A92258D9DAF7EDCF60BEFD3CB622,42041,11,13,2,10,47,547
2118,2118,A0D0A92258D9DAF7EDCF60BEFD3CB622,19441,14,22,8,8,46,446
2125,2125,ED389B0738C21DFCB029EF12B67F5260,12601,8,12,4,25,47,1297
2126,2126,ED389B0738C21DFCB029EF12B67F5260,42271,15,16,1,40,47,2047
2127,2127,ED389B0738C21DFCB029EF12B67F5260,12401,18,20,2,39,49,1999
2132,2132,B53C313F28E9C152305715765AEEF04B,12521,1,2,1,35,41,1791
2133,2133,B53C313F28E9C152305715765AEEF04B,43011,3,6,3,40,42,2042
2134,2134,B53C313F28E9C152305715765AEEF04B,42151,8,18,10,35,45,1795
2135,2135,D1D5B16F27340AAF330DB0252EB38467,19101,0,6,6,17,29,879
2136,2136,D1D5B16F27340AAF330DB0252EB38467,19531,7,8,1,17,30,880
2137,2137,D1D5B16F27340AAF330DB0252EB38467,12051,9,11,2,20,47,1047
2138,2138,D1D5B16F27340AAF330DB0252EB38467,11781,16,19,3,38,49,1949
2139,2139,D1D5B16F27340AAF330DB0252EB38467,42151,21,22,1,35,45,1795
2143,2143,4F1CE0C1A5E6BF21E963500414770875,10841,0,15,15,37,47,1897
2144,2144,4F1CE0C1A5E6BF21E963500414770875,42623,17,19,2,22,49,1149
2145,2145,4F1CE0C1A5E6BF21E963500414770875,10841,22,23,1,37,47,1897
2146,2146,C36C389487F236497E05D4F18E330E72,11324,1,3,2,31,46,1596
2147,2147,C36C389487F236497E05D4F18E330E72,11875,4,5,1,30,46,1546
2148,2148,C36C389487F236497E05D4F18E330E72,11324,6,7,1,31,46,1596
2149,2149,C36C389487F236497E05D4F18E330E72,42491,11,12,1,32,46,1646
2150,2150,C36C389487F236497E05D4F18E330E72,10107,13,16,3,38,49,1949
2151,2151,C36C389487F236497E05D4F18E330E72,42523,17,20,3,31,47,1597
2152,2152,71AB304A084EB4095E1F705C48CB0E23,11901,0,6,6,42,49,2149
2153,2153,71AB304A084EB4095E1F705C48CB0E23,11914,8,18,10,37,48,1898
2154,2154,71AB304A084EB4095E1F705C48CB0E23,11901,18,22,4,42,49,2149
2155,2155,5B38B567B1C7BA8CD66BEFDF9C575D7A,11231,0,10,10,37,49,1899
2156,2156,5B38B567B1C7BA8CD66BEFDF9C575D7A,11351,12,15,3,36,48,1848
2157,2157,5B38B567B1C7BA8CD66BEFDF9C575D7A,12083,16,17,1,36,49,1849
2158,2158,5B38B567B1C7BA8CD66BEFDF9C575D7A,11151,17,20,3,30,48,1548
2173,2173,B4F79C9383A51C8FC77DBF84EB3E0920,11781,0,9,9,38,49,1949
2174,2174,B4F79C9383A51C8FC77DBF84EB3E0920,11531,12,13,1,34,49,1749
2175,2175,B4F79C9383A51C8FC77DBF84EB3E0920,40341,15,17,2,23,49,1199
2176,2176,B4F79C9383A51C8FC77DBF84EB3E0920,12971,18,19,1,32,48,1648
2177,2177,B4F79C9383A51C8FC77DBF84EB3E0920,10107,20,23,3,38,49,1949
2178,2178,035EFC7ABF2A1232F1603932C135383B,10251,0,11,11,35,47,1797
2179,2179,035EFC7ABF2A1232F1603932C135383B,11021,11,13,2,36,49,1849
2180,2180,035EFC7ABF2A1232F1603932C135383B,40341,14,16,2,23,49,1199
2181,2181,035EFC7ABF2A1232F1603932C135383B,11201,17,19,2,35,49,1799
2182,2182,035EFC7ABF2A1232F1603932C135383B,10251,19,21,2,35,47,1797
2183,2183,EC3702B6D1EF3E2036629A2FF6DCF74A,43761,0,12,12,32,47,1647
2184,2184,EC3702B6D1EF3E2036629A2FF6DCF74A,42021,12,13,1,33,47,1697
2185,2185,EC3702B6D1EF3E2036629A2FF6DCF74A,43761,14,15,1,32,47,1647
2186,2186,EC3702B6D1EF3E2036629A2FF6DCF74A,10107,16,19,3,38,49,1949
2187,2187,EC3702B6D1EF3E2036629A2FF6DCF74A,43761,21,22,1,32,47,1647
2194,2194,D1348284A12247DBF7195CE953852CD8,11161,0,7,7,32,48,1648
2195,2195,D1348284A12247DBF7195CE953852CD8,11061,9,11,2,29,48,1498
2196,2196,D1348284A12247DBF7195CE953852CD8,11161,11,12,1,32,48,1648
2197,2197,D1348284A12247DBF7195CE953852CD8,11061,14,15,1,29,48,1498
2198,2198,D1348284A12247DBF7195CE953852CD8,11161,16,18,2,32,48,1648
2199,2199,D1348284A12247DBF7195CE953852CD8,11381,19,23,4,30,47,1547
2207,2207,B52839E57EB154B7D2D8F51A5330D26E,42521,0,7,7,31,47,1597
2208,2208,B52839E57EB154B7D2D8F51A5330D26E,13911,8,10,2,39,46,1996
2209,2209,B52839E57EB154B7D2D8F51A5330D26E,10681,14,17,3,30,48,1548
2210,2210,B52839E57EB154B7D2D8F51A5330D26E,42521,17,23,6,31,47,1597
2211,2211,D3A8E24567875F3C39102478CB1D4A49,42633,0,6,6,42,46,2146
2212,2212,D3A8E24567875F3C39102478CB1D4A49,11061,6,17,11,29,48,1498
2213,2213,D3A8E24567875F3C39102478CB1D4A49,42633,21,23,2,42,46,2146
2214,2214,ECBC886277109C0582E65AB313F27C1C,13314,1,7,6,31,39,1589
2215,2215,ECBC886277109C0582E65AB313F27C1C,12521,9,16,7,35,41,1791
2216,2216,ECBC886277109C0582E65AB313F27C1C,13314,18,21,3,31,39,1589
2217,2217,C493E8EAD829832CA31397E82BE4990B,43021,0,5,5,16,43,843
2218,2218,C493E8EAD829832CA31397E82BE4990B,12641,6,16,10,10,43,543
2219,2219,C493E8EAD829832CA31397E82BE4990B,12921,18,19,1,9,41,491
2220,2220,C493E8EAD829832CA31397E82BE4990B,43021,19,23,4,16,43,843
2221,2221,65CC73945151CAE40C5DA3FBAA4A83B7,13271,0,7,7,41,47,2097
2222,2222,65CC73945151CAE40C5DA3FBAA4A83B7,42971,14,15,1,43,49,2199
2223,2223,65CC73945151CAE40C5DA3FBAA4A83B7,11201,18,21,3,35,49,1799
2224,2224,350909571DAF40BC1326F0871B6F4AC2,42371,0,7,7,34,46,1746
2225,2225,350909571DAF40BC1326F0871B6F4AC2,42523,9,11,2,31,47,1597
2226,2226,350909571DAF40BC1326F0871B6F4AC2,42371,12,19,7,34,46,1746
2227,2227,350909571DAF40BC1326F0871B6F4AC2,11861,19,21,2,32,47,1647
2228,2228,350909571DAF40BC1326F0871B6F4AC2,42371,22,23,1,34,46,1746
2229,2229,37CA6FC93298247417BA55BAFA788505,11351,0,14,14,36,48,1848
2230,2230,37CA6FC93298247417BA55BAFA788505,42491,15,17,2,32,46,1646
2231,2231,37CA6FC93298247417BA55BAFA788505,11351,18,22,4,36,48,1848
2232,2232,5BCB7EE8D327B290B87F3A6084CE7836,42583,0,6,6,40,48,2048
2233,2233,5BCB7EE8D327B290B87F3A6084CE7836,11771,7,11,4,39,49,1999
2234,2234,5BCB7EE8D327B290B87F3A6084CE7836,42583,12,13,1,40,48,2048
2235,2235,5BCB7EE8D327B290B87F3A6084CE7836,40341,16,19,3,23,49,1199
2236,2236,5BCB7EE8D327B290B87F3A6084CE7836,10191,20,23,3,40,48,2048
2240,2240,C187943D20D187183526E0228C45660E,11021,0,10,10,36,49,1849
2241,2241,C187943D20D187183526E0228C45660E,40034,10,15,5,32,48,1648
2242,2242,C187943D20D187183526E0228C45660E,11021,18,23,5,36,49,1849
2246,2246,E9E990F48245ACFDBDC8F1C95015FE95,42301,0,7,7,36,47,1847
2247,2247,E9E990F48245ACFDBDC8F1C95015FE95,43361,8,9,1,38,48,1948
2248,2248,E9E990F48245ACFDBDC8F1C95015FE95,10841,10,15,5,37,47,1897
2249,2249,E9E990F48245ACFDBDC8F1C95015FE95,40691,19,20,1,42,48,2148
2250,2250,E9E990F48245ACFDBDC8F1C95015FE95,42511,22,23,1,37,47,1897
2251,2251,89F007BE47A4CA030F723091B0A0C36F,42291,0,13,13,29,48,1498
2252,2252,89F007BE47A4CA030F723091B0A0C36F,11151,15,17,2,30,48,1548
2253,2253,89F007BE47A4CA030F723091B0A0C36F,40951,18,21,3,36,49,1849
2258,2258,0B308F8177D01C3A8D264E73918BD4FC,13371,1,2,1,41,47,2097
2259,2259,0B308F8177D01C3A8D264E73918BD4FC,42321,4,7,3,43,47,2197
2260,2260,0B308F8177D01C3A8D264E73918BD4FC,10801,8,9,1,42,47,2147
2261,2261,0B308F8177D01C3A8D264E73918BD4FC,42321,11,15,4,43,47,2197
2262,2262,0B308F8177D01C3A8D264E73918BD4FC,13101,16,17,1,40,47,2047
2263,2263,0B308F8177D01C3A8D264E73918BD4FC,42321,17,23,6,43,47,2197
2264,2264,5B606639B0DDA81D89C67819EC5B7D64,13271,0,7,7,41,47,2097
2265,2265,5B606639B0DDA81D89C67819EC5B7D64,13101,10,11,1,40,47,2047
2266,2266,5B606639B0DDA81D89C67819EC5B7D64,13271,11,12,1,41,47,2097
2267,2267,5B606639B0DDA81D89C67819EC5B7D64,13101,13,15,2,40,47,2047
2268,2268,5B606639B0DDA81D89C67819EC5B7D64,13271,16,21,5,41,47,2097
2269,2269,3D4FBC2518533BED6EC2BBDFA4619398,11491,0,7,7,36,47,1847
2270,2270,3D4FBC2518533BED6EC2BBDFA4619398,10531,8,11,3,34,46,1746
2271,2271,3D4FBC2518533BED6EC2BBDFA4619398,11491,11,13,2,36,47,1847
2272,2272,3D4FBC2518533BED6EC2BBDFA4619398,11381,14,23,9,30,47,1547
2277,2277,951E4A9F24E81DD7E0BF78CE09FD6CB8,12611,0,6,6,41,29,2079
2278,2278,951E4A9F24E81DD7E0BF78CE09FD6CB8,15191,7,16,9,36,27,1827
2279,2279,951E4A9F24E81DD7E0BF78CE09FD6CB8,12792,16,18,2,34,30,1730
2280,2280,7A7976C668D0EB24AB546298DF5E61BE,12661,1,8,7,32,45,1645
2281,2281,7A7976C668D0EB24AB546298DF5E61BE,12731,8,11,3,22,40,1140
2282,2282,7A7976C668D0EB24AB546298DF5E61BE,12311,14,17,3,30,44,1544
2283,2283,7A7976C668D0EB24AB546298DF5E61BE,42151,20,21,1,35,45,1795
2284,2284,A173D95D10744F51E84E73DBC7C501E5,12514,7,9,2,38,47,1947
2285,2285,A173D95D10744F51E84E73DBC7C501E5,42581,9,16,7,38,48,1948
2286,2286,A173D95D10744F51E84E73DBC7C501E5,11954,18,19,1,32,49,1649
2287,2287,70E50AA138C0538910E5623295B506D8,42351,2,9,7,38,45,1945
2288,2288,70E50AA138C0538910E5623295B506D8,11261,9,10,1,36,46,1846
2289,2289,70E50AA138C0538910E5623295B506D8,42351,10,18,8,38,45,1945
2290,2290,70E50AA138C0538910E5623295B506D8,13911,19,20,1,39,46,1996
2291,2291,70E50AA138C0538910E5623295B506D8,11261,20,21,1,36,46,1846
2295,2295,43AA632E12ABCA3F01D2033AFFAEDEF3,10151,0,8,8,34,47,1747
2296,2296,43AA632E12ABCA3F01D2033AFFAEDEF3,19744,11,12,1,6,43,343
2297,2297,43AA632E12ABCA3F01D2033AFFAEDEF3,10151,12,14,2,34,47,1747
2298,2298,43AA632E12ABCA3F01D2033AFFAEDEF3,41591,15,17,2,34,49,1749
2299,2299,43AA632E12ABCA3F01D2033AFFAEDEF3,10151,17,23,6,34,47,1747
2300,2300,E2B478B35FF728C1A2A2F8166134A4FC,42301,0,7,7,36,47,1847
2301,2301,E2B478B35FF728C1A2A2F8166134A4FC,40124,9,12,3,38,47,1947
2302,2302,E2B478B35FF728C1A2A2F8166134A4FC,13821,14,15,1,49,45,2495
2303,2303,E2B478B35FF728C1A2A2F8166134A4FC,40124,18,21,3,38,47,1947
2304,2304,E2B478B35FF728C1A2A2F8166134A4FC,42941,21,22,1,37,47,1897
2305,2305,7861278735CDA91B9BABB196FBF7605C,43951,0,1,1,49,41,2491
2306,2306,7861278735CDA91B9BABB196FBF7605C,13411,2,4,2,49,42,2492
2307,2307,7861278735CDA91B9BABB196FBF7605C,43951,6,7,1,49,41,2491
2308,2308,7861278735CDA91B9BABB196FBF7605C,13411,7,8,1,49,42,2492
2309,2309,7861278735CDA91B9BABB196FBF7605C,13951,12,16,4,47,45,2395
2310,2310,7861278735CDA91B9BABB196FBF7605C,43951,17,20,3,49,41,2491
2315,2315,877B11B227A36AA9104653D0535EB383,12121,0,10,10,29,47,1497
2316,2316,877B11B227A36AA9104653D0535EB383,40341,12,16,4,23,49,1199
2317,2317,877B11B227A36AA9104653D0535EB383,12121,18,22,4,29,47,1497
2318,2318,86CF6119E10F18123CA8CD5F2D9246A8,42021,2,9,7,33,47,1697
2319,2319,86CF6119E10F18123CA8CD5F2D9246A8,42381,10,12,2,39,41,1991
2320,2320,86CF6119E10F18123CA8CD5F2D9246A8,40341,13,17,4,23,49,1199
2321,2321,86CF6119E10F18123CA8CD5F2D9246A8,42021,19,21,2,33,47,1697
2322,2322,A54E515E45C9983FF6CA2263317B045A,10711,0,7,7,29,46,1496
2323,2323,A54E515E45C9983FF6CA2263317B045A,11324,7,9,2,31,46,1596
2324,2324,A54E515E45C9983FF6CA2263317B045A,10281,19,20,1,33,48,1698
2325,2325,A54E515E45C9983FF6CA2263317B045A,42141,20,23,3,32,47,1647
2332,2332,ABCCD88A0E489E701C66A4C8C3515246,11331,0,14,14,37,48,1898
2333,2333,ABCCD88A0E489E701C66A4C8C3515246,10491,15,18,3,33,48,1698
2334,2334,ABCCD88A0E489E701C66A4C8C3515246,42621,18,19,1,24,49,1249
2335,2335,ABCCD88A0E489E701C66A4C8C3515246,10491,21,22,1,33,48,1698
2336,2336,DC15358175A492C6F21AAEFAD4CD0BB7,42161,0,10,10,36,47,1847
2337,2337,DC15358175A492C6F21AAEFAD4CD0BB7,43501,12,19,7,27,48,1398
2338,2338,DC15358175A492C6F21AAEFAD4CD0BB7,42401,21,23,2,36,47,1847
2339,2339,BC2C7ED50793849953B206E080DFFB52,42531,0,7,7,31,45,1595
2340,2340,BC2C7ED50793849953B206E080DFFB52,12311,9,11,2,30,44,1544
2341,2341,BC2C7ED50793849953B206E080DFFB52,40341,13,16,3,23,49,1199
2342,2342,BC2C7ED50793849953B206E080DFFB52,12311,18,19,1,30,44,1544
2349,2349,5522136C3A0E3B7CBA395E403A69B807,40073,9,12,3,37,48,1898
2350,2350,5522136C3A0E3B7CBA395E403A69B807,40463,12,13,1,38,49,1949
2351,2351,5522136C3A0E3B7CBA395E403A69B807,40341,19,21,2,23,49,1199
2362,2362,D86DB1BEA0F083F088F38431FE80102F,11324,0,8,8,31,46,1596
2363,2363,D86DB1BEA0F083F088F38431FE80102F,40341,9,16,7,23,49,1199
2364,2364,D86DB1BEA0F083F088F38431FE80102F,11324,20,23,3,31,46,1596
2365,2365,400659CE2E6F8BFF6D95D6F52F73DF5B,42921,0,5,5,33,47,1697
2366,2366,400659CE2E6F8BFF6D95D6F52F73DF5B,11861,5,11,6,32,47,1647
2367,2367,400659CE2E6F8BFF6D95D6F52F73DF5B,42921,11,13,2,33,47,1697
2368,2368,400659CE2E6F8BFF6D95D6F52F73DF5B,11861,13,19,6,32,47,1647
2369,2369,400659CE2E6F8BFF6D95D6F52F73DF5B,42921,21,23,2,33,47,1697
2370,2370,D1B681929BD44A1A7918A0268A3E43F0,12641,0,1,1,10,43,543
2371,2371,D1B681929BD44A1A7918A0268A3E43F0,43021,3,4,1,16,43,843
2372,2372,D1B681929BD44A1A7918A0268A3E43F0,12641,6,9,3,10,43,543
2373,2373,D1B681929BD44A1A7918A0268A3E43F0,43644,11,13,2,14,38,738
2374,2374,D1B681929BD44A1A7918A0268A3E43F0,12641,15,22,7,10,43,543
2375,2375,B7E4FDFF413A43CA71D45063D60CFDB6,11161,0,8,8,32,48,1648
2376,2376,B7E4FDFF413A43CA71D45063D60CFDB6,11481,12,15,3,41,48,2098
2377,2377,B7E4FDFF413A43CA71D45063D60CFDB6,11861,18,23,5,32,47,1647
2385,2385,B7685410B5F2070987C141F92E3D6247,42961,0,15,15,35,49,1799
2386,2386,B7685410B5F2070987C141F92E3D6247,13121,15,17,2,38,46,1946
2387,2387,B7685410B5F2070987C141F92E3D6247,42961,19,23,4,35,49,1799
2388,2388,671FB010BDB8AB18F1C7C189D2A5B267,42871,0,15,15,30,45,1545
2389,2389,671FB010BDB8AB18F1C7C189D2A5B267,11871,16,18,2,29,46,1496
2390,2390,671FB010BDB8AB18F1C7C189D2A5B267,11074,19,23,4,37,47,1897
2395,2395,29CCFF89800AD184CF93EA13427035C5,11741,10,14,4,42,49,2149
2396,2396,29CCFF89800AD184CF93EA13427035C5,40951,15,16,1,36,49,1849
2397,2397,29CCFF89800AD184CF93EA13427035C5,43621,20,22,2,46,48,2348
2398,2398,E234B5120D56DA23234C53D64CFEED38,11491,0,5,5,36,47,1847
2399,2399,E234B5120D56DA23234C53D64CFEED38,10271,6,7,1,37,46,1896
2400,2400,E234B5120D56DA23234C53D64CFEED38,11491,10,16,6,36,47,1847
2401,2401,E234B5120D56DA23234C53D64CFEED38,13121,16,17,1,38,46,1946
2402,2402,E234B5120D56DA23234C53D64CFEED38,11491,19,22,3,36,47,1847
2417,2417,2A1A9C67ED693DB686DC56860749C976,40637,0,11,11,36,47,1847
2418,2418,2A1A9C67ED693DB686DC56860749C976,42231,14,15,1,37,46,1896
2419,2419,2A1A9C67ED693DB686DC56860749C976,11901,18,19,1,42,49,2149
2423,2423,5C81004482023832AD545CD8F1DA1576,42231,6,7,1,37,46,1896
2424,2424,5C81004482023832AD545CD8F1DA1576,13911,8,9,1,39,46,1996
2425,2425,5C81004482023832AD545CD8F1DA1576,42231,9,17,8,37,46,1896
2426,2426,5C81004482023832AD545CD8F1DA1576,11261,17,18,1,36,46,1846
2427,2427,5C81004482023832AD545CD8F1DA1576,42231,18,20,2,37,46,1896
2428,2428,5C81004482023832AD545CD8F1DA1576,13911,20,23,3,39,46,1996
2432,2432,4FB7544A1E67AE742452DB3735E5F7CF,10771,0,6,6,41,46,2096
2433,2433,4FB7544A1E67AE742452DB3735E5F7CF,12561,7,9,2,45,43,2293
2434,2434,4FB7544A1E67AE742452DB3735E5F7CF,42631,13,17,4,43,45,2195
2435,2435,4FB7544A1E67AE742452DB3735E5F7CF,11001,19,21,2,42,47,2147
2436,2436,ED63CD6A523ED82BABC0C283513656AA,19114,0,8,8,7,43,393
2437,2437,ED63CD6A523ED82BABC0C283513656AA,42041,10,11,1,10,47,547
2438,2438,ED63CD6A523ED82BABC0C283513656AA,19441,11,17,6,8,46,446
2439,2439,ED63CD6A523ED82BABC0C283513656AA,42041,17,18,1,10,47,547
2440,2440,ED63CD6A523ED82BABC0C283513656AA,19441,18,21,3,8,46,446
2444,2444,F93FC485E5AA02DFA65C5E4A357B61F3,13101,0,7,7,40,47,2047
2445,2445,F93FC485E5AA02DFA65C5E4A357B61F3,11753,8,11,3,35,48,1798
2446,2446,F93FC485E5AA02DFA65C5E4A357B61F3,43731,12,13,1,34,47,1747
2447,2447,F93FC485E5AA02DFA65C5E4A357B61F3,11301,14,23,9,41,49,2099
2448,2448,E765D84E1BAC04688BB5332DDA62FCAC,42281,0,10,10,40,48,2048
2449,2449,E765D84E1BAC04688BB5332DDA62FCAC,43391,14,15,1,29,48,1498
2450,2450,E765D84E1BAC04688BB5332DDA62FCAC,10681,16,17,1,30,48,1548
2451,2451,E765D84E1BAC04688BB5332DDA62FCAC,11481,21,23,2,41,48,2098
2452,2452,11704FF17E4FD7E63ADE6C058CAD0DB1,43751,0,2,2,19,48,998
2453,2453,11704FF17E4FD7E63ADE6C058CAD0DB1,10061,3,9,6,20,46,1046
2454,2454,11704FF17E4FD7E63ADE6C058CAD0DB1,10251,11,23,12,35,47,1797
2459,2459,D0E3E3D3D7ABA8FA6CFDC84690231EAA,10341,0,12,12,31,47,1597
2460,2460,D0E3E3D3D7ABA8FA6CFDC84690231EAA,40341,16,17,1,23,49,1199
2461,2461,D0E3E3D3D7ABA8FA6CFDC84690231EAA,10341,18,19,1,31,47,1597
2462,2462,D0E3E3D3D7ABA8FA6CFDC84690231EAA,42491,20,21,1,32,46,1646
2470,2470,F64F82B99814EDA749801401A785F51A,43041,0,10,10,41,46,2096
2471,2471,F64F82B99814EDA749801401A785F51A,11921,11,18,7,38,48,1948
2472,2472,F64F82B99814EDA749801401A785F51A,43041,19,23,4,41,46,2096
2473,2473,AC5E2D2DBE4624330996B666281808FE,12131,5,9,4,32,47,1647
2474,2474,AC5E2D2DBE4624330996B666281808FE,10471,11,15,4,37,48,1898
2475,2475,AC5E2D2DBE4624330996B666281808FE,12131,19,20,1,32,47,1647
2476,2476,AC5E2D2DBE4624330996B666281808FE,42491,21,23,2,32,46,1646
2495,2495,11FECEE7865049CDA55CAB34FACD3089,12311,0,3,3,30,44,1544
2496,2496,11FECEE7865049CDA55CAB34FACD3089,42871,6,8,2,30,45,1545
2497,2497,11FECEE7865049CDA55CAB34FACD3089,11061,11,16,5,29,48,1498
2498,2498,11FECEE7865049CDA55CAB34FACD3089,11875,18,20,2,30,46,1546
2499,2499,823BB637426A4B64F4A56D087D45C241,12921,7,12,5,9,41,491
2500,2500,823BB637426A4B64F4A56D087D45C241,49201,13,14,1,7,41,391
2501,2501,823BB637426A4B64F4A56D087D45C241,12921,15,18,3,9,41,491
2502,2502,823BB637426A4B64F4A56D087D45C241,49201,19,20,1,7,41,391
2503,2503,823BB637426A4B64F4A56D087D45C241,12641,20,23,3,10,43,543
2510,2510,F8320AC02FAC6F4A311CBF8892D02227,15411,8,10,2,44,27,2227
2511,2511,F8320AC02FAC6F4A311CBF8892D02227,13251,10,11,1,48,28,2428
2512,2512,F8320AC02FAC6F4A311CBF8892D02227,15411,11,20,9,44,27,2227
2513,2513,F8320AC02FAC6F4A311CBF8892D02227,13251,21,23,2,48,28,2428
2514,2514,CE155B610E3EDB8ECA1DCB73ED422C8D,12571,0,8,8,48,39,2439
2515,2515,CE155B610E3EDB8ECA1DCB73ED422C8D,43101,9,10,1,46,40,2340
2516,2516,CE155B610E3EDB8ECA1DCB73ED422C8D,12571,11,15,4,48,39,2439
2517,2517,CE155B610E3EDB8ECA1DCB73ED422C8D,43101,16,17,1,46,40,2340
2518,2518,CE155B610E3EDB8ECA1DCB73ED422C8D,12571,19,21,2,48,39,2439
2526,2526,3343C0EB8E0F4F8050DD19670396B99E,11875,0,7,7,30,46,1546
2527,2527,3343C0EB8E0F4F8050DD19670396B99E,42871,9,13,4,30,45,1545
2528,2528,3343C0EB8E0F4F8050DD19670396B99E,11875,14,15,1,30,46,1546
2529,2529,3343C0EB8E0F4F8050DD19670396B99E,40951,17,20,3,36,49,1849
2530,2530,3343C0EB8E0F4F8050DD19670396B99E,13651,22,23,1,30,47,1547
2531,2531,16D740AE27D92BE968DE244652195181,13671,1,7,6,27,43,1393
2532,2532,16D740AE27D92BE968DE244652195181,13314,9,10,1,31,39,1589
2533,2533,16D740AE27D92BE968DE244652195181,13671,12,21,9,27,43,1393
2537,2537,28C9421C06020E26AE9FBA6D6D7188F9,13231,2,6,4,39,46,1996
2538,2538,28C9421C06020E26AE9FBA6D6D7188F9,13841,6,7,1,40,46,2046
2539,2539,28C9421C06020E26AE9FBA6D6D7188F9,11231,12,21,9,37,49,1899
2540,2540,CC9014FC196BC06D34CCADB91E1ECFC5,42021,0,1,1,33,47,1697
2541,2541,CC9014FC196BC06D34CCADB91E1ECFC5,11061,2,9,7,29,48,1498
2542,2542,CC9014FC196BC06D34CCADB91E1ECFC5,10731,11,16,5,33,47,1697
2543,2543,CC9014FC196BC06D34CCADB91E1ECFC5,19441,19,20,1,8,46,446
2544,2544,CC9014FC196BC06D34CCADB91E1ECFC5,19621,22,23,1,5,46,296
2557,2557,7179E8D23C9EF0FE56A034B0F52DF3EB,42071,0,5,5,31,49,1599
2558,2558,7179E8D23C9EF0FE56A034B0F52DF3EB,42623,6,7,1,22,49,1149
2559,2559,7179E8D23C9EF0FE56A034B0F52DF3EB,42071,9,11,2,31,49,1599
2560,2560,7179E8D23C9EF0FE56A034B0F52DF3EB,42623,12,15,3,22,49,1149
2561,2561,7179E8D23C9EF0FE56A034B0F52DF3EB,42071,15,16,1,31,49,1599
2562,2562,7179E8D23C9EF0FE56A034B0F52DF3EB,42623,17,22,5,22,49,1149
2563,2563,AE9210FE4397D0EFA5D520EE9DB8E420,10661,1,6,5,37,49,1899
2564,2564,AE9210FE4397D0EFA5D520EE9DB8E420,11021,9,11,2,36,49,1849
2565,2565,AE9210FE4397D0EFA5D520EE9DB8E420,11481,13,15,2,41,48,2098
2566,2566,AE9210FE4397D0EFA5D520EE9DB8E420,12481,18,20,2,37,49,1899
2567,2567,C96AF7724AE07D1D1BE56C246C9FE7FC,13341,1,2,1,44,45,2245
2568,2568,C96AF7724AE07D1D1BE56C246C9FE7FC,42461,3,7,4,45,47,2297
2569,2569,C96AF7724AE07D1D1BE56C246C9FE7FC,12221,9,10,1,43,44,2194
2570,2570,C96AF7724AE07D1D1BE56C246C9FE7FC,42461,12,14,2,45,47,2297
2571,2571,C96AF7724AE07D1D1BE56C246C9FE7FC,12491,19,20,1,36,43,1843
2575,2575,1524472E0F488196485345CA30C18599,13371,0,8,8,41,47,2097
2576,2576,1524472E0F488196485345CA30C18599,41101,9,12,3,32,48,1648
2577,2577,1524472E0F488196485345CA30C18599,13371,12,18,6,41,47,2097
2578,2578,1524472E0F488196485345CA30C18599,42981,19,20,1,36,49,1849
2579,2579,3FC8D67795F3EEA8407598FCF167D900,13331,0,2,2,38,47,1947
2580,2580,3FC8D67795F3EEA8407598FCF167D900,13381,2,3,1,39,47,1997
2581,2581,3FC8D67795F3EEA8407598FCF167D900,13331,4,8,4,38,47,1947
2582,2582,3FC8D67795F3EEA8407598FCF167D900,42511,9,10,1,37,47,1897
2583,2583,3FC8D67795F3EEA8407598FCF167D900,13331,11,19,8,38,47,1947
2584,2584,3FC8D67795F3EEA8407598FCF167D900,42231,21,22,1,37,46,1896
2588,2588,F3AEB1F515C71F7796F27FC530C1BB14,19441,0,6,6,8,46,446
2589,2589,F3AEB1F515C71F7796F27FC530C1BB14,11381,9,12,3,30,47,1547
2590,2590,F3AEB1F515C71F7796F27FC530C1BB14,11061,13,14,1,29,48,1498
2591,2591,F3AEB1F515C71F7796F27FC530C1BB14,42041,18,19,1,10,47,547
2592,2592,7C2FA5CEA73141A81877A1173A887B3A,42501,9,14,5,28,47,1447
2593,2593,7C2FA5CEA73141A81877A1173A887B3A,40341,14,17,3,23,49,1199
2594,2594,7C2FA5CEA73141A81877A1173A887B3A,12121,18,19,1,29,47,1497
2595,2595,7C2FA5CEA73141A81877A1173A887B3A,42501,20,23,3,28,47,1447
2596,2596,3668A484BABF64A24B33B58BBBC417A2,42491,0,8,8,32,46,1646
2597,2597,3668A484BABF64A24B33B58BBBC417A2,42633,9,11,2,42,46,2146
2598,2598,3668A484BABF64A24B33B58BBBC417A2,42491,13,23,10,32,46,1646
2602,2602,EA84EDCB7C9475F6273168934FDD6476,19441,0,6,6,8,46,446
2603,2603,EA84EDCB7C9475F6273168934FDD6476,11571,6,8,2,13,46,696
2604,2604,EA84EDCB7C9475F6273168934FDD6476,42041,8,10,2,10,47,547
2605,2605,EA84EDCB7C9475F6273168934FDD6476,19441,13,15,2,8,46,446
2606,2606,EA84EDCB7C9475F6273168934FDD6476,42041,18,19,1,10,47,547
2611,2611,5AF85D9ED958D0E5348613692DAC5B4D,11201,0,2,2,35,49,1799
2612,2612,5AF85D9ED958D0E5348613692DAC5B4D,10901,2,10,8,35,48,1798
2613,2613,5AF85D9ED958D0E5348613692DAC5B4D,12083,11,14,3,36,49,1849
2614,2614,5AF85D9ED958D0E5348613692DAC5B4D,10061,17,18,1,20,46,1046
2615,2615,5AF85D9ED958D0E5348613692DAC5B4D,11231,19,20,1,37,49,1899
2616,2616,5AF85D9ED958D0E5348613692DAC5B4D,11201,22,23,1,35,49,1799
2617,2617,13DB42C49EC9ED45CF6537DBB88A08A0,42151,0,2,2,35,45,1795
2618,2618,13DB42C49EC9ED45CF6537DBB88A08A0,42531,5,11,6,31,45,1595
2619,2619,13DB42C49EC9ED45CF6537DBB88A08A0,42151,13,15,2,35,45,1795
2620,2620,13DB42C49EC9ED45CF6537DBB88A08A0,12311,15,17,2,30,44,1544
2621,2621,13DB42C49EC9ED45CF6537DBB88A08A0,42151,20,22,2,35,45,1795
2622,2622,525655B30753832E11A6455806FEB5D9,13711,0,9,9,38,46,1946
2623,2623,525655B30753832E11A6455806FEB5D9,40094,14,15,1,29,48,1498
2624,2624,525655B30753832E11A6455806FEB5D9,43361,18,21,3,38,48,1948
2625,2625,7701963A2D83F69D6570AFE709E8D139,19744,0,1,1,6,43,343
2626,2626,7701963A2D83F69D6570AFE709E8D139,19031,1,2,1,1,42,92
2627,2627,7701963A2D83F69D6570AFE709E8D139,19744,3,4,1,6,43,343
2628,2628,7701963A2D83F69D6570AFE709E8D139,12921,8,10,2,9,41,491
2629,2629,7701963A2D83F69D6570AFE709E8D139,12641,18,19,1,10,43,543
2630,2630,7701963A2D83F69D6570AFE709E8D139,19744,21,22,1,6,43,343
2631,2631,C3E7E27638EA741DDDE69937A4FC718E,19181,0,6,6,8,40,440
2632,2632,C3E7E27638EA741DDDE69937A4FC718E,49201,8,9,1,7,41,391
2633,2633,C3E7E27638EA741DDDE69937A4FC718E,43644,12,18,6,14,38,738
2638,2638,92E1BAA88B052422B820ED36A9E8F107,41392,0,6,6,43,48,2198
2639,2639,92E1BAA88B052422B820ED36A9E8F107,40171,7,10,3,38,48,1948
2640,2640,92E1BAA88B052422B820ED36A9E8F107,41392,12,14,2,43,48,2198
2641,2641,92E1BAA88B052422B820ED36A9E8F107,40171,14,16,2,38,48,1948
2642,2642,92E1BAA88B052422B820ED36A9E8F107,41392,20,22,2,43,48,2198
2643,2643,2AD3F2884E18AD0482D962206C918704,11271,2,8,6,37,48,1898
2644,2644,2AD3F2884E18AD0482D962206C918704,11351,10,12,2,36,48,1848
2645,2645,2AD3F2884E18AD0482D962206C918704,11231,12,14,2,37,49,1899
2646,2646,2AD3F2884E18AD0482D962206C918704,12083,15,16,1,36,49,1849
2647,2647,2AD3F2884E18AD0482D962206C918704,11351,20,23,3,36,48,1848
2651,2651,FD75B7EE8A679BE3555E4529F550725B,42161,0,12,12,36,47,1847
2652,2652,FD75B7EE8A679BE3555E4529F550725B,43161,12,13,1,35,47,1797
2653,2653,FD75B7EE8A679BE3555E4529F550725B,42161,14,15,1,36,47,1847
2654,2654,FD75B7EE8A679BE3555E4529F550725B,40341,16,17,1,23,49,1199
2655,2655,FD75B7EE8A679BE3555E4529F550725B,42161,18,21,3,36,47,1847
2656,2656,FD75B7EE8A679BE3555E4529F550725B,43161,22,23,1,35,47,1797
2657,2657,B293D0904747D1E5B83274515439040B,11211,0,1,1,34,49,1749
2658,2658,B293D0904747D1E5B83274515439040B,42471,1,3,2,35,49,1799
2659,2659,B293D0904747D1E5B83274515439040B,11211,3,7,4,34,49,1749
2660,2660,B293D0904747D1E5B83274515439040B,40261,12,15,3,35,49,1799
2661,2661,B293D0904747D1E5B83274515439040B,13711,18,21,3,38,46,1946
2662,2662,B293D0904747D1E5B83274515439040B,40463,22,23,1,38,49,1949
2673,2673,F06696253146EEBB7842F43A19CD992F,43121,7,8,1,25,27,1277
2674,2674,F06696253146EEBB7842F43A19CD992F,12871,13,14,1,22,33,1133
2675,2675,F06696253146EEBB7842F43A19CD992F,19801,14,17,3,19,26,976
2676,2676,F06696253146EEBB7842F43A19CD992F,12871,20,21,1,22,33,1133
2685,2685,BC1C4C76663B580E82BC58287DEF604A,19281,1,11,10,16,32,832
2686,2686,BC1C4C76663B580E82BC58287DEF604A,12871,15,18,3,22,33,1133
2687,2687,BC1C4C76663B580E82BC58287DEF604A,19281,18,20,2,16,32,832
2688,2688,BC1C4C76663B580E82BC58287DEF604A,12874,20,21,1,20,34,1034
2696,2696,088874D8FFB9880A3AB7584004E8CCF9,42861,10,12,2,37,44,1894
2697,2697,088874D8FFB9880A3AB7584004E8CCF9,42151,15,16,1,35,45,1795
2698,2698,088874D8FFB9880A3AB7584004E8CCF9,12491,16,20,4,36,43,1843
2699,2699,088874D8FFB9880A3AB7584004E8CCF9,10651,22,23,1,36,49,1849
2704,2704,FFEA4CB7E5D4908CD6175B5CEA940814,10191,0,14,14,40,48,2048
2705,2705,FFEA4CB7E5D4908CD6175B5CEA940814,40341,15,17,2,23,49,1199
2706,2706,FFEA4CB7E5D4908CD6175B5CEA940814,10191,19,23,4,40,48,2048
2707,2707,392F2B932A839BB0C6F602E5FA556570,11074,0,15,15,37,47,1897
2708,2708,392F2B932A839BB0C6F602E5FA556570,15331,17,18,1,38,24,1924
2709,2709,392F2B932A839BB0C6F602E5FA556570,11074,20,23,3,37,47,1897
2714,2714,F601F492A1C4AFF2186642420E496A03,49201,0,2,2,7,41,391
2715,2715,F601F492A1C4AFF2186642420E496A03,12641,2,4,2,10,43,543
2716,2716,F601F492A1C4AFF2186642420E496A03,49201,4,13,9,7,41,391
2717,2717,F601F492A1C4AFF2186642420E496A03,12921,17,19,2,9,41,491
2718,2718,F601F492A1C4AFF2186642420E496A03,49201,21,23,2,7,41,391
2723,2723,44252BDD34C9CED88CB823A21BA118E7,10841,10,11,1,37,47,1897
2724,2724,44252BDD34C9CED88CB823A21BA118E7,11021,11,13,2,36,49,1849
2725,2725,44252BDD34C9CED88CB823A21BA118E7,19181,15,17,2,8,40,440
2726,2726,44252BDD34C9CED88CB823A21BA118E7,40891,20,22,2,37,47,1897
2727,2727,B93C16A242FE2C6BDA83A87AD4FAA434,12601,0,6,6,25,47,1297
2728,2728,B93C16A242FE2C6BDA83A87AD4FAA434,10501,7,9,2,22,46,1146
2729,2729,B93C16A242FE2C6BDA83A87AD4FAA434,12601,11,14,3,25,47,1297
2730,2730,B93C16A242FE2C6BDA83A87AD4FAA434,10501,14,16,2,22,46,1146
2731,2731,B93C16A242FE2C6BDA83A87AD4FAA434,12601,17,20,3,25,47,1297
2732,2732,B93C16A242FE2C6BDA83A87AD4FAA434,10501,21,23,2,22,46,1146
2733,2733,5F2B7640725B4972B38C79BCE5AB49C5,13331,1,9,8,38,47,1947
2734,2734,5F2B7640725B4972B38C79BCE5AB49C5,40341,10,12,2,23,49,1199
2735,2735,5F2B7640725B4972B38C79BCE5AB49C5,13094,12,15,3,21,42,1092
2736,2736,5F2B7640725B4972B38C79BCE5AB49C5,13331,22,23,1,38,47,1947
2737,2737,7EF134DC4AA448D8CF4E13C9163629DD,40171,1,3,2,38,48,1948
2738,2738,7EF134DC4AA448D8CF4E13C9163629DD,10731,4,8,4,33,47,1697
2739,2739,7EF134DC4AA448D8CF4E13C9163629DD,13601,9,12,3,34,47,1747
2740,2740,7EF134DC4AA448D8CF4E13C9163629DD,42021,12,16,4,33,47,1697
2741,2741,7EF134DC4AA448D8CF4E13C9163629DD,19441,18,20,2,8,46,446
2742,2742,7EF134DC4AA448D8CF4E13C9163629DD,19621,21,22,1,5,46,296
2743,2743,C952F6311F45A99604AB187276235BD1,10251,0,11,11,35,47,1797
2744,2744,C952F6311F45A99604AB187276235BD1,40341,14,16,2,23,49,1199
2745,2745,C952F6311F45A99604AB187276235BD1,10251,19,22,3,35,47,1797
2746,2746,A534FD7E51A551BE3196665029DD0400,19931,0,4,4,7,43,393
2747,2747,A534FD7E51A551BE3196665029DD0400,19031,7,12,5,1,42,92
2748,2748,A534FD7E51A551BE3196665029DD0400,12641,12,19,7,10,43,543
2749,2749,A534FD7E51A551BE3196665029DD0400,19931,21,23,2,7,43,393
2750,2750,660D0729A871FB18966DF6415A58AEF7,11381,7,9,2,30,47,1547
2751,2751,660D0729A871FB18966DF6415A58AEF7,11211,10,12,2,34,49,1749
2752,2752,660D0729A871FB18966DF6415A58AEF7,11061,17,18,1,29,48,1498
2753,2753,660D0729A871FB18966DF6415A58AEF7,11381,18,22,4,30,47,1547
2754,2754,1718224804A8248FA5EAEB1E0784A53E,11861,0,12,12,32,47,1647
2755,2755,1718224804A8248FA5EAEB1E0784A53E,10107,13,15,2,38,49,1949
2756,2756,1718224804A8248FA5EAEB1E0784A53E,43761,16,19,3,32,47,1647
2757,2757,1718224804A8248FA5EAEB1E0784A53E,11061,20,21,1,29,48,1498
2758,2758,290CF9B7E8E39B2A6D619522168B66C7,19441,0,7,7,8,46,446
2759,2759,290CF9B7E8E39B2A6D619522168B66C7,43841,12,13,1,40,37,2037
2760,2760,290CF9B7E8E39B2A6D619522168B66C7,42801,15,16,1,40,49,2049
2761,2761,290CF9B7E8E39B2A6D619522168B66C7,19441,17,23,6,8,46,446
2765,2765,9BBBC00C93BA6A3176E2B008E6F8A88E,13911,0,5,5,39,46,1996
2766,2766,9BBBC00C93BA6A3176E2B008E6F8A88E,11261,5,11,6,36,46,1846
2767,2767,9BBBC00C93BA6A3176E2B008E6F8A88E,13911,11,13,2,39,46,1996
2768,2768,9BBBC00C93BA6A3176E2B008E6F8A88E,11261,13,17,4,36,46,1846
2769,2769,9BBBC00C93BA6A3176E2B008E6F8A88E,13911,19,21,2,39,46,1996
2770,2770,C42F4D358B434058D63F50357AB3111D,42321,0,6,6,43,47,2197
2771,2771,C42F4D358B434058D63F50357AB3111D,10841,7,9,2,37,47,1897
2772,2772,C42F4D358B434058D63F50357AB3111D,42301,12,14,2,36,47,1847
2773,2773,C42F4D358B434058D63F50357AB3111D,10841,15,17,2,37,47,1897
2774,2774,C42F4D358B434058D63F50357AB3111D,10801,19,20,1,42,47,2147
2778,2778,EFCBAB639755CB78156C2E81B94AFAB4,42281,2,4,2,40,48,2048
2779,2779,EFCBAB639755CB78156C2E81B94AFAB4,11921,4,5,1,38,48,1948
2780,2780,EFCBAB639755CB78156C2E81B94AFAB4,42281,6,10,4,40,48,2048
2781,2781,EFCBAB639755CB78156C2E81B94AFAB4,10591,12,13,1,39,48,1998
2782,2782,EFCBAB639755CB78156C2E81B94AFAB4,42221,17,18,1,38,48,1948
2783,2783,EE107F15123C6DB132974358298F51B4,42583,0,13,13,40,48,2048
2784,2784,EE107F15123C6DB132974358298F51B4,11914,14,16,2,37,48,1898
2785,2785,EE107F15123C6DB132974358298F51B4,40171,16,18,2,38,48,1948
2786,2786,EE107F15123C6DB132974358298F51B4,42583,19,20,1,40,48,2048
2787,2787,EE107F15123C6DB132974358298F51B4,11291,21,22,1,40,49,2049
2788,2788,9B486689278BE374093A259A43CD5B5C,10281,0,6,6,33,48,1698
2789,2789,9B486689278BE374093A259A43CD5B5C,10351,9,11,2,28,45,1445
2790,2790,9B486689278BE374093A259A43CD5B5C,42141,12,17,5,32,47,1647
2791,2791,9B486689278BE374093A259A43CD5B5C,10281,22,23,1,33,48,1698
2795,2795,C5DB1A1E870205D37CECFE50CB6195A9,10331,0,9,9,39,46,1996
2796,2796,C5DB1A1E870205D37CECFE50CB6195A9,15411,10,11,1,44,27,2227
2797,2797,C5DB1A1E870205D37CECFE50CB6195A9,13251,12,13,1,48,28,2428
2798,2798,C5DB1A1E870205D37CECFE50CB6195A9,11531,17,20,3,34,49,1749
2799,2799,C5DB1A1E870205D37CECFE50CB6195A9,10331,22,23,1,39,46,1996
2800,2800,931D1B9D3F88D7DAF9B270F67C939CF9,40331,0,6,6,30,47,1547
2801,2801,931D1B9D3F88D7DAF9B270F67C939CF9,13941,7,9,2,41,47,2097
2802,2802,931D1B9D3F88D7DAF9B270F67C939CF9,11061,18,19,1,29,48,1498
2803,2803,931D1B9D3F88D7DAF9B270F67C939CF9,11381,22,23,1,30,47,1547
2804,2804,AA469B3E094431C7C24AA5EAC2184992,43471,2,13,11,31,49,1599
2805,2805,AA469B3E094431C7C24AA5EAC2184992,42623,17,18,1,22,49,1149
2806,2806,AA469B3E094431C7C24AA5EAC2184992,43471,19,23,4,31,49,1599
2807,2807,D53BBB9B618478B075FC0E11D59C8E5C,11271,0,7,7,37,48,1898
2808,2808,D53BBB9B618478B075FC0E11D59C8E5C,19021,9,17,8,10,45,545
2809,2809,D53BBB9B618478B075FC0E11D59C8E5C,11271,18,23,5,37,48,1898
2810,2810,E4D6271627F68F0A6924319AF3674CF6,10281,0,9,9,33,48,1698
2811,2811,E4D6271627F68F0A6924319AF3674CF6,12311,12,13,1,30,44,1544
2812,2812,E4D6271627F68F0A6924319AF3674CF6,11161,17,20,3,32,48,1648
2813,2813,DE69FEBC50432F9871EF62D07F7A5C1A,12641,2,3,1,10,43,543
2814,2814,DE69FEBC50432F9871EF62D07F7A5C1A,19021,4,5,1,10,45,545
2815,2815,DE69FEBC50432F9871EF62D07F7A5C1A,19181,7,12,5,8,40,440
2816,2816,DE69FEBC50432F9871EF62D07F7A5C1A,43644,12,14,2,14,38,738
2817,2817,DE69FEBC50432F9871EF62D07F7A5C1A,19181,18,21,3,8,40,440
2818,2818,296E7B917A1C9BBE703645D1D7E31230,11231,0,8,8,37,49,1899
2819,2819,296E7B917A1C9BBE703645D1D7E31230,10901,10,13,3,35,48,1798
2820,2820,296E7B917A1C9BBE703645D1D7E31230,11231,14,16,2,37,49,1899
2821,2821,296E7B917A1C9BBE703645D1D7E31230,11731,17,21,4,36,48,1848
2822,2822,296E7B917A1C9BBE703645D1D7E31230,11231,21,22,1,37,49,1899
2830,2830,D5AEB0275C07F9A43E4282B7A52A66F5,11061,0,13,13,29,48,1498
2831,2831,D5AEB0275C07F9A43E4282B7A52A66F5,40951,18,20,2,36,49,1849
2832,2832,D5AEB0275C07F9A43E4282B7A52A66F5,11061,21,23,2,29,48,1498
2833,2833,04D73C3CD00D40CB611F6BA5801F802C,13314,0,13,13,31,39,1589
2834,2834,04D73C3CD00D40CB611F6BA5801F802C,12521,15,18,3,35,41,1791
2835,2835,04D73C3CD00D40CB611F6BA5801F802C,13314,19,23,4,31,39,1589
2836,2836,7B654C3798CB89CF9AFEC7720C14AC66,41393,0,10,10,43,49,2199
2837,2837,7B654C3798CB89CF9AFEC7720C14AC66,43051,13,19,6,46,45,2345
2838,2838,7B654C3798CB89CF9AFEC7720C14AC66,41393,20,21,1,43,49,2199
2839,2839,D3B816A66DD89A202275F936B44B8244,11861,0,7,7,32,47,1647
2840,2840,D3B816A66DD89A202275F936B44B8244,12021,11,13,2,37,49,1899
2841,2841,D3B816A66DD89A202275F936B44B8244,11861,14,16,2,32,47,1647
2842,2842,D3B816A66DD89A202275F936B44B8244,11211,21,22,1,34,49,1749
2843,2843,87EA98F6DB0A80D4C1E433FC304DD805,40636,0,1,1,35,48,1798
2844,2844,87EA98F6DB0A80D4C1E433FC304DD805,11061,1,19,18,29,48,1498
2845,2845,87EA98F6DB0A80D4C1E433FC304DD805,43361,22,23,1,38,48,1948
2849,2849,BE35BD29F0A392EE036220327B804613,11701,0,6,6,43,48,2198
2850,2850,BE35BD29F0A392EE036220327B804613,10251,8,18,10,35,47,1797
2851,2851,BE35BD29F0A392EE036220327B804613,11701,21,23,2,43,48,2198
2861,2861,AF48B8274EF204750841FA6014372B51,10491,0,7,7,33,48,1698
2862,2862,AF48B8274EF204750841FA6014372B51,13091,14,15,1,20,42,1042
2863,2863,AF48B8274EF204750841FA6014372B51,43731,17,18,1,34,47,1747
2864,2864,AF48B8274EF204750841FA6014372B51,10491,21,23,2,33,48,1698
2865,2865,9526CA84048ECDF651C5107129654F39,15145,0,15,15,22,9,1109
2866,2866,9526CA84048ECDF651C5107129654F39,16151,15,17,2,13,11,661
2867,2867,9526CA84048ECDF651C5107129654F39,15145,19,23,4,22,9,1109
2868,2868,F03C4FDCA7049DEDC319C1816D5644A4,13111,0,11,11,42,46,2146
2869,2869,F03C4FDCA7049DEDC319C1816D5644A4,43061,11,13,2,43,46,2196
2870,2870,F03C4FDCA7049DEDC319C1816D5644A4,42921,16,18,2,33,47,1697
2874,2874,1392494D57B796B91B75A7B60FEEA3EE,42161,1,6,5,36,47,1847
2875,2875,1392494D57B796B91B75A7B60FEEA3EE,10251,7,8,1,35,47,1797
2876,2876,1392494D57B796B91B75A7B60FEEA3EE,16071,13,16,3,3,3,153
2877,2877,1392494D57B796B91B75A7B60FEEA3EE,16184,18,19,1,1,1,51
2878,2878,1392494D57B796B91B75A7B60FEEA3EE,16211,20,23,3,4,3,203
2886,2886,8FFDEB2573593D2EBFD07303D94AB87F,42321,0,17,17,43,47,2197
2887,2887,8FFDEB2573593D2EBFD07303D94AB87F,11541,18,20,2,35,49,1799
2888,2888,8FFDEB2573593D2EBFD07303D94AB87F,42321,20,23,3,43,47,2197
2889,2889,E8F01E707ECDEF9641A4C634D7B210CC,41393,2,8,6,43,49,2199
2890,2890,E8F01E707ECDEF9641A4C634D7B210CC,42021,12,16,4,33,47,1697
2891,2891,E8F01E707ECDEF9641A4C634D7B210CC,19441,19,21,2,8,46,446
2896,2896,19B7F0CF3E3FD886B38254D17C1F93A2,12311,0,6,6,30,44,1544
2897,2897,19B7F0CF3E3FD886B38254D17C1F93A2,10301,9,11,2,31,45,1595
2898,2898,19B7F0CF3E3FD886B38254D17C1F93A2,12311,16,17,1,30,44,1544
2899,2899,19B7F0CF3E3FD886B38254D17C1F93A2,42021,20,23,3,33,47,1697
2900,2900,E78E0ABBE194ABEE97C2D7DD94378A1C,10121,0,6,6,36,49,1849
2901,2901,E78E0ABBE194ABEE97C2D7DD94378A1C,12971,9,11,2,32,48,1648
2902,2902,E78E0ABBE194ABEE97C2D7DD94378A1C,10121,11,23,12,36,49,1849
2903,2903,F2E0A788EC41736380A7AB3495E7AB34,42161,0,6,6,36,47,1847
2904,2904,F2E0A788EC41736380A7AB3495E7AB34,12051,7,18,11,20,47,1047
2905,2905,F2E0A788EC41736380A7AB3495E7AB34,42161,19,23,4,36,47,1847
2909,2909,6CA2209D62B6706E5E59A4258E6B7718,13671,0,4,4,27,43,1393
2910,2910,6CA2209D62B6706E5E59A4258E6B7718,13091,4,6,2,20,42,1042
2911,2911,6CA2209D62B6706E5E59A4258E6B7718,13671,6,15,9,27,43,1393
2912,2912,6CA2209D62B6706E5E59A4258E6B7718,42351,19,20,1,38,45,1945
2917,2917,7D8BB90B66B5BB302B836A7DB354A71B,42601,0,6,6,44,48,2248
2918,2918,7D8BB90B66B5BB302B836A7DB354A71B,42321,8,9,1,43,47,2197
2919,2919,7D8BB90B66B5BB302B836A7DB354A71B,11701,9,10,1,43,48,2198
2920,2920,7D8BB90B66B5BB302B836A7DB354A71B,42601,12,14,2,44,48,2248
2921,2921,7D8BB90B66B5BB302B836A7DB354A71B,42321,14,21,7,43,47,2197
2922,2922,DE5F96E34E99D2F6A2C0DEB645C43B1D,11806,1,5,4,41,48,2098
2923,2923,DE5F96E34E99D2F6A2C0DEB645C43B1D,42581,6,7,1,38,48,1948
2924,2924,DE5F96E34E99D2F6A2C0DEB645C43B1D,42271,8,9,1,40,47,2047
2925,2925,DE5F96E34E99D2F6A2C0DEB645C43B1D,10107,12,17,5,38,49,1949
2926,2926,DE5F96E34E99D2F6A2C0DEB645C43B1D,42221,19,21,2,38,48,1948
2931,2931,6869A5F90DBC32E3AB5337DBC7DAA2BA,43951,10,17,7,49,41,2491
2932,2932,6869A5F90DBC32E3AB5337DBC7DAA2BA,42151,19,20,1,35,45,1795
2933,2933,6869A5F90DBC32E3AB5337DBC7DAA2BA,12491,21,23,2,36,43,1843
2934,2934,FE4547C9BDE2F0CE3554897F6352AE34,43011,0,6,6,40,42,2042
2935,2935,FE4547C9BDE2F0CE3554897F6352AE34,43451,7,8,1,37,40,1890
2936,2936,FE4547C9BDE2F0CE3554897F6352AE34,43011,11,13,2,40,42,2042
2937,2937,FE4547C9BDE2F0CE3554897F6352AE34,43451,14,17,3,37,40,1890
2938,2938,FE4547C9BDE2F0CE3554897F6352AE34,11231,21,23,2,37,49,1899
2942,2942,C069A0126B5D5D8D81FDB27FE9AA5203,40381,0,7,7,32,46,1646
2943,2943,C069A0126B5D5D8D81FDB27FE9AA5203,11791,11,12,1,38,49,1949
2944,2944,C069A0126B5D5D8D81FDB27FE9AA5203,40381,13,23,10,32,46,1646
2945,2945,D01E401FAFCE77494265233990B95230,11231,6,10,4,37,49,1899
2946,2946,D01E401FAFCE77494265233990B95230,40341,14,17,3,23,49,1199
2947,2947,D01E401FAFCE77494265233990B95230,11231,18,19,1,37,49,1899
2948,2948,D01E401FAFCE77494265233990B95230,42961,21,23,2,35,49,1799
2949,2949,D6932FB45D03368B8FD3FCD5E6F4054F,13561,0,8,8,37,49,1899
2950,2950,D6932FB45D03368B8FD3FCD5E6F4054F,11875,12,13,1,30,46,1546
2951,2951,D6932FB45D03368B8FD3FCD5E6F4054F,12021,14,20,6,37,49,1899
2952,2952,D6932FB45D03368B8FD3FCD5E6F4054F,42281,22,23,1,40,48,2048
2953,2953,84D6F944A9720742D92DF6BE4B5D36E6,12141,1,3,2,42,45,2145
2954,2954,84D6F944A9720742D92DF6BE4B5D36E6,12561,4,6,2,45,43,2293
2955,2955,84D6F944A9720742D92DF6BE4B5D36E6,12141,6,10,4,42,45,2145
2956,2956,84D6F944A9720742D92DF6BE4B5D36E6,13341,10,12,2,44,45,2245
2957,2957,84D6F944A9720742D92DF6BE4B5D36E6,12561,15,22,7,45,43,2293
2962,2962,E3B088F7DEFCCE4BD4EB6ADB8F0E5950,12514,7,9,2,38,47,1947
2963,2963,E3B088F7DEFCCE4BD4EB6ADB8F0E5950,10841,9,11,2,37,47,1897
2964,2964,E3B088F7DEFCCE4BD4EB6ADB8F0E5950,12131,16,21,5,32,47,1647
2965,2965,656752102BA99654C7060CE5B2133D72,19114,0,5,5,7,43,393
2966,2966,656752102BA99654C7060CE5B2133D72,12921,6,11,5,9,41,491
2967,2967,656752102BA99654C7060CE5B2133D72,19114,12,13,1,7,43,393
2968,2968,656752102BA99654C7060CE5B2133D72,12921,14,18,4,9,41,491
2969,2969,656752102BA99654C7060CE5B2133D72,19114,20,22,2,7,43,393
2970,2970,4758180F09203E5FD5F58618A9F360BF,11381,0,7,7,30,47,1547
2971,2971,4758180F09203E5FD5F58618A9F360BF,10431,7,8,1,33,49,1699
2972,2972,4758180F09203E5FD5F58618A9F360BF,11061,13,16,3,29,48,1498
2973,2973,4758180F09203E5FD5F58618A9F360BF,11791,17,18,1,38,49,1949
2974,2974,4758180F09203E5FD5F58618A9F360BF,10401,19,20,1,33,49,1699
2975,2975,9F1824F4E1493708E44E02E9F071631E,11161,0,6,6,32,48,1648
2976,2976,9F1824F4E1493708E44E02E9F071631E,19951,9,15,6,0,34,34
2977,2977,9F1824F4E1493708E44E02E9F071631E,12491,19,23,4,36,43,1843
2978,2978,B449426FD7A697C41704BAACFB4B5433,11461,0,1,1,37,49,1899
2979,2979,B449426FD7A697C41704BAACFB4B5433,11331,2,3,1,37,48,1898
2980,2980,B449426FD7A697C41704BAACFB4B5433,43181,5,9,4,39,48,1998
2981,2981,B449426FD7A697C41704BAACFB4B5433,10401,11,17,6,33,49,1699
2982,2982,B449426FD7A697C41704BAACFB4B5433,13741,20,23,3,37,49,1899
2989,2989,F736C39F560B9A4948E68A46A6A6DDA8,10781,0,10,10,35,47,1797
2990,2990,F736C39F560B9A4948E68A46A6A6DDA8,10107,13,16,3,38,49,1949
2991,2991,F736C39F560B9A4948E68A46A6A6DDA8,11954,19,23,4,32,49,1649
2992,2992,C1CF59B64EE7642E956AF0C2EBE03CC9,11351,0,15,15,36,48,1848
2993,2993,C1CF59B64EE7642E956AF0C2EBE03CC9,11301,15,18,3,41,49,2099
2994,2994,C1CF59B64EE7642E956AF0C2EBE03CC9,10151,19,23,4,34,47,1747
2999,2999,2F8CA12038D8BFDAC42D43FF94213821,13071,2,3,1,41,41,2091
3000,3000,2F8CA12038D8BFDAC42D43FF94213821,43451,6,10,4,37,40,1890
3001,3001,2F8CA12038D8BFDAC42D43FF94213821,42381,13,23,10,39,41,1991
3002,3002,015977F21CA69DACA3E876A5F028B2A4,43051,0,4,4,46,45,2345
3003,3003,015977F21CA69DACA3E876A5F028B2A4,13351,5,7,2,48,48,2448
3004,3004,015977F21CA69DACA3E876A5F028B2A4,11701,7,8,1,43,48,2198
3005,3005,015977F21CA69DACA3E876A5F028B2A4,13351,10,12,2,48,48,2448
3006,3006,015977F21CA69DACA3E876A5F028B2A4,43051,12,14,2,46,45,2345
3007,3007,015977F21CA69DACA3E876A5F028B2A4,13351,16,20,4,48,48,2448
3008,3008,015977F21CA69DACA3E876A5F028B2A4,43051,21,23,2,46,45,2345
3009,3009,03D4250EA3D1F32EC132B89A302745BE,12971,0,7,7,32,48,1648
3010,3010,03D4250EA3D1F32EC132B89A302745BE,10221,9,12,3,34,49,1749
3011,3011,03D4250EA3D1F32EC132B89A302745BE,42801,13,15,2,40,49,2049
3012,3012,03D4250EA3D1F32EC132B89A302745BE,12971,17,23,6,32,48,1648
3013,3013,C77F23D19DAEA5BB8ADE1BB3D3C261B4,12311,0,6,6,30,44,1544
3014,3014,C77F23D19DAEA5BB8ADE1BB3D3C261B4,13911,8,17,9,39,46,1996
3015,3015,C77F23D19DAEA5BB8ADE1BB3D3C261B4,12311,18,19,1,30,44,1544
3016,3016,9B3D4DB494E6B8E7329532A1BECC6FF1,12921,6,8,2,9,41,491
3017,3017,9B3D4DB494E6B8E7329532A1BECC6FF1,12641,8,10,2,10,43,543
3018,3018,9B3D4DB494E6B8E7329532A1BECC6FF1,12921,12,13,1,9,41,491
3019,3019,9B3D4DB494E6B8E7329532A1BECC6FF1,12641,14,15,1,10,43,543
3020,3020,9B3D4DB494E6B8E7329532A1BECC6FF1,12921,16,17,1,9,41,491
3021,3021,9B3D4DB494E6B8E7329532A1BECC6FF1,12641,19,22,3,10,43,543
3022,3022,4EABE655BE26B3EDCCD7B6B2C89F187F,10161,0,8,8,35,49,1799
3023,3023,4EABE655BE26B3EDCCD7B6B2C89F187F,13561,9,10,1,37,49,1899
3024,3024,4EABE655BE26B3EDCCD7B6B2C89F187F,41061,11,14,3,34,49,1749
3025,3025,4EABE655BE26B3EDCCD7B6B2C89F187F,42981,17,20,3,36,49,1849
3026,3026,4EABE655BE26B3EDCCD7B6B2C89F187F,11331,21,22,1,37,48,1898
3037,3037,62F6BE848412C7FADEB816AFD62C431F,15145,0,7,7,22,9,1109
3038,3038,62F6BE848412C7FADEB816AFD62C431F,16251,8,9,1,15,13,763
3039,3039,62F6BE848412C7FADEB816AFD62C431F,16151,11,22,11,13,11,661
3061,3061,66EFC8F9C7FAE5063697A1B225D83F8D,13121,0,7,7,38,46,1946
3062,3062,66EFC8F9C7FAE5063697A1B225D83F8D,13094,8,12,4,21,42,1092
3063,3063,66EFC8F9C7FAE5063697A1B225D83F8D,13121,13,23,10,38,46,1946
3064,3064,DC11747477231C468C8C898AF6AEDDB8,41724,0,7,7,38,48,1948
3065,3065,DC11747477231C468C8C898AF6AEDDB8,42461,10,11,1,45,47,2297
3066,3066,DC11747477231C468C8C898AF6AEDDB8,42511,12,14,2,37,47,1897
3067,3067,DC11747477231C468C8C898AF6AEDDB8,41724,15,23,8,38,48,1948
3071,3071,2D8F7C2E000B799DCADCAEF4A15BB1AE,42471,0,7,7,35,49,1799
3072,3072,2D8F7C2E000B799DCADCAEF4A15BB1AE,12561,8,17,9,45,43,2293
3073,3073,2D8F7C2E000B799DCADCAEF4A15BB1AE,42471,20,23,3,35,49,1799
3074,3074,D92D00150BC27A9BD4FD19E6AAF05E52,42271,1,13,12,40,47,2047
3075,3075,D92D00150BC27A9BD4FD19E6AAF05E52,11201,16,18,2,35,49,1799
3076,3076,D92D00150BC27A9BD4FD19E6AAF05E52,13331,21,22,1,38,47,1947
3080,3080,51CA45CA2AACCC83748D6918E9F511C1,12661,0,7,7,32,45,1645
3081,3081,51CA45CA2AACCC83748D6918E9F511C1,42151,8,10,2,35,45,1795
3082,3082,51CA45CA2AACCC83748D6918E9F511C1,12661,12,13,1,32,45,1645
3083,3083,51CA45CA2AACCC83748D6918E9F511C1,42151,14,18,4,35,45,1795
3084,3084,51CA45CA2AACCC83748D6918E9F511C1,12661,21,22,1,32,45,1645
3085,3085,3B7DB05F60A1A0EC0EBAAC440955BA1F,19744,8,11,3,6,43,343
3086,3086,3B7DB05F60A1A0EC0EBAAC440955BA1F,42623,14,19,5,22,49,1149
3087,3087,3B7DB05F60A1A0EC0EBAAC440955BA1F,40341,20,22,2,23,49,1199
3091,3091,F7A05B3FECD253C9C578617425D22E9D,41393,2,4,2,43,49,2199
3092,3092,F7A05B3FECD253C9C578617425D22E9D,40302,8,11,3,40,49,2049
3093,3093,F7A05B3FECD253C9C578617425D22E9D,42381,14,15,1,39,41,1991
3094,3094,F7A05B3FECD253C9C578617425D22E9D,40691,18,21,3,42,48,2148
3095,3095,F7A05B3FECD253C9C578617425D22E9D,13351,21,22,1,48,48,2448
3096,3096,72941904C5B2A65DAB254EB3FC579740,10971,0,4,4,35,47,1797
3097,3097,72941904C5B2A65DAB254EB3FC579740,42021,4,6,2,33,47,1697
3098,3098,72941904C5B2A65DAB254EB3FC579740,10971,9,10,1,35,47,1797
3099,3099,72941904C5B2A65DAB254EB3FC579740,42021,10,15,5,33,47,1697
3100,3100,72941904C5B2A65DAB254EB3FC579740,10971,16,17,1,35,47,1797
3101,3101,72941904C5B2A65DAB254EB3FC579740,42021,18,19,1,33,47,1697
3102,3102,4E8CF0BE1A57E085938ED2B5916A9E34,11381,3,14,11,30,47,1547
3103,3103,4E8CF0BE1A57E085938ED2B5916A9E34,12601,15,17,2,25,47,1297
3104,3104,4E8CF0BE1A57E085938ED2B5916A9E34,43661,20,22,2,33,47,1697
3105,3105,5B105ADD9BC39D9388FE233BAD1ECEBC,10331,0,8,8,39,46,1996
3106,3106,5B105ADD9BC39D9388FE233BAD1ECEBC,43361,12,13,1,38,48,1948
3107,3107,5B105ADD9BC39D9388FE233BAD1ECEBC,10331,14,18,4,39,46,1996
3108,3108,5B105ADD9BC39D9388FE233BAD1ECEBC,13561,19,21,2,37,49,1899
3109,3109,9A9D0A13AD6F91D20BCC8AD53CCF337B,40673,1,12,11,36,48,1848
3110,3110,9A9D0A13AD6F91D20BCC8AD53CCF337B,11751,13,15,2,35,48,1798
3111,3111,9A9D0A13AD6F91D20BCC8AD53CCF337B,40951,16,17,1,36,49,1849
3112,3112,9A9D0A13AD6F91D20BCC8AD53CCF337B,10491,18,19,1,33,48,1698
3113,3113,9A9D0A13AD6F91D20BCC8AD53CCF337B,10411,20,23,3,36,48,1848
3114,3114,D429753EEB35077FBB0F7FD7B24671DA,13071,1,3,2,41,41,2091
3115,3115,D429753EEB35077FBB0F7FD7B24671DA,42381,5,6,1,39,41,1991
3116,3116,D429753EEB35077FBB0F7FD7B24671DA,43451,6,8,2,37,40,1890
3117,3117,D429753EEB35077FBB0F7FD7B24671DA,13071,8,11,3,41,41,2091
3118,3118,D429753EEB35077FBB0F7FD7B24671DA,43451,14,19,5,37,40,1890
3119,3119,D429753EEB35077FBB0F7FD7B24671DA,42381,21,23,2,39,41,1991
3120,3120,A4DA699043EB7E2C63FEB4BA93C3D7D3,12211,1,11,10,41,44,2094
3121,3121,A4DA699043EB7E2C63FEB4BA93C3D7D3,43281,12,13,1,37,48,1898
3122,3122,A4DA699043EB7E2C63FEB4BA93C3D7D3,12641,18,23,5,10,43,543
3123,3123,D8FB972AAAC5DB0F06EEBA221E7E96BB,42201,0,7,7,43,46,2196
3124,3124,D8FB972AAAC5DB0F06EEBA221E7E96BB,13951,10,11,1,47,45,2395
3125,3125,D8FB972AAAC5DB0F06EEBA221E7E96BB,42461,11,20,9,45,47,2297
3126,3126,D8FB972AAAC5DB0F06EEBA221E7E96BB,40073,22,23,1,37,48,1898
3130,3130,04E25EABAF57B3731144C024B2F68618,42631,1,3,2,43,45,2195
3131,3131,04E25EABAF57B3731144C024B2F68618,13341,3,7,4,44,45,2245
3132,3132,04E25EABAF57B3731144C024B2F68618,42631,8,16,8,43,45,2195
3133,3133,04E25EABAF57B3731144C024B2F68618,13341,17,21,4,44,45,2245
3134,3134,04E25EABAF57B3731144C024B2F68618,42631,22,23,1,43,45,2195
3135,3135,17498D6550424DFF6F06843A74FEF75D,43971,0,13,13,30,48,1548
3136,3136,17498D6550424DFF6F06843A74FEF75D,42521,18,19,1,31,47,1597
3137,3137,17498D6550424DFF6F06843A74FEF75D,11771,22,23,1,39,49,1999
3138,3138,59E8BD2B3B6F40BDD7AA0B26E7BC6262,13471,5,6,1,47,49,2399
3139,3139,59E8BD2B3B6F40BDD7AA0B26E7BC6262,43621,9,10,1,46,48,2348
3140,3140,59E8BD2B3B6F40BDD7AA0B26E7BC6262,13351,10,12,2,48,48,2448
3141,3141,59E8BD2B3B6F40BDD7AA0B26E7BC6262,43621,15,18,3,46,48,2348
3142,3142,59E8BD2B3B6F40BDD7AA0B26E7BC6262,42601,18,20,2,44,48,2248
3150,3150,416D607C8FBA6E4388C26114FE79C312,15411,0,10,10,44,27,2227
3151,3151,416D607C8FBA6E4388C26114FE79C312,12611,10,12,2,41,29,2079
3152,3152,416D607C8FBA6E4388C26114FE79C312,15411,14,17,3,44,27,2227
3153,3153,416D607C8FBA6E4388C26114FE79C312,12611,18,19,1,41,29,2079
3154,3154,416D607C8FBA6E4388C26114FE79C312,15411,20,21,1,44,27,2227
3155,3155,3F48F13FCC4498B48AC8157DCC837814,15051,4,7,3,19,4,954
3156,3156,3F48F13FCC4498B48AC8157DCC837814,16281,8,9,1,11,4,554
3157,3157,3F48F13FCC4498B48AC8157DCC837814,15051,10,19,9,19,4,954
3161,3161,FB78D5322DE89BC4ACBA0A9E43B4FF54,40402,0,14,14,41,46,2096
3162,3162,FB78D5322DE89BC4ACBA0A9E43B4FF54,10924,18,20,2,43,49,2199
3163,3163,FB78D5322DE89BC4ACBA0A9E43B4FF54,11461,22,23,1,37,49,1899
3167,3167,80A82BF5E27BBEC497DE7B21F3ABF3D7,42071,0,1,1,31,49,1599
3168,3168,80A82BF5E27BBEC497DE7B21F3ABF3D7,42623,6,13,7,22,49,1149
3169,3169,80A82BF5E27BBEC497DE7B21F3ABF3D7,42081,14,17,3,24,49,1249
3170,3170,80A82BF5E27BBEC497DE7B21F3ABF3D7,42071,19,23,4,31,49,1599
3171,3171,EC560F6546AD25F4929F03780C27F37C,42091,1,2,1,43,46,2196
3172,3172,EC560F6546AD25F4929F03780C27F37C,13951,3,5,2,47,45,2395
3173,3173,EC560F6546AD25F4929F03780C27F37C,42091,5,22,17,43,46,2196
3174,3174,76D7493785EDE4B8F3D7EECAC00CF8DA,11531,0,9,9,34,49,1749
3175,3175,76D7493785EDE4B8F3D7EECAC00CF8DA,10191,13,15,2,40,48,2048
3176,3176,76D7493785EDE4B8F3D7EECAC00CF8DA,43621,19,20,1,46,48,2348
3177,3177,76D7493785EDE4B8F3D7EECAC00CF8DA,11301,21,23,2,41,49,2099
3178,3178,28AE6FF44E8686DC354D2E3DF7700FCC,42461,0,6,6,45,47,2297
3179,3179,28AE6FF44E8686DC354D2E3DF7700FCC,42321,10,11,1,43,47,2197
3180,3180,28AE6FF44E8686DC354D2E3DF7700FCC,42461,12,13,1,45,47,2297
3181,3181,28AE6FF44E8686DC354D2E3DF7700FCC,42321,13,17,4,43,47,2197
3182,3182,28AE6FF44E8686DC354D2E3DF7700FCC,42461,19,21,2,45,47,2297
3186,3186,046445D1DB12CBF4315C57EFE7A8E5B3,40833,0,8,8,41,47,2097
3187,3187,046445D1DB12CBF4315C57EFE7A8E5B3,12971,9,12,3,32,48,1648
3188,3188,046445D1DB12CBF4315C57EFE7A8E5B3,12511,17,23,6,39,47,1997
3189,3189,CC0D30B226024F1F29D1C2ECB6081AFF,42583,0,9,9,40,48,2048
3190,3190,CC0D30B226024F1F29D1C2ECB6081AFF,43181,9,11,2,39,48,1998
3191,3191,CC0D30B226024F1F29D1C2ECB6081AFF,10191,12,13,1,40,48,2048
3192,3192,CC0D30B226024F1F29D1C2ECB6081AFF,10211,15,21,6,16,49,849
3193,3193,FA34681C91C9E16E3D387DA8AA6FC6EE,11074,0,7,7,37,47,1897
3194,3194,FA34681C91C9E16E3D387DA8AA6FC6EE,43391,7,18,11,29,48,1498
3195,3195,FA34681C91C9E16E3D387DA8AA6FC6EE,11271,19,20,1,37,48,1898
3196,3196,FA34681C91C9E16E3D387DA8AA6FC6EE,11074,21,22,1,37,47,1897
3201,3201,9F18509EFD8ADDA9EFE2006310FB3458,13961,0,8,8,42,48,2148
3202,3202,9F18509EFD8ADDA9EFE2006310FB3458,40341,14,17,3,23,49,1199
3203,3203,9F18509EFD8ADDA9EFE2006310FB3458,13961,19,22,3,42,48,2148
3204,3204,4FA7E2AF35091649A8D61648BF92F5C0,42581,0,6,6,38,48,1948
3205,3205,4FA7E2AF35091649A8D61648BF92F5C0,10471,7,10,3,37,48,1898
3206,3206,4FA7E2AF35091649A8D61648BF92F5C0,42581,12,13,1,38,48,1948
3207,3207,4FA7E2AF35091649A8D61648BF92F5C0,10471,14,17,3,37,48,1898
3208,3208,4FA7E2AF35091649A8D61648BF92F5C0,42581,19,23,4,38,48,1948
3209,3209,3A3E30929F956029CA3F3618BEC4878A,12641,0,1,1,10,43,543
3210,3210,3A3E30929F956029CA3F3618BEC4878A,19904,1,3,2,9,44,494
3211,3211,3A3E30929F956029CA3F3618BEC4878A,12641,4,5,1,10,43,543
3212,3212,3A3E30929F956029CA3F3618BEC4878A,19904,11,13,2,9,44,494
3213,3213,3A3E30929F956029CA3F3618BEC4878A,12921,16,17,1,9,41,491
3214,3214,3A3E30929F956029CA3F3618BEC4878A,12641,19,23,4,10,43,543
3218,3218,802D06E8811CDC65FDAB61E1A1D233B3,10501,0,2,2,22,46,1146
3219,3219,802D06E8811CDC65FDAB61E1A1D233B3,12601,2,6,4,25,47,1297
3220,3220,802D06E8811CDC65FDAB61E1A1D233B3,10491,11,19,8,33,48,1698
3221,3221,802D06E8811CDC65FDAB61E1A1D233B3,10501,21,23,2,22,46,1146
3222,3222,795778B687A9F641E7B9E4B56F2E2929,10151,0,9,9,34,47,1747
3223,3223,795778B687A9F641E7B9E4B56F2E2929,42523,9,11,2,31,47,1597
3224,3224,795778B687A9F641E7B9E4B56F2E2929,42321,12,13,1,43,47,2197
3225,3225,795778B687A9F641E7B9E4B56F2E2929,10151,15,23,8,34,47,1747
3226,3226,E88B109CBC294EFCA44C40A3CE1C92F7,10901,0,1,1,35,48,1798
3227,3227,E88B109CBC294EFCA44C40A3CE1C92F7,10381,3,9,6,31,49,1599
3228,3228,E88B109CBC294EFCA44C40A3CE1C92F7,10431,10,18,8,33,49,1699
3229,3229,E88B109CBC294EFCA44C40A3CE1C92F7,10381,18,20,2,31,49,1599
3230,3230,E88B109CBC294EFCA44C40A3CE1C92F7,11231,21,22,1,37,49,1899
3231,3231,99D46FD0BFCE2697587F3F7CC00D69FD,10411,0,8,8,36,48,1848
3232,3232,99D46FD0BFCE2697587F3F7CC00D69FD,12083,8,10,2,36,49,1849
3233,3233,99D46FD0BFCE2697587F3F7CC00D69FD,11911,12,13,1,37,48,1898
3234,3234,99D46FD0BFCE2697587F3F7CC00D69FD,13511,15,16,1,34,48,1748
3235,3235,99D46FD0BFCE2697587F3F7CC00D69FD,11911,16,19,3,37,48,1898
3236,3236,99D46FD0BFCE2697587F3F7CC00D69FD,12121,20,23,3,29,47,1497
3237,3237,5C04F6FD3F97ABC2FBFD2ECD3C21BB3B,10491,0,9,9,33,48,1698
3238,3238,5C04F6FD3F97ABC2FBFD2ECD3C21BB3B,11271,10,11,1,37,48,1898
3239,3239,5C04F6FD3F97ABC2FBFD2ECD3C21BB3B,13121,16,18,2,38,46,1946
3240,3240,5C04F6FD3F97ABC2FBFD2ECD3C21BB3B,11231,19,22,3,37,49,1899
3241,3241,5B57577B655216854B442291E844CE12,11061,2,14,12,29,48,1498
3242,3242,5B57577B655216854B442291E844CE12,40341,15,16,1,23,49,1199
3243,3243,5B57577B655216854B442291E844CE12,11061,18,19,1,29,48,1498
3254,3254,AF33B63270ACE9AB69654032F975C430,42081,3,6,3,24,49,1249
3255,3255,AF33B63270ACE9AB69654032F975C430,40341,8,10,2,23,49,1199
3256,3256,AF33B63270ACE9AB69654032F975C430,11211,11,12,1,34,49,1749
3257,3257,AF33B63270ACE9AB69654032F975C430,40341,16,20,4,23,49,1199
3261,3261,920D49567ED28B9B13699E5357A7E252,10331,0,11,11,39,46,1996
3262,3262,920D49567ED28B9B13699E5357A7E252,42021,12,16,4,33,47,1697
3263,3263,920D49567ED28B9B13699E5357A7E252,19441,21,22,1,8,46,446
3264,3264,7CC37941C51F98F5E212A1A341874974,19441,10,11,1,8,46,446
3265,3265,7CC37941C51F98F5E212A1A341874974,11851,12,13,1,13,47,697
3266,3266,7CC37941C51F98F5E212A1A341874974,19441,15,17,2,8,46,446
3267,3267,7CC37941C51F98F5E212A1A341874974,19061,19,22,3,3,43,193
3274,3274,B0CA59461CE535DA6C80DC6682EBEAFB,42271,0,5,5,40,47,2047
3275,3275,B0CA59461CE535DA6C80DC6682EBEAFB,11291,8,13,5,40,49,2049
3276,3276,B0CA59461CE535DA6C80DC6682EBEAFB,11806,17,19,2,41,48,2098
3277,3277,B0CA59461CE535DA6C80DC6682EBEAFB,42271,20,21,1,40,47,2047
3278,3278,B0CA59461CE535DA6C80DC6682EBEAFB,11806,21,23,2,41,48,2098
3279,3279,8E08AC2D21EF7AACBB7B9CAA669D9D24,11804,0,1,1,41,48,2098
3280,3280,8E08AC2D21EF7AACBB7B9CAA669D9D24,13101,2,3,1,40,47,2047
3281,3281,8E08AC2D21EF7AACBB7B9CAA669D9D24,11804,3,10,7,41,48,2098
3282,3282,8E08AC2D21EF7AACBB7B9CAA669D9D24,13101,12,13,1,40,47,2047
3283,3283,8E08AC2D21EF7AACBB7B9CAA669D9D24,11481,14,23,9,41,48,2098
3284,3284,4B5119258FB3482B746B53277561992F,12051,3,13,10,20,47,1047
3285,3285,4B5119258FB3482B746B53277561992F,12601,14,19,5,25,47,1297
3286,3286,4B5119258FB3482B746B53277561992F,12051,20,22,2,20,47,1047
3287,3287,6E802E6EED0751631BE3E26AAC23D1D7,19114,0,6,6,7,43,393
3288,3288,6E802E6EED0751631BE3E26AAC23D1D7,12921,7,9,2,9,41,491
3289,3289,6E802E6EED0751631BE3E26AAC23D1D7,19114,12,13,1,7,43,393
3290,3290,6E802E6EED0751631BE3E26AAC23D1D7,12641,14,18,4,10,43,543
3291,3291,6E802E6EED0751631BE3E26AAC23D1D7,19114,20,23,3,7,43,393
3296,3296,8334763C5210061BC91FE55E5B83F59A,42271,1,6,5,40,47,2047
3297,3297,8334763C5210061BC91FE55E5B83F59A,11806,7,14,7,41,48,2098
3298,3298,8334763C5210061BC91FE55E5B83F59A,11731,15,20,5,36,48,1848
3299,3299,178C1814DC56B2552B1E10875CB04AB0,12121,0,10,10,29,47,1497
3300,3300,178C1814DC56B2552B1E10875CB04AB0,13841,12,14,2,40,46,2046
3301,3301,178C1814DC56B2552B1E10875CB04AB0,41392,15,17,2,43,48,2198
3302,3302,178C1814DC56B2552B1E10875CB04AB0,13651,22,23,1,30,47,1547
3306,3306,E8C2391DA6D45D7659D6871A0F1C6C82,13671,0,7,7,27,43,1393
3307,3307,E8C2391DA6D45D7659D6871A0F1C6C82,10301,9,11,2,31,45,1595
3308,3308,E8C2391DA6D45D7659D6871A0F1C6C82,11834,14,15,1,32,45,1645
3309,3309,E8C2391DA6D45D7659D6871A0F1C6C82,42151,15,16,1,35,45,1795
3310,3310,E8C2391DA6D45D7659D6871A0F1C6C82,13671,21,23,2,27,43,1393
3311,3311,4B205EF05CB93258703A0CC04FC5E2D3,11161,0,8,8,32,48,1648
3312,3312,4B205EF05CB93258703A0CC04FC5E2D3,11481,10,15,5,41,48,2098
3313,3313,4B205EF05CB93258703A0CC04FC5E2D3,11861,18,23,5,32,47,1647
3314,3314,CD62F89A81CF58E2979469073621225B,10491,0,6,6,33,48,1698
3315,3315,CD62F89A81CF58E2979469073621225B,42941,7,8,1,37,47,1897
3316,3316,CD62F89A81CF58E2979469073621225B,43731,8,11,3,34,47,1747
3317,3317,CD62F89A81CF58E2979469073621225B,42941,11,16,5,37,47,1897
3318,3318,CD62F89A81CF58E2979469073621225B,12031,19,23,4,33,48,1698
3319,3319,CC5288899FA27F3FD7EFC15D06000348,13101,7,9,2,40,47,2047
3320,3320,CC5288899FA27F3FD7EFC15D06000348,40833,10,11,1,41,47,2097
3321,3321,CC5288899FA27F3FD7EFC15D06000348,13101,11,12,1,40,47,2047
3322,3322,CC5288899FA27F3FD7EFC15D06000348,40833,12,15,3,41,47,2097
3323,3323,CC5288899FA27F3FD7EFC15D06000348,13331,19,21,2,38,47,1947
3324,3324,174E4C13BDB6C5289AC0D06522E091C4,13111,1,7,6,42,46,2146
3325,3325,174E4C13BDB6C5289AC0D06522E091C4,43951,8,12,4,49,41,2491
3326,3326,174E4C13BDB6C5289AC0D06522E091C4,13111,13,17,4,42,46,2146
3327,3327,174E4C13BDB6C5289AC0D06522E091C4,43951,17,19,2,49,41,2491
3328,3328,174E4C13BDB6C5289AC0D06522E091C4,13951,20,22,2,47,45,2395
3332,3332,C5F312228D11C34AF80DEE1D05F37F08,42031,0,2,2,40,46,2046
3333,3333,C5F312228D11C34AF80DEE1D05F37F08,11481,3,8,5,41,48,2098
3334,3334,C5F312228D11C34AF80DEE1D05F37F08,11631,10,12,2,12,49,649
3335,3335,C5F312228D11C34AF80DEE1D05F37F08,42771,15,17,2,36,47,1847
3336,3336,C5F312228D11C34AF80DEE1D05F37F08,13371,21,23,2,41,47,2097
3337,3337,06B13F92826569E384E99D9217BBB33F,11791,0,6,6,38,49,1949
3338,3338,06B13F92826569E384E99D9217BBB33F,11701,7,9,2,43,48,2198
3339,3339,06B13F92826569E384E99D9217BBB33F,11791,21,23,2,38,49,1949
3343,3343,8A92802CD5A9CAF544C441DBF5EB2408,13951,1,7,6,47,45,2395
3344,3344,8A92802CD5A9CAF544C441DBF5EB2408,13791,11,12,1,42,47,2147
3345,3345,8A92802CD5A9CAF544C441DBF5EB2408,42201,13,20,7,43,46,2196
3346,3346,8A92802CD5A9CAF544C441DBF5EB2408,13951,22,23,1,47,45,2395
3347,3347,293692379EDF53AAAE0730F4BC43EE22,10221,0,7,7,34,49,1749
3348,3348,293692379EDF53AAAE0730F4BC43EE22,19114,10,12,2,7,43,393
3349,3349,293692379EDF53AAAE0730F4BC43EE22,43671,15,23,8,35,48,1798
3353,3353,9B7F26279C5B5C8F1C40AF56DFBB8919,42971,1,7,6,43,49,2199
3354,3354,9B7F26279C5B5C8F1C40AF56DFBB8919,11751,9,10,1,35,48,1798
3355,3355,9B7F26279C5B5C8F1C40AF56DFBB8919,40951,13,14,1,36,49,1849
3356,3356,9B7F26279C5B5C8F1C40AF56DFBB8919,11751,14,16,2,35,48,1798
3357,3357,9B7F26279C5B5C8F1C40AF56DFBB8919,42971,19,23,4,43,49,2199
3361,3361,94C6F56D5A134F9EE242A027FD478896,13671,0,1,1,27,43,1393
3362,3362,94C6F56D5A134F9EE242A027FD478896,12671,1,5,4,21,43,1093
3363,3363,94C6F56D5A134F9EE242A027FD478896,13671,6,18,12,27,43,1393
3364,3364,94C6F56D5A134F9EE242A027FD478896,10711,19,20,1,29,46,1496
3365,3365,94C6F56D5A134F9EE242A027FD478896,13671,20,23,3,27,43,1393
3366,3366,9118236113ABD2907EA8C4297C93D9B6,10471,0,14,14,37,48,1898
3367,3367,9118236113ABD2907EA8C4297C93D9B6,11231,16,18,2,37,49,1899
3368,3368,9118236113ABD2907EA8C4297C93D9B6,40341,19,20,1,23,49,1199
3376,3376,E000B9FE6E0D26E970155137EDA56CCF,11951,2,8,6,31,49,1599
3377,3377,E000B9FE6E0D26E970155137EDA56CCF,42091,9,11,2,43,46,2196
3378,3378,E000B9FE6E0D26E970155137EDA56CCF,12381,16,23,7,32,48,1648
3392,3392,7E52A5B7447DF4E0B028AE7D4242B41E,42971,0,3,3,43,49,2199
3393,3393,7E52A5B7447DF4E0B028AE7D4242B41E,42031,5,6,1,40,46,2046
3394,3394,7E52A5B7447DF4E0B028AE7D4242B41E,10921,17,18,1,43,48,2198
3395,3395,7E52A5B7447DF4E0B028AE7D4242B41E,42341,18,23,5,43,49,2199
3396,3396,075D6798652C490159667E0379AA18B5,42221,1,7,6,38,48,1948
3397,3397,075D6798652C490159667E0379AA18B5,41101,8,12,4,32,48,1648
3398,3398,075D6798652C490159667E0379AA18B5,13121,16,17,1,38,46,1946
3399,3399,075D6798652C490159667E0379AA18B5,42221,20,21,1,38,48,1948
3400,3400,C50F95F31F14C0EC9A55706C3B181C1C,15391,0,2,2,35,26,1776
3401,3401,C50F95F31F14C0EC9A55706C3B181C1C,12792,5,17,12,34,30,1730
3402,3402,C50F95F31F14C0EC9A55706C3B181C1C,15391,18,23,5,35,26,1776
3403,3403,3F33AD3960DCEE156A9DDCB2B689DCAB,49201,0,10,10,7,41,391
3404,3404,3F33AD3960DCEE156A9DDCB2B689DCAB,40341,14,17,3,23,49,1199
3405,3405,3F33AD3960DCEE156A9DDCB2B689DCAB,11521,18,23,5,41,48,2098
3406,3406,8ED78C7DD4E1B880F311FE3FB9457EF7,10111,0,12,12,37,47,1897
3407,3407,8ED78C7DD4E1B880F311FE3FB9457EF7,42301,19,21,2,36,47,1847
3408,3408,8ED78C7DD4E1B880F311FE3FB9457EF7,11701,22,23,1,43,48,2198
3409,3409,2FCC231DE348255A3F9CDA8D77EEA7DC,12581,0,5,5,24,48,1248
3410,3410,2FCC231DE348255A3F9CDA8D77EEA7DC,12051,6,14,8,20,47,1047
3411,3411,2FCC231DE348255A3F9CDA8D77EEA7DC,42291,16,23,7,29,48,1498
3425,3425,B04B4476BEBD302A7170633C92E3A4D5,11521,1,3,2,41,48,2098
3426,3426,B04B4476BEBD302A7170633C92E3A4D5,13271,4,12,8,41,47,2097
3427,3427,B04B4476BEBD302A7170633C92E3A4D5,10661,12,13,1,37,49,1899
3428,3428,B04B4476BEBD302A7170633C92E3A4D5,11521,21,23,2,41,48,2098
3449,3449,540311DE1F12F752C637697C87C1492F,43951,0,6,6,49,41,2491
3450,3450,540311DE1F12F752C637697C87C1492F,43101,9,11,2,46,40,2340
3451,3451,540311DE1F12F752C637697C87C1492F,43951,12,13,1,49,41,2491
3452,3452,540311DE1F12F752C637697C87C1492F,43101,14,17,3,46,40,2340
3453,3453,540311DE1F12F752C637697C87C1492F,43951,18,23,5,49,41,2491
3454,3454,5162937DF1848BF91C2D1A23F150B1C1,42031,0,13,13,40,46,2046
3455,3455,5162937DF1848BF91C2D1A23F150B1C1,40341,14,17,3,23,49,1199
3456,3456,5162937DF1848BF91C2D1A23F150B1C1,42031,19,23,4,40,46,2046
3457,3457,E9713E11372C592FE87FDB21F1BE6D79,15401,7,10,3,39,25,1975
3458,3458,E9713E11372C592FE87FDB21F1BE6D79,40341,13,14,1,23,49,1199
3459,3459,E9713E11372C592FE87FDB21F1BE6D79,15401,18,21,3,39,25,1975
3460,3460,A09B631BCC319D5EC41B3CFE0EF885AC,12401,0,9,9,39,49,1999
3461,3461,A09B631BCC319D5EC41B3CFE0EF885AC,10401,11,12,1,33,49,1699
3462,3462,A09B631BCC319D5EC41B3CFE0EF885AC,12601,13,15,2,25,47,1297
3463,3463,A09B631BCC319D5EC41B3CFE0EF885AC,10401,20,21,1,33,49,1699
3464,3464,8C8C425A004037149DFA27FA23698BC9,15171,1,8,7,42,21,2121
3465,3465,8C8C425A004037149DFA27FA23698BC9,12781,8,10,2,46,24,2324
3466,3466,8C8C425A004037149DFA27FA23698BC9,15171,10,21,11,42,21,2121
3473,3473,996E78B516B54BE4ADEF09770F316D9D,13341,0,3,3,44,45,2245
3474,3474,996E78B516B54BE4ADEF09770F316D9D,42031,7,20,13,40,46,2046
3475,3475,996E78B516B54BE4ADEF09770F316D9D,13341,21,23,2,44,45,2245
3476,3476,5A550DAD8756DD62214660A28F92C9C8,42523,0,5,5,31,47,1597
3477,3477,5A550DAD8756DD62214660A28F92C9C8,40341,10,13,3,23,49,1199
3478,3478,5A550DAD8756DD62214660A28F92C9C8,42861,18,19,1,37,44,1894
3479,3479,5A550DAD8756DD62214660A28F92C9C8,42523,20,21,1,31,47,1597
3486,3486,F776CF5BFCBAFE40EFE079BFD8CF34A4,19901,1,3,2,7,44,394
3487,3487,F776CF5BFCBAFE40EFE079BFD8CF34A4,12921,3,5,2,9,41,491
3488,3488,F776CF5BFCBAFE40EFE079BFD8CF34A4,12641,5,6,1,10,43,543
3489,3489,F776CF5BFCBAFE40EFE079BFD8CF34A4,19021,8,10,2,10,45,545
3490,3490,F776CF5BFCBAFE40EFE079BFD8CF34A4,19111,15,17,2,9,45,495
3491,3491,F776CF5BFCBAFE40EFE079BFD8CF34A4,12641,19,20,1,10,43,543
3505,3505,A61D0F5D6E4730E77483BB5A83F54B2C,13841,1,12,11,40,46,2046
3506,3506,A61D0F5D6E4730E77483BB5A83F54B2C,42401,15,16,1,36,47,1847
3507,3507,A61D0F5D6E4730E77483BB5A83F54B2C,16321,18,23,5,8,7,407
3515,3515,A93373D4AE8900B5DF144BDA85C34A5C,10292,0,11,11,30,47,1547
3516,3516,A93373D4AE8900B5DF144BDA85C34A5C,40951,12,15,3,36,49,1849
3517,3517,A93373D4AE8900B5DF144BDA85C34A5C,10292,17,22,5,30,47,1547
3518,3518,08B5F60DD6B7DB11849E866F45DDEEA5,11001,3,8,5,42,47,2147
3519,3519,08B5F60DD6B7DB11849E866F45DDEEA5,12083,12,13,1,36,49,1849
3520,3520,08B5F60DD6B7DB11849E866F45DDEEA5,13941,16,18,2,41,47,2097
3521,3521,9D27A1D6D841B5A6A86263553CA4E022,43101,3,4,1,46,40,2340
3522,3522,9D27A1D6D841B5A6A86263553CA4E022,43011,6,21,15,40,42,2042
3523,3523,9D27A1D6D841B5A6A86263553CA4E022,43101,22,23,1,46,40,2340
3524,3524,1758A0FBAEF328AC5BB5BEA9854EDCEC,40636,0,1,1,35,48,1798
3525,3525,1758A0FBAEF328AC5BB5BEA9854EDCEC,42491,1,9,8,32,46,1646
3526,3526,1758A0FBAEF328AC5BB5BEA9854EDCEC,13601,10,11,1,34,47,1747
3527,3527,1758A0FBAEF328AC5BB5BEA9854EDCEC,42021,12,16,4,33,47,1697
3528,3528,1758A0FBAEF328AC5BB5BEA9854EDCEC,19441,18,19,1,8,46,446
3529,3529,1758A0FBAEF328AC5BB5BEA9854EDCEC,19621,21,23,2,5,46,296
3530,3530,4A1082E29116D07A4EA830C32D0BE5ED,12221,0,6,6,43,44,2194
3531,3531,4A1082E29116D07A4EA830C32D0BE5ED,42631,8,9,1,43,45,2195
3532,3532,4A1082E29116D07A4EA830C32D0BE5ED,12221,12,18,6,43,44,2194
3533,3533,4A1082E29116D07A4EA830C32D0BE5ED,10811,21,23,2,38,46,1946
3534,3534,B6F80668987D76AE8AEC48092E44D3BD,42301,2,5,3,36,47,1847
3535,3535,B6F80668987D76AE8AEC48092E44D3BD,10271,7,12,5,37,46,1896
3536,3536,B6F80668987D76AE8AEC48092E44D3BD,13121,13,15,2,38,46,1946
3537,3537,B6F80668987D76AE8AEC48092E44D3BD,10841,18,19,1,37,47,1897
3538,3538,B6F80668987D76AE8AEC48092E44D3BD,12381,20,21,1,32,48,1648
3539,3539,180C57D9A40178E5B15186C701804F1B,10421,0,4,4,41,48,2098
3540,3540,180C57D9A40178E5B15186C701804F1B,42931,6,7,1,41,49,2099
3541,3541,180C57D9A40178E5B15186C701804F1B,10421,8,10,2,41,48,2098
3542,3542,180C57D9A40178E5B15186C701804F1B,42741,12,14,2,43,48,2198
3543,3543,180C57D9A40178E5B15186C701804F1B,11741,14,22,8,42,49,2149
3544,3544,9F875FB94770B83139951C3FD13AB867,10951,0,11,11,29,48,1498
3545,3545,9F875FB94770B83139951C3FD13AB867,42031,14,15,1,40,46,2046
3546,3546,9F875FB94770B83139951C3FD13AB867,12511,15,16,1,39,47,1997
3547,3547,9F875FB94770B83139951C3FD13AB867,43391,21,22,1,29,48,1498
3551,3551,51E47FDE51716EB36BE96125516194AB,11021,0,10,10,36,49,1849
3552,3552,51E47FDE51716EB36BE96125516194AB,10191,11,14,3,40,48,2048
3553,3553,51E47FDE51716EB36BE96125516194AB,11021,15,17,2,36,49,1849
3554,3554,51E47FDE51716EB36BE96125516194AB,41601,18,20,2,39,49,1999
3555,3555,51E47FDE51716EB36BE96125516194AB,11021,21,23,2,36,49,1849
3559,3559,8EC6592A5302140A9CA2CC55F2BCF8B9,42201,0,8,8,43,46,2196
3560,3560,8EC6592A5302140A9CA2CC55F2BCF8B9,11001,8,10,2,42,47,2147
3561,3561,8EC6592A5302140A9CA2CC55F2BCF8B9,10971,13,23,10,35,47,1797
3562,3562,E6B9ADF0D467AEDA16D352A77A3C24BA,41392,0,17,17,43,48,2198
3563,3563,E6B9ADF0D467AEDA16D352A77A3C24BA,11211,19,20,1,34,49,1749
3564,3564,E6B9ADF0D467AEDA16D352A77A3C24BA,11021,21,23,2,36,49,1849
3569,3569,BF3354E7653978B437BDBF5412A04932,12871,0,1,1,22,33,1133
3570,3570,BF3354E7653978B437BDBF5412A04932,19281,3,14,11,16,32,832
3571,3571,BF3354E7653978B437BDBF5412A04932,12871,15,22,7,22,33,1133
3572,3572,C7DA72F726B4520B22200C08CF53C7BB,11851,0,5,5,13,47,697
3573,3573,C7DA72F726B4520B22200C08CF53C7BB,19441,6,19,13,8,46,446
3574,3574,C7DA72F726B4520B22200C08CF53C7BB,11851,20,22,2,13,47,697
3578,3578,F93D646A1BCE1AFF390EB78A01863C9E,42581,6,10,4,38,48,1948
3579,3579,F93D646A1BCE1AFF390EB78A01863C9E,11914,10,12,2,37,48,1898
3580,3580,F93D646A1BCE1AFF390EB78A01863C9E,40171,12,17,5,38,48,1948
3581,3581,F93D646A1BCE1AFF390EB78A01863C9E,10471,17,18,1,37,48,1898
3582,3582,F93D646A1BCE1AFF390EB78A01863C9E,40171,19,20,1,38,48,1948
3583,3583,839E5B2416DDB60AF8D62A7EA6186138,42021,0,17,17,33,47,1697
3584,3584,839E5B2416DDB60AF8D62A7EA6186138,12021,17,19,2,37,49,1899
3585,3585,839E5B2416DDB60AF8D62A7EA6186138,42021,22,23,1,33,47,1697
3586,3586,9EE10D053E0D0FEE91EC61F0A8AFA62E,19931,0,2,2,7,43,393
3587,3587,9EE10D053E0D0FEE91EC61F0A8AFA62E,12641,2,6,4,10,43,543
3588,3588,9EE10D053E0D0FEE91EC61F0A8AFA62E,19114,8,9,1,7,43,393
3589,3589,9EE10D053E0D0FEE91EC61F0A8AFA62E,19901,19,21,2,7,44,394
3590,3590,9EE10D053E0D0FEE91EC61F0A8AFA62E,19621,21,22,1,5,46,296
3605,3605,EF81D5350C78C47D74F1239C7A88A260,11201,0,3,3,35,49,1799
3606,3606,EF81D5350C78C47D74F1239C7A88A260,11861,7,17,10,32,47,1647
3607,3607,EF81D5350C78C47D74F1239C7A88A260,10221,18,19,1,34,49,1749
3608,3608,EF81D5350C78C47D74F1239C7A88A260,11201,21,23,2,35,49,1799
3609,3609,C2DF457F1D0C11A80CBA147D424E3E70,11871,0,6,6,29,46,1496
3610,3610,C2DF457F1D0C11A80CBA147D424E3E70,12311,7,8,1,30,44,1544
3611,3611,C2DF457F1D0C11A80CBA147D424E3E70,10711,11,13,2,29,46,1496
3612,3612,C2DF457F1D0C11A80CBA147D424E3E70,11861,15,18,3,32,47,1647
3613,3613,C2DF457F1D0C11A80CBA147D424E3E70,11871,21,23,2,29,46,1496
3617,3617,64A2E9501F429B6DEC66E8EE627CCABA,11061,0,7,7,29,48,1498
3618,3618,64A2E9501F429B6DEC66E8EE627CCABA,10301,8,12,4,31,45,1595
3619,3619,64A2E9501F429B6DEC66E8EE627CCABA,11781,14,17,3,38,49,1949
3620,3620,64A2E9501F429B6DEC66E8EE627CCABA,11541,18,21,3,35,49,1799
3621,3621,64A2E9501F429B6DEC66E8EE627CCABA,11061,21,22,1,29,48,1498
3626,3626,CC7C043FFC6EDBA54A459773B754F7C8,11331,0,1,1,37,48,1898
3627,3627,CC7C043FFC6EDBA54A459773B754F7C8,11074,11,15,4,37,47,1897
3628,3628,CC7C043FFC6EDBA54A459773B754F7C8,11331,15,17,2,37,48,1898
3629,3629,CC7C043FFC6EDBA54A459773B754F7C8,42481,18,20,2,22,49,1149
3630,3630,F4216F10A56AA211D52B63CFF0F7762F,10471,0,13,13,37,48,1898
3631,3631,F4216F10A56AA211D52B63CFF0F7762F,40341,15,18,3,23,49,1199
3632,3632,F4216F10A56AA211D52B63CFF0F7762F,10471,19,22,3,37,48,1898
3633,3633,DBE56CF804EFF98F06EBBF480586FC01,43021,0,2,2,16,43,843
3634,3634,DBE56CF804EFF98F06EBBF480586FC01,12921,6,7,1,9,41,491
3635,3635,DBE56CF804EFF98F06EBBF480586FC01,43021,11,13,2,16,43,843
3636,3636,DBE56CF804EFF98F06EBBF480586FC01,12921,16,17,1,9,41,491
3637,3637,DBE56CF804EFF98F06EBBF480586FC01,43021,17,20,3,16,43,843
3638,3638,D618A6C3100C9BD1930907167F1B2D2D,13961,0,8,8,42,48,2148
3639,3639,D618A6C3100C9BD1930907167F1B2D2D,19951,12,13,1,0,34,34
3640,3640,D618A6C3100C9BD1930907167F1B2D2D,13961,16,23,7,42,48,2148
3641,3641,8F3D87765F7FBCF1F1DB0B2C068A5C58,42151,1,8,7,35,45,1795
3642,3642,8F3D87765F7FBCF1F1DB0B2C068A5C58,42501,9,11,2,28,47,1447
3643,3643,8F3D87765F7FBCF1F1DB0B2C068A5C58,42151,11,12,1,35,45,1795
3644,3644,8F3D87765F7FBCF1F1DB0B2C068A5C58,11801,15,16,1,42,48,2148
3645,3645,8F3D87765F7FBCF1F1DB0B2C068A5C58,42151,20,21,1,35,45,1795
3649,3649,8EA53D8E1525E5DC764AA8B750C1926A,13411,0,8,8,49,42,2492
3650,3650,8EA53D8E1525E5DC764AA8B750C1926A,43951,9,10,1,49,41,2491
3651,3651,8EA53D8E1525E5DC764AA8B750C1926A,13411,11,12,1,49,42,2492
3652,3652,8EA53D8E1525E5DC764AA8B750C1926A,43951,15,17,2,49,41,2491
3653,3653,8EA53D8E1525E5DC764AA8B750C1926A,13371,20,22,2,41,47,2097
3654,3654,D227D6EA815AD3E534730A42BDF45066,42631,0,13,13,43,45,2195
3655,3655,D227D6EA815AD3E534730A42BDF45066,40341,14,17,3,23,49,1199
3656,3656,D227D6EA815AD3E534730A42BDF45066,42631,19,23,4,43,45,2195
3668,3668,29A2674FAC6768EF49F86959585CDC48,42041,0,9,9,10,47,547
3669,3669,29A2674FAC6768EF49F86959585CDC48,11851,9,16,7,13,47,697
3670,3670,29A2674FAC6768EF49F86959585CDC48,19744,19,20,1,6,43,343
3671,3671,5AF26FD3EDD59D73F20E2AE7E3BEDAFF,43311,0,6,6,31,48,1598
3672,3672,5AF26FD3EDD59D73F20E2AE7E3BEDAFF,10681,6,11,5,30,48,1548
3673,3673,5AF26FD3EDD59D73F20E2AE7E3BEDAFF,49201,14,21,7,7,41,391
3678,3678,65161D8F8A2EE0E4F87D9472311EE576,12514,1,2,1,38,47,1947
3679,3679,65161D8F8A2EE0E4F87D9472311EE576,10841,6,11,5,37,47,1897
3680,3680,65161D8F8A2EE0E4F87D9472311EE576,12514,12,14,2,38,47,1947
3681,3681,65161D8F8A2EE0E4F87D9472311EE576,10841,15,17,2,37,47,1897
3682,3682,65161D8F8A2EE0E4F87D9472311EE576,12514,17,23,6,38,47,1947
3683,3683,884D0F3F0399E45AD292FC787967C25B,42871,1,6,5,30,45,1545
3684,3684,884D0F3F0399E45AD292FC787967C25B,10061,9,10,1,20,46,1046
3685,3685,884D0F3F0399E45AD292FC787967C25B,11871,13,14,1,29,46,1496
3686,3686,884D0F3F0399E45AD292FC787967C25B,10061,15,16,1,20,46,1046
3687,3687,884D0F3F0399E45AD292FC787967C25B,11875,21,22,1,30,46,1546
3692,3692,21B13E6FE5B4D725790EA640EC4328C1,42371,0,7,7,34,46,1746
3693,3693,21B13E6FE5B4D725790EA640EC4328C1,12514,7,9,2,38,47,1947
3694,3694,21B13E6FE5B4D725790EA640EC4328C1,43481,9,10,1,39,48,1998
3695,3695,21B13E6FE5B4D725790EA640EC4328C1,42371,12,14,2,34,46,1746
3696,3696,21B13E6FE5B4D725790EA640EC4328C1,12514,16,18,2,38,47,1947
3697,3697,21B13E6FE5B4D725790EA640EC4328C1,42371,19,23,4,34,46,1746
3698,3698,7AB7808A497636952D0CCE900063C9AF,19021,0,3,3,10,45,545
3699,3699,7AB7808A497636952D0CCE900063C9AF,19024,3,5,2,9,45,495
3700,3700,7AB7808A497636952D0CCE900063C9AF,11571,6,9,3,13,46,696
3701,3701,7AB7808A497636952D0CCE900063C9AF,12641,12,16,4,10,43,543
3702,3702,7AB7808A497636952D0CCE900063C9AF,19024,21,23,2,9,45,495
3706,3706,C5E6CD443585007EEBF145B2163DFA1C,42981,0,5,5,36,49,1849
3707,3707,C5E6CD443585007EEBF145B2163DFA1C,10901,5,11,6,35,48,1798
3708,3708,C5E6CD443585007EEBF145B2163DFA1C,10471,14,17,3,37,48,1898
3709,3709,C5E6CD443585007EEBF145B2163DFA1C,11351,19,20,1,36,48,1848
3710,3710,C5E6CD443585007EEBF145B2163DFA1C,10901,20,23,3,35,48,1798
3715,3715,507C264A3FC1C39E70D178529DA708EA,11074,0,13,13,37,47,1897
3716,3716,507C264A3FC1C39E70D178529DA708EA,42641,18,20,2,33,49,1699
3717,3717,507C264A3FC1C39E70D178529DA708EA,11074,22,23,1,37,47,1897
3718,3718,1F9F1C83F1B526750C2575DE062BE373,42523,0,8,8,31,47,1597
3719,3719,1F9F1C83F1B526750C2575DE062BE373,43581,10,11,1,33,48,1698
3720,3720,1F9F1C83F1B526750C2575DE062BE373,11001,19,23,4,42,47,2147
3721,3721,B1FBA7CD09E43DD0FE0ADDDFA4EA80A3,49181,7,12,5,21,31,1081
3722,3722,B1FBA7CD09E43DD0FE0ADDDFA4EA80A3,12792,14,16,2,34,30,1730
3723,3723,B1FBA7CD09E43DD0FE0ADDDFA4EA80A3,49181,17,21,4,21,31,1081
3724,3724,5DF114073179F0DA145C22152DE0E34C,11731,0,4,4,36,48,1848
3725,3725,5DF114073179F0DA145C22152DE0E34C,11751,4,5,1,35,48,1798
3726,3726,5DF114073179F0DA145C22152DE0E34C,11731,6,9,3,36,48,1848
3727,3727,5DF114073179F0DA145C22152DE0E34C,11061,18,22,4,29,48,1498
3728,3728,1D6534B12FE6A267A8565A671F05A941,19441,0,8,8,8,46,446
3729,3729,1D6534B12FE6A267A8565A671F05A941,49201,9,10,1,7,41,391
3730,3730,1D6534B12FE6A267A8565A671F05A941,19441,13,23,10,8,46,446
3731,3731,4668498322059FDBAD6E4D56B28B3D41,12141,1,2,1,42,45,2145
3732,3732,4668498322059FDBAD6E4D56B28B3D41,42321,3,6,3,43,47,2197
3733,3733,4668498322059FDBAD6E4D56B28B3D41,12211,10,11,1,41,44,2094
3734,3734,4668498322059FDBAD6E4D56B28B3D41,13341,18,19,1,44,45,2245
3735,3735,4668498322059FDBAD6E4D56B28B3D41,42461,19,23,4,45,47,2297
3742,3742,F270E2429049EC12B817A3B7398AF53A,10111,0,12,12,37,47,1897
3743,3743,F270E2429049EC12B817A3B7398AF53A,11211,15,19,4,34,49,1749
3744,3744,F270E2429049EC12B817A3B7398AF53A,10111,20,21,1,37,47,1897
3745,3745,9BE9B638A03223167AF819AA94751264,43121,0,13,13,25,27,1277
3746,3746,9BE9B638A03223167AF819AA94751264,15321,14,15,1,29,26,1476
3747,3747,9BE9B638A03223167AF819AA94751264,43121,18,23,5,25,27,1277
3755,3755,2F380CE2E674806561EC26C449F15D1B,41393,0,8,8,43,49,2199
3756,3756,2F380CE2E674806561EC26C449F15D1B,43581,9,10,1,33,48,1698
3757,3757,2F380CE2E674806561EC26C449F15D1B,10161,11,12,1,35,49,1799
3758,3758,2F380CE2E674806561EC26C449F15D1B,11021,12,14,2,36,49,1849
3759,3759,2F380CE2E674806561EC26C449F15D1B,10781,15,18,3,35,47,1797
3760,3760,2F380CE2E674806561EC26C449F15D1B,11541,19,20,1,35,49,1799
3761,3761,2F380CE2E674806561EC26C449F15D1B,41393,21,22,1,43,49,2199
3768,3768,628D613E9F0649F54A43E37BD2AB1CF1,42461,0,3,3,45,47,2297
3769,3769,628D613E9F0649F54A43E37BD2AB1CF1,42601,4,7,3,44,48,2248
3770,3770,628D613E9F0649F54A43E37BD2AB1CF1,42461,7,9,2,45,47,2297
3771,3771,628D613E9F0649F54A43E37BD2AB1CF1,42321,11,12,1,43,47,2197
3772,3772,628D613E9F0649F54A43E37BD2AB1CF1,42461,13,15,2,45,47,2297
3773,3773,628D613E9F0649F54A43E37BD2AB1CF1,42321,19,22,3,43,47,2197
3785,3785,490784C5CC038E165F62C1F43CB21EF7,11231,0,2,2,37,49,1899
3786,3786,490784C5CC038E165F62C1F43CB21EF7,12871,15,19,4,22,33,1133
3787,3787,490784C5CC038E165F62C1F43CB21EF7,43281,22,23,1,37,48,1898
3788,3788,2963DF7A578CB40D3B563AE1F82E4E79,19741,0,8,8,5,44,294
3789,3789,2963DF7A578CB40D3B563AE1F82E4E79,42231,8,10,2,37,46,1896
3790,3790,2963DF7A578CB40D3B563AE1F82E4E79,19741,13,15,2,5,44,294
3791,3791,2963DF7A578CB40D3B563AE1F82E4E79,19744,15,18,3,6,43,343
3792,3792,6AF9BC3BC00A2DB4E93E7EFAFF6696BB,43761,5,6,1,32,47,1647
3793,3793,6AF9BC3BC00A2DB4E93E7EFAFF6696BB,19571,11,12,1,1,36,86
3794,3794,6AF9BC3BC00A2DB4E93E7EFAFF6696BB,10341,13,23,10,31,47,1597
3795,3795,79AB37E4BA910BB73519FC84F2A35B1A,12921,0,1,1,9,41,491
3796,3796,79AB37E4BA910BB73519FC84F2A35B1A,43021,1,7,6,16,43,843
3797,3797,79AB37E4BA910BB73519FC84F2A35B1A,12921,10,19,9,9,41,491
3801,3801,F597BC5BA22F9522878BB728C9D7E3BA,10501,0,8,8,22,46,1146
3802,3802,F597BC5BA22F9522878BB728C9D7E3BA,42491,11,13,2,32,46,1646
3803,3803,F597BC5BA22F9522878BB728C9D7E3BA,10107,16,19,3,38,49,1949
3804,3804,EB723F2604EF7AE7C37A9459E67C1BA0,10171,0,15,15,26,47,1347
3805,3805,EB723F2604EF7AE7C37A9459E67C1BA0,11261,16,17,1,36,46,1846
3806,3806,EB723F2604EF7AE7C37A9459E67C1BA0,13911,17,18,1,39,46,1996
3807,3807,EB723F2604EF7AE7C37A9459E67C1BA0,11261,20,21,1,36,46,1846
3808,3808,0C90EB56CFED32EC1E67AE278986F434,13251,0,10,10,48,28,2428
3809,3809,0C90EB56CFED32EC1E67AE278986F434,15411,12,13,1,44,27,2227
3810,3810,0C90EB56CFED32EC1E67AE278986F434,13251,15,20,5,48,28,2428
3811,3811,7525C5E0D4A1F16451ECCF96F09BECD1,10281,0,15,15,33,48,1698
3812,3812,7525C5E0D4A1F16451ECCF96F09BECD1,40341,15,17,2,23,49,1199
3813,3813,7525C5E0D4A1F16451ECCF96F09BECD1,40951,21,23,2,36,49,1849
3814,3814,03A3755F092A2E05E2E792F58283AE09,13231,0,7,7,39,46,1996
3815,3815,03A3755F092A2E05E2E792F58283AE09,40637,16,18,2,36,47,1847
3816,3816,03A3755F092A2E05E2E792F58283AE09,11631,22,23,1,12,49,649
3817,3817,E83888D24F9B489390D1BDDD69FB71BE,42861,2,4,2,37,44,1894
3818,3818,E83888D24F9B489390D1BDDD69FB71BE,43761,5,9,4,32,47,1647
3819,3819,E83888D24F9B489390D1BDDD69FB71BE,42861,9,23,14,37,44,1894
3820,3820,CE29EB37C112E7F535813A697DFC251A,43751,0,6,6,19,48,998
3821,3821,CE29EB37C112E7F535813A697DFC251A,11361,8,9,1,22,48,1148
3822,3822,CE29EB37C112E7F535813A697DFC251A,43751,12,13,1,19,48,998
3823,3823,CE29EB37C112E7F535813A697DFC251A,42681,15,16,1,24,48,1248
3824,3824,CE29EB37C112E7F535813A697DFC251A,43751,17,23,6,19,48,998
3832,3832,40A3F567657A043546A2ED7A5DC91A85,12792,0,5,5,34,30,1730
3833,3833,40A3F567657A043546A2ED7A5DC91A85,15401,6,7,1,39,25,1975
3834,3834,40A3F567657A043546A2ED7A5DC91A85,12792,7,23,16,34,30,1730
3835,3835,A2A76E9881459C38F2E7EA3180775566,42681,0,9,9,24,48,1248
3836,3836,A2A76E9881459C38F2E7EA3180775566,11641,9,12,3,22,49,1149
3837,3837,A2A76E9881459C38F2E7EA3180775566,42681,14,17,3,24,48,1248
3838,3838,A2A76E9881459C38F2E7EA3180775566,40343,18,19,1,24,49,1249
3839,3839,A2A76E9881459C38F2E7EA3180775566,42681,20,23,3,24,48,1248
3840,3840,81946AFE1D298F3B40176C804AE3EF84,19801,3,6,3,19,26,976
3841,3841,81946AFE1D298F3B40176C804AE3EF84,43121,8,10,2,25,27,1277
3842,3842,81946AFE1D298F3B40176C804AE3EF84,19801,11,20,9,19,26,976
3843,3843,81946AFE1D298F3B40176C804AE3EF84,43121,20,21,1,25,27,1277
3850,3850,AB57CFBC7FBBD1B4F46C04046F726522,12881,0,2,2,47,22,2372
3851,3851,AB57CFBC7FBBD1B4F46C04046F726522,15171,3,4,1,42,21,2121
3852,3852,AB57CFBC7FBBD1B4F46C04046F726522,15021,6,7,1,46,18,2318
3853,3853,AB57CFBC7FBBD1B4F46C04046F726522,12881,14,17,3,47,22,2372
3854,3854,AB57CFBC7FBBD1B4F46C04046F726522,15171,21,23,2,42,21,2121
3858,3858,49782122BC11DEA91C73D752CF8047A0,10121,0,9,9,36,49,1849
3859,3859,49782122BC11DEA91C73D752CF8047A0,13094,11,12,1,21,42,1092
3860,3860,49782122BC11DEA91C73D752CF8047A0,10121,14,22,8,36,49,1849
3861,3861,1EE93E8FFF74D270AB00DC1FFEF6860E,15021,0,5,5,46,18,2318
3862,3862,1EE93E8FFF74D270AB00DC1FFEF6860E,12881,10,11,1,47,22,2372
3863,3863,1EE93E8FFF74D270AB00DC1FFEF6860E,15021,14,21,7,46,18,2318
3864,3864,5B271E71191E2FACCAE0B2BFD4BBBD24,13111,0,11,11,42,46,2146
3865,3865,5B271E71191E2FACCAE0B2BFD4BBBD24,43061,11,13,2,43,46,2196
3866,3866,5B271E71191E2FACCAE0B2BFD4BBBD24,42921,16,23,7,33,47,1697
3867,3867,B90520ED7BDDE423CEFE3ED6913620C9,12514,1,3,2,38,47,1947
3868,3868,B90520ED7BDDE423CEFE3ED6913620C9,10841,5,6,1,37,47,1897
3869,3869,B90520ED7BDDE423CEFE3ED6913620C9,10271,8,10,2,37,46,1896
3870,3870,B90520ED7BDDE423CEFE3ED6913620C9,10841,13,17,4,37,47,1897
3871,3871,B90520ED7BDDE423CEFE3ED6913620C9,10271,18,20,2,37,46,1896
3872,3872,54AF0735D887B9C0B8CEE7B0E8BAEF2D,19441,0,3,3,8,46,446
3873,3873,54AF0735D887B9C0B8CEE7B0E8BAEF2D,11471,4,5,1,12,48,648
3874,3874,54AF0735D887B9C0B8CEE7B0E8BAEF2D,19441,8,19,11,8,46,446
3882,3882,B7E9AE724F2B171EE75FE884D0B34C45,43721,0,6,6,32,34,1634
3883,3883,B7E9AE724F2B171EE75FE884D0B34C45,43451,8,11,3,37,40,1890
3884,3884,B7E9AE724F2B171EE75FE884D0B34C45,43721,13,21,8,32,34,1634
3888,3888,D183DAEA0AF895171FF11F62CF443DCD,10841,0,12,12,37,47,1897
3889,3889,D183DAEA0AF895171FF11F62CF443DCD,42161,13,16,3,36,47,1847
3890,3890,D183DAEA0AF895171FF11F62CF443DCD,12514,18,20,2,38,47,1947
3891,3891,D183DAEA0AF895171FF11F62CF443DCD,42511,20,22,2,37,47,1897
3892,3892,D183DAEA0AF895171FF11F62CF443DCD,12514,22,23,1,38,47,1947
3896,3896,94E10F043AAF9155CBF5CC2C21719C3F,10191,0,7,7,40,48,2048
3897,3897,94E10F043AAF9155CBF5CC2C21719C3F,11834,8,16,8,32,45,1645
3898,3898,94E10F043AAF9155CBF5CC2C21719C3F,11531,21,22,1,34,49,1749
3902,3902,F272E0E14AD5890D3F963AAE56775AE9,11324,1,9,8,31,46,1596
3903,3903,F272E0E14AD5890D3F963AAE56775AE9,42491,12,13,1,32,46,1646
3904,3904,F272E0E14AD5890D3F963AAE56775AE9,42151,14,15,1,35,45,1795
3905,3905,F272E0E14AD5890D3F963AAE56775AE9,11324,16,19,3,31,46,1596
3906,3906,F272E0E14AD5890D3F963AAE56775AE9,10716,22,23,1,30,46,1546
3913,3913,0A27EAE690B1EA20001899CE496B6598,12921,9,11,2,9,41,491
3914,3914,0A27EAE690B1EA20001899CE496B6598,12641,13,17,4,10,43,543
3915,3915,0A27EAE690B1EA20001899CE496B6598,19744,19,23,4,6,43,343
3916,3916,887D22D8A56D3CC76F47CC3B51F82C12,43021,0,1,1,16,43,843
3917,3917,887D22D8A56D3CC76F47CC3B51F82C12,19021,3,4,1,10,45,545
3918,3918,887D22D8A56D3CC76F47CC3B51F82C12,43021,5,11,6,16,43,843
3919,3919,887D22D8A56D3CC76F47CC3B51F82C12,19021,13,14,1,10,45,545
3920,3920,887D22D8A56D3CC76F47CC3B51F82C12,12641,15,17,2,10,43,543
3921,3921,887D22D8A56D3CC76F47CC3B51F82C12,43021,21,23,2,16,43,843
3922,3922,0C3B0F465A7BDE89311DCA3821959FAE,11701,0,8,8,43,48,2198
3923,3923,0C3B0F465A7BDE89311DCA3821959FAE,11021,8,11,3,36,49,1849
3924,3924,0C3B0F465A7BDE89311DCA3821959FAE,41393,14,19,5,43,49,2199
3925,3925,0C3B0F465A7BDE89311DCA3821959FAE,10881,20,22,2,34,48,1748
3930,3930,E9F42163BF59C85AF44CD915A00B0B78,10621,1,2,1,41,49,2099
3931,3931,E9F42163BF59C85AF44CD915A00B0B78,40302,7,9,2,40,49,2049
3932,3932,E9F42163BF59C85AF44CD915A00B0B78,12514,9,10,1,38,47,1947
3933,3933,E9F42163BF59C85AF44CD915A00B0B78,13351,12,13,1,48,48,2448
3934,3934,E9F42163BF59C85AF44CD915A00B0B78,43981,15,18,3,36,49,1849
3935,3935,E9F42163BF59C85AF44CD915A00B0B78,40302,20,23,3,40,49,2049
3939,3939,D88EA2A634C927FE2BD8ECB490F7D727,10292,0,10,10,30,47,1547
3940,3940,D88EA2A634C927FE2BD8ECB490F7D727,40302,14,16,2,40,49,2049
3941,3941,D88EA2A634C927FE2BD8ECB490F7D727,13511,18,19,1,34,48,1748
3945,3945,1B914EA19E608B834149612681BFDCB4,43011,0,13,13,40,42,2042
3946,3946,1B914EA19E608B834149612681BFDCB4,43451,14,17,3,37,40,1890
3947,3947,1B914EA19E608B834149612681BFDCB4,10811,20,21,1,38,46,1946
3948,3948,4F6A74BBD714EF065A4DB365EFF3390D,11271,0,7,7,37,48,1898
3949,3949,4F6A74BBD714EF065A4DB365EFF3390D,12971,12,13,1,32,48,1648
3950,3950,4F6A74BBD714EF065A4DB365EFF3390D,11271,14,23,9,37,48,1898
3951,3951,CCC9E3BFC07B5F90A220A4A2A363FD6B,42321,9,10,1,43,47,2197
3952,3952,CCC9E3BFC07B5F90A220A4A2A363FD6B,10161,15,17,2,35,49,1799
3953,3953,CCC9E3BFC07B5F90A220A4A2A363FD6B,13951,18,23,5,47,45,2395
3957,3957,24CACF86A8CD21A17E28510F56598929,11021,0,14,14,36,49,1849
3958,3958,24CACF86A8CD21A17E28510F56598929,13121,17,19,2,38,46,1946
3959,3959,24CACF86A8CD21A17E28510F56598929,11021,21,23,2,36,49,1849
3966,3966,AB1E27033ABBCFEAE4B83A799FB358FD,19744,0,5,5,6,43,343
3967,3967,AB1E27033ABBCFEAE4B83A799FB358FD,12311,7,14,7,30,44,1544
3968,3968,AB1E27033ABBCFEAE4B83A799FB358FD,19744,19,23,4,6,43,343
3969,3969,BBCB9918D42B41DEDF16DD7F5A9BE26F,11861,0,5,5,32,47,1647
3970,3970,BBCB9918D42B41DEDF16DD7F5A9BE26F,42161,5,14,9,36,47,1847
3971,3971,BBCB9918D42B41DEDF16DD7F5A9BE26F,11911,14,17,3,37,48,1898
3972,3972,BBCB9918D42B41DEDF16DD7F5A9BE26F,11861,17,23,6,32,47,1647
3973,3973,778FCC24D7E33BA6E0BE6A312CE18590,40882,0,6,6,34,49,1749
3974,3974,778FCC24D7E33BA6E0BE6A312CE18590,10431,7,9,2,33,49,1699
3975,3975,778FCC24D7E33BA6E0BE6A312CE18590,40882,10,11,1,34,49,1749
3976,3976,778FCC24D7E33BA6E0BE6A312CE18590,10431,11,13,2,33,49,1699
3977,3977,778FCC24D7E33BA6E0BE6A312CE18590,10491,14,17,3,33,48,1698
3978,3978,778FCC24D7E33BA6E0BE6A312CE18590,10431,18,19,1,33,49,1699
3979,3979,778FCC24D7E33BA6E0BE6A312CE18590,42161,19,23,4,36,47,1847
3980,3980,1D5FEB85097765A4DAC299D8A4D17B3D,10951,0,7,7,29,48,1498
3981,3981,1D5FEB85097765A4DAC299D8A4D17B3D,12121,11,14,3,29,47,1497
3982,3982,1D5FEB85097765A4DAC299D8A4D17B3D,40951,17,19,2,36,49,1849
3983,3983,1D5FEB85097765A4DAC299D8A4D17B3D,10951,20,23,3,29,48,1498
3987,3987,46E2E10251607E59BAC1F84F8487D62D,19031,0,3,3,1,42,92
3988,3988,46E2E10251607E59BAC1F84F8487D62D,12641,3,4,1,10,43,543
3989,3989,46E2E10251607E59BAC1F84F8487D62D,19031,5,21,16,1,42,92
3990,3990,FEB496C5821975C466BBF1CF529CA926,13961,0,9,9,42,48,2148
3991,3991,FEB496C5821975C466BBF1CF529CA926,42623,15,17,2,22,49,1149
3992,3992,FEB496C5821975C466BBF1CF529CA926,13961,18,22,4,42,48,2148
3997,3997,8D431E4EF5D87BD7BBE15F3B7CAAFB54,11061,0,13,13,29,48,1498
3998,3998,8D431E4EF5D87BD7BBE15F3B7CAAFB54,40341,17,18,1,23,49,1199
3999,3999,8D431E4EF5D87BD7BBE15F3B7CAAFB54,11061,21,23,2,29,48,1498
4000,4000,1CB58B09C25D2B7B49F5AB599F0CB5E0,42161,9,11,2,36,47,1847
4001,4001,1CB58B09C25D2B7B49F5AB599F0CB5E0,40341,14,18,4,23,49,1199
4002,4002,1CB58B09C25D2B7B49F5AB599F0CB5E0,42301,21,22,1,36,47,1847
4003,4003,34460EAE07C3CF26D59119C1F819471C,12131,0,7,7,32,47,1647
4004,4004,34460EAE07C3CF26D59119C1F819471C,10451,9,15,6,25,48,1298
4005,4005,34460EAE07C3CF26D59119C1F819471C,12131,17,23,6,32,47,1647
4010,4010,B51B8C74A49BD6867CCC9145F07F78FF,12921,1,3,2,9,41,491
4011,4011,B51B8C74A49BD6867CCC9145F07F78FF,13091,6,7,1,20,42,1042
4012,4012,B51B8C74A49BD6867CCC9145F07F78FF,43021,12,13,1,16,43,843
4013,4013,B51B8C74A49BD6867CCC9145F07F78FF,12921,15,16,1,9,41,491
4014,4014,B51B8C74A49BD6867CCC9145F07F78FF,43021,16,21,5,16,43,843
4021,4021,F7065DEB6EFDA3755D41B0E87F33EEEE,42351,0,8,8,38,45,1945
4022,4022,F7065DEB6EFDA3755D41B0E87F33EEEE,13911,8,10,2,39,46,1996
4023,4023,F7065DEB6EFDA3755D41B0E87F33EEEE,42351,11,13,2,38,45,1945
4024,4024,F7065DEB6EFDA3755D41B0E87F33EEEE,13911,15,16,1,39,46,1996
4025,4025,F7065DEB6EFDA3755D41B0E87F33EEEE,11261,18,19,1,36,46,1846
4026,4026,F7065DEB6EFDA3755D41B0E87F33EEEE,42351,19,22,3,38,45,1945
4027,4027,415FC43FB4CC0D76625B5D7E80BDE869,42531,0,6,6,31,45,1595
4028,4028,415FC43FB4CC0D76625B5D7E80BDE869,12641,7,11,4,10,43,543
4029,4029,415FC43FB4CC0D76625B5D7E80BDE869,42531,12,13,1,31,45,1595
4030,4030,415FC43FB4CC0D76625B5D7E80BDE869,12641,14,16,2,10,43,543
4031,4031,415FC43FB4CC0D76625B5D7E80BDE869,42531,19,23,4,31,45,1595
4038,4038,15351107348D533F1A62174A9ED24724,13314,0,7,7,31,39,1589
4039,4039,15351107348D533F1A62174A9ED24724,12521,8,17,9,35,41,1791
4040,4040,15351107348D533F1A62174A9ED24724,13314,19,23,4,31,39,1589
4041,4041,3CF5F62AE12DD66999666DAC6F22CDF6,11541,0,15,15,35,49,1799
4042,4042,3CF5F62AE12DD66999666DAC6F22CDF6,40341,16,17,1,23,49,1199
4043,4043,3CF5F62AE12DD66999666DAC6F22CDF6,42301,18,19,1,36,47,1847
4044,4044,3CF5F62AE12DD66999666DAC6F22CDF6,11541,22,23,1,35,49,1799
4045,4045,E2FC80C995A3EFA4B2AF01BAD4B24C1C,11074,0,6,6,37,47,1897
4046,4046,E2FC80C995A3EFA4B2AF01BAD4B24C1C,11701,10,11,1,43,48,2198
4047,4047,E2FC80C995A3EFA4B2AF01BAD4B24C1C,11211,12,13,1,34,49,1749
4048,4048,E2FC80C995A3EFA4B2AF01BAD4B24C1C,10111,17,19,2,37,47,1897
4049,4049,DF87A912FB5A87CC67505086D59E3EE5,42031,0,7,7,40,46,2046
4050,4050,DF87A912FB5A87CC67505086D59E3EE5,13371,7,9,2,41,47,2097
4051,4051,DF87A912FB5A87CC67505086D59E3EE5,11231,9,21,12,37,49,1899
4052,4052,1E478A5FEF40D5F63DF757696B4C9EAC,12971,0,1,1,32,48,1648
4053,4053,1E478A5FEF40D5F63DF757696B4C9EAC,40637,2,9,7,36,47,1847
4054,4054,1E478A5FEF40D5F63DF757696B4C9EAC,42871,10,20,10,30,45,1545
4055,4055,1E478A5FEF40D5F63DF757696B4C9EAC,10431,22,23,1,33,49,1699
4060,4060,FDF3A555382668B3FCFD730AFF8664D2,10411,0,6,6,36,48,1848
4061,4061,FDF3A555382668B3FCFD730AFF8664D2,11231,8,12,4,37,49,1899
4062,4062,FDF3A555382668B3FCFD730AFF8664D2,10411,12,14,2,36,48,1848
4063,4063,FDF3A555382668B3FCFD730AFF8664D2,10471,14,16,2,37,48,1898
4064,4064,FDF3A555382668B3FCFD730AFF8664D2,11231,16,18,2,37,49,1899
4065,4065,FDF3A555382668B3FCFD730AFF8664D2,10411,20,23,3,36,48,1848
4075,4075,A52680CFF3255B80F2E899094DC1E938,13951,0,7,7,47,45,2395
4076,4076,A52680CFF3255B80F2E899094DC1E938,43951,7,18,11,49,41,2491
4077,4077,A52680CFF3255B80F2E899094DC1E938,43051,21,23,2,46,45,2345
4078,4078,D97F93CB7946C1399F01BAA588B11A0C,42351,0,7,7,38,45,1945
4079,4079,D97F93CB7946C1399F01BAA588B11A0C,11261,9,10,1,36,46,1846
4080,4080,D97F93CB7946C1399F01BAA588B11A0C,42351,11,14,3,38,45,1945
4081,4081,D97F93CB7946C1399F01BAA588B11A0C,11261,14,16,2,36,46,1846
4082,4082,D97F93CB7946C1399F01BAA588B11A0C,42351,19,20,1,38,45,1945
4086,4086,2F5B7ED53328F20A9F800703BCFAE68A,13314,0,4,4,31,39,1589
4087,4087,2F5B7ED53328F20A9F800703BCFAE68A,12521,4,13,9,35,41,1791
4088,4088,2F5B7ED53328F20A9F800703BCFAE68A,13314,14,23,9,31,39,1589
4089,4089,FAB6E0EFF3959E8AB05799759710E733,11001,0,15,15,42,47,2147
4090,4090,FAB6E0EFF3959E8AB05799759710E733,13371,15,17,2,41,47,2097
4091,4091,FAB6E0EFF3959E8AB05799759710E733,13121,18,20,2,38,46,1946
4092,4092,2F2D1E61607F6ADC79433F98695F59B1,13371,0,8,8,41,47,2097
4093,4093,2F2D1E61607F6ADC79433F98695F59B1,49181,10,11,1,21,31,1081
4094,4094,2F2D1E61607F6ADC79433F98695F59B1,13371,15,23,8,41,47,2097
4099,4099,34B0487DA91675A6216B605C367EE35D,40094,1,3,2,29,48,1498
4100,4100,34B0487DA91675A6216B605C367EE35D,43761,4,8,4,32,47,1647
4101,4101,34B0487DA91675A6216B605C367EE35D,40094,12,14,2,29,48,1498
4102,4102,34B0487DA91675A6216B605C367EE35D,10221,15,17,2,34,49,1749
4103,4103,34B0487DA91675A6216B605C367EE35D,11151,20,21,1,30,48,1548
4107,4107,104C7B4B7606A62E54D0F0C8A8FC6416,10292,0,8,8,30,47,1547
4108,4108,104C7B4B7606A62E54D0F0C8A8FC6416,10401,10,11,1,33,49,1699
4109,4109,104C7B4B7606A62E54D0F0C8A8FC6416,10295,22,23,1,30,47,1547
4110,4110,7308A861032DD6CDA204025A180927B9,42151,0,2,2,35,45,1795
4111,4111,7308A861032DD6CDA204025A180927B9,12311,5,19,14,30,44,1544
4112,4112,7308A861032DD6CDA204025A180927B9,12661,20,22,2,32,45,1645
4113,4113,078E2223E91F81B17020069DDFB27450,11875,0,10,10,30,46,1546
4114,4114,078E2223E91F81B17020069DDFB27450,10107,11,13,2,38,49,1949
4115,4115,078E2223E91F81B17020069DDFB27450,10421,13,16,3,41,48,2098
4116,4116,078E2223E91F81B17020069DDFB27450,11871,18,23,5,29,46,1496
4128,4128,46C451A78B7E321B3F0DB3CC5D554FD8,42191,0,17,17,38,49,1949
4129,4129,46C451A78B7E321B3F0DB3CC5D554FD8,42621,19,20,1,24,49,1249
4130,4130,46C451A78B7E321B3F0DB3CC5D554FD8,42191,22,23,1,38,49,1949
4131,4131,FAD054CB1E50A863F05124534D53D394,13221,0,10,10,40,47,2047
4132,4132,FAD054CB1E50A863F05124534D53D394,10951,13,16,3,29,48,1498
4133,4133,FAD054CB1E50A863F05124534D53D394,11631,20,23,3,12,49,649
4134,4134,1F6BCFEB56D245CBF5160F742055C8A2,11151,0,7,7,30,48,1548
4135,4135,1F6BCFEB56D245CBF5160F742055C8A2,11061,10,12,2,29,48,1498
4136,4136,1F6BCFEB56D245CBF5160F742055C8A2,11151,12,16,4,30,48,1548
4137,4137,1F6BCFEB56D245CBF5160F742055C8A2,43391,19,20,1,29,48,1498
4138,4138,1F6BCFEB56D245CBF5160F742055C8A2,11151,21,23,2,30,48,1548
4139,4139,E9E9C9DE1050FFAD63256F714329F12B,42201,0,11,11,43,46,2196
4140,4140,E9E9C9DE1050FFAD63256F714329F12B,13951,12,13,1,47,45,2395
4141,4141,E9E9C9DE1050FFAD63256F714329F12B,42201,14,23,9,43,46,2196
4142,4142,7A880FE847C48EF3051E04A866E8ED9A,42341,3,12,9,43,49,2199
4143,4143,7A880FE847C48EF3051E04A866E8ED9A,11551,12,15,3,39,49,1999
4144,4144,7A880FE847C48EF3051E04A866E8ED9A,13221,16,17,1,40,47,2047
4145,4145,7A880FE847C48EF3051E04A866E8ED9A,11741,20,23,3,42,49,2149
4149,4149,345D4029BCC33DBFE6D7841DB885E7B2,42491,0,7,7,32,46,1646
4150,4150,345D4029BCC33DBFE6D7841DB885E7B2,11741,8,11,3,42,49,2149
4151,4151,345D4029BCC33DBFE6D7841DB885E7B2,42961,13,14,1,35,49,1799
4152,4152,345D4029BCC33DBFE6D7841DB885E7B2,11301,14,17,3,41,49,2099
4153,4153,345D4029BCC33DBFE6D7841DB885E7B2,12083,17,22,5,36,49,1849
4154,4154,9405F1AA60C8D4BA8CE42D14FCCDEA09,10381,0,13,13,31,49,1599
4155,4155,9405F1AA60C8D4BA8CE42D14FCCDEA09,42161,15,17,2,36,47,1847
4156,4156,9405F1AA60C8D4BA8CE42D14FCCDEA09,10381,18,22,4,31,49,1599
4157,4157,758ECA2D694A442FBDD9376D536CAB79,10771,1,7,6,41,46,2096
4158,4158,758ECA2D694A442FBDD9376D536CAB79,43951,9,17,8,49,41,2491
4159,4159,758ECA2D694A442FBDD9376D536CAB79,13951,20,22,2,47,45,2395
4160,4160,269D447672970199F5F53A3187F57CEB,10901,0,16,16,35,48,1798
4161,4161,269D447672970199F5F53A3187F57CEB,42381,16,18,2,39,41,1991
4162,4162,269D447672970199F5F53A3187F57CEB,10901,21,23,2,35,48,1798
4169,4169,026400BF77ED9426898CFF8EBE921A19,43751,0,6,6,19,48,998
4170,4170,026400BF77ED9426898CFF8EBE921A19,12581,7,11,4,24,48,1248
4171,4171,026400BF77ED9426898CFF8EBE921A19,43751,12,13,1,19,48,998
4172,4172,026400BF77ED9426898CFF8EBE921A19,12581,13,19,6,24,48,1248
4173,4173,026400BF77ED9426898CFF8EBE921A19,43751,21,23,2,19,48,998
4177,4177,CBB3A1D6824270FA410EE426B6C16351,12641,10,11,1,10,43,543
4178,4178,CBB3A1D6824270FA410EE426B6C16351,49201,12,13,1,7,41,391
4179,4179,CBB3A1D6824270FA410EE426B6C16351,12921,13,14,1,9,41,491
4180,4180,CBB3A1D6824270FA410EE426B6C16351,49201,15,16,1,7,41,391
4181,4181,CBB3A1D6824270FA410EE426B6C16351,12921,16,19,3,9,41,491
4182,4182,CBB3A1D6824270FA410EE426B6C16351,19111,19,21,2,9,45,495
4183,4183,93DD2C863C5AA53C83002ED6F1D5AEBB,19031,0,6,6,1,42,92
4184,4184,93DD2C863C5AA53C83002ED6F1D5AEBB,19181,9,13,4,8,40,440
4185,4185,93DD2C863C5AA53C83002ED6F1D5AEBB,12921,13,15,2,9,41,491
4186,4186,93DD2C863C5AA53C83002ED6F1D5AEBB,12641,18,22,4,10,43,543
4193,4193,C5CEA5CBE70F0BCBF75A48F426F2F5F5,12561,1,3,2,45,43,2293
4194,4194,C5CEA5CBE70F0BCBF75A48F426F2F5F5,13231,7,8,1,39,46,1996
4195,4195,C5CEA5CBE70F0BCBF75A48F426F2F5F5,12561,10,23,13,45,43,2293
4196,4196,C29236190F3AC44E80C226AA7DDFB4B6,42321,0,1,1,43,47,2197
4197,4197,C29236190F3AC44E80C226AA7DDFB4B6,10801,2,6,4,42,47,2147
4198,4198,C29236190F3AC44E80C226AA7DDFB4B6,10421,9,11,2,41,48,2098
4199,4199,C29236190F3AC44E80C226AA7DDFB4B6,11701,15,16,1,43,48,2198
4200,4200,C29236190F3AC44E80C226AA7DDFB4B6,42321,19,20,1,43,47,2197
4201,4201,C29236190F3AC44E80C226AA7DDFB4B6,10801,22,23,1,42,47,2147
4211,4211,A0A00D4FFCF39B121347488247DF3626,12311,1,5,4,30,44,1544
4212,4212,A0A00D4FFCF39B121347488247DF3626,11875,7,9,2,30,46,1546
4213,4213,A0A00D4FFCF39B121347488247DF3626,10301,9,10,1,31,45,1595
4214,4214,A0A00D4FFCF39B121347488247DF3626,11875,12,15,3,30,46,1546
4215,4215,A0A00D4FFCF39B121347488247DF3626,12311,17,20,3,30,44,1544
4216,4216,DEAA09DD3D6B03626A2328FE868C62CE,42681,0,10,10,24,48,1248
4217,4217,DEAA09DD3D6B03626A2328FE868C62CE,11074,15,16,1,37,47,1897
4218,4218,DEAA09DD3D6B03626A2328FE868C62CE,42681,19,21,2,24,48,1248
4232,4232,9F8B1DD6D80751B4C4B13C705B0FAEDB,12792,0,15,15,34,30,1730
4233,4233,9F8B1DD6D80751B4C4B13C705B0FAEDB,15391,19,20,1,35,26,1776
4234,4234,9F8B1DD6D80751B4C4B13C705B0FAEDB,12792,21,23,2,34,30,1730
4235,4235,04F832571F2FA91E6613526630C6992E,10471,0,16,16,37,48,1898
4236,4236,04F832571F2FA91E6613526630C6992E,42381,17,18,1,39,41,1991
4237,4237,04F832571F2FA91E6613526630C6992E,10471,19,23,4,37,48,1898
4238,4238,BD617A9E4D9F179C8ADCCBAAC0159F0B,40277,0,2,2,35,49,1799
4239,4239,BD617A9E4D9F179C8ADCCBAAC0159F0B,43951,8,11,3,49,41,2491
4240,4240,BD617A9E4D9F179C8ADCCBAAC0159F0B,13411,12,18,6,49,42,2492
4241,4241,BA91B9470249EAFC3720D0B9152253D7,42501,0,7,7,28,47,1447
4242,4242,BA91B9470249EAFC3720D0B9152253D7,12083,7,10,3,36,49,1849
4243,4243,BA91B9470249EAFC3720D0B9152253D7,42501,11,23,12,28,47,1447
4244,4244,37E4BCF7FCD3080EBB0EFE1716A04474,40444,0,8,8,27,48,1398
4245,4245,37E4BCF7FCD3080EBB0EFE1716A04474,10381,10,11,1,31,49,1599
4246,4246,37E4BCF7FCD3080EBB0EFE1716A04474,42831,12,15,3,27,48,1398
4247,4247,37E4BCF7FCD3080EBB0EFE1716A04474,42071,15,18,3,31,49,1599
4248,4248,37E4BCF7FCD3080EBB0EFE1716A04474,42831,19,22,3,27,48,1398
4249,4249,39B67DC39A8ED7B06231FF29E273DA57,13371,0,9,9,41,47,2097
4250,4250,39B67DC39A8ED7B06231FF29E273DA57,42381,11,12,1,39,41,1991
4251,4251,39B67DC39A8ED7B06231FF29E273DA57,13371,14,23,9,41,47,2097
4256,4256,3BECF31DFB7D64B1A13F9240B42280C8,42321,0,9,9,43,47,2197
4257,4257,3BECF31DFB7D64B1A13F9240B42280C8,10107,16,18,2,38,49,1949
4258,4258,3BECF31DFB7D64B1A13F9240B42280C8,42321,19,23,4,43,47,2197
4265,4265,215BDE429F30F137ADAADE2A69B9C88C,43644,0,2,2,14,38,738
4266,4266,215BDE429F30F137ADAADE2A69B9C88C,19571,3,4,1,1,36,86
4267,4267,215BDE429F30F137ADAADE2A69B9C88C,43644,4,6,2,14,38,738
4268,4268,215BDE429F30F137ADAADE2A69B9C88C,49201,7,8,1,7,41,391
4269,4269,215BDE429F30F137ADAADE2A69B9C88C,12641,15,18,3,10,43,543
4270,4270,215BDE429F30F137ADAADE2A69B9C88C,43644,18,21,3,14,38,738
4271,4271,AB549C59FCD93A3593309CBEEEB0538B,11381,1,17,16,30,47,1547
4272,4272,AB549C59FCD93A3593309CBEEEB0538B,42321,18,19,1,43,47,2197
4273,4273,AB549C59FCD93A3593309CBEEEB0538B,11381,21,23,2,30,47,1547
4277,4277,63513D6B50408304273B49ADE712E1D0,40637,0,8,8,36,47,1847
4278,4278,63513D6B50408304273B49ADE712E1D0,42291,8,11,3,29,48,1498
4279,4279,63513D6B50408304273B49ADE712E1D0,40673,13,15,2,36,48,1848
4280,4280,63513D6B50408304273B49ADE712E1D0,42291,18,23,5,29,48,1498
4281,4281,44AA91905A7E8DBC24B0A51CC88C9204,42151,3,6,3,35,45,1795
4282,4282,44AA91905A7E8DBC24B0A51CC88C9204,42531,6,7,1,31,45,1595
4283,4283,44AA91905A7E8DBC24B0A51CC88C9204,12311,7,8,1,30,44,1544
4284,4284,44AA91905A7E8DBC24B0A51CC88C9204,42151,13,14,1,35,45,1795
4285,4285,44AA91905A7E8DBC24B0A51CC88C9204,12311,15,17,2,30,44,1544
4286,4286,44AA91905A7E8DBC24B0A51CC88C9204,42151,18,20,2,35,45,1795
4287,4287,44AA91905A7E8DBC24B0A51CC88C9204,12311,21,23,2,30,44,1544
4288,4288,95370FE550223219072A41E321AAB07C,11074,0,11,11,37,47,1897
4289,4289,95370FE550223219072A41E321AAB07C,12921,12,13,1,9,41,491
4290,4290,95370FE550223219072A41E321AAB07C,11331,15,19,4,37,48,1898
4291,4291,95370FE550223219072A41E321AAB07C,40673,20,22,2,36,48,1848
4292,4292,B7EEF2B178640D89D1EA0EECF6DA162E,12841,0,7,7,37,47,1897
4293,4293,B7EEF2B178640D89D1EA0EECF6DA162E,12211,9,17,8,41,44,2094
4294,4294,B7EEF2B178640D89D1EA0EECF6DA162E,12841,19,23,4,37,47,1897
4295,4295,ACFB892F60074737B9E0F9A496FA6823,42861,0,3,3,37,44,1894
4296,4296,ACFB892F60074737B9E0F9A496FA6823,42151,3,10,7,35,45,1795
4297,4297,ACFB892F60074737B9E0F9A496FA6823,42861,10,12,2,37,44,1894
4298,4298,ACFB892F60074737B9E0F9A496FA6823,42151,15,17,2,35,45,1795
4299,4299,ACFB892F60074737B9E0F9A496FA6823,42351,19,21,2,38,45,1945
4300,4300,ACFB892F60074737B9E0F9A496FA6823,42861,21,23,2,37,44,1894
4301,4301,C783F573219BE815B78681C436E8AC03,11871,0,7,7,29,46,1496
4302,4302,C783F573219BE815B78681C436E8AC03,12601,8,16,8,25,47,1297
4303,4303,C783F573219BE815B78681C436E8AC03,11875,17,20,3,30,46,1546
4304,4304,C783F573219BE815B78681C436E8AC03,11871,21,22,1,29,46,1496
4305,4305,6C0E943C8B3CE3071E466B3888DE833C,42531,6,8,2,31,45,1595
4306,4306,6C0E943C8B3CE3071E466B3888DE833C,12311,8,15,7,30,44,1544
4307,4307,6C0E943C8B3CE3071E466B3888DE833C,19744,20,21,1,6,43,343
4308,4308,6B301C33659FC7DDF1FEBEFD22E1FEA8,42931,0,12,12,41,49,2099
4309,4309,6B301C33659FC7DDF1FEBEFD22E1FEA8,43761,17,18,1,32,47,1647
4310,4310,6B301C33659FC7DDF1FEBEFD22E1FEA8,42931,22,23,1,41,49,2099
4315,4315,098D732E3EBF6403141AA2A02CAC7F6D,11271,0,8,8,37,48,1898
4316,4316,098D732E3EBF6403141AA2A02CAC7F6D,13511,8,10,2,34,48,1748
4317,4317,098D732E3EBF6403141AA2A02CAC7F6D,11231,10,13,3,37,49,1899
4318,4318,098D732E3EBF6403141AA2A02CAC7F6D,43161,14,16,2,35,47,1797
4319,4319,098D732E3EBF6403141AA2A02CAC7F6D,43731,16,18,2,34,47,1747
4320,4320,098D732E3EBF6403141AA2A02CAC7F6D,10281,18,21,3,33,48,1698
4321,4321,098D732E3EBF6403141AA2A02CAC7F6D,10471,21,22,1,37,48,1898
4325,4325,4442F4779857F254B3128B4BDEABAE8D,11061,0,8,8,29,48,1498
4326,4326,4442F4779857F254B3128B4BDEABAE8D,10107,15,17,2,38,49,1949
4327,4327,4442F4779857F254B3128B4BDEABAE8D,11061,18,23,5,29,48,1498
4328,4328,176F4E967E986DAF00C74DDD3BF2A8FE,42271,1,6,5,40,47,2047
4329,4329,176F4E967E986DAF00C74DDD3BF2A8FE,11806,6,7,1,41,48,2098
4330,4330,176F4E967E986DAF00C74DDD3BF2A8FE,42271,8,11,3,40,47,2047
4331,4331,176F4E967E986DAF00C74DDD3BF2A8FE,11806,16,17,1,41,48,2098
4332,4332,176F4E967E986DAF00C74DDD3BF2A8FE,42401,19,23,4,36,47,1847
4333,4333,CFB5B91AB0CD7543884ADBE535AD19D6,43021,0,6,6,16,43,843
4334,4334,CFB5B91AB0CD7543884ADBE535AD19D6,12641,7,9,2,10,43,543
4335,4335,CFB5B91AB0CD7543884ADBE535AD19D6,43021,14,23,9,16,43,843
4336,4336,2881834474B021D3CB48D66D6B38B4E5,11921,0,6,6,38,48,1948
4337,4337,2881834474B021D3CB48D66D6B38B4E5,42523,8,13,5,31,47,1597
4338,4338,2881834474B021D3CB48D66D6B38B4E5,43311,14,15,1,31,48,1598
4339,4339,2881834474B021D3CB48D66D6B38B4E5,11161,16,18,2,32,48,1648
4340,4340,2881834474B021D3CB48D66D6B38B4E5,11921,20,23,3,38,48,1948
4344,4344,E28CB398A05F199E2CD954D4A53E76A9,42971,0,5,5,43,49,2199
4345,4345,E28CB398A05F199E2CD954D4A53E76A9,42601,5,8,3,44,48,2248
4346,4346,E28CB398A05F199E2CD954D4A53E76A9,11701,10,14,4,43,48,2198
4347,4347,E28CB398A05F199E2CD954D4A53E76A9,42971,18,20,2,43,49,2199
4348,4348,E28CB398A05F199E2CD954D4A53E76A9,11701,21,22,1,43,48,2198
4349,4349,06447D7C67D558233065F1766A844E28,13411,0,8,8,49,42,2492
4350,4350,06447D7C67D558233065F1766A844E28,43951,8,11,3,49,41,2491
4351,4351,06447D7C67D558233065F1766A844E28,13411,12,13,1,49,42,2492
4352,4352,06447D7C67D558233065F1766A844E28,43951,14,15,1,49,41,2491
4353,4353,06447D7C67D558233065F1766A844E28,13411,17,22,5,49,42,2492
4354,4354,5FA17670CF7B34EAE6DE8FBA5C753F49,12661,2,7,5,32,45,1645
4355,4355,5FA17670CF7B34EAE6DE8FBA5C753F49,11551,9,12,3,39,49,1999
4356,4356,5FA17670CF7B34EAE6DE8FBA5C753F49,10971,15,17,2,35,47,1797
4357,4357,5FA17670CF7B34EAE6DE8FBA5C753F49,11551,21,23,2,39,49,1999
4361,4361,94D2DC29F82C6C3DA49DC7A81D34B7C8,13341,0,6,6,44,45,2245
4362,4362,94D2DC29F82C6C3DA49DC7A81D34B7C8,43101,9,10,1,46,40,2340
4363,4363,94D2DC29F82C6C3DA49DC7A81D34B7C8,13341,11,23,12,44,45,2245
4364,4364,5B1C0BC031C302008BE737E10A20E45F,11481,0,8,8,41,48,2098
4365,4365,5B1C0BC031C302008BE737E10A20E45F,13771,13,16,3,21,45,1095
4366,4366,5B1C0BC031C302008BE737E10A20E45F,12601,18,19,1,25,47,1297
4371,4371,02E0CB45554333B2040DD7003864DFC5,43391,0,10,10,29,48,1498
4372,4372,02E0CB45554333B2040DD7003864DFC5,11541,13,14,1,35,49,1799
4373,4373,02E0CB45554333B2040DD7003864DFC5,40951,15,16,1,36,49,1849
4374,4374,02E0CB45554333B2040DD7003864DFC5,11231,17,19,2,37,49,1899
4375,4375,2FB9B4671D70EAA841884AE3AD828EC1,12561,0,4,4,45,43,2293
4376,4376,2FB9B4671D70EAA841884AE3AD828EC1,13341,8,10,2,44,45,2245
4377,4377,2FB9B4671D70EAA841884AE3AD828EC1,11061,13,17,4,29,48,1498
4378,4378,2FB9B4671D70EAA841884AE3AD828EC1,13341,21,23,2,44,45,2245
4385,4385,3FBA130DE96D19DDB92B7C1710211CF0,10611,0,7,7,32,48,1648
4386,4386,3FBA130DE96D19DDB92B7C1710211CF0,10251,7,9,2,35,47,1797
4387,4387,3FBA130DE96D19DDB92B7C1710211CF0,10611,10,13,3,32,48,1648
4388,4388,3FBA130DE96D19DDB92B7C1710211CF0,13651,13,15,2,30,47,1547
4389,4389,3FBA130DE96D19DDB92B7C1710211CF0,10611,19,23,4,32,48,1648
4390,4390,5B0A3A237A4956AD5374313D05D80155,42031,0,11,11,40,46,2046
4391,4391,5B0A3A237A4956AD5374313D05D80155,10107,12,14,2,38,49,1949
4392,4392,5B0A3A237A4956AD5374313D05D80155,42031,14,21,7,40,46,2046
4393,4393,644074FAED2D07B771DBBC3C2ED7ABF4,13411,0,6,6,49,42,2492
4394,4394,644074FAED2D07B771DBBC3C2ED7ABF4,43951,6,7,1,49,41,2491
4395,4395,644074FAED2D07B771DBBC3C2ED7ABF4,13411,11,13,2,49,42,2492
4396,4396,644074FAED2D07B771DBBC3C2ED7ABF4,43951,14,19,5,49,41,2491
4397,4397,644074FAED2D07B771DBBC3C2ED7ABF4,13411,21,23,2,49,42,2492
4398,4398,9A0E1728710A4135A2CED14F55D7DC99,11231,2,7,5,37,49,1899
4399,4399,9A0E1728710A4135A2CED14F55D7DC99,11291,8,11,3,40,49,2049
4400,4400,9A0E1728710A4135A2CED14F55D7DC99,43181,15,17,2,39,48,1998
4401,4401,9A0E1728710A4135A2CED14F55D7DC99,40171,17,19,2,38,48,1948
4402,4402,9A0E1728710A4135A2CED14F55D7DC99,11521,21,23,2,41,48,2098
4410,4410,A655C67D52402CE056E16AFA14815F89,11481,1,3,2,41,48,2098
4411,4411,A655C67D52402CE056E16AFA14815F89,13271,3,8,5,41,47,2097
4412,4412,A655C67D52402CE056E16AFA14815F89,11481,9,11,2,41,48,2098
4413,4413,A655C67D52402CE056E16AFA14815F89,13101,11,12,1,40,47,2047
4414,4414,A655C67D52402CE056E16AFA14815F89,13271,14,16,2,41,47,2097
4415,4415,A655C67D52402CE056E16AFA14815F89,11481,20,21,1,41,48,2098
4432,4432,7E3A49A9F3B04050C259F110804E017C,10191,0,9,9,40,48,2048
4433,4433,7E3A49A9F3B04050C259F110804E017C,11651,10,18,8,33,47,1697
4434,4434,7E3A49A9F3B04050C259F110804E017C,12401,20,23,3,39,49,1999
4446,4446,4E362C32A29B97A8B1D3D1CAEBE45453,13351,0,12,12,48,48,2448
4447,4447,4E362C32A29B97A8B1D3D1CAEBE45453,11701,14,16,2,43,48,2198
4448,4448,4E362C32A29B97A8B1D3D1CAEBE45453,13351,17,23,6,48,48,2448
4449,4449,8FDF90BCC35D3EEB194B0E3446C0F9D8,42151,0,12,12,35,45,1795
4450,4450,8FDF90BCC35D3EEB194B0E3446C0F9D8,40341,13,15,2,23,49,1199
4451,4451,8FDF90BCC35D3EEB194B0E3446C0F9D8,42151,16,17,1,35,45,1795
4452,4452,8FDF90BCC35D3EEB194B0E3446C0F9D8,11941,18,20,2,37,46,1896
4453,4453,8FDF90BCC35D3EEB194B0E3446C0F9D8,42151,21,23,2,35,45,1795
4454,4454,E8500F4CD84CAAEC607E94BD30603728,42921,0,6,6,33,47,1697
4455,4455,E8500F4CD84CAAEC607E94BD30603728,10881,6,9,3,34,48,1748
4456,4456,E8500F4CD84CAAEC607E94BD30603728,13601,9,11,2,34,47,1747
4457,4457,E8500F4CD84CAAEC607E94BD30603728,11561,14,15,1,32,49,1649
4458,4458,E8500F4CD84CAAEC607E94BD30603728,43731,20,21,1,34,47,1747
4459,4459,1DA79481C6B6D1D9223A378A0D81757A,10111,0,2,2,37,47,1897
4460,4460,1DA79481C6B6D1D9223A378A0D81757A,42771,2,4,2,36,47,1847
4461,4461,1DA79481C6B6D1D9223A378A0D81757A,10111,5,15,10,37,47,1897
4462,4462,1DA79481C6B6D1D9223A378A0D81757A,10251,16,18,2,35,47,1797
4463,4463,1DA79481C6B6D1D9223A378A0D81757A,10841,18,23,5,37,47,1897
4464,4464,EB24244BB73BD551F4B0247AA2F1F50A,12971,0,7,7,32,48,1648
4465,4465,EB24244BB73BD551F4B0247AA2F1F50A,13731,10,11,1,33,49,1699
4466,4466,EB24244BB73BD551F4B0247AA2F1F50A,12381,13,17,4,32,48,1648
4467,4467,EB24244BB73BD551F4B0247AA2F1F50A,11531,18,20,2,34,49,1749
4468,4468,EB24244BB73BD551F4B0247AA2F1F50A,12381,20,23,3,32,48,1648
4473,4473,DC11B465805E4B821937065119204055,12311,1,9,8,30,44,1544
4474,4474,DC11B465805E4B821937065119204055,42151,10,12,2,35,45,1795
4475,4475,DC11B465805E4B821937065119204055,12311,15,19,4,30,44,1544
4480,4480,88EA299A0C16C608CBE4531419EDE59B,15404,0,6,6,40,24,2024
4481,4481,88EA299A0C16C608CBE4531419EDE59B,12881,7,9,2,47,22,2372
4482,4482,88EA299A0C16C608CBE4531419EDE59B,15404,12,14,2,40,24,2024
4483,4483,88EA299A0C16C608CBE4531419EDE59B,12881,14,16,2,47,22,2372
4484,4484,88EA299A0C16C608CBE4531419EDE59B,15404,19,23,4,40,24,2024
4485,4485,9FC0BC45BE701813F526EAC57C959C9E,10781,9,12,3,35,47,1797
4486,4486,9FC0BC45BE701813F526EAC57C959C9E,13101,13,16,3,40,47,2047
4487,4487,9FC0BC45BE701813F526EAC57C959C9E,10781,17,21,4,35,47,1797
4491,4491,F681B79833B44C7DE260E9A55ED030A3,19741,0,6,6,5,44,294
4492,4492,F681B79833B44C7DE260E9A55ED030A3,12921,7,8,1,9,41,491
4493,4493,F681B79833B44C7DE260E9A55ED030A3,19111,8,9,1,9,45,495
4494,4494,F681B79833B44C7DE260E9A55ED030A3,19741,11,13,2,5,44,294
4495,4495,F681B79833B44C7DE260E9A55ED030A3,12921,14,16,2,9,41,491
4496,4496,F681B79833B44C7DE260E9A55ED030A3,19111,16,18,2,9,45,495
4497,4497,F681B79833B44C7DE260E9A55ED030A3,19741,19,23,4,5,44,294
4498,4498,FEE5ACDB24DFF6E9A25C550C618C43AE,10251,0,1,1,35,47,1797
4499,4499,FEE5ACDB24DFF6E9A25C550C618C43AE,11331,5,6,1,37,48,1898
4500,4500,FEE5ACDB24DFF6E9A25C550C618C43AE,10251,11,13,2,35,47,1797
4501,4501,FEE5ACDB24DFF6E9A25C550C618C43AE,40637,13,17,4,36,47,1847
4502,4502,FEE5ACDB24DFF6E9A25C550C618C43AE,10251,17,23,6,35,47,1797
4503,4503,055392723CC93B49A610878855A95D5B,11471,0,6,6,12,48,648
4504,4504,055392723CC93B49A610878855A95D5B,19441,7,14,7,8,46,446
4505,4505,055392723CC93B49A610878855A95D5B,19901,16,23,7,7,44,394
4506,4506,394B81CC36B31D897120A6153D7C1457,11061,0,4,4,29,48,1498
4507,4507,394B81CC36B31D897120A6153D7C1457,12121,6,9,3,29,47,1497
4508,4508,394B81CC36B31D897120A6153D7C1457,42501,10,11,1,28,47,1447
4509,4509,394B81CC36B31D897120A6153D7C1457,12121,11,14,3,29,47,1497
4510,4510,394B81CC36B31D897120A6153D7C1457,11061,17,20,3,29,48,1498
4514,4514,07E992F561CF39DBB35462863FFE0A66,12641,3,14,11,10,43,543
4515,4515,07E992F561CF39DBB35462863FFE0A66,42321,16,18,2,43,47,2197
4516,4516,07E992F561CF39DBB35462863FFE0A66,10107,19,21,2,38,49,1949
4517,4517,F0325CEF852754DCE2C27B3EFD10E96B,12221,4,5,1,43,44,2194
4518,4518,F0325CEF852754DCE2C27B3EFD10E96B,13341,10,12,2,44,45,2245
4519,4519,F0325CEF852754DCE2C27B3EFD10E96B,12401,15,19,4,39,49,1999
4520,4520,F0325CEF852754DCE2C27B3EFD10E96B,13341,20,21,1,44,45,2245
4531,4531,F8D1CB0964200EDD6CE11F18DF30768B,15331,0,11,11,38,24,1924
4532,4532,F8D1CB0964200EDD6CE11F18DF30768B,40341,16,18,2,23,49,1199
4533,4533,F8D1CB0964200EDD6CE11F18DF30768B,15331,21,23,2,38,24,1924
4534,4534,E1D9DCC26BD9E70C84DC1D28D9FFAAE6,19621,2,5,3,5,46,296
4535,4535,E1D9DCC26BD9E70C84DC1D28D9FFAAE6,12641,7,9,2,10,43,543
4536,4536,E1D9DCC26BD9E70C84DC1D28D9FFAAE6,19904,12,16,4,9,44,494
4537,4537,E1D9DCC26BD9E70C84DC1D28D9FFAAE6,12641,19,21,2,10,43,543
4541,4541,F6332816251025BD7BE865D9790FDADB,12221,3,6,3,43,44,2194
4542,4542,F6332816251025BD7BE865D9790FDADB,10751,6,7,1,47,43,2393
4543,4543,F6332816251025BD7BE865D9790FDADB,12211,12,14,2,41,44,2094
4544,4544,F6332816251025BD7BE865D9790FDADB,12221,16,21,5,43,44,2194
4545,4545,A567BE5B1DACD6E00CC2FAA52D5DB6DF,40833,0,7,7,41,47,2097
4546,4546,A567BE5B1DACD6E00CC2FAA52D5DB6DF,42531,10,12,2,31,45,1595
4547,4547,A567BE5B1DACD6E00CC2FAA52D5DB6DF,12311,13,17,4,30,44,1544
4548,4548,A567BE5B1DACD6E00CC2FAA52D5DB6DF,40833,19,23,4,41,47,2097
4552,4552,F5EEE4E2E2A37FAB5177B1D5CC189108,10191,9,12,3,40,48,2048
4553,4553,F5EEE4E2E2A37FAB5177B1D5CC189108,13601,16,17,1,34,47,1747
4554,4554,F5EEE4E2E2A37FAB5177B1D5CC189108,11861,18,23,5,32,47,1647
4559,4559,F6947486712885EDC02BCA122A5A6DB5,15061,0,16,16,41,25,2075
4560,4560,F6947486712885EDC02BCA122A5A6DB5,12541,17,18,1,37,35,1885
4561,4561,F6947486712885EDC02BCA122A5A6DB5,15061,21,23,2,41,25,2075
4568,4568,9453219D6B8ACA7F6FC8FE6660A42D8A,13911,0,9,9,39,46,1996
4569,4569,9453219D6B8ACA7F6FC8FE6660A42D8A,42151,9,11,2,35,45,1795
4570,4570,9453219D6B8ACA7F6FC8FE6660A42D8A,13911,14,23,9,39,46,1996
4571,4571,3EEFB7BDF8C8012BA246A804A35191A0,15671,0,5,5,37,26,1876
4572,4572,3EEFB7BDF8C8012BA246A804A35191A0,15191,5,7,2,36,27,1827
4573,4573,3EEFB7BDF8C8012BA246A804A35191A0,12792,7,10,3,34,30,1730
4574,4574,3EEFB7BDF8C8012BA246A804A35191A0,15671,11,23,12,37,26,1876
4575,4575,A6FD529C3EA66C1845775EA07FC46A8F,12601,0,7,7,25,47,1297
4576,4576,A6FD529C3EA66C1845775EA07FC46A8F,12051,8,10,2,20,47,1047
4577,4577,A6FD529C3EA66C1845775EA07FC46A8F,12601,12,14,2,25,47,1297
4578,4578,A6FD529C3EA66C1845775EA07FC46A8F,12051,15,17,2,20,47,1047
4579,4579,A6FD529C3EA66C1845775EA07FC46A8F,12601,18,23,5,25,47,1297
4584,4584,9F7BD4B191C6CDB262073FE9BC5F12C5,11381,1,13,12,30,47,1547
4585,4585,9F7BD4B191C6CDB262073FE9BC5F12C5,11074,15,17,2,37,47,1897
4586,4586,9F7BD4B191C6CDB262073FE9BC5F12C5,11381,17,23,6,30,47,1547
4587,4587,AF57FD742700B6DD506E3D60F4DB6DD5,13351,0,8,8,48,48,2448
4588,4588,AF57FD742700B6DD506E3D60F4DB6DD5,10901,9,10,1,35,48,1798
4589,4589,AF57FD742700B6DD506E3D60F4DB6DD5,13471,11,12,1,47,49,2399
4590,4590,AF57FD742700B6DD506E3D60F4DB6DD5,11481,12,15,3,41,48,2098
4591,4591,AF57FD742700B6DD506E3D60F4DB6DD5,12621,18,22,4,10,48,548
4596,4596,06E6100A9347A6AC3691C42CD550F1BC,13711,0,14,14,38,46,1946
4597,4597,06E6100A9347A6AC3691C42CD550F1BC,13511,15,17,2,34,48,1748
4598,4598,06E6100A9347A6AC3691C42CD550F1BC,11753,21,23,2,35,48,1798
4599,4599,B9F4C9D18F82BAF4FF50860E0E28B6F2,42161,0,7,7,36,47,1847
4600,4600,B9F4C9D18F82BAF4FF50860E0E28B6F2,40421,8,10,2,37,48,1898
4601,4601,B9F4C9D18F82BAF4FF50860E0E28B6F2,42161,14,15,1,36,47,1847
4602,4602,B9F4C9D18F82BAF4FF50860E0E28B6F2,10251,15,17,2,35,47,1797
4603,4603,B9F4C9D18F82BAF4FF50860E0E28B6F2,42401,17,19,2,36,47,1847
4604,4604,B9F4C9D18F82BAF4FF50860E0E28B6F2,10111,20,21,1,37,47,1897
4605,4605,B9F4C9D18F82BAF4FF50860E0E28B6F2,42401,22,23,1,36,47,1847
4606,4606,28EBB6D57CDF154CAAA637D0ED8F305E,11091,0,9,9,29,47,1497
4607,4607,28EBB6D57CDF154CAAA637D0ED8F305E,19114,9,13,4,7,43,393
4608,4608,28EBB6D57CDF154CAAA637D0ED8F305E,11431,18,23,5,29,47,1497
4609,4609,C4802465E54C3EB1EF275A3A252F1CF0,43011,0,6,6,40,42,2042
4610,4610,C4802465E54C3EB1EF275A3A252F1CF0,42231,8,9,1,37,46,1896
4611,4611,C4802465E54C3EB1EF275A3A252F1CF0,43011,10,11,1,40,42,2042
4612,4612,C4802465E54C3EB1EF275A3A252F1CF0,42231,15,16,1,37,46,1896
4613,4613,C4802465E54C3EB1EF275A3A252F1CF0,43451,17,18,1,37,40,1890
4614,4614,F475546FA2D112D7D0EDED3FAB477F8E,40801,0,13,13,43,46,2196
4615,4615,F475546FA2D112D7D0EDED3FAB477F8E,40341,14,16,2,23,49,1199
4616,4616,F475546FA2D112D7D0EDED3FAB477F8E,40801,18,23,5,43,46,2196
4617,4617,1A3E9AF87A52539233BE5D40AC80FCFB,11301,0,10,10,41,49,2099
4618,4618,1A3E9AF87A52539233BE5D40AC80FCFB,10061,15,17,2,20,46,1046
4619,4619,1A3E9AF87A52539233BE5D40AC80FCFB,10971,18,19,1,35,47,1797
4620,4620,1A3E9AF87A52539233BE5D40AC80FCFB,12514,21,23,2,38,47,1947
4624,4624,0C653DC860B823A0FBD73915967D7A74,13341,0,5,5,44,45,2245
4625,4625,0C653DC860B823A0FBD73915967D7A74,12211,6,7,1,41,44,2094
4626,4626,0C653DC860B823A0FBD73915967D7A74,12221,7,10,3,43,44,2194
4627,4627,0C653DC860B823A0FBD73915967D7A74,13341,11,13,2,44,45,2245
4628,4628,0C653DC860B823A0FBD73915967D7A74,12221,13,16,3,43,44,2194
4629,4629,0C653DC860B823A0FBD73915967D7A74,13341,17,18,1,44,45,2245
4630,4630,0C653DC860B823A0FBD73915967D7A74,43051,19,20,1,46,45,2345
4634,4634,A09953F67FED80A8C2308F84F83FE6DA,42011,1,3,2,36,46,1846
4635,4635,A09953F67FED80A8C2308F84F83FE6DA,13711,7,10,3,38,46,1946
4636,4636,A09953F67FED80A8C2308F84F83FE6DA,43241,11,12,1,36,46,1846
4637,4637,A09953F67FED80A8C2308F84F83FE6DA,13711,17,19,2,38,46,1946
4638,4638,A09953F67FED80A8C2308F84F83FE6DA,43241,20,21,1,36,46,1846
4649,4649,25C8E48F46CE3AC7F14FD7208B98656B,12121,0,2,2,29,47,1497
4650,4650,25C8E48F46CE3AC7F14FD7208B98656B,13651,4,6,2,30,47,1547
4651,4651,25C8E48F46CE3AC7F14FD7208B98656B,12601,8,11,3,25,47,1297
4652,4652,25C8E48F46CE3AC7F14FD7208B98656B,12121,14,15,1,29,47,1497
4653,4653,25C8E48F46CE3AC7F14FD7208B98656B,13651,19,21,2,30,47,1547
4657,4657,9CF78E84CD3BA9E9D9C008A7E609BF72,11951,0,7,7,31,49,1599
4658,4658,9CF78E84CD3BA9E9D9C008A7E609BF72,10161,8,10,2,35,49,1799
4659,4659,9CF78E84CD3BA9E9D9C008A7E609BF72,10381,10,13,3,31,49,1599
4660,4660,9CF78E84CD3BA9E9D9C008A7E609BF72,10161,14,15,1,35,49,1799
4661,4661,9CF78E84CD3BA9E9D9C008A7E609BF72,11951,15,23,8,31,49,1599
4662,4662,CB2670EF1D333CA807E913627050A3A0,11834,0,10,10,32,45,1645
4663,4663,CB2670EF1D333CA807E913627050A3A0,12601,12,14,2,25,47,1297
4664,4664,CB2670EF1D333CA807E913627050A3A0,11834,15,23,8,32,45,1645
4669,4669,44CFFC276A65F95BE03A7F0CD0EA65D0,11381,2,6,4,30,47,1547
4670,4670,44CFFC276A65F95BE03A7F0CD0EA65D0,10371,8,18,10,37,49,1899
4671,4671,44CFFC276A65F95BE03A7F0CD0EA65D0,43761,18,23,5,32,47,1647
4676,4676,DAD4C4CCB9D717CA848AB20853599079,42521,2,6,4,31,47,1597
4677,4677,DAD4C4CCB9D717CA848AB20853599079,11101,9,16,7,18,48,948
4678,4678,DAD4C4CCB9D717CA848AB20853599079,10901,17,20,3,35,48,1798
4679,4679,DAD4C4CCB9D717CA848AB20853599079,42521,21,23,2,31,47,1597
4703,4703,39A12A7E8C423731CE90191A15A5C3F4,12921,6,7,1,9,41,491
4704,4704,39A12A7E8C423731CE90191A15A5C3F4,43021,12,13,1,16,43,843
4705,4705,39A12A7E8C423731CE90191A15A5C3F4,12921,14,19,5,9,41,491
4724,4724,837F3F02D5DF4CAFACB69987A0805A6C,40925,0,8,8,35,49,1799
4725,4725,837F3F02D5DF4CAFACB69987A0805A6C,40341,11,13,2,23,49,1199
4726,4726,837F3F02D5DF4CAFACB69987A0805A6C,11201,13,23,10,35,49,1799
4727,4727,7681E0D68D024C184A5D43D46389C591,12021,0,2,2,37,49,1899
4728,4728,7681E0D68D024C184A5D43D46389C591,42021,4,8,4,33,47,1697
4729,4729,7681E0D68D024C184A5D43D46389C591,43761,12,22,10,32,47,1647
4730,4730,620A0D1EA3EF14FD25FBF0EFC8FC8A56,42633,0,10,10,42,46,2146
4731,4731,620A0D1EA3EF14FD25FBF0EFC8FC8A56,11074,11,12,1,37,47,1897
4732,4732,620A0D1EA3EF14FD25FBF0EFC8FC8A56,42633,13,23,10,42,46,2146
4748,4748,7B7EC78C492826B1A2F98257774A5C01,11061,1,5,4,29,48,1498
4749,4749,7B7EC78C492826B1A2F98257774A5C01,10681,7,8,1,30,48,1548
4750,4750,7B7EC78C492826B1A2F98257774A5C01,40171,12,22,10,38,48,1948
4751,4751,7B7EC78C492826B1A2F98257774A5C01,11271,22,23,1,37,48,1898
4765,4765,491A238AA4384452660B45316F9C67AB,19021,0,15,15,10,45,545
4766,4766,491A238AA4384452660B45316F9C67AB,12921,15,16,1,9,41,491
4767,4767,491A238AA4384452660B45316F9C67AB,19904,20,23,3,9,44,494
4768,4768,CC1D3C2DA42F1EBED6688749C3DA1D87,11381,0,5,5,30,47,1547
4769,4769,CC1D3C2DA42F1EBED6688749C3DA1D87,11261,6,15,9,36,46,1846
4770,4770,CC1D3C2DA42F1EBED6688749C3DA1D87,13911,16,17,1,39,46,1996
4771,4771,CC1D3C2DA42F1EBED6688749C3DA1D87,43971,20,22,2,30,48,1548
4778,4778,3243BCA7877B5643A15BA00487A40335,10951,0,9,9,29,48,1498
4779,4779,3243BCA7877B5643A15BA00487A40335,11381,9,12,3,30,47,1547
4780,4780,3243BCA7877B5643A15BA00487A40335,10951,12,17,5,29,48,1498
4781,4781,3243BCA7877B5643A15BA00487A40335,10381,17,19,2,31,49,1599
4782,4782,3243BCA7877B5643A15BA00487A40335,40094,19,22,3,29,48,1498
4783,4783,3243BCA7877B5643A15BA00487A40335,11381,22,23,1,30,47,1547
4784,4784,6693E144B27A01201B52D6F23675A75D,11061,5,6,1,29,48,1498
4785,4785,6693E144B27A01201B52D6F23675A75D,11591,7,12,5,36,49,1849
4786,4786,6693E144B27A01201B52D6F23675A75D,10491,18,20,2,33,48,1698
4787,4787,6693E144B27A01201B52D6F23675A75D,43321,21,23,2,36,49,1849
4788,4788,957B13B978E49C7D5F0C344341485CC0,10651,0,6,6,36,49,1849
4789,4789,957B13B978E49C7D5F0C344341485CC0,19744,8,10,2,6,43,343
4790,4790,957B13B978E49C7D5F0C344341485CC0,19741,10,11,1,5,44,294
4791,4791,957B13B978E49C7D5F0C344341485CC0,19744,12,16,4,6,43,343
4792,4792,957B13B978E49C7D5F0C344341485CC0,40341,19,20,1,23,49,1199
4793,4793,957B13B978E49C7D5F0C344341485CC0,10651,20,23,3,36,49,1849
4798,4798,6C841C7D2D2B53A8BCAAFC5972E77D1F,11381,2,4,2,30,47,1547
4799,4799,6C841C7D2D2B53A8BCAAFC5972E77D1F,42623,8,14,6,22,49,1149
4800,4800,6C841C7D2D2B53A8BCAAFC5972E77D1F,42081,16,17,1,24,49,1249
4801,4801,6C841C7D2D2B53A8BCAAFC5972E77D1F,11381,22,23,1,30,47,1547
4802,4802,ACD04627348D28EB014FAB46490D4B92,10351,0,3,3,28,45,1445
4803,4803,ACD04627348D28EB014FAB46490D4B92,13771,4,7,3,21,45,1095
4804,4804,ACD04627348D28EB014FAB46490D4B92,12601,10,14,4,25,47,1297
4805,4805,ACD04627348D28EB014FAB46490D4B92,10351,15,16,1,28,45,1445
4806,4806,ACD04627348D28EB014FAB46490D4B92,12601,16,19,3,25,47,1297
4807,4807,ACD04627348D28EB014FAB46490D4B92,10351,19,22,3,28,45,1445
4808,4808,85FD0824809DD36E6F4EE776DF75318A,12391,0,8,8,36,49,1849
4809,4809,85FD0824809DD36E6F4EE776DF75318A,10451,12,14,2,25,48,1298
4810,4810,85FD0824809DD36E6F4EE776DF75318A,42261,17,19,2,25,49,1299
4825,4825,B5C7142939A2E6ED4C5CA8232F2EC9F9,19741,0,6,6,5,44,294
4826,4826,B5C7142939A2E6ED4C5CA8232F2EC9F9,19114,9,10,1,7,43,393
4827,4827,B5C7142939A2E6ED4C5CA8232F2EC9F9,19111,11,12,1,9,45,495
4828,4828,B5C7142939A2E6ED4C5CA8232F2EC9F9,12641,14,15,1,10,43,543
4829,4829,B5C7142939A2E6ED4C5CA8232F2EC9F9,19741,19,23,4,5,44,294
4830,4830,791234E587E0C86D41967E57B8EBA1DD,42321,0,8,8,43,47,2197
4831,4831,791234E587E0C86D41967E57B8EBA1DD,10271,9,10,1,37,46,1896
4832,4832,791234E587E0C86D41967E57B8EBA1DD,42161,10,13,3,36,47,1847
4833,4833,791234E587E0C86D41967E57B8EBA1DD,42321,14,16,2,43,47,2197
4834,4834,791234E587E0C86D41967E57B8EBA1DD,11271,18,19,1,37,48,1898
4835,4835,791234E587E0C86D41967E57B8EBA1DD,42321,21,23,2,43,47,2197
4836,4836,4EAEA07A12B611EF65EDB5896F86C5E3,13671,1,8,7,27,43,1393
4837,4837,4EAEA07A12B611EF65EDB5896F86C5E3,11161,8,16,8,32,48,1648
4838,4838,4EAEA07A12B611EF65EDB5896F86C5E3,42531,19,20,1,31,45,1595
4839,4839,026D9CD2D7AB3D5BF684F04063945AE0,42031,0,9,9,40,46,2046
4840,4840,026D9CD2D7AB3D5BF684F04063945AE0,11211,11,12,1,34,49,1749
4841,4841,026D9CD2D7AB3D5BF684F04063945AE0,42311,14,16,2,41,46,2096
4842,4842,026D9CD2D7AB3D5BF684F04063945AE0,42231,19,20,1,37,46,1896
4843,4843,026D9CD2D7AB3D5BF684F04063945AE0,42031,22,23,1,40,46,2046
4851,4851,43125D201B2090874D2E0EE6E6251F06,10111,0,16,16,37,47,1897
4852,4852,43125D201B2090874D2E0EE6E6251F06,10491,18,21,3,33,48,1698
4853,4853,43125D201B2090874D2E0EE6E6251F06,11751,21,23,2,35,48,1798
4858,4858,BF5EFB3BDBF5437ACD467C87E9038A8B,43021,1,17,16,16,43,843
4859,4859,BF5EFB3BDBF5437ACD467C87E9038A8B,12921,18,19,1,9,41,491
4860,4860,BF5EFB3BDBF5437ACD467C87E9038A8B,43021,19,23,4,16,43,843
4870,4870,30AB292EA71BCCA29EAC6C791311F4E2,12761,0,3,3,25,40,1290
4871,4871,30AB292EA71BCCA29EAC6C791311F4E2,12521,5,7,2,35,41,1791
4872,4872,30AB292EA71BCCA29EAC6C791311F4E2,13671,7,10,3,27,43,1393
4873,4873,30AB292EA71BCCA29EAC6C791311F4E2,11921,15,19,4,38,48,1948
4874,4874,30AB292EA71BCCA29EAC6C791311F4E2,11331,20,23,3,37,48,1898
4878,4878,1C0548F40841AD0870DAD8EC7BECCBC6,13314,0,6,6,31,39,1589
4879,4879,1C0548F40841AD0870DAD8EC7BECCBC6,12521,7,9,2,35,41,1791
4880,4880,1C0548F40841AD0870DAD8EC7BECCBC6,13314,9,16,7,31,39,1589
4881,4881,1C0548F40841AD0870DAD8EC7BECCBC6,12521,16,17,1,35,41,1791
4882,4882,1C0548F40841AD0870DAD8EC7BECCBC6,13314,17,19,2,31,39,1589
4883,4883,26B9AAC369331C3B7CCBFCA623526739,13461,2,12,10,39,44,1994
4884,4884,26B9AAC369331C3B7CCBFCA623526739,11481,13,16,3,41,48,2098
4885,4885,26B9AAC369331C3B7CCBFCA623526739,13461,19,21,2,39,44,1994
4886,4886,26B9AAC369331C3B7CCBFCA623526739,10811,21,23,2,38,46,1946
4890,4890,226A103DD52D17CBE49174A987582107,42071,1,7,6,31,49,1599
4891,4891,226A103DD52D17CBE49174A987582107,42121,9,10,1,26,49,1349
4892,4892,226A103DD52D17CBE49174A987582107,42071,11,23,12,31,49,1599
4896,4896,3F22CE3BC69EEA321201B2CF165B0591,13551,0,8,8,45,38,2288
4897,4897,3F22CE3BC69EEA321201B2CF165B0591,43101,9,10,1,46,40,2340
4898,4898,3F22CE3BC69EEA321201B2CF165B0591,12481,12,18,6,37,49,1899
4903,4903,6873293A7011427730E4398465E19659,12921,0,5,5,9,41,491
4904,4904,6873293A7011427730E4398465E19659,12641,7,12,5,10,43,543
4905,4905,6873293A7011427730E4398465E19659,43021,14,19,5,16,43,843
4906,4906,6873293A7011427730E4398465E19659,12921,19,20,1,9,41,491
4910,4910,C7C431E83C90A041B3FA2A63798CE4F8,43021,2,5,3,16,43,843
4911,4911,C7C431E83C90A041B3FA2A63798CE4F8,12921,6,7,1,9,41,491
4912,4912,C7C431E83C90A041B3FA2A63798CE4F8,43021,8,19,11,16,43,843
4913,4913,C7C431E83C90A041B3FA2A63798CE4F8,12921,22,23,1,9,41,491
4914,4914,60DB2F1E5C63BE640D47B87EE3CFB05B,42461,0,6,6,45,47,2297
4915,4915,60DB2F1E5C63BE640D47B87EE3CFB05B,10421,8,9,1,41,48,2098
4916,4916,60DB2F1E5C63BE640D47B87EE3CFB05B,42461,18,23,5,45,47,2297
4917,4917,B643B7DEA11EAB401D7A618365BD531B,42801,2,9,7,40,49,2049
4918,4918,B643B7DEA11EAB401D7A618365BD531B,49181,10,12,2,21,31,1081
4919,4919,B643B7DEA11EAB401D7A618365BD531B,13481,13,14,1,26,31,1331
4920,4920,B643B7DEA11EAB401D7A618365BD531B,42801,17,18,1,40,49,2049
4921,4921,B643B7DEA11EAB401D7A618365BD531B,10231,20,21,1,39,49,1999
4925,4925,A796809FFC26797F0B17A0B66E102B15,13314,0,7,7,31,39,1589
4926,4926,A796809FFC26797F0B17A0B66E102B15,12521,7,10,3,35,41,1791
4927,4927,A796809FFC26797F0B17A0B66E102B15,13314,11,12,1,31,39,1589
4928,4928,A796809FFC26797F0B17A0B66E102B15,12521,13,18,5,35,41,1791
4929,4929,A796809FFC26797F0B17A0B66E102B15,13314,19,23,4,31,39,1589
4938,4938,0D947EBDA1250C07F4411B7BDAEBFDBC,42531,0,6,6,31,45,1595
4939,4939,0D947EBDA1250C07F4411B7BDAEBFDBC,12601,8,9,1,25,47,1297
4940,4940,0D947EBDA1250C07F4411B7BDAEBFDBC,42501,15,16,1,28,47,1447
4941,4941,0D947EBDA1250C07F4411B7BDAEBFDBC,12311,21,22,1,30,44,1544
4942,4942,649CA0B4C9C73F10630BCAC6C100E533,42151,0,3,3,35,45,1795
4943,4943,649CA0B4C9C73F10630BCAC6C100E533,12311,5,18,13,30,44,1544
4944,4944,649CA0B4C9C73F10630BCAC6C100E533,42151,19,23,4,35,45,1795
4945,4945,FA0C4CA4021C0DDC268260533289E286,11381,0,13,13,30,47,1547
4946,4946,FA0C4CA4021C0DDC268260533289E286,40343,15,17,2,24,49,1249
4947,4947,FA0C4CA4021C0DDC268260533289E286,11381,21,23,2,30,47,1547
4960,4960,A2322C7E82C506086C86C7A37D702773,12381,0,15,15,32,48,1648
4961,4961,A2322C7E82C506086C86C7A37D702773,10841,18,20,2,37,47,1897
4962,4962,A2322C7E82C506086C86C7A37D702773,12381,20,22,2,32,48,1648
4963,4963,A91D753DEB5BEBF3343BA20504460C91,10111,0,8,8,37,47,1897
4964,4964,A91D753DEB5BEBF3343BA20504460C91,42401,8,10,2,36,47,1847
4965,4965,A91D753DEB5BEBF3343BA20504460C91,40341,11,12,1,23,49,1199
4966,4966,A91D753DEB5BEBF3343BA20504460C91,42401,13,14,1,36,47,1847
4967,4967,A91D753DEB5BEBF3343BA20504460C91,10111,15,22,7,37,47,1897
4968,4968,A91D753DEB5BEBF3343BA20504460C91,42401,22,23,1,36,47,1847
4972,4972,331C93B6083F5634586EEDFC958D0A76,42231,0,4,4,37,46,1896
4973,4973,331C93B6083F5634586EEDFC958D0A76,13911,4,8,4,39,46,1996
4974,4974,331C93B6083F5634586EEDFC958D0A76,10292,9,10,1,30,47,1547
4975,4975,331C93B6083F5634586EEDFC958D0A76,13911,10,13,3,39,46,1996
4976,4976,331C93B6083F5634586EEDFC958D0A76,42231,17,23,6,37,46,1896
4980,4980,6A457FC295BEABB4E7455CBB04B50835,12921,6,8,2,9,41,491
4981,4981,6A457FC295BEABB4E7455CBB04B50835,43021,12,13,1,16,43,843
4982,4982,6A457FC295BEABB4E7455CBB04B50835,12921,13,21,8,9,41,491
4987,4987,D6B662C0D72BBB94314A69A6BE13D66E,43761,0,13,13,32,47,1647
4988,4988,D6B662C0D72BBB94314A69A6BE13D66E,10161,14,19,5,35,49,1799
4989,4989,D6B662C0D72BBB94314A69A6BE13D66E,43761,21,23,2,32,47,1647
4990,4990,02BBBAE0EEB14D2A94F8B0B08DAE3106,11061,0,12,12,29,48,1498
4991,4991,02BBBAE0EEB14D2A94F8B0B08DAE3106,11151,12,14,2,30,48,1548
4992,4992,02BBBAE0EEB14D2A94F8B0B08DAE3106,10731,14,15,1,33,47,1697
4993,4993,02BBBAE0EEB14D2A94F8B0B08DAE3106,11061,16,18,2,29,48,1498
4994,4994,02BBBAE0EEB14D2A94F8B0B08DAE3106,13651,18,19,1,30,47,1547
4995,4995,F5E1FADD1A2B73E311D54EEEF39B7046,43621,0,5,5,46,48,2348
4996,4996,F5E1FADD1A2B73E311D54EEEF39B7046,40833,6,9,3,41,47,2097
4997,4997,F5E1FADD1A2B73E311D54EEEF39B7046,42321,10,11,1,43,47,2197
4998,4998,F5E1FADD1A2B73E311D54EEEF39B7046,43621,12,13,1,46,48,2348
4999,4999,F5E1FADD1A2B73E311D54EEEF39B7046,42321,14,18,4,43,47,2197
5000,5000,F5E1FADD1A2B73E311D54EEEF39B7046,43621,21,23,2,46,48,2348
5008,5008,7F22F6803A0EF06EA97B48DC039DF4A6,10121,0,8,8,36,49,1849
5009,5009,7F22F6803A0EF06EA97B48DC039DF4A6,42623,8,10,2,22,49,1149
5010,5010,7F22F6803A0EF06EA97B48DC039DF4A6,10121,11,23,12,36,49,1849
5011,5011,3D5155FED5D588D672DAF8A84230D7BD,43751,0,10,10,19,48,998
5012,5012,3D5155FED5D588D672DAF8A84230D7BD,40341,11,19,8,23,49,1199
5013,5013,3D5155FED5D588D672DAF8A84230D7BD,11631,21,23,2,12,49,649
5023,5023,32D54E641C550F1191577801F5A35620,12601,2,3,1,25,47,1297
5024,5024,32D54E641C550F1191577801F5A35620,11641,7,9,2,22,49,1149
5025,5025,32D54E641C550F1191577801F5A35620,12601,9,11,2,25,47,1297
5026,5026,32D54E641C550F1191577801F5A35620,11641,17,18,1,22,49,1149
5027,5027,32D54E641C550F1191577801F5A35620,12051,21,22,1,20,47,1047
5039,5039,80E99D218F7B7EB842E1715C4BA06805,43761,1,16,15,32,47,1647
5040,5040,80E99D218F7B7EB842E1715C4BA06805,42621,18,19,1,24,49,1249
5041,5041,80E99D218F7B7EB842E1715C4BA06805,13601,20,23,3,34,47,1747
5048,5048,09D4E4AC27B1C2BD71280354244F178D,42121,1,8,7,26,49,1349
5049,5049,09D4E4AC27B1C2BD71280354244F178D,42461,10,18,8,45,47,2297
5050,5050,09D4E4AC27B1C2BD71280354244F178D,10511,21,23,2,35,46,1796
5051,5051,594835BD749880E69EF137011FAE9C84,19744,0,8,8,6,43,343
5052,5052,594835BD749880E69EF137011FAE9C84,12641,10,11,1,10,43,543
5053,5053,594835BD749880E69EF137011FAE9C84,19741,12,13,1,5,44,294
5054,5054,594835BD749880E69EF137011FAE9C84,12641,13,18,5,10,43,543
5055,5055,594835BD749880E69EF137011FAE9C84,19114,21,23,2,7,43,393
5056,5056,89C5F5C036761FD2C32F64BC4CDE2E5B,19024,0,11,11,9,45,495
5057,5057,89C5F5C036761FD2C32F64BC4CDE2E5B,19621,11,13,2,5,46,296
5058,5058,89C5F5C036761FD2C32F64BC4CDE2E5B,19441,14,16,2,8,46,446
5059,5059,89C5F5C036761FD2C32F64BC4CDE2E5B,12083,19,21,2,36,49,1849
5060,5060,89C5F5C036761FD2C32F64BC4CDE2E5B,19441,21,23,2,8,46,446
5065,5065,88B9BB6F8A123CE6C50912DC892EFBF2,42941,4,6,2,37,47,1897
5066,5066,88B9BB6F8A123CE6C50912DC892EFBF2,11491,6,7,1,36,47,1847
5067,5067,88B9BB6F8A123CE6C50912DC892EFBF2,42941,9,12,3,37,47,1897
5068,5068,88B9BB6F8A123CE6C50912DC892EFBF2,40341,14,17,3,23,49,1199
5069,5069,88B9BB6F8A123CE6C50912DC892EFBF2,42941,19,23,4,37,47,1897
5073,5073,A38091759521D4626A5F01BBEDF538A5,42141,0,6,6,32,47,1647
5074,5074,A38091759521D4626A5F01BBEDF538A5,10841,11,13,2,37,47,1897
5075,5075,A38091759521D4626A5F01BBEDF538A5,40463,14,15,1,38,49,1949
5076,5076,A38091759521D4626A5F01BBEDF538A5,11861,18,22,4,32,47,1647
5077,5077,CE818D17EA4EEFB77B41EEE2EC0F4E04,43021,0,3,3,16,43,843
5078,5078,CE818D17EA4EEFB77B41EEE2EC0F4E04,19021,3,10,7,10,45,545
5079,5079,CE818D17EA4EEFB77B41EEE2EC0F4E04,43021,11,13,2,16,43,843
5080,5080,CE818D17EA4EEFB77B41EEE2EC0F4E04,19021,13,21,8,10,45,545
5084,5084,DEA13AE4E25C1F5535D501BC3C7ECF55,19111,0,13,13,9,45,495
5085,5085,DEA13AE4E25C1F5535D501BC3C7ECF55,13511,18,20,2,34,48,1748
5086,5086,DEA13AE4E25C1F5535D501BC3C7ECF55,19111,21,23,2,9,45,495
5087,5087,8736004B0EE048BD6FCD4DB2FCD2B597,11641,1,11,10,22,49,1149
5088,5088,8736004B0EE048BD6FCD4DB2FCD2B597,10292,14,18,4,30,47,1547
5089,5089,8736004B0EE048BD6FCD4DB2FCD2B597,42261,18,21,3,25,49,1299
5101,5101,AC38F90B82E2DAAA768172BDE9BA8C19,13121,1,8,7,38,46,1946
5102,5102,AC38F90B82E2DAAA768172BDE9BA8C19,11151,11,12,1,30,48,1548
5103,5103,AC38F90B82E2DAAA768172BDE9BA8C19,10191,15,16,1,40,48,2048
5104,5104,AC38F90B82E2DAAA768172BDE9BA8C19,11531,17,18,1,34,49,1749
5105,5105,AC38F90B82E2DAAA768172BDE9BA8C19,13711,18,23,5,38,46,1946
5106,5106,1F899C425E1D44BC86781F60DDEF728E,43021,0,8,8,16,43,843
5107,5107,1F899C425E1D44BC86781F60DDEF728E,12641,9,11,2,10,43,543
5108,5108,1F899C425E1D44BC86781F60DDEF728E,43021,12,22,10,16,43,843
5109,5109,B36C8579A2DBF718933C4838B2421A42,13121,1,2,1,38,46,1946
5110,5110,B36C8579A2DBF718933C4838B2421A42,42511,3,10,7,37,47,1897
5111,5111,B36C8579A2DBF718933C4838B2421A42,40123,13,14,1,38,47,1947
5112,5112,B36C8579A2DBF718933C4838B2421A42,42511,15,18,3,37,47,1897
5113,5113,B36C8579A2DBF718933C4838B2421A42,13121,21,23,2,38,46,1946
5114,5114,890E28003097AE1252F2C7F02F9B8CC8,12511,2,12,10,39,47,1997
5115,5115,890E28003097AE1252F2C7F02F9B8CC8,12311,14,15,1,30,44,1544
5116,5116,890E28003097AE1252F2C7F02F9B8CC8,42531,18,20,2,31,45,1595
5117,5117,9A9C137891FEFB703538FEE848B58967,13341,0,13,13,44,45,2245
5118,5118,9A9C137891FEFB703538FEE848B58967,40691,17,18,1,42,48,2148
5119,5119,9A9C137891FEFB703538FEE848B58967,13341,20,23,3,44,45,2245
5130,5130,BA6F91C8DB332B28B4CFAA6DD9B35517,10151,0,17,17,34,47,1747
5131,5131,BA6F91C8DB332B28B4CFAA6DD9B35517,43481,18,19,1,39,48,1998
5132,5132,BA6F91C8DB332B28B4CFAA6DD9B35517,10151,21,23,2,34,47,1747
5133,5133,D159D7E2120F2A31F888B2ED598E06C3,13314,0,7,7,31,39,1589
5134,5134,D159D7E2120F2A31F888B2ED598E06C3,12521,9,11,2,35,41,1791
5135,5135,D159D7E2120F2A31F888B2ED598E06C3,13314,12,22,10,31,39,1589
5143,5143,8287F1BA3C627FF87E885A87753169B5,19021,5,6,1,10,45,545
5144,5144,8287F1BA3C627FF87E885A87753169B5,12921,7,9,2,9,41,491
5145,5145,8287F1BA3C627FF87E885A87753169B5,12641,11,19,8,10,43,543
5146,5146,8287F1BA3C627FF87E885A87753169B5,19021,21,22,1,10,45,545
5151,5151,8A4EE976F1E8BC4CA88390DFA08CB5DF,10151,0,9,9,34,47,1747
5152,5152,8A4EE976F1E8BC4CA88390DFA08CB5DF,10621,12,20,8,41,49,2099
5153,5153,8A4EE976F1E8BC4CA88390DFA08CB5DF,11951,21,23,2,31,49,1599
5154,5154,7B34C273E34CE1CA5EC462EE747405EC,42031,0,9,9,40,46,2046
5155,5155,7B34C273E34CE1CA5EC462EE747405EC,12641,10,12,2,10,43,543
5156,5156,7B34C273E34CE1CA5EC462EE747405EC,19111,13,14,1,9,45,495
5157,5157,7B34C273E34CE1CA5EC462EE747405EC,42031,18,23,5,40,46,2046
5162,5162,D10B96AA1BF5CD87C338E64E29042982,10721,0,15,15,31,48,1598
5163,5163,D10B96AA1BF5CD87C338E64E29042982,11481,17,19,2,41,48,2098
5164,5164,D10B96AA1BF5CD87C338E64E29042982,12971,20,21,1,32,48,1648
5165,5165,34D0F1740730A8549938BF81A7322203,11591,0,6,6,36,49,1849
5166,5166,34D0F1740730A8549938BF81A7322203,12141,10,16,6,42,45,2145
5167,5167,34D0F1740730A8549938BF81A7322203,11021,19,20,1,36,49,1849
5168,5168,3A63CD750D955EA804AF981EAEDD9718,11331,0,14,14,37,48,1898
5169,5169,3A63CD750D955EA804AF981EAEDD9718,40341,15,17,2,23,49,1199
5170,5170,3A63CD750D955EA804AF981EAEDD9718,11331,19,20,1,37,48,1898
5171,5171,AE443C520762B13259449692A7250295,11081,0,14,14,35,46,1796
5172,5172,AE443C520762B13259449692A7250295,42531,17,19,2,31,45,1595
5173,5173,AE443C520762B13259449692A7250295,11081,21,23,2,35,46,1796
5180,5180,B289C6428E0D98B8D720F0FA5499A67A,15271,0,5,5,14,20,720
5181,5181,B289C6428E0D98B8D720F0FA5499A67A,15381,8,9,1,19,21,971
5182,5182,B289C6428E0D98B8D720F0FA5499A67A,15371,10,15,5,15,22,772
5183,5183,B289C6428E0D98B8D720F0FA5499A67A,15271,16,17,1,14,20,720
5184,5184,B289C6428E0D98B8D720F0FA5499A67A,16441,17,19,2,15,17,767
5185,5185,B289C6428E0D98B8D720F0FA5499A67A,15271,21,22,1,14,20,720
5189,5189,4A8B6D4A591CC4F1D4132A3A7DF0E4D7,42141,0,9,9,32,47,1647
5190,5190,4A8B6D4A591CC4F1D4132A3A7DF0E4D7,10634,9,10,1,27,45,1395
5191,5191,4A8B6D4A591CC4F1D4132A3A7DF0E4D7,42141,13,16,3,32,47,1647
5192,5192,4A8B6D4A591CC4F1D4132A3A7DF0E4D7,42521,18,20,2,31,47,1597
5203,5203,0CED0A2998E753C043314DC59E2912AD,15143,3,12,9,18,7,907
5204,5204,0CED0A2998E753C043314DC59E2912AD,16151,12,16,4,13,11,661
5205,5205,0CED0A2998E753C043314DC59E2912AD,16251,20,21,1,15,13,763
5206,5206,DF94D54F1FB61A8A2D0D102E79DF1633,11875,0,8,8,30,46,1546
5207,5207,DF94D54F1FB61A8A2D0D102E79DF1633,12521,12,14,2,35,41,1791
5208,5208,DF94D54F1FB61A8A2D0D102E79DF1633,42231,14,16,2,37,46,1896
5209,5209,DF94D54F1FB61A8A2D0D102E79DF1633,10511,16,18,2,35,46,1796
5210,5210,DF94D54F1FB61A8A2D0D102E79DF1633,42161,18,20,2,36,47,1847
5211,5211,DF94D54F1FB61A8A2D0D102E79DF1633,12131,21,22,1,32,47,1647
5212,5212,CD5F8D7604C7020A19DDE3C48998E9F5,13314,0,3,3,31,39,1589
5213,5213,CD5F8D7604C7020A19DDE3C48998E9F5,12521,6,15,9,35,41,1791
5214,5214,CD5F8D7604C7020A19DDE3C48998E9F5,13041,15,17,2,30,37,1537
5215,5215,CD5F8D7604C7020A19DDE3C48998E9F5,12521,17,18,1,35,41,1791
5219,5219,57E38E75C3154FA28FE7B22CE29AF775,11061,0,4,4,29,48,1498
5220,5220,57E38E75C3154FA28FE7B22CE29AF775,11151,4,5,1,30,48,1548
5221,5221,57E38E75C3154FA28FE7B22CE29AF775,11061,10,12,2,29,48,1498
5222,5222,57E38E75C3154FA28FE7B22CE29AF775,10381,15,17,2,31,49,1599
5223,5223,57E38E75C3154FA28FE7B22CE29AF775,11061,17,18,1,29,48,1498
5224,5224,57E38E75C3154FA28FE7B22CE29AF775,11151,20,22,2,30,48,1548
5225,5225,2FD7CB563CD330B8757D30F36F5DB42E,13111,0,10,10,42,46,2146
5226,5226,2FD7CB563CD330B8757D30F36F5DB42E,43951,11,14,3,49,41,2491
5227,5227,2FD7CB563CD330B8757D30F36F5DB42E,40691,15,16,1,42,48,2148
5228,5228,2FD7CB563CD330B8757D30F36F5DB42E,13111,16,18,2,42,46,2146
5235,5235,0BC188D7CF3FF6A0EC262A8B4A0342D0,10471,0,9,9,37,48,1898
5236,5236,0BC188D7CF3FF6A0EC262A8B4A0342D0,10281,9,17,8,33,48,1698
5237,5237,0BC188D7CF3FF6A0EC262A8B4A0342D0,11861,18,19,1,32,47,1647
5238,5238,0BC188D7CF3FF6A0EC262A8B4A0342D0,11231,20,23,3,37,49,1899
5239,5239,8E1DB9D4ECEC1F108A151A8D21BA1A04,42231,0,5,5,37,46,1896
5240,5240,8E1DB9D4ECEC1F108A151A8D21BA1A04,13911,5,8,3,39,46,1996
5241,5241,8E1DB9D4ECEC1F108A151A8D21BA1A04,42231,10,11,1,37,46,1896
5242,5242,8E1DB9D4ECEC1F108A151A8D21BA1A04,13911,13,16,3,39,46,1996
5243,5243,8E1DB9D4ECEC1F108A151A8D21BA1A04,42231,19,23,4,37,46,1896
5255,5255,A8DFAF39A5A26AE1BCD9E9DE060BB315,11091,0,6,6,29,47,1497
5256,5256,A8DFAF39A5A26AE1BCD9E9DE060BB315,13651,8,9,1,30,47,1547
5257,5257,A8DFAF39A5A26AE1BCD9E9DE060BB315,11091,12,13,1,29,47,1497
5258,5258,A8DFAF39A5A26AE1BCD9E9DE060BB315,13651,14,17,3,30,47,1547
5259,5259,A8DFAF39A5A26AE1BCD9E9DE060BB315,11091,18,23,5,29,47,1497
5260,5260,21B656E93C25F88D6CD1C23ADB7656C7,42491,7,11,4,32,46,1646
5261,5261,21B656E93C25F88D6CD1C23ADB7656C7,10341,12,19,7,31,47,1597
5262,5262,21B656E93C25F88D6CD1C23ADB7656C7,16211,21,23,2,4,3,203
5276,5276,473C22BAAFDC4EEA08D2201BE36B884B,10471,0,13,13,37,48,1898
5277,5277,473C22BAAFDC4EEA08D2201BE36B884B,11381,15,19,4,30,47,1547
5278,5278,473C22BAAFDC4EEA08D2201BE36B884B,11231,20,22,2,37,49,1899
5279,5279,A53D76C44A71267FF477911E38598EC8,11301,0,1,1,41,49,2099
5280,5280,A53D76C44A71267FF477911E38598EC8,11161,2,9,7,32,48,1648
5281,5281,A53D76C44A71267FF477911E38598EC8,11021,12,13,1,36,49,1849
5282,5282,A53D76C44A71267FF477911E38598EC8,11161,14,16,2,32,48,1648
5283,5283,A53D76C44A71267FF477911E38598EC8,42523,17,18,1,31,47,1597
5284,5284,A53D76C44A71267FF477911E38598EC8,11161,21,22,1,32,48,1648
5288,5288,7FBB65FFFB6C624D9A36B33C0250B5DC,12921,0,13,13,9,41,491
5289,5289,7FBB65FFFB6C624D9A36B33C0250B5DC,43021,17,18,1,16,43,843
5290,5290,7FBB65FFFB6C624D9A36B33C0250B5DC,12921,19,23,4,9,41,491
5294,5294,705C51D8F089C59467951CA7C8D9F6AF,11381,0,12,12,30,47,1547
5295,5295,705C51D8F089C59467951CA7C8D9F6AF,43761,15,16,1,32,47,1647
5296,5296,705C51D8F089C59467951CA7C8D9F6AF,12021,18,20,2,37,49,1899
5300,5300,AB91075D74B89201EF94A5C267B3FB04,10281,0,8,8,33,48,1698
5301,5301,AB91075D74B89201EF94A5C267B3FB04,11651,10,15,5,33,47,1697
5302,5302,AB91075D74B89201EF94A5C267B3FB04,40341,17,18,1,23,49,1199
5303,5303,FEB10E9619CCB09DA2455DDE3043904C,40637,0,11,11,36,47,1847
5304,5304,FEB10E9619CCB09DA2455DDE3043904C,10721,11,13,2,31,48,1598
5305,5305,FEB10E9619CCB09DA2455DDE3043904C,11331,13,15,2,37,48,1898
5306,5306,FEB10E9619CCB09DA2455DDE3043904C,10251,15,23,8,35,47,1797
5307,5307,6EE4E240317F954C8DC3C54A6B19C5B7,11831,0,8,8,32,45,1645
5308,5308,6EE4E240317F954C8DC3C54A6B19C5B7,10351,8,10,2,28,45,1445
5309,5309,6EE4E240317F954C8DC3C54A6B19C5B7,11261,13,16,3,36,46,1846
5310,5310,6EE4E240317F954C8DC3C54A6B19C5B7,13121,17,18,1,38,46,1946
5311,5311,6EE4E240317F954C8DC3C54A6B19C5B7,11261,19,20,1,36,46,1846
5312,5312,63D46256AD6F86C8491C2B2581A93893,11291,0,7,7,40,49,2049
5313,5313,63D46256AD6F86C8491C2B2581A93893,43581,12,14,2,33,48,1698
5314,5314,63D46256AD6F86C8491C2B2581A93893,42031,16,18,2,40,46,2046
5315,5315,63D46256AD6F86C8491C2B2581A93893,11291,19,23,4,40,49,2049
5326,5326,721583612DD91C02373A89BD2EE4B291,11231,0,16,16,37,49,1899
5327,5327,721583612DD91C02373A89BD2EE4B291,11954,18,19,1,32,49,1649
5328,5328,721583612DD91C02373A89BD2EE4B291,12391,22,23,1,36,49,1849
5332,5332,78875D602E8E6F484D7C11BFF3A852AA,10471,0,8,8,37,48,1898
5333,5333,78875D602E8E6F484D7C11BFF3A852AA,11231,10,11,1,37,49,1899
5334,5334,78875D602E8E6F484D7C11BFF3A852AA,13091,12,14,2,20,42,1042
5335,5335,78875D602E8E6F484D7C11BFF3A852AA,43644,16,17,1,14,38,738
5336,5336,78875D602E8E6F484D7C11BFF3A852AA,13091,18,20,2,20,42,1042
5337,5337,78875D602E8E6F484D7C11BFF3A852AA,10471,22,23,1,37,48,1898
5341,5341,3D39BFF619D555933510C63A4C03CAF1,13121,0,6,6,38,46,1946
5342,5342,3D39BFF619D555933510C63A4C03CAF1,11914,8,10,2,37,48,1898
5343,5343,3D39BFF619D555933510C63A4C03CAF1,19031,13,15,2,1,42,92
5344,5344,3D39BFF619D555933510C63A4C03CAF1,13121,20,23,3,38,46,1946
5348,5348,EA719FE167C1AD6B2818F9B11628F0AB,42921,0,7,7,33,47,1697
5349,5349,EA719FE167C1AD6B2818F9B11628F0AB,13601,8,11,3,34,47,1747
5350,5350,EA719FE167C1AD6B2818F9B11628F0AB,11631,14,23,9,12,49,649
5351,5351,45669AC1C18BB18F867D0F4B4ED2448F,19114,0,7,7,7,43,393
5352,5352,45669AC1C18BB18F867D0F4B4ED2448F,19901,8,9,1,7,44,394
5353,5353,45669AC1C18BB18F867D0F4B4ED2448F,19114,9,13,4,7,43,393
5354,5354,45669AC1C18BB18F867D0F4B4ED2448F,12641,14,16,2,10,43,543
5355,5355,45669AC1C18BB18F867D0F4B4ED2448F,19114,18,22,4,7,43,393
5356,5356,9A32E318CA0CDE9DA0BCF043EF40ABC3,10721,0,8,8,31,48,1598
5357,5357,9A32E318CA0CDE9DA0BCF043EF40ABC3,12381,14,16,2,32,48,1648
5358,5358,9A32E318CA0CDE9DA0BCF043EF40ABC3,11081,18,20,2,35,46,1796
5359,5359,D0B112E1686AD0075BEEB3801B0B257E,12211,0,2,2,41,44,2094
5360,5360,D0B112E1686AD0075BEEB3801B0B257E,42301,5,12,7,36,47,1847
5361,5361,D0B112E1686AD0075BEEB3801B0B257E,40401,13,14,1,40,46,2046
5362,5362,D0B112E1686AD0075BEEB3801B0B257E,11324,18,21,3,31,46,1596
5363,5363,3C102E33ADB348DA2AD74B1F02BBC759,41612,0,14,14,36,47,1847
5364,5364,3C102E33ADB348DA2AD74B1F02BBC759,40691,18,19,1,42,48,2148
5365,5365,3C102E33ADB348DA2AD74B1F02BBC759,43361,21,22,1,38,48,1948
5366,5366,CA03F391D079777CAEBDBA2CE3ADBA30,19031,0,6,6,1,42,92
5367,5367,CA03F391D079777CAEBDBA2CE3ADBA30,12641,6,10,4,10,43,543
5368,5368,CA03F391D079777CAEBDBA2CE3ADBA30,19031,11,13,2,1,42,92
5369,5369,CA03F391D079777CAEBDBA2CE3ADBA30,12641,13,23,10,10,43,543
5373,5373,5A5B2CBA296E90D3798147AFE5312824,13561,0,15,15,37,49,1899
5374,5374,5A5B2CBA296E90D3798147AFE5312824,42491,19,21,2,32,46,1646
5375,5375,5A5B2CBA296E90D3798147AFE5312824,13561,22,23,1,37,49,1899
5376,5376,D5C1627EC885D036667AAD28591A0C0E,12381,0,8,8,32,48,1648
5377,5377,D5C1627EC885D036667AAD28591A0C0E,43161,9,10,1,35,47,1797
5378,5378,D5C1627EC885D036667AAD28591A0C0E,12381,12,13,1,32,48,1648
5379,5379,D5C1627EC885D036667AAD28591A0C0E,11201,13,17,4,35,49,1799
5380,5380,D5C1627EC885D036667AAD28591A0C0E,40034,21,23,2,32,48,1648
5385,5385,401DBF9291C70DB6E3FE8385830F996E,13791,0,16,16,42,47,2147
5386,5386,401DBF9291C70DB6E3FE8385830F996E,40341,17,19,2,23,49,1199
5387,5387,401DBF9291C70DB6E3FE8385830F996E,11021,20,22,2,36,49,1849
5388,5388,A48B765CF9060B1526CD525D1F4A95C6,43021,1,7,6,16,43,843
5389,5389,A48B765CF9060B1526CD525D1F4A95C6,49181,11,13,2,21,31,1081
5390,5390,A48B765CF9060B1526CD525D1F4A95C6,10061,18,23,5,20,46,1046
5391,5391,7EBDDCB5CDC79795950C5F54618B3045,43581,0,6,6,33,48,1698
5392,5392,7EBDDCB5CDC79795950C5F54618B3045,19031,9,11,2,1,42,92
5393,5393,7EBDDCB5CDC79795950C5F54618B3045,11201,12,14,2,35,49,1799
5394,5394,7EBDDCB5CDC79795950C5F54618B3045,43581,19,20,1,33,48,1698
5395,5395,7EBDDCB5CDC79795950C5F54618B3045,10401,20,22,2,33,49,1699
5396,5396,99A92AD24D04D2EBCBD0E2108B572F74,11061,0,2,2,29,48,1498
5397,5397,99A92AD24D04D2EBCBD0E2108B572F74,10721,2,8,6,31,48,1598
5398,5398,99A92AD24D04D2EBCBD0E2108B572F74,11061,9,15,6,29,48,1498
5399,5399,99A92AD24D04D2EBCBD0E2108B572F74,11151,16,17,1,30,48,1548
5400,5400,99A92AD24D04D2EBCBD0E2108B572F74,11061,17,23,6,29,48,1498
5407,5407,439D8CB010A4086802C0243322BA6C31,11061,3,7,4,29,48,1498
5408,5408,439D8CB010A4086802C0243322BA6C31,40343,10,16,6,24,49,1249
5409,5409,439D8CB010A4086802C0243322BA6C31,11061,19,22,3,29,48,1498
5414,5414,AF85AB0F84B58F4A12483525349C1572,43121,0,5,5,25,27,1277
5415,5415,AF85AB0F84B58F4A12483525349C1572,15191,7,11,4,36,27,1827
5416,5416,AF85AB0F84B58F4A12483525349C1572,43121,12,14,2,25,27,1277
5417,5417,AF85AB0F84B58F4A12483525349C1572,15191,17,18,1,36,27,1827
5418,5418,AF85AB0F84B58F4A12483525349C1572,43121,21,23,2,25,27,1277
5419,5419,D259EBC25D16C8B830E9270CCEA05D8E,13941,0,6,6,41,47,2097
5420,5420,D259EBC25D16C8B830E9270CCEA05D8E,11001,7,13,6,42,47,2147
5421,5421,D259EBC25D16C8B830E9270CCEA05D8E,13371,14,16,2,41,47,2097
5422,5422,D259EBC25D16C8B830E9270CCEA05D8E,12511,18,20,2,39,47,1997
5423,5423,D259EBC25D16C8B830E9270CCEA05D8E,13941,21,23,2,41,47,2097
5424,5424,F6FB5D19A46EB8136C0144283CF5CA04,10544,0,12,12,28,48,1448
5425,5425,F6FB5D19A46EB8136C0144283CF5CA04,40673,13,15,2,36,48,1848
5426,5426,F6FB5D19A46EB8136C0144283CF5CA04,10251,16,19,3,35,47,1797
5427,5427,2A1C69FE81920B6640E78AE191F4B0AD,42531,0,8,8,31,45,1595
5428,5428,2A1C69FE81920B6640E78AE191F4B0AD,12311,12,18,6,30,44,1544
5429,5429,2A1C69FE81920B6640E78AE191F4B0AD,10151,20,21,1,34,47,1747
5430,5430,2A1C69FE81920B6640E78AE191F4B0AD,42531,21,23,2,31,45,1595
5431,5431,7443CDF94A0FA46BFF27295D785ECEBA,12311,0,7,7,30,44,1544
5432,5432,7443CDF94A0FA46BFF27295D785ECEBA,40341,9,12,3,23,49,1199
5433,5433,7443CDF94A0FA46BFF27295D785ECEBA,11061,13,14,1,29,48,1498
5434,5434,7443CDF94A0FA46BFF27295D785ECEBA,10111,16,18,2,37,47,1897
5435,5435,94AE5556A83EAFD53104748037AB672F,40302,1,14,13,40,49,2049
5436,5436,94AE5556A83EAFD53104748037AB672F,42161,15,17,2,36,47,1847
5437,5437,94AE5556A83EAFD53104748037AB672F,10251,18,19,1,35,47,1797
5438,5438,94AE5556A83EAFD53104748037AB672F,11201,20,21,1,35,49,1799
5439,5439,94AE5556A83EAFD53104748037AB672F,11231,21,22,1,37,49,1899
5446,5446,A05E50C8250D6971328B3F8C4CFB1D1A,11061,0,9,9,29,48,1498
5447,5447,A05E50C8250D6971328B3F8C4CFB1D1A,40341,10,12,2,23,49,1199
5448,5448,A05E50C8250D6971328B3F8C4CFB1D1A,10381,13,15,2,31,49,1599
5449,5449,A05E50C8250D6971328B3F8C4CFB1D1A,11061,16,23,7,29,48,1498
5450,5450,172F302F5199600F927C0E74978E3B3A,10111,0,9,9,37,47,1897
5451,5451,172F302F5199600F927C0E74978E3B3A,43341,11,14,3,41,46,2096
5452,5452,172F302F5199600F927C0E74978E3B3A,10681,15,17,2,30,48,1548
5453,5453,172F302F5199600F927C0E74978E3B3A,42401,20,23,3,36,47,1847
5454,5454,895178A7C4631A70E81256690FBFBF91,11331,0,5,5,37,48,1898
5455,5455,895178A7C4631A70E81256690FBFBF91,42091,7,16,9,43,46,2196
5456,5456,895178A7C4631A70E81256690FBFBF91,13371,20,23,3,41,47,2097
5467,5467,4D4E482DE77E19D1B2EC549782E6CF3D,10381,1,8,7,31,49,1599
5468,5468,4D4E482DE77E19D1B2EC549782E6CF3D,12601,11,15,4,25,47,1297
5469,5469,4D4E482DE77E19D1B2EC549782E6CF3D,10161,19,22,3,35,49,1799
5470,5470,D3EF141BDC81929D7A3D2C86A2B15366,15411,0,1,1,44,27,2227
5471,5471,D3EF141BDC81929D7A3D2C86A2B15366,12611,2,5,3,41,29,2079
5472,5472,D3EF141BDC81929D7A3D2C86A2B15366,15411,5,19,14,44,27,2227
5473,5473,698C19411560F37F7FA9C84922A810AD,40841,0,10,10,33,49,1699
5474,5474,698C19411560F37F7FA9C84922A810AD,10451,12,14,2,25,48,1298
5475,5475,698C19411560F37F7FA9C84922A810AD,40872,16,18,2,30,49,1549
5476,5476,1DD5E3CBE74991223EA5E7C350F82331,11806,1,2,1,41,48,2098
5477,5477,1DD5E3CBE74991223EA5E7C350F82331,42271,6,7,1,40,47,2047
5478,5478,1DD5E3CBE74991223EA5E7C350F82331,42511,11,21,10,37,47,1897
5479,5479,D73B2854AD737668DCBFC2AD5E22AA5A,42864,2,4,2,38,44,1944
5480,5480,D73B2854AD737668DCBFC2AD5E22AA5A,11261,9,12,3,36,46,1846
5481,5481,D73B2854AD737668DCBFC2AD5E22AA5A,42864,15,17,2,38,44,1944
5482,5482,D73B2854AD737668DCBFC2AD5E22AA5A,11261,18,20,2,36,46,1846
5483,5483,D73B2854AD737668DCBFC2AD5E22AA5A,42864,21,23,2,38,44,1944
5493,5493,C173E680DFAEC165B5B7AE7346539D93,11031,2,10,8,42,49,2149
5494,5494,C173E680DFAEC165B5B7AE7346539D93,10621,13,16,3,41,49,2099
5495,5495,C173E680DFAEC165B5B7AE7346539D93,11201,19,22,3,35,49,1799
5502,5502,AAC98D8EB5664A9B5DE56F266CB31991,16281,0,16,16,11,4,554
5503,5503,AAC98D8EB5664A9B5DE56F266CB31991,15143,16,19,3,18,7,907
5504,5504,AAC98D8EB5664A9B5DE56F266CB31991,16281,20,22,2,11,4,554
5505,5505,4312C7B9A8B44ACA401028F3E785818A,10721,0,12,12,31,48,1598
5506,5506,4312C7B9A8B44ACA401028F3E785818A,40302,14,15,1,40,49,2049
5507,5507,4312C7B9A8B44ACA401028F3E785818A,12381,20,23,3,32,48,1648
5511,5511,4DCE5ECF090CCD499D4123AF8AD66CF3,10681,0,16,16,30,48,1548
5512,5512,4DCE5ECF090CCD499D4123AF8AD66CF3,10221,18,21,3,34,49,1749
5513,5513,4DCE5ECF090CCD499D4123AF8AD66CF3,10681,22,23,1,30,48,1548
5514,5514,A53DAA006542212C0F792E33874BF547,42801,3,10,7,40,49,2049
5515,5515,A53DAA006542212C0F792E33874BF547,10381,11,13,2,31,49,1599
5516,5516,A53DAA006542212C0F792E33874BF547,42801,18,22,4,40,49,2049
5517,5517,46624C7A7A05E81084BABC40FE8F937C,13314,0,7,7,31,39,1589
5518,5518,46624C7A7A05E81084BABC40FE8F937C,12521,7,9,2,35,41,1791
5519,5519,46624C7A7A05E81084BABC40FE8F937C,13314,11,23,12,31,39,1589
5520,5520,3AF1B21295E43D0D207FC9F12927314D,41401,1,2,1,37,46,1896
5521,5521,3AF1B21295E43D0D207FC9F12927314D,11171,2,15,13,33,48,1698
5522,5522,3AF1B21295E43D0D207FC9F12927314D,42231,16,17,1,37,46,1896
5523,5523,3AF1B21295E43D0D207FC9F12927314D,11171,20,23,3,33,48,1698
5524,5524,62C5F990E363019A0A27FD9217EC4B7B,15361,0,11,11,33,25,1675
5525,5525,62C5F990E363019A0A27FD9217EC4B7B,15391,14,15,1,35,26,1776
5526,5526,62C5F990E363019A0A27FD9217EC4B7B,15191,16,17,1,36,27,1827
5527,5527,62C5F990E363019A0A27FD9217EC4B7B,42221,20,21,1,38,48,1948
5528,5528,2F1F7798F5E8889B4080CA59D71F0274,10271,0,6,6,37,46,1896
5529,5529,2F1F7798F5E8889B4080CA59D71F0274,11081,6,8,2,35,46,1796
5530,5530,2F1F7798F5E8889B4080CA59D71F0274,10271,9,11,2,37,46,1896
5531,5531,2F1F7798F5E8889B4080CA59D71F0274,13711,11,17,6,38,46,1946
5532,5532,2F1F7798F5E8889B4080CA59D71F0274,10271,19,23,4,37,46,1896
5537,5537,906075D6233195F1F9099F6FBB81286D,43761,0,6,6,32,47,1647
5538,5538,906075D6233195F1F9099F6FBB81286D,42523,11,12,1,31,47,1597
5539,5539,906075D6233195F1F9099F6FBB81286D,11861,13,14,1,32,47,1647
5540,5540,906075D6233195F1F9099F6FBB81286D,10107,16,19,3,38,49,1949
5548,5548,4A13D317408FAA25E5E85E9637D26642,10811,0,6,6,38,46,1946
5549,5549,4A13D317408FAA25E5E85E9637D26642,40691,9,10,1,42,48,2148
5550,5550,4A13D317408FAA25E5E85E9637D26642,10811,12,23,11,38,46,1946
5558,5558,635220F16D99C75A2306E5A0687FDC46,42231,0,9,9,37,46,1896
5559,5559,635220F16D99C75A2306E5A0687FDC46,12121,11,12,1,29,47,1497
5560,5560,635220F16D99C75A2306E5A0687FDC46,42621,14,15,1,24,49,1249
5561,5561,635220F16D99C75A2306E5A0687FDC46,42511,19,22,3,37,47,1897
5565,5565,B9EADEBA268989D8CCA0A1249C757D09,10681,0,7,7,30,48,1548
5566,5566,B9EADEBA268989D8CCA0A1249C757D09,42511,11,12,1,37,47,1897
5567,5567,B9EADEBA268989D8CCA0A1249C757D09,13731,17,21,4,33,49,1699
5571,5571,3E98933C589157FCDDD2AEF7643E6F5D,42961,0,3,3,35,49,1799
5572,5572,3E98933C589157FCDDD2AEF7643E6F5D,10121,4,9,5,36,49,1849
5573,5573,3E98933C589157FCDDD2AEF7643E6F5D,40341,12,14,2,23,49,1199
5574,5574,3E98933C589157FCDDD2AEF7643E6F5D,42961,15,22,7,35,49,1799
5575,5575,DA45C385079CB215948D5C65FC8DC814,40637,0,9,9,36,47,1847
5576,5576,DA45C385079CB215948D5C65FC8DC814,11011,10,17,7,39,49,1999
5577,5577,DA45C385079CB215948D5C65FC8DC814,40637,18,23,5,36,47,1847
5578,5578,1522BDE7E05C3ADAA9D8391F632D7715,11361,0,3,3,22,48,1148
5579,5579,1522BDE7E05C3ADAA9D8391F632D7715,12051,7,8,1,20,47,1047
5580,5580,1522BDE7E05C3ADAA9D8391F632D7715,11361,12,16,4,22,48,1148
5581,5581,1522BDE7E05C3ADAA9D8391F632D7715,12581,17,18,1,24,48,1248
5582,5582,1522BDE7E05C3ADAA9D8391F632D7715,11361,21,23,2,22,48,1148
5583,5583,C7B2C2AE2DF954A69981F5A4F94159CA,13231,0,2,2,39,46,1996
5584,5584,C7B2C2AE2DF954A69981F5A4F94159CA,13671,3,9,6,27,43,1393
5585,5585,C7B2C2AE2DF954A69981F5A4F94159CA,11261,13,19,6,36,46,1846
5586,5586,C7B2C2AE2DF954A69981F5A4F94159CA,42351,21,22,1,38,45,1945
5590,5590,405425CB3107629C743592DE469E38AA,42581,0,7,7,38,48,1948
5591,5591,405425CB3107629C743592DE469E38AA,11914,7,8,1,37,48,1898
5592,5592,405425CB3107629C743592DE469E38AA,42581,8,17,9,38,48,1948
5593,5593,405425CB3107629C743592DE469E38AA,11914,17,18,1,37,48,1898
5594,5594,405425CB3107629C743592DE469E38AA,42581,19,22,3,38,48,1948
5599,5599,2B30FE33FBF3AFAE54A80917AD235B85,11021,0,6,6,36,49,1849
5600,5600,2B30FE33FBF3AFAE54A80917AD235B85,43341,8,9,1,41,46,2096
5601,5601,2B30FE33FBF3AFAE54A80917AD235B85,11231,15,16,1,37,49,1899
5602,5602,2B30FE33FBF3AFAE54A80917AD235B85,11591,21,23,2,36,49,1849
5606,5606,08661D16C30CA77E77F4A21FC9E00187,13711,0,9,9,38,46,1946
5607,5607,08661D16C30CA77E77F4A21FC9E00187,40691,12,14,2,42,48,2148
5608,5608,08661D16C30CA77E77F4A21FC9E00187,42271,16,19,3,40,47,2047
5609,5609,08661D16C30CA77E77F4A21FC9E00187,12511,19,21,2,39,47,1997
5610,5610,5279441575ECF61EDE50B3CE17FFB568,11753,0,15,15,35,48,1798
5611,5611,5279441575ECF61EDE50B3CE17FFB568,40341,16,17,1,23,49,1199
5612,5612,5279441575ECF61EDE50B3CE17FFB568,13511,18,19,1,34,48,1748
5613,5613,5279441575ECF61EDE50B3CE17FFB568,42021,21,22,1,33,47,1697
5614,5614,0161781F72F04358B8C36BF7C396B645,13341,0,1,1,44,45,2245
5615,5615,0161781F72F04358B8C36BF7C396B645,43061,1,2,1,43,46,2196
5616,5616,0161781F72F04358B8C36BF7C396B645,13341,2,10,8,44,45,2245
5617,5617,0161781F72F04358B8C36BF7C396B645,11074,13,14,1,37,47,1897
5618,5618,0161781F72F04358B8C36BF7C396B645,13341,16,19,3,44,45,2245
5619,5619,C2031A0078FA580DC3FF11C21BE12650,10251,7,16,9,35,47,1797
5620,5620,C2031A0078FA580DC3FF11C21BE12650,40463,18,19,1,38,49,1949
5621,5621,C2031A0078FA580DC3FF11C21BE12650,10251,22,23,1,35,47,1797
5626,5626,33A86271513E790D005DA73004BB62A7,11171,0,2,2,33,48,1698
5627,5627,33A86271513E790D005DA73004BB62A7,11061,2,17,15,29,48,1498
5628,5628,33A86271513E790D005DA73004BB62A7,13121,19,23,4,38,46,1946
5635,5635,ACE6CA8B487669BE8A7949AA7EA2747D,12381,3,12,9,32,48,1648
5636,5636,ACE6CA8B487669BE8A7949AA7EA2747D,11201,13,17,4,35,49,1799
5637,5637,ACE6CA8B487669BE8A7949AA7EA2747D,10911,19,22,3,39,46,1996
5638,5638,FDEB991F197D09BEFBCB8EC007D54430,40302,0,8,8,40,49,2049
5639,5639,FDEB991F197D09BEFBCB8EC007D54430,13511,8,10,2,34,48,1748
5640,5640,FDEB991F197D09BEFBCB8EC007D54430,11301,14,17,3,41,49,2099
5641,5641,FDEB991F197D09BEFBCB8EC007D54430,11541,18,20,2,35,49,1799
5642,5642,FDEB991F197D09BEFBCB8EC007D54430,11301,21,23,2,41,49,2099
5643,5643,2A8CA6F11C450B23235B353369F9B4CE,10841,1,2,1,37,47,1897
5644,5644,2A8CA6F11C450B23235B353369F9B4CE,42221,4,9,5,38,48,1948
5645,5645,2A8CA6F11C450B23235B353369F9B4CE,42471,9,11,2,35,49,1799
5646,5646,2A8CA6F11C450B23235B353369F9B4CE,11914,16,17,1,37,48,1898
5647,5647,2A8CA6F11C450B23235B353369F9B4CE,12514,18,21,3,38,47,1947
5648,5648,421D5A74E728EAFB0215FB1663C04EEE,13511,0,9,9,34,48,1748
5649,5649,421D5A74E728EAFB0215FB1663C04EEE,10107,12,13,1,38,49,1949
5650,5650,421D5A74E728EAFB0215FB1663C04EEE,13511,14,17,3,34,48,1748
5651,5651,421D5A74E728EAFB0215FB1663C04EEE,11301,18,20,2,41,49,2099
5652,5652,421D5A74E728EAFB0215FB1663C04EEE,11231,21,23,2,37,49,1899
5664,5664,A6A724CC4460DBD754141119DC329855,43761,2,9,7,32,47,1647
5665,5665,A6A724CC4460DBD754141119DC329855,42623,15,21,6,22,49,1149
5666,5666,A6A724CC4460DBD754141119DC329855,42141,22,23,1,32,47,1647
5667,5667,7A8E3559723376A6192CDCAE45BE4C4D,42021,1,6,5,33,47,1697
5668,5668,7A8E3559723376A6192CDCAE45BE4C4D,42161,8,9,1,36,47,1847
5669,5669,7A8E3559723376A6192CDCAE45BE4C4D,11651,10,12,2,33,47,1697
5670,5670,7A8E3559723376A6192CDCAE45BE4C4D,40341,16,18,2,23,49,1199
5671,5671,DDE982C188D8BEC9B774766B9EFBC5C3,10951,3,15,12,29,48,1498
5672,5672,DDE982C188D8BEC9B774766B9EFBC5C3,43731,18,19,1,34,47,1747
5673,5673,DDE982C188D8BEC9B774766B9EFBC5C3,10951,20,23,3,29,48,1498
5677,5677,D8645003EB503AEF89D00D98D7E87255,11231,0,8,8,37,49,1899
5678,5678,D8645003EB503AEF89D00D98D7E87255,11021,13,14,1,36,49,1849
5679,5679,D8645003EB503AEF89D00D98D7E87255,11861,16,17,1,32,47,1647
5680,5680,D8645003EB503AEF89D00D98D7E87255,42161,19,23,4,36,47,1847
5684,5684,6657340E3E8EAFBE8630D734C7DFAA0A,19181,1,6,5,8,40,440
5685,5685,6657340E3E8EAFBE8630D734C7DFAA0A,19021,9,10,1,10,45,545
5686,5686,6657340E3E8EAFBE8630D734C7DFAA0A,10471,12,14,2,37,48,1898
5687,5687,6657340E3E8EAFBE8630D734C7DFAA0A,19021,16,17,1,10,45,545
5688,5688,6657340E3E8EAFBE8630D734C7DFAA0A,19114,21,22,1,7,43,393
5689,5689,50654F68D94497D10A1C2B9ADDEB1DF4,11771,0,7,7,39,49,1999
5690,5690,50654F68D94497D10A1C2B9ADDEB1DF4,10191,12,16,4,40,48,2048
5691,5691,50654F68D94497D10A1C2B9ADDEB1DF4,11551,17,19,2,39,49,1999
5692,5692,50654F68D94497D10A1C2B9ADDEB1DF4,10721,20,22,2,31,48,1598
5693,5693,E311A49FD79CE1E67702DBA9B7887B92,12641,0,5,5,10,43,543
5694,5694,E311A49FD79CE1E67702DBA9B7887B92,19021,6,11,5,10,45,545
5695,5695,E311A49FD79CE1E67702DBA9B7887B92,12641,11,13,2,10,43,543
5696,5696,E311A49FD79CE1E67702DBA9B7887B92,19021,13,18,5,10,45,545
5697,5697,E311A49FD79CE1E67702DBA9B7887B92,12641,20,23,3,10,43,543
5698,5698,B15C7136391E7685B64800EC1916966F,13671,5,11,6,27,43,1393
5699,5699,B15C7136391E7685B64800EC1916966F,11324,13,15,2,31,46,1596
5700,5700,B15C7136391E7685B64800EC1916966F,12601,16,18,2,25,47,1297
5701,5701,B15C7136391E7685B64800EC1916966F,11324,21,23,2,31,46,1596
5702,5702,D2E6AB586A09EFBBD099D10181890291,11324,1,13,12,31,46,1596
5703,5703,D2E6AB586A09EFBBD099D10181890291,11061,16,18,2,29,48,1498
5704,5704,D2E6AB586A09EFBBD099D10181890291,11151,19,20,1,30,48,1548
5705,5705,D2E6AB586A09EFBBD099D10181890291,13511,22,23,1,34,48,1748
5706,5706,678046569E2EA8E0029CA68E4A494B0D,12311,2,9,7,30,44,1544
5707,5707,678046569E2EA8E0029CA68E4A494B0D,42151,9,14,5,35,45,1795
5708,5708,678046569E2EA8E0029CA68E4A494B0D,12311,14,23,9,30,44,1544
5709,5709,83032CC6A0DAD180410F046AB9CA56B4,11381,0,9,9,30,47,1547
5710,5710,83032CC6A0DAD180410F046AB9CA56B4,13101,11,12,1,40,47,2047
5711,5711,83032CC6A0DAD180410F046AB9CA56B4,11381,13,19,6,30,47,1547
5712,5712,83032CC6A0DAD180410F046AB9CA56B4,43971,21,23,2,30,48,1548
5713,5713,2D9132D891C9F27B94429ACB6007E58D,11161,0,9,9,32,48,1648
5714,5714,2D9132D891C9F27B94429ACB6007E58D,12731,10,13,3,22,40,1140
5715,5715,2D9132D891C9F27B94429ACB6007E58D,10491,14,18,4,33,48,1698
5716,5716,2D9132D891C9F27B94429ACB6007E58D,40951,18,20,2,36,49,1849
5717,5717,2D9132D891C9F27B94429ACB6007E58D,11161,22,23,1,32,48,1648
5721,5721,C5AC3744EA191771220A3FE471A7FACC,42161,0,7,7,36,47,1847
5722,5722,C5AC3744EA191771220A3FE471A7FACC,19024,9,17,8,9,45,495
5723,5723,C5AC3744EA191771220A3FE471A7FACC,42161,19,23,4,36,47,1847
5727,5727,5BD38FAF30C47E51437EACD34683C50B,10281,9,11,2,33,48,1698
5728,5728,5BD38FAF30C47E51437EACD34683C50B,11861,12,13,1,32,47,1647
5729,5729,5BD38FAF30C47E51437EACD34683C50B,10281,13,14,1,33,48,1698
5730,5730,5BD38FAF30C47E51437EACD34683C50B,11651,19,20,1,33,47,1697
5731,5731,5BD38FAF30C47E51437EACD34683C50B,11861,21,22,1,32,47,1647
5741,5741,0AA9A21AE5592E43C5386C31A83CC971,11021,0,7,7,36,49,1849
5742,5742,0AA9A21AE5592E43C5386C31A83CC971,11751,8,9,1,35,48,1798
5743,5743,0AA9A21AE5592E43C5386C31A83CC971,40951,9,10,1,36,49,1849
5744,5744,0AA9A21AE5592E43C5386C31A83CC971,11751,10,12,2,35,48,1798
5745,5745,0AA9A21AE5592E43C5386C31A83CC971,40951,13,23,10,36,49,1849
5746,5746,84B75432EA5C292CE9D6A723114523BF,43581,0,10,10,33,48,1698
5747,5747,84B75432EA5C292CE9D6A723114523BF,40833,11,14,3,41,47,2097
5748,5748,84B75432EA5C292CE9D6A723114523BF,43581,15,22,7,33,48,1698
5753,5753,C6743ABD033F6E6B699408DD69018D42,10611,0,7,7,32,48,1648
5754,5754,C6743ABD033F6E6B699408DD69018D42,10491,7,16,9,33,48,1698
5755,5755,C6743ABD033F6E6B699408DD69018D42,10611,17,19,2,32,48,1648
5756,5756,C6743ABD033F6E6B699408DD69018D42,42623,19,21,2,22,49,1149
5757,5757,36BD94283960F3FA7F12C7E16BBE1044,42041,2,7,5,10,47,547
5758,5758,36BD94283960F3FA7F12C7E16BBE1044,19441,7,10,3,8,46,446
5759,5759,36BD94283960F3FA7F12C7E16BBE1044,42041,12,13,1,10,47,547
5760,5760,36BD94283960F3FA7F12C7E16BBE1044,19114,20,21,1,7,43,393
5761,5761,36BD94283960F3FA7F12C7E16BBE1044,11571,21,23,2,13,46,696
5762,5762,BAF8CBAEABDF4063FF5ED369E100E588,12083,0,8,8,36,49,1849
5763,5763,BAF8CBAEABDF4063FF5ED369E100E588,15201,10,15,5,42,16,2116
5764,5764,BAF8CBAEABDF4063FF5ED369E100E588,11161,17,20,3,32,48,1648
5765,5765,BAF8CBAEABDF4063FF5ED369E100E588,12083,21,23,2,36,49,1849
5766,5766,FBFB039BFE202B4D733B8197A5DE9AA1,43751,0,6,6,19,48,998
5767,5767,FBFB039BFE202B4D733B8197A5DE9AA1,12581,6,18,12,24,48,1248
5768,5768,FBFB039BFE202B4D733B8197A5DE9AA1,43751,18,23,5,19,48,998
5769,5769,D66DDB1AF696D6DDB044E124EA6B793E,13941,1,15,14,41,47,2097
5770,5770,D66DDB1AF696D6DDB044E124EA6B793E,11161,16,18,2,32,48,1648
5771,5771,D66DDB1AF696D6DDB044E124EA6B793E,10681,18,22,4,30,48,1548
5772,5772,1425A0F2912750FA0EF5B4ADBC6542C9,40271,3,13,10,35,49,1799
5773,5773,1425A0F2912750FA0EF5B4ADBC6542C9,42601,13,14,1,44,48,2248
5774,5774,1425A0F2912750FA0EF5B4ADBC6542C9,40271,19,23,4,35,49,1799
5791,5791,4C4BFC6596FD3FEC2B91BC1C914BF8BF,12871,0,7,7,22,33,1133
5792,5792,4C4BFC6596FD3FEC2B91BC1C914BF8BF,19281,11,15,4,16,32,832
5793,5793,4C4BFC6596FD3FEC2B91BC1C914BF8BF,12871,15,17,2,22,33,1133
5794,5794,4C4BFC6596FD3FEC2B91BC1C914BF8BF,19281,18,21,3,16,32,832
5798,5798,C518A470FA17AE3A0BAE461DF974B289,10901,0,2,2,35,48,1798
5799,5799,C518A470FA17AE3A0BAE461DF974B289,13271,2,20,18,41,47,2097
5800,5800,C518A470FA17AE3A0BAE461DF974B289,11481,20,23,3,41,48,2098
5801,5801,3E2728364EE0F8914C7020C6A1917CB0,42161,0,10,10,36,47,1847
5802,5802,3E2728364EE0F8914C7020C6A1917CB0,10971,10,12,2,35,47,1797
5803,5803,3E2728364EE0F8914C7020C6A1917CB0,12601,15,17,2,25,47,1297
5804,5804,3E2728364EE0F8914C7020C6A1917CB0,42161,20,22,2,36,47,1847
5808,5808,566A98F570A1628E8F6EFD9CFCC9370E,42381,1,4,3,39,41,1991
5809,5809,566A98F570A1628E8F6EFD9CFCC9370E,12491,7,8,1,36,43,1843
5810,5810,566A98F570A1628E8F6EFD9CFCC9370E,12661,8,14,6,32,45,1645
5811,5811,566A98F570A1628E8F6EFD9CFCC9370E,12021,15,17,2,37,49,1899
5812,5812,566A98F570A1628E8F6EFD9CFCC9370E,13911,18,20,2,39,46,1996
5813,5813,566A98F570A1628E8F6EFD9CFCC9370E,12661,20,22,2,32,45,1645
5814,5814,95471D684DB585D0049B7AB0C8B83123,43311,2,7,5,31,48,1598
5815,5815,95471D684DB585D0049B7AB0C8B83123,11061,8,11,3,29,48,1498
5816,5816,95471D684DB585D0049B7AB0C8B83123,40445,11,13,2,30,48,1548
5817,5817,95471D684DB585D0049B7AB0C8B83123,11061,13,16,3,29,48,1498
5818,5818,95471D684DB585D0049B7AB0C8B83123,43311,20,21,1,31,48,1598
5819,5819,12366BA0CE6EA78A5F9525D697B32EB5,13711,2,14,12,38,46,1946
5820,5820,12366BA0CE6EA78A5F9525D697B32EB5,40341,15,17,2,23,49,1199
5821,5821,12366BA0CE6EA78A5F9525D697B32EB5,11074,18,19,1,37,47,1897
5822,5822,8B6448FD7DB9F8E2F8F73AFDDD5BFD38,19021,0,1,1,10,45,545
5823,5823,8B6448FD7DB9F8E2F8F73AFDDD5BFD38,43021,1,5,4,16,43,843
5824,5824,8B6448FD7DB9F8E2F8F73AFDDD5BFD38,12921,5,19,14,9,41,491
5825,5825,BA02C3BCEE7A48A5C905C95BDC29D4FD,15391,5,6,1,35,26,1776
5826,5826,BA02C3BCEE7A48A5C905C95BDC29D4FD,12791,6,7,1,31,29,1579
5827,5827,BA02C3BCEE7A48A5C905C95BDC29D4FD,15391,11,13,2,35,26,1776
5828,5828,BA02C3BCEE7A48A5C905C95BDC29D4FD,12791,15,17,2,31,29,1579
5829,5829,BA02C3BCEE7A48A5C905C95BDC29D4FD,15391,21,23,2,35,26,1776
5830,5830,8ACC50A8C55036CCB5F5CED9121C61C8,15191,5,11,6,36,27,1827
5831,5831,8ACC50A8C55036CCB5F5CED9121C61C8,12791,11,12,1,31,29,1579
5832,5832,8ACC50A8C55036CCB5F5CED9121C61C8,15191,14,23,9,36,27,1827
5833,5833,58C2B7607E34F1174410FF741430D7C5,10621,0,8,8,41,49,2099
5834,5834,58C2B7607E34F1174410FF741430D7C5,10401,10,11,1,33,49,1699
5835,5835,58C2B7607E34F1174410FF741430D7C5,10621,14,17,3,41,49,2099
5836,5836,58C2B7607E34F1174410FF741430D7C5,11751,18,20,2,35,48,1798
5837,5837,58C2B7607E34F1174410FF741430D7C5,10621,21,23,2,41,49,2099
5841,5841,200194CA33DD57C0E0CC791C5F2E51EB,12514,0,9,9,38,47,1947
5842,5842,200194CA33DD57C0E0CC791C5F2E51EB,13121,12,14,2,38,46,1946
5843,5843,200194CA33DD57C0E0CC791C5F2E51EB,10491,18,20,2,33,48,1698
5844,5844,200194CA33DD57C0E0CC791C5F2E51EB,10251,20,21,1,35,47,1797
5848,5848,C48AF9FD92249AFBDE30934410FF853B,10471,0,10,10,37,48,1898
5849,5849,C48AF9FD92249AFBDE30934410FF853B,11381,12,14,2,30,47,1547
5850,5850,C48AF9FD92249AFBDE30934410FF853B,10471,17,23,6,37,48,1898
5855,5855,97EED02186157B67ACCA35C5CC13851D,43161,0,10,10,35,47,1797
5856,5856,97EED02186157B67ACCA35C5CC13851D,11731,12,13,1,36,48,1848
5857,5857,97EED02186157B67ACCA35C5CC13851D,11331,13,14,1,37,48,1898
5858,5858,97EED02186157B67ACCA35C5CC13851D,11731,15,17,2,36,48,1848
5859,5859,97EED02186157B67ACCA35C5CC13851D,10901,17,18,1,35,48,1798
5860,5860,97EED02186157B67ACCA35C5CC13851D,40691,21,23,2,42,48,2148
5861,5861,A845F5E6E274947D69D978D433D48E69,11914,0,11,11,37,48,1898
5862,5862,A845F5E6E274947D69D978D433D48E69,12601,13,16,3,25,47,1297
5863,5863,A845F5E6E274947D69D978D433D48E69,42641,19,21,2,33,49,1699
5864,5864,A845F5E6E274947D69D978D433D48E69,11331,22,23,1,37,48,1898
5868,5868,E274FB59BFC8CCFE4F74C199808635E9,12311,0,6,6,30,44,1544
5869,5869,E274FB59BFC8CCFE4F74C199808635E9,11211,10,11,1,34,49,1749
5870,5870,E274FB59BFC8CCFE4F74C199808635E9,12311,14,22,8,30,44,1544
5871,5871,CE609F9A3F19D534B803960C84F7425C,11231,1,3,2,37,49,1899
5872,5872,CE609F9A3F19D534B803960C84F7425C,40171,3,11,8,38,48,1948
5873,5873,CE609F9A3F19D534B803960C84F7425C,10921,12,13,1,43,48,2198
5874,5874,CE609F9A3F19D534B803960C84F7425C,11231,19,21,2,37,49,1899
5875,5875,CE609F9A3F19D534B803960C84F7425C,41101,21,23,2,32,48,1648
5876,5876,93009210860BDDA03DDE81542E8F3857,42221,0,7,7,38,48,1948
5877,5877,93009210860BDDA03DDE81542E8F3857,12481,7,9,2,37,49,1899
5878,5878,93009210860BDDA03DDE81542E8F3857,11751,12,15,3,35,48,1798
5879,5879,93009210860BDDA03DDE81542E8F3857,11771,15,19,4,39,49,1999
5880,5880,93009210860BDDA03DDE81542E8F3857,12514,19,23,4,38,47,1947
5892,5892,5D521E2F15FD8DA6F8D88E5B58CB6A8B,13511,0,9,9,34,48,1748
5893,5893,5D521E2F15FD8DA6F8D88E5B58CB6A8B,11481,10,11,1,41,48,2098
5894,5894,5D521E2F15FD8DA6F8D88E5B58CB6A8B,13094,16,17,1,21,42,1092
5895,5895,5D521E2F15FD8DA6F8D88E5B58CB6A8B,40341,18,21,3,23,49,1199
5896,5896,0C5285B3D9349DE5F23E13A6102C7D40,49201,1,13,12,7,41,391
5897,5897,0C5285B3D9349DE5F23E13A6102C7D40,12641,14,17,3,10,43,543
5898,5898,0C5285B3D9349DE5F23E13A6102C7D40,49201,20,23,3,7,41,391
5899,5899,9F589AB01E58B6B2CA9FB997F96CB7F3,43011,0,2,2,40,42,2042
5900,5900,9F589AB01E58B6B2CA9FB997F96CB7F3,13071,2,5,3,41,41,2091
5901,5901,9F589AB01E58B6B2CA9FB997F96CB7F3,42381,6,8,2,39,41,1991
5902,5902,9F589AB01E58B6B2CA9FB997F96CB7F3,43451,9,16,7,37,40,1890
5903,5903,9F589AB01E58B6B2CA9FB997F96CB7F3,42381,19,22,3,39,41,1991
5910,5910,2C9F9127F2AECFBA8069624790D23C60,10471,0,3,3,37,48,1898
5911,5911,2C9F9127F2AECFBA8069624790D23C60,11921,3,5,2,38,48,1948
5912,5912,2C9F9127F2AECFBA8069624790D23C60,10471,5,16,11,37,48,1898
5913,5913,2C9F9127F2AECFBA8069624790D23C60,40077,17,19,2,37,49,1899
5914,5914,2C9F9127F2AECFBA8069624790D23C60,10471,19,23,4,37,48,1898
5915,5915,81722474C4A312C50576536C7B45B8F0,12841,0,11,11,37,47,1897
5916,5916,81722474C4A312C50576536C7B45B8F0,10411,13,14,1,36,48,1848
5917,5917,81722474C4A312C50576536C7B45B8F0,10061,17,19,2,20,46,1046
5918,5918,81722474C4A312C50576536C7B45B8F0,12841,21,23,2,37,47,1897
5922,5922,3DD4BB111CF6FE24DC80977720A33A24,10121,0,1,1,36,49,1849
5923,5923,3DD4BB111CF6FE24DC80977720A33A24,13741,2,17,15,37,49,1899
5924,5924,3DD4BB111CF6FE24DC80977720A33A24,10411,18,20,2,36,48,1848
5925,5925,3DD4BB111CF6FE24DC80977720A33A24,40637,20,21,1,36,47,1847
5926,5926,3DD4BB111CF6FE24DC80977720A33A24,10251,22,23,1,35,47,1797
5930,5930,3B8E942809CB0C16C1DC0CEA3AD9EB11,11381,0,12,12,30,47,1547
5931,5931,3B8E942809CB0C16C1DC0CEA3AD9EB11,10951,12,17,5,29,48,1498
5932,5932,3B8E942809CB0C16C1DC0CEA3AD9EB11,42071,17,18,1,31,49,1599
5933,5933,3B8E942809CB0C16C1DC0CEA3AD9EB11,40094,19,22,3,29,48,1498
5934,5934,3B8E942809CB0C16C1DC0CEA3AD9EB11,11381,22,23,1,30,47,1547
5935,5935,19FF976328DAF40B2191A4FAD8E693E1,43451,7,10,3,37,40,1890
5936,5936,19FF976328DAF40B2191A4FAD8E693E1,13071,10,13,3,41,41,2091
5937,5937,19FF976328DAF40B2191A4FAD8E693E1,43451,15,18,3,37,40,1890
5938,5938,19FF976328DAF40B2191A4FAD8E693E1,42381,20,23,3,39,41,1991
5939,5939,7EA7A90DDE25A9C1BE3AA0C608BD2169,12381,0,2,2,32,48,1648
5940,5940,7EA7A90DDE25A9C1BE3AA0C608BD2169,11461,4,16,12,37,49,1899
5941,5941,7EA7A90DDE25A9C1BE3AA0C608BD2169,43281,18,20,2,37,48,1898
5942,5942,7EA7A90DDE25A9C1BE3AA0C608BD2169,40636,21,23,2,35,48,1798
5943,5943,6D1767685CFDF945848EE7885E835BAF,42871,1,8,7,30,45,1545
5944,5944,6D1767685CFDF945848EE7885E835BAF,11951,10,14,4,31,49,1599
5945,5945,6D1767685CFDF945848EE7885E835BAF,42871,19,23,4,30,45,1545
5946,5946,5A02A0783A87EA433648AFD73A3E8C60,19111,0,8,8,9,45,495
5947,5947,5A02A0783A87EA433648AFD73A3E8C60,10471,11,18,7,37,48,1898
5948,5948,5A02A0783A87EA433648AFD73A3E8C60,19111,21,23,2,9,45,495
5949,5949,D049151AA3A3F2786A77273D813485C6,40833,0,6,6,41,47,2097
5950,5950,D049151AA3A3F2786A77273D813485C6,11074,7,8,1,37,47,1897
5951,5951,D049151AA3A3F2786A77273D813485C6,13101,9,10,1,40,47,2047
5952,5952,D049151AA3A3F2786A77273D813485C6,40833,14,15,1,41,47,2097
5953,5953,D049151AA3A3F2786A77273D813485C6,13101,18,23,5,40,47,2047
5954,5954,5C7872947538FD21C5B6506FBE006EFB,40302,0,7,7,40,49,2049
5955,5955,5C7872947538FD21C5B6506FBE006EFB,42071,9,12,3,31,49,1599
5956,5956,5C7872947538FD21C5B6506FBE006EFB,10621,15,19,4,41,49,2099
5957,5957,5C7872947538FD21C5B6506FBE006EFB,40302,21,23,2,40,49,2049
5962,5962,44BA65919A80728667B0D62571A4968D,13121,0,7,7,38,46,1946
5963,5963,44BA65919A80728667B0D62571A4968D,10271,8,10,2,37,46,1896
5964,5964,44BA65919A80728667B0D62571A4968D,13121,10,11,1,38,46,1946
5965,5965,44BA65919A80728667B0D62571A4968D,10271,11,12,1,37,46,1896
5966,5966,44BA65919A80728667B0D62571A4968D,13121,13,15,2,38,46,1946
5967,5967,44BA65919A80728667B0D62571A4968D,10271,16,17,1,37,46,1896
5968,5968,44BA65919A80728667B0D62571A4968D,13121,21,22,1,38,46,1946
5973,5973,33EDDBB002EAA8F959EFBAE3B2DF7CED,10161,4,10,6,35,49,1799
5974,5974,33EDDBB002EAA8F959EFBAE3B2DF7CED,11521,12,16,4,41,48,2098
5975,5975,33EDDBB002EAA8F959EFBAE3B2DF7CED,11381,17,23,6,30,47,1547
5979,5979,E6C97D60C462CFB721F2FD41AA49CE5E,10107,7,15,8,38,49,1949
5980,5980,E6C97D60C462CFB721F2FD41AA49CE5E,11061,17,18,1,29,48,1498
5981,5981,E6C97D60C462CFB721F2FD41AA49CE5E,10681,18,23,5,30,48,1548
5986,5986,B07A88B87F7275C03AADB4B1031F05C9,11541,0,16,16,35,49,1799
5987,5987,B07A88B87F7275C03AADB4B1031F05C9,40341,17,18,1,23,49,1199
5988,5988,B07A88B87F7275C03AADB4B1031F05C9,10511,19,20,1,35,46,1796
5989,5989,69B39B5C39870FB3BB89916D30DD5659,11061,0,13,13,29,48,1498
5990,5990,69B39B5C39870FB3BB89916D30DD5659,40951,13,15,2,36,49,1849
5991,5991,69B39B5C39870FB3BB89916D30DD5659,11481,15,16,1,41,48,2098
5992,5992,69B39B5C39870FB3BB89916D30DD5659,11061,17,18,1,29,48,1498
5993,5993,69B39B5C39870FB3BB89916D30DD5659,11151,20,23,3,30,48,1548
5997,5997,E7F0BEFEB527574747952B709C847F2A,15051,0,9,9,19,4,954
5998,5998,E7F0BEFEB527574747952B709C847F2A,16281,11,13,2,11,4,554
5999,5999,E7F0BEFEB527574747952B709C847F2A,15051,13,15,2,19,4,954
6000,6000,E7F0BEFEB527574747952B709C847F2A,16281,16,18,2,11,4,554
6001,6001,E7F0BEFEB527574747952B709C847F2A,15051,21,23,2,19,4,954
6005,6005,F276DA0C0E39AE3BAD5B91AE46CB6EA8,42971,0,6,6,43,49,2199
6006,6006,F276DA0C0E39AE3BAD5B91AE46CB6EA8,11231,6,8,2,37,49,1899
6007,6007,F276DA0C0E39AE3BAD5B91AE46CB6EA8,10471,10,11,1,37,48,1898
6008,6008,F276DA0C0E39AE3BAD5B91AE46CB6EA8,11231,14,22,8,37,49,1899
6009,6009,62A81BAE02AD26F7FD1065485EC5610B,42321,0,5,5,43,47,2197
6010,6010,62A81BAE02AD26F7FD1065485EC5610B,42401,9,16,7,36,47,1847
6011,6011,62A81BAE02AD26F7FD1065485EC5610B,42321,20,23,3,43,47,2197
6022,6022,105A3B72395833D152D1F67AE98737D7,49201,8,12,4,7,41,391
6023,6023,105A3B72395833D152D1F67AE98737D7,12921,13,15,2,9,41,491
6024,6024,105A3B72395833D152D1F67AE98737D7,19181,16,18,2,8,40,440
6025,6025,105A3B72395833D152D1F67AE98737D7,12641,21,22,1,10,43,543
6029,6029,0F63EB0E2A76702961055628B34A5DB2,43241,1,7,6,36,46,1846
6030,6030,0F63EB0E2A76702961055628B34A5DB2,11491,10,11,1,36,47,1847
6031,6031,0F63EB0E2A76702961055628B34A5DB2,11841,12,13,1,33,46,1696
6032,6032,0F63EB0E2A76702961055628B34A5DB2,43241,15,17,2,36,46,1846
6033,6033,0F63EB0E2A76702961055628B34A5DB2,11841,20,21,1,33,46,1696
6037,6037,331736FE71666B7814EF475D313271C7,19031,1,2,1,1,42,92
6038,6038,331736FE71666B7814EF475D313271C7,12641,17,18,1,10,43,543
6039,6039,331736FE71666B7814EF475D313271C7,19931,19,20,1,7,43,393
6043,6043,6EB93CCAB2222C7D454DB87232E2BFCB,42623,0,5,5,22,49,1149
6044,6044,6EB93CCAB2222C7D454DB87232E2BFCB,42071,6,7,1,31,49,1599
6045,6045,6EB93CCAB2222C7D454DB87232E2BFCB,42623,7,23,16,22,49,1149
6062,6062,3817ED13C89DC986F3BE205F1215C1F8,10401,0,8,8,33,49,1699
6063,6063,3817ED13C89DC986F3BE205F1215C1F8,12561,18,20,2,45,43,2293
6064,6064,3817ED13C89DC986F3BE205F1215C1F8,43581,21,23,2,33,48,1698
6073,6073,84163E57ED4BE91550DB75AFE47332A8,42941,0,7,7,37,47,1897
6074,6074,84163E57ED4BE91550DB75AFE47332A8,12601,10,12,2,25,47,1297
6075,6075,84163E57ED4BE91550DB75AFE47332A8,42941,16,23,7,37,47,1897
6076,6076,246B62AE483A51351D1FFEA71D16E917,13961,0,9,9,42,48,2148
6077,6077,246B62AE483A51351D1FFEA71D16E917,40341,10,17,7,23,49,1199
6078,6078,246B62AE483A51351D1FFEA71D16E917,10421,19,23,4,41,48,2098
6079,6079,5F18C270CA517AE9165CAE32BDF74BE1,16421,1,7,6,8,2,402
6080,6080,5F18C270CA517AE9165CAE32BDF74BE1,16261,9,14,5,3,3,153
6081,6081,5F18C270CA517AE9165CAE32BDF74BE1,10107,18,21,3,38,49,1949
6082,6082,26E63B54A3846EB2740D7C84C9BF9FCC,40691,7,11,4,42,48,2148
6083,6083,26E63B54A3846EB2740D7C84C9BF9FCC,40951,12,17,5,36,49,1849
6084,6084,26E63B54A3846EB2740D7C84C9BF9FCC,42301,21,23,2,36,47,1847
6085,6085,C32C8F9FF080A801FCB6173A50B0D920,16233,0,6,6,5,15,265
6086,6086,C32C8F9FF080A801FCB6173A50B0D920,19351,11,13,2,2,18,118
6087,6087,C32C8F9FF080A801FCB6173A50B0D920,16151,13,15,2,13,11,661
6088,6088,C32C8F9FF080A801FCB6173A50B0D920,16233,19,23,4,5,15,265
6089,6089,BA700350BC4A7C5771B294B7292BB07F,10951,0,5,5,29,48,1498
6090,6090,BA700350BC4A7C5771B294B7292BB07F,40124,9,10,1,38,47,1947
6091,6091,BA700350BC4A7C5771B294B7292BB07F,13481,12,14,2,26,31,1331
6092,6092,BA700350BC4A7C5771B294B7292BB07F,43391,16,18,2,29,48,1498
6093,6093,BA700350BC4A7C5771B294B7292BB07F,42071,19,21,2,31,49,1599
6094,6094,E7F1EEAC2431E472C01748ABBDDF9743,40124,2,4,2,38,47,1947
6095,6095,E7F1EEAC2431E472C01748ABBDDF9743,13711,5,7,2,38,46,1946
6096,6096,E7F1EEAC2431E472C01748ABBDDF9743,10531,11,12,1,34,46,1746
6097,6097,E7F1EEAC2431E472C01748ABBDDF9743,40124,13,14,1,38,47,1947
6098,6098,E7F1EEAC2431E472C01748ABBDDF9743,11081,19,20,1,35,46,1796
6110,6110,9018E266A8BE2EB9DB62903115D3AAB1,15671,0,2,2,37,26,1876
6111,6111,9018E266A8BE2EB9DB62903115D3AAB1,15191,2,4,2,36,27,1827
6112,6112,9018E266A8BE2EB9DB62903115D3AAB1,12792,8,14,6,34,30,1730
6113,6113,9018E266A8BE2EB9DB62903115D3AAB1,15661,17,22,5,36,26,1826
6114,6114,1DDBA4173A1A82CE4A25CA162B8D11CB,42381,1,5,4,39,41,1991
6115,6115,1DDBA4173A1A82CE4A25CA162B8D11CB,13071,6,11,5,41,41,2091
6116,6116,1DDBA4173A1A82CE4A25CA162B8D11CB,42381,12,14,2,39,41,1991
6117,6117,1DDBA4173A1A82CE4A25CA162B8D11CB,43451,14,17,3,37,40,1890
6118,6118,1DDBA4173A1A82CE4A25CA162B8D11CB,43011,20,21,1,40,42,2042
6119,6119,1DDBA4173A1A82CE4A25CA162B8D11CB,42381,22,23,1,39,41,1991
6128,6128,23473E2E03D0A65C4003DD5C7AD8CFFA,42371,0,8,8,34,46,1746
6129,6129,23473E2E03D0A65C4003DD5C7AD8CFFA,42481,9,10,1,22,49,1149
6130,6130,23473E2E03D0A65C4003DD5C7AD8CFFA,42371,12,18,6,34,46,1746
6131,6131,23473E2E03D0A65C4003DD5C7AD8CFFA,10511,19,23,4,35,46,1796
6139,6139,2AC46CC4CE6B06A054D67C3525A8F6E5,10271,0,8,8,37,46,1896
6140,6140,2AC46CC4CE6B06A054D67C3525A8F6E5,11541,11,12,1,35,49,1799
6141,6141,2AC46CC4CE6B06A054D67C3525A8F6E5,10271,13,19,6,37,46,1896
6142,6142,2AC46CC4CE6B06A054D67C3525A8F6E5,11331,19,22,3,37,48,1898
6143,6143,FF0C11254BA355CCA708C36EE5C4353D,11381,0,7,7,30,47,1547
6144,6144,FF0C11254BA355CCA708C36EE5C4353D,42111,8,15,7,44,46,2246
6145,6145,FF0C11254BA355CCA708C36EE5C4353D,11381,19,21,2,30,47,1547
6153,6153,765113C0EC03D9C2E8837F99909100D7,40637,0,5,5,36,47,1847
6154,6154,765113C0EC03D9C2E8837F99909100D7,40673,5,7,2,36,48,1848
6155,6155,765113C0EC03D9C2E8837F99909100D7,10681,11,19,8,30,48,1548
6156,6156,D5E71E390724904049A5FF1B250D4255,10281,0,9,9,33,48,1698
6157,6157,D5E71E390724904049A5FF1B250D4255,10107,10,11,1,38,49,1949
6158,6158,D5E71E390724904049A5FF1B250D4255,11861,14,22,8,32,47,1647
6162,6162,D16481CD67BBDCD24B1E531B64FDA960,42261,8,9,1,25,49,1299
6163,6163,D16481CD67BBDCD24B1E531B64FDA960,42071,13,18,5,31,49,1599
6164,6164,D16481CD67BBDCD24B1E531B64FDA960,42121,20,21,1,26,49,1349
6165,6165,6A33D51836FB8796CD0675823F25553F,11091,0,10,10,29,47,1497
6166,6166,6A33D51836FB8796CD0675823F25553F,10271,14,15,1,37,46,1896
6167,6167,6A33D51836FB8796CD0675823F25553F,13121,16,18,2,38,46,1946
6168,6168,6A33D51836FB8796CD0675823F25553F,10651,19,20,1,36,49,1849
6169,6169,6A33D51836FB8796CD0675823F25553F,11231,21,23,2,37,49,1899
6173,6173,ECC55A41DE7DF4FF6A356DE1634B0C55,19264,0,8,8,10,36,536
6174,6174,ECC55A41DE7DF4FF6A356DE1634B0C55,43644,9,11,2,14,38,738
6175,6175,ECC55A41DE7DF4FF6A356DE1634B0C55,19264,12,23,11,10,36,536
6176,6176,538F90B2CC3C634AB532E22F4202476F,43761,0,5,5,32,47,1647
6177,6177,538F90B2CC3C634AB532E22F4202476F,13101,8,11,3,40,47,2047
6178,6178,538F90B2CC3C634AB532E22F4202476F,43761,16,23,7,32,47,1647
6187,6187,3922FD238DD5D48F7D9D1E9687F957C1,43161,0,1,1,35,47,1797
6188,6188,3922FD238DD5D48F7D9D1E9687F957C1,43731,1,6,5,34,47,1747
6189,6189,3922FD238DD5D48F7D9D1E9687F957C1,43161,9,10,1,35,47,1797
6190,6190,3922FD238DD5D48F7D9D1E9687F957C1,10731,13,14,1,33,47,1697
6191,6191,3922FD238DD5D48F7D9D1E9687F957C1,13561,16,17,1,37,49,1899
6192,6192,3922FD238DD5D48F7D9D1E9687F957C1,10731,19,20,1,33,47,1697
6193,6193,3922FD238DD5D48F7D9D1E9687F957C1,43161,20,23,3,35,47,1797
6194,6194,1D20B498D42204F7DA0BA75047AF3620,11271,0,8,8,37,48,1898
6195,6195,1D20B498D42204F7DA0BA75047AF3620,12083,9,10,1,36,49,1849
6196,6196,1D20B498D42204F7DA0BA75047AF3620,11201,12,13,1,35,49,1799
6197,6197,1D20B498D42204F7DA0BA75047AF3620,10471,15,20,5,37,48,1898
6198,6198,1D20B498D42204F7DA0BA75047AF3620,10111,20,23,3,37,47,1897
6199,6199,CC8D8ECF8D806D9A23B6F26FCF563846,10292,9,13,4,30,47,1547
6200,6200,CC8D8ECF8D806D9A23B6F26FCF563846,42523,17,18,1,31,47,1597
6201,6201,CC8D8ECF8D806D9A23B6F26FCF563846,10292,18,19,1,30,47,1547
6202,6202,CC8D8ECF8D806D9A23B6F26FCF563846,10931,21,23,2,41,48,2098
6203,6203,5ADA9660158083BA681D3EABE7C6BBBF,42864,0,1,1,38,44,1944
6204,6204,5ADA9660158083BA681D3EABE7C6BBBF,42861,6,10,4,37,44,1894
6205,6205,5ADA9660158083BA681D3EABE7C6BBBF,42864,12,13,1,38,44,1944
6206,6206,5ADA9660158083BA681D3EABE7C6BBBF,42861,14,17,3,37,44,1894
6207,6207,5ADA9660158083BA681D3EABE7C6BBBF,42864,20,21,1,38,44,1944
6208,6208,FADBD24FB94D9388BE2E59D5F595D57D,42161,7,9,2,36,47,1847
6209,6209,FADBD24FB94D9388BE2E59D5F595D57D,11481,12,15,3,41,48,2098
6210,6210,FADBD24FB94D9388BE2E59D5F595D57D,42461,15,17,2,45,47,2297
6211,6211,FADBD24FB94D9388BE2E59D5F595D57D,11481,18,19,1,41,48,2098
6212,6212,FADBD24FB94D9388BE2E59D5F595D57D,42161,20,22,2,36,47,1847
6216,6216,4ABDFA1F0DAD010CDAD68ED2F99BD05B,10971,0,4,4,35,47,1797
6217,6217,4ABDFA1F0DAD010CDAD68ED2F99BD05B,11871,8,18,10,29,46,1496
6218,6218,4ABDFA1F0DAD010CDAD68ED2F99BD05B,10971,20,21,1,35,47,1797
6228,6228,E4BBDF95EAE9C03A1D9EA65966C607FE,11661,0,7,7,40,49,2049
6229,6229,E4BBDF95EAE9C03A1D9EA65966C607FE,42831,9,13,4,27,48,1398
6230,6230,E4BBDF95EAE9C03A1D9EA65966C607FE,11661,14,20,6,40,49,2049
6231,6231,9DA7BAB7FB3814204B7C4507A07E372B,10151,0,7,7,34,47,1747
6232,6232,9DA7BAB7FB3814204B7C4507A07E372B,43951,9,10,1,49,41,2491
6233,6233,9DA7BAB7FB3814204B7C4507A07E372B,10151,14,19,5,34,47,1747
6234,6234,B041461E36B355457CA97CA2324D4DB7,13251,0,5,5,48,28,2428
6235,6235,B041461E36B355457CA97CA2324D4DB7,15411,7,9,2,44,27,2227
6236,6236,B041461E36B355457CA97CA2324D4DB7,13251,13,15,2,48,28,2428
6237,6237,B041461E36B355457CA97CA2324D4DB7,15411,16,18,2,44,27,2227
6238,6238,B041461E36B355457CA97CA2324D4DB7,12792,20,21,1,34,30,1730
6239,6239,B041461E36B355457CA97CA2324D4DB7,15411,22,23,1,44,27,2227
6240,6240,72D431B0819605E8021508E3D5962061,10221,0,8,8,34,49,1749
6241,6241,72D431B0819605E8021508E3D5962061,42801,18,19,1,40,49,2049
6242,6242,72D431B0819605E8021508E3D5962061,11791,20,23,3,38,49,1949
6243,6243,850AE9D8A5B62DE63BBA33B6F276F204,10161,0,3,3,35,49,1799
6244,6244,850AE9D8A5B62DE63BBA33B6F276F204,11381,4,12,8,30,47,1547
6245,6245,850AE9D8A5B62DE63BBA33B6F276F204,42961,14,15,1,35,49,1799
6246,6246,850AE9D8A5B62DE63BBA33B6F276F204,12311,18,19,1,30,44,1544
6247,6247,1D73A39CD9D00E7A842906C3097D7487,42301,0,1,1,36,47,1847
6248,6248,1D73A39CD9D00E7A842906C3097D7487,42511,3,4,1,37,47,1897
6249,6249,1D73A39CD9D00E7A842906C3097D7487,11491,7,8,1,36,47,1847
6250,6250,1D73A39CD9D00E7A842906C3097D7487,42151,16,17,1,35,45,1795
6251,6251,1D73A39CD9D00E7A842906C3097D7487,11261,17,18,1,36,46,1846
6261,6261,0C082730D94DAD2A3534B4A3313D4403,10911,0,8,8,39,46,1996
6262,6262,0C082730D94DAD2A3534B4A3313D4403,15641,11,14,3,9,21,471
6263,6263,0C082730D94DAD2A3534B4A3313D4403,42301,17,18,1,36,47,1847
6270,6270,E40FF661B4F3DA89AB28D734DF463F41,43021,0,6,6,16,43,843
6271,6271,E40FF661B4F3DA89AB28D734DF463F41,12921,8,18,10,9,41,491
6272,6272,E40FF661B4F3DA89AB28D734DF463F41,12641,21,23,2,10,43,543
6279,6279,E129E250452098C10CCF7A03E7B60A11,42071,10,13,3,31,49,1599
6280,6280,E129E250452098C10CCF7A03E7B60A11,42623,13,16,3,22,49,1149
6281,6281,E129E250452098C10CCF7A03E7B60A11,42071,18,23,5,31,49,1599
6282,6282,1C4286795932E5315147C67BA60ADCE3,15191,0,9,9,36,27,1827
6283,6283,1C4286795932E5315147C67BA60ADCE3,15091,9,12,3,35,26,1776
6284,6284,1C4286795932E5315147C67BA60ADCE3,15191,13,14,1,36,27,1827
6285,6285,1C4286795932E5315147C67BA60ADCE3,40341,16,19,3,23,49,1199
6286,6286,B332ABCA25E0A28EE94B43EC02EB2251,13311,0,5,5,27,39,1389
6287,6287,B332ABCA25E0A28EE94B43EC02EB2251,12521,9,17,8,35,41,1791
6288,6288,B332ABCA25E0A28EE94B43EC02EB2251,13311,18,23,5,27,39,1389
6289,6289,B02817398E68340C5586B4B2228E2088,42523,7,10,3,31,47,1597
6290,6290,B02817398E68340C5586B4B2228E2088,13651,10,11,1,30,47,1547
6291,6291,B02817398E68340C5586B4B2228E2088,42523,12,14,2,31,47,1597
6292,6292,B02817398E68340C5586B4B2228E2088,10295,15,18,3,30,47,1547
6293,6293,B02817398E68340C5586B4B2228E2088,42523,20,21,1,31,47,1597
6294,6294,3E43826B2F3C90E1974FF5F797EBAA40,42581,0,6,6,38,48,1948
6295,6295,3E43826B2F3C90E1974FF5F797EBAA40,13731,10,18,8,33,49,1699
6296,6296,3E43826B2F3C90E1974FF5F797EBAA40,11914,19,20,1,37,48,1898
6297,6297,D278A78B03015D942733A0F36181B50F,43041,0,7,7,41,46,2096
6298,6298,D278A78B03015D942733A0F36181B50F,10431,8,16,8,33,49,1699
6299,6299,D278A78B03015D942733A0F36181B50F,43041,19,23,4,41,46,2096
6300,6300,23938B8CBED0514FF17E1734652299B6,43481,0,1,1,39,48,1998
6301,6301,23938B8CBED0514FF17E1734652299B6,11806,2,6,4,41,48,2098
6302,6302,23938B8CBED0514FF17E1734652299B6,11074,7,13,6,37,47,1897
6303,6303,23938B8CBED0514FF17E1734652299B6,10221,14,18,4,34,49,1749
6304,6304,0E002027D741B8AED4EE58E469659344,10501,0,1,1,22,46,1146
6305,6305,0E002027D741B8AED4EE58E469659344,12601,3,6,3,25,47,1297
6306,6306,0E002027D741B8AED4EE58E469659344,12581,9,10,1,24,48,1248
6307,6307,0E002027D741B8AED4EE58E469659344,10061,14,17,3,20,46,1046
6308,6308,0E002027D741B8AED4EE58E469659344,10501,18,19,1,22,46,1146
6309,6309,0E002027D741B8AED4EE58E469659344,12581,19,22,3,24,48,1248
6310,6310,89313D14D4AEEAD368F822E4A0AA83FD,42041,0,5,5,10,47,547
6311,6311,89313D14D4AEEAD368F822E4A0AA83FD,19441,8,9,1,8,46,446
6312,6312,89313D14D4AEEAD368F822E4A0AA83FD,42041,12,13,1,10,47,547
6313,6313,89313D14D4AEEAD368F822E4A0AA83FD,19441,14,17,3,8,46,446
6314,6314,89313D14D4AEEAD368F822E4A0AA83FD,11851,17,18,1,13,47,697
6315,6315,89313D14D4AEEAD368F822E4A0AA83FD,42041,19,23,4,10,47,547
6316,6316,39179060954ADF536A44D5CDC3D7ADA4,12491,0,4,4,36,43,1843
6317,6317,39179060954ADF536A44D5CDC3D7ADA4,11261,5,6,1,36,46,1846
6318,6318,39179060954ADF536A44D5CDC3D7ADA4,13911,6,8,2,39,46,1996
6319,6319,39179060954ADF536A44D5CDC3D7ADA4,11261,8,11,3,36,46,1846
6320,6320,39179060954ADF536A44D5CDC3D7ADA4,12491,12,13,1,36,43,1843
6321,6321,39179060954ADF536A44D5CDC3D7ADA4,13911,14,16,2,39,46,1996
6322,6322,39179060954ADF536A44D5CDC3D7ADA4,11261,17,23,6,36,46,1846
6326,6326,8CF816555C069C916CD2D7420EB98D35,12561,0,8,8,45,43,2293
6327,6327,8CF816555C069C916CD2D7420EB98D35,43011,11,16,5,40,42,2042
6328,6328,8CF816555C069C916CD2D7420EB98D35,12561,16,18,2,45,43,2293
6329,6329,8CF816555C069C916CD2D7420EB98D35,43011,21,23,2,40,42,2042
6333,6333,1ECD76C2AA4A3FEC2AC37DC3DCA313AA,42981,1,7,6,36,49,1849
6334,6334,1ECD76C2AA4A3FEC2AC37DC3DCA313AA,10661,8,9,1,37,49,1899
6335,6335,1ECD76C2AA4A3FEC2AC37DC3DCA313AA,10107,12,13,1,38,49,1949
6336,6336,1ECD76C2AA4A3FEC2AC37DC3DCA313AA,10661,14,15,1,37,49,1899
6337,6337,1ECD76C2AA4A3FEC2AC37DC3DCA313AA,42981,15,17,2,36,49,1849
6338,6338,1ECD76C2AA4A3FEC2AC37DC3DCA313AA,42051,18,19,1,42,48,2148
6339,6339,1ECD76C2AA4A3FEC2AC37DC3DCA313AA,42221,21,23,2,38,48,1948
6343,6343,F1B018296E8ED57E3EC7BBC1652329B6,12521,0,6,6,35,41,1791
6344,6344,F1B018296E8ED57E3EC7BBC1652329B6,13041,6,8,2,30,37,1537
6345,6345,F1B018296E8ED57E3EC7BBC1652329B6,12521,9,23,14,35,41,1791
6349,6349,56577D7E072F237C8DE51C5D025371C7,12391,0,7,7,36,49,1849
6350,6350,56577D7E072F237C8DE51C5D025371C7,11941,10,11,1,37,46,1896
6351,6351,56577D7E072F237C8DE51C5D025371C7,11301,14,17,3,41,49,2099
6352,6352,56577D7E072F237C8DE51C5D025371C7,10121,21,23,2,36,49,1849
6370,6370,F209A399D7060EB5C592C672B5567F86,12921,0,6,6,9,41,491
6371,6371,F209A399D7060EB5C592C672B5567F86,12641,8,10,2,10,43,543
6372,6372,F209A399D7060EB5C592C672B5567F86,12921,13,15,2,9,41,491
6373,6373,F209A399D7060EB5C592C672B5567F86,19901,15,17,2,7,44,394
6374,6374,F209A399D7060EB5C592C672B5567F86,19021,21,22,1,10,45,545
6375,6375,990F89A555478F97C2E0E123BB133187,49201,0,2,2,7,41,391
6376,6376,990F89A555478F97C2E0E123BB133187,19031,4,5,1,1,42,92
6377,6377,990F89A555478F97C2E0E123BB133187,19181,10,21,11,8,40,440
6378,6378,4F1CE0C1A5E6BF21E963500414770875,40123,0,7,7,38,47,1947
6379,6379,4F1CE0C1A5E6BF21E963500414770875,42871,8,10,2,30,45,1545
6380,6380,4F1CE0C1A5E6BF21E963500414770875,13681,10,13,3,38,47,1947
6381,6381,4F1CE0C1A5E6BF21E963500414770875,10271,15,17,2,37,46,1896
6382,6382,4F1CE0C1A5E6BF21E963500414770875,42581,18,20,2,38,48,1948
6387,6387,71AB304A084EB4095E1F705C48CB0E23,11901,0,7,7,42,49,2149
6388,6388,71AB304A084EB4095E1F705C48CB0E23,11914,7,18,11,37,48,1898
6389,6389,71AB304A084EB4095E1F705C48CB0E23,11901,19,23,4,42,49,2149
6390,6390,5B38B567B1C7BA8CD66BEFDF9C575D7A,11231,2,13,11,37,49,1899
6391,6391,5B38B567B1C7BA8CD66BEFDF9C575D7A,10681,16,20,4,30,48,1548
6392,6392,5B38B567B1C7BA8CD66BEFDF9C575D7A,11231,20,23,3,37,49,1899
6396,6396,8420BC80E057341A3D646D0572754A34,12641,0,7,7,10,43,543
6397,6397,8420BC80E057341A3D646D0572754A34,12921,11,13,2,9,41,491
6398,6398,8420BC80E057341A3D646D0572754A34,12641,13,15,2,10,43,543
6399,6399,8420BC80E057341A3D646D0572754A34,12921,15,21,6,9,41,491
6400,6400,8420BC80E057341A3D646D0572754A34,19741,22,23,1,5,44,294
6404,6404,D899725588B270E131E7E8D09EC7B782,13121,0,2,2,38,46,1946
6405,6405,D899725588B270E131E7E8D09EC7B782,11941,2,4,2,37,46,1896
6406,6406,D899725588B270E131E7E8D09EC7B782,13121,5,6,1,38,46,1946
6407,6407,D899725588B270E131E7E8D09EC7B782,11941,9,11,2,37,46,1896
6408,6408,D899725588B270E131E7E8D09EC7B782,10381,16,17,1,31,49,1599
6409,6409,D899725588B270E131E7E8D09EC7B782,13711,21,23,2,38,46,1946
6410,6410,37D12B9A785069D9567B986D8917ECC5,11381,9,10,1,30,47,1547
6411,6411,37D12B9A785069D9567B986D8917ECC5,10351,12,16,4,28,45,1445
6412,6412,37D12B9A785069D9567B986D8917ECC5,10634,18,19,1,27,45,1395
6413,6413,23179CE474279BF26E56795AAD67CA26,12792,0,1,1,34,30,1730
6414,6414,23179CE474279BF26E56795AAD67CA26,15391,3,7,4,35,26,1776
6415,6415,23179CE474279BF26E56795AAD67CA26,12792,7,15,8,34,30,1730
6416,6416,23179CE474279BF26E56795AAD67CA26,15391,18,21,3,35,26,1776
6417,6417,E46B106D8E00D97389A785DC633B97D5,10841,0,2,2,37,47,1897
6418,6418,E46B106D8E00D97389A785DC633B97D5,11791,9,14,5,38,49,1949
6419,6419,E46B106D8E00D97389A785DC633B97D5,40094,18,21,3,29,48,1498
6420,6420,8D919DAD3A397736A2CF7D13317D0776,10621,0,6,6,41,49,2099
6421,6421,8D919DAD3A397736A2CF7D13317D0776,11261,7,8,1,36,46,1846
6422,6422,8D919DAD3A397736A2CF7D13317D0776,12491,9,15,6,36,43,1843
6423,6423,8D919DAD3A397736A2CF7D13317D0776,10621,18,23,5,41,49,2099
6436,6436,D1D5D5D0BF0B42619E7CE422BF2FC9C5,10381,0,4,4,31,49,1599
6437,6437,D1D5D5D0BF0B42619E7CE422BF2FC9C5,42081,4,6,2,24,49,1249
6438,6438,D1D5D5D0BF0B42619E7CE422BF2FC9C5,13561,10,15,5,37,49,1899
6439,6439,D1D5D5D0BF0B42619E7CE422BF2FC9C5,42221,16,17,1,38,48,1948
6440,6440,D1D5D5D0BF0B42619E7CE422BF2FC9C5,43481,17,18,1,39,48,1998
6441,6441,D1D5D5D0BF0B42619E7CE422BF2FC9C5,11074,19,20,1,37,47,1897
6449,6449,C493E8EAD829832CA31397E82BE4990B,43021,0,3,3,16,43,843
6450,6450,C493E8EAD829832CA31397E82BE4990B,12641,7,8,1,10,43,543
6451,6451,C493E8EAD829832CA31397E82BE4990B,12921,8,9,1,9,41,491
6452,6452,C493E8EAD829832CA31397E82BE4990B,43021,11,12,1,16,43,843
6453,6453,C493E8EAD829832CA31397E82BE4990B,12641,13,17,4,10,43,543
6454,6454,C493E8EAD829832CA31397E82BE4990B,43021,19,22,3,16,43,843
6455,6455,981FF39DB0050476FC5E5BA7D49F90F5,42861,0,2,2,37,44,1894
6456,6456,981FF39DB0050476FC5E5BA7D49F90F5,42864,2,7,5,38,44,1944
6457,6457,981FF39DB0050476FC5E5BA7D49F90F5,11261,9,15,6,36,46,1846
6458,6458,981FF39DB0050476FC5E5BA7D49F90F5,42864,16,17,1,38,44,1944
6459,6459,981FF39DB0050476FC5E5BA7D49F90F5,11261,17,19,2,36,46,1846
6460,6460,981FF39DB0050476FC5E5BA7D49F90F5,42864,20,23,3,38,44,1944
6464,6464,5E22906ABD87316CCD758EB08D18DF85,13351,1,6,5,48,48,2448
6465,6465,5E22906ABD87316CCD758EB08D18DF85,41393,7,15,8,43,49,2199
6466,6466,5E22906ABD87316CCD758EB08D18DF85,13351,18,23,5,48,48,2448
6467,6467,DC108CA51A8D783261AB9156C36F59F1,10351,3,7,4,28,45,1445
6468,6468,DC108CA51A8D783261AB9156C36F59F1,10634,11,12,1,27,45,1395
6469,6469,DC108CA51A8D783261AB9156C36F59F1,12601,16,19,3,25,47,1297
6470,6470,BF7FFA6FFA5EC12886C40D23DEBE66EE,13221,9,10,1,40,47,2047
6471,6471,BF7FFA6FFA5EC12886C40D23DEBE66EE,40341,13,17,4,23,49,1199
6472,6472,BF7FFA6FFA5EC12886C40D23DEBE66EE,13221,18,21,3,40,47,2047
6473,6473,F4A5CE128B0276BA64A57CF9F5D60F74,42831,0,13,13,27,48,1398
6474,6474,F4A5CE128B0276BA64A57CF9F5D60F74,10901,15,16,1,35,48,1798
6475,6475,F4A5CE128B0276BA64A57CF9F5D60F74,42831,17,23,6,27,48,1398
6479,6479,399CA2761360F63ACC0C500243EC6E08,11231,0,8,8,37,49,1899
6480,6480,399CA2761360F63ACC0C500243EC6E08,10381,10,12,2,31,49,1599
6481,6481,399CA2761360F63ACC0C500243EC6E08,11231,17,23,6,37,49,1899
6482,6482,AA5CCAB744F8E761C88177BD996FA26C,11074,0,10,10,37,47,1897
6483,6483,AA5CCAB744F8E761C88177BD996FA26C,42221,11,13,2,38,48,1948
6484,6484,AA5CCAB744F8E761C88177BD996FA26C,11074,13,16,3,37,47,1897
6485,6485,AA5CCAB744F8E761C88177BD996FA26C,12514,18,20,2,38,47,1947
6486,6486,AA5CCAB744F8E761C88177BD996FA26C,11074,20,22,2,37,47,1897
6491,6491,3D4FBC2518533BED6EC2BBDFA4619398,10531,0,6,6,34,46,1746
6492,6492,3D4FBC2518533BED6EC2BBDFA4619398,11491,6,9,3,36,47,1847
6493,6493,3D4FBC2518533BED6EC2BBDFA4619398,10531,10,11,1,34,46,1746
6494,6494,3D4FBC2518533BED6EC2BBDFA4619398,11381,13,22,9,30,47,1547
6498,6498,FC7F07CD1D5AF70821C22336FA7C594A,42541,8,14,6,25,47,1297
6499,6499,FC7F07CD1D5AF70821C22336FA7C594A,11211,16,17,1,34,49,1749
6500,6500,FC7F07CD1D5AF70821C22336FA7C594A,40341,19,21,2,23,49,1199
6501,6501,EF24F74DDF741D0DEC0CB3B2510AE4FC,10301,0,6,6,31,45,1595
6502,6502,EF24F74DDF741D0DEC0CB3B2510AE4FC,10351,6,7,1,28,45,1445
6503,6503,EF24F74DDF741D0DEC0CB3B2510AE4FC,10301,9,14,5,31,45,1595
6504,6504,EF24F74DDF741D0DEC0CB3B2510AE4FC,10351,15,16,1,28,45,1445
6505,6505,EF24F74DDF741D0DEC0CB3B2510AE4FC,10301,19,22,3,31,45,1595
6506,6506,BA285F01E6926591864F1F3184565800,11914,4,6,2,37,48,1898
6507,6507,BA285F01E6926591864F1F3184565800,42581,11,12,1,38,48,1948
6508,6508,BA285F01E6926591864F1F3184565800,40341,14,17,3,23,49,1199
6509,6509,BA285F01E6926591864F1F3184565800,42581,20,22,2,38,48,1948
6510,6510,9185912CB5BD8654E60A0E4E2DD43FA7,11001,0,8,8,42,47,2147
6511,6511,9185912CB5BD8654E60A0E4E2DD43FA7,13941,8,10,2,41,47,2097
6512,6512,9185912CB5BD8654E60A0E4E2DD43FA7,11001,10,15,5,42,47,2147
6513,6513,9185912CB5BD8654E60A0E4E2DD43FA7,13941,16,17,1,41,47,2097
6514,6514,9185912CB5BD8654E60A0E4E2DD43FA7,11001,18,19,1,42,47,2147
6519,6519,F1E9B03CDFE5AD7057DF68BB80A12EAC,15391,0,10,10,35,26,1776
6520,6520,F1E9B03CDFE5AD7057DF68BB80A12EAC,12792,14,15,1,34,30,1730
6521,6521,F1E9B03CDFE5AD7057DF68BB80A12EAC,15391,16,19,3,35,26,1776
6522,6522,F1E9B03CDFE5AD7057DF68BB80A12EAC,12792,20,21,1,34,30,1730
6523,6523,B671273BF5D0429E749B3B0F044C7639,43751,0,6,6,19,48,998
6524,6524,B671273BF5D0429E749B3B0F044C7639,10451,9,11,2,25,48,1298
6525,6525,B671273BF5D0429E749B3B0F044C7639,43751,11,23,12,19,48,998
6526,6526,43AA632E12ABCA3F01D2033AFFAEDEF3,10151,0,13,13,34,47,1747
6527,6527,43AA632E12ABCA3F01D2033AFFAEDEF3,19744,15,16,1,6,43,343
6528,6528,43AA632E12ABCA3F01D2033AFFAEDEF3,10151,17,23,6,34,47,1747
6529,6529,6B614428F8D95ECFDE2207017437E97D,19281,0,1,1,16,32,832
6530,6530,6B614428F8D95ECFDE2207017437E97D,12871,2,18,16,22,33,1133
6531,6531,6B614428F8D95ECFDE2207017437E97D,19281,21,23,2,16,32,832
6535,6535,153CE50D2F461F93D9D92EA917F9E163,11954,0,5,5,32,49,1649
6536,6536,153CE50D2F461F93D9D92EA917F9E163,42081,8,10,2,24,49,1249
6537,6537,153CE50D2F461F93D9D92EA917F9E163,42261,16,17,1,25,49,1299
6538,6538,153CE50D2F461F93D9D92EA917F9E163,11951,21,23,2,31,49,1599
6539,6539,F3045CC1C5922EA9E51F158FC63C4145,11941,0,7,7,37,46,1896
6540,6540,F3045CC1C5922EA9E51F158FC63C4145,12641,14,15,1,10,43,543
6541,6541,F3045CC1C5922EA9E51F158FC63C4145,40611,18,19,1,35,47,1797
6542,6542,F3045CC1C5922EA9E51F158FC63C4145,43281,20,23,3,37,48,1898
6554,6554,26BC902D12FC58394A8E0EC87BB357F4,10381,0,2,2,31,49,1599
6555,6555,26BC902D12FC58394A8E0EC87BB357F4,42501,5,6,1,28,47,1447
6556,6556,26BC902D12FC58394A8E0EC87BB357F4,13671,8,18,10,27,43,1393
6557,6557,26BC902D12FC58394A8E0EC87BB357F4,12121,21,23,2,29,47,1497
6558,6558,ABCCD88A0E489E701C66A4C8C3515246,11911,0,8,8,37,48,1898
6559,6559,ABCCD88A0E489E701C66A4C8C3515246,19114,12,13,1,7,43,393
6560,6560,ABCCD88A0E489E701C66A4C8C3515246,10491,17,23,6,33,48,1698
6565,6565,A74E23E4DF377EEA47D2C5660C581B28,42681,0,7,7,24,48,1248
6566,6566,A74E23E4DF377EEA47D2C5660C581B28,40343,10,11,1,24,49,1249
6567,6567,A74E23E4DF377EEA47D2C5660C581B28,42681,14,15,1,24,48,1248
6568,6568,A74E23E4DF377EEA47D2C5660C581B28,11211,19,20,1,34,49,1749
6569,6569,2772001BC3F7379DE82D552064F2ABBB,12871,10,11,1,22,33,1133
6570,6570,2772001BC3F7379DE82D552064F2ABBB,12874,14,18,4,20,34,1034
6571,6571,2772001BC3F7379DE82D552064F2ABBB,19281,22,23,1,16,32,832
6576,6576,1A91AEEE90C2E9E272AA316893DAE839,43751,0,11,11,19,48,998
6577,6577,1A91AEEE90C2E9E272AA316893DAE839,11061,12,14,2,29,48,1498
6578,6578,1A91AEEE90C2E9E272AA316893DAE839,13091,15,17,2,20,42,1042
6579,6579,1A91AEEE90C2E9E272AA316893DAE839,10951,18,19,1,29,48,1498
6580,6580,1A91AEEE90C2E9E272AA316893DAE839,43751,21,23,2,19,48,998
6581,6581,8671664FCEA72D44791A077CF27C82B3,12921,1,2,1,9,41,491
6582,6582,8671664FCEA72D44791A077CF27C82B3,12641,7,12,5,10,43,543
6583,6583,8671664FCEA72D44791A077CF27C82B3,12921,13,14,1,9,41,491
6584,6584,8671664FCEA72D44791A077CF27C82B3,12641,16,17,1,10,43,543
6585,6585,8671664FCEA72D44791A077CF27C82B3,12921,20,21,1,9,41,491
6586,6586,9B8E3A84EF821A3E9564A6D6EAEA0FE5,10471,6,7,1,37,48,1898
6587,6587,9B8E3A84EF821A3E9564A6D6EAEA0FE5,40171,8,10,2,38,48,1948
6588,6588,9B8E3A84EF821A3E9564A6D6EAEA0FE5,11914,10,11,1,37,48,1898
6589,6589,9B8E3A84EF821A3E9564A6D6EAEA0FE5,40171,16,20,4,38,48,1948
6590,6590,9B8E3A84EF821A3E9564A6D6EAEA0FE5,11914,21,22,1,37,48,1898
6591,6591,400659CE2E6F8BFF6D95D6F52F73DF5B,42921,0,5,5,33,47,1697
6592,6592,400659CE2E6F8BFF6D95D6F52F73DF5B,11861,5,11,6,32,47,1647
6593,6593,400659CE2E6F8BFF6D95D6F52F73DF5B,42921,11,13,2,33,47,1697
6594,6594,400659CE2E6F8BFF6D95D6F52F73DF5B,11861,15,16,1,32,47,1647
6595,6595,400659CE2E6F8BFF6D95D6F52F73DF5B,42921,18,23,5,33,47,1697
6600,6600,15137702EE1A04125F31B316CD83322E,11231,0,1,1,37,49,1899
6601,6601,15137702EE1A04125F31B316CD83322E,43761,2,4,2,32,47,1647
6602,6602,15137702EE1A04125F31B316CD83322E,42523,4,8,4,31,47,1597
6603,6603,15137702EE1A04125F31B316CD83322E,40341,15,18,3,23,49,1199
6604,6604,EB3039C415C508F2A2DCF6403E75C42C,43021,0,4,4,16,43,843
6605,6605,EB3039C415C508F2A2DCF6403E75C42C,12921,5,7,2,9,41,491
6606,6606,EB3039C415C508F2A2DCF6403E75C42C,12641,9,11,2,10,43,543
6607,6607,EB3039C415C508F2A2DCF6403E75C42C,12921,13,23,10,9,41,491
6608,6608,9C211F2E07C17475B7D2343E9DD9ED0D,10721,0,9,9,31,48,1598
6609,6609,9C211F2E07C17475B7D2343E9DD9ED0D,10301,10,15,5,31,45,1595
6610,6610,9C211F2E07C17475B7D2343E9DD9ED0D,11021,17,20,3,36,49,1849
6611,6611,9C211F2E07C17475B7D2343E9DD9ED0D,12381,21,22,1,32,48,1648
6612,6612,D8B7EC7024B24F78AC319A0324ED51C1,11631,6,7,1,12,49,649
6613,6613,D8B7EC7024B24F78AC319A0324ED51C1,42381,10,11,1,39,41,1991
6614,6614,D8B7EC7024B24F78AC319A0324ED51C1,40341,16,18,2,23,49,1199
6615,6615,D8B7EC7024B24F78AC319A0324ED51C1,42351,20,22,2,38,45,1945
6616,6616,2D3B83C92B0AAE4695063FEE06A33C52,13371,0,9,9,41,47,2097
6617,6617,2D3B83C92B0AAE4695063FEE06A33C52,42381,12,13,1,39,41,1991
6618,6618,2D3B83C92B0AAE4695063FEE06A33C52,13371,14,23,9,41,47,2097
6634,6634,7BD5666208D4C4EF90CAAD8A97E6ED7C,12491,0,6,6,36,43,1843
6635,6635,7BD5666208D4C4EF90CAAD8A97E6ED7C,13671,8,17,9,27,43,1393
6636,6636,7BD5666208D4C4EF90CAAD8A97E6ED7C,42151,20,22,2,35,45,1795
6637,6637,EF7A20DA8B1B5B9AEB04342FCDE03590,42271,0,9,9,40,47,2047
6638,6638,EF7A20DA8B1B5B9AEB04342FCDE03590,11631,10,15,5,12,49,649
6639,6639,EF7A20DA8B1B5B9AEB04342FCDE03590,42271,17,23,6,40,47,2047
6640,6640,4FB7544A1E67AE742452DB3735E5F7CF,12561,7,8,1,45,43,2293
6641,6641,4FB7544A1E67AE742452DB3735E5F7CF,42631,8,10,2,43,45,2195
6642,6642,4FB7544A1E67AE742452DB3735E5F7CF,12561,10,17,7,45,43,2293
6643,6643,4FB7544A1E67AE742452DB3735E5F7CF,10771,19,20,1,41,46,2096
6644,6644,4FB7544A1E67AE742452DB3735E5F7CF,11001,21,23,2,42,47,2147
6645,6645,2FA830A3F4936C72A1774CB1227927A5,42161,0,7,7,36,47,1847
6646,6646,2FA830A3F4936C72A1774CB1227927A5,10421,8,17,9,41,48,2098
6647,6647,2FA830A3F4936C72A1774CB1227927A5,42161,18,23,5,36,47,1847
6652,6652,CA5A17D561EB9E25269F629C4481540B,19441,0,5,5,8,46,446
6653,6653,CA5A17D561EB9E25269F629C4481540B,11571,6,8,2,13,46,696
6654,6654,CA5A17D561EB9E25269F629C4481540B,19441,12,23,11,8,46,446
6655,6655,F1D52E271AD2CA60B9DB39C5E4BE77A4,19021,0,5,5,10,45,545
6656,6656,F1D52E271AD2CA60B9DB39C5E4BE77A4,12641,9,10,1,10,43,543
6657,6657,F1D52E271AD2CA60B9DB39C5E4BE77A4,12921,10,12,2,9,41,491
6658,6658,F1D52E271AD2CA60B9DB39C5E4BE77A4,12641,15,16,1,10,43,543
6659,6659,F1D52E271AD2CA60B9DB39C5E4BE77A4,19021,21,23,2,10,45,545
6664,6664,E9A6854809AA21C1B70C29D20C0730F1,42583,0,5,5,40,48,2048
6665,6665,E9A6854809AA21C1B70C29D20C0730F1,42271,7,8,1,40,47,2047
6666,6666,E9A6854809AA21C1B70C29D20C0730F1,42581,8,9,1,38,48,1948
6667,6667,E9A6854809AA21C1B70C29D20C0730F1,42271,13,18,5,40,47,2047
6668,6668,E9A6854809AA21C1B70C29D20C0730F1,42583,18,22,4,40,48,2048
6677,6677,11FECEE7865049CDA55CAB34FACD3089,42871,0,1,1,30,45,1545
6678,6678,11FECEE7865049CDA55CAB34FACD3089,12311,3,5,2,30,44,1544
6679,6679,11FECEE7865049CDA55CAB34FACD3089,11871,9,11,2,29,46,1496
6680,6680,11FECEE7865049CDA55CAB34FACD3089,11875,13,14,1,30,46,1546
6681,6681,11FECEE7865049CDA55CAB34FACD3089,11151,15,17,2,30,48,1548
6682,6682,11FECEE7865049CDA55CAB34FACD3089,11875,18,19,1,30,46,1546
6686,6686,F8320AC02FAC6F4A311CBF8892D02227,13251,0,1,1,48,28,2428
6687,6687,F8320AC02FAC6F4A311CBF8892D02227,15411,2,4,2,44,27,2227
6688,6688,F8320AC02FAC6F4A311CBF8892D02227,13251,4,10,6,48,28,2428
6689,6689,F8320AC02FAC6F4A311CBF8892D02227,15411,10,15,5,44,27,2227
6690,6690,F8320AC02FAC6F4A311CBF8892D02227,13251,16,19,3,48,28,2428
6691,6691,F8320AC02FAC6F4A311CBF8892D02227,15411,20,21,1,44,27,2227
6695,6695,66335493F54DE3C63DCFDD3799CFFE2F,12771,0,8,8,20,46,1046
6696,6696,66335493F54DE3C63DCFDD3799CFFE2F,13771,10,12,2,21,45,1095
6697,6697,66335493F54DE3C63DCFDD3799CFFE2F,10351,14,17,3,28,45,1445
6698,6698,66335493F54DE3C63DCFDD3799CFFE2F,10061,18,19,1,20,46,1046
6699,6699,0DFEDC78D60F5843A6BF5E676B2D7913,11001,0,14,14,42,47,2147
6700,6700,0DFEDC78D60F5843A6BF5E676B2D7913,40341,15,19,4,23,49,1199
6701,6701,0DFEDC78D60F5843A6BF5E676B2D7913,11001,20,23,3,42,47,2147
6702,6702,6CE752B65E9105FE0CE9B700B2FBE03D,13121,1,8,7,38,46,1946
6703,6703,6CE752B65E9105FE0CE9B700B2FBE03D,12511,17,19,2,39,47,1997
6704,6704,6CE752B65E9105FE0CE9B700B2FBE03D,11661,20,21,1,40,49,2049
6705,6705,DC9866094212A637CCAC17CF01FE4B5F,42861,0,5,5,37,44,1894
6706,6706,DC9866094212A637CCAC17CF01FE4B5F,11261,7,11,4,36,46,1846
6707,6707,DC9866094212A637CCAC17CF01FE4B5F,42861,11,12,1,37,44,1894
6708,6708,DC9866094212A637CCAC17CF01FE4B5F,11261,13,17,4,36,46,1846
6709,6709,DC9866094212A637CCAC17CF01FE4B5F,42861,18,23,5,37,44,1894
6710,6710,F7BC8ED51AD7582E547FDB1B901EE928,11061,0,8,8,29,48,1498
6711,6711,F7BC8ED51AD7582E547FDB1B901EE928,10681,9,10,1,30,48,1548
6712,6712,F7BC8ED51AD7582E547FDB1B901EE928,13511,13,22,9,34,48,1748
6732,6732,7C98BDF484E2B085C51A4945E804FC0C,13671,2,6,4,27,43,1393
6733,6733,7C98BDF484E2B085C51A4945E804FC0C,42151,6,11,5,35,45,1795
6734,6734,7C98BDF484E2B085C51A4945E804FC0C,12311,13,15,2,30,44,1544
6735,6735,7C98BDF484E2B085C51A4945E804FC0C,42151,17,22,5,35,45,1795
6739,6739,ED36A592544F9D3B4DC283835B5C723A,11481,9,13,4,41,48,2098
6740,6740,ED36A592544F9D3B4DC283835B5C723A,42271,14,16,2,40,47,2047
6741,6741,ED36A592544F9D3B4DC283835B5C723A,11481,17,18,1,41,48,2098
6742,6742,ED36A592544F9D3B4DC283835B5C723A,42271,19,20,1,40,47,2047
6743,6743,ED36A592544F9D3B4DC283835B5C723A,40833,20,21,1,41,47,2097
6748,6748,C96AF7724AE07D1D1BE56C246C9FE7FC,13341,0,13,13,44,45,2245
6749,6749,C96AF7724AE07D1D1BE56C246C9FE7FC,42631,16,17,1,43,45,2195
6750,6750,C96AF7724AE07D1D1BE56C246C9FE7FC,13341,18,19,1,44,45,2245
6751,6751,C96AF7724AE07D1D1BE56C246C9FE7FC,40691,20,21,1,42,48,2148
6756,6756,F9B50F8C0BC548F341BD45D3142A9731,43671,0,15,15,35,48,1798
6757,6757,F9B50F8C0BC548F341BD45D3142A9731,13101,18,19,1,40,47,2047
6758,6758,F9B50F8C0BC548F341BD45D3142A9731,11751,19,23,4,35,48,1798
6759,6759,5E9662A656E5A4C6BC4104240F4E1743,13791,0,7,7,42,47,2147
6760,6760,5E9662A656E5A4C6BC4104240F4E1743,42461,10,11,1,45,47,2297
6761,6761,5E9662A656E5A4C6BC4104240F4E1743,13791,11,15,4,42,47,2147
6762,6762,5E9662A656E5A4C6BC4104240F4E1743,43061,15,17,2,43,46,2196
6763,6763,5E9662A656E5A4C6BC4104240F4E1743,13791,17,20,3,42,47,2147
6770,6770,525655B30753832E11A6455806FEB5D9,40094,0,7,7,29,48,1498
6771,6771,525655B30753832E11A6455806FEB5D9,13711,8,9,1,38,46,1946
6772,6772,525655B30753832E11A6455806FEB5D9,40094,11,12,1,29,48,1498
6773,6773,525655B30753832E11A6455806FEB5D9,41591,12,14,2,34,49,1749
6774,6774,525655B30753832E11A6455806FEB5D9,40094,15,23,8,29,48,1498
6782,6782,92E1BAA88B052422B820ED36A9E8F107,41392,0,6,6,43,48,2198
6783,6783,92E1BAA88B052422B820ED36A9E8F107,40171,6,8,2,38,48,1948
6784,6784,92E1BAA88B052422B820ED36A9E8F107,41392,11,14,3,43,48,2198
6785,6785,92E1BAA88B052422B820ED36A9E8F107,40171,14,16,2,38,48,1948
6786,6786,92E1BAA88B052422B820ED36A9E8F107,11271,17,18,1,37,48,1898
6787,6787,92E1BAA88B052422B820ED36A9E8F107,41392,19,23,4,43,48,2198
6791,6791,B293D0904747D1E5B83274515439040B,11781,0,1,1,38,49,1949
6792,6792,B293D0904747D1E5B83274515439040B,11021,2,9,7,36,49,1849
6793,6793,B293D0904747D1E5B83274515439040B,13671,12,13,1,27,43,1393
6794,6794,B293D0904747D1E5B83274515439040B,13481,15,17,2,26,31,1331
6795,6795,B293D0904747D1E5B83274515439040B,11021,21,23,2,36,49,1849
6800,6800,7F2BAF1424E1429CBB713DDAAB1EA670,11261,0,10,10,36,46,1846
6801,6801,7F2BAF1424E1429CBB713DDAAB1EA670,12661,13,15,2,32,45,1645
6802,6802,7F2BAF1424E1429CBB713DDAAB1EA670,12731,16,18,2,22,40,1140
6803,6803,7F2BAF1424E1429CBB713DDAAB1EA670,12661,21,22,1,32,45,1645
6804,6804,F06696253146EEBB7842F43A19CD992F,19801,0,3,3,19,26,976
6805,6805,F06696253146EEBB7842F43A19CD992F,12871,3,5,2,22,33,1133
6806,6806,F06696253146EEBB7842F43A19CD992F,19801,6,17,11,19,26,976
6807,6807,F06696253146EEBB7842F43A19CD992F,12871,18,20,2,22,33,1133
6811,6811,7D165D6EF5EE6D7A94F3B95841A45261,42071,1,2,1,31,49,1599
6812,6812,7D165D6EF5EE6D7A94F3B95841A45261,42081,3,5,2,24,49,1249
6813,6813,7D165D6EF5EE6D7A94F3B95841A45261,10381,6,23,17,31,49,1599
6825,6825,9FE70E4B6B2CB4BF68BC98D789DF7939,43311,0,9,9,31,48,1598
6826,6826,9FE70E4B6B2CB4BF68BC98D789DF7939,11201,12,16,4,35,49,1799
6827,6827,9FE70E4B6B2CB4BF68BC98D789DF7939,11531,17,18,1,34,49,1749
6828,6828,9FE70E4B6B2CB4BF68BC98D789DF7939,12381,19,22,3,32,48,1648
6832,6832,3F29D0D409D1B6D4E7D2087740FD0BBC,10251,0,8,8,35,47,1797
6833,6833,3F29D0D409D1B6D4E7D2087740FD0BBC,42161,9,10,1,36,47,1847
6834,6834,3F29D0D409D1B6D4E7D2087740FD0BBC,10251,10,20,10,35,47,1797
6835,6835,3F29D0D409D1B6D4E7D2087740FD0BBC,40697,21,22,1,43,48,2198
6836,6836,23380E5607B1F49422924115A0CC13E5,40343,0,8,8,24,49,1249
6837,6837,23380E5607B1F49422924115A0CC13E5,11781,11,13,2,38,49,1949
6838,6838,23380E5607B1F49422924115A0CC13E5,40073,14,15,1,37,48,1898
6839,6839,23380E5607B1F49422924115A0CC13E5,40343,16,20,4,24,49,1249
6843,6843,392F2B932A839BB0C6F602E5FA556570,11074,0,5,5,37,47,1897
6844,6844,392F2B932A839BB0C6F602E5FA556570,15331,7,8,1,38,24,1924
6845,6845,392F2B932A839BB0C6F602E5FA556570,10601,10,12,2,39,47,1997
6846,6846,392F2B932A839BB0C6F602E5FA556570,11074,12,23,11,37,47,1897
6847,6847,FD112B5156FECF6460254CADD94A5EF4,12641,0,9,9,10,43,543
6848,6848,FD112B5156FECF6460254CADD94A5EF4,19031,11,13,2,1,42,92
6849,6849,FD112B5156FECF6460254CADD94A5EF4,12641,13,23,10,10,43,543
6854,6854,562E96819CF0FFCBA08A0756D64971B1,13271,0,8,8,41,47,2097
6855,6855,562E96819CF0FFCBA08A0756D64971B1,11151,13,18,5,30,48,1548
6856,6856,562E96819CF0FFCBA08A0756D64971B1,11801,22,23,1,42,48,2148
6857,6857,79B5754532E0B50E66F26F447FE8D896,13371,0,9,9,41,47,2097
6858,6858,79B5754532E0B50E66F26F447FE8D896,42381,12,13,1,39,41,1991
6859,6859,79B5754532E0B50E66F26F447FE8D896,13371,14,23,9,41,47,2097
6860,6860,2F66AC01887397A198C9CCA6611EA97B,12521,0,15,15,35,41,1791
6861,6861,2F66AC01887397A198C9CCA6611EA97B,13314,16,17,1,31,39,1589
6862,6862,2F66AC01887397A198C9CCA6611EA97B,12521,18,23,5,35,41,1791
6866,6866,9C686B624E1F19B96755FA9920EEF4B6,42921,0,8,8,33,47,1697
6867,6867,9C686B624E1F19B96755FA9920EEF4B6,13791,13,17,4,42,47,2147
6868,6868,9C686B624E1F19B96755FA9920EEF4B6,42021,20,22,2,33,47,1697
6875,6875,FA1C47B30A6719710DE91AE83F7A3A28,19114,0,12,12,7,43,393
6876,6876,FA1C47B30A6719710DE91AE83F7A3A28,43581,14,15,1,33,48,1698
6877,6877,FA1C47B30A6719710DE91AE83F7A3A28,19744,19,21,2,6,43,343
6878,6878,9BBBC00C93BA6A3176E2B008E6F8A88E,12211,2,5,3,41,44,2094
6879,6879,9BBBC00C93BA6A3176E2B008E6F8A88E,11261,5,11,6,36,46,1846
6880,6880,9BBBC00C93BA6A3176E2B008E6F8A88E,13911,11,13,2,39,46,1996
6881,6881,9BBBC00C93BA6A3176E2B008E6F8A88E,11261,14,23,9,36,46,1846
6892,6892,A1B1493AD1E4959D25E397CB780FB65E,42531,0,7,7,31,45,1595
6893,6893,A1B1493AD1E4959D25E397CB780FB65E,12311,9,10,1,30,44,1544
6894,6894,A1B1493AD1E4959D25E397CB780FB65E,42531,11,14,3,31,45,1595
6895,6895,A1B1493AD1E4959D25E397CB780FB65E,12311,17,18,1,30,44,1544
6896,6896,A1B1493AD1E4959D25E397CB780FB65E,42871,19,23,4,30,45,1545
6901,6901,A02F58F4D887D8C7AFCC5C3BF1733917,11461,0,9,9,37,49,1899
6902,6902,A02F58F4D887D8C7AFCC5C3BF1733917,13481,11,12,1,26,31,1331
6903,6903,A02F58F4D887D8C7AFCC5C3BF1733917,11461,14,17,3,37,49,1899
6904,6904,A02F58F4D887D8C7AFCC5C3BF1733917,40341,19,21,2,23,49,1199
6908,6908,296E7B917A1C9BBE703645D1D7E31230,10661,1,8,7,37,49,1899
6909,6909,296E7B917A1C9BBE703645D1D7E31230,10901,9,13,4,35,48,1798
6910,6910,296E7B917A1C9BBE703645D1D7E31230,10661,14,16,2,37,49,1899
6911,6911,296E7B917A1C9BBE703645D1D7E31230,10901,17,21,4,35,48,1798
6912,6912,296E7B917A1C9BBE703645D1D7E31230,10661,22,23,1,37,49,1899
6913,6913,C17757E967F389816ECAA205070C814B,42831,0,7,7,27,48,1398
6914,6914,C17757E967F389816ECAA205070C814B,42351,11,12,1,38,45,1945
6915,6915,C17757E967F389816ECAA205070C814B,15661,12,23,11,36,26,1826
6916,6916,68D66AC2F31097852E1113FCAC38B096,12311,0,2,2,30,44,1544
6917,6917,68D66AC2F31097852E1113FCAC38B096,12121,5,6,1,29,47,1497
6918,6918,68D66AC2F31097852E1113FCAC38B096,42531,7,8,1,31,45,1595
6919,6919,68D66AC2F31097852E1113FCAC38B096,12311,9,16,7,30,44,1544
6920,6920,68D66AC2F31097852E1113FCAC38B096,42531,16,21,5,31,45,1595
6921,6921,04D73C3CD00D40CB611F6BA5801F802C,13314,0,7,7,31,39,1589
6922,6922,04D73C3CD00D40CB611F6BA5801F802C,12521,8,10,2,35,41,1791
6923,6923,04D73C3CD00D40CB611F6BA5801F802C,13314,12,23,11,31,39,1589
6924,6924,FF16D1104349162E539969031BE39A02,12511,2,6,4,39,47,1997
6925,6925,FF16D1104349162E539969031BE39A02,12514,6,7,1,38,47,1947
6926,6926,FF16D1104349162E539969031BE39A02,12511,8,12,4,39,47,1997
6927,6927,FF16D1104349162E539969031BE39A02,43481,14,15,1,39,48,1998
6928,6928,FF16D1104349162E539969031BE39A02,12511,16,20,4,39,47,1997
6929,6929,0A3915084FB03CADF4F6A03BF3CFEF49,10661,10,14,4,37,49,1899
6930,6930,0A3915084FB03CADF4F6A03BF3CFEF49,40341,15,17,2,23,49,1199
6931,6931,0A3915084FB03CADF4F6A03BF3CFEF49,10661,17,23,6,37,49,1899
6936,6936,0F2E7737761FB5772278335D9DA9FBBB,15321,0,5,5,29,26,1476
6937,6937,0F2E7737761FB5772278335D9DA9FBBB,15091,7,17,10,35,26,1776
6938,6938,0F2E7737761FB5772278335D9DA9FBBB,43121,17,19,2,25,27,1277
6939,6939,0F2E7737761FB5772278335D9DA9FBBB,15321,22,23,1,29,26,1476
6940,6940,72F3812C7BC5DA0C0A9601C157EE83E7,11541,0,8,8,35,49,1799
6941,6941,72F3812C7BC5DA0C0A9601C157EE83E7,11875,10,13,3,30,46,1546
6942,6942,72F3812C7BC5DA0C0A9601C157EE83E7,42161,18,20,2,36,47,1847
6943,6943,72F3812C7BC5DA0C0A9601C157EE83E7,11875,21,22,1,30,46,1546
6947,6947,BE35BD29F0A392EE036220327B804613,11701,0,6,6,43,48,2198
6948,6948,BE35BD29F0A392EE036220327B804613,10251,8,18,10,35,47,1797
6949,6949,BE35BD29F0A392EE036220327B804613,11701,20,23,3,43,48,2198
6950,6950,68A1105E45875228253ACCFACF581238,15143,0,16,16,18,7,907
6951,6951,68A1105E45875228253ACCFACF581238,16281,16,17,1,11,4,554
6952,6952,68A1105E45875228253ACCFACF581238,15143,17,23,6,18,7,907
6957,6957,87F6D9996659541EF975AE3E55004A94,10221,0,3,3,34,49,1749
6958,6958,87F6D9996659541EF975AE3E55004A94,11301,7,14,7,41,49,2099
6959,6959,87F6D9996659541EF975AE3E55004A94,13731,18,20,2,33,49,1699
6966,6966,85CC46EAA805F4481ACB92E952F93867,42523,2,5,3,31,47,1597
6967,6967,85CC46EAA805F4481ACB92E952F93867,10401,9,11,2,33,49,1699
6968,6968,85CC46EAA805F4481ACB92E952F93867,43761,12,14,2,32,47,1647
6969,6969,85CC46EAA805F4481ACB92E952F93867,11161,15,16,1,32,48,1648
6970,6970,85CC46EAA805F4481ACB92E952F93867,11731,19,20,1,36,48,1848
6971,6971,F974829D990BC301C23E1088CA3B893A,42151,2,5,3,35,45,1795
6972,6972,F974829D990BC301C23E1088CA3B893A,10351,6,7,1,28,45,1445
6973,6973,F974829D990BC301C23E1088CA3B893A,10634,8,21,13,27,45,1395
6974,6974,E09A2EB70E1320F8C58EBB2C4083C66B,13371,10,12,2,41,47,2097
6975,6975,E09A2EB70E1320F8C58EBB2C4083C66B,10381,13,17,4,31,49,1599
6976,6976,E09A2EB70E1320F8C58EBB2C4083C66B,40341,18,20,2,23,49,1199
6977,6977,E09A2EB70E1320F8C58EBB2C4083C66B,13941,22,23,1,41,47,2097
6978,6978,170A0AC014DC9BA930EAA0E56A2C9D03,42321,0,6,6,43,47,2197
6979,6979,170A0AC014DC9BA930EAA0E56A2C9D03,11001,7,8,1,42,47,2147
6980,6980,170A0AC014DC9BA930EAA0E56A2C9D03,11701,9,11,2,43,48,2198
6981,6981,170A0AC014DC9BA930EAA0E56A2C9D03,42461,13,19,6,45,47,2297
6982,6982,170A0AC014DC9BA930EAA0E56A2C9D03,42321,22,23,1,43,47,2197
6986,6986,F0D3FEBF4CC350A5851C8C36AA32D49C,11331,0,7,7,37,48,1898
6987,6987,F0D3FEBF4CC350A5851C8C36AA32D49C,42161,8,9,1,36,47,1847
6988,6988,F0D3FEBF4CC350A5851C8C36AA32D49C,11331,13,16,3,37,48,1898
6989,6989,F0D3FEBF4CC350A5851C8C36AA32D49C,42401,17,18,1,36,47,1847
6990,6990,F0D3FEBF4CC350A5851C8C36AA32D49C,11331,21,23,2,37,48,1898
6994,6994,23E7B51B197B2F53A6762756E4AC5287,11631,5,7,2,12,49,649
6995,6995,23E7B51B197B2F53A6762756E4AC5287,12083,7,16,9,36,49,1849
6996,6996,23E7B51B197B2F53A6762756E4AC5287,11231,17,23,6,37,49,1899
7000,7000,F2E0A788EC41736380A7AB3495E7AB34,42161,0,6,6,36,47,1847
7001,7001,F2E0A788EC41736380A7AB3495E7AB34,12051,7,15,8,20,47,1047
7002,7002,F2E0A788EC41736380A7AB3495E7AB34,42161,19,23,4,36,47,1847
7009,7009,94092014F9DD3213271810B8D19555BE,49201,0,5,5,7,41,391
7010,7010,94092014F9DD3213271810B8D19555BE,12641,8,10,2,10,43,543
7011,7011,94092014F9DD3213271810B8D19555BE,49201,11,13,2,7,41,391
7012,7012,94092014F9DD3213271810B8D19555BE,12921,13,18,5,9,41,491
7013,7013,94092014F9DD3213271810B8D19555BE,49201,21,22,1,7,41,391
7014,7014,7D8BB90B66B5BB302B836A7DB354A71B,11701,0,6,6,43,48,2198
7015,7015,7D8BB90B66B5BB302B836A7DB354A71B,42321,7,8,1,43,47,2197
7016,7016,7D8BB90B66B5BB302B836A7DB354A71B,42601,11,14,3,44,48,2248
7017,7017,7D8BB90B66B5BB302B836A7DB354A71B,42321,14,18,4,43,47,2197
7018,7018,7D8BB90B66B5BB302B836A7DB354A71B,11701,19,23,4,43,48,2198
7019,7019,E95FA2D5DAFD0A95F7957AB5724B1100,11061,0,1,1,29,48,1498
7020,7020,E95FA2D5DAFD0A95F7957AB5724B1100,10681,1,17,16,30,48,1548
7021,7021,E95FA2D5DAFD0A95F7957AB5724B1100,42261,20,21,1,25,49,1299
7025,7025,EEB3CBC85DF19031E292162C06516E43,11381,0,7,7,30,47,1547
7026,7026,EEB3CBC85DF19031E292162C06516E43,10471,7,12,5,37,48,1898
7027,7027,EEB3CBC85DF19031E292162C06516E43,11381,13,15,2,30,47,1547
7028,7028,EEB3CBC85DF19031E292162C06516E43,10471,16,21,5,37,48,1898
7032,7032,13E192A41573EE21B0A86028C0154874,42471,0,3,3,35,49,1799
7033,7033,13E192A41573EE21B0A86028C0154874,11531,8,16,8,34,49,1749
7034,7034,13E192A41573EE21B0A86028C0154874,43321,18,20,2,36,49,1849
7035,7035,13E192A41573EE21B0A86028C0154874,11531,20,21,1,34,49,1749
7036,7036,13E192A41573EE21B0A86028C0154874,11021,22,23,1,36,49,1849
7037,7037,DE5F96E34E99D2F6A2C0DEB645C43B1D,42581,0,6,6,38,48,1948
7038,7038,DE5F96E34E99D2F6A2C0DEB645C43B1D,11806,8,11,3,41,48,2098
7039,7039,DE5F96E34E99D2F6A2C0DEB645C43B1D,42221,12,13,1,38,48,1948
7040,7040,DE5F96E34E99D2F6A2C0DEB645C43B1D,42271,20,22,2,40,47,2047
7041,7041,DE5F96E34E99D2F6A2C0DEB645C43B1D,42221,22,23,1,38,48,1948
7045,7045,1DFC063262F02B96AF96AED120E22A58,40673,0,10,10,36,48,1848
7046,7046,1DFC063262F02B96AF96AED120E22A58,15044,13,14,1,40,8,2008
7047,7047,1DFC063262F02B96AF96AED120E22A58,42351,15,16,1,38,45,1945
7048,7048,1DFC063262F02B96AF96AED120E22A58,12083,18,20,2,36,49,1849
7049,7049,1DFC063262F02B96AF96AED120E22A58,10411,20,23,3,36,48,1848
7053,7053,CAF14FA74E880F943EA550A7A4DBB4F8,19031,0,11,11,1,42,92
7054,7054,CAF14FA74E880F943EA550A7A4DBB4F8,12641,11,14,3,10,43,543
7055,7055,CAF14FA74E880F943EA550A7A4DBB4F8,42161,16,23,7,36,47,1847
7059,7059,B2012EE6BD195EC80673B0F2B5EC1C5E,12921,0,8,8,9,41,491
7060,7060,B2012EE6BD195EC80673B0F2B5EC1C5E,19901,9,10,1,7,44,394
7061,7061,B2012EE6BD195EC80673B0F2B5EC1C5E,12641,11,15,4,10,43,543
7062,7062,B2012EE6BD195EC80673B0F2B5EC1C5E,12921,18,19,1,9,41,491
7063,7063,B2012EE6BD195EC80673B0F2B5EC1C5E,12641,21,22,1,10,43,543
7068,7068,84D6F944A9720742D92DF6BE4B5D36E6,43011,0,1,1,40,42,2042
7069,7069,84D6F944A9720742D92DF6BE4B5D36E6,12561,1,6,5,45,43,2293
7070,7070,84D6F944A9720742D92DF6BE4B5D36E6,12141,9,14,5,42,45,2145
7071,7071,84D6F944A9720742D92DF6BE4B5D36E6,12221,16,17,1,43,44,2194
7072,7072,84D6F944A9720742D92DF6BE4B5D36E6,12141,18,19,1,42,45,2145
7073,7073,2F1F755AD0C3D64033AC7CD812D0FE51,10421,0,7,7,41,48,2098
7074,7074,2F1F755AD0C3D64033AC7CD812D0FE51,40302,11,12,1,40,49,2049
7075,7075,2F1F755AD0C3D64033AC7CD812D0FE51,12651,14,15,1,43,47,2197
7076,7076,2F1F755AD0C3D64033AC7CD812D0FE51,43161,15,17,2,35,47,1797
7077,7077,2F1F755AD0C3D64033AC7CD812D0FE51,10421,19,23,4,41,48,2098
7082,7082,E3B088F7DEFCCE4BD4EB6ADB8F0E5950,12514,9,14,5,38,47,1947
7083,7083,E3B088F7DEFCCE4BD4EB6ADB8F0E5950,10841,18,20,2,37,47,1897
7084,7084,E3B088F7DEFCCE4BD4EB6ADB8F0E5950,41061,21,23,2,34,49,1749
7088,7088,6FE087EF982BDB2568A12CCC091731A0,13071,10,12,2,41,41,2091
7089,7089,6FE087EF982BDB2568A12CCC091731A0,43451,13,18,5,37,40,1890
7090,7090,6FE087EF982BDB2568A12CCC091731A0,13321,20,21,1,41,37,2087
7091,7091,6FE087EF982BDB2568A12CCC091731A0,43841,21,23,2,40,37,2037
7103,7103,4C580D78A88C28BCF4ADEB9168B64E1D,12491,0,2,2,36,43,1843
7104,7104,4C580D78A88C28BCF4ADEB9168B64E1D,43011,3,5,2,40,42,2042
7105,7105,4C580D78A88C28BCF4ADEB9168B64E1D,42861,7,19,12,37,44,1894
7106,7106,C1CF59B64EE7642E956AF0C2EBE03CC9,42921,0,9,9,33,47,1697
7107,7107,C1CF59B64EE7642E956AF0C2EBE03CC9,11351,13,14,1,36,48,1848
7108,7108,C1CF59B64EE7642E956AF0C2EBE03CC9,10121,16,17,1,36,49,1849
7109,7109,C1CF59B64EE7642E956AF0C2EBE03CC9,42931,20,22,2,41,49,2099
7113,7113,015977F21CA69DACA3E876A5F028B2A4,43051,0,5,5,46,45,2345
7114,7114,015977F21CA69DACA3E876A5F028B2A4,11701,7,8,1,43,48,2198
7115,7115,015977F21CA69DACA3E876A5F028B2A4,13351,8,12,4,48,48,2448
7116,7116,015977F21CA69DACA3E876A5F028B2A4,43051,12,14,2,46,45,2345
7117,7117,015977F21CA69DACA3E876A5F028B2A4,13351,15,20,5,48,48,2448
7118,7118,015977F21CA69DACA3E876A5F028B2A4,43051,21,22,1,46,45,2345
7119,7119,E572D34D15CCFF06895D9E2C410E6273,13671,0,15,15,27,43,1393
7120,7120,E572D34D15CCFF06895D9E2C410E6273,42371,19,20,1,34,46,1746
7121,7121,E572D34D15CCFF06895D9E2C410E6273,42151,21,22,1,35,45,1795
7125,7125,91A0161E6D61AFB62AB329EF29AE8AA8,11324,3,7,4,31,46,1596
7126,7126,91A0161E6D61AFB62AB329EF29AE8AA8,12601,11,12,1,25,47,1297
7127,7127,91A0161E6D61AFB62AB329EF29AE8AA8,13651,15,18,3,30,47,1547
7134,7134,9B3D4DB494E6B8E7329532A1BECC6FF1,12921,0,14,14,9,41,491
7135,7135,9B3D4DB494E6B8E7329532A1BECC6FF1,12641,14,15,1,10,43,543
7136,7136,9B3D4DB494E6B8E7329532A1BECC6FF1,12921,15,20,5,9,41,491
7137,7137,9B3D4DB494E6B8E7329532A1BECC6FF1,43021,22,23,1,16,43,843
7138,7138,43DBEEA61839592A95FC32BC8064AB85,12921,0,6,6,9,41,491
7139,7139,43DBEEA61839592A95FC32BC8064AB85,12641,7,9,2,10,43,543
7140,7140,43DBEEA61839592A95FC32BC8064AB85,12921,9,16,7,9,41,491
7141,7141,43DBEEA61839592A95FC32BC8064AB85,19114,19,20,1,7,43,393
7142,7142,43DBEEA61839592A95FC32BC8064AB85,12641,21,23,2,10,43,543
7149,7149,62F6BE848412C7FADEB816AFD62C431F,15121,5,7,2,27,19,1369
7150,7150,62F6BE848412C7FADEB816AFD62C431F,15141,7,8,1,26,11,1311
7151,7151,62F6BE848412C7FADEB816AFD62C431F,16151,8,21,13,13,11,661
7152,7152,62F6BE848412C7FADEB816AFD62C431F,15521,22,23,1,27,14,1364
7156,7156,7E3BBFD69E1A37298143A682DBBA8F14,10731,0,9,9,33,47,1697
7157,7157,7E3BBFD69E1A37298143A682DBBA8F14,42381,10,12,2,39,41,1991
7158,7158,7E3BBFD69E1A37298143A682DBBA8F14,10731,16,23,7,33,47,1697
7159,7159,18F85D1FF157146B3054BAA6982B6768,43061,0,14,14,43,46,2196
7160,7160,18F85D1FF157146B3054BAA6982B6768,10271,14,16,2,37,46,1896
7161,7161,18F85D1FF157146B3054BAA6982B6768,43061,21,22,1,43,46,2196
7162,7162,3582950BA90FF3FBFD95BD8C97C90A9C,10151,0,10,10,34,47,1747
7163,7163,3582950BA90FF3FBFD95BD8C97C90A9C,11201,10,12,2,35,49,1799
7164,7164,3582950BA90FF3FBFD95BD8C97C90A9C,10151,13,15,2,34,47,1747
7165,7165,3582950BA90FF3FBFD95BD8C97C90A9C,41591,16,18,2,34,49,1749
7166,7166,3582950BA90FF3FBFD95BD8C97C90A9C,10151,19,23,4,34,47,1747
7167,7167,FF3E223EC645685F23BE28ABAEB636E3,12391,0,11,11,36,49,1849
7168,7168,FF3E223EC645685F23BE28ABAEB636E3,13651,14,16,2,30,47,1547
7169,7169,FF3E223EC645685F23BE28ABAEB636E3,12391,19,20,1,36,49,1849
7170,7170,FF604ADE0B9A2535A71C015160B61DC6,12761,0,2,2,25,40,1290
7171,7171,FF604ADE0B9A2535A71C015160B61DC6,12521,3,4,1,35,41,1791
7172,7172,FF604ADE0B9A2535A71C015160B61DC6,12761,4,7,3,25,40,1290
7173,7173,FF604ADE0B9A2535A71C015160B61DC6,13671,10,12,2,27,43,1393
7174,7174,FF604ADE0B9A2535A71C015160B61DC6,12761,12,13,1,25,40,1290
7175,7175,FF604ADE0B9A2535A71C015160B61DC6,13311,16,17,1,27,39,1389
7176,7176,FF604ADE0B9A2535A71C015160B61DC6,12521,19,20,1,35,41,1791
7177,7177,FF604ADE0B9A2535A71C015160B61DC6,12761,22,23,1,25,40,1290
7178,7178,CA0F44B6F7E193634D6CFE5FD4DF9739,10691,0,8,8,33,48,1698
7179,7179,CA0F44B6F7E193634D6CFE5FD4DF9739,42161,11,16,5,36,47,1847
7180,7180,CA0F44B6F7E193634D6CFE5FD4DF9739,10107,18,22,4,38,49,1949
7181,7181,62FCB15297A7724012720DDE29CC0405,13791,4,7,3,42,47,2147
7182,7182,62FCB15297A7724012720DDE29CC0405,13111,9,10,1,42,46,2146
7183,7183,62FCB15297A7724012720DDE29CC0405,42541,14,15,1,25,47,1297
7184,7184,62FCB15297A7724012720DDE29CC0405,10221,20,21,1,34,49,1749
7185,7185,0E40901167898EDFDA9B65FF7D65C295,19021,1,5,4,10,45,545
7186,7186,0E40901167898EDFDA9B65FF7D65C295,11851,7,13,6,13,47,697
7187,7187,0E40901167898EDFDA9B65FF7D65C295,42041,16,18,2,10,47,547
7188,7188,0E40901167898EDFDA9B65FF7D65C295,19021,20,23,3,10,45,545
7189,7189,2D8F7C2E000B799DCADCAEF4A15BB1AE,42471,0,6,6,35,49,1799
7190,7190,2D8F7C2E000B799DCADCAEF4A15BB1AE,12561,7,17,10,45,43,2293
7191,7191,2D8F7C2E000B799DCADCAEF4A15BB1AE,42471,21,23,2,35,49,1799
7192,7192,4442A57FD104BDC9B32FBAA9AB03595B,13121,0,7,7,38,46,1946
7193,7193,4442A57FD104BDC9B32FBAA9AB03595B,42511,7,9,2,37,47,1897
7194,7194,4442A57FD104BDC9B32FBAA9AB03595B,10107,9,11,2,38,49,1949
7195,7195,4442A57FD104BDC9B32FBAA9AB03595B,13121,12,16,4,38,46,1946
7196,7196,4442A57FD104BDC9B32FBAA9AB03595B,40341,17,18,1,23,49,1199
7197,7197,4442A57FD104BDC9B32FBAA9AB03595B,13121,21,23,2,38,46,1946
7201,7201,BA06C6DB1A8D5242DF18546BCDE19F8A,13371,0,9,9,41,47,2097
7202,7202,BA06C6DB1A8D5242DF18546BCDE19F8A,42381,12,13,1,39,41,1991
7203,7203,BA06C6DB1A8D5242DF18546BCDE19F8A,13371,14,23,9,41,47,2097
7216,7216,7434ACDB9BA9B713F36CA5EA86C630A5,11731,0,7,7,36,48,1848
7217,7217,7434ACDB9BA9B713F36CA5EA86C630A5,40341,11,14,3,23,49,1199
7218,7218,7434ACDB9BA9B713F36CA5EA86C630A5,11731,16,17,1,36,48,1848
7219,7219,7434ACDB9BA9B713F36CA5EA86C630A5,42381,19,20,1,39,41,1991
7223,7223,43BEB4EC58DC5F240366957C238FE4C6,12731,3,15,12,22,40,1140
7224,7224,43BEB4EC58DC5F240366957C238FE4C6,12761,15,17,2,25,40,1290
7225,7225,43BEB4EC58DC5F240366957C238FE4C6,13671,19,20,1,27,43,1393
7226,7226,43BEB4EC58DC5F240366957C238FE4C6,12761,21,22,1,25,40,1290
7227,7227,5134C03EB3276C610A7AB253ED006E01,42981,0,8,8,36,49,1849
7228,7228,5134C03EB3276C610A7AB253ED006E01,11541,11,13,2,35,49,1799
7229,7229,5134C03EB3276C610A7AB253ED006E01,11301,13,15,2,41,49,2099
7230,7230,5134C03EB3276C610A7AB253ED006E01,10107,15,18,3,38,49,1949
7231,7231,5134C03EB3276C610A7AB253ED006E01,11301,20,23,3,41,49,2099
7232,7232,E83EEC0EDEADBA548B114EA601516E47,42961,0,8,8,35,49,1799
7233,7233,E83EEC0EDEADBA548B114EA601516E47,10221,9,12,3,34,49,1749
7234,7234,E83EEC0EDEADBA548B114EA601516E47,42351,13,15,2,38,45,1945
7235,7235,E83EEC0EDEADBA548B114EA601516E47,10221,16,23,7,34,49,1749
7236,7236,971B8063CF84FDB0EAB7721185FDA161,42681,0,8,8,24,48,1248
7237,7237,971B8063CF84FDB0EAB7721185FDA161,13091,9,10,1,20,42,1042
7238,7238,971B8063CF84FDB0EAB7721185FDA161,13094,11,12,1,21,42,1092
7239,7239,971B8063CF84FDB0EAB7721185FDA161,13091,13,14,1,20,42,1042
7240,7240,971B8063CF84FDB0EAB7721185FDA161,42681,15,21,6,24,48,1248
7241,7241,09757EDFE7795D1E67DCE5C4439A4727,12521,0,6,6,35,41,1791
7242,7242,09757EDFE7795D1E67DCE5C4439A4727,13041,7,9,2,30,37,1537
7243,7243,09757EDFE7795D1E67DCE5C4439A4727,12521,10,23,13,35,41,1791
7244,7244,E2F2F4143F844EB76521711717E3F1F1,43644,0,5,5,14,38,738
7245,7245,E2F2F4143F844EB76521711717E3F1F1,12641,6,8,2,10,43,543
7246,7246,E2F2F4143F844EB76521711717E3F1F1,12921,9,17,8,9,41,491
7247,7247,E2F2F4143F844EB76521711717E3F1F1,12641,17,18,1,10,43,543
7248,7248,E2F2F4143F844EB76521711717E3F1F1,12921,18,22,4,9,41,491
7249,7249,D2007E56CDD263F500CAE75A804D6B50,42871,0,4,4,30,45,1545
7250,7250,D2007E56CDD263F500CAE75A804D6B50,12311,6,15,9,30,44,1544
7251,7251,D2007E56CDD263F500CAE75A804D6B50,10381,18,19,1,31,49,1599
7252,7252,48CA64E3001D246DD7FC4FDF40132060,19021,0,7,7,10,45,545
7253,7253,48CA64E3001D246DD7FC4FDF40132060,19441,10,11,1,8,46,446
7254,7254,48CA64E3001D246DD7FC4FDF40132060,12921,13,14,1,9,41,491
7255,7255,48CA64E3001D246DD7FC4FDF40132060,19021,16,17,1,10,45,545
7256,7256,48CA64E3001D246DD7FC4FDF40132060,19114,18,20,2,7,43,393
7257,7257,48CA64E3001D246DD7FC4FDF40132060,19021,21,23,2,10,45,545
7258,7258,EFA77265EA024128FED31E4EE63DAAA7,40302,0,8,8,40,49,2049
7259,7259,EFA77265EA024128FED31E4EE63DAAA7,11061,12,15,3,29,48,1498
7260,7260,EFA77265EA024128FED31E4EE63DAAA7,42801,17,23,6,40,49,2049
7261,7261,914FCCE81925BD3B7C09A01C1E108BA6,43621,1,4,3,46,48,2348
7262,7262,914FCCE81925BD3B7C09A01C1E108BA6,42461,5,13,8,45,47,2297
7263,7263,914FCCE81925BD3B7C09A01C1E108BA6,43621,14,15,1,46,48,2348
7264,7264,914FCCE81925BD3B7C09A01C1E108BA6,42091,16,18,2,43,46,2196
7265,7265,914FCCE81925BD3B7C09A01C1E108BA6,42461,19,21,2,45,47,2297
7270,7270,E478E2D9BCF7A4F7B498F875A46F0A1D,40801,0,7,7,43,46,2196
7271,7271,E478E2D9BCF7A4F7B498F875A46F0A1D,42321,9,12,3,43,47,2197
7272,7272,E478E2D9BCF7A4F7B498F875A46F0A1D,43621,13,18,5,46,48,2348
7276,7276,4FA7E2AF35091649A8D61648BF92F5C0,42581,0,6,6,38,48,1948
7277,7277,4FA7E2AF35091649A8D61648BF92F5C0,10471,6,9,3,37,48,1898
7278,7278,4FA7E2AF35091649A8D61648BF92F5C0,42581,9,14,5,38,48,1948
7279,7279,4FA7E2AF35091649A8D61648BF92F5C0,10471,14,16,2,37,48,1898
7280,7280,4FA7E2AF35091649A8D61648BF92F5C0,42221,18,23,5,38,48,1948
7284,7284,802D06E8811CDC65FDAB61E1A1D233B3,10501,0,6,6,22,46,1146
7285,7285,802D06E8811CDC65FDAB61E1A1D233B3,12601,8,9,1,25,47,1297
7286,7286,802D06E8811CDC65FDAB61E1A1D233B3,10491,10,18,8,33,48,1698
7287,7287,ACE91F60C33B205BD4C9C7783BB8F826,19441,7,9,2,8,46,446
7288,7288,ACE91F60C33B205BD4C9C7783BB8F826,19024,10,11,1,9,45,495
7289,7289,ACE91F60C33B205BD4C9C7783BB8F826,19114,12,13,1,7,43,393
7290,7290,ACE91F60C33B205BD4C9C7783BB8F826,19024,17,18,1,9,45,495
7291,7291,ACE91F60C33B205BD4C9C7783BB8F826,19114,19,23,4,7,43,393
7292,7292,9BD3B78DE3CC1700630FC53FFF98B201,19264,0,5,5,10,36,536
7293,7293,9BD3B78DE3CC1700630FC53FFF98B201,12871,8,13,5,22,33,1133
7294,7294,9BD3B78DE3CC1700630FC53FFF98B201,19811,13,15,2,10,34,534
7295,7295,9BD3B78DE3CC1700630FC53FFF98B201,12871,16,17,1,22,33,1133
7296,7296,9BD3B78DE3CC1700630FC53FFF98B201,19264,17,18,1,10,36,536
7297,7297,B994420A8793AD6580B078DE084AD127,42971,0,7,7,43,49,2199
7298,7298,B994420A8793AD6580B078DE084AD127,42381,13,14,1,39,41,1991
7299,7299,B994420A8793AD6580B078DE084AD127,11211,22,23,1,34,49,1749
7311,7311,7E24910A24832FFFD951546D65AD3046,12971,0,12,12,32,48,1648
7312,7312,7E24910A24832FFFD951546D65AD3046,40951,13,17,4,36,49,1849
7313,7313,7E24910A24832FFFD951546D65AD3046,10221,21,23,2,34,49,1749
7324,7324,BA68D19087DD7682E8C396165511A278,11381,0,14,14,30,47,1547
7325,7325,BA68D19087DD7682E8C396165511A278,42081,15,16,1,24,49,1249
7326,7326,BA68D19087DD7682E8C396165511A278,11161,19,23,4,32,48,1648
7327,7327,C5F6807D0DC220589E806B0C1AC61E83,10951,0,6,6,29,48,1498
7328,7328,C5F6807D0DC220589E806B0C1AC61E83,40124,8,9,1,38,47,1947
7329,7329,C5F6807D0DC220589E806B0C1AC61E83,10951,17,21,4,29,48,1498
7334,7334,3E2AD10F373D6414DCF10B230807A028,15184,0,8,8,29,22,1472
7335,7335,3E2AD10F373D6414DCF10B230807A028,12792,12,15,3,34,30,1730
7336,7336,3E2AD10F373D6414DCF10B230807A028,15184,16,22,6,29,22,1472
7337,7337,4B5119258FB3482B746B53277561992F,12601,0,1,1,25,47,1297
7338,7338,4B5119258FB3482B746B53277561992F,12584,2,5,3,24,48,1248
7339,7339,4B5119258FB3482B746B53277561992F,12601,8,13,5,25,47,1297
7340,7340,4B5119258FB3482B746B53277561992F,12051,15,16,1,20,47,1047
7341,7341,4B5119258FB3482B746B53277561992F,12601,17,19,2,25,47,1297
7342,7342,A2D507EA5E3520526C66D89C2499D500,10901,0,16,16,35,48,1798
7343,7343,A2D507EA5E3520526C66D89C2499D500,42621,17,18,1,24,49,1249
7344,7344,A2D507EA5E3520526C66D89C2499D500,10901,20,23,3,35,48,1798
7345,7345,7F73EEE1198B300F5190B9A740E251E3,12491,1,3,2,36,43,1843
7346,7346,7F73EEE1198B300F5190B9A740E251E3,13911,3,13,10,39,46,1996
7347,7347,7F73EEE1198B300F5190B9A740E251E3,11261,13,20,7,36,46,1846
7348,7348,25A0E61F1DC4EDCA55BC31768CCB616A,15061,0,7,7,41,25,2075
7349,7349,25A0E61F1DC4EDCA55BC31768CCB616A,15651,8,9,1,39,25,1975
7350,7350,25A0E61F1DC4EDCA55BC31768CCB616A,15061,11,14,3,41,25,2075
7351,7351,25A0E61F1DC4EDCA55BC31768CCB616A,13371,15,20,5,41,47,2097
7352,7352,A8FE6CFECD0860615708930D316AC04E,42221,0,2,2,38,48,1948
7353,7353,A8FE6CFECD0860615708930D316AC04E,43481,4,6,2,39,48,1998
7354,7354,A8FE6CFECD0860615708930D316AC04E,10601,6,11,5,39,47,1997
7355,7355,A8FE6CFECD0860615708930D316AC04E,11074,13,15,2,37,47,1897
7356,7356,A8FE6CFECD0860615708930D316AC04E,12511,16,23,7,39,47,1997
7357,7357,9605516642BC724238866AB756F87B3C,11381,3,8,5,30,47,1547
7358,7358,9605516642BC724238866AB756F87B3C,11061,8,9,1,29,48,1498
7359,7359,9605516642BC724238866AB756F87B3C,11381,9,10,1,30,47,1547
7360,7360,9605516642BC724238866AB756F87B3C,11061,14,16,2,29,48,1498
7361,7361,9605516642BC724238866AB756F87B3C,11631,18,19,1,12,49,649
7365,7365,CD62F89A81CF58E2979469073621225B,12031,0,6,6,33,48,1698
7366,7366,CD62F89A81CF58E2979469073621225B,42941,7,16,9,37,47,1897
7367,7367,CD62F89A81CF58E2979469073621225B,10491,19,23,4,33,48,1698
7368,7368,1ECB7758304FB0B6302614AF93330553,12311,0,6,6,30,44,1544
7369,7369,1ECB7758304FB0B6302614AF93330553,12661,8,10,2,32,45,1645
7370,7370,1ECB7758304FB0B6302614AF93330553,42161,12,13,1,36,47,1847
7371,7371,1ECB7758304FB0B6302614AF93330553,11834,16,17,1,32,45,1645
7372,7372,1ECB7758304FB0B6302614AF93330553,42531,19,22,3,31,45,1595
7376,7376,4C238BB7C5832FF7221019CFAA6E94A4,19024,0,7,7,9,45,495
7377,7377,4C238BB7C5832FF7221019CFAA6E94A4,19621,8,11,3,5,46,296
7378,7378,4C238BB7C5832FF7221019CFAA6E94A4,10221,12,18,6,34,49,1749
7379,7379,4C238BB7C5832FF7221019CFAA6E94A4,19024,21,23,2,9,45,495
7383,7383,FACA7C472055342CB52356ECCA18D789,42864,1,10,9,38,44,1944
7384,7384,FACA7C472055342CB52356ECCA18D789,13671,11,17,6,27,43,1393
7385,7385,FACA7C472055342CB52356ECCA18D789,11261,18,19,1,36,46,1846
7386,7386,FACA7C472055342CB52356ECCA18D789,13671,20,23,3,27,43,1393
7396,7396,39AF3644B5575CFA85818E74A5317361,13251,0,1,1,48,28,2428
7397,7397,39AF3644B5575CFA85818E74A5317361,15411,5,8,3,44,27,2227
7398,7398,39AF3644B5575CFA85818E74A5317361,13251,12,13,1,48,28,2428
7399,7399,39AF3644B5575CFA85818E74A5317361,15411,15,20,5,44,27,2227
7400,7400,B51CF68BE97808727E238A35594EB565,15391,0,11,11,35,26,1776
7401,7401,B51CF68BE97808727E238A35594EB565,12881,15,17,2,47,22,2372
7402,7402,B51CF68BE97808727E238A35594EB565,15391,21,23,2,35,26,1776
7403,7403,1BCA8F195CED1A69C9ABE190E0303E0A,19111,0,2,2,9,45,495
7404,7404,1BCA8F195CED1A69C9ABE190E0303E0A,19114,5,6,1,7,43,393
7405,7405,1BCA8F195CED1A69C9ABE190E0303E0A,19111,9,11,2,9,45,495
7406,7406,1BCA8F195CED1A69C9ABE190E0303E0A,12641,13,14,1,10,43,543
7407,7407,1BCA8F195CED1A69C9ABE190E0303E0A,19111,15,17,2,9,45,495
7408,7408,1BCA8F195CED1A69C9ABE190E0303E0A,12641,18,20,2,10,43,543
7409,7409,1BCA8F195CED1A69C9ABE190E0303E0A,19114,20,22,2,7,43,393
7413,7413,9E8B6B3A1DE6AA06F7DBDE6405587922,10107,0,3,3,38,49,1949
7414,7414,9E8B6B3A1DE6AA06F7DBDE6405587922,11861,3,14,11,32,47,1647
7415,7415,9E8B6B3A1DE6AA06F7DBDE6405587922,41007,16,19,3,37,47,1897
7416,7416,B407E10E40F14F417BB48241B7C62C97,13271,0,9,9,41,47,2097
7417,7417,B407E10E40F14F417BB48241B7C62C97,12511,11,13,2,39,47,1997
7418,7418,B407E10E40F14F417BB48241B7C62C97,40833,13,14,1,41,47,2097
7419,7419,B407E10E40F14F417BB48241B7C62C97,11801,18,19,1,42,48,2148
7420,7420,B407E10E40F14F417BB48241B7C62C97,13271,20,23,3,41,47,2097
7424,7424,25CF3C44C23E92B4E11CBD2CE06A92E5,11001,0,7,7,42,47,2147
7425,7425,25CF3C44C23E92B4E11CBD2CE06A92E5,11231,9,18,9,37,49,1899
7426,7426,25CF3C44C23E92B4E11CBD2CE06A92E5,11001,19,23,4,42,47,2147
7430,7430,E2E7904AF585940CD43CDDA5A90CDD82,10661,0,14,14,37,49,1899
7431,7431,E2E7904AF585940CD43CDDA5A90CDD82,19031,16,17,1,1,42,92
7432,7432,E2E7904AF585940CD43CDDA5A90CDD82,10661,20,23,3,37,49,1899
7433,7433,C5C866B840AB1E710A19532E1F1DAD43,10295,0,8,8,30,47,1547
7434,7434,C5C866B840AB1E710A19532E1F1DAD43,11751,10,11,1,35,48,1798
7435,7435,C5C866B840AB1E710A19532E1F1DAD43,42523,12,18,6,31,47,1597
7436,7436,C5C866B840AB1E710A19532E1F1DAD43,10381,18,19,1,31,49,1599
7437,7437,C5C866B840AB1E710A19532E1F1DAD43,10295,20,23,3,30,47,1547
7441,7441,075D6798652C490159667E0379AA18B5,42221,0,7,7,38,48,1948
7442,7442,075D6798652C490159667E0379AA18B5,11074,12,13,1,37,47,1897
7443,7443,075D6798652C490159667E0379AA18B5,42221,14,15,1,38,48,1948
7444,7444,075D6798652C490159667E0379AA18B5,11074,16,18,2,37,47,1897
7445,7445,075D6798652C490159667E0379AA18B5,13331,18,20,2,38,47,1947
7446,7446,C50F95F31F14C0EC9A55706C3B181C1C,15391,0,1,1,35,26,1776
7447,7447,C50F95F31F14C0EC9A55706C3B181C1C,12792,2,14,12,34,30,1730
7448,7448,C50F95F31F14C0EC9A55706C3B181C1C,15391,14,16,2,35,26,1776
7449,7449,C50F95F31F14C0EC9A55706C3B181C1C,12792,18,19,1,34,30,1730
7450,7450,8ED78C7DD4E1B880F311FE3FB9457EF7,10111,0,14,14,37,47,1897
7451,7451,8ED78C7DD4E1B880F311FE3FB9457EF7,42501,14,15,1,28,47,1447
7452,7452,8ED78C7DD4E1B880F311FE3FB9457EF7,10111,17,23,6,37,47,1897
7453,7453,D5D027DEC2E15CD439B6E37A42DFD8C1,43021,0,1,1,16,43,843
7454,7454,D5D027DEC2E15CD439B6E37A42DFD8C1,12921,1,4,3,9,41,491
7455,7455,D5D027DEC2E15CD439B6E37A42DFD8C1,43021,4,11,7,16,43,843
7456,7456,D5D027DEC2E15CD439B6E37A42DFD8C1,12921,15,16,1,9,41,491
7457,7457,D5D027DEC2E15CD439B6E37A42DFD8C1,43021,16,22,6,16,43,843
7465,7465,97CABD5CA4B44BD80C3C863536728BE4,11151,3,7,4,30,48,1548
7466,7466,97CABD5CA4B44BD80C3C863536728BE4,12311,8,9,1,30,44,1544
7467,7467,97CABD5CA4B44BD80C3C863536728BE4,11871,13,17,4,29,46,1496
7468,7468,97CABD5CA4B44BD80C3C863536728BE4,11491,21,23,2,36,47,1847
7475,7475,39E8FB5C4AE9A0E0783441178F244CD5,10341,0,13,13,31,47,1597
7476,7476,39E8FB5C4AE9A0E0783441178F244CD5,11791,14,17,3,38,49,1949
7477,7477,39E8FB5C4AE9A0E0783441178F244CD5,13601,18,19,1,34,47,1747
7478,7478,39E8FB5C4AE9A0E0783441178F244CD5,10341,20,21,1,31,47,1597
7482,7482,90A29F95C1A65E198C9A7C59F8AD296B,12521,0,8,8,35,41,1791
7483,7483,90A29F95C1A65E198C9A7C59F8AD296B,11794,13,14,1,38,49,1949
7484,7484,90A29F95C1A65E198C9A7C59F8AD296B,13091,15,19,4,20,42,1042
7492,7492,145E734E186950C5FCF9FF61BBA7968A,12161,4,6,2,32,46,1646
7493,7493,145E734E186950C5FCF9FF61BBA7968A,42401,10,17,7,36,47,1847
7494,7494,145E734E186950C5FCF9FF61BBA7968A,13221,17,20,3,40,47,2047
7498,7498,11C5ACA60B0246DE7069023057E8285F,40101,0,3,3,34,49,1749
7499,7499,11C5ACA60B0246DE7069023057E8285F,11381,3,5,2,30,47,1547
7500,7500,11C5ACA60B0246DE7069023057E8285F,42291,6,22,16,29,48,1498
7501,7501,11C5ACA60B0246DE7069023057E8285F,11381,22,23,1,30,47,1547
7505,7505,089202C74F7A5B708A3906BDD594D636,12601,0,2,2,25,47,1297
7506,7506,089202C74F7A5B708A3906BDD594D636,10351,3,8,5,28,45,1445
7507,7507,089202C74F7A5B708A3906BDD594D636,12601,8,12,4,25,47,1297
7508,7508,089202C74F7A5B708A3906BDD594D636,10501,14,17,3,22,46,1146
7509,7509,089202C74F7A5B708A3906BDD594D636,12601,18,19,1,25,47,1297
7510,7510,A09B631BCC319D5EC41B3CFE0EF885AC,10401,0,9,9,33,49,1699
7511,7511,A09B631BCC319D5EC41B3CFE0EF885AC,12601,11,17,6,25,47,1297
7512,7512,A09B631BCC319D5EC41B3CFE0EF885AC,10401,18,23,5,33,49,1699
7513,7513,7DDE2119A71FDAA78AE910A4980C3757,42161,0,2,2,36,47,1847
7514,7514,7DDE2119A71FDAA78AE910A4980C3757,42941,3,4,1,37,47,1897
7515,7515,7DDE2119A71FDAA78AE910A4980C3757,42161,4,14,10,36,47,1847
7516,7516,7DDE2119A71FDAA78AE910A4980C3757,12521,15,16,1,35,41,1791
7517,7517,7DDE2119A71FDAA78AE910A4980C3757,42401,18,19,1,36,47,1847
7521,7521,FB6BC9371546DBE1906038833E54155A,16241,0,7,7,3,3,153
7522,7522,FB6BC9371546DBE1906038833E54155A,16281,8,13,5,11,4,554
7523,7523,FB6BC9371546DBE1906038833E54155A,16241,16,23,7,3,3,153
7524,7524,E9C5D67F82A2CCBA27E905D3F4A2B0C8,10221,0,6,6,34,49,1749
7525,7525,E9C5D67F82A2CCBA27E905D3F4A2B0C8,43751,7,9,2,19,48,998
7526,7526,E9C5D67F82A2CCBA27E905D3F4A2B0C8,10221,10,18,8,34,49,1749
7527,7527,E9C5D67F82A2CCBA27E905D3F4A2B0C8,12514,18,21,3,38,47,1947
7531,7531,AB219C42504F381A0E907A3E3912C30E,13711,0,9,9,38,46,1946
7532,7532,AB219C42504F381A0E907A3E3912C30E,11531,10,11,1,34,49,1749
7533,7533,AB219C42504F381A0E907A3E3912C30E,13711,11,19,8,38,46,1946
7534,7534,1A5DEB007188BBCFFE665C75C024CDE9,12311,0,2,2,30,44,1544
7535,7535,1A5DEB007188BBCFFE665C75C024CDE9,42531,3,17,14,31,45,1595
7536,7536,1A5DEB007188BBCFFE665C75C024CDE9,13711,19,21,2,38,46,1946
7537,7537,135EF939D99CED11694D71795A5772B0,19031,0,9,9,1,42,92
7538,7538,135EF939D99CED11694D71795A5772B0,12641,9,11,2,10,43,543
7539,7539,135EF939D99CED11694D71795A5772B0,19031,11,16,5,1,42,92
7540,7540,135EF939D99CED11694D71795A5772B0,12641,16,18,2,10,43,543
7541,7541,135EF939D99CED11694D71795A5772B0,19031,19,23,4,1,42,92
7548,7548,4CA1188698B5DD1E66E2EDCA80216CDE,12571,0,5,5,48,39,2439
7549,7549,4CA1188698B5DD1E66E2EDCA80216CDE,13071,10,17,7,41,41,2091
7550,7550,4CA1188698B5DD1E66E2EDCA80216CDE,43101,17,18,1,46,40,2340
7551,7551,4CA1188698B5DD1E66E2EDCA80216CDE,12571,20,23,3,48,39,2439
7552,7552,47C1473BA4462B22BD05E79B53CFA190,11471,8,10,2,12,48,648
7553,7553,47C1473BA4462B22BD05E79B53CFA190,42041,11,12,1,10,47,547
7554,7554,47C1473BA4462B22BD05E79B53CFA190,19441,12,18,6,8,46,446
7555,7555,47C1473BA4462B22BD05E79B53CFA190,42041,20,22,2,10,47,547
7556,7556,3B1A21AC2752B4BA140F5FCFF69BF0F4,42331,0,9,9,39,46,1996
7557,7557,3B1A21AC2752B4BA140F5FCFF69BF0F4,11151,9,11,2,30,48,1548
7558,7558,3B1A21AC2752B4BA140F5FCFF69BF0F4,10431,12,15,3,33,49,1699
7559,7559,3B1A21AC2752B4BA140F5FCFF69BF0F4,42331,16,23,7,39,46,1996
7560,7560,B8989CFFC223BB64D623BE9489BA8A6F,12083,10,11,1,36,49,1849
7561,7561,B8989CFFC223BB64D623BE9489BA8A6F,10191,16,17,1,40,48,2048
7562,7562,B8989CFFC223BB64D623BE9489BA8A6F,11954,19,20,1,32,49,1649
7566,7566,30B694F22AAF2BCD8A000284EDDEC0CA,13941,0,9,9,41,47,2097
7567,7567,30B694F22AAF2BCD8A000284EDDEC0CA,10107,11,14,3,38,49,1949
7568,7568,30B694F22AAF2BCD8A000284EDDEC0CA,13941,16,22,6,41,47,2097
7575,7575,AADB28E9DA77189EEA8935A9DB4C082F,42921,0,7,7,33,47,1697
7576,7576,AADB28E9DA77189EEA8935A9DB4C082F,10107,11,14,3,38,49,1949
7577,7577,AADB28E9DA77189EEA8935A9DB4C082F,10281,15,18,3,33,48,1698
7578,7578,523D7A2E824432957848434352090885,10341,9,18,9,31,47,1597
7579,7579,523D7A2E824432957848434352090885,43181,19,20,1,39,48,1998
7580,7580,523D7A2E824432957848434352090885,10341,20,23,3,31,47,1597
7581,7581,0DC30FA0CCDAD859C724130675369152,42351,0,5,5,38,45,1945
7582,7582,0DC30FA0CCDAD859C724130675369152,12211,6,11,5,41,44,2094
7583,7583,0DC30FA0CCDAD859C724130675369152,42351,12,13,1,38,45,1945
7584,7584,0DC30FA0CCDAD859C724130675369152,11261,15,17,2,36,46,1846
7585,7585,0DC30FA0CCDAD859C724130675369152,42351,17,20,3,38,45,1945
7586,7586,0DC30FA0CCDAD859C724130675369152,11261,20,22,2,36,46,1846
7587,7587,23EA4F8B5D0ABEDDC9284DC80F701F9F,42091,1,6,5,43,46,2196
7588,7588,23EA4F8B5D0ABEDDC9284DC80F701F9F,42461,10,11,1,45,47,2297
7589,7589,23EA4F8B5D0ABEDDC9284DC80F701F9F,11701,12,14,2,43,48,2198
7590,7590,23EA4F8B5D0ABEDDC9284DC80F701F9F,42461,15,19,4,45,47,2297
7591,7591,23EA4F8B5D0ABEDDC9284DC80F701F9F,42091,20,23,3,43,46,2196
7595,7595,7F0F7E01EE512C1A933F7133254355CA,43021,0,5,5,16,43,843
7596,7596,7F0F7E01EE512C1A933F7133254355CA,12921,5,19,14,9,41,491
7597,7597,7F0F7E01EE512C1A933F7133254355CA,43021,22,23,1,16,43,843
7598,7598,73118727834AEF72D14D5BE83EC91BD1,11001,1,7,6,42,47,2147
7599,7599,73118727834AEF72D14D5BE83EC91BD1,11074,9,17,8,37,47,1897
7600,7600,73118727834AEF72D14D5BE83EC91BD1,11001,18,21,3,42,47,2147
7601,7601,B45EBCB4BC75C6E8F280E8288A368DBC,11481,0,6,6,41,48,2098
7602,7602,B45EBCB4BC75C6E8F280E8288A368DBC,12601,9,10,1,25,47,1297
7603,7603,B45EBCB4BC75C6E8F280E8288A368DBC,11521,15,22,7,41,48,2098
7611,7611,03A9B89D0B7788100B73A84DF9F7F0DB,10661,0,1,1,37,49,1899
7612,7612,03A9B89D0B7788100B73A84DF9F7F0DB,10061,8,10,2,20,46,1046
7613,7613,03A9B89D0B7788100B73A84DF9F7F0DB,19021,10,18,8,10,45,545
7614,7614,E11BA5121889EE34879DAAEE104F176F,12051,0,1,1,20,47,1047
7615,7615,E11BA5121889EE34879DAAEE104F176F,12581,1,3,2,24,48,1248
7616,7616,E11BA5121889EE34879DAAEE104F176F,11361,4,10,6,22,48,1148
7617,7617,E11BA5121889EE34879DAAEE104F176F,10451,10,15,5,25,48,1298
7618,7618,E11BA5121889EE34879DAAEE104F176F,12051,16,18,2,20,47,1047
7619,7619,E11BA5121889EE34879DAAEE104F176F,10501,19,22,3,22,46,1146
7620,7620,5D7734B1178D7780B618167D253CC3A3,42864,0,5,5,38,44,1944
7621,7621,5D7734B1178D7780B618167D253CC3A3,11261,6,8,2,36,46,1846
7622,7622,5D7734B1178D7780B618167D253CC3A3,42864,11,14,3,38,44,1944
7623,7623,5D7734B1178D7780B618167D253CC3A3,11261,18,19,1,36,46,1846
7624,7624,5D7734B1178D7780B618167D253CC3A3,42864,20,23,3,38,44,1944
7625,7625,8E007C4DFBE066342DBB5AB7D666AD2F,43101,1,13,12,46,40,2340
7626,7626,8E007C4DFBE066342DBB5AB7D666AD2F,13071,13,15,2,41,41,2091
7627,7627,8E007C4DFBE066342DBB5AB7D666AD2F,43101,18,23,5,46,40,2340
7628,7628,A1E490700FE526497C6D06909C6A4A1B,11861,0,15,15,32,47,1647
7629,7629,A1E490700FE526497C6D06909C6A4A1B,13331,16,17,1,38,47,1947
7630,7630,A1E490700FE526497C6D06909C6A4A1B,42371,20,23,3,34,46,1746
7634,7634,C26832B26CF325B999FB991628AA9579,13651,0,7,7,30,47,1547
7635,7635,C26832B26CF325B999FB991628AA9579,12311,8,9,1,30,44,1544
7636,7636,C26832B26CF325B999FB991628AA9579,12641,10,13,3,10,43,543
7637,7637,C26832B26CF325B999FB991628AA9579,13651,17,23,6,30,47,1547
7648,7648,DAF070E37522449552E837969D087804,11171,0,6,6,33,48,1698
7649,7649,DAF070E37522449552E837969D087804,10471,7,11,4,37,48,1898
7650,7650,DAF070E37522449552E837969D087804,11171,11,13,2,33,48,1698
7651,7651,DAF070E37522449552E837969D087804,10471,14,15,1,37,48,1898
7652,7652,DAF070E37522449552E837969D087804,40171,15,17,2,38,48,1948
7653,7653,DAF070E37522449552E837969D087804,10491,19,23,4,33,48,1698
7657,7657,63C0608C6DDAD2FAC28A4EAB04A95799,11324,0,6,6,31,46,1596
7658,7658,63C0608C6DDAD2FAC28A4EAB04A95799,10341,9,13,4,31,47,1597
7659,7659,63C0608C6DDAD2FAC28A4EAB04A95799,40341,13,16,3,23,49,1199
7660,7660,63C0608C6DDAD2FAC28A4EAB04A95799,10341,16,18,2,31,47,1597
7661,7661,EF81D5350C78C47D74F1239C7A88A260,11201,1,3,2,35,49,1799
7662,7662,EF81D5350C78C47D74F1239C7A88A260,11861,4,16,12,32,47,1647
7663,7663,EF81D5350C78C47D74F1239C7A88A260,11231,19,21,2,37,49,1899
7674,7674,04FA90051CCA5DE90D33C1756F991BAB,11081,0,4,4,35,46,1796
7675,7675,04FA90051CCA5DE90D33C1756F991BAB,12601,6,18,12,25,47,1297
7676,7676,04FA90051CCA5DE90D33C1756F991BAB,11081,22,23,1,35,46,1796
7677,7677,DE562E077213566DA78895C5D4449486,10411,0,7,7,36,48,1848
7678,7678,DE562E077213566DA78895C5D4449486,12921,9,13,4,9,41,491
7679,7679,DE562E077213566DA78895C5D4449486,10411,16,23,7,36,48,1848
7680,7680,64A2E9501F429B6DEC66E8EE627CCABA,11061,0,7,7,29,48,1498
7681,7681,64A2E9501F429B6DEC66E8EE627CCABA,10301,9,17,8,31,45,1595
7682,7682,64A2E9501F429B6DEC66E8EE627CCABA,13561,21,23,2,37,49,1899
7683,7683,7D52EFF6C051B4158B65888370EEB92D,42521,2,3,1,31,47,1597
7684,7684,7D52EFF6C051B4158B65888370EEB92D,43311,3,5,2,31,48,1598
7685,7685,7D52EFF6C051B4158B65888370EEB92D,42381,9,10,1,39,41,1991
7686,7686,7D52EFF6C051B4158B65888370EEB92D,42521,13,14,1,31,47,1597
7687,7687,7D52EFF6C051B4158B65888370EEB92D,12021,18,19,1,37,49,1899
7688,7688,CC7C043FFC6EDBA54A459773B754F7C8,11074,0,2,2,37,47,1897
7689,7689,CC7C043FFC6EDBA54A459773B754F7C8,40421,13,17,4,37,48,1898
7690,7690,CC7C043FFC6EDBA54A459773B754F7C8,42481,18,19,1,22,49,1149
7691,7691,32D5D1285727F452ABF73DEA4C737FB8,11151,5,7,2,30,48,1548
7692,7692,32D5D1285727F452ABF73DEA4C737FB8,11261,9,14,5,36,46,1846
7693,7693,32D5D1285727F452ABF73DEA4C737FB8,11151,17,22,5,30,48,1548
7697,7697,4939079DBC41D72C03B48C02C72AD37E,43021,0,15,15,16,43,843
7698,7698,4939079DBC41D72C03B48C02C72AD37E,12921,19,21,2,9,41,491
7699,7699,4939079DBC41D72C03B48C02C72AD37E,43021,21,23,2,16,43,843
7700,7700,B1D714EAA88F4188BDEB8AEAFDE91C5B,42461,0,1,1,45,47,2297
7701,7701,B1D714EAA88F4188BDEB8AEAFDE91C5B,42111,2,5,3,44,46,2246
7702,7702,B1D714EAA88F4188BDEB8AEAFDE91C5B,42461,6,7,1,45,47,2297
7703,7703,B1D714EAA88F4188BDEB8AEAFDE91C5B,42111,7,10,3,44,46,2246
7704,7704,B1D714EAA88F4188BDEB8AEAFDE91C5B,42461,13,14,1,45,47,2297
7705,7705,B1D714EAA88F4188BDEB8AEAFDE91C5B,42111,18,20,2,44,46,2246
7716,7716,B5B7E67EE3F7DD4C56009F9489E4B4C1,12521,0,14,14,35,41,1791
7717,7717,B5B7E67EE3F7DD4C56009F9489E4B4C1,40341,17,19,2,23,49,1199
7718,7718,B5B7E67EE3F7DD4C56009F9489E4B4C1,42851,21,23,2,35,41,1791
7722,7722,DBE56CF804EFF98F06EBBF480586FC01,43021,1,5,4,16,43,843
7723,7723,DBE56CF804EFF98F06EBBF480586FC01,12921,9,10,1,9,41,491
7724,7724,DBE56CF804EFF98F06EBBF480586FC01,43021,12,23,11,16,43,843
7728,7728,181B5103F0FBF120AFF5BEC3A26A3DB7,43761,1,2,1,32,47,1647
7729,7729,181B5103F0FBF120AFF5BEC3A26A3DB7,42521,4,5,1,31,47,1597
7730,7730,181B5103F0FBF120AFF5BEC3A26A3DB7,43761,7,17,10,32,47,1647
7731,7731,181B5103F0FBF120AFF5BEC3A26A3DB7,11161,18,19,1,32,48,1648
7732,7732,181B5103F0FBF120AFF5BEC3A26A3DB7,43761,19,22,3,32,47,1647
7733,7733,8F3D87765F7FBCF1F1DB0B2C068A5C58,42151,2,12,10,35,45,1795
7734,7734,8F3D87765F7FBCF1F1DB0B2C068A5C58,40341,13,15,2,23,49,1199
7735,7735,8F3D87765F7FBCF1F1DB0B2C068A5C58,42151,16,17,1,35,45,1795
7736,7736,8F3D87765F7FBCF1F1DB0B2C068A5C58,10911,21,23,2,39,46,1996
7737,7737,17B467982DBE02EE2EDDF7462F3AE5CF,11201,0,2,2,35,49,1799
7738,7738,17B467982DBE02EE2EDDF7462F3AE5CF,11351,3,12,9,36,48,1848
7739,7739,17B467982DBE02EE2EDDF7462F3AE5CF,40951,12,16,4,36,49,1849
7740,7740,17B467982DBE02EE2EDDF7462F3AE5CF,11351,18,19,1,36,48,1848
7741,7741,17B467982DBE02EE2EDDF7462F3AE5CF,11201,20,23,3,35,49,1799
7745,7745,8EA53D8E1525E5DC764AA8B750C1926A,42511,1,4,3,37,47,1897
7746,7746,8EA53D8E1525E5DC764AA8B750C1926A,43951,7,15,8,49,41,2491
7747,7747,8EA53D8E1525E5DC764AA8B750C1926A,13411,17,18,1,49,42,2492
7761,7761,0D753CC6181FC64E07F668A618F8F0BC,13071,5,13,8,41,41,2091
7762,7762,0D753CC6181FC64E07F668A618F8F0BC,43101,16,19,3,46,40,2340
7763,7763,0D753CC6181FC64E07F668A618F8F0BC,13071,20,23,3,41,41,2091
7764,7764,21B13E6FE5B4D725790EA640EC4328C1,42371,0,6,6,34,46,1746
7765,7765,21B13E6FE5B4D725790EA640EC4328C1,12514,7,9,2,38,47,1947
7766,7766,21B13E6FE5B4D725790EA640EC4328C1,11074,9,11,2,37,47,1897
7767,7767,21B13E6FE5B4D725790EA640EC4328C1,42371,11,14,3,34,46,1746
7768,7768,21B13E6FE5B4D725790EA640EC4328C1,42554,15,17,2,14,46,746
7769,7769,21B13E6FE5B4D725790EA640EC4328C1,42371,18,23,5,34,46,1746
7770,7770,F201252F5BA00C6F932DF03156A92782,11651,1,7,6,33,47,1697
7771,7771,F201252F5BA00C6F932DF03156A92782,42161,8,10,2,36,47,1847
7772,7772,F201252F5BA00C6F932DF03156A92782,11651,10,16,6,33,47,1697
7773,7773,F201252F5BA00C6F932DF03156A92782,40341,17,18,1,23,49,1199
7780,7780,906243C5709CD9CCAD3C51750530738A,10292,0,7,7,30,47,1547
7781,7781,906243C5709CD9CCAD3C51750530738A,43051,8,11,3,46,45,2345
7782,7782,906243C5709CD9CCAD3C51750530738A,13951,17,23,6,47,45,2395
7783,7783,014F2036841200D8A412C38BCBB64F7D,10521,0,6,6,41,47,2097
7784,7784,014F2036841200D8A412C38BCBB64F7D,12521,7,15,8,35,41,1791
7785,7785,014F2036841200D8A412C38BCBB64F7D,12514,17,18,1,38,47,1947
7786,7786,014F2036841200D8A412C38BCBB64F7D,10521,21,23,2,41,47,2097
7787,7787,B1FBA7CD09E43DD0FE0ADDDFA4EA80A3,49181,10,13,3,21,31,1081
7788,7788,B1FBA7CD09E43DD0FE0ADDDFA4EA80A3,43121,14,15,1,25,27,1277
7789,7789,B1FBA7CD09E43DD0FE0ADDDFA4EA80A3,49181,16,23,7,21,31,1081
7790,7790,5408DC5B0AFBD23C3FA2E4CCFD3A9C81,42633,0,6,6,42,46,2146
7791,7791,5408DC5B0AFBD23C3FA2E4CCFD3A9C81,11261,6,7,1,36,46,1846
7792,7792,5408DC5B0AFBD23C3FA2E4CCFD3A9C81,42633,12,13,1,42,46,2146
7793,7793,5408DC5B0AFBD23C3FA2E4CCFD3A9C81,42031,14,15,1,40,46,2046
7794,7794,5408DC5B0AFBD23C3FA2E4CCFD3A9C81,42633,19,21,2,42,46,2146
7795,7795,9B5C95C2C25E0F8F2EC966D9AC4886F9,13111,0,6,6,42,46,2146
7796,7796,9B5C95C2C25E0F8F2EC966D9AC4886F9,42511,8,9,1,37,47,1897
7797,7797,9B5C95C2C25E0F8F2EC966D9AC4886F9,13331,10,11,1,38,47,1947
7798,7798,9B5C95C2C25E0F8F2EC966D9AC4886F9,42511,12,14,2,37,47,1897
7799,7799,9B5C95C2C25E0F8F2EC966D9AC4886F9,13111,14,23,9,42,46,2146
7800,7800,4668498322059FDBAD6E4D56B28B3D41,12141,0,5,5,42,45,2145
7801,7801,4668498322059FDBAD6E4D56B28B3D41,13341,9,11,2,44,45,2245
7802,7802,4668498322059FDBAD6E4D56B28B3D41,12211,12,14,2,41,44,2094
7803,7803,4668498322059FDBAD6E4D56B28B3D41,13341,14,19,5,44,45,2245
7804,7804,4668498322059FDBAD6E4D56B28B3D41,12561,19,20,1,45,43,2293
7805,7805,03FE0D0BD52A528C1B4DF1F3C44F085B,43241,0,4,4,36,46,1846
7806,7806,03FE0D0BD52A528C1B4DF1F3C44F085B,42231,5,9,4,37,46,1896
7807,7807,03FE0D0BD52A528C1B4DF1F3C44F085B,42351,11,14,3,38,45,1945
7808,7808,03FE0D0BD52A528C1B4DF1F3C44F085B,42231,19,20,1,37,46,1896
7809,7809,03FE0D0BD52A528C1B4DF1F3C44F085B,42351,21,22,1,38,45,1945
7810,7810,A0ABB6B6CBBF7812210D9E6FA5915038,12921,0,10,10,9,41,491
7811,7811,A0ABB6B6CBBF7812210D9E6FA5915038,40341,13,15,2,23,49,1199
7812,7812,A0ABB6B6CBBF7812210D9E6FA5915038,12921,20,21,1,9,41,491
7813,7813,CA7675D4504FF649E5D3C79C1D770D57,10161,0,6,6,35,49,1799
7814,7814,CA7675D4504FF649E5D3C79C1D770D57,42831,7,9,2,27,48,1398
7815,7815,CA7675D4504FF649E5D3C79C1D770D57,11151,10,14,4,30,48,1548
7816,7816,CA7675D4504FF649E5D3C79C1D770D57,42831,15,17,2,27,48,1398
7817,7817,CA7675D4504FF649E5D3C79C1D770D57,10161,18,23,5,35,49,1799
7818,7818,1392C8E19F85085262C8C4C5B019D410,11074,0,7,7,37,47,1897
7819,7819,1392C8E19F85085262C8C4C5B019D410,42261,11,18,7,25,49,1299
7820,7820,1392C8E19F85085262C8C4C5B019D410,11074,20,23,3,37,47,1897
7821,7821,79180DDD86B22B2BAEB51E3552560D4E,11381,0,17,17,30,47,1547
7822,7822,79180DDD86B22B2BAEB51E3552560D4E,40341,17,19,2,23,49,1199
7823,7823,79180DDD86B22B2BAEB51E3552560D4E,11381,19,20,1,30,47,1547
7824,7824,79180DDD86B22B2BAEB51E3552560D4E,42523,20,23,3,31,47,1597
7831,7831,846C85CD309BB53F7D267BCD4A6ADE5D,12792,1,10,9,34,30,1730
7832,7832,846C85CD309BB53F7D267BCD4A6ADE5D,15391,12,14,2,35,26,1776
7833,7833,846C85CD309BB53F7D267BCD4A6ADE5D,12792,16,23,7,34,30,1730
7834,7834,6AF9BC3BC00A2DB4E93E7EFAFF6696BB,43761,0,6,6,32,47,1647
7835,7835,6AF9BC3BC00A2DB4E93E7EFAFF6696BB,13481,9,11,2,26,31,1331
7836,7836,6AF9BC3BC00A2DB4E93E7EFAFF6696BB,43761,14,19,5,32,47,1647
7837,7837,6AF9BC3BC00A2DB4E93E7EFAFF6696BB,42523,22,23,1,31,47,1597
7838,7838,FD400E5E5D48DD38D9BF2DF0674CF1A6,11281,0,1,1,27,40,1390
7839,7839,FD400E5E5D48DD38D9BF2DF0674CF1A6,13314,4,5,1,31,39,1589
7840,7840,FD400E5E5D48DD38D9BF2DF0674CF1A6,11281,6,7,1,27,40,1390
7841,7841,FD400E5E5D48DD38D9BF2DF0674CF1A6,13314,9,10,1,31,39,1589
7842,7842,FD400E5E5D48DD38D9BF2DF0674CF1A6,13671,13,14,1,27,43,1393
7843,7843,FD400E5E5D48DD38D9BF2DF0674CF1A6,11281,19,23,4,27,40,1390
7844,7844,9A42A597C11681270D6DCA52ED395A52,11801,0,1,1,42,48,2148
7845,7845,9A42A597C11681270D6DCA52ED395A52,10421,5,6,1,41,48,2098
7846,7846,9A42A597C11681270D6DCA52ED395A52,40341,15,18,3,23,49,1199
7857,7857,E1C94ADF7C5F9FDFC23FBE30C6F5D01A,11021,0,8,8,36,49,1849
7858,7858,E1C94ADF7C5F9FDFC23FBE30C6F5D01A,10381,8,12,4,31,49,1599
7859,7859,E1C94ADF7C5F9FDFC23FBE30C6F5D01A,10651,14,23,9,36,49,1849
7860,7860,DF034F57FA5C1FCBE0179C4156624820,13511,0,6,6,34,48,1748
7861,7861,DF034F57FA5C1FCBE0179C4156624820,43391,7,11,4,29,48,1498
7862,7862,DF034F57FA5C1FCBE0179C4156624820,13511,12,22,10,34,48,1748
7863,7863,F25BE183CA9EE48D61C03B85D10E9DF5,42021,0,1,1,33,47,1697
7864,7864,F25BE183CA9EE48D61C03B85D10E9DF5,13601,2,6,4,34,47,1747
7865,7865,F25BE183CA9EE48D61C03B85D10E9DF5,42921,7,9,2,33,47,1697
7866,7866,F25BE183CA9EE48D61C03B85D10E9DF5,40171,17,19,2,38,48,1948
7867,7867,F25BE183CA9EE48D61C03B85D10E9DF5,42021,20,23,3,33,47,1697
7871,7871,CE29EB37C112E7F535813A697DFC251A,43751,0,7,7,19,48,998
7872,7872,CE29EB37C112E7F535813A697DFC251A,12581,8,9,1,24,48,1248
7873,7873,CE29EB37C112E7F535813A697DFC251A,43751,10,19,9,19,48,998
7874,7874,CE29EB37C112E7F535813A697DFC251A,11101,19,21,2,18,48,948
7875,7875,CE29EB37C112E7F535813A697DFC251A,43751,22,23,1,19,48,998
7885,7885,AB57CFBC7FBBD1B4F46C04046F726522,15171,0,5,5,42,21,2121
7886,7886,AB57CFBC7FBBD1B4F46C04046F726522,12881,7,9,2,47,22,2372
7887,7887,AB57CFBC7FBBD1B4F46C04046F726522,15171,9,11,2,42,21,2121
7888,7888,AB57CFBC7FBBD1B4F46C04046F726522,12881,14,18,4,47,22,2372
7889,7889,AB57CFBC7FBBD1B4F46C04046F726522,15171,19,22,3,42,21,2121
7893,7893,6166F4BC9B2530F6FDAD5A0233FBAAD6,42581,0,2,2,38,48,1948
7894,7894,6166F4BC9B2530F6FDAD5A0233FBAAD6,12514,2,4,2,38,47,1947
7895,7895,6166F4BC9B2530F6FDAD5A0233FBAAD6,10471,6,8,2,37,48,1898
7896,7896,6166F4BC9B2530F6FDAD5A0233FBAAD6,42581,15,17,2,38,48,1948
7897,7897,6166F4BC9B2530F6FDAD5A0233FBAAD6,11914,17,20,3,37,48,1898
7901,7901,1ECAC98D318A51663C4EB0195708BA33,42191,0,6,6,38,49,1949
7902,7902,1ECAC98D318A51663C4EB0195708BA33,42871,9,10,1,30,45,1545
7903,7903,1ECAC98D318A51663C4EB0195708BA33,12661,11,14,3,32,45,1645
7904,7904,1ECAC98D318A51663C4EB0195708BA33,11201,21,23,2,35,49,1799
7915,7915,B7E9AE724F2B171EE75FE884D0B34C45,43721,1,3,2,32,34,1634
7916,7916,B7E9AE724F2B171EE75FE884D0B34C45,43724,3,6,3,35,33,1783
7917,7917,B7E9AE724F2B171EE75FE884D0B34C45,43451,8,11,3,37,40,1890
7918,7918,B7E9AE724F2B171EE75FE884D0B34C45,12514,12,14,2,38,47,1947
7919,7919,B7E9AE724F2B171EE75FE884D0B34C45,12511,14,19,5,39,47,1997
7920,7920,B7E9AE724F2B171EE75FE884D0B34C45,10331,20,21,1,39,46,1996
7921,7921,F3B16B9F2FE5D66DD896BE8E61C1FA80,10351,1,7,6,28,45,1445
7922,7922,F3B16B9F2FE5D66DD896BE8E61C1FA80,10301,9,11,2,31,45,1595
7923,7923,F3B16B9F2FE5D66DD896BE8E61C1FA80,10351,11,15,4,28,45,1445
7924,7924,F3B16B9F2FE5D66DD896BE8E61C1FA80,10301,16,18,2,31,45,1595
7925,7925,F3B16B9F2FE5D66DD896BE8E61C1FA80,12311,20,23,3,30,44,1544
7933,7933,BD318E9AF2E060A187A0EF37B2B8ED3A,12381,0,9,9,32,48,1648
7934,7934,BD318E9AF2E060A187A0EF37B2B8ED3A,42231,11,13,2,37,46,1896
7935,7935,BD318E9AF2E060A187A0EF37B2B8ED3A,10161,18,21,3,35,49,1799
7936,7936,5D22D5996B8B2F473B76F0D178C9C592,10951,3,7,4,29,48,1498
7937,7937,5D22D5996B8B2F473B76F0D178C9C592,12121,7,9,2,29,47,1497
7938,7938,5D22D5996B8B2F473B76F0D178C9C592,10951,12,14,2,29,48,1498
7939,7939,5D22D5996B8B2F473B76F0D178C9C592,43731,18,19,1,34,47,1747
7940,7940,5D22D5996B8B2F473B76F0D178C9C592,10951,20,22,2,29,48,1498
7941,7941,5D22D5996B8B2F473B76F0D178C9C592,11381,22,23,1,30,47,1547
7942,7942,386BC50CA64654644AF23E51C1C909E9,42351,0,7,7,38,45,1945
7943,7943,386BC50CA64654644AF23E51C1C909E9,11061,11,12,1,29,48,1498
7944,7944,386BC50CA64654644AF23E51C1C909E9,11231,15,19,4,37,49,1899
7945,7945,386BC50CA64654644AF23E51C1C909E9,12083,19,20,1,36,49,1849
7949,7949,90AC20E6CC0B4ABA3A4EAC5C3086C030,12481,0,7,7,37,49,1899
7950,7950,90AC20E6CC0B4ABA3A4EAC5C3086C030,10411,7,11,4,36,48,1848
7951,7951,90AC20E6CC0B4ABA3A4EAC5C3086C030,11791,12,13,1,38,49,1949
7952,7952,90AC20E6CC0B4ABA3A4EAC5C3086C030,13741,14,18,4,37,49,1899
7953,7953,90AC20E6CC0B4ABA3A4EAC5C3086C030,11831,20,22,2,32,45,1645
7960,7960,68CBF4973E612A79902148CC05F36307,11081,0,7,7,35,46,1796
7961,7961,68CBF4973E612A79902148CC05F36307,42623,11,13,2,22,49,1149
7962,7962,68CBF4973E612A79902148CC05F36307,40431,15,23,8,36,47,1847
7963,7963,9ABBA028751151DFC8C8A46C7FB232AE,43361,0,8,8,38,48,1948
7964,7964,9ABBA028751151DFC8C8A46C7FB232AE,42381,9,10,1,39,41,1991
7965,7965,9ABBA028751151DFC8C8A46C7FB232AE,40171,12,15,3,38,48,1948
7966,7966,9ABBA028751151DFC8C8A46C7FB232AE,11021,17,18,1,36,49,1849
7967,7967,9ABBA028751151DFC8C8A46C7FB232AE,43361,22,23,1,38,48,1948
7968,7968,5232A1F9DD43FADD1ACE9CE9BD82FED1,42801,0,11,11,40,49,2049
7969,7969,5232A1F9DD43FADD1ACE9CE9BD82FED1,43581,12,14,2,33,48,1698
7970,7970,5232A1F9DD43FADD1ACE9CE9BD82FED1,42801,15,17,2,40,49,2049
7971,7971,5232A1F9DD43FADD1ACE9CE9BD82FED1,11021,20,23,3,36,49,1849
7972,7972,887D22D8A56D3CC76F47CC3B51F82C12,43021,0,5,5,16,43,843
7973,7973,887D22D8A56D3CC76F47CC3B51F82C12,12641,8,12,4,10,43,543
7974,7974,887D22D8A56D3CC76F47CC3B51F82C12,11101,13,17,4,18,48,948
7975,7975,887D22D8A56D3CC76F47CC3B51F82C12,12641,17,19,2,10,43,543
7976,7976,24576DC2C63BF30A46BA06C33A71F868,13911,2,5,3,39,46,1996
7977,7977,24576DC2C63BF30A46BA06C33A71F868,11261,7,9,2,36,46,1846
7978,7978,24576DC2C63BF30A46BA06C33A71F868,12491,11,12,1,36,43,1843
7979,7979,24576DC2C63BF30A46BA06C33A71F868,13911,14,16,2,39,46,1996
7980,7980,24576DC2C63BF30A46BA06C33A71F868,11261,16,19,3,36,46,1846
7981,7981,24576DC2C63BF30A46BA06C33A71F868,42151,20,21,1,35,45,1795
7982,7982,27A0DD6A965A1FEA8EED4D0E73345414,19181,0,6,6,8,40,440
7983,7983,27A0DD6A965A1FEA8EED4D0E73345414,12641,7,10,3,10,43,543
7984,7984,27A0DD6A965A1FEA8EED4D0E73345414,12921,10,18,8,9,41,491
7985,7985,77C71CB0D4F3A8C7B3C07F9549000796,43971,3,6,3,30,48,1548
7986,7986,77C71CB0D4F3A8C7B3C07F9549000796,11731,8,17,9,36,48,1848
7987,7987,77C71CB0D4F3A8C7B3C07F9549000796,42521,20,21,1,31,47,1597
7991,7991,D88EA2A634C927FE2BD8ECB490F7D727,10292,1,9,8,30,47,1547
7992,7992,D88EA2A634C927FE2BD8ECB490F7D727,40302,12,16,4,40,49,2049
7993,7993,D88EA2A634C927FE2BD8ECB490F7D727,13511,17,20,3,34,48,1748
7994,7994,49EBFFED818B81ED7AB867F150330C08,11911,6,7,1,37,48,1898
7995,7995,49EBFFED818B81ED7AB867F150330C08,12921,9,14,5,9,41,491
7996,7996,49EBFFED818B81ED7AB867F150330C08,10411,16,22,6,36,48,1848
7997,7997,D0819644627AC00B1760F57708B6F7FF,41393,0,3,3,43,49,2199
7998,7998,D0819644627AC00B1760F57708B6F7FF,42461,5,6,1,45,47,2297
7999,7999,D0819644627AC00B1760F57708B6F7FF,41393,10,18,8,43,49,2199
8000,8000,D0819644627AC00B1760F57708B6F7FF,43621,18,19,1,46,48,2348
8001,8001,D0819644627AC00B1760F57708B6F7FF,41393,19,23,4,43,49,2199
8002,8002,5BCDBBB7087A3436009F2DE29ADB0358,10421,0,8,8,41,48,2098
8003,8003,5BCDBBB7087A3436009F2DE29ADB0358,42691,10,12,2,24,48,1248
8004,8004,5BCDBBB7087A3436009F2DE29ADB0358,40691,13,16,3,42,48,2148
8005,8005,5BCDBBB7087A3436009F2DE29ADB0358,10107,18,20,2,38,49,1949
8006,8006,5BCDBBB7087A3436009F2DE29ADB0358,10421,21,22,1,41,48,2098
8010,8010,57EC765DB2F1DB3B77E594E7AA6D8B39,10711,1,11,10,29,46,1496
8011,8011,57EC765DB2F1DB3B77E594E7AA6D8B39,42501,12,13,1,28,47,1447
8012,8012,57EC765DB2F1DB3B77E594E7AA6D8B39,43761,13,18,5,32,47,1647
8013,8013,57EC765DB2F1DB3B77E594E7AA6D8B39,42521,20,21,1,31,47,1597
8014,8014,57EC765DB2F1DB3B77E594E7AA6D8B39,10711,22,23,1,29,46,1496
8015,8015,BBCB9918D42B41DEDF16DD7F5A9BE26F,11861,0,6,6,32,47,1647
8016,8016,BBCB9918D42B41DEDF16DD7F5A9BE26F,42161,6,12,6,36,47,1847
8017,8017,BBCB9918D42B41DEDF16DD7F5A9BE26F,11911,13,17,4,37,48,1898
8018,8018,BBCB9918D42B41DEDF16DD7F5A9BE26F,11861,17,23,6,32,47,1647
8019,8019,078CA2EAFF3076F19C858FC6E3E5D2A6,11081,0,14,14,35,46,1796
8020,8020,078CA2EAFF3076F19C858FC6E3E5D2A6,40341,16,18,2,23,49,1199
8021,8021,078CA2EAFF3076F19C858FC6E3E5D2A6,11081,21,23,2,35,46,1796
8022,8022,5CD91E60AE04D9AB04DFAC1F5D36AFBF,40637,0,7,7,36,47,1847
8023,8023,5CD91E60AE04D9AB04DFAC1F5D36AFBF,40951,10,14,4,36,49,1849
8024,8024,5CD91E60AE04D9AB04DFAC1F5D36AFBF,40341,15,16,1,23,49,1199
8025,8025,5CD91E60AE04D9AB04DFAC1F5D36AFBF,11021,21,23,2,36,49,1849
8026,8026,A345B58C2304F83DF0BAD404D00E0742,42151,2,12,10,35,45,1795
8027,8027,A345B58C2304F83DF0BAD404D00E0742,40341,13,15,2,23,49,1199
8028,8028,A345B58C2304F83DF0BAD404D00E0742,42151,16,18,2,35,45,1795
8029,8029,A345B58C2304F83DF0BAD404D00E0742,10911,21,23,2,39,46,1996
8030,8030,1D5FEB85097765A4DAC299D8A4D17B3D,10951,0,7,7,29,48,1498
8031,8031,1D5FEB85097765A4DAC299D8A4D17B3D,11431,10,11,1,29,47,1497
8032,8032,1D5FEB85097765A4DAC299D8A4D17B3D,10431,12,13,1,33,49,1699
8033,8033,1D5FEB85097765A4DAC299D8A4D17B3D,43311,13,17,4,31,48,1598
8034,8034,1D5FEB85097765A4DAC299D8A4D17B3D,10951,18,23,5,29,48,1498
8035,8035,78DFF6F6292A0DDF324331E63E2B26C2,11521,0,7,7,41,48,2098
8036,8036,78DFF6F6292A0DDF324331E63E2B26C2,11021,7,20,13,36,49,1849
8037,8037,78DFF6F6292A0DDF324331E63E2B26C2,11521,21,23,2,41,48,2098
8038,8038,46E2E10251607E59BAC1F84F8487D62D,12641,0,4,4,10,43,543
8039,8039,46E2E10251607E59BAC1F84F8487D62D,12671,4,5,1,21,43,1093
8040,8040,46E2E10251607E59BAC1F84F8487D62D,19031,6,10,4,1,42,92
8041,8041,46E2E10251607E59BAC1F84F8487D62D,12641,11,14,3,10,43,543
8042,8042,46E2E10251607E59BAC1F84F8487D62D,19031,16,22,6,1,42,92
8050,8050,1AA8F470D04F98B9B304B3DE1B991E4C,10191,0,2,2,40,48,2048
8051,8051,1AA8F470D04F98B9B304B3DE1B991E4C,13791,4,6,2,42,47,2147
8052,8052,1AA8F470D04F98B9B304B3DE1B991E4C,13091,9,10,1,20,42,1042
8053,8053,1AA8F470D04F98B9B304B3DE1B991E4C,13791,11,15,4,42,47,2147
8054,8054,1AA8F470D04F98B9B304B3DE1B991E4C,10491,17,20,3,33,48,1698
8055,8055,1AA8F470D04F98B9B304B3DE1B991E4C,10721,20,23,3,31,48,1598
8056,8056,40A368CA34750DF505DA57A322872C86,12611,0,13,13,41,29,2079
8057,8057,40A368CA34750DF505DA57A322872C86,15411,15,17,2,44,27,2227
8058,8058,40A368CA34750DF505DA57A322872C86,12611,17,23,6,41,29,2079
8059,8059,69835053D5A6F452D437F565F1621320,13791,1,8,7,42,47,2147
8060,8060,69835053D5A6F452D437F565F1621320,10841,9,12,3,37,47,1897
8061,8061,69835053D5A6F452D437F565F1621320,12083,15,16,1,36,49,1849
8062,8062,69835053D5A6F452D437F565F1621320,11231,20,22,2,37,49,1899
8063,8063,33355741ED0AC97461CECC52FEC57FD4,43451,9,10,1,37,40,1890
8064,8064,33355741ED0AC97461CECC52FEC57FD4,42351,12,13,1,38,45,1945
8065,8065,33355741ED0AC97461CECC52FEC57FD4,43451,16,18,2,37,40,1890
8066,8066,33355741ED0AC97461CECC52FEC57FD4,13231,19,20,1,39,46,1996
8067,8067,4C1423685C8C5ED7D39376983854C5AE,42623,0,5,5,22,49,1149
8068,8068,4C1423685C8C5ED7D39376983854C5AE,42081,6,7,1,24,49,1249
8069,8069,4C1423685C8C5ED7D39376983854C5AE,42623,13,19,6,22,49,1149
8070,8070,4C1423685C8C5ED7D39376983854C5AE,42081,20,21,1,24,49,1249
8071,8071,4C1423685C8C5ED7D39376983854C5AE,42623,21,23,2,22,49,1149
8072,8072,F7065DEB6EFDA3755D41B0E87F33EEEE,42351,1,8,7,38,45,1945
8073,8073,F7065DEB6EFDA3755D41B0E87F33EEEE,43731,11,12,1,34,47,1747
8074,8074,F7065DEB6EFDA3755D41B0E87F33EEEE,42351,12,14,2,38,45,1945
8075,8075,F7065DEB6EFDA3755D41B0E87F33EEEE,11261,17,18,1,36,46,1846
8076,8076,F7065DEB6EFDA3755D41B0E87F33EEEE,42351,19,20,1,38,45,1945
8077,8077,D3B019C9CD0C814FB369F01AC2154E50,12311,0,12,12,30,44,1544
8078,8078,D3B019C9CD0C814FB369F01AC2154E50,42401,15,16,1,36,47,1847
8079,8079,D3B019C9CD0C814FB369F01AC2154E50,40951,20,21,1,36,49,1849
8088,8088,587D5F224C01DBFA5DAC05C42B3ABD58,10431,0,1,1,33,49,1699
8089,8089,587D5F224C01DBFA5DAC05C42B3ABD58,42021,2,14,12,33,47,1697
8090,8090,587D5F224C01DBFA5DAC05C42B3ABD58,12521,15,20,5,35,41,1791
8091,8091,587D5F224C01DBFA5DAC05C42B3ABD58,42021,21,23,2,33,47,1697
8092,8092,D3DC370569FB1A17A82A4A92B8E4C021,11001,0,8,8,42,47,2147
8093,8093,D3DC370569FB1A17A82A4A92B8E4C021,10821,10,11,1,40,47,2047
8094,8094,D3DC370569FB1A17A82A4A92B8E4C021,10521,11,13,2,41,47,2097
8095,8095,D3DC370569FB1A17A82A4A92B8E4C021,11001,19,20,1,42,47,2147
8096,8096,D3DC370569FB1A17A82A4A92B8E4C021,11031,21,22,1,42,49,2149
8097,8097,1E478A5FEF40D5F63DF757696B4C9EAC,42871,3,10,7,30,45,1545
8098,8098,1E478A5FEF40D5F63DF757696B4C9EAC,10971,19,20,1,35,47,1797
8099,8099,1E478A5FEF40D5F63DF757696B4C9EAC,13511,21,23,2,34,48,1748
8116,8116,1A250079CB7773B5EF41A4819B5FE42C,40051,0,10,10,32,49,1649
8117,8117,1A250079CB7773B5EF41A4819B5FE42C,42981,11,12,1,36,49,1849
8118,8118,1A250079CB7773B5EF41A4819B5FE42C,40051,12,16,4,32,49,1649
8119,8119,1A250079CB7773B5EF41A4819B5FE42C,11541,17,19,2,35,49,1799
8120,8120,1A250079CB7773B5EF41A4819B5FE42C,12971,19,23,4,32,48,1648
8124,8124,7308A861032DD6CDA204025A180927B9,42371,1,2,1,34,46,1746
8125,8125,7308A861032DD6CDA204025A180927B9,12311,6,18,12,30,44,1544
8126,8126,7308A861032DD6CDA204025A180927B9,11324,19,20,1,31,46,1596
8127,8127,6A4A5A77F646A86F44D17BC3161AA06F,15401,0,1,1,39,25,1975
8128,8128,6A4A5A77F646A86F44D17BC3161AA06F,15091,1,10,9,35,26,1776
8129,8129,6A4A5A77F646A86F44D17BC3161AA06F,15191,11,16,5,36,27,1827
8130,8130,6A4A5A77F646A86F44D17BC3161AA06F,15661,20,23,3,36,26,1826
8131,8131,FED0F32FAD7E2AF3E2C934AA6A661AD7,13671,0,13,13,27,43,1393
8132,8132,FED0F32FAD7E2AF3E2C934AA6A661AD7,10841,14,16,2,37,47,1897
8133,8133,FED0F32FAD7E2AF3E2C934AA6A661AD7,13671,18,23,5,27,43,1393
8134,8134,27FD8A6CDE751A5F2BC12F75826C7985,12641,7,9,2,10,43,543
8135,8135,27FD8A6CDE751A5F2BC12F75826C7985,43021,10,13,3,16,43,843
8136,8136,27FD8A6CDE751A5F2BC12F75826C7985,12641,13,16,3,10,43,543
8137,8137,27FD8A6CDE751A5F2BC12F75826C7985,43021,21,22,1,16,43,843
8145,8145,F1971B0D93358A30C1692731F0AE03C0,42141,10,14,4,32,47,1647
8146,8146,F1971B0D93358A30C1692731F0AE03C0,42381,16,20,4,39,41,1991
8147,8147,F1971B0D93358A30C1692731F0AE03C0,13314,20,22,2,31,39,1589
8148,8148,CB51EA3DFBAD71C46F446085843381F3,15391,0,14,14,35,26,1776
8149,8149,CB51EA3DFBAD71C46F446085843381F3,12792,15,16,1,34,30,1730
8150,8150,CB51EA3DFBAD71C46F446085843381F3,43121,18,20,2,25,27,1277
8151,8151,CB51EA3DFBAD71C46F446085843381F3,15091,20,23,3,35,26,1776
8156,8156,C89DD497B3E25F408D5F4E0FF457EA4C,42583,0,6,6,40,48,2048
8157,8157,C89DD497B3E25F408D5F4E0FF457EA4C,40171,8,9,1,38,48,1948
8158,8158,C89DD497B3E25F408D5F4E0FF457EA4C,42583,11,14,3,40,48,2048
8159,8159,C89DD497B3E25F408D5F4E0FF457EA4C,42581,14,15,1,38,48,1948
8160,8160,C89DD497B3E25F408D5F4E0FF457EA4C,11914,16,17,1,37,48,1898
8161,8161,C89DD497B3E25F408D5F4E0FF457EA4C,42583,19,23,4,40,48,2048
8169,8169,079D8B606B741550F5C3182CF58367EA,10221,0,3,3,34,49,1749
8170,8170,079D8B606B741550F5C3182CF58367EA,11061,6,18,12,29,48,1498
8171,8171,079D8B606B741550F5C3182CF58367EA,40101,21,23,2,34,49,1749
8172,8172,514DFD29F10E23B36E15DBEEFDA55ADD,11875,2,4,2,30,46,1546
8173,8173,514DFD29F10E23B36E15DBEEFDA55ADD,13651,5,8,3,30,47,1547
8174,8174,514DFD29F10E23B36E15DBEEFDA55ADD,10341,10,16,6,31,47,1597
8175,8175,514DFD29F10E23B36E15DBEEFDA55ADD,11324,16,17,1,31,46,1596
8176,8176,514DFD29F10E23B36E15DBEEFDA55ADD,10292,18,19,1,30,47,1547
8181,8181,B6CAA9219981441A23ABBC4BCF8340B1,11291,0,8,8,40,49,2049
8182,8182,B6CAA9219981441A23ABBC4BCF8340B1,10221,16,18,2,34,49,1749
8183,8183,B6CAA9219981441A23ABBC4BCF8340B1,11771,20,23,3,39,49,1999
8188,8188,026400BF77ED9426898CFF8EBE921A19,43751,1,6,5,19,48,998
8189,8189,026400BF77ED9426898CFF8EBE921A19,12581,6,12,6,24,48,1248
8190,8190,026400BF77ED9426898CFF8EBE921A19,43751,13,14,1,19,48,998
8191,8191,026400BF77ED9426898CFF8EBE921A19,12581,15,17,2,24,48,1248
8192,8192,026400BF77ED9426898CFF8EBE921A19,43751,19,20,1,19,48,998
8193,8193,026400BF77ED9426898CFF8EBE921A19,11101,21,22,1,18,48,948
8194,8194,1277ACA424D6A91D4C363B632562549C,10501,1,6,5,22,46,1146
8195,8195,1277ACA424D6A91D4C363B632562549C,42291,8,9,1,29,48,1498
8196,8196,1277ACA424D6A91D4C363B632562549C,12601,11,12,1,25,47,1297
8197,8197,1277ACA424D6A91D4C363B632562549C,10501,12,13,1,22,46,1146
8198,8198,1277ACA424D6A91D4C363B632562549C,12601,14,19,5,25,47,1297
8199,8199,35281B68ACFFF615B0B586BF1E97F668,19101,0,5,5,17,29,879
8200,8200,35281B68ACFFF615B0B586BF1E97F668,19801,7,9,2,19,26,976
8201,8201,35281B68ACFFF615B0B586BF1E97F668,19101,11,23,12,17,29,879
8205,8205,93DD2C863C5AA53C83002ED6F1D5AEBB,12641,2,3,1,10,43,543
8206,8206,93DD2C863C5AA53C83002ED6F1D5AEBB,19031,3,5,2,1,42,92
8207,8207,93DD2C863C5AA53C83002ED6F1D5AEBB,12641,6,7,1,10,43,543
8208,8208,93DD2C863C5AA53C83002ED6F1D5AEBB,12921,7,11,4,9,41,491
8209,8209,93DD2C863C5AA53C83002ED6F1D5AEBB,12641,12,14,2,10,43,543
8210,8210,93DD2C863C5AA53C83002ED6F1D5AEBB,19181,15,17,2,8,40,440
8211,8211,93DD2C863C5AA53C83002ED6F1D5AEBB,19901,21,23,2,7,44,394
8212,8212,C8236143E8B93D5FDE499177CF2B28F7,11381,0,5,5,30,47,1547
8213,8213,C8236143E8B93D5FDE499177CF2B28F7,42861,7,17,10,37,44,1894
8214,8214,C8236143E8B93D5FDE499177CF2B28F7,11381,19,23,4,30,47,1547
8215,8215,BBA244405FCBF580331CF1C7DC28986A,12521,0,4,4,35,41,1791
8216,8216,BBA244405FCBF580331CF1C7DC28986A,12311,9,10,1,30,44,1544
8217,8217,BBA244405FCBF580331CF1C7DC28986A,13314,11,22,11,31,39,1589
8218,8218,2EBC10BAB64948B06839A3FFCF8F4630,19904,1,4,3,9,44,494
8219,8219,2EBC10BAB64948B06839A3FFCF8F4630,19021,5,8,3,10,45,545
8220,8220,2EBC10BAB64948B06839A3FFCF8F4630,12921,10,11,1,9,41,491
8221,8221,2EBC10BAB64948B06839A3FFCF8F4630,19904,12,20,8,9,44,494
8222,8222,2EBC10BAB64948B06839A3FFCF8F4630,19621,21,22,1,5,46,296
8223,8223,7F1A4061B66F38C8A33331487E043D0F,10301,0,3,3,31,45,1595
8224,8224,7F1A4061B66F38C8A33331487E043D0F,13671,3,5,2,27,43,1393
8225,8225,7F1A4061B66F38C8A33331487E043D0F,10301,7,8,1,31,45,1595
8226,8226,7F1A4061B66F38C8A33331487E043D0F,13671,13,16,3,27,43,1393
8227,8227,7F1A4061B66F38C8A33331487E043D0F,10301,20,23,3,31,45,1595
8228,8228,32BD2AF310EFD29A5844E39849D21E0C,13671,0,6,6,27,43,1393
8229,8229,32BD2AF310EFD29A5844E39849D21E0C,12761,7,8,1,25,40,1290
8230,8230,32BD2AF310EFD29A5844E39849D21E0C,13671,12,21,9,27,43,1393
8234,8234,40DFEFDD084B7E6FA138B7FBB6CFBE81,13121,1,8,7,38,46,1946
8235,8235,40DFEFDD084B7E6FA138B7FBB6CFBE81,42381,11,12,1,39,41,1991
8236,8236,40DFEFDD084B7E6FA138B7FBB6CFBE81,10271,21,22,1,37,46,1896
8241,8241,7A89F90274317B23FC53152227A2C065,12921,1,6,5,9,41,491
8242,8242,7A89F90274317B23FC53152227A2C065,49201,10,11,1,7,41,391
8243,8243,7A89F90274317B23FC53152227A2C065,19031,15,17,2,1,42,92
8244,8244,7A89F90274317B23FC53152227A2C065,49201,22,23,1,7,41,391
8245,8245,21578D96674272B155F8382C873AFC6B,11081,0,11,11,35,46,1796
8246,8246,21578D96674272B155F8382C873AFC6B,43241,11,15,4,36,46,1846
8247,8247,21578D96674272B155F8382C873AFC6B,12381,18,20,2,32,48,1648
8248,8248,21578D96674272B155F8382C873AFC6B,11861,20,22,2,32,47,1647
8249,8249,BA13A7062DE028254DE7234CD28475E8,13381,1,9,8,39,47,1997
8250,8250,BA13A7062DE028254DE7234CD28475E8,43721,12,14,2,32,34,1634
8251,8251,BA13A7062DE028254DE7234CD28475E8,13381,16,19,3,39,47,1997
8258,8258,A0B07DBD7CFEABE1E4A0E9444C496CF6,13381,0,7,7,39,47,1997
8259,8259,A0B07DBD7CFEABE1E4A0E9444C496CF6,42271,8,9,1,40,47,2047
8260,8260,A0B07DBD7CFEABE1E4A0E9444C496CF6,13381,10,14,4,39,47,1997
8261,8261,A0B07DBD7CFEABE1E4A0E9444C496CF6,42271,14,17,3,40,47,2047
8262,8262,A0B07DBD7CFEABE1E4A0E9444C496CF6,13381,18,23,5,39,47,1997
8266,8266,C81A008C6A2DF50D7F8D73F324D235D0,19621,0,13,13,5,46,296
8267,8267,C81A008C6A2DF50D7F8D73F324D235D0,19021,17,18,1,10,45,545
8268,8268,C81A008C6A2DF50D7F8D73F324D235D0,19621,19,23,4,5,46,296
8276,8276,14C205DF57BD0AA586E26BE4ED695846,42581,0,8,8,38,48,1948
8277,8277,14C205DF57BD0AA586E26BE4ED695846,11914,10,11,1,37,48,1898
8278,8278,14C205DF57BD0AA586E26BE4ED695846,42581,12,16,4,38,48,1948
8279,8279,14C205DF57BD0AA586E26BE4ED695846,11914,16,18,2,37,48,1898
8280,8280,14C205DF57BD0AA586E26BE4ED695846,42581,19,22,3,38,48,1948
8297,8297,CD1558A461467623497C8E8A3785B0D9,42091,0,7,7,43,46,2196
8298,8298,CD1558A461467623497C8E8A3785B0D9,42461,9,11,2,45,47,2297
8299,8299,CD1558A461467623497C8E8A3785B0D9,42091,12,13,1,43,46,2196
8300,8300,CD1558A461467623497C8E8A3785B0D9,42461,14,15,1,45,47,2297
8301,8301,CD1558A461467623497C8E8A3785B0D9,42091,16,17,1,43,46,2196
8302,8302,CD1558A461467623497C8E8A3785B0D9,42461,17,18,1,45,47,2297
8303,8303,D01B29B4F49282632E2D608AA5299A7E,42151,6,11,5,35,45,1795
8304,8304,D01B29B4F49282632E2D608AA5299A7E,42381,12,14,2,39,41,1991
8305,8305,D01B29B4F49282632E2D608AA5299A7E,42151,15,18,3,35,45,1795
8306,8306,D01B29B4F49282632E2D608AA5299A7E,42381,18,23,5,39,41,1991
8307,8307,BF866CAC6181D104CF2321FFD1D54D90,10292,8,9,1,30,47,1547
8308,8308,BF866CAC6181D104CF2321FFD1D54D90,42521,14,15,1,31,47,1597
8309,8309,BF866CAC6181D104CF2321FFD1D54D90,11201,18,20,2,35,49,1799
8324,8324,5507179083B5F01EF4086E9B59332C6E,42301,0,13,13,36,47,1847
8325,8325,5507179083B5F01EF4086E9B59332C6E,40341,14,18,4,23,49,1199
8326,8326,5507179083B5F01EF4086E9B59332C6E,11631,19,22,3,12,49,649
8327,8327,D75859C5199E26E4E069299921FEC112,43761,2,10,8,32,47,1647
8328,8328,D75859C5199E26E4E069299921FEC112,42921,11,12,1,33,47,1697
8329,8329,D75859C5199E26E4E069299921FEC112,43761,12,14,2,32,47,1647
8330,8330,D75859C5199E26E4E069299921FEC112,40341,17,19,2,23,49,1199
8331,8331,EB693B6F0535EF64BAF5D2EED3BE6375,42921,0,8,8,33,47,1697
8332,8332,EB693B6F0535EF64BAF5D2EED3BE6375,13231,12,14,2,39,46,1996
8333,8333,EB693B6F0535EF64BAF5D2EED3BE6375,40341,16,18,2,23,49,1199
8334,8334,EB693B6F0535EF64BAF5D2EED3BE6375,42921,21,23,2,33,47,1697
8335,8335,44AA91905A7E8DBC24B0A51CC88C9204,42151,0,4,4,35,45,1795
8336,8336,44AA91905A7E8DBC24B0A51CC88C9204,12311,6,9,3,30,44,1544
8337,8337,44AA91905A7E8DBC24B0A51CC88C9204,42151,12,14,2,35,45,1795
8338,8338,44AA91905A7E8DBC24B0A51CC88C9204,12311,16,18,2,30,44,1544
8339,8339,44AA91905A7E8DBC24B0A51CC88C9204,42151,19,22,3,35,45,1795
8355,8355,6C0E943C8B3CE3071E466B3888DE833C,42531,6,8,2,31,45,1595
8356,8356,6C0E943C8B3CE3071E466B3888DE833C,12311,8,12,4,30,44,1544
8357,8357,6C0E943C8B3CE3071E466B3888DE833C,42531,13,18,5,31,45,1595
8358,8358,6C0E943C8B3CE3071E466B3888DE833C,19744,18,21,3,6,43,343
8362,8362,03D6FFA8E0742D0181BD0480CCE1246D,42511,0,7,7,37,47,1897
8363,8363,03D6FFA8E0742D0181BD0480CCE1246D,13911,8,9,1,39,46,1996
8364,8364,03D6FFA8E0742D0181BD0480CCE1246D,10651,13,14,1,36,49,1849
8365,8365,03D6FFA8E0742D0181BD0480CCE1246D,42511,20,21,1,37,47,1897
8366,8366,03D6FFA8E0742D0181BD0480CCE1246D,40637,22,23,1,36,47,1847
8367,8367,3821B66A00758CF4502F36B7CE2D17D9,12491,0,1,1,36,43,1843
8368,8368,3821B66A00758CF4502F36B7CE2D17D9,43451,2,3,1,37,40,1890
8369,8369,3821B66A00758CF4502F36B7CE2D17D9,13071,3,5,2,41,41,2091
8370,8370,3821B66A00758CF4502F36B7CE2D17D9,43451,5,7,2,37,40,1890
8371,8371,3821B66A00758CF4502F36B7CE2D17D9,12491,7,19,12,36,43,1843
8372,8372,D278A78B03015D942733A0F36181B50F,43041,0,7,7,41,46,2096
8373,8373,D278A78B03015D942733A0F36181B50F,10431,8,19,11,33,49,1699
8374,8374,D278A78B03015D942733A0F36181B50F,43041,21,23,2,41,46,2096
8375,8375,E8E9D7FFA16E2A5F20F0A6E4D68711FF,11104,0,1,1,17,47,897
8376,8376,E8E9D7FFA16E2A5F20F0A6E4D68711FF,43751,4,5,1,19,48,998
8377,8377,E8E9D7FFA16E2A5F20F0A6E4D68711FF,12581,7,22,15,24,48,1248
8385,8385,89313D14D4AEEAD368F822E4A0AA83FD,42041,0,3,3,10,47,547
8386,8386,89313D14D4AEEAD368F822E4A0AA83FD,19441,6,9,3,8,46,446
8387,8387,89313D14D4AEEAD368F822E4A0AA83FD,42041,11,13,2,10,47,547
8388,8388,89313D14D4AEEAD368F822E4A0AA83FD,19441,15,18,3,8,46,446
8389,8389,89313D14D4AEEAD368F822E4A0AA83FD,42041,20,21,1,10,47,547
8390,8390,BA6D45213D52989026A398B5D7995374,43644,0,2,2,14,38,738
8391,8391,BA6D45213D52989026A398B5D7995374,49201,3,5,2,7,41,391
8392,8392,BA6D45213D52989026A398B5D7995374,12921,6,10,4,9,41,491
8393,8393,BA6D45213D52989026A398B5D7995374,43644,13,15,2,14,38,738
8394,8394,BA6D45213D52989026A398B5D7995374,19181,16,19,3,8,40,440
8395,8395,D88F49E3B11A4CFA62D4C72B8E1291C0,11521,0,6,6,41,48,2098
8396,8396,D88F49E3B11A4CFA62D4C72B8E1291C0,11751,12,13,1,35,48,1798
8397,8397,D88F49E3B11A4CFA62D4C72B8E1291C0,40951,15,16,1,36,49,1849
8398,8398,D88F49E3B11A4CFA62D4C72B8E1291C0,11521,18,23,5,41,48,2098
8403,8403,6B233920E3ADCD98186EA0225BEE346B,11861,0,18,18,32,47,1647
8404,8404,6B233920E3ADCD98186EA0225BEE346B,11741,19,21,2,42,49,2149
8405,8405,6B233920E3ADCD98186EA0225BEE346B,10801,22,23,1,42,47,2147
8406,8406,A5A342C5B79B8AEE00BA80AE678B8EC5,42331,0,14,14,39,46,1996
8407,8407,A5A342C5B79B8AEE00BA80AE678B8EC5,11151,15,18,3,30,48,1548
8408,8408,A5A342C5B79B8AEE00BA80AE678B8EC5,10331,19,23,4,39,46,1996
8409,8409,B83BCE458ADDCFED4DD9A769B8669EC2,43731,0,1,1,34,47,1747
8410,8410,B83BCE458ADDCFED4DD9A769B8669EC2,41551,2,7,5,37,46,1896
8411,8411,B83BCE458ADDCFED4DD9A769B8669EC2,13671,8,9,1,27,43,1393
8412,8412,B83BCE458ADDCFED4DD9A769B8669EC2,11781,12,16,4,38,49,1949
8413,8413,B83BCE458ADDCFED4DD9A769B8669EC2,40691,17,18,1,42,48,2148
8414,8414,06447D7C67D558233065F1766A844E28,13411,0,1,1,49,42,2492
8415,8415,06447D7C67D558233065F1766A844E28,43951,1,2,1,49,41,2491
8416,8416,06447D7C67D558233065F1766A844E28,13411,2,10,8,49,42,2492
8417,8417,06447D7C67D558233065F1766A844E28,43951,10,12,2,49,41,2491
8418,8418,06447D7C67D558233065F1766A844E28,13411,12,14,2,49,42,2492
8419,8419,06447D7C67D558233065F1766A844E28,43951,14,16,2,49,41,2491
8420,8420,06447D7C67D558233065F1766A844E28,13411,17,21,4,49,42,2492
8421,8421,06447D7C67D558233065F1766A844E28,43951,22,23,1,49,41,2491
8425,8425,48BFDAC45FFDDC1EE0721263D1AD77D7,42511,0,6,6,37,47,1897
8426,8426,48BFDAC45FFDDC1EE0721263D1AD77D7,10107,8,9,1,38,49,1949
8427,8427,48BFDAC45FFDDC1EE0721263D1AD77D7,10251,15,17,2,35,47,1797
8428,8428,48BFDAC45FFDDC1EE0721263D1AD77D7,42461,19,20,1,45,47,2297
8429,8429,48BFDAC45FFDDC1EE0721263D1AD77D7,10841,21,23,2,37,47,1897
8430,8430,5FA17670CF7B34EAE6DE8FBA5C753F49,11551,10,11,1,39,49,1999
8431,8431,5FA17670CF7B34EAE6DE8FBA5C753F49,40341,12,14,2,23,49,1199
8432,8432,5FA17670CF7B34EAE6DE8FBA5C753F49,11491,15,17,2,36,47,1847
8433,8433,5FA17670CF7B34EAE6DE8FBA5C753F49,12661,20,23,3,32,45,1645
8434,8434,F1B018296E8ED57E3EC7BBC1652329B6,12521,0,6,6,35,41,1791
8435,8435,F1B018296E8ED57E3EC7BBC1652329B6,13041,6,7,1,30,37,1537
8436,8436,F1B018296E8ED57E3EC7BBC1652329B6,12521,7,23,16,35,41,1791
8437,8437,2DDB60F9B283A15F9C74B796D02976EA,10221,10,13,3,34,49,1749
8438,8438,2DDB60F9B283A15F9C74B796D02976EA,11201,14,17,3,35,49,1799
8439,8439,2DDB60F9B283A15F9C74B796D02976EA,13471,19,20,1,47,49,2399
8440,8440,2DDB60F9B283A15F9C74B796D02976EA,10221,20,23,3,34,49,1749
8444,8444,3FE81F655F604A04C1DE04F180E9A11A,19021,0,6,6,10,45,545
8445,8445,3FE81F655F604A04C1DE04F180E9A11A,12921,9,10,1,9,41,491
8446,8446,3FE81F655F604A04C1DE04F180E9A11A,19021,13,16,3,10,45,545
8447,8447,3FE81F655F604A04C1DE04F180E9A11A,19744,20,22,2,6,43,343
8455,8455,BA20AB589050C3413ABFF181CD940740,10471,0,12,12,37,48,1898
8456,8456,BA20AB589050C3413ABFF181CD940740,40341,16,20,4,23,49,1199
8457,8457,BA20AB589050C3413ABFF181CD940740,10471,21,23,2,37,48,1898
8461,8461,565E911568BF499034CE3AB0C1F32A25,11941,0,4,4,37,46,1896
8462,8462,565E911568BF499034CE3AB0C1F32A25,43101,7,16,9,46,40,2340
8463,8463,565E911568BF499034CE3AB0C1F32A25,42231,19,23,4,37,46,1896
8470,8470,9F40B3D85B5B187AC3E43FCFCE8AC0B8,13671,3,14,11,27,43,1393
8471,8471,9F40B3D85B5B187AC3E43FCFCE8AC0B8,12671,14,15,1,21,43,1093
8472,8472,9F40B3D85B5B187AC3E43FCFCE8AC0B8,13671,16,23,7,27,43,1393
8473,8473,111CDDD5FA2E313735C2BD7B109AA3EE,42151,5,16,11,35,45,1795
8474,8474,111CDDD5FA2E313735C2BD7B109AA3EE,40341,17,18,1,23,49,1199
8475,8475,111CDDD5FA2E313735C2BD7B109AA3EE,42861,19,20,1,37,44,1894
8476,8476,111CDDD5FA2E313735C2BD7B109AA3EE,42151,21,22,1,35,45,1795
8477,8477,FB55B20B748C0A1CF26B4BE2B509424A,12731,0,6,6,22,40,1140
8478,8478,FB55B20B748C0A1CF26B4BE2B509424A,13671,7,10,3,27,43,1393
8479,8479,FB55B20B748C0A1CF26B4BE2B509424A,12761,12,14,2,25,40,1290
8480,8480,FB55B20B748C0A1CF26B4BE2B509424A,13671,19,20,1,27,43,1393
8481,8481,FB55B20B748C0A1CF26B4BE2B509424A,12761,20,22,2,25,40,1290
8485,8485,653984DE3233D4AFAF389C1902BDCACD,12561,0,6,6,45,43,2293
8486,8486,653984DE3233D4AFAF389C1902BDCACD,12211,11,19,8,41,44,2094
8487,8487,653984DE3233D4AFAF389C1902BDCACD,12561,19,21,2,45,43,2293
8488,8488,2FB9B4671D70EAA841884AE3AD828EC1,13111,1,2,1,42,46,2146
8489,8489,2FB9B4671D70EAA841884AE3AD828EC1,13341,2,9,7,44,45,2245
8490,8490,2FB9B4671D70EAA841884AE3AD828EC1,11061,12,17,5,29,48,1498
8491,8491,2FB9B4671D70EAA841884AE3AD828EC1,13341,19,22,3,44,45,2245
8492,8492,98029F333AC5519D4BA1B7A7F8079304,41721,0,7,7,39,48,1998
8493,8493,98029F333AC5519D4BA1B7A7F8079304,10721,9,12,3,31,48,1598
8494,8494,98029F333AC5519D4BA1B7A7F8079304,41721,12,14,2,39,48,1998
8495,8495,98029F333AC5519D4BA1B7A7F8079304,10431,19,20,1,33,49,1699
8496,8496,98029F333AC5519D4BA1B7A7F8079304,41721,21,23,2,39,48,1998
8497,8497,5F17942389EDB952EA52D3EC24EE812F,10341,0,12,12,31,47,1597
8498,8498,5F17942389EDB952EA52D3EC24EE812F,12514,13,16,3,38,47,1947
8499,8499,5F17942389EDB952EA52D3EC24EE812F,10341,17,23,6,31,47,1597
8503,8503,C6A8E88AF4FAB8E3B900B709C1644500,10251,0,1,1,35,47,1797
8504,8504,C6A8E88AF4FAB8E3B900B709C1644500,10411,1,8,7,36,48,1848
8505,8505,C6A8E88AF4FAB8E3B900B709C1644500,12841,11,12,1,37,47,1897
8506,8506,C6A8E88AF4FAB8E3B900B709C1644500,10151,16,18,2,34,47,1747
8507,8507,C6A8E88AF4FAB8E3B900B709C1644500,12971,20,21,1,32,48,1648
8508,8508,C6A8E88AF4FAB8E3B900B709C1644500,42961,21,23,2,35,49,1799
8509,8509,BD7A9B1FFC762DBCDB1D1EDCF09AE427,42031,0,2,2,40,46,2046
8510,8510,BD7A9B1FFC762DBCDB1D1EDCF09AE427,13941,3,8,5,41,47,2097
8511,8511,BD7A9B1FFC762DBCDB1D1EDCF09AE427,11001,11,13,2,42,47,2147
8512,8512,BD7A9B1FFC762DBCDB1D1EDCF09AE427,13941,13,15,2,41,47,2097
8513,8513,BD7A9B1FFC762DBCDB1D1EDCF09AE427,40697,19,21,2,43,48,2198
8514,8514,A4B13605C78797589D9B98BC8787EDD0,12641,0,3,3,10,43,543
8515,8515,A4B13605C78797589D9B98BC8787EDD0,19031,4,5,1,1,42,92
8516,8516,A4B13605C78797589D9B98BC8787EDD0,19931,8,20,12,7,43,393
8517,8517,E1B13C10C70559CA0D05219029F29CFC,13341,4,9,5,44,45,2245
8518,8518,E1B13C10C70559CA0D05219029F29CFC,42161,13,14,1,36,47,1847
8519,8519,E1B13C10C70559CA0D05219029F29CFC,13341,16,21,5,44,45,2245
8520,8520,C1C9B221745BFCA4CC927246B51B8DF9,10121,0,11,11,36,49,1849
8521,8521,C1C9B221745BFCA4CC927246B51B8DF9,10681,12,15,3,30,48,1548
8522,8522,C1C9B221745BFCA4CC927246B51B8DF9,10121,19,23,4,36,49,1849
8523,8523,D9BD529C15B6C1C3809A564D34B0E0F2,10061,0,6,6,20,46,1046
8524,8524,D9BD529C15B6C1C3809A564D34B0E0F2,12601,7,9,2,25,47,1297
8525,8525,D9BD529C15B6C1C3809A564D34B0E0F2,10061,9,10,1,20,46,1046
8526,8526,D9BD529C15B6C1C3809A564D34B0E0F2,10501,12,14,2,22,46,1146
8527,8527,D9BD529C15B6C1C3809A564D34B0E0F2,10061,14,23,9,20,46,1046
8528,8528,5D77C455155C654440C1FABC6822DC8C,11301,0,6,6,41,49,2099
8529,8529,5D77C455155C654440C1FABC6822DC8C,10716,11,21,10,30,46,1546
8530,8530,5D77C455155C654440C1FABC6822DC8C,11301,21,22,1,41,49,2099
8531,8531,ABBC15AEF4378BFD8D5F602AE997A519,11381,0,9,9,30,47,1547
8532,8532,ABBC15AEF4378BFD8D5F602AE997A519,11531,12,13,1,34,49,1749
8533,8533,ABBC15AEF4378BFD8D5F602AE997A519,11381,17,23,6,30,47,1547
8534,8534,AA71E9A6AEA764D2564D532D0321512B,42041,0,6,6,10,47,547
8535,8535,AA71E9A6AEA764D2564D532D0321512B,19441,7,12,5,8,46,446
8536,8536,AA71E9A6AEA764D2564D532D0321512B,11571,12,13,1,13,46,696
8537,8537,AA71E9A6AEA764D2564D532D0321512B,19441,13,16,3,8,46,446
8538,8538,AA71E9A6AEA764D2564D532D0321512B,11571,19,20,1,13,46,696
8539,8539,AA71E9A6AEA764D2564D532D0321512B,42041,21,22,1,10,47,547
8540,8540,803884DAE228D36B780CDE250AFE5FD1,13711,0,8,8,38,46,1946
8541,8541,803884DAE228D36B780CDE250AFE5FD1,12391,10,11,1,36,49,1849
8542,8542,803884DAE228D36B780CDE250AFE5FD1,13711,13,23,10,38,46,1946
8543,8543,FE81E42864EDDDA28517F901264CA3C6,12514,0,8,8,38,47,1947
8544,8544,FE81E42864EDDDA28517F901264CA3C6,40341,10,19,9,23,49,1199
8545,8545,FE81E42864EDDDA28517F901264CA3C6,12511,21,22,1,39,47,1997
8546,8546,644074FAED2D07B771DBBC3C2ED7ABF4,13411,0,6,6,49,42,2492
8547,8547,644074FAED2D07B771DBBC3C2ED7ABF4,43951,7,8,1,49,41,2491
8548,8548,644074FAED2D07B771DBBC3C2ED7ABF4,13411,12,13,1,49,42,2492
8549,8549,644074FAED2D07B771DBBC3C2ED7ABF4,43951,15,19,4,49,41,2491
8550,8550,644074FAED2D07B771DBBC3C2ED7ABF4,13411,21,22,1,49,42,2492
8551,8551,43DBC097DABD3DD07A95B28C32F20D40,13371,0,7,7,41,47,2097
8552,8552,43DBC097DABD3DD07A95B28C32F20D40,42801,7,9,2,40,49,2049
8553,8553,43DBC097DABD3DD07A95B28C32F20D40,13371,12,14,2,41,47,2097
8554,8554,43DBC097DABD3DD07A95B28C32F20D40,40691,18,20,2,42,48,2148
8555,8555,43DBC097DABD3DD07A95B28C32F20D40,13371,22,23,1,41,47,2097
8556,8556,F0C853BC0C5214D6B512154041EF8C01,42321,0,8,8,43,47,2197
8557,8557,F0C853BC0C5214D6B512154041EF8C01,11351,10,12,2,36,48,1848
8558,8558,F0C853BC0C5214D6B512154041EF8C01,42321,13,14,1,43,47,2197
8559,8559,F0C853BC0C5214D6B512154041EF8C01,10411,18,20,2,36,48,1848
8560,8560,F0C853BC0C5214D6B512154041EF8C01,40491,21,22,1,39,49,1999
8561,8561,AA51DE94270AE4663B2578A38D4EECC9,13961,0,7,7,42,48,2148
8562,8562,AA51DE94270AE4663B2578A38D4EECC9,11914,8,11,3,37,48,1898
8563,8563,AA51DE94270AE4663B2578A38D4EECC9,13961,12,23,11,42,48,2148
8571,8571,394D700E14C58A7853C10805B183B24E,11061,2,3,1,29,48,1498
8572,8572,394D700E14C58A7853C10805B183B24E,11381,3,6,3,30,47,1547
8573,8573,394D700E14C58A7853C10805B183B24E,11875,8,12,4,30,46,1546
8574,8574,394D700E14C58A7853C10805B183B24E,12311,13,14,1,30,44,1544
8575,8575,394D700E14C58A7853C10805B183B24E,11871,14,17,3,29,46,1496
8576,8576,394D700E14C58A7853C10805B183B24E,11381,18,19,1,30,47,1547
8583,8583,AD3EDA3142ED65E7DCEA2ECC9D2EC5AC,12641,0,3,3,10,43,543
8584,8584,AD3EDA3142ED65E7DCEA2ECC9D2EC5AC,19181,3,16,13,8,40,440
8585,8585,AD3EDA3142ED65E7DCEA2ECC9D2EC5AC,12641,18,21,3,10,43,543
8592,8592,D1D02DF9C1212407C948C37939001BC3,42531,6,8,2,31,45,1595
8593,8593,D1D02DF9C1212407C948C37939001BC3,12661,8,9,1,32,45,1645
8594,8594,D1D02DF9C1212407C948C37939001BC3,42531,9,11,2,31,45,1595
8595,8595,D1D02DF9C1212407C948C37939001BC3,13671,12,23,11,27,43,1393
8612,8612,E0E4B5D4D4CD8E175B5DFCE30492C24D,13711,0,7,7,38,46,1946
8613,8613,E0E4B5D4D4CD8E175B5DFCE30492C24D,40341,9,10,1,23,49,1199
8614,8614,E0E4B5D4D4CD8E175B5DFCE30492C24D,11481,13,14,1,41,48,2098
8615,8615,E0E4B5D4D4CD8E175B5DFCE30492C24D,13711,16,21,5,38,46,1946
8616,8616,6EF69708DD923556D4EF232AA0406F1C,11941,0,6,6,37,46,1896
8617,8617,6EF69708DD923556D4EF232AA0406F1C,42351,8,11,3,38,45,1945
8618,8618,6EF69708DD923556D4EF232AA0406F1C,11941,12,15,3,37,46,1896
8619,8619,6EF69708DD923556D4EF232AA0406F1C,42351,16,17,1,38,45,1945
8620,8620,6EF69708DD923556D4EF232AA0406F1C,11941,19,22,3,37,46,1896
8621,8621,6313E6A742098F61EEF977759F6EF549,11061,0,8,8,29,48,1498
8622,8622,6313E6A742098F61EEF977759F6EF549,11431,10,12,2,29,47,1497
8623,8623,6313E6A742098F61EEF977759F6EF549,10251,15,23,8,35,47,1797
8630,8630,E18F8AF2EB337B6D11E725D7DF22D1D9,10111,0,14,14,37,47,1897
8631,8631,E18F8AF2EB337B6D11E725D7DF22D1D9,42523,19,20,1,31,47,1597
8632,8632,E18F8AF2EB337B6D11E725D7DF22D1D9,43761,21,22,1,32,47,1647
8636,8636,69F41107244EDDE97DD1AAB2D554177A,12871,0,7,7,22,33,1133
8637,8637,69F41107244EDDE97DD1AAB2D554177A,19281,12,13,1,16,32,832
8638,8638,69F41107244EDDE97DD1AAB2D554177A,10151,17,19,2,34,47,1747
8639,8639,69F41107244EDDE97DD1AAB2D554177A,19281,20,23,3,16,32,832
8649,8649,6164F469738A30A14CD373EB73D02471,11801,0,7,7,42,48,2148
8650,8650,6164F469738A30A14CD373EB73D02471,11211,8,11,3,34,49,1749
8651,8651,6164F469738A30A14CD373EB73D02471,10331,12,13,1,39,46,1996
8652,8652,6164F469738A30A14CD373EB73D02471,11211,15,18,3,34,49,1749
8653,8653,6164F469738A30A14CD373EB73D02471,11801,21,23,2,42,48,2148
8654,8654,091497AD7ED956A0C3F93F46CFB651F5,10107,0,6,6,38,49,1949
8655,8655,091497AD7ED956A0C3F93F46CFB651F5,19261,9,11,2,6,37,337
8656,8656,091497AD7ED956A0C3F93F46CFB651F5,43021,12,13,1,16,43,843
8657,8657,091497AD7ED956A0C3F93F46CFB651F5,12921,14,15,1,9,41,491
8658,8658,091497AD7ED956A0C3F93F46CFB651F5,43021,17,18,1,16,43,843
8659,8659,ABC9186267E71F28FA785B0F903DDD72,10471,0,8,8,37,48,1898
8660,8660,ABC9186267E71F28FA785B0F903DDD72,11811,8,10,2,38,49,1949
8661,8661,ABC9186267E71F28FA785B0F903DDD72,10471,10,13,3,37,48,1898
8662,8662,ABC9186267E71F28FA785B0F903DDD72,11811,13,14,1,38,49,1949
8663,8663,ABC9186267E71F28FA785B0F903DDD72,10471,15,18,3,37,48,1898
8664,8664,ABC9186267E71F28FA785B0F903DDD72,40171,19,21,2,38,48,1948
8672,8672,5ECDAA2EB4652040809B2B1EAC7A3195,13331,5,6,1,38,47,1947
8673,8673,5ECDAA2EB4652040809B2B1EAC7A3195,10331,7,8,1,39,46,1996
8674,8674,5ECDAA2EB4652040809B2B1EAC7A3195,40341,8,10,2,23,49,1199
8675,8675,5ECDAA2EB4652040809B2B1EAC7A3195,13331,16,18,2,38,47,1947
8676,8676,5ECDAA2EB4652040809B2B1EAC7A3195,10471,19,21,2,37,48,1898
8677,8677,5ECDAA2EB4652040809B2B1EAC7A3195,42161,21,23,2,36,47,1847
8686,8686,DC108CA51A8D783261AB9156C36F59F1,10351,3,4,1,28,45,1445
8687,8687,DC108CA51A8D783261AB9156C36F59F1,12601,4,22,18,25,47,1297
8688,8688,DC108CA51A8D783261AB9156C36F59F1,12671,22,23,1,21,43,1093
8689,8689,A923C41770F47C64367C4A31C06C83C7,10292,4,9,5,30,47,1547
8690,8690,A923C41770F47C64367C4A31C06C83C7,42523,13,15,2,31,47,1597
8691,8691,A923C41770F47C64367C4A31C06C83C7,42491,16,17,1,32,46,1646
8692,8692,A923C41770F47C64367C4A31C06C83C7,13561,19,22,3,37,49,1899
8693,8693,119196C18578341D0084AF6B48A62632,19741,10,11,1,5,44,294
8694,8694,119196C18578341D0084AF6B48A62632,12641,21,22,1,10,43,543
8695,8695,119196C18578341D0084AF6B48A62632,19114,22,23,1,7,43,393
8699,8699,6C2D4CD6D85FE617D987108263F4FB2E,10301,2,7,5,31,45,1595
8700,8700,6C2D4CD6D85FE617D987108263F4FB2E,10351,7,9,2,28,45,1445
8701,8701,6C2D4CD6D85FE617D987108263F4FB2E,10301,13,14,1,31,45,1595
8702,8702,6C2D4CD6D85FE617D987108263F4FB2E,10351,14,16,2,28,45,1445
8703,8703,6C2D4CD6D85FE617D987108263F4FB2E,10301,17,19,2,31,45,1595
8704,8704,6C2D4CD6D85FE617D987108263F4FB2E,10381,19,21,2,31,49,1599
8705,8705,1DA79481C6B6D1D9223A378A0D81757A,10111,0,8,8,37,47,1897
8706,8706,1DA79481C6B6D1D9223A378A0D81757A,40882,9,17,8,34,49,1749
8707,8707,1DA79481C6B6D1D9223A378A0D81757A,40637,18,23,5,36,47,1847
8708,8708,C187943D20D187183526E0228C45660E,11021,0,8,8,36,49,1849
8709,8709,C187943D20D187183526E0228C45660E,40034,12,16,4,32,48,1648
8710,8710,C187943D20D187183526E0228C45660E,11021,17,23,6,36,49,1849
8711,8711,91C5B3238A8419D0CA530F7A4D0E4118,42633,0,8,8,42,46,2146
8712,8712,91C5B3238A8419D0CA530F7A4D0E4118,11781,11,16,5,38,49,1949
8713,8713,91C5B3238A8419D0CA530F7A4D0E4118,13141,18,21,3,23,30,1180
8714,8714,91C5B3238A8419D0CA530F7A4D0E4118,12491,22,23,1,36,43,1843
8715,8715,FD7105C12E91B42B4F2E50C95FDBDCF6,11331,0,6,6,37,48,1898
8716,8716,FD7105C12E91B42B4F2E50C95FDBDCF6,12083,7,10,3,36,49,1849
8717,8717,FD7105C12E91B42B4F2E50C95FDBDCF6,11911,11,13,2,37,48,1898
8718,8718,FD7105C12E91B42B4F2E50C95FDBDCF6,11231,15,18,3,37,49,1899
8719,8719,FD7105C12E91B42B4F2E50C95FDBDCF6,11911,18,22,4,37,48,1898
8720,8720,6E14D0E93CFE5E8B8CCB16C998A46287,11151,0,7,7,30,48,1548
8721,8721,6E14D0E93CFE5E8B8CCB16C998A46287,40341,8,9,1,23,49,1199
8722,8722,6E14D0E93CFE5E8B8CCB16C998A46287,11151,15,17,2,30,48,1548
8723,8723,6E14D0E93CFE5E8B8CCB16C998A46287,11061,20,23,3,29,48,1498
8724,8724,BF7FFA6FFA5EC12886C40D23DEBE66EE,13221,8,12,4,40,47,2047
8725,8725,BF7FFA6FFA5EC12886C40D23DEBE66EE,40341,15,18,3,23,49,1199
8726,8726,BF7FFA6FFA5EC12886C40D23DEBE66EE,13221,19,23,4,40,47,2047
8727,8727,E9E990F48245ACFDBDC8F1C95015FE95,42301,0,8,8,36,47,1847
8728,8728,E9E990F48245ACFDBDC8F1C95015FE95,13121,8,9,1,38,46,1946
8729,8729,E9E990F48245ACFDBDC8F1C95015FE95,42301,13,15,2,36,47,1847
8730,8730,E9E990F48245ACFDBDC8F1C95015FE95,10681,18,19,1,30,48,1548
8731,8731,E9E990F48245ACFDBDC8F1C95015FE95,42301,21,22,1,36,47,1847
8736,8736,DC11B465805E4B821937065119204055,12491,0,1,1,36,43,1843
8737,8737,DC11B465805E4B821937065119204055,12311,2,9,7,30,44,1544
8738,8738,DC11B465805E4B821937065119204055,42151,11,21,10,35,45,1795
8745,8745,C5ED324891B8B95E257970408E8D4150,12491,0,6,6,36,43,1843
8746,8746,C5ED324891B8B95E257970408E8D4150,13911,9,11,2,39,46,1996
8747,8747,C5ED324891B8B95E257970408E8D4150,11261,15,21,6,36,46,1846
8748,8748,C5ED324891B8B95E257970408E8D4150,12491,22,23,1,36,43,1843
8755,8755,F681B79833B44C7DE260E9A55ED030A3,19741,0,5,5,5,44,294
8756,8756,F681B79833B44C7DE260E9A55ED030A3,19111,6,11,5,9,45,495
8757,8757,F681B79833B44C7DE260E9A55ED030A3,19741,13,14,1,5,44,294
8758,8758,F681B79833B44C7DE260E9A55ED030A3,19111,14,17,3,9,45,495
8759,8759,F681B79833B44C7DE260E9A55ED030A3,19741,20,23,3,5,44,294
8760,8760,FEE5ACDB24DFF6E9A25C550C618C43AE,10251,0,4,4,35,47,1797
8761,8761,FEE5ACDB24DFF6E9A25C550C618C43AE,40673,9,12,3,36,48,1848
8762,8762,FEE5ACDB24DFF6E9A25C550C618C43AE,10251,13,14,1,35,47,1797
8763,8763,FEE5ACDB24DFF6E9A25C550C618C43AE,10901,15,16,1,35,48,1798
8764,8764,FEE5ACDB24DFF6E9A25C550C618C43AE,10251,17,23,6,35,47,1797
8765,8765,3E1FC4D135BB13FEB2589C9806D420B1,42581,1,5,4,38,48,1948
8766,8766,3E1FC4D135BB13FEB2589C9806D420B1,11914,7,11,4,37,48,1898
8767,8767,3E1FC4D135BB13FEB2589C9806D420B1,42581,12,13,1,38,48,1948
8768,8768,3E1FC4D135BB13FEB2589C9806D420B1,11914,14,19,5,37,48,1898
8769,8769,3E1FC4D135BB13FEB2589C9806D420B1,42581,20,23,3,38,48,1948
8779,8779,876FECEB4E00230F43BDE8608E6A168E,42321,0,7,7,43,47,2197
8780,8780,876FECEB4E00230F43BDE8608E6A168E,10161,10,16,6,35,49,1799
8781,8781,876FECEB4E00230F43BDE8608E6A168E,42321,17,18,1,43,47,2197
8793,8793,070CCFB95BD7B5493FC205585FDC7AC9,13341,0,6,6,44,45,2245
8794,8794,070CCFB95BD7B5493FC205585FDC7AC9,42631,7,8,1,43,45,2195
8795,8795,070CCFB95BD7B5493FC205585FDC7AC9,13341,8,9,1,44,45,2245
8796,8796,070CCFB95BD7B5493FC205585FDC7AC9,42631,15,22,7,43,45,2195
8797,8797,070CCFB95BD7B5493FC205585FDC7AC9,13341,22,23,1,44,45,2245
8798,8798,B91911A8552538AFFDA41E3648A8C009,13651,5,7,2,30,47,1547
8799,8799,B91911A8552538AFFDA41E3648A8C009,10951,8,9,1,29,48,1498
8800,8800,B91911A8552538AFFDA41E3648A8C009,11381,12,14,2,30,47,1547
8801,8801,B91911A8552538AFFDA41E3648A8C009,40941,18,19,1,32,48,1648
8802,8802,B91911A8552538AFFDA41E3648A8C009,11381,21,22,1,30,47,1547
8809,8809,E51EE41655D386174398555E16D6604B,12381,0,8,8,32,48,1648
8810,8810,E51EE41655D386174398555E16D6604B,10721,12,14,2,31,48,1598
8811,8811,E51EE41655D386174398555E16D6604B,10634,15,16,1,27,45,1395
8812,8812,E51EE41655D386174398555E16D6604B,12311,18,21,3,30,44,1544
8813,8813,8AEC3F43D5D83F5BD682D6C5D7D41196,42031,0,6,6,40,46,2046
8814,8814,8AEC3F43D5D83F5BD682D6C5D7D41196,40171,7,11,4,38,48,1948
8815,8815,8AEC3F43D5D83F5BD682D6C5D7D41196,42331,12,13,1,39,46,1996
8816,8816,8AEC3F43D5D83F5BD682D6C5D7D41196,40171,14,18,4,38,48,1948
8817,8817,8AEC3F43D5D83F5BD682D6C5D7D41196,42331,21,23,2,39,46,1996
8818,8818,6B614428F8D95ECFDE2207017437E97D,19281,0,2,2,16,32,832
8819,8819,6B614428F8D95ECFDE2207017437E97D,12871,2,5,3,22,33,1133
8820,8820,6B614428F8D95ECFDE2207017437E97D,19281,7,9,2,16,32,832
8821,8821,6B614428F8D95ECFDE2207017437E97D,12871,11,17,6,22,33,1133
8822,8822,6B614428F8D95ECFDE2207017437E97D,19281,22,23,1,16,32,832
8823,8823,F8A2EC8C9348BFB1362087B807B825C5,43971,0,4,4,30,48,1548
8824,8824,F8A2EC8C9348BFB1362087B807B825C5,40271,8,15,7,35,49,1799
8825,8825,F8A2EC8C9348BFB1362087B807B825C5,11381,17,19,2,30,47,1547
8826,8826,F8A2EC8C9348BFB1362087B807B825C5,43971,22,23,1,30,48,1548
8827,8827,9F541427977446D96030A544BAE61896,10221,0,6,6,34,49,1749
8828,8828,9F541427977446D96030A544BAE61896,11301,7,9,2,41,49,2099
8829,8829,9F541427977446D96030A544BAE61896,10221,12,13,1,34,49,1749
8830,8830,9F541427977446D96030A544BAE61896,42931,15,17,2,41,49,2099
8831,8831,9F541427977446D96030A544BAE61896,11811,19,20,1,38,49,1949
8838,8838,C36F1AFEB94481B9AE3619D8906170DC,13671,6,11,5,27,43,1393
8839,8839,C36F1AFEB94481B9AE3619D8906170DC,10841,15,18,3,37,47,1897
8840,8840,C36F1AFEB94481B9AE3619D8906170DC,13671,20,21,1,27,43,1393
8841,8841,9CE154E0E9981462DE8BB5E8103CB6DC,11901,0,9,9,42,49,2149
8842,8842,9CE154E0E9981462DE8BB5E8103CB6DC,11914,10,19,9,37,48,1898
8843,8843,9CE154E0E9981462DE8BB5E8103CB6DC,42581,20,22,2,38,48,1948
8844,8844,D8E810E9944384CCB75FBE32C487F667,43321,7,8,1,36,49,1849
8845,8845,D8E810E9944384CCB75FBE32C487F667,11531,8,13,5,34,49,1749
8846,8846,D8E810E9944384CCB75FBE32C487F667,11021,13,16,3,36,49,1849
8847,8847,D8E810E9944384CCB75FBE32C487F667,11531,16,18,2,34,49,1749
8848,8848,D8E810E9944384CCB75FBE32C487F667,43321,22,23,1,36,49,1849
8852,8852,804B7737707030C63DF2E4BD94DF220F,42971,0,7,7,43,49,2199
8853,8853,804B7737707030C63DF2E4BD94DF220F,11806,7,18,11,41,48,2098
8854,8854,804B7737707030C63DF2E4BD94DF220F,42271,19,21,2,40,47,2047
8855,8855,804B7737707030C63DF2E4BD94DF220F,11806,21,23,2,41,48,2098
8856,8856,54D116DFE588BA5FCFDC53B2DC83AC2F,43391,0,6,6,29,48,1498
8857,8857,54D116DFE588BA5FCFDC53B2DC83AC2F,10381,6,7,1,31,49,1599
8858,8858,54D116DFE588BA5FCFDC53B2DC83AC2F,43391,12,13,1,29,48,1498
8859,8859,54D116DFE588BA5FCFDC53B2DC83AC2F,10381,18,19,1,31,49,1599
8860,8860,54D116DFE588BA5FCFDC53B2DC83AC2F,43391,21,23,2,29,48,1498
8861,8861,F6947486712885EDC02BCA122A5A6DB5,15061,0,5,5,41,25,2075
8862,8862,F6947486712885EDC02BCA122A5A6DB5,12881,5,17,12,47,22,2372
8863,8863,F6947486712885EDC02BCA122A5A6DB5,15061,21,23,2,41,25,2075
8864,8864,6AD981E757B177FB5B64F1D1D2EAA27F,12651,0,7,7,43,47,2197
8865,8865,6AD981E757B177FB5B64F1D1D2EAA27F,42961,8,10,2,35,49,1799
8866,8866,6AD981E757B177FB5B64F1D1D2EAA27F,10221,16,20,4,34,49,1749
8867,8867,6AD981E757B177FB5B64F1D1D2EAA27F,42961,21,23,2,35,49,1799
8868,8868,9F7BBEBDE25379D4345B2CB89A6224BC,42523,0,7,7,31,47,1597
8869,8869,9F7BBEBDE25379D4345B2CB89A6224BC,11021,10,17,7,36,49,1849
8870,8870,9F7BBEBDE25379D4345B2CB89A6224BC,10295,20,23,3,30,47,1547
8871,8871,60431017DB48728DD1D9AC55BBBFB348,11161,0,7,7,32,48,1648
8872,8872,60431017DB48728DD1D9AC55BBBFB348,10251,8,11,3,35,47,1797
8873,8873,60431017DB48728DD1D9AC55BBBFB348,11161,12,14,2,32,48,1648
8874,8874,60431017DB48728DD1D9AC55BBBFB348,10251,14,17,3,35,47,1797
8875,8875,60431017DB48728DD1D9AC55BBBFB348,11161,18,23,5,32,48,1648
8880,8880,93C27183809E9D71326FC6A69D187B04,10411,0,8,8,36,48,1848
8881,8881,93C27183809E9D71326FC6A69D187B04,12971,11,14,3,32,48,1648
8882,8882,93C27183809E9D71326FC6A69D187B04,11061,17,19,2,29,48,1498
8883,8883,93C27183809E9D71326FC6A69D187B04,12391,20,22,2,36,49,1849
8887,8887,154B39807A422FDB28537C4227930019,11941,0,4,4,37,46,1896
8888,8888,154B39807A422FDB28537C4227930019,13711,6,9,3,38,46,1946
8889,8889,154B39807A422FDB28537C4227930019,11941,9,17,8,37,46,1896
8890,8890,154B39807A422FDB28537C4227930019,13711,18,19,1,38,46,1946
8891,8891,154B39807A422FDB28537C4227930019,11941,19,23,4,37,46,1896
8895,8895,AA9DDBAE747C0C61A76E689DD898E315,42301,0,7,7,36,47,1847
8896,8896,AA9DDBAE747C0C61A76E689DD898E315,42531,10,11,1,31,45,1595
8897,8897,AA9DDBAE747C0C61A76E689DD898E315,42511,12,13,1,37,47,1897
8898,8898,AA9DDBAE747C0C61A76E689DD898E315,11841,14,18,4,33,46,1696
8899,8899,CF7D11A98378B7038E896806F404F060,10841,0,8,8,37,47,1897
8900,8900,CF7D11A98378B7038E896806F404F060,11281,12,14,2,27,40,1390
8901,8901,CF7D11A98378B7038E896806F404F060,10841,18,23,5,37,47,1897
8902,8902,8671664FCEA72D44791A077CF27C82B3,12641,0,1,1,10,43,543
8903,8903,8671664FCEA72D44791A077CF27C82B3,12921,3,8,5,9,41,491
8904,8904,8671664FCEA72D44791A077CF27C82B3,19261,8,10,2,6,37,337
8905,8905,8671664FCEA72D44791A077CF27C82B3,12921,11,12,1,9,41,491
8906,8906,8671664FCEA72D44791A077CF27C82B3,43021,16,17,1,16,43,843
8907,8907,8671664FCEA72D44791A077CF27C82B3,12921,20,22,2,9,41,491
8911,8911,8E0D20320C5276BDD797BA6D65B9C51D,11074,0,7,7,37,47,1897
8912,8912,8E0D20320C5276BDD797BA6D65B9C51D,11231,8,12,4,37,49,1899
8913,8913,8E0D20320C5276BDD797BA6D65B9C51D,12083,12,13,1,36,49,1849
8914,8914,8E0D20320C5276BDD797BA6D65B9C51D,11231,14,18,4,37,49,1899
8915,8915,8E0D20320C5276BDD797BA6D65B9C51D,11074,18,23,5,37,47,1897
8919,8919,31CBC77871B7612C90BD0F8F8FF24A20,42321,0,6,6,43,47,2197
8920,8920,31CBC77871B7612C90BD0F8F8FF24A20,10801,6,7,1,42,47,2147
8921,8921,31CBC77871B7612C90BD0F8F8FF24A20,42321,7,13,6,43,47,2197
8922,8922,31CBC77871B7612C90BD0F8F8FF24A20,10801,14,15,1,42,47,2147
8923,8923,31CBC77871B7612C90BD0F8F8FF24A20,42321,15,22,7,43,47,2197
8927,8927,D60446D7DF1A587EF306D57742530A6F,12481,0,7,7,37,49,1899
8928,8928,D60446D7DF1A587EF306D57742530A6F,10401,9,11,2,33,49,1699
8929,8929,D60446D7DF1A587EF306D57742530A6F,10661,12,13,1,37,49,1899
8930,8930,D60446D7DF1A587EF306D57742530A6F,11481,14,15,1,41,48,2098
8931,8931,D60446D7DF1A587EF306D57742530A6F,40073,17,18,1,37,48,1898
8932,8932,D60446D7DF1A587EF306D57742530A6F,11231,21,23,2,37,49,1899
8937,8937,150A7E893F2E956108A56695B1962075,19441,0,16,16,8,46,446
8938,8938,150A7E893F2E956108A56695B1962075,11571,17,18,1,13,46,696
8939,8939,150A7E893F2E956108A56695B1962075,19441,19,23,4,8,46,446
8943,8943,459FC143B3AB01B134D25F22BE576C47,10611,0,10,10,32,48,1648
8944,8944,459FC143B3AB01B134D25F22BE576C47,11731,13,19,6,36,48,1848
8945,8945,459FC143B3AB01B134D25F22BE576C47,40951,19,21,2,36,49,1849
8949,8949,F66EBAC9EE1CB5E174070796CFB61D9B,11834,0,12,12,32,45,1645
8950,8950,F66EBAC9EE1CB5E174070796CFB61D9B,40341,14,19,5,23,49,1199
8951,8951,F66EBAC9EE1CB5E174070796CFB61D9B,12491,20,23,3,36,43,1843
8959,8959,9CFD096A7BDD76C773AF0C5EF90468CD,10951,1,9,8,29,48,1498
8960,8960,9CFD096A7BDD76C773AF0C5EF90468CD,11531,12,13,1,34,49,1749
8961,8961,9CFD096A7BDD76C773AF0C5EF90468CD,11381,17,23,6,30,47,1547
8962,8962,0798706F6D3F4308756154400CF7AEDB,42541,0,8,8,25,47,1297
8963,8963,0798706F6D3F4308756154400CF7AEDB,11531,12,13,1,34,49,1749
8964,8964,0798706F6D3F4308756154400CF7AEDB,42541,18,19,1,25,47,1297
8965,8965,0798706F6D3F4308756154400CF7AEDB,40341,19,21,2,23,49,1199
8966,8966,0798706F6D3F4308756154400CF7AEDB,12021,21,22,1,37,49,1899
8967,8967,17B310C5C0CD98D91D2EAE008E1E6775,42491,0,10,10,32,46,1646
8968,8968,17B310C5C0CD98D91D2EAE008E1E6775,11751,11,13,2,35,48,1798
8969,8969,17B310C5C0CD98D91D2EAE008E1E6775,10161,13,14,1,35,49,1799
8970,8970,17B310C5C0CD98D91D2EAE008E1E6775,12131,15,19,4,32,47,1647
8974,8974,6C054AEBB9CA77441FEC6C9497BF29D2,13601,0,6,6,34,47,1747
8975,8975,6C054AEBB9CA77441FEC6C9497BF29D2,42021,7,9,2,33,47,1697
8976,8976,6C054AEBB9CA77441FEC6C9497BF29D2,13601,10,11,1,34,47,1747
8977,8977,6C054AEBB9CA77441FEC6C9497BF29D2,42021,11,13,2,33,47,1697
8978,8978,6C054AEBB9CA77441FEC6C9497BF29D2,13601,13,15,2,34,47,1747
8979,8979,6C054AEBB9CA77441FEC6C9497BF29D2,42021,15,16,1,33,47,1697
8980,8980,6C054AEBB9CA77441FEC6C9497BF29D2,13601,17,20,3,34,47,1747
8981,8981,ED63CD6A523ED82BABC0C283513656AA,11471,0,5,5,12,48,648
8982,8982,ED63CD6A523ED82BABC0C283513656AA,42041,8,16,8,10,47,547
8983,8983,ED63CD6A523ED82BABC0C283513656AA,19441,19,22,3,8,46,446
8984,8984,4FB7544A1E67AE742452DB3735E5F7CF,11001,1,4,3,42,47,2147
8985,8985,4FB7544A1E67AE742452DB3735E5F7CF,10771,4,6,2,41,46,2096
8986,8986,4FB7544A1E67AE742452DB3735E5F7CF,43951,9,10,1,49,41,2491
8987,8987,4FB7544A1E67AE742452DB3735E5F7CF,12561,12,17,5,45,43,2293
8988,8988,4FB7544A1E67AE742452DB3735E5F7CF,10771,21,22,1,41,46,2096
8993,8993,4515D69DA9DF7C67BD58AB71BAA57E58,11231,0,4,4,37,49,1899
8994,8994,4515D69DA9DF7C67BD58AB71BAA57E58,10471,5,6,1,37,48,1898
8995,8995,4515D69DA9DF7C67BD58AB71BAA57E58,40171,7,11,4,38,48,1948
8996,8996,4515D69DA9DF7C67BD58AB71BAA57E58,10471,12,18,6,37,48,1898
8997,8997,4515D69DA9DF7C67BD58AB71BAA57E58,11231,18,23,5,37,49,1899
8998,8998,0FCC9992AE8D71AAE404BB0E597A281E,11861,0,4,4,32,47,1647
8999,8999,0FCC9992AE8D71AAE404BB0E597A281E,11201,5,18,13,35,49,1799
9000,9000,0FCC9992AE8D71AAE404BB0E597A281E,11861,18,23,5,32,47,1647
9001,9001,CEA501FA7BDE5D84B551C94F16C00DA1,11021,0,13,13,36,49,1849
9002,9002,CEA501FA7BDE5D84B551C94F16C00DA1,13791,14,17,3,42,47,2147
9003,9003,CEA501FA7BDE5D84B551C94F16C00DA1,10651,17,23,6,36,49,1849
9004,9004,24CACD73BA8D75767DDD668E5EA165E2,40171,0,5,5,38,48,1948
9005,9005,24CACD73BA8D75767DDD668E5EA165E2,11914,6,7,1,37,48,1898
9006,9006,24CACD73BA8D75767DDD668E5EA165E2,42581,8,9,1,38,48,1948
9007,9007,24CACD73BA8D75767DDD668E5EA165E2,11914,9,10,1,37,48,1898
9008,9008,24CACD73BA8D75767DDD668E5EA165E2,42191,11,13,2,38,49,1949
9009,9009,24CACD73BA8D75767DDD668E5EA165E2,11914,13,18,5,37,48,1898
9010,9010,7300FFB733BFFEA187DB110E4D4DC3D2,49201,0,8,8,7,41,391
9011,9011,7300FFB733BFFEA187DB110E4D4DC3D2,12921,8,12,4,9,41,491
9012,9012,7300FFB733BFFEA187DB110E4D4DC3D2,49201,12,14,2,7,41,391
9013,9013,7300FFB733BFFEA187DB110E4D4DC3D2,12641,15,16,1,10,43,543
9014,9014,7300FFB733BFFEA187DB110E4D4DC3D2,19181,19,20,1,8,40,440
9015,9015,582FCEF67ED9C80E5B2E8667690F61FB,42221,0,7,7,38,48,1948
9016,9016,582FCEF67ED9C80E5B2E8667690F61FB,42401,8,12,4,36,47,1847
9017,9017,582FCEF67ED9C80E5B2E8667690F61FB,42221,12,16,4,38,48,1948
9018,9018,582FCEF67ED9C80E5B2E8667690F61FB,42401,17,22,5,36,47,1847
9019,9019,582FCEF67ED9C80E5B2E8667690F61FB,42221,22,23,1,38,48,1948
9020,9020,E6E1B072EE7202225510F5B63E9E6AA7,42221,2,6,4,38,48,1948
9021,9021,E6E1B072EE7202225510F5B63E9E6AA7,42121,8,16,8,26,49,1349
9022,9022,E6E1B072EE7202225510F5B63E9E6AA7,42221,19,21,2,38,48,1948
9030,9030,AB35C432DC3D59E7929F031635A675AA,12601,0,10,10,25,47,1297
9031,9031,AB35C432DC3D59E7929F031635A675AA,10061,10,11,1,20,46,1046
9032,9032,AB35C432DC3D59E7929F031635A675AA,12601,12,19,7,25,47,1297
9036,9036,823BB637426A4B64F4A56D087D45C241,49201,0,6,6,7,41,391
9037,9037,823BB637426A4B64F4A56D087D45C241,12921,7,8,1,9,41,491
9038,9038,823BB637426A4B64F4A56D087D45C241,49201,12,13,1,7,41,391
9039,9039,823BB637426A4B64F4A56D087D45C241,12921,14,16,2,9,41,491
9040,9040,823BB637426A4B64F4A56D087D45C241,49201,17,18,1,7,41,391
9041,9041,823BB637426A4B64F4A56D087D45C241,12641,20,21,1,10,43,543
9042,9042,823BB637426A4B64F4A56D087D45C241,49201,21,22,1,7,41,391
9057,9057,0045D13BE8E4DDAB53C0085B23256BBF,42471,0,8,8,35,49,1799
9058,9058,0045D13BE8E4DDAB53C0085B23256BBF,10501,9,10,1,22,46,1146
9059,9059,0045D13BE8E4DDAB53C0085B23256BBF,10171,12,13,1,26,47,1347
9060,9060,0045D13BE8E4DDAB53C0085B23256BBF,42471,17,23,6,35,49,1799
9061,9061,2BC714C204CBBFEE616B46CC493E087B,12641,0,3,3,10,43,543
9062,9062,2BC714C204CBBFEE616B46CC493E087B,12921,3,4,1,9,41,491
9063,9063,2BC714C204CBBFEE616B46CC493E087B,19021,5,6,1,10,45,545
9064,9064,2BC714C204CBBFEE616B46CC493E087B,12921,7,9,2,9,41,491
9065,9065,2BC714C204CBBFEE616B46CC493E087B,12641,12,22,10,10,43,543
9066,9066,1D8BB04BA223F58C0F7219E50B383AFD,40441,0,10,10,30,48,1548
9067,9067,1D8BB04BA223F58C0F7219E50B383AFD,11061,10,11,1,29,48,1498
9068,9068,1D8BB04BA223F58C0F7219E50B383AFD,10731,15,17,2,33,47,1697
9069,9069,1D8BB04BA223F58C0F7219E50B383AFD,10681,17,21,4,30,48,1548
9070,9070,1D8BB04BA223F58C0F7219E50B383AFD,43151,22,23,1,40,49,2049
9071,9071,0BC1BC9FA127A76D4558FF0A0EC8FEFB,42921,0,7,7,33,47,1697
9072,9072,0BC1BC9FA127A76D4558FF0A0EC8FEFB,10281,7,10,3,33,48,1698
9073,9073,0BC1BC9FA127A76D4558FF0A0EC8FEFB,42921,13,14,1,33,47,1697
9074,9074,0BC1BC9FA127A76D4558FF0A0EC8FEFB,10281,15,16,1,33,48,1698
9075,9075,0BC1BC9FA127A76D4558FF0A0EC8FEFB,13601,17,19,2,34,47,1747
9076,9076,0BC1BC9FA127A76D4558FF0A0EC8FEFB,42921,22,23,1,33,47,1697
9096,9096,EC5A6DF746AC421318D6AE3B8794E793,11231,0,14,14,37,49,1899
9097,9097,EC5A6DF746AC421318D6AE3B8794E793,42501,19,20,1,28,47,1447
9098,9098,EC5A6DF746AC421318D6AE3B8794E793,11231,22,23,1,37,49,1899
9099,9099,7C98BDF484E2B085C51A4945E804FC0C,42151,0,1,1,35,45,1795
9100,9100,7C98BDF484E2B085C51A4945E804FC0C,12491,1,5,4,36,43,1843
9101,9101,7C98BDF484E2B085C51A4945E804FC0C,42151,6,8,2,35,45,1795
9102,9102,7C98BDF484E2B085C51A4945E804FC0C,12491,9,10,1,36,43,1843
9103,9103,7C98BDF484E2B085C51A4945E804FC0C,42151,10,14,4,35,45,1795
9104,9104,7C98BDF484E2B085C51A4945E804FC0C,12491,17,19,2,36,43,1843
9105,9105,7C98BDF484E2B085C51A4945E804FC0C,42151,19,22,3,35,45,1795
9112,9112,4A1E2DF13E9399DEAE7966E1EFE6FC6B,13271,0,4,4,41,47,2097
9113,9113,4A1E2DF13E9399DEAE7966E1EFE6FC6B,12311,6,9,3,30,44,1544
9114,9114,4A1E2DF13E9399DEAE7966E1EFE6FC6B,11875,12,14,2,30,46,1546
9115,9115,4A1E2DF13E9399DEAE7966E1EFE6FC6B,11481,19,20,1,41,48,2098
9116,9116,5A39E82B4B89A7E32F8694D4D3BC7774,43761,1,7,6,32,47,1647
9117,9117,5A39E82B4B89A7E32F8694D4D3BC7774,43501,12,15,3,27,48,1398
9118,9118,5A39E82B4B89A7E32F8694D4D3BC7774,42523,17,18,1,31,47,1597
9119,9119,00ED2280FB2BEC22D8FB36F8A7AFB1A5,42791,0,7,7,35,45,1795
9120,9120,00ED2280FB2BEC22D8FB36F8A7AFB1A5,10271,9,16,7,37,46,1896
9121,9121,00ED2280FB2BEC22D8FB36F8A7AFB1A5,13121,16,17,1,38,46,1946
9122,9122,00ED2280FB2BEC22D8FB36F8A7AFB1A5,10271,17,18,1,37,46,1896
9123,9123,00ED2280FB2BEC22D8FB36F8A7AFB1A5,42151,21,23,2,35,45,1795
9124,9124,6B33C993B739D337E981CD19E6D27BBE,42091,0,14,14,43,46,2196
9125,9125,6B33C993B739D337E981CD19E6D27BBE,13791,16,17,1,42,47,2147
9126,9126,6B33C993B739D337E981CD19E6D27BBE,13511,19,20,1,34,48,1748
9135,9135,76B5A35D98B8893850740B68B6528B2B,10801,3,4,1,42,47,2147
9136,9136,76B5A35D98B8893850740B68B6528B2B,42321,4,5,1,43,47,2197
9137,9137,76B5A35D98B8893850740B68B6528B2B,13671,7,18,11,27,43,1393
9138,9138,76B5A35D98B8893850740B68B6528B2B,42321,19,21,2,43,47,2197
9139,9139,47844E829FCB05D6E87386BF9A1380C3,13711,0,7,7,38,46,1946
9140,9140,47844E829FCB05D6E87386BF9A1380C3,11941,10,14,4,37,46,1896
9141,9141,47844E829FCB05D6E87386BF9A1380C3,11021,15,17,2,36,49,1849
9142,9142,47844E829FCB05D6E87386BF9A1380C3,11491,19,23,4,36,47,1847
9149,9149,E6269ED2D0B33F287E30A99BF131EC42,42291,0,10,10,29,48,1498
9150,9150,E6269ED2D0B33F287E30A99BF131EC42,40341,13,18,5,23,49,1199
9151,9151,E6269ED2D0B33F287E30A99BF131EC42,11381,18,23,5,30,47,1547
9152,9152,CC1D3C2DA42F1EBED6688749C3DA1D87,11061,1,2,1,29,48,1498
9153,9153,CC1D3C2DA42F1EBED6688749C3DA1D87,11261,6,8,2,36,46,1846
9154,9154,CC1D3C2DA42F1EBED6688749C3DA1D87,13911,8,14,6,39,46,1996
9155,9155,CC1D3C2DA42F1EBED6688749C3DA1D87,11261,14,17,3,36,46,1846
9156,9156,CC1D3C2DA42F1EBED6688749C3DA1D87,11381,21,23,2,30,47,1547
9157,9157,EDB289CED4924F8EDA17F7FC2CBC2541,11231,0,7,7,37,49,1899
9158,9158,EDB289CED4924F8EDA17F7FC2CBC2541,13351,8,10,2,48,48,2448
9159,9159,EDB289CED4924F8EDA17F7FC2CBC2541,11351,12,22,10,36,48,1848
9163,9163,D7349708A10855AEF98FEB8D22C33E59,40833,0,7,7,41,47,2097
9164,9164,D7349708A10855AEF98FEB8D22C33E59,11231,8,15,7,37,49,1899
9165,9165,D7349708A10855AEF98FEB8D22C33E59,10601,19,23,4,39,47,1997
9166,9166,03400E70232608A9491D68EE417E3691,10921,0,6,6,43,48,2198
9167,9167,03400E70232608A9491D68EE417E3691,42511,8,17,9,37,47,1897
9168,9168,03400E70232608A9491D68EE417E3691,10921,21,23,2,43,48,2198
9169,9169,5AF85D9ED958D0E5348613692DAC5B4D,12381,0,1,1,32,48,1648
9170,9170,5AF85D9ED958D0E5348613692DAC5B4D,12083,2,20,18,36,49,1849
9171,9171,5AF85D9ED958D0E5348613692DAC5B4D,10431,22,23,1,33,49,1699
9181,9181,F850A01EC352DE808C8F4EFD91A8118B,10491,0,3,3,33,48,1698
9182,9182,F850A01EC352DE808C8F4EFD91A8118B,42161,3,8,5,36,47,1847
9183,9183,F850A01EC352DE808C8F4EFD91A8118B,42381,10,11,1,39,41,1991
9184,9184,F850A01EC352DE808C8F4EFD91A8118B,40951,13,15,2,36,49,1849
9185,9185,F850A01EC352DE808C8F4EFD91A8118B,42471,19,22,3,35,49,1799
9186,9186,6C841C7D2D2B53A8BCAAFC5972E77D1F,10951,4,6,2,29,48,1498
9187,9187,6C841C7D2D2B53A8BCAAFC5972E77D1F,11381,6,7,1,30,47,1547
9188,9188,6C841C7D2D2B53A8BCAAFC5972E77D1F,42081,8,14,6,24,49,1249
9189,9189,6C841C7D2D2B53A8BCAAFC5972E77D1F,42623,17,19,2,22,49,1149
9190,9190,92E1BAA88B052422B820ED36A9E8F107,41392,0,6,6,43,48,2198
9191,9191,92E1BAA88B052422B820ED36A9E8F107,40171,6,9,3,38,48,1948
9192,9192,92E1BAA88B052422B820ED36A9E8F107,41392,11,23,12,43,48,2198
9193,9193,539C214E856C11F03C56CBF97B3E24CF,10681,1,9,8,30,48,1548
9194,9194,539C214E856C11F03C56CBF97B3E24CF,10107,13,15,2,38,49,1949
9195,9195,539C214E856C11F03C56CBF97B3E24CF,42301,17,23,6,36,47,1847
9196,9196,0C2E73493B95B864220B3E14F6C11E84,13314,0,7,7,31,39,1589
9197,9197,0C2E73493B95B864220B3E14F6C11E84,12521,9,18,9,35,41,1791
9198,9198,0C2E73493B95B864220B3E14F6C11E84,13314,19,23,4,31,39,1589
9210,9210,F06696253146EEBB7842F43A19CD992F,12871,2,5,3,22,33,1133
9211,9211,F06696253146EEBB7842F43A19CD992F,19801,9,16,7,19,26,976
9212,9212,F06696253146EEBB7842F43A19CD992F,12871,18,19,1,22,33,1133
9213,9213,BB0A84AC7C57BEBD2A2A02394D6C075F,10111,0,10,10,37,47,1897
9214,9214,BB0A84AC7C57BEBD2A2A02394D6C075F,10221,10,15,5,34,49,1749
9215,9215,BB0A84AC7C57BEBD2A2A02394D6C075F,10841,20,21,1,37,47,1897
9219,9219,32E472ABE1AC8EE5712784968711993D,10721,8,11,3,31,48,1598
9220,9220,32E472ABE1AC8EE5712784968711993D,10251,12,14,2,35,47,1797
9221,9221,32E472ABE1AC8EE5712784968711993D,10721,16,21,5,31,48,1598
9222,9222,D8B46FFCD15B641FB93B8219A29A7205,10251,0,6,6,35,47,1797
9223,9223,D8B46FFCD15B641FB93B8219A29A7205,40673,6,8,2,36,48,1848
9224,9224,D8B46FFCD15B641FB93B8219A29A7205,10251,9,10,1,35,47,1797
9225,9225,D8B46FFCD15B641FB93B8219A29A7205,42161,10,13,3,36,47,1847
9226,9226,D8B46FFCD15B641FB93B8219A29A7205,10251,16,21,5,35,47,1797
9227,9227,A78FA5D54AC2E8DA68B00F4C335E7B86,11111,0,11,11,26,48,1348
9228,9228,A78FA5D54AC2E8DA68B00F4C335E7B86,43761,14,16,2,32,47,1647
9229,9229,A78FA5D54AC2E8DA68B00F4C335E7B86,11111,20,23,3,26,48,1348
9234,9234,E45B0EC44E00842EDD865C65A561543D,10471,9,12,3,37,48,1898
9235,9235,E45B0EC44E00842EDD865C65A561543D,11231,14,17,3,37,49,1899
9236,9236,E45B0EC44E00842EDD865C65A561543D,43311,19,20,1,31,48,1598
9237,9237,F004825C5EEC7F8B7A184D4985895C55,13341,0,6,6,44,45,2245
9238,9238,F004825C5EEC7F8B7A184D4985895C55,10841,7,10,3,37,47,1897
9239,9239,F004825C5EEC7F8B7A184D4985895C55,42631,11,20,9,43,45,2195
9240,9240,722F93E6CE54FADD6A9BE8EB60306018,11061,0,1,1,29,48,1498
9241,9241,722F93E6CE54FADD6A9BE8EB60306018,10971,1,13,12,35,47,1797
9242,9242,722F93E6CE54FADD6A9BE8EB60306018,41591,17,19,2,34,49,1749
9243,9243,722F93E6CE54FADD6A9BE8EB60306018,43161,21,23,2,35,47,1797
9244,9244,D0FC92B342424050598F772FA0F08EFF,11541,0,8,8,35,49,1799
9245,9245,D0FC92B342424050598F772FA0F08EFF,42381,12,14,2,39,41,1991
9246,9246,D0FC92B342424050598F772FA0F08EFF,43451,16,18,2,37,40,1890
9247,9247,D0FC92B342424050598F772FA0F08EFF,42381,18,20,2,39,41,1991
9248,9248,D0FC92B342424050598F772FA0F08EFF,43451,22,23,1,37,40,1890
9253,9253,3F29D0D409D1B6D4E7D2087740FD0BBC,42161,0,7,7,36,47,1847
9254,9254,3F29D0D409D1B6D4E7D2087740FD0BBC,10251,7,11,4,35,47,1797
9255,9255,3F29D0D409D1B6D4E7D2087740FD0BBC,42161,11,12,1,36,47,1847
9256,9256,3F29D0D409D1B6D4E7D2087740FD0BBC,10251,16,20,4,35,47,1797
9257,9257,3F29D0D409D1B6D4E7D2087740FD0BBC,42161,20,23,3,36,47,1847
9261,9261,43125D201B2090874D2E0EE6E6251F06,10111,0,11,11,37,47,1897
9262,9262,43125D201B2090874D2E0EE6E6251F06,10491,11,13,2,33,48,1698
9263,9263,43125D201B2090874D2E0EE6E6251F06,11331,14,16,2,37,48,1898
9264,9264,43125D201B2090874D2E0EE6E6251F06,10491,17,20,3,33,48,1698
9265,9265,43125D201B2090874D2E0EE6E6251F06,11331,21,22,1,37,48,1898
9266,9266,B6EDE923BA421C490CFB0E81830396F2,11231,0,12,12,37,49,1899
9267,9267,B6EDE923BA421C490CFB0E81830396F2,11074,12,13,1,37,47,1897
9268,9268,B6EDE923BA421C490CFB0E81830396F2,11231,14,18,4,37,49,1899
9269,9269,B6EDE923BA421C490CFB0E81830396F2,43311,19,20,1,31,48,1598
9270,9270,B6EDE923BA421C490CFB0E81830396F2,11231,21,22,1,37,49,1899
9274,9274,5A45F00505D10CE6F80144DAC647FEEE,19441,0,6,6,8,46,446
9275,9275,5A45F00505D10CE6F80144DAC647FEEE,12921,6,12,6,9,41,491
9276,9276,5A45F00505D10CE6F80144DAC647FEEE,12641,12,14,2,10,43,543
9277,9277,5A45F00505D10CE6F80144DAC647FEEE,12921,15,16,1,9,41,491
9278,9278,5A45F00505D10CE6F80144DAC647FEEE,19024,19,23,4,9,45,495
9283,9283,1AEFE268D60CBB68A6A0A3D12DEC5407,10471,1,10,9,37,48,1898
9284,9284,1AEFE268D60CBB68A6A0A3D12DEC5407,42381,12,14,2,39,41,1991
9285,9285,1AEFE268D60CBB68A6A0A3D12DEC5407,12021,18,19,1,37,49,1899
9292,9292,0C993A1B5BD23944DD153F92F92FAA1E,10351,1,2,1,28,45,1445
9293,9293,0C993A1B5BD23944DD153F92F92FAA1E,10634,4,5,1,27,45,1395
9294,9294,0C993A1B5BD23944DD153F92F92FAA1E,10351,7,8,1,28,45,1445
9295,9295,0C993A1B5BD23944DD153F92F92FAA1E,10634,15,17,2,27,45,1395
9296,9296,0C993A1B5BD23944DD153F92F92FAA1E,10351,21,23,2,28,45,1445
9300,9300,E648A6F090A3BE85617E0ED54A73B4F0,12601,0,9,9,25,47,1297
9301,9301,E648A6F090A3BE85617E0ED54A73B4F0,12671,12,16,4,21,43,1093
9302,9302,E648A6F090A3BE85617E0ED54A73B4F0,12601,17,21,4,25,47,1297
9303,9303,E648A6F090A3BE85617E0ED54A73B4F0,12671,21,23,2,21,43,1093
9304,9304,2E9DA8BFC00288392B827149BB3FB265,12921,7,9,2,9,41,491
9305,9305,2E9DA8BFC00288392B827149BB3FB265,43021,12,13,1,16,43,843
9306,9306,2E9DA8BFC00288392B827149BB3FB265,12641,17,18,1,10,43,543
9307,9307,0E1208E76DAA7EDCAA41CA6CF6A73776,42521,1,2,1,31,47,1597
9308,9308,0E1208E76DAA7EDCAA41CA6CF6A73776,11381,2,4,2,30,47,1547
9309,9309,0E1208E76DAA7EDCAA41CA6CF6A73776,42521,5,6,1,31,47,1597
9310,9310,0E1208E76DAA7EDCAA41CA6CF6A73776,11381,8,10,2,30,47,1547
9311,9311,0E1208E76DAA7EDCAA41CA6CF6A73776,12121,11,12,1,29,47,1497
9312,9312,0E1208E76DAA7EDCAA41CA6CF6A73776,11381,13,23,10,30,47,1547
9313,9313,6873293A7011427730E4398465E19659,12921,0,17,17,9,41,491
9314,9314,6873293A7011427730E4398465E19659,43021,18,19,1,16,43,843
9315,9315,6873293A7011427730E4398465E19659,12921,20,21,1,9,41,491
9323,9323,BDA67F5B71597181E331845AE88C939C,42161,0,4,4,36,47,1847
9324,9324,BDA67F5B71597181E331845AE88C939C,10111,4,13,9,37,47,1897
9325,9325,BDA67F5B71597181E331845AE88C939C,42161,14,16,2,36,47,1847
9326,9326,BDA67F5B71597181E331845AE88C939C,11271,18,20,2,37,48,1898
9327,9327,BDA67F5B71597181E331845AE88C939C,42161,21,22,1,36,47,1847
9328,9328,AC604569EDEC121EE97D76ACCBB6C578,12521,0,6,6,35,41,1791
9329,9329,AC604569EDEC121EE97D76ACCBB6C578,43451,6,8,2,37,40,1890
9330,9330,AC604569EDEC121EE97D76ACCBB6C578,12521,8,15,7,35,41,1791
9331,9331,AC604569EDEC121EE97D76ACCBB6C578,43451,16,17,1,37,40,1890
9332,9332,AC604569EDEC121EE97D76ACCBB6C578,12521,17,23,6,35,41,1791
9333,9333,C9CAC2C6335B37B2CDE3F43D7A7F9A91,40277,0,1,1,35,49,1799
9334,9334,C9CAC2C6335B37B2CDE3F43D7A7F9A91,11061,2,9,7,29,48,1498
9335,9335,C9CAC2C6335B37B2CDE3F43D7A7F9A91,11381,9,15,6,30,47,1547
9336,9336,C9CAC2C6335B37B2CDE3F43D7A7F9A91,10381,16,23,7,31,49,1599
9344,9344,8E04CA34920941791B1B2D80E2E36134,42021,0,2,2,33,47,1697
9345,9345,8E04CA34920941791B1B2D80E2E36134,43581,3,8,5,33,48,1698
9346,9346,8E04CA34920941791B1B2D80E2E36134,13951,17,19,2,47,45,2395
9347,9347,8E04CA34920941791B1B2D80E2E36134,43581,20,23,3,33,48,1698
9355,9355,05C3A7EB5EF4E026B421540B8AC90475,12491,3,4,1,36,43,1843
9356,9356,05C3A7EB5EF4E026B421540B8AC90475,42151,6,8,2,35,45,1795
9357,9357,05C3A7EB5EF4E026B421540B8AC90475,12491,12,13,1,36,43,1843
9358,9358,05C3A7EB5EF4E026B421540B8AC90475,12311,16,18,2,30,44,1544
9359,9359,05C3A7EB5EF4E026B421540B8AC90475,12491,22,23,1,36,43,1843
9363,9363,3F7BFF26419AB43EAAC9D4DF4B7C2705,42301,0,5,5,36,47,1847
9364,9364,3F7BFF26419AB43EAAC9D4DF4B7C2705,19061,10,12,2,3,43,193
9365,9365,3F7BFF26419AB43EAAC9D4DF4B7C2705,40341,13,15,2,23,49,1199
9366,9366,3F7BFF26419AB43EAAC9D4DF4B7C2705,42301,17,23,6,36,47,1847
9371,9371,5CB395EE61B203CDEC22915C029A400C,10151,9,11,2,34,47,1747
9372,9372,5CB395EE61B203CDEC22915C029A400C,10331,14,16,2,39,46,1996
9373,9373,5CB395EE61B203CDEC22915C029A400C,10531,16,17,1,34,46,1746
9374,9374,5CB395EE61B203CDEC22915C029A400C,10911,20,23,3,39,46,1996
9375,9375,2076FDA641FB832C37A3CEDC0E6FC7AC,10351,0,4,4,28,45,1445
9376,9376,2076FDA641FB832C37A3CEDC0E6FC7AC,13671,7,8,1,27,43,1393
9377,9377,2076FDA641FB832C37A3CEDC0E6FC7AC,12311,9,11,2,30,44,1544
9378,9378,2076FDA641FB832C37A3CEDC0E6FC7AC,13671,14,15,1,27,43,1393
9379,9379,2076FDA641FB832C37A3CEDC0E6FC7AC,10351,18,20,2,28,45,1445
9380,9380,A796809FFC26797F0B17A0B66E102B15,13314,0,7,7,31,39,1589
9381,9381,A796809FFC26797F0B17A0B66E102B15,12521,7,10,3,35,41,1791
9382,9382,A796809FFC26797F0B17A0B66E102B15,13314,11,23,12,31,39,1589
9383,9383,A79534BBCA0DDDDF6D160742220606F4,43951,0,4,4,49,41,2491
9384,9384,A79534BBCA0DDDDF6D160742220606F4,12561,6,21,15,45,43,2293
9385,9385,A79534BBCA0DDDDF6D160742220606F4,43051,22,23,1,46,45,2345
9386,9386,0D947EBDA1250C07F4411B7BDAEBFDBC,42531,0,5,5,31,45,1595
9387,9387,0D947EBDA1250C07F4411B7BDAEBFDBC,12601,7,9,2,25,47,1297
9388,9388,0D947EBDA1250C07F4411B7BDAEBFDBC,11091,9,10,1,29,47,1497
9389,9389,0D947EBDA1250C07F4411B7BDAEBFDBC,42531,12,20,8,31,45,1595
9390,9390,0D947EBDA1250C07F4411B7BDAEBFDBC,12311,22,23,1,30,44,1544
9391,9391,296E7B917A1C9BBE703645D1D7E31230,10661,2,6,4,37,49,1899
9392,9392,296E7B917A1C9BBE703645D1D7E31230,10901,9,13,4,35,48,1798
9393,9393,296E7B917A1C9BBE703645D1D7E31230,11231,13,16,3,37,49,1899
9394,9394,296E7B917A1C9BBE703645D1D7E31230,11731,17,21,4,36,48,1848
9395,9395,296E7B917A1C9BBE703645D1D7E31230,10661,22,23,1,37,49,1899
9400,9400,A2E834D310B55F9EA0A1B4DBD80E9D3B,11861,6,8,2,32,47,1647
9401,9401,A2E834D310B55F9EA0A1B4DBD80E9D3B,12311,10,12,2,30,44,1544
9402,9402,A2E834D310B55F9EA0A1B4DBD80E9D3B,11061,17,20,3,29,48,1498
9403,9403,A2E834D310B55F9EA0A1B4DBD80E9D3B,12311,21,23,2,30,44,1544
9404,9404,68D66AC2F31097852E1113FCAC38B096,12311,0,2,2,30,44,1544
9405,9405,68D66AC2F31097852E1113FCAC38B096,42531,2,4,2,31,45,1595
9406,9406,68D66AC2F31097852E1113FCAC38B096,12311,4,5,1,30,44,1544
9407,9407,68D66AC2F31097852E1113FCAC38B096,12121,5,6,1,29,47,1497
9408,9408,68D66AC2F31097852E1113FCAC38B096,12311,8,9,1,30,44,1544
9409,9409,68D66AC2F31097852E1113FCAC38B096,42531,11,18,7,31,45,1595
9410,9410,68D66AC2F31097852E1113FCAC38B096,12311,21,23,2,30,44,1544
9411,9411,C404F60AD0A2D6862A45A9C320EEAB5F,11261,0,5,5,36,46,1846
9412,9412,C404F60AD0A2D6862A45A9C320EEAB5F,42861,7,9,2,37,44,1894
9413,9413,C404F60AD0A2D6862A45A9C320EEAB5F,42351,11,12,1,38,45,1945
9414,9414,C404F60AD0A2D6862A45A9C320EEAB5F,42861,13,17,4,37,44,1894
9415,9415,C404F60AD0A2D6862A45A9C320EEAB5F,11261,21,23,2,36,46,1846
9419,9419,04D73C3CD00D40CB611F6BA5801F802C,13314,0,6,6,31,39,1589
9420,9420,04D73C3CD00D40CB611F6BA5801F802C,12521,7,8,1,35,41,1791
9421,9421,04D73C3CD00D40CB611F6BA5801F802C,13314,8,23,15,31,39,1589
9422,9422,FF16D1104349162E539969031BE39A02,12511,0,8,8,39,47,1997
9423,9423,FF16D1104349162E539969031BE39A02,12514,9,10,1,38,47,1947
9424,9424,FF16D1104349162E539969031BE39A02,43481,12,14,2,39,48,1998
9425,9425,FF16D1104349162E539969031BE39A02,12511,16,18,2,39,47,1997
9426,9426,FF16D1104349162E539969031BE39A02,43481,21,23,2,39,48,1998
9427,9427,1DB915E5C2FD44F999C47520EABDE31F,11291,0,7,7,40,49,2049
9428,9428,1DB915E5C2FD44F999C47520EABDE31F,41271,12,15,3,38,48,1948
9429,9429,1DB915E5C2FD44F999C47520EABDE31F,11074,17,20,3,37,47,1897
9430,9430,1DB915E5C2FD44F999C47520EABDE31F,11291,21,23,2,40,49,2049
9434,9434,AE9DABC8C76DE8782FA56379E8CBF939,10544,0,7,7,28,48,1448
9435,9435,AE9DABC8C76DE8782FA56379E8CBF939,11631,8,17,9,12,49,649
9436,9436,AE9DABC8C76DE8782FA56379E8CBF939,43501,17,18,1,27,48,1398
9440,9440,6A457FC295BEABB4E7455CBB04B50835,43021,1,2,1,16,43,843
9441,9441,6A457FC295BEABB4E7455CBB04B50835,12921,4,10,6,9,41,491
9442,9442,6A457FC295BEABB4E7455CBB04B50835,43644,13,18,5,14,38,738
9443,9443,B65986D45181EA9BD7712A84F575953B,19071,3,4,1,7,29,379
9444,9444,B65986D45181EA9BD7712A84F575953B,15121,7,10,3,27,19,1369
9445,9445,B65986D45181EA9BD7712A84F575953B,19071,12,13,1,7,29,379
9446,9446,B65986D45181EA9BD7712A84F575953B,15121,13,15,2,27,19,1369
9447,9447,B65986D45181EA9BD7712A84F575953B,15351,18,20,2,24,22,1222
9448,9448,B65986D45181EA9BD7712A84F575953B,19051,21,22,1,16,23,823
9460,9460,7CC60DD17F7D376F38E6F744A557371C,13314,0,5,5,31,39,1589
9461,9461,7CC60DD17F7D376F38E6F744A557371C,12521,6,9,3,35,41,1791
9462,9462,7CC60DD17F7D376F38E6F744A557371C,13314,12,13,1,31,39,1589
9463,9463,7CC60DD17F7D376F38E6F744A557371C,12521,14,16,2,35,41,1791
9464,9464,7CC60DD17F7D376F38E6F744A557371C,13314,18,23,5,31,39,1589
9471,9471,E6262059789A6AD500E2E5AF7EB560CA,12601,8,9,1,25,47,1297
9472,9472,E6262059789A6AD500E2E5AF7EB560CA,42141,10,11,1,32,47,1647
9473,9473,E6262059789A6AD500E2E5AF7EB560CA,10292,11,14,3,30,47,1547
9474,9474,E6262059789A6AD500E2E5AF7EB560CA,10716,14,20,6,30,46,1546
9475,9475,E6262059789A6AD500E2E5AF7EB560CA,10292,20,21,1,30,47,1547
9476,9476,85061C43999146706723F4E0700EE955,13911,0,4,4,39,46,1996
9477,9477,85061C43999146706723F4E0700EE955,11261,5,10,5,36,46,1846
9478,9478,85061C43999146706723F4E0700EE955,13911,12,15,3,39,46,1996
9479,9479,85061C43999146706723F4E0700EE955,11261,15,21,6,36,46,1846
9480,9480,85061C43999146706723F4E0700EE955,42351,22,23,1,38,45,1945
9481,9481,E6F8B18996A93B41942201687916F106,11231,0,2,2,37,49,1899
9482,9482,E6F8B18996A93B41942201687916F106,10471,2,3,1,37,48,1898
9483,9483,E6F8B18996A93B41942201687916F106,11231,4,12,8,37,49,1899
9484,9484,E6F8B18996A93B41942201687916F106,10471,17,19,2,37,48,1898
9485,9485,E6F8B18996A93B41942201687916F106,11231,19,21,2,37,49,1899
9486,9486,E6F8B18996A93B41942201687916F106,10471,22,23,1,37,48,1898
9491,9491,2D9F8EEE0946858BEC66856CB73B8335,43021,0,3,3,16,43,843
9492,9492,2D9F8EEE0946858BEC66856CB73B8335,12921,3,18,15,9,41,491
9493,9493,2D9F8EEE0946858BEC66856CB73B8335,43021,19,22,3,16,43,843
9494,9494,43D5A4B21D49F330FF46E8A3E900BDBD,10721,0,7,7,31,48,1598
9495,9495,43D5A4B21D49F330FF46E8A3E900BDBD,11231,8,9,1,37,49,1899
9496,9496,43D5A4B21D49F330FF46E8A3E900BDBD,10901,13,14,1,35,48,1798
9497,9497,43D5A4B21D49F330FF46E8A3E900BDBD,11231,18,23,5,37,49,1899
9511,9511,F0D3FEBF4CC350A5851C8C36AA32D49C,11331,0,6,6,37,48,1898
9512,9512,F0D3FEBF4CC350A5851C8C36AA32D49C,40673,7,8,1,36,48,1848
9513,9513,F0D3FEBF4CC350A5851C8C36AA32D49C,42161,9,10,1,36,47,1847
9514,9514,F0D3FEBF4CC350A5851C8C36AA32D49C,11331,14,16,2,37,48,1898
9515,9515,F0D3FEBF4CC350A5851C8C36AA32D49C,42161,17,19,2,36,47,1847
9516,9516,C029826C5BB7E45FB7F0BA61E1CA759A,12381,2,9,7,32,48,1648
9517,9517,C029826C5BB7E45FB7F0BA61E1CA759A,10841,12,14,2,37,47,1897
9518,9518,C029826C5BB7E45FB7F0BA61E1CA759A,12381,15,16,1,32,48,1648
9519,9519,C029826C5BB7E45FB7F0BA61E1CA759A,43731,20,23,3,34,47,1747
9523,9523,EFBB325901A77CC80B4A6113783C819C,10971,0,6,6,35,47,1797
9524,9524,EFBB325901A77CC80B4A6113783C819C,10951,9,10,1,29,48,1498
9525,9525,EFBB325901A77CC80B4A6113783C819C,10971,12,22,10,35,47,1797
9530,9530,36A5DA74A38B0FD57799D67573348D49,10841,0,9,9,37,47,1897
9531,9531,36A5DA74A38B0FD57799D67573348D49,40673,9,11,2,36,48,1848
9532,9532,36A5DA74A38B0FD57799D67573348D49,11541,12,13,1,35,49,1799
9533,9533,36A5DA74A38B0FD57799D67573348D49,10411,14,15,1,36,48,1848
9534,9534,36A5DA74A38B0FD57799D67573348D49,42511,19,22,3,37,47,1897
9535,9535,DE5BDD3B470489AE77EA550C66DF0B7A,13314,0,5,5,31,39,1589
9536,9536,DE5BDD3B470489AE77EA550C66DF0B7A,12521,6,11,5,35,41,1791
9537,9537,DE5BDD3B470489AE77EA550C66DF0B7A,13314,11,23,12,31,39,1589
9538,9538,3CEDD9F281DC77B01703F7776FC0CEB7,15091,1,6,5,35,26,1776
9539,9539,3CEDD9F281DC77B01703F7776FC0CEB7,43121,11,13,2,25,27,1277
9540,9540,3CEDD9F281DC77B01703F7776FC0CEB7,15091,14,19,5,35,26,1776
9541,9541,3CEDD9F281DC77B01703F7776FC0CEB7,43121,19,23,4,25,27,1277
9546,9546,7D8BB90B66B5BB302B836A7DB354A71B,42601,0,6,6,44,48,2248
9547,9547,7D8BB90B66B5BB302B836A7DB354A71B,42321,7,8,1,43,47,2197
9548,9548,7D8BB90B66B5BB302B836A7DB354A71B,42601,12,14,2,44,48,2248
9549,9549,7D8BB90B66B5BB302B836A7DB354A71B,42321,17,21,4,43,47,2197
9550,9550,7D8BB90B66B5BB302B836A7DB354A71B,42601,22,23,1,44,48,2248
9551,9551,94092014F9DD3213271810B8D19555BE,49201,0,5,5,7,41,391
9552,9552,94092014F9DD3213271810B8D19555BE,12921,6,9,3,9,41,491
9553,9553,94092014F9DD3213271810B8D19555BE,49201,11,14,3,7,41,391
9554,9554,94092014F9DD3213271810B8D19555BE,12921,17,19,2,9,41,491
9555,9555,94092014F9DD3213271810B8D19555BE,49201,19,21,2,7,41,391
9560,9560,94DF6D416CC5B92A0E5062ABBAC5B786,11074,0,4,4,37,47,1897
9561,9561,94DF6D416CC5B92A0E5062ABBAC5B786,12514,4,6,2,38,47,1947
9562,9562,94DF6D416CC5B92A0E5062ABBAC5B786,42071,8,16,8,31,49,1599
9563,9563,94DF6D416CC5B92A0E5062ABBAC5B786,42471,20,22,2,35,49,1799
9564,9564,EEB3CBC85DF19031E292162C06516E43,10471,8,12,4,37,48,1898
9565,9565,EEB3CBC85DF19031E292162C06516E43,11381,12,19,7,30,47,1547
9566,9566,EEB3CBC85DF19031E292162C06516E43,10471,19,22,3,37,48,1898
9567,9567,83898511EC061507AABFD305D35646FF,10341,3,13,10,31,47,1597
9568,9568,83898511EC061507AABFD305D35646FF,40341,14,15,1,23,49,1199
9569,9569,83898511EC061507AABFD305D35646FF,10341,16,19,3,31,47,1597
9570,9570,9D2F8B673CF5A851F245B3DD21FD08F4,10251,0,5,5,35,47,1797
9571,9571,9D2F8B673CF5A851F245B3DD21FD08F4,42161,5,8,3,36,47,1847
9572,9572,9D2F8B673CF5A851F245B3DD21FD08F4,10111,8,13,5,37,47,1897
9573,9573,9D2F8B673CF5A851F245B3DD21FD08F4,42161,14,16,2,36,47,1847
9574,9574,9D2F8B673CF5A851F245B3DD21FD08F4,10251,19,23,4,35,47,1797
9578,9578,7C11C7CBC4724062CEFCE060A70E0F2E,12921,0,5,5,9,41,491
9579,9579,7C11C7CBC4724062CEFCE060A70E0F2E,19021,5,8,3,10,45,545
9580,9580,7C11C7CBC4724062CEFCE060A70E0F2E,12921,10,11,1,9,41,491
9581,9581,7C11C7CBC4724062CEFCE060A70E0F2E,12641,12,23,11,10,43,543
9582,9582,09D4E4AC27B1C2BD71280354244F178D,42121,0,7,7,26,49,1349
9583,9583,09D4E4AC27B1C2BD71280354244F178D,42461,8,18,10,45,47,2297
9584,9584,09D4E4AC27B1C2BD71280354244F178D,11081,22,23,1,35,46,1796
9585,9585,CAF14FA74E880F943EA550A7A4DBB4F8,10251,0,11,11,35,47,1797
9586,9586,CAF14FA74E880F943EA550A7A4DBB4F8,19901,12,16,4,7,44,394
9587,9587,CAF14FA74E880F943EA550A7A4DBB4F8,42161,19,23,4,36,47,1847
9588,9588,2295C74F0BD2BB081A3FCDFFDED68B9C,43644,2,3,1,14,38,738
9589,9589,2295C74F0BD2BB081A3FCDFFDED68B9C,12921,3,11,8,9,41,491
9590,9590,2295C74F0BD2BB081A3FCDFFDED68B9C,12641,15,17,2,10,43,543
9591,9591,2295C74F0BD2BB081A3FCDFFDED68B9C,12921,18,19,1,9,41,491
9592,9592,3264DF2DB3BEAC4C4CEC353428467D3B,10121,0,13,13,36,49,1849
9593,9593,3264DF2DB3BEAC4C4CEC353428467D3B,42351,14,15,1,38,45,1945
9594,9594,3264DF2DB3BEAC4C4CEC353428467D3B,10121,16,22,6,36,49,1849
9595,9595,AEB67BDC79FE6552942E6F2DEC149F32,11551,0,9,9,39,49,1999
9596,9596,AEB67BDC79FE6552942E6F2DEC149F32,10681,12,13,1,30,48,1548
9597,9597,AEB67BDC79FE6552942E6F2DEC149F32,11551,14,23,9,39,49,1999
9598,9598,656752102BA99654C7060CE5B2133D72,19114,0,5,5,7,43,393
9599,9599,656752102BA99654C7060CE5B2133D72,12921,6,7,1,9,41,491
9600,9600,656752102BA99654C7060CE5B2133D72,49201,7,10,3,7,41,391
9601,9601,656752102BA99654C7060CE5B2133D72,12921,10,12,2,9,41,491
9602,9602,656752102BA99654C7060CE5B2133D72,19114,12,13,1,7,43,393
9603,9603,656752102BA99654C7060CE5B2133D72,49201,16,18,2,7,41,391
9604,9604,656752102BA99654C7060CE5B2133D72,19114,20,23,3,7,43,393
9609,9609,99165E654E4A5840EA37FC83361CE61B,42581,0,7,7,38,48,1948
9610,9610,99165E654E4A5840EA37FC83361CE61B,11914,8,10,2,37,48,1898
9611,9611,99165E654E4A5840EA37FC83361CE61B,42581,12,14,2,38,48,1948
9612,9612,99165E654E4A5840EA37FC83361CE61B,11914,19,21,2,37,48,1898
9613,9613,99165E654E4A5840EA37FC83361CE61B,42581,21,23,2,38,48,1948
9614,9614,0A753885BE5CDC6D1CF1B7B35F1C199C,42523,0,6,6,31,47,1597
9615,9615,0A753885BE5CDC6D1CF1B7B35F1C199C,43761,9,11,2,32,47,1647
9616,9616,0A753885BE5CDC6D1CF1B7B35F1C199C,42523,12,16,4,31,47,1597
9617,9617,0A753885BE5CDC6D1CF1B7B35F1C199C,10295,17,19,2,30,47,1547
9618,9618,0A753885BE5CDC6D1CF1B7B35F1C199C,43761,20,22,2,32,47,1647
9629,9629,ED0EE3E9960BCEF6967F4298DBD60F07,43644,0,1,1,14,38,738
9630,9630,ED0EE3E9960BCEF6967F4298DBD60F07,12641,1,3,2,10,43,543
9631,9631,ED0EE3E9960BCEF6967F4298DBD60F07,19114,3,21,18,7,43,393
9632,9632,ED0EE3E9960BCEF6967F4298DBD60F07,12641,21,23,2,10,43,543
9633,9633,055660D96102C90837257CF6FD6D548A,13911,0,6,6,39,46,1996
9634,9634,055660D96102C90837257CF6FD6D548A,11261,7,8,1,36,46,1846
9635,9635,055660D96102C90837257CF6FD6D548A,11914,9,10,1,37,48,1898
9636,9636,055660D96102C90837257CF6FD6D548A,13911,12,18,6,39,46,1996
9637,9637,055660D96102C90837257CF6FD6D548A,11875,19,23,4,30,46,1546
9638,9638,015977F21CA69DACA3E876A5F028B2A4,43051,0,4,4,46,45,2345
9639,9639,015977F21CA69DACA3E876A5F028B2A4,13351,6,7,1,48,48,2448
9640,9640,015977F21CA69DACA3E876A5F028B2A4,11701,7,9,2,43,48,2198
9641,9641,015977F21CA69DACA3E876A5F028B2A4,43051,12,14,2,46,45,2345
9642,9642,015977F21CA69DACA3E876A5F028B2A4,13351,18,20,2,48,48,2448
9643,9643,015977F21CA69DACA3E876A5F028B2A4,43051,21,23,2,46,45,2345
9644,9644,E22AA6097575A79A4D7ECBABD3861529,11901,0,7,7,42,49,2149
9645,9645,E22AA6097575A79A4D7ECBABD3861529,12601,9,10,1,25,47,1297
9646,9646,E22AA6097575A79A4D7ECBABD3861529,11901,13,23,10,42,49,2149
9647,9647,1F899C425E1D44BC86781F60DDEF728E,43021,0,3,3,16,43,843
9648,9648,1F899C425E1D44BC86781F60DDEF728E,12921,3,10,7,9,41,491
9649,9649,1F899C425E1D44BC86781F60DDEF728E,43021,12,22,10,16,43,843
9650,9650,A182F67A9AD0CFFDEC550200F4061A7D,11151,0,8,8,30,48,1548
9651,9651,A182F67A9AD0CFFDEC550200F4061A7D,42261,10,11,1,25,49,1299
9652,9652,A182F67A9AD0CFFDEC550200F4061A7D,11151,12,23,11,30,48,1548
9660,9660,45E2591DDB181830E886EA4FBDDB1E4F,11861,1,8,7,32,47,1647
9661,9661,45E2591DDB181830E886EA4FBDDB1E4F,12481,13,14,1,37,49,1899
9662,9662,45E2591DDB181830E886EA4FBDDB1E4F,10151,18,20,2,34,47,1747
9663,9663,45E2591DDB181830E886EA4FBDDB1E4F,10971,21,23,2,35,47,1797
9664,9664,9B3D4DB494E6B8E7329532A1BECC6FF1,12921,5,12,7,9,41,491
9665,9665,9B3D4DB494E6B8E7329532A1BECC6FF1,12641,14,18,4,10,43,543
9666,9666,9B3D4DB494E6B8E7329532A1BECC6FF1,43021,20,23,3,16,43,843
9670,9670,B63E2FCEA885CD7623CDD5F3E0385915,11324,3,8,5,31,46,1596
9671,9671,B63E2FCEA885CD7623CDD5F3E0385915,11875,9,10,1,30,46,1546
9672,9672,B63E2FCEA885CD7623CDD5F3E0385915,11324,12,14,2,31,46,1596
9673,9673,B63E2FCEA885CD7623CDD5F3E0385915,40341,15,17,2,23,49,1199
9674,9674,B63E2FCEA885CD7623CDD5F3E0385915,11324,19,20,1,31,46,1596
9679,9679,62F6BE848412C7FADEB816AFD62C431F,15521,0,6,6,27,14,1364
9680,9680,62F6BE848412C7FADEB816AFD62C431F,16151,6,8,2,13,11,661
9681,9681,62F6BE848412C7FADEB816AFD62C431F,15521,13,14,1,27,14,1364
9682,9682,62F6BE848412C7FADEB816AFD62C431F,16151,18,21,3,13,11,661
9683,9683,62F6BE848412C7FADEB816AFD62C431F,15141,21,22,1,26,11,1311
9690,9690,DC865F572039BA6AEAA0A2E2CDFDCF23,19741,1,7,6,5,44,294
9691,9691,DC865F572039BA6AEAA0A2E2CDFDCF23,19181,10,11,1,8,40,440
9692,9692,DC865F572039BA6AEAA0A2E2CDFDCF23,12921,11,13,2,9,41,491
9693,9693,DC865F572039BA6AEAA0A2E2CDFDCF23,19741,16,23,7,5,44,294
9694,9694,18F85D1FF157146B3054BAA6982B6768,43061,0,14,14,43,46,2196
9695,9695,18F85D1FF157146B3054BAA6982B6768,10271,15,16,1,37,46,1896
9696,9696,18F85D1FF157146B3054BAA6982B6768,43061,20,23,3,43,46,2196
9697,9697,091DCC0237DDF0F056E1A7BFB1F57890,19021,0,7,7,10,45,545
9698,9698,091DCC0237DDF0F056E1A7BFB1F57890,12921,8,11,3,9,41,491
9699,9699,091DCC0237DDF0F056E1A7BFB1F57890,19021,12,13,1,10,45,545
9700,9700,091DCC0237DDF0F056E1A7BFB1F57890,12641,18,19,1,10,43,543
9701,9701,091DCC0237DDF0F056E1A7BFB1F57890,19021,20,22,2,10,45,545
9702,9702,62FCB15297A7724012720DDE29CC0405,13111,0,9,9,42,46,2146
9703,9703,62FCB15297A7724012720DDE29CC0405,12601,12,13,1,25,47,1297
9704,9704,62FCB15297A7724012720DDE29CC0405,13091,18,19,1,20,42,1042
9705,9705,62FCB15297A7724012720DDE29CC0405,43061,21,22,1,43,46,2196
9706,9706,D92D00150BC27A9BD4FD19E6AAF05E52,11806,0,3,3,41,48,2098
9707,9707,D92D00150BC27A9BD4FD19E6AAF05E52,42271,8,17,9,40,47,2047
9708,9708,D92D00150BC27A9BD4FD19E6AAF05E52,10841,18,20,2,37,47,1897
9709,9709,D92D00150BC27A9BD4FD19E6AAF05E52,13331,21,22,1,38,47,1947
9710,9710,16B2F0D78BEB849442A93B3F29FB7F4E,42271,3,11,8,40,47,2047
9711,9711,16B2F0D78BEB849442A93B3F29FB7F4E,40094,15,17,2,29,48,1498
9712,9712,16B2F0D78BEB849442A93B3F29FB7F4E,11806,19,22,3,41,48,2098
9713,9713,4DA21EF09DE00955AFF28F16D2698178,12792,1,4,3,34,30,1730
9714,9714,4DA21EF09DE00955AFF28F16D2698178,15391,5,7,2,35,26,1776
9715,9715,4DA21EF09DE00955AFF28F16D2698178,12792,8,13,5,34,30,1730
9716,9716,4DA21EF09DE00955AFF28F16D2698178,15391,14,16,2,35,26,1776
9717,9717,4DA21EF09DE00955AFF28F16D2698178,15661,19,21,2,36,26,1826
9718,9718,4DA21EF09DE00955AFF28F16D2698178,15391,22,23,1,35,26,1776
9719,9719,D159D7E2120F2A31F888B2ED598E06C3,13314,0,7,7,31,39,1589
9720,9720,D159D7E2120F2A31F888B2ED598E06C3,12521,7,10,3,35,41,1791
9721,9721,D159D7E2120F2A31F888B2ED598E06C3,13314,12,13,1,31,39,1589
9722,9722,D159D7E2120F2A31F888B2ED598E06C3,12521,15,16,1,35,41,1791
9723,9723,D159D7E2120F2A31F888B2ED598E06C3,13314,18,22,4,31,39,1589
9727,9727,0102436000D6EFDA91A3939751E37135,12221,1,7,6,43,44,2194
9728,9728,0102436000D6EFDA91A3939751E37135,42741,10,12,2,43,48,2198
9729,9729,0102436000D6EFDA91A3939751E37135,13951,13,15,2,47,45,2395
9730,9730,0102436000D6EFDA91A3939751E37135,13341,19,20,1,44,45,2245
9731,9731,7B34C273E34CE1CA5EC462EE747405EC,42031,0,7,7,40,46,2046
9732,9732,7B34C273E34CE1CA5EC462EE747405EC,12921,8,11,3,9,41,491
9733,9733,7B34C273E34CE1CA5EC462EE747405EC,19114,12,20,8,7,43,393
9737,9737,11B7F7677A0CABD0DA5C6CA237E025AC,11171,1,7,6,33,48,1698
9738,9738,11B7F7677A0CABD0DA5C6CA237E025AC,42411,9,12,3,40,49,2049
9739,9739,11B7F7677A0CABD0DA5C6CA237E025AC,11521,13,18,5,41,48,2098
9740,9740,11B7F7677A0CABD0DA5C6CA237E025AC,11701,19,20,1,43,48,2198
9741,9741,11B7F7677A0CABD0DA5C6CA237E025AC,40941,22,23,1,32,48,1648
9742,9742,5134C03EB3276C610A7AB253ED006E01,11301,0,2,2,41,49,2099
9743,9743,5134C03EB3276C610A7AB253ED006E01,11021,2,13,11,36,49,1849
9744,9744,5134C03EB3276C610A7AB253ED006E01,42501,20,23,3,28,47,1447
9745,9745,B8F09D673505D81D4D8EBE55B08A2A62,42471,0,10,10,35,49,1799
9746,9746,B8F09D673505D81D4D8EBE55B08A2A62,11481,11,13,2,41,48,2098
9747,9747,B8F09D673505D81D4D8EBE55B08A2A62,11541,16,23,7,35,49,1799
9748,9748,7252A0F90E29EC78621699C082578EF7,11261,0,6,6,36,46,1846
9749,9749,7252A0F90E29EC78621699C082578EF7,10292,7,11,4,30,47,1547
9750,9750,7252A0F90E29EC78621699C082578EF7,42371,13,14,1,34,46,1746
9751,9751,7252A0F90E29EC78621699C082578EF7,10292,15,21,6,30,47,1547
9752,9752,7252A0F90E29EC78621699C082578EF7,10511,22,23,1,35,46,1796
9760,9760,E2F2F4143F844EB76521711717E3F1F1,43644,0,3,3,14,38,738
9761,9761,E2F2F4143F844EB76521711717E3F1F1,12921,4,9,5,9,41,491
9762,9762,E2F2F4143F844EB76521711717E3F1F1,12641,14,16,2,10,43,543
9763,9763,E2F2F4143F844EB76521711717E3F1F1,12921,17,18,1,9,41,491
9764,9764,A02CC63C83B0DB8DAC13DDD011BB9A96,11161,0,7,7,32,48,1648
9765,9765,A02CC63C83B0DB8DAC13DDD011BB9A96,13821,8,12,4,49,45,2495
9766,9766,A02CC63C83B0DB8DAC13DDD011BB9A96,40691,13,14,1,42,48,2148
9767,9767,A02CC63C83B0DB8DAC13DDD011BB9A96,13951,14,21,7,47,45,2395
9768,9768,A02CC63C83B0DB8DAC13DDD011BB9A96,11781,21,23,2,38,49,1949
9773,9773,D2007E56CDD263F500CAE75A804D6B50,42871,0,4,4,30,45,1545
9774,9774,D2007E56CDD263F500CAE75A804D6B50,12311,7,8,1,30,44,1544
9775,9775,D2007E56CDD263F500CAE75A804D6B50,42871,13,15,2,30,45,1545
9776,9776,D2007E56CDD263F500CAE75A804D6B50,10301,16,17,1,31,45,1595
9777,9777,D2007E56CDD263F500CAE75A804D6B50,11091,18,19,1,29,47,1497
9778,9778,D2007E56CDD263F500CAE75A804D6B50,42871,21,23,2,30,45,1545
9779,9779,EFC8D98403D76A829ED8CCA80A205D3C,49181,7,14,7,21,31,1081
9780,9780,EFC8D98403D76A829ED8CCA80A205D3C,13141,14,16,2,23,30,1180
9781,9781,EFC8D98403D76A829ED8CCA80A205D3C,49181,18,20,2,21,31,1081
9782,9782,EFC8D98403D76A829ED8CCA80A205D3C,13141,20,21,1,23,30,1180
9783,9783,EFC8D98403D76A829ED8CCA80A205D3C,49181,22,23,1,21,31,1081
9791,9791,58FF60972C1637520443DC5766A2AB67,13411,0,5,5,49,42,2492
9792,9792,58FF60972C1637520443DC5766A2AB67,43951,6,9,3,49,41,2491
9793,9793,58FF60972C1637520443DC5766A2AB67,13411,12,13,1,49,42,2492
9794,9794,58FF60972C1637520443DC5766A2AB67,43951,13,16,3,49,41,2491
9795,9795,58FF60972C1637520443DC5766A2AB67,13411,19,23,4,49,42,2492
9799,9799,F10F5F870D2BAF9C3378171A398BFD7F,42861,0,8,8,37,44,1894
9800,9800,F10F5F870D2BAF9C3378171A398BFD7F,42151,8,9,1,35,45,1795
9801,9801,F10F5F870D2BAF9C3378171A398BFD7F,42861,10,11,1,37,44,1894
9802,9802,F10F5F870D2BAF9C3378171A398BFD7F,42151,15,17,2,35,45,1795
9803,9803,F10F5F870D2BAF9C3378171A398BFD7F,42861,19,21,2,37,44,1894
9811,9811,9501B3C8BE1B511FE71DDA9AADB1FC60,12514,0,9,9,38,47,1947
9812,9812,9501B3C8BE1B511FE71DDA9AADB1FC60,40341,10,19,9,23,49,1199
9813,9813,9501B3C8BE1B511FE71DDA9AADB1FC60,12511,20,23,3,39,47,1997
9814,9814,04ED2C698002ED049877B001216EC992,42971,0,9,9,43,49,2199
9815,9815,04ED2C698002ED049877B001216EC992,42191,13,16,3,38,49,1949
9816,9816,04ED2C698002ED049877B001216EC992,11271,16,17,1,37,48,1898
9817,9817,04ED2C698002ED049877B001216EC992,42191,17,18,1,38,49,1949
9818,9818,04ED2C698002ED049877B001216EC992,42971,19,23,4,43,49,2199
9822,9822,28AE6FF44E8686DC354D2E3DF7700FCC,42461,0,6,6,45,47,2297
9823,9823,28AE6FF44E8686DC354D2E3DF7700FCC,42321,6,11,5,43,47,2197
9824,9824,28AE6FF44E8686DC354D2E3DF7700FCC,42461,11,13,2,45,47,2297
9825,9825,28AE6FF44E8686DC354D2E3DF7700FCC,42321,13,15,2,43,47,2197
9826,9826,28AE6FF44E8686DC354D2E3DF7700FCC,42461,19,23,4,45,47,2297
9843,9843,802D06E8811CDC65FDAB61E1A1D233B3,12601,2,7,5,25,47,1297
9844,9844,802D06E8811CDC65FDAB61E1A1D233B3,10691,10,18,8,33,48,1698
9845,9845,802D06E8811CDC65FDAB61E1A1D233B3,12601,22,23,1,25,47,1297
9846,9846,7EA63201A47B68AA085BD7B8AF1F7767,10721,0,7,7,31,48,1598
9847,9847,7EA63201A47B68AA085BD7B8AF1F7767,11231,8,18,10,37,49,1899
9848,9848,7EA63201A47B68AA085BD7B8AF1F7767,10721,19,23,4,31,48,1598
9852,9852,6F09D1262EC8E2C3295473A92A5F6BBF,11061,0,3,3,29,48,1498
9853,9853,6F09D1262EC8E2C3295473A92A5F6BBF,42831,3,6,3,27,48,1398
9854,9854,6F09D1262EC8E2C3295473A92A5F6BBF,11151,6,7,1,30,48,1548
9855,9855,6F09D1262EC8E2C3295473A92A5F6BBF,42831,8,9,1,27,48,1398
9856,9856,6F09D1262EC8E2C3295473A92A5F6BBF,11151,11,19,8,30,48,1548
9857,9857,6F09D1262EC8E2C3295473A92A5F6BBF,43391,22,23,1,29,48,1498
9858,9858,9B353F06ECF34A550C00046F7DE80EF8,42281,0,6,6,40,48,2048
9859,9859,9B353F06ECF34A550C00046F7DE80EF8,42271,7,9,2,40,47,2047
9860,9860,9B353F06ECF34A550C00046F7DE80EF8,42583,12,13,1,40,48,2048
9861,9861,9B353F06ECF34A550C00046F7DE80EF8,42271,13,15,2,40,47,2047
9862,9862,9B353F06ECF34A550C00046F7DE80EF8,42221,19,20,1,38,48,1948
9863,9863,9B353F06ECF34A550C00046F7DE80EF8,42281,21,23,2,40,48,2048
9868,9868,550035E235750077DB6B90A64CB04939,13101,0,12,12,40,47,2047
9869,9869,550035E235750077DB6B90A64CB04939,42461,17,18,1,45,47,2297
9870,9870,550035E235750077DB6B90A64CB04939,13791,21,23,2,42,47,2147
9881,9881,658F51686040AA05DF52C044278C9795,12791,3,6,3,31,29,1579
9882,9882,658F51686040AA05DF52C044278C9795,12792,9,11,2,34,30,1730
9883,9883,658F51686040AA05DF52C044278C9795,12791,12,13,1,31,29,1579
9884,9884,658F51686040AA05DF52C044278C9795,15391,14,21,7,35,26,1776
9885,9885,658F51686040AA05DF52C044278C9795,12792,21,23,2,34,30,1730
9890,9890,4146889442AEFC7E2DA5CC656F28D41F,11794,0,8,8,38,49,1949
9891,9891,4146889442AEFC7E2DA5CC656F28D41F,10471,8,12,4,37,48,1898
9892,9892,4146889442AEFC7E2DA5CC656F28D41F,11794,12,13,1,38,49,1949
9893,9893,4146889442AEFC7E2DA5CC656F28D41F,10471,14,16,2,37,48,1898
9894,9894,4146889442AEFC7E2DA5CC656F28D41F,11791,18,23,5,38,49,1949
9902,9902,9F569681847AE1CB91DC5B95636EE88A,19021,2,8,6,10,45,545
9903,9903,9F569681847AE1CB91DC5B95636EE88A,43021,13,16,3,16,43,843
9904,9904,9F569681847AE1CB91DC5B95636EE88A,19021,18,23,5,10,45,545
9915,9915,436FA3DEC56DD7389B50B7F6DCA5EAC7,42321,0,3,3,43,47,2197
9916,9916,436FA3DEC56DD7389B50B7F6DCA5EAC7,10771,4,6,2,41,46,2096
9917,9917,436FA3DEC56DD7389B50B7F6DCA5EAC7,10801,10,11,1,42,47,2147
9918,9918,436FA3DEC56DD7389B50B7F6DCA5EAC7,41601,13,14,1,39,49,1999
9919,9919,436FA3DEC56DD7389B50B7F6DCA5EAC7,42621,15,16,1,24,49,1249
9920,9920,436FA3DEC56DD7389B50B7F6DCA5EAC7,42321,22,23,1,43,47,2197
9925,9925,52A195A8FE89EC70D1A1F00BB9B30229,12641,0,3,3,10,43,543
9926,9926,52A195A8FE89EC70D1A1F00BB9B30229,12921,5,14,9,9,41,491
9927,9927,52A195A8FE89EC70D1A1F00BB9B30229,43644,14,18,4,14,38,738
9928,9928,52A195A8FE89EC70D1A1F00BB9B30229,12921,20,22,2,9,41,491
9929,9929,52A195A8FE89EC70D1A1F00BB9B30229,12641,22,23,1,10,43,543
9930,9930,B57FA6A577B54BB28114ABA28733D834,11061,0,14,14,29,48,1498
9931,9931,B57FA6A577B54BB28114ABA28733D834,42623,16,17,1,22,49,1149
9932,9932,B57FA6A577B54BB28114ABA28733D834,11151,20,21,1,30,48,1548
9937,9937,63D46256AD6F86C8491C2B2581A93893,11291,0,6,6,40,49,2049
9938,9938,63D46256AD6F86C8491C2B2581A93893,10161,8,14,6,35,49,1799
9939,9939,63D46256AD6F86C8491C2B2581A93893,10401,18,19,1,33,49,1699
9947,9947,7F73A642AA11134206C46BA15C785E40,42491,6,7,1,32,46,1646
9948,9948,7F73A642AA11134206C46BA15C785E40,10295,7,9,2,30,47,1547
9949,9949,7F73A642AA11134206C46BA15C785E40,42521,9,11,2,31,47,1597
9950,9950,7F73A642AA11134206C46BA15C785E40,10292,12,14,2,30,47,1547
9951,9951,7F73A642AA11134206C46BA15C785E40,42521,16,17,1,31,47,1597
9952,9952,7F73A642AA11134206C46BA15C785E40,13651,17,18,1,30,47,1547
9953,9953,7F73A642AA11134206C46BA15C785E40,42521,19,22,3,31,47,1597
9969,9969,6CC3FE89A8F1A15E71D203BFCADF8D3A,11701,0,8,8,43,48,2198
9970,9970,6CC3FE89A8F1A15E71D203BFCADF8D3A,10251,8,19,11,35,47,1797
9971,9971,6CC3FE89A8F1A15E71D203BFCADF8D3A,11701,21,23,2,43,48,2198
9975,9975,3CAAAB45FC52161FB376E0D7ADAEF558,10251,2,7,5,35,47,1797
9976,9976,3CAAAB45FC52161FB376E0D7ADAEF558,43731,8,9,1,34,47,1747
9977,9977,3CAAAB45FC52161FB376E0D7ADAEF558,10251,12,14,2,35,47,1797
9978,9978,3CAAAB45FC52161FB376E0D7ADAEF558,11131,14,17,3,33,48,1698
9979,9979,3CAAAB45FC52161FB376E0D7ADAEF558,42161,19,22,3,36,47,1847
9980,9980,5AB06890D1F02153F5E7416054C280D9,43581,5,6,1,33,48,1698
9981,9981,5AB06890D1F02153F5E7416054C280D9,42941,11,18,7,37,47,1897
9982,9982,5AB06890D1F02153F5E7416054C280D9,43581,20,22,2,33,48,1698
9983,9983,284847A3C6721710FAF6E0CFEF216C5D,42521,0,8,8,31,47,1597
9984,9984,284847A3C6721710FAF6E0CFEF216C5D,10221,12,14,2,34,49,1749
9985,9985,284847A3C6721710FAF6E0CFEF216C5D,12391,18,19,1,36,49,1849
9986,9986,284847A3C6721710FAF6E0CFEF216C5D,10491,20,21,1,33,48,1698
9990,9990,3ACC8BF8C4DFF8F069BDD805025DF41D,43021,0,3,3,16,43,843
9991,9991,3ACC8BF8C4DFF8F069BDD805025DF41D,12921,3,11,8,9,41,491
9992,9992,3ACC8BF8C4DFF8F069BDD805025DF41D,43021,12,19,7,16,43,843
9996,9996,FDF69B8E48B92C210539C7D1B8F4072C,11791,0,14,14,38,49,1949
9997,9997,FDF69B8E48B92C210539C7D1B8F4072C,43241,15,16,1,36,46,1846
9998,9998,FDF69B8E48B92C210539C7D1B8F4072C,43171,18,22,4,39,49,1999
9999,9999,C4D6D6893D15A40EF6C21B7CBC7CED3E,42021,0,4,4,33,47,1697
10000,10000,C4D6D6893D15A40EF6C21B7CBC7CED3E,11861,5,6,1,32,47,1647
10001,10001,C4D6D6893D15A40EF6C21B7CBC7CED3E,11541,8,17,9,35,49,1799
10002,10002,C4D6D6893D15A40EF6C21B7CBC7CED3E,42021,19,20,1,33,47,1697
10003,10003,C4D6D6893D15A40EF6C21B7CBC7CED3E,11861,21,23,2,32,47,1647
10007,10007,073EBE93660DAEAA6A02C36811E4AA2E,12381,0,9,9,32,48,1648
10008,10008,073EBE93660DAEAA6A02C36811E4AA2E,10471,10,17,7,37,48,1898
10009,10009,073EBE93660DAEAA6A02C36811E4AA2E,12381,19,23,4,32,48,1648
10026,10026,3A1B49B490CA109FD4D5251F0C86C9CB,43581,0,14,14,33,48,1698
10027,10027,3A1B49B490CA109FD4D5251F0C86C9CB,12601,14,17,3,25,47,1297
10028,10028,3A1B49B490CA109FD4D5251F0C86C9CB,43581,18,23,5,33,48,1698
10029,10029,BC71A128CC1D1FD204F1FA3A371EA53A,43021,0,3,3,16,43,843
10030,10030,BC71A128CC1D1FD204F1FA3A371EA53A,12921,3,16,13,9,41,491
10031,10031,BC71A128CC1D1FD204F1FA3A371EA53A,12641,16,17,1,10,43,543
10032,10032,BC71A128CC1D1FD204F1FA3A371EA53A,43021,21,23,2,16,43,843
10033,10033,30C0B23C34E9959F6A4FEC1908ADB011,12971,0,10,10,32,48,1648
10034,10034,30C0B23C34E9959F6A4FEC1908ADB011,11171,11,17,6,33,48,1698
10035,10035,30C0B23C34E9959F6A4FEC1908ADB011,11021,20,22,2,36,49,1849
10036,10036,99EF4A4C6EEE35257A93BB52B8A18E43,11481,0,15,15,41,48,2098
10037,10037,99EF4A4C6EEE35257A93BB52B8A18E43,10841,16,17,1,37,47,1897
10038,10038,99EF4A4C6EEE35257A93BB52B8A18E43,11481,17,22,5,41,48,2098
10039,10039,CCA622EF7C7521B099036A38CE525CBA,11631,0,1,1,12,49,649
10040,10040,CCA622EF7C7521B099036A38CE525CBA,11741,2,9,7,42,49,2149
10041,10041,CCA622EF7C7521B099036A38CE525CBA,11324,13,23,10,31,46,1596
10042,10042,0637B8AE1DA92EBE87F92EC86B26B64B,11201,2,7,5,35,49,1799
10043,10043,0637B8AE1DA92EBE87F92EC86B26B64B,10491,8,15,7,33,48,1698
10044,10044,0637B8AE1DA92EBE87F92EC86B26B64B,42321,19,21,2,43,47,2197
10045,10045,C9AEC4984FB48AB111972A72575D06EF,10292,0,7,7,30,47,1547
10046,10046,C9AEC4984FB48AB111972A72575D06EF,42961,8,19,11,35,49,1799
10047,10047,C9AEC4984FB48AB111972A72575D06EF,10292,20,21,1,30,47,1547
10048,10048,0AD8838435D12A1009D3BADE4EAE690D,11381,0,8,8,30,47,1547
10049,10049,0AD8838435D12A1009D3BADE4EAE690D,11061,8,9,1,29,48,1498
10050,10050,0AD8838435D12A1009D3BADE4EAE690D,11381,11,14,3,30,47,1547
10051,10051,0AD8838435D12A1009D3BADE4EAE690D,10951,14,19,5,29,48,1498
10052,10052,0AD8838435D12A1009D3BADE4EAE690D,11381,20,23,3,30,47,1547
10062,10062,4F0631F4673317A16DCB59F5A84B3918,13711,0,1,1,38,46,1946
10063,10063,4F0631F4673317A16DCB59F5A84B3918,11941,2,6,4,37,46,1896
10064,10064,4F0631F4673317A16DCB59F5A84B3918,13711,7,14,7,38,46,1946
10065,10065,4F0631F4673317A16DCB59F5A84B3918,42511,15,17,2,37,47,1897
10066,10066,4F0631F4673317A16DCB59F5A84B3918,13711,18,19,1,38,46,1946
10067,10067,9A32E318CA0CDE9DA0BCF043EF40ABC3,10511,0,10,10,35,46,1796
10068,10068,9A32E318CA0CDE9DA0BCF043EF40ABC3,12381,11,14,3,32,48,1648
10069,10069,9A32E318CA0CDE9DA0BCF043EF40ABC3,11531,16,17,1,34,49,1749
10070,10070,9A32E318CA0CDE9DA0BCF043EF40ABC3,12381,17,18,1,32,48,1648
10071,10071,E2E7904AF585940CD43CDDA5A90CDD82,10661,0,8,8,37,49,1899
10072,10072,E2E7904AF585940CD43CDDA5A90CDD82,13651,13,14,1,30,47,1547
10073,10073,E2E7904AF585940CD43CDDA5A90CDD82,10661,16,23,7,37,49,1899
10093,10093,439D8CB010A4086802C0243322BA6C31,11061,1,7,6,29,48,1498
10094,10094,439D8CB010A4086802C0243322BA6C31,40343,8,16,8,24,49,1249
10095,10095,439D8CB010A4086802C0243322BA6C31,11061,18,23,5,29,48,1498
10096,10096,3473FA09F0017B3BD24476C962AE1520,13314,0,6,6,31,39,1589
10097,10097,3473FA09F0017B3BD24476C962AE1520,12521,10,16,6,35,41,1791
10098,10098,3473FA09F0017B3BD24476C962AE1520,43451,19,21,2,37,40,1890
10102,10102,AF85AB0F84B58F4A12483525349C1572,43121,0,14,14,25,27,1277
10103,10103,AF85AB0F84B58F4A12483525349C1572,15191,16,19,3,36,27,1827
10104,10104,AF85AB0F84B58F4A12483525349C1572,43121,22,23,1,25,27,1277
10115,10115,2FCC231DE348255A3F9CDA8D77EEA7DC,12581,0,5,5,24,48,1248
10116,10116,2FCC231DE348255A3F9CDA8D77EEA7DC,12051,5,18,13,20,47,1047
10117,10117,2FCC231DE348255A3F9CDA8D77EEA7DC,12581,19,22,3,24,48,1248
10118,10118,BEBF279FD319A0C2562B829B708A50BB,42981,3,4,1,36,49,1849
10119,10119,BEBF279FD319A0C2562B829B708A50BB,11231,7,13,6,37,49,1899
10120,10120,BEBF279FD319A0C2562B829B708A50BB,10971,13,15,2,35,47,1797
10121,10121,BEBF279FD319A0C2562B829B708A50BB,11231,15,19,4,37,49,1899
10122,10122,BEBF279FD319A0C2562B829B708A50BB,42981,20,21,1,36,49,1849
10123,10123,1D604F5710A9E4979C670CB3E8F5518A,11381,0,8,8,30,47,1547
10124,10124,1D604F5710A9E4979C670CB3E8F5518A,11431,9,11,2,29,47,1497
10125,10125,1D604F5710A9E4979C670CB3E8F5518A,11381,12,15,3,30,47,1547
10126,10126,1D604F5710A9E4979C670CB3E8F5518A,11151,19,20,1,30,48,1548
10127,10127,1D604F5710A9E4979C670CB3E8F5518A,13671,21,22,1,27,43,1393
10128,10128,B8307F419F74EB6BD798982B1246A67A,10251,0,11,11,35,47,1797
10129,10129,B8307F419F74EB6BD798982B1246A67A,42301,11,13,2,36,47,1847
10130,10130,B8307F419F74EB6BD798982B1246A67A,43361,17,18,1,38,48,1948
10131,10131,B8307F419F74EB6BD798982B1246A67A,10841,18,21,3,37,47,1897
10132,10132,B8307F419F74EB6BD798982B1246A67A,10251,21,23,2,35,47,1797
10136,10136,EF2E66853800FD0F0FDF1A24C24F87DD,10151,0,2,2,34,47,1747
10137,10137,EF2E66853800FD0F0FDF1A24C24F87DD,12514,2,13,11,38,47,1947
10138,10138,EF2E66853800FD0F0FDF1A24C24F87DD,11921,15,17,2,38,48,1948
10139,10139,EF2E66853800FD0F0FDF1A24C24F87DD,13511,19,23,4,34,48,1748
10143,10143,316A0E40672ECD32AD5754FDA8EFDE1F,10161,0,7,7,35,49,1799
10144,10144,316A0E40672ECD32AD5754FDA8EFDE1F,11211,11,13,2,34,49,1749
10145,10145,316A0E40672ECD32AD5754FDA8EFDE1F,10161,13,17,4,35,49,1799
10146,10146,316A0E40672ECD32AD5754FDA8EFDE1F,10191,18,21,3,40,48,2048
10147,10147,316A0E40672ECD32AD5754FDA8EFDE1F,10161,22,23,1,35,49,1799
10148,10148,27278737D09D5670A3F233313E8FF2D1,42491,2,4,2,32,46,1646
10149,10149,27278737D09D5670A3F233313E8FF2D1,43041,9,16,7,41,46,2096
10150,10150,27278737D09D5670A3F233313E8FF2D1,11861,20,21,1,32,47,1647
10151,10151,6562297688D8CD63CE654B7524AA8368,11861,4,13,9,32,47,1647
10152,10152,6562297688D8CD63CE654B7524AA8368,40341,14,17,3,23,49,1199
10153,10153,6562297688D8CD63CE654B7524AA8368,11861,18,22,4,32,47,1647
10154,10154,1788FF83230593384DFEF88881720D90,13551,0,6,6,45,38,2288
10155,10155,1788FF83230593384DFEF88881720D90,43101,7,8,1,46,40,2340
10156,10156,1788FF83230593384DFEF88881720D90,13551,13,14,1,45,38,2288
10157,10157,1788FF83230593384DFEF88881720D90,43101,14,16,2,46,40,2340
10158,10158,1788FF83230593384DFEF88881720D90,13551,19,20,1,45,38,2288
10168,10168,11C5ACA60B0246DE7069023057E8285F,11381,2,8,6,30,47,1547
10169,10169,11C5ACA60B0246DE7069023057E8285F,11061,9,10,1,29,48,1498
10170,10170,11C5ACA60B0246DE7069023057E8285F,11381,13,19,6,30,47,1547
10171,10171,11C5ACA60B0246DE7069023057E8285F,11061,20,21,1,29,48,1498
10172,10172,11C5ACA60B0246DE7069023057E8285F,11381,22,23,1,30,47,1547
10187,10187,3E351ABACF5670F218BE0092A1FF748D,40343,0,7,7,24,49,1249
10188,10188,3E351ABACF5670F218BE0092A1FF748D,43761,11,14,3,32,47,1647
10189,10189,3E351ABACF5670F218BE0092A1FF748D,40343,19,20,1,24,49,1249
10190,10190,3E351ABACF5670F218BE0092A1FF748D,43751,21,23,2,19,48,998
10194,10194,895178A7C4631A70E81256690FBFBF91,11331,1,6,5,37,48,1898
10195,10195,895178A7C4631A70E81256690FBFBF91,11701,10,12,2,43,48,2198
10196,10196,895178A7C4631A70E81256690FBFBF91,42461,12,14,2,45,47,2297
10197,10197,895178A7C4631A70E81256690FBFBF91,11331,19,20,1,37,48,1898
10198,10198,895178A7C4631A70E81256690FBFBF91,13371,20,23,3,41,47,2097
10202,10202,9CBB75B1408BC3198ED582DF5244D363,12491,3,4,1,36,43,1843
10203,10203,9CBB75B1408BC3198ED582DF5244D363,42861,4,6,2,37,44,1894
10204,10204,9CBB75B1408BC3198ED582DF5244D363,42151,10,11,1,35,45,1795
10205,10205,9CBB75B1408BC3198ED582DF5244D363,42861,12,14,2,37,44,1894
10206,10206,9CBB75B1408BC3198ED582DF5244D363,42801,18,19,1,40,49,2049
10210,10210,C416994B9DC2E3F8C8BB43A19558B9AA,15143,1,2,1,18,7,907
10211,10211,C416994B9DC2E3F8C8BB43A19558B9AA,16281,2,5,3,11,4,554
10212,10212,C416994B9DC2E3F8C8BB43A19558B9AA,15143,6,8,2,18,7,907
10213,10213,C416994B9DC2E3F8C8BB43A19558B9AA,16281,12,13,1,11,4,554
10214,10214,C416994B9DC2E3F8C8BB43A19558B9AA,15143,14,17,3,18,7,907
10215,10215,C416994B9DC2E3F8C8BB43A19558B9AA,16281,17,19,2,11,4,554
10216,10216,135EF939D99CED11694D71795A5772B0,19031,0,14,14,1,42,92
10217,10217,135EF939D99CED11694D71795A5772B0,12641,14,19,5,10,43,543
10218,10218,135EF939D99CED11694D71795A5772B0,19031,20,23,3,1,42,92
10219,10219,67BCB76F611F63115F44CBB7619B7D68,42161,0,10,10,36,47,1847
10220,10220,67BCB76F611F63115F44CBB7619B7D68,12641,12,15,3,10,43,543
10221,10221,67BCB76F611F63115F44CBB7619B7D68,10971,18,23,5,35,47,1797
10222,10222,CCCE2FAF6F3E0B095D610BAEF16D853B,10931,0,8,8,41,48,2098
10223,10223,CCCE2FAF6F3E0B095D610BAEF16D853B,11861,11,14,3,32,47,1647
10224,10224,CCCE2FAF6F3E0B095D610BAEF16D853B,10931,15,23,8,41,48,2098
10228,10228,2548F565FB80BB34AA5595F42A83E58D,11701,1,7,6,43,48,2198
10229,10229,2548F565FB80BB34AA5595F42A83E58D,42501,9,10,1,28,47,1447
10230,10230,2548F565FB80BB34AA5595F42A83E58D,11701,13,15,2,43,48,2198
10231,10231,2548F565FB80BB34AA5595F42A83E58D,42091,19,23,4,43,46,2196
10243,10243,3AEA3CF422288C2FFB9C65FD7BE694C9,12921,2,5,3,9,41,491
10244,10244,3AEA3CF422288C2FFB9C65FD7BE694C9,19901,8,10,2,7,44,394
10245,10245,3AEA3CF422288C2FFB9C65FD7BE694C9,12921,11,12,1,9,41,491
10246,10246,3AEA3CF422288C2FFB9C65FD7BE694C9,19931,13,18,5,7,43,393
10250,10250,E9E78448A0B6BEA2407D42EC36610250,42601,4,8,4,44,48,2248
10251,10251,E9E78448A0B6BEA2407D42EC36610250,42971,8,10,2,43,49,2199
10252,10252,E9E78448A0B6BEA2407D42EC36610250,42601,12,17,5,44,48,2248
10253,10253,E9E78448A0B6BEA2407D42EC36610250,13351,20,21,1,48,48,2448
10254,10254,E9E78448A0B6BEA2407D42EC36610250,42601,22,23,1,44,48,2248
10255,10255,3C97F95D3E300B5D6FAF61C6893E701A,10271,0,9,9,37,46,1896
10256,10256,3C97F95D3E300B5D6FAF61C6893E701A,11021,10,13,3,36,49,1849
10257,10257,3C97F95D3E300B5D6FAF61C6893E701A,40341,18,19,1,23,49,1199
10258,10258,3C97F95D3E300B5D6FAF61C6893E701A,10271,20,23,3,37,46,1896
10259,10259,A4704BA674093D21C0A8033730D49AF8,43501,6,7,1,27,48,1398
10260,10260,A4704BA674093D21C0A8033730D49AF8,10341,12,20,8,31,47,1597
10261,10261,A4704BA674093D21C0A8033730D49AF8,43501,21,23,2,27,48,1398
10269,10269,99C7ECB8A04AED18341CF71575998F26,10811,0,7,7,38,46,1946
10270,10270,99C7ECB8A04AED18341CF71575998F26,42091,8,10,2,43,46,2196
10271,10271,99C7ECB8A04AED18341CF71575998F26,13231,12,17,5,39,46,1996
10272,10272,99C7ECB8A04AED18341CF71575998F26,10811,18,22,4,38,46,1946
10273,10273,D8EB6BE19D6F1BE7A38B119F9A32FCB2,42531,0,3,3,31,45,1595
10274,10274,D8EB6BE19D6F1BE7A38B119F9A32FCB2,10634,4,6,2,27,45,1395
10275,10275,D8EB6BE19D6F1BE7A38B119F9A32FCB2,42531,6,12,6,31,45,1595
10276,10276,D8EB6BE19D6F1BE7A38B119F9A32FCB2,12311,15,18,3,30,44,1544
10277,10277,D8EB6BE19D6F1BE7A38B119F9A32FCB2,42871,19,20,1,30,45,1545
10278,10278,D8EB6BE19D6F1BE7A38B119F9A32FCB2,12311,20,22,2,30,44,1544
10292,10292,942A242C54C5AF79C66351D8C7F17676,42691,0,10,10,24,48,1248
10293,10293,942A242C54C5AF79C66351D8C7F17676,43161,13,16,3,35,47,1797
10294,10294,942A242C54C5AF79C66351D8C7F17676,11731,19,21,2,36,48,1848
10295,10295,E67DA67FCD45B9364F372EDFEC0B97BD,11541,9,11,2,35,49,1799
10296,10296,E67DA67FCD45B9364F372EDFEC0B97BD,40094,14,18,4,29,48,1498
10297,10297,E67DA67FCD45B9364F372EDFEC0B97BD,11541,19,21,2,35,49,1799
10298,10298,6E3A482A59CE9925DB19971C6ACB206A,11811,0,4,4,38,49,1949
10299,10299,6E3A482A59CE9925DB19971C6ACB206A,40171,5,6,1,38,48,1948
10300,10300,6E3A482A59CE9925DB19971C6ACB206A,10471,11,12,1,37,48,1898
10301,10301,6E3A482A59CE9925DB19971C6ACB206A,40171,17,19,2,38,48,1948
10302,10302,6E3A482A59CE9925DB19971C6ACB206A,11271,19,20,1,37,48,1898
10303,10303,6E3A482A59CE9925DB19971C6ACB206A,40171,20,21,1,38,48,1948
10304,10304,8F2DCDB1E6ACA3D4E7FFFCA1E99BF72D,10292,0,7,7,30,47,1547
10305,10305,8F2DCDB1E6ACA3D4E7FFFCA1E99BF72D,43161,11,13,2,35,47,1797
10306,10306,8F2DCDB1E6ACA3D4E7FFFCA1E99BF72D,10731,14,16,2,33,47,1697
10307,10307,8F2DCDB1E6ACA3D4E7FFFCA1E99BF72D,43161,17,21,4,35,47,1797
10308,10308,8F2DCDB1E6ACA3D4E7FFFCA1E99BF72D,10292,21,22,1,30,47,1547
10309,10309,8CAA944A76DA7309343EF407118B2A8F,42151,3,4,1,35,45,1795
10310,10310,8CAA944A76DA7309343EF407118B2A8F,42861,4,8,4,37,44,1894
10311,10311,8CAA944A76DA7309343EF407118B2A8F,11261,8,17,9,36,46,1846
10312,10312,8CAA944A76DA7309343EF407118B2A8F,42861,18,21,3,37,44,1894
10313,10313,8CAA944A76DA7309343EF407118B2A8F,11261,22,23,1,36,46,1846
10314,10314,DE7A331A2ADB65AF4D6289538234B91E,42201,0,1,1,43,46,2196
10315,10315,DE7A331A2ADB65AF4D6289538234B91E,13341,1,8,7,44,45,2245
10316,10316,DE7A331A2ADB65AF4D6289538234B91E,42201,10,11,1,43,46,2196
10317,10317,DE7A331A2ADB65AF4D6289538234B91E,13341,14,16,2,44,45,2245
10318,10318,DE7A331A2ADB65AF4D6289538234B91E,13231,19,21,2,39,46,1996
10319,10319,DE7A331A2ADB65AF4D6289538234B91E,11491,22,23,1,36,47,1847
10323,10323,A61D0F5D6E4730E77483BB5A83F54B2C,42771,1,8,7,36,47,1847
10324,10324,A61D0F5D6E4730E77483BB5A83F54B2C,42511,9,10,1,37,47,1897
10325,10325,A61D0F5D6E4730E77483BB5A83F54B2C,40124,12,17,5,38,47,1947
10326,10326,A61D0F5D6E4730E77483BB5A83F54B2C,11781,18,20,2,38,49,1949
10327,10327,A61D0F5D6E4730E77483BB5A83F54B2C,11531,21,23,2,34,49,1749
10331,10331,A53DAA006542212C0F792E33874BF547,11661,1,9,8,40,49,2049
10332,10332,A53DAA006542212C0F792E33874BF547,42161,13,18,5,36,47,1847
10333,10333,A53DAA006542212C0F792E33874BF547,42801,19,23,4,40,49,2049
10334,10334,BCCA36AC6DE92B5D284204C1D312B82A,43161,0,6,6,35,47,1797
10335,10335,BCCA36AC6DE92B5D284204C1D312B82A,10431,10,16,6,33,49,1699
10336,10336,BCCA36AC6DE92B5D284204C1D312B82A,11381,18,20,2,30,47,1547
10337,10337,BCCA36AC6DE92B5D284204C1D312B82A,42161,21,23,2,36,47,1847
10345,10345,7C46E639818D9018A7FC0F2856E8C040,42541,10,17,7,25,47,1297
10346,10346,7C46E639818D9018A7FC0F2856E8C040,13601,18,19,1,34,47,1747
10347,10347,7C46E639818D9018A7FC0F2856E8C040,42021,21,23,2,33,47,1697
10351,10351,CCCD2290FB632A48009771412BE68ADD,10491,2,5,3,33,48,1698
10352,10352,CCCD2290FB632A48009771412BE68ADD,42021,8,11,3,33,47,1697
10353,10353,CCCD2290FB632A48009771412BE68ADD,11861,12,15,3,32,47,1647
10354,10354,CCCD2290FB632A48009771412BE68ADD,42021,16,17,1,33,47,1697
10355,10355,CCCD2290FB632A48009771412BE68ADD,10691,19,23,4,33,48,1698
10360,10360,7F0F7E01EE512C1A933F7133254355CA,43021,0,3,3,16,43,843
10361,10361,7F0F7E01EE512C1A933F7133254355CA,12921,5,8,3,9,41,491
10362,10362,7F0F7E01EE512C1A933F7133254355CA,19261,8,10,2,6,37,337
10363,10363,7F0F7E01EE512C1A933F7133254355CA,12921,10,12,2,9,41,491
10364,10364,7F0F7E01EE512C1A933F7133254355CA,43021,12,13,1,16,43,843
10365,10365,7F0F7E01EE512C1A933F7133254355CA,12921,19,20,1,9,41,491
10366,10366,7F0F7E01EE512C1A933F7133254355CA,43021,20,23,3,16,43,843
10370,10370,73118727834AEF72D14D5BE83EC91BD1,11001,0,8,8,42,47,2147
10371,10371,73118727834AEF72D14D5BE83EC91BD1,13941,8,9,1,41,47,2097
10372,10372,73118727834AEF72D14D5BE83EC91BD1,11001,12,13,1,42,47,2147
10373,10373,73118727834AEF72D14D5BE83EC91BD1,11074,14,21,7,37,47,1897
10384,10384,4DA57F9F33C37E2CA21407DE781C18AF,42351,0,2,2,38,45,1945
10385,10385,4DA57F9F33C37E2CA21407DE781C18AF,13911,4,8,4,39,46,1996
10386,10386,4DA57F9F33C37E2CA21407DE781C18AF,42351,12,14,2,38,45,1945
10387,10387,4DA57F9F33C37E2CA21407DE781C18AF,10601,16,17,1,39,47,1997
10388,10388,4DA57F9F33C37E2CA21407DE781C18AF,11261,18,20,2,36,46,1846
10389,10389,4DA57F9F33C37E2CA21407DE781C18AF,13911,21,22,1,39,46,1996
10398,10398,E92DAF4B9A48CD6EAC32B0432875DE75,42041,1,2,1,10,47,547
10399,10399,E92DAF4B9A48CD6EAC32B0432875DE75,19441,3,4,1,8,46,446
10400,10400,E92DAF4B9A48CD6EAC32B0432875DE75,19621,5,8,3,5,46,296
10401,10401,E92DAF4B9A48CD6EAC32B0432875DE75,19901,11,13,2,7,44,394
10402,10402,E92DAF4B9A48CD6EAC32B0432875DE75,19441,18,22,4,8,46,446
10403,10403,F1249E9F0C0E4CFC8DF3A999C283E2E8,42151,0,8,8,35,45,1795
10404,10404,F1249E9F0C0E4CFC8DF3A999C283E2E8,10351,9,15,6,28,45,1445
10405,10405,F1249E9F0C0E4CFC8DF3A999C283E2E8,42151,19,23,4,35,45,1795
10406,10406,C7B2C2AE2DF954A69981F5A4F94159CA,13671,0,5,5,27,43,1393
10407,10407,C7B2C2AE2DF954A69981F5A4F94159CA,12731,7,10,3,22,40,1140
10408,10408,C7B2C2AE2DF954A69981F5A4F94159CA,42351,12,19,7,38,45,1945
10413,10413,5262ABE790766FD3345CF84BDACCA78B,11061,1,11,10,29,48,1498
10414,10414,5262ABE790766FD3345CF84BDACCA78B,42521,15,16,1,31,47,1597
10415,10415,5262ABE790766FD3345CF84BDACCA78B,11281,18,19,1,27,40,1390
10416,10416,5262ABE790766FD3345CF84BDACCA78B,10681,22,23,1,30,48,1548
10420,10420,2317EEF942E511029895E416C1875CE5,10281,2,16,14,33,48,1698
10421,10421,2317EEF942E511029895E416C1875CE5,11471,18,20,2,12,48,648
10422,10422,2317EEF942E511029895E416C1875CE5,10281,21,23,2,33,48,1698
10423,10423,5F63BC0B7F59A132C51B3769C24634BC,19441,3,6,3,8,46,446
10424,10424,5F63BC0B7F59A132C51B3769C24634BC,42041,10,11,1,10,47,547
10425,10425,5F63BC0B7F59A132C51B3769C24634BC,19441,11,19,8,8,46,446
10426,10426,5F63BC0B7F59A132C51B3769C24634BC,11631,21,23,2,12,49,649
10436,10436,5F5C2388C16FBBCF889B7BB88B6087BC,13341,0,6,6,44,45,2245
10437,10437,5F5C2388C16FBBCF889B7BB88B6087BC,42201,8,10,2,43,46,2196
10438,10438,5F5C2388C16FBBCF889B7BB88B6087BC,13341,12,14,2,44,45,2245
10439,10439,5F5C2388C16FBBCF889B7BB88B6087BC,43051,17,18,1,46,45,2345
10440,10440,5F5C2388C16FBBCF889B7BB88B6087BC,13341,20,23,3,44,45,2245
10441,10441,BF3354E7653978B437BDBF5412A04932,19281,0,8,8,16,32,832
10442,10442,BF3354E7653978B437BDBF5412A04932,12871,11,17,6,22,33,1133
10443,10443,BF3354E7653978B437BDBF5412A04932,19281,20,23,3,16,32,832
10444,10444,F238E4BCD894635E3C09F75844D0698F,42231,0,6,6,37,46,1896
10445,10445,F238E4BCD894635E3C09F75844D0698F,13711,6,8,2,38,46,1946
10446,10446,F238E4BCD894635E3C09F75844D0698F,42231,13,15,2,37,46,1896
10447,10447,F238E4BCD894635E3C09F75844D0698F,42351,17,18,1,38,45,1945
10448,10448,F238E4BCD894635E3C09F75844D0698F,42231,22,23,1,37,46,1896
10449,10449,19DD9EA3315ECB699A68A051C9281E6B,10471,0,7,7,37,48,1898
10450,10450,19DD9EA3315ECB699A68A051C9281E6B,11201,8,9,1,35,49,1799
10451,10451,19DD9EA3315ECB699A68A051C9281E6B,10471,10,17,7,37,48,1898
10452,10452,19DD9EA3315ECB699A68A051C9281E6B,11701,19,22,3,43,48,2198
10453,10453,DAF070E37522449552E837969D087804,11171,0,6,6,33,48,1698
10454,10454,DAF070E37522449552E837969D087804,10471,6,9,3,37,48,1898
10455,10455,DAF070E37522449552E837969D087804,11171,12,13,1,33,48,1698
10456,10456,DAF070E37522449552E837969D087804,10471,14,18,4,37,48,1898
10457,10457,DAF070E37522449552E837969D087804,11171,20,23,3,33,48,1698
10458,10458,DD41A5B37253F8BC5CA4FE0D3117DB9E,13314,0,6,6,31,39,1589
10459,10459,DD41A5B37253F8BC5CA4FE0D3117DB9E,12521,7,15,8,35,41,1791
10460,10460,DD41A5B37253F8BC5CA4FE0D3117DB9E,13314,18,20,2,31,39,1589
10464,10464,94C8FCC28825AA3685A20FFBC498E581,13091,0,3,3,20,42,1042
10465,10465,94C8FCC28825AA3685A20FFBC498E581,12311,4,5,1,30,44,1544
10466,10466,94C8FCC28825AA3685A20FFBC498E581,11834,6,9,3,32,45,1645
10467,10467,94C8FCC28825AA3685A20FFBC498E581,13091,12,23,11,20,42,1042
10471,10471,C7DA09D84BB6D5A3ABEAD976C8C0731E,42861,0,5,5,37,44,1894
10472,10472,C7DA09D84BB6D5A3ABEAD976C8C0731E,43451,7,9,2,37,40,1890
10473,10473,C7DA09D84BB6D5A3ABEAD976C8C0731E,42861,12,13,1,37,44,1894
10474,10474,C7DA09D84BB6D5A3ABEAD976C8C0731E,11261,13,15,2,36,46,1846
10475,10475,C7DA09D84BB6D5A3ABEAD976C8C0731E,42861,19,23,4,37,44,1894
10476,10476,B8DB030E6F574F75DC469AA0B11A44D5,10531,0,7,7,34,46,1746
10477,10477,B8DB030E6F574F75DC469AA0B11A44D5,42161,8,13,5,36,47,1847
10478,10478,B8DB030E6F574F75DC469AA0B11A44D5,42921,14,15,1,33,47,1697
10479,10479,B8DB030E6F574F75DC469AA0B11A44D5,43731,17,18,1,34,47,1747
10480,10480,B8DB030E6F574F75DC469AA0B11A44D5,10531,22,23,1,34,46,1746
10488,10488,6DD85D7BDF1489DA1FD52E787D95C9E5,10711,0,4,4,29,46,1496
10489,10489,6DD85D7BDF1489DA1FD52E787D95C9E5,19261,7,10,3,6,37,337
10490,10490,6DD85D7BDF1489DA1FD52E787D95C9E5,11871,12,18,6,29,46,1496
10491,10491,6DD85D7BDF1489DA1FD52E787D95C9E5,12021,20,21,1,37,49,1899
10495,10495,F2229754FABF7F398D6839D6208AC86F,10544,0,14,14,28,48,1448
10496,10496,F2229754FABF7F398D6839D6208AC86F,10381,14,15,1,31,49,1599
10497,10497,F2229754FABF7F398D6839D6208AC86F,11201,19,20,1,35,49,1799
10498,10498,F2229754FABF7F398D6839D6208AC86F,10544,21,23,2,28,48,1448
10502,10502,4939079DBC41D72C03B48C02C72AD37E,43021,0,3,3,16,43,843
10503,10503,4939079DBC41D72C03B48C02C72AD37E,12921,3,9,6,9,41,491
10504,10504,4939079DBC41D72C03B48C02C72AD37E,19261,10,11,1,6,37,337
10505,10505,4939079DBC41D72C03B48C02C72AD37E,43021,12,13,1,16,43,843
10506,10506,4939079DBC41D72C03B48C02C72AD37E,12921,14,16,2,9,41,491
10507,10507,4939079DBC41D72C03B48C02C72AD37E,43021,19,22,3,16,43,843
10511,10511,6D11D3FEB14395619B2C8DA34BCD86CD,11001,0,8,8,42,47,2147
10512,10512,6D11D3FEB14395619B2C8DA34BCD86CD,13941,8,9,1,41,47,2097
10513,10513,6D11D3FEB14395619B2C8DA34BCD86CD,11001,12,13,1,42,47,2147
10514,10514,6D11D3FEB14395619B2C8DA34BCD86CD,13941,16,18,2,41,47,2097
10515,10515,6D11D3FEB14395619B2C8DA34BCD86CD,11001,21,23,2,42,47,2147
10516,10516,2C3A1C890B30FB06A95DD4A9EF742265,19801,0,15,15,19,26,976
10517,10517,2C3A1C890B30FB06A95DD4A9EF742265,43121,15,17,2,25,27,1277
10518,10518,2C3A1C890B30FB06A95DD4A9EF742265,19801,17,20,3,19,26,976
10526,10526,BD5F22A4C7CC8B9EE10A1932970BC1EE,42623,0,8,8,22,49,1149
10527,10527,BD5F22A4C7CC8B9EE10A1932970BC1EE,11211,9,12,3,34,49,1749
10528,10528,BD5F22A4C7CC8B9EE10A1932970BC1EE,40341,15,18,3,23,49,1199
10529,10529,BD5F22A4C7CC8B9EE10A1932970BC1EE,42623,19,23,4,22,49,1149
10536,10536,0DD480B5A13E261C7A404CA1C7C938C6,42511,0,8,8,37,47,1897
10537,10537,0DD480B5A13E261C7A404CA1C7C938C6,13121,12,15,3,38,46,1946
10538,10538,0DD480B5A13E261C7A404CA1C7C938C6,42511,15,16,1,37,47,1897
10539,10539,0DD480B5A13E261C7A404CA1C7C938C6,13121,18,19,1,38,46,1946
10540,10540,0DD480B5A13E261C7A404CA1C7C938C6,42511,22,23,1,37,47,1897
10541,10541,A5A090591E63A367211B3058D6F881BC,12921,3,8,5,9,41,491
10542,10542,A5A090591E63A367211B3058D6F881BC,19114,10,11,1,7,43,393
10543,10543,A5A090591E63A367211B3058D6F881BC,43021,12,20,8,16,43,843
10544,10544,A5A090591E63A367211B3058D6F881BC,19114,21,22,1,7,43,393
10548,10548,709DC3F9DE860ECA4A76048AC96AFC2A,11271,8,12,4,37,48,1898
10549,10549,709DC3F9DE860ECA4A76048AC96AFC2A,13011,12,14,2,39,47,1997
10550,10550,709DC3F9DE860ECA4A76048AC96AFC2A,42031,17,22,5,40,46,2046
10555,10555,E1AC53F32ACDAF9A28CF81EDDD7292F5,19531,0,7,7,17,30,880
10556,10556,E1AC53F32ACDAF9A28CF81EDDD7292F5,19281,8,10,2,16,32,832
10557,10557,E1AC53F32ACDAF9A28CF81EDDD7292F5,19264,10,13,3,10,36,536
10558,10558,E1AC53F32ACDAF9A28CF81EDDD7292F5,19281,13,23,10,16,32,832
10559,10559,F7452B1C8BA4A771426217E4DE3588FB,42521,4,5,1,31,47,1597
10560,10560,F7452B1C8BA4A771426217E4DE3588FB,11061,6,7,1,29,48,1498
10561,10561,F7452B1C8BA4A771426217E4DE3588FB,40445,11,13,2,30,48,1548
10562,10562,F7452B1C8BA4A771426217E4DE3588FB,11061,15,17,2,29,48,1498
10563,10563,F7452B1C8BA4A771426217E4DE3588FB,11381,21,22,1,30,47,1547
10564,10564,6A033A0EADDB46E67519B419B27B2B4B,10491,0,9,9,33,48,1698
10565,10565,6A033A0EADDB46E67519B419B27B2B4B,42221,10,12,2,38,48,1948
10566,10566,6A033A0EADDB46E67519B419B27B2B4B,10491,12,14,2,33,48,1698
10567,10567,6A033A0EADDB46E67519B419B27B2B4B,42081,15,16,1,24,49,1249
10568,10568,6A033A0EADDB46E67519B419B27B2B4B,11641,16,18,2,22,49,1149
10569,10569,6A033A0EADDB46E67519B419B27B2B4B,10491,19,23,4,33,48,1698
10570,10570,22C64E68537A7507DD485F3E7D317C27,40833,1,6,5,41,47,2097
10571,10571,22C64E68537A7507DD485F3E7D317C27,11481,6,11,5,41,48,2098
10572,10572,22C64E68537A7507DD485F3E7D317C27,11074,13,18,5,37,47,1897
10573,10573,22C64E68537A7507DD485F3E7D317C27,11914,19,21,2,37,48,1898
10574,10574,22C64E68537A7507DD485F3E7D317C27,40302,21,23,2,40,49,2049
10578,10578,C5AC3744EA191771220A3FE471A7FACC,42161,0,7,7,36,47,1847
10579,10579,C5AC3744EA191771220A3FE471A7FACC,19111,9,14,5,9,45,495
10580,10580,C5AC3744EA191771220A3FE471A7FACC,10107,16,18,2,38,49,1949
10581,10581,C5AC3744EA191771220A3FE471A7FACC,42161,19,23,4,36,47,1847
10582,10582,13FE336F780D5F9F83776798BCE67144,11261,3,5,2,36,46,1846
10583,10583,13FE336F780D5F9F83776798BCE67144,42351,5,10,5,38,45,1945
10584,10584,13FE336F780D5F9F83776798BCE67144,11261,10,12,2,36,46,1846
10585,10585,13FE336F780D5F9F83776798BCE67144,42351,12,14,2,38,45,1945
10586,10586,13FE336F780D5F9F83776798BCE67144,11261,14,20,6,36,46,1846
10587,10587,75219378BBB10FFE07C7301517B53FE1,11806,0,7,7,41,48,2098
10588,10588,75219378BBB10FFE07C7301517B53FE1,11231,8,18,10,37,49,1899
10589,10589,75219378BBB10FFE07C7301517B53FE1,12514,18,19,1,38,47,1947
10590,10590,75219378BBB10FFE07C7301517B53FE1,42271,19,23,4,40,47,2047
10594,10594,8B162D826614AE6B0D3DB5A304485836,12401,0,7,7,39,49,1999
10595,10595,8B162D826614AE6B0D3DB5A304485836,11914,10,17,7,37,48,1898
10596,10596,8B162D826614AE6B0D3DB5A304485836,40697,19,21,2,43,48,2198
10603,10603,6DCAC2F18F7407E5D3AE4A23200E1C6B,43021,1,3,2,16,43,843
10604,10604,6DCAC2F18F7407E5D3AE4A23200E1C6B,12731,4,8,4,22,40,1140
10605,10605,6DCAC2F18F7407E5D3AE4A23200E1C6B,43021,12,18,6,16,43,843
10606,10606,6DCAC2F18F7407E5D3AE4A23200E1C6B,12641,19,20,1,10,43,543
10624,10624,7AA89BB9661933B510855B369171B5D1,40322,0,8,8,38,46,1946
10625,10625,7AA89BB9661933B510855B369171B5D1,42531,9,10,1,31,45,1595
10626,10626,7AA89BB9661933B510855B369171B5D1,42151,13,14,1,35,45,1795
10627,10627,7AA89BB9661933B510855B369171B5D1,11261,15,16,1,36,46,1846
10628,10628,7AA89BB9661933B510855B369171B5D1,42864,18,19,1,38,44,1944
10629,10629,7AA89BB9661933B510855B369171B5D1,11261,19,23,4,36,46,1846
10630,10630,20538B8C1777892DA77867D1D04B5D49,43761,0,2,2,32,47,1647
10631,10631,20538B8C1777892DA77867D1D04B5D49,11161,3,8,5,32,48,1648
10632,10632,20538B8C1777892DA77867D1D04B5D49,43761,10,17,7,32,47,1647
10633,10633,20538B8C1777892DA77867D1D04B5D49,11161,17,19,2,32,48,1648
10634,10634,20538B8C1777892DA77867D1D04B5D49,43761,20,23,3,32,47,1647
10638,10638,EC971BEA56DBA93E199ED44EE6EDF346,11861,0,8,8,32,47,1647
10639,10639,EC971BEA56DBA93E199ED44EE6EDF346,10691,9,12,3,33,48,1698
10640,10640,EC971BEA56DBA93E199ED44EE6EDF346,11861,12,13,1,32,47,1647
10641,10641,EC971BEA56DBA93E199ED44EE6EDF346,12381,16,17,1,32,48,1648
10642,10642,EC971BEA56DBA93E199ED44EE6EDF346,11861,19,23,4,32,47,1647
10643,10643,CA7675D4504FF649E5D3C79C1D770D57,10161,0,6,6,35,49,1799
10644,10644,CA7675D4504FF649E5D3C79C1D770D57,42831,7,8,1,27,48,1398
10645,10645,CA7675D4504FF649E5D3C79C1D770D57,10901,12,14,2,35,48,1798
10646,10646,CA7675D4504FF649E5D3C79C1D770D57,11151,14,18,4,30,48,1548
10647,10647,CA7675D4504FF649E5D3C79C1D770D57,10901,19,23,4,35,48,1798
10648,10648,FBFB039BFE202B4D733B8197A5DE9AA1,43751,1,5,4,19,48,998
10649,10649,FBFB039BFE202B4D733B8197A5DE9AA1,11361,6,7,1,22,48,1148
10650,10650,FBFB039BFE202B4D733B8197A5DE9AA1,12581,7,16,9,24,48,1248
10651,10651,FBFB039BFE202B4D733B8197A5DE9AA1,11361,16,18,2,22,48,1148
10652,10652,FBFB039BFE202B4D733B8197A5DE9AA1,43751,22,23,1,19,48,998
10653,10653,7A3CCBEE1EF7E270B4B301C75856D62F,11861,0,12,12,32,47,1647
10654,10654,7A3CCBEE1EF7E270B4B301C75856D62F,11461,14,15,1,37,49,1899
10655,10655,7A3CCBEE1EF7E270B4B301C75856D62F,11271,16,17,1,37,48,1898
10656,10656,7A3CCBEE1EF7E270B4B301C75856D62F,10731,18,21,3,33,47,1697
10657,10657,7A3CCBEE1EF7E270B4B301C75856D62F,11861,21,23,2,32,47,1647
10658,10658,14E7D089DD5BD2BF6DC15BA2DC5F8A8C,11324,0,14,14,31,46,1596
10659,10659,14E7D089DD5BD2BF6DC15BA2DC5F8A8C,40341,15,18,3,23,49,1199
10660,10660,14E7D089DD5BD2BF6DC15BA2DC5F8A8C,11324,19,21,2,31,46,1596
10664,10664,B896148F02B54F70CF09F4303DF87A20,19061,0,7,7,3,43,193
10665,10665,B896148F02B54F70CF09F4303DF87A20,19931,7,12,5,7,43,393
10666,10666,B896148F02B54F70CF09F4303DF87A20,11161,15,19,4,32,48,1648
10667,10667,B896148F02B54F70CF09F4303DF87A20,19621,21,23,2,5,46,296
10668,10668,4C4BFC6596FD3FEC2B91BC1C914BF8BF,19281,0,1,1,16,32,832
10669,10669,4C4BFC6596FD3FEC2B91BC1C914BF8BF,12871,1,4,3,22,33,1133
10670,10670,4C4BFC6596FD3FEC2B91BC1C914BF8BF,19531,6,8,2,17,30,880
10671,10671,4C4BFC6596FD3FEC2B91BC1C914BF8BF,19281,10,14,4,16,32,832
10672,10672,4C4BFC6596FD3FEC2B91BC1C914BF8BF,12871,15,17,2,22,33,1133
10673,10673,4C4BFC6596FD3FEC2B91BC1C914BF8BF,13511,18,23,5,34,48,1748
10703,10703,C518A470FA17AE3A0BAE461DF974B289,11481,0,2,2,41,48,2098
10704,10704,C518A470FA17AE3A0BAE461DF974B289,13271,5,10,5,41,47,2097
10705,10705,C518A470FA17AE3A0BAE461DF974B289,10251,17,18,1,35,47,1797
10706,10706,C518A470FA17AE3A0BAE461DF974B289,40833,21,23,2,41,47,2097
10707,10707,A0E1933ED6F7A553840E39014C4F2632,12871,0,6,6,22,33,1133
10708,10708,A0E1933ED6F7A553840E39014C4F2632,49181,7,9,2,21,31,1081
10709,10709,A0E1933ED6F7A553840E39014C4F2632,12871,12,15,3,22,33,1133
10710,10710,A0E1933ED6F7A553840E39014C4F2632,49181,17,18,1,21,31,1081
10711,10711,A0E1933ED6F7A553840E39014C4F2632,13481,20,23,3,26,31,1331
10715,10715,734BE21864A3611A04F28278A72C8D0B,42151,1,5,4,35,45,1795
10716,10716,734BE21864A3611A04F28278A72C8D0B,42351,7,8,1,38,45,1945
10717,10717,734BE21864A3611A04F28278A72C8D0B,13231,9,11,2,39,46,1996
10718,10718,734BE21864A3611A04F28278A72C8D0B,42151,12,21,9,35,45,1795
10719,10719,8B6448FD7DB9F8E2F8F73AFDDD5BFD38,43021,0,3,3,16,43,843
10720,10720,8B6448FD7DB9F8E2F8F73AFDDD5BFD38,12731,3,5,2,22,40,1140
10721,10721,8B6448FD7DB9F8E2F8F73AFDDD5BFD38,12921,5,18,13,9,41,491
10725,10725,BA02C3BCEE7A48A5C905C95BDC29D4FD,12792,7,9,2,34,30,1730
10726,10726,BA02C3BCEE7A48A5C905C95BDC29D4FD,15391,10,14,4,35,26,1776
10727,10727,BA02C3BCEE7A48A5C905C95BDC29D4FD,15661,15,17,2,36,26,1826
10728,10728,BA02C3BCEE7A48A5C905C95BDC29D4FD,15391,19,22,3,35,26,1776
10732,10732,CE83884CFD17B5073DAD15A75E54F414,12521,3,8,5,35,41,1791
10733,10733,CE83884CFD17B5073DAD15A75E54F414,10601,12,15,3,39,47,1997
10734,10734,CE83884CFD17B5073DAD15A75E54F414,12521,19,20,1,35,41,1791
10735,10735,A2DD7BA75FCE1B5306A377D198F94491,15391,0,13,13,35,26,1776
10736,10736,A2DD7BA75FCE1B5306A377D198F94491,12792,13,14,1,34,30,1730
10737,10737,A2DD7BA75FCE1B5306A377D198F94491,15391,19,23,4,35,26,1776
10745,10745,B354D45F8A0C0C2D18A14C5F2B89CD9E,11111,0,1,1,26,48,1348
10746,10746,B354D45F8A0C0C2D18A14C5F2B89CD9E,10841,4,10,6,37,47,1897
10747,10747,B354D45F8A0C0C2D18A14C5F2B89CD9E,10221,14,16,2,34,49,1749
10748,10748,B354D45F8A0C0C2D18A14C5F2B89CD9E,11074,18,19,1,37,47,1897
10749,10749,81946AFE1D298F3B40176C804AE3EF84,43121,0,1,1,25,27,1277
10750,10750,81946AFE1D298F3B40176C804AE3EF84,19801,2,12,10,19,26,976
10751,10751,81946AFE1D298F3B40176C804AE3EF84,43121,13,14,1,25,27,1277
10752,10752,81946AFE1D298F3B40176C804AE3EF84,19801,14,23,9,19,26,976
10756,10756,78A4AA9407E763ED8D1652A4AFF74DAE,12921,0,2,2,9,41,491
10757,10757,78A4AA9407E763ED8D1652A4AFF74DAE,19021,3,10,7,10,45,545
10758,10758,78A4AA9407E763ED8D1652A4AFF74DAE,19114,12,18,6,7,43,393
10759,10759,78A4AA9407E763ED8D1652A4AFF74DAE,12921,19,23,4,9,41,491
10767,10767,9CBF9B7BBDA02761C2FCA54EEB069B75,40801,0,7,7,43,46,2196
10768,10768,9CBF9B7BBDA02761C2FCA54EEB069B75,10511,9,12,3,35,46,1796
10769,10769,9CBF9B7BBDA02761C2FCA54EEB069B75,40801,13,15,2,43,46,2196
10770,10770,9CBF9B7BBDA02761C2FCA54EEB069B75,42511,15,18,3,37,47,1897
10771,10771,9CBF9B7BBDA02761C2FCA54EEB069B75,42301,18,19,1,36,47,1847
10772,10772,9CBF9B7BBDA02761C2FCA54EEB069B75,42511,21,23,2,37,47,1897
10773,10773,AB57CFBC7FBBD1B4F46C04046F726522,15171,0,5,5,42,21,2121
10774,10774,AB57CFBC7FBBD1B4F46C04046F726522,15021,6,8,2,46,18,2318
10775,10775,AB57CFBC7FBBD1B4F46C04046F726522,12881,12,16,4,47,22,2372
10776,10776,AB57CFBC7FBBD1B4F46C04046F726522,15171,20,23,3,42,21,2121
10777,10777,E45BFF8A7B42DBE312092B84982F68A3,11861,0,7,7,32,47,1647
10778,10778,E45BFF8A7B42DBE312092B84982F68A3,10634,9,10,1,27,45,1395
10779,10779,E45BFF8A7B42DBE312092B84982F68A3,11871,13,18,5,29,46,1496
10780,10780,E45BFF8A7B42DBE312092B84982F68A3,11861,19,23,4,32,47,1647
10788,10788,7CDAB588EA65BCF95FE0652A61C14CC7,12581,0,3,3,24,48,1248
10789,10789,7CDAB588EA65BCF95FE0652A61C14CC7,11101,7,14,7,18,48,948
10790,10790,7CDAB588EA65BCF95FE0652A61C14CC7,12581,17,23,6,24,48,1248
10794,10794,B90520ED7BDDE423CEFE3ED6913620C9,12514,3,6,3,38,47,1947
10795,10795,B90520ED7BDDE423CEFE3ED6913620C9,10841,8,9,1,37,47,1897
10796,10796,B90520ED7BDDE423CEFE3ED6913620C9,12514,9,12,3,38,47,1947
10797,10797,B90520ED7BDDE423CEFE3ED6913620C9,10841,14,17,3,37,47,1897
10798,10798,B90520ED7BDDE423CEFE3ED6913620C9,12514,17,22,5,38,47,1947
10799,10799,F96339A49EA24867AF66AA212A3AA3FA,11171,1,14,13,33,48,1698
10800,10800,F96339A49EA24867AF66AA212A3AA3FA,11631,16,20,4,12,49,649
10801,10801,F96339A49EA24867AF66AA212A3AA3FA,10881,22,23,1,34,48,1748
10805,10805,3A0EE9386BA4FE78C3588E05656D5E25,13371,0,14,14,41,47,2097
10806,10806,3A0EE9386BA4FE78C3588E05656D5E25,43161,15,17,2,35,47,1797
10807,10807,3A0EE9386BA4FE78C3588E05656D5E25,13371,19,23,4,41,47,2097
10808,10808,2C9F9127F2AECFBA8069624790D23C60,11921,1,7,6,38,48,1948
10809,10809,2C9F9127F2AECFBA8069624790D23C60,10471,7,9,2,37,48,1898
10810,10810,2C9F9127F2AECFBA8069624790D23C60,10221,10,12,2,34,49,1749
10811,10811,2C9F9127F2AECFBA8069624790D23C60,10301,16,17,1,31,45,1595
10812,10812,2C9F9127F2AECFBA8069624790D23C60,10471,21,23,2,37,48,1898
10813,10813,058B27B80ABF64CD68CCF0A1DE55F657,43021,0,3,3,16,43,843
10814,10814,058B27B80ABF64CD68CCF0A1DE55F657,11571,5,6,1,13,46,696
10815,10815,058B27B80ABF64CD68CCF0A1DE55F657,19261,7,8,1,6,37,337
10816,10816,058B27B80ABF64CD68CCF0A1DE55F657,12921,8,10,2,9,41,491
10817,10817,058B27B80ABF64CD68CCF0A1DE55F657,19021,10,11,1,10,45,545
10818,10818,058B27B80ABF64CD68CCF0A1DE55F657,43021,13,22,9,16,43,843
10822,10822,94E10F043AAF9155CBF5CC2C21719C3F,12401,0,7,7,39,49,1999
10823,10823,94E10F043AAF9155CBF5CC2C21719C3F,12661,10,16,6,32,45,1645
10824,10824,94E10F043AAF9155CBF5CC2C21719C3F,11211,18,19,1,34,49,1749
10825,10825,59644621240D60A0095CD2C9DBFE93CE,12871,0,2,2,22,33,1133
10826,10826,59644621240D60A0095CD2C9DBFE93CE,49181,3,4,1,21,31,1081
10827,10827,59644621240D60A0095CD2C9DBFE93CE,19801,9,10,1,19,26,976
10828,10828,59644621240D60A0095CD2C9DBFE93CE,12871,11,12,1,22,33,1133
10829,10829,59644621240D60A0095CD2C9DBFE93CE,49181,14,15,1,21,31,1081
10830,10830,59644621240D60A0095CD2C9DBFE93CE,12871,18,19,1,22,33,1133
10831,10831,59644621240D60A0095CD2C9DBFE93CE,12874,22,23,1,20,34,1034
10839,10839,88FE361D84BF34DD1AB79F3DA14ADA96,11461,0,7,7,37,49,1899
10840,10840,88FE361D84BF34DD1AB79F3DA14ADA96,10107,8,9,1,38,49,1949
10841,10841,88FE361D84BF34DD1AB79F3DA14ADA96,43281,12,17,5,37,48,1898
10842,10842,88FE361D84BF34DD1AB79F3DA14ADA96,10107,19,21,2,38,49,1949
10843,10843,88FE361D84BF34DD1AB79F3DA14ADA96,43281,22,23,1,37,48,1898
10851,10851,456B92CD20400F1E2BB076575324C8C5,42141,0,5,5,32,47,1647
10852,10852,456B92CD20400F1E2BB076575324C8C5,42523,7,8,1,31,47,1597
10853,10853,456B92CD20400F1E2BB076575324C8C5,43761,10,11,1,32,47,1647
10854,10854,456B92CD20400F1E2BB076575324C8C5,42523,15,16,1,31,47,1597
10855,10855,456B92CD20400F1E2BB076575324C8C5,42141,19,23,4,32,47,1647
10860,10860,AF03CB6E19CFE236682919AFB51A6FD2,11731,1,4,3,36,48,1848
10861,10861,AF03CB6E19CFE236682919AFB51A6FD2,10401,8,9,1,33,49,1699
10862,10862,AF03CB6E19CFE236682919AFB51A6FD2,10531,12,14,2,34,46,1746
10863,10863,AF03CB6E19CFE236682919AFB51A6FD2,10295,18,19,1,30,47,1547
10864,10864,AF03CB6E19CFE236682919AFB51A6FD2,11731,21,23,2,36,48,1848
10865,10865,27A0DD6A965A1FEA8EED4D0E73345414,12921,0,1,1,9,41,491
10866,10866,27A0DD6A965A1FEA8EED4D0E73345414,19181,1,6,5,8,40,440
10867,10867,27A0DD6A965A1FEA8EED4D0E73345414,12921,10,11,1,9,41,491
10868,10868,27A0DD6A965A1FEA8EED4D0E73345414,12641,19,20,1,10,43,543
10869,10869,27A0DD6A965A1FEA8EED4D0E73345414,12921,21,23,2,9,41,491
10883,10883,1206CD8A013308907070315A8285F2C6,42161,0,1,1,36,47,1847
10884,10884,1206CD8A013308907070315A8285F2C6,10271,4,5,1,37,46,1896
10885,10885,1206CD8A013308907070315A8285F2C6,40431,5,7,2,36,47,1847
10886,10886,1206CD8A013308907070315A8285F2C6,13671,14,16,2,27,43,1393
10887,10887,1206CD8A013308907070315A8285F2C6,11491,21,23,2,36,47,1847
10892,10892,09C2A5500F5ABAEEAC932C07F5628EC4,11021,1,8,7,36,49,1849
10893,10893,09C2A5500F5ABAEEAC932C07F5628EC4,43161,9,12,3,35,47,1797
10894,10894,09C2A5500F5ABAEEAC932C07F5628EC4,11021,12,13,1,36,49,1849
10895,10895,09C2A5500F5ABAEEAC932C07F5628EC4,42161,14,19,5,36,47,1847
10896,10896,09C2A5500F5ABAEEAC932C07F5628EC4,11021,19,23,4,36,49,1849
10900,10900,D386638145B111A8970690A997DA1BBB,10292,0,10,10,30,47,1547
10901,10901,D386638145B111A8970690A997DA1BBB,13094,11,13,2,21,42,1092
10902,10902,D386638145B111A8970690A997DA1BBB,10381,16,17,1,31,49,1599
10903,10903,D386638145B111A8970690A997DA1BBB,10292,21,23,2,30,47,1547
10904,10904,93C8A9BFC982F63705EDC3214DA05AC8,12841,1,7,6,37,47,1897
10905,10905,93C8A9BFC982F63705EDC3214DA05AC8,42081,10,14,4,24,49,1249
10906,10906,93C8A9BFC982F63705EDC3214DA05AC8,11291,15,16,1,40,49,2049
10907,10907,93C8A9BFC982F63705EDC3214DA05AC8,40673,19,22,3,36,48,1848
10908,10908,4F985171E935EB3DC7536EAA1C4743E5,42623,0,2,2,22,49,1149
10909,10909,4F985171E935EB3DC7536EAA1C4743E5,42081,3,4,1,24,49,1249
10910,10910,4F985171E935EB3DC7536EAA1C4743E5,42623,7,8,1,22,49,1149
10911,10911,4F985171E935EB3DC7536EAA1C4743E5,42071,10,13,3,31,49,1599
10912,10912,4F985171E935EB3DC7536EAA1C4743E5,42623,14,23,9,22,49,1149
10913,10913,F276DA0C0E39AE3BAD5B91AE46CB6EA8,10471,3,4,1,37,48,1898
10914,10914,F276DA0C0E39AE3BAD5B91AE46CB6EA8,11231,8,10,2,37,49,1899
10915,10915,F276DA0C0E39AE3BAD5B91AE46CB6EA8,10471,14,15,1,37,48,1898
10916,10916,F276DA0C0E39AE3BAD5B91AE46CB6EA8,42971,19,23,4,43,49,2199
10917,10917,BBCB9918D42B41DEDF16DD7F5A9BE26F,11861,0,6,6,32,47,1647
10918,10918,BBCB9918D42B41DEDF16DD7F5A9BE26F,42161,7,10,3,36,47,1847
10919,10919,BBCB9918D42B41DEDF16DD7F5A9BE26F,11861,11,12,1,32,47,1647
10920,10920,BBCB9918D42B41DEDF16DD7F5A9BE26F,10411,13,17,4,36,48,1848
10921,10921,BBCB9918D42B41DEDF16DD7F5A9BE26F,11861,17,23,6,32,47,1647
10922,10922,B05109E3A879289F30B4B70D9AEC3191,13351,0,6,6,48,48,2448
10923,10923,B05109E3A879289F30B4B70D9AEC3191,11701,8,15,7,43,48,2198
10924,10924,B05109E3A879289F30B4B70D9AEC3191,13351,17,22,5,48,48,2448
10929,10929,C4D447C579303801DBAA68E63C8E7FE2,13371,0,9,9,41,47,2097
10930,10930,C4D447C579303801DBAA68E63C8E7FE2,11481,9,11,2,41,48,2098
10931,10931,C4D447C579303801DBAA68E63C8E7FE2,13371,11,13,2,41,47,2097
10932,10932,C4D447C579303801DBAA68E63C8E7FE2,11481,14,15,1,41,48,2098
10933,10933,C4D447C579303801DBAA68E63C8E7FE2,13371,16,23,7,41,47,2097
10934,10934,AAE32F7F7BC1DB54B5A7606079B9E082,13941,0,6,6,41,47,2097
10935,10935,AAE32F7F7BC1DB54B5A7606079B9E082,10841,10,11,1,37,47,1897
10936,10936,AAE32F7F7BC1DB54B5A7606079B9E082,13941,12,15,3,41,47,2097
10937,10937,AAE32F7F7BC1DB54B5A7606079B9E082,10841,16,18,2,37,47,1897
10938,10938,AAE32F7F7BC1DB54B5A7606079B9E082,13511,18,20,2,34,48,1748
10939,10939,62A81BAE02AD26F7FD1065485EC5610B,42321,0,6,6,43,47,2197
10940,10940,62A81BAE02AD26F7FD1065485EC5610B,42401,6,18,12,36,47,1847
10941,10941,62A81BAE02AD26F7FD1065485EC5610B,42321,18,23,5,43,47,2197
10953,10953,AD235EE6A83CA7956AB86E8BC887D3C7,11541,0,5,5,35,49,1799
10954,10954,AD235EE6A83CA7956AB86E8BC887D3C7,13561,6,10,4,37,49,1899
10955,10955,AD235EE6A83CA7956AB86E8BC887D3C7,11021,10,11,1,36,49,1849
10956,10956,AD235EE6A83CA7956AB86E8BC887D3C7,13561,12,14,2,37,49,1899
10957,10957,AD235EE6A83CA7956AB86E8BC887D3C7,11021,14,16,2,36,49,1849
10958,10958,AD235EE6A83CA7956AB86E8BC887D3C7,11541,18,23,5,35,49,1799
10965,10965,30165500CA5F6A8CB10812947A58AC25,10251,0,14,14,35,47,1797
10966,10966,30165500CA5F6A8CB10812947A58AC25,10061,16,17,1,20,46,1046
10967,10967,30165500CA5F6A8CB10812947A58AC25,10251,19,23,4,35,47,1797
10971,10971,3BFDEE5AA767E9C0C7179A3FAC680D84,11861,0,1,1,32,47,1647
10972,10972,3BFDEE5AA767E9C0C7179A3FAC680D84,12083,2,16,14,36,49,1849
10973,10973,3BFDEE5AA767E9C0C7179A3FAC680D84,11861,21,23,2,32,47,1647
10974,10974,5A023340217ACADB6D658A3D5912E97C,11061,0,7,7,29,48,1498
10975,10975,5A023340217ACADB6D658A3D5912E97C,43241,9,15,6,36,46,1846
10976,10976,5A023340217ACADB6D658A3D5912E97C,12971,16,17,1,32,48,1648
10977,10977,5A023340217ACADB6D658A3D5912E97C,43971,17,18,1,30,48,1548
10981,10981,B51B8C74A49BD6867CCC9145F07F78FF,12921,0,7,7,9,41,491
10982,10982,B51B8C74A49BD6867CCC9145F07F78FF,19261,8,9,1,6,37,337
10983,10983,B51B8C74A49BD6867CCC9145F07F78FF,43644,13,15,2,14,38,738
10984,10984,B51B8C74A49BD6867CCC9145F07F78FF,43021,17,19,2,16,43,843
10985,10985,6B0C3EBFB355FDC40FD1A590445FAB6D,19441,0,9,9,8,46,446
10986,10986,6B0C3EBFB355FDC40FD1A590445FAB6D,10107,13,14,1,38,49,1949
10987,10987,6B0C3EBFB355FDC40FD1A590445FAB6D,19441,17,21,4,8,46,446
10988,10988,BA7C0D0905AD7B2A4C37AC9B433E8493,10111,0,1,1,37,47,1897
10989,10989,BA7C0D0905AD7B2A4C37AC9B433E8493,43361,3,9,6,38,48,1948
10990,10990,BA7C0D0905AD7B2A4C37AC9B433E8493,13941,13,15,2,41,47,2097
10991,10991,BA7C0D0905AD7B2A4C37AC9B433E8493,10681,16,17,1,30,48,1548
10992,10992,BA7C0D0905AD7B2A4C37AC9B433E8493,10921,21,23,2,43,48,2198
10993,10993,56BF703F887E17790C3BEE3B65E096E0,42351,0,6,6,38,45,1945
10994,10994,56BF703F887E17790C3BEE3B65E096E0,43101,7,9,2,46,40,2340
10995,10995,56BF703F887E17790C3BEE3B65E096E0,42351,11,13,2,38,45,1945
10996,10996,56BF703F887E17790C3BEE3B65E096E0,43951,17,18,1,49,41,2491
10997,10997,56BF703F887E17790C3BEE3B65E096E0,42351,19,23,4,38,45,1945
10998,10998,15351107348D533F1A62174A9ED24724,13314,0,3,3,31,39,1589
10999,10999,15351107348D533F1A62174A9ED24724,12521,7,15,8,35,41,1791
11000,11000,15351107348D533F1A62174A9ED24724,43451,16,17,1,37,40,1890
11001,11001,15351107348D533F1A62174A9ED24724,13314,18,23,5,31,39,1589
11002,11002,78102BB6CA60765D76F3DF3B51005292,42071,2,15,13,31,49,1599
11003,11003,78102BB6CA60765D76F3DF3B51005292,42121,15,16,1,26,49,1349
11004,11004,78102BB6CA60765D76F3DF3B51005292,42071,16,20,4,31,49,1599
11005,11005,1875203C4585FEEACDDFD3A15D9A505C,13941,0,9,9,41,47,2097
11006,11006,1875203C4585FEEACDDFD3A15D9A505C,11021,13,14,1,36,49,1849
11007,11007,1875203C4585FEEACDDFD3A15D9A505C,13941,15,18,3,41,47,2097
11008,11008,1875203C4585FEEACDDFD3A15D9A505C,10801,19,20,1,42,47,2147
11009,11009,1875203C4585FEEACDDFD3A15D9A505C,13371,20,22,2,41,47,2097
11010,11010,68A24D68E1EE6F85D7484BA18462FF82,40733,2,9,7,32,48,1648
11011,11011,68A24D68E1EE6F85D7484BA18462FF82,42491,10,12,2,32,46,1646
11012,11012,68A24D68E1EE6F85D7484BA18462FF82,42091,15,17,2,43,46,2196
11013,11013,68A24D68E1EE6F85D7484BA18462FF82,42523,19,20,1,31,47,1597
11014,11014,587D5F224C01DBFA5DAC05C42B3ABD58,42021,0,9,9,33,47,1697
11015,11015,587D5F224C01DBFA5DAC05C42B3ABD58,10251,10,14,4,35,47,1797
11016,11016,587D5F224C01DBFA5DAC05C42B3ABD58,11081,14,17,3,35,46,1796
11017,11017,587D5F224C01DBFA5DAC05C42B3ABD58,42921,18,20,2,33,47,1697
11018,11018,587D5F224C01DBFA5DAC05C42B3ABD58,42801,21,22,1,40,49,2049
11019,11019,D6B032CB5D87220B41302869DA7EAC60,11914,0,1,1,37,48,1898
11020,11020,D6B032CB5D87220B41302869DA7EAC60,11351,3,4,1,36,48,1848
11021,11021,D6B032CB5D87220B41302869DA7EAC60,12083,4,6,2,36,49,1849
11022,11022,D6B032CB5D87220B41302869DA7EAC60,11351,6,9,3,36,48,1848
11023,11023,D6B032CB5D87220B41302869DA7EAC60,11271,12,14,2,37,48,1898
11024,11024,D6B032CB5D87220B41302869DA7EAC60,10681,19,21,2,30,48,1548
11025,11025,D6B032CB5D87220B41302869DA7EAC60,11271,21,23,2,37,48,1898
11030,11030,FDF3A555382668B3FCFD730AFF8664D2,10411,0,7,7,36,48,1848
11031,11031,FDF3A555382668B3FCFD730AFF8664D2,10471,8,9,1,37,48,1898
11032,11032,FDF3A555382668B3FCFD730AFF8664D2,11231,9,12,3,37,49,1899
11033,11033,FDF3A555382668B3FCFD730AFF8664D2,10411,13,14,1,36,48,1848
11034,11034,FDF3A555382668B3FCFD730AFF8664D2,11231,14,18,4,37,49,1899
11035,11035,FDF3A555382668B3FCFD730AFF8664D2,10411,19,23,4,36,48,1848
11036,11036,A52680CFF3255B80F2E899094DC1E938,43051,0,5,5,46,45,2345
11037,11037,A52680CFF3255B80F2E899094DC1E938,43951,7,17,10,49,41,2491
11038,11038,A52680CFF3255B80F2E899094DC1E938,13951,21,23,2,47,45,2395
11039,11039,7C4A1E720A876232959C1D9DB2E3F46A,43644,0,2,2,14,38,738
11040,11040,7C4A1E720A876232959C1D9DB2E3F46A,19181,3,12,9,8,40,440
11041,11041,7C4A1E720A876232959C1D9DB2E3F46A,43644,16,18,2,14,38,738
11042,11042,7C4A1E720A876232959C1D9DB2E3F46A,19181,21,22,1,8,40,440
11043,11043,F587555054424F7ED0D63829AAEB0C06,42271,0,4,4,40,47,2047
11044,11044,F587555054424F7ED0D63829AAEB0C06,11806,4,6,2,41,48,2098
11045,11045,F587555054424F7ED0D63829AAEB0C06,42271,6,12,6,40,47,2047
11046,11046,F587555054424F7ED0D63829AAEB0C06,11806,16,18,2,41,48,2098
11047,11047,F587555054424F7ED0D63829AAEB0C06,42271,19,22,3,40,47,2047
11048,11048,49DE38F8BB8DEC2E062FBDF39519CC2F,40034,0,6,6,32,48,1648
11049,11049,49DE38F8BB8DEC2E062FBDF39519CC2F,11381,8,9,1,30,47,1547
11050,11050,49DE38F8BB8DEC2E062FBDF39519CC2F,12381,10,13,3,32,48,1648
11051,11051,49DE38F8BB8DEC2E062FBDF39519CC2F,40203,13,17,4,33,49,1699
11052,11052,49DE38F8BB8DEC2E062FBDF39519CC2F,43361,20,23,3,38,48,1948
11056,11056,FED0F32FAD7E2AF3E2C934AA6A661AD7,13671,0,7,7,27,43,1393
11057,11057,FED0F32FAD7E2AF3E2C934AA6A661AD7,12311,16,18,2,30,44,1544
11058,11058,FED0F32FAD7E2AF3E2C934AA6A661AD7,13791,19,20,1,42,47,2147
11059,11059,FED0F32FAD7E2AF3E2C934AA6A661AD7,13671,21,23,2,27,43,1393
11060,11060,586F3CB937FEA42C49864E019CACBB68,11331,0,9,9,37,48,1898
11061,11061,586F3CB937FEA42C49864E019CACBB68,12401,10,13,3,39,49,1999
11062,11062,586F3CB937FEA42C49864E019CACBB68,11074,16,17,1,37,47,1897
11063,11063,586F3CB937FEA42C49864E019CACBB68,12401,19,20,1,39,49,1999
11064,11064,586F3CB937FEA42C49864E019CACBB68,42623,21,22,1,22,49,1149
11068,11068,D366589B3E90DFE9BB97263FFFDAB40D,13911,0,5,5,39,46,1996
11069,11069,D366589B3E90DFE9BB97263FFFDAB40D,42231,7,10,3,37,46,1896
11070,11070,D366589B3E90DFE9BB97263FFFDAB40D,13911,12,13,1,39,46,1996
11071,11071,D366589B3E90DFE9BB97263FFFDAB40D,42231,14,18,4,37,46,1896
11072,11072,D366589B3E90DFE9BB97263FFFDAB40D,13911,21,23,2,39,46,1996
11073,11073,B33429D7A00DB66721EA07FF9AC9AB45,11861,0,9,9,32,47,1647
11074,11074,B33429D7A00DB66721EA07FF9AC9AB45,40077,12,22,10,37,49,1899
11075,11075,B33429D7A00DB66721EA07FF9AC9AB45,11861,22,23,1,32,47,1647
11076,11076,08B6161A63F0BFCCF67BFC0EA5B81E44,42621,0,6,6,24,49,1249
11077,11077,08B6161A63F0BFCCF67BFC0EA5B81E44,40341,6,11,5,23,49,1199
11078,11078,08B6161A63F0BFCCF67BFC0EA5B81E44,42621,11,13,2,24,49,1249
11079,11079,08B6161A63F0BFCCF67BFC0EA5B81E44,40341,14,18,4,23,49,1199
11080,11080,08B6161A63F0BFCCF67BFC0EA5B81E44,42621,22,23,1,24,49,1249
11090,11090,6D25A6C829B8BD023CC00BFD8686E2F7,11074,1,15,14,37,47,1897
11091,11091,6D25A6C829B8BD023CC00BFD8686E2F7,12221,18,20,2,43,44,2194
11092,11092,6D25A6C829B8BD023CC00BFD8686E2F7,11074,22,23,1,37,47,1897
11093,11093,57A11C69A3CFFAF7D81C63116FAF187A,42711,0,14,14,26,48,1348
11094,11094,57A11C69A3CFFAF7D81C63116FAF187A,40951,15,19,4,36,49,1849
11095,11095,57A11C69A3CFFAF7D81C63116FAF187A,10901,19,21,2,35,48,1798
11096,11096,FF0C11254BA355CCA708C36EE5C4353D,11381,0,7,7,30,47,1547
11097,11097,FF0C11254BA355CCA708C36EE5C4353D,42111,8,17,9,44,46,2246
11098,11098,FF0C11254BA355CCA708C36EE5C4353D,11381,21,23,2,30,47,1547
11099,11099,A42A7F31D778621002EB431CD3277B01,43621,0,6,6,46,48,2348
11100,11100,A42A7F31D778621002EB431CD3277B01,11481,7,8,1,41,48,2098
11101,11101,A42A7F31D778621002EB431CD3277B01,43621,12,23,11,46,48,2348
11105,11105,765113C0EC03D9C2E8837F99909100D7,42401,0,7,7,36,47,1847
11106,11106,765113C0EC03D9C2E8837F99909100D7,10681,11,12,1,30,48,1548
11107,11107,765113C0EC03D9C2E8837F99909100D7,10251,14,16,2,35,47,1797
11108,11108,765113C0EC03D9C2E8837F99909100D7,10681,17,20,3,30,48,1548
11109,11109,DAE97FB0BCA7A931E79901DF80B6F76E,19901,0,7,7,7,44,394
11110,11110,DAE97FB0BCA7A931E79901DF80B6F76E,12921,7,12,5,9,41,491
11111,11111,DAE97FB0BCA7A931E79901DF80B6F76E,19901,12,23,11,7,44,394
11112,11112,EC8D784C19C185B8F2C30A9ECA831652,13911,0,3,3,39,46,1996
11113,11113,EC8D784C19C185B8F2C30A9ECA831652,12211,3,8,5,41,44,2094
11114,11114,EC8D784C19C185B8F2C30A9ECA831652,13911,12,13,1,39,46,1996
11115,11115,EC8D784C19C185B8F2C30A9ECA831652,11261,15,16,1,36,46,1846
11116,11116,EC8D784C19C185B8F2C30A9ECA831652,13911,21,23,2,39,46,1996
11117,11117,9DA4BB2C882A7F80C23A8CE3C669C4E5,12971,0,7,7,32,48,1648
11118,11118,9DA4BB2C882A7F80C23A8CE3C669C4E5,11741,9,12,3,42,49,2149
11119,11119,9DA4BB2C882A7F80C23A8CE3C669C4E5,10281,13,14,1,33,48,1698
11120,11120,9DA4BB2C882A7F80C23A8CE3C669C4E5,42021,16,17,1,33,47,1697
11121,11121,9DA4BB2C882A7F80C23A8CE3C669C4E5,12971,18,23,5,32,48,1648
11122,11122,E528C1BCF7730647027A4A7EFB058975,13341,0,1,1,44,45,2245
11123,11123,E528C1BCF7730647027A4A7EFB058975,42631,1,7,6,43,45,2195
11124,11124,E528C1BCF7730647027A4A7EFB058975,13341,9,12,3,44,45,2245
11125,11125,E528C1BCF7730647027A4A7EFB058975,43061,16,18,2,43,46,2196
11126,11126,E528C1BCF7730647027A4A7EFB058975,42631,19,23,4,43,45,2195
11127,11127,04FC279D8763FD0D52EBF8F599CB8F45,11021,0,8,8,36,49,1849
11128,11128,04FC279D8763FD0D52EBF8F599CB8F45,42511,10,18,8,37,47,1897
11129,11129,04FC279D8763FD0D52EBF8F599CB8F45,10121,18,20,2,36,49,1849
11130,11130,04FC279D8763FD0D52EBF8F599CB8F45,13711,21,23,2,38,46,1946
11131,11131,5ABFABF55A302AC65CDD1BFE0186727A,11921,2,7,5,38,48,1948
11132,11132,5ABFABF55A302AC65CDD1BFE0186727A,43731,11,13,2,34,47,1747
11133,11133,5ABFABF55A302AC65CDD1BFE0186727A,10971,17,19,2,35,47,1797
11141,11141,75BFFCED9CAF9A2E487EE1A330B72AB2,42151,0,14,14,35,45,1795
11142,11142,75BFFCED9CAF9A2E487EE1A330B72AB2,40341,15,19,4,23,49,1199
11143,11143,75BFFCED9CAF9A2E487EE1A330B72AB2,10531,20,21,1,34,46,1746
11144,11144,75BFFCED9CAF9A2E487EE1A330B72AB2,42151,21,23,2,35,45,1795
11145,11145,5F315B8AB5504104DAD81595D37335A2,11231,0,2,2,37,49,1899
11146,11146,5F315B8AB5504104DAD81595D37335A2,10471,2,3,1,37,48,1898
11147,11147,5F315B8AB5504104DAD81595D37335A2,11381,6,18,12,30,47,1547
11148,11148,5F315B8AB5504104DAD81595D37335A2,11871,18,20,2,29,46,1496
11158,11158,026400BF77ED9426898CFF8EBE921A19,43751,0,6,6,19,48,998
11159,11159,026400BF77ED9426898CFF8EBE921A19,12581,6,11,5,24,48,1248
11160,11160,026400BF77ED9426898CFF8EBE921A19,43751,13,14,1,19,48,998
11161,11161,026400BF77ED9426898CFF8EBE921A19,12581,18,19,1,24,48,1248
11162,11162,026400BF77ED9426898CFF8EBE921A19,43751,19,23,4,19,48,998
11163,11163,1277ACA424D6A91D4C363B632562549C,10501,2,7,5,22,46,1146
11164,11164,1277ACA424D6A91D4C363B632562549C,10951,9,10,1,29,48,1498
11165,11165,1277ACA424D6A91D4C363B632562549C,10501,12,18,6,22,46,1146
11169,11169,31E3C6E91E6520C2C5D7BFDA47CC8641,43971,1,7,6,30,48,1548
11170,11170,31E3C6E91E6520C2C5D7BFDA47CC8641,11061,10,11,1,29,48,1498
11171,11171,31E3C6E91E6520C2C5D7BFDA47CC8641,11381,14,15,1,30,47,1547
11172,11172,31E3C6E91E6520C2C5D7BFDA47CC8641,11061,15,16,1,29,48,1498
11173,11173,31E3C6E91E6520C2C5D7BFDA47CC8641,11381,18,20,2,30,47,1547
11174,11174,72CBF9D6A57AAF950CC7AA6E4324A7E7,11331,0,6,6,37,48,1898
11175,11175,72CBF9D6A57AAF950CC7AA6E4324A7E7,12521,9,12,3,35,41,1791
11176,11176,72CBF9D6A57AAF950CC7AA6E4324A7E7,13314,14,18,4,31,39,1589
11177,11177,72CBF9D6A57AAF950CC7AA6E4324A7E7,10281,20,21,1,33,48,1698
11178,11178,72CBF9D6A57AAF950CC7AA6E4324A7E7,11331,21,23,2,37,48,1898
11179,11179,41A01DC1A08492F811E75051AA4EA6A5,10621,4,13,9,41,49,2099
11180,11180,41A01DC1A08492F811E75051AA4EA6A5,13121,17,19,2,38,46,1946
11181,11181,41A01DC1A08492F811E75051AA4EA6A5,10231,22,23,1,39,49,1999
11182,11182,C8236143E8B93D5FDE499177CF2B28F7,11381,0,5,5,30,47,1547
11183,11183,C8236143E8B93D5FDE499177CF2B28F7,42861,6,7,1,37,44,1894
11184,11184,C8236143E8B93D5FDE499177CF2B28F7,12661,8,9,1,32,45,1645
11185,11185,C8236143E8B93D5FDE499177CF2B28F7,42861,14,15,1,37,44,1894
11186,11186,C8236143E8B93D5FDE499177CF2B28F7,11381,16,23,7,30,47,1547
11187,11187,64FF3E93355E6DCA29977E04D316EABA,42471,0,1,1,35,49,1799
11188,11188,64FF3E93355E6DCA29977E04D316EABA,40637,3,8,5,36,47,1847
11189,11189,64FF3E93355E6DCA29977E04D316EABA,43161,13,16,3,35,47,1797
11190,11190,64FF3E93355E6DCA29977E04D316EABA,12083,16,18,2,36,49,1849
11191,11191,64FF3E93355E6DCA29977E04D316EABA,11541,19,23,4,35,49,1799
11192,11192,C35FFF479AFA41CBA0BE0F746C2360BC,11875,0,6,6,30,46,1546
11193,11193,C35FFF479AFA41CBA0BE0F746C2360BC,12311,9,10,1,30,44,1544
11194,11194,C35FFF479AFA41CBA0BE0F746C2360BC,11875,12,13,1,30,46,1546
11195,11195,C35FFF479AFA41CBA0BE0F746C2360BC,12311,16,17,1,30,44,1544
11196,11196,C35FFF479AFA41CBA0BE0F746C2360BC,11875,18,23,5,30,46,1546
11197,11197,414AA00EC00DAA3D830C87A4F3E4DD09,13601,0,2,2,34,47,1747
11198,11198,414AA00EC00DAA3D830C87A4F3E4DD09,11861,2,8,6,32,47,1647
11199,11199,414AA00EC00DAA3D830C87A4F3E4DD09,10651,12,17,5,36,49,1849
11200,11200,414AA00EC00DAA3D830C87A4F3E4DD09,13561,18,20,2,37,49,1899
11208,11208,3C9CB61D74BB3E5D7C5E26532F3182E9,10661,0,9,9,37,49,1899
11209,11209,3C9CB61D74BB3E5D7C5E26532F3182E9,40341,11,16,5,23,49,1199
11210,11210,3C9CB61D74BB3E5D7C5E26532F3182E9,10661,19,21,2,37,49,1899
11214,11214,4FF00BF3407B9A1F2FB89B661DFCF590,10111,0,9,9,37,47,1897
11215,11215,4FF00BF3407B9A1F2FB89B661DFCF590,40637,14,16,2,36,47,1847
11216,11216,4FF00BF3407B9A1F2FB89B661DFCF590,40421,17,18,1,37,48,1898
11217,11217,4FF00BF3407B9A1F2FB89B661DFCF590,40341,19,20,1,23,49,1199
11218,11218,A26526FCE25758DA240C3B314B205E8A,19024,0,6,6,9,45,495
11219,11219,A26526FCE25758DA240C3B314B205E8A,19114,8,12,4,7,43,393
11220,11220,A26526FCE25758DA240C3B314B205E8A,12921,13,15,2,9,41,491
11221,11221,A26526FCE25758DA240C3B314B205E8A,12641,15,17,2,10,43,543
11222,11222,A26526FCE25758DA240C3B314B205E8A,19441,19,20,1,8,46,446
11223,11223,A26526FCE25758DA240C3B314B205E8A,19024,21,23,2,9,45,495
11230,11230,1F739BDB545C56FBC617A916604523EE,42231,0,6,6,37,46,1896
11231,11231,1F739BDB545C56FBC617A916604523EE,12581,9,15,6,24,48,1248
11232,11232,1F739BDB545C56FBC617A916604523EE,43751,16,18,2,19,48,998
11233,11233,1F739BDB545C56FBC617A916604523EE,42231,19,22,3,37,46,1896
11241,11241,D5A1F589AD5A8A456E0D23A90489837D,43761,0,7,7,32,47,1647
11242,11242,D5A1F589AD5A8A456E0D23A90489837D,11231,8,16,8,37,49,1899
11243,11243,D5A1F589AD5A8A456E0D23A90489837D,10611,21,22,1,32,48,1648
11244,11244,3C89D3E050BD396C6E176628C3E38174,10471,0,7,7,37,48,1898
11245,11245,3C89D3E050BD396C6E176628C3E38174,11201,8,10,2,35,49,1799
11246,11246,3C89D3E050BD396C6E176628C3E38174,10111,11,14,3,37,47,1897
11247,11247,3C89D3E050BD396C6E176628C3E38174,42161,15,16,1,36,47,1847
11248,11248,3C89D3E050BD396C6E176628C3E38174,10471,20,23,3,37,48,1898
11252,11252,D6B8E098B6A6C1244D0BFBC8B20D7D77,42921,0,8,8,33,47,1697
11253,11253,D6B8E098B6A6C1244D0BFBC8B20D7D77,13231,11,14,3,39,46,1996
11254,11254,D6B8E098B6A6C1244D0BFBC8B20D7D77,40341,16,17,1,23,49,1199
11255,11255,D6B8E098B6A6C1244D0BFBC8B20D7D77,42921,21,22,1,33,47,1697
11256,11256,A0B07DBD7CFEABE1E4A0E9444C496CF6,13381,0,11,11,39,47,1997
11257,11257,A0B07DBD7CFEABE1E4A0E9444C496CF6,42271,11,14,3,40,47,2047
11258,11258,A0B07DBD7CFEABE1E4A0E9444C496CF6,13381,14,16,2,39,47,1997
11259,11259,A0B07DBD7CFEABE1E4A0E9444C496CF6,43481,17,19,2,39,48,1998
11260,11260,A0B07DBD7CFEABE1E4A0E9444C496CF6,13221,21,22,1,40,47,2047
11261,11261,E6FF42AEECF0CDA6C42BDBDEFD456416,13951,0,6,6,47,45,2395
11262,11262,E6FF42AEECF0CDA6C42BDBDEFD456416,43951,7,11,4,49,41,2491
11263,11263,E6FF42AEECF0CDA6C42BDBDEFD456416,13411,12,13,1,49,42,2492
11264,11264,E6FF42AEECF0CDA6C42BDBDEFD456416,43951,16,18,2,49,41,2491
11265,11265,E6FF42AEECF0CDA6C42BDBDEFD456416,13951,19,23,4,47,45,2395
11266,11266,9F8B1DD6D80751B4C4B13C705B0FAEDB,12792,0,3,3,34,30,1730
11267,11267,9F8B1DD6D80751B4C4B13C705B0FAEDB,15391,4,8,4,35,26,1776
11268,11268,9F8B1DD6D80751B4C4B13C705B0FAEDB,12792,8,9,1,34,30,1730
11269,11269,9F8B1DD6D80751B4C4B13C705B0FAEDB,15391,10,11,1,35,26,1776
11270,11270,9F8B1DD6D80751B4C4B13C705B0FAEDB,12792,12,20,8,34,30,1730
11271,11271,0D9AA89290D1F445356B85B4B256A343,10811,7,10,3,38,46,1946
11272,11272,0D9AA89290D1F445356B85B4B256A343,11001,12,14,2,42,47,2147
11273,11273,0D9AA89290D1F445356B85B4B256A343,10811,14,17,3,38,46,1946
11274,11274,0D9AA89290D1F445356B85B4B256A343,10521,19,20,1,41,47,2097
11287,11287,9A1CB6044954B6099E36F60F8EE95A99,11381,0,6,6,30,47,1547
11288,11288,9A1CB6044954B6099E36F60F8EE95A99,10951,7,8,1,29,48,1498
11289,11289,9A1CB6044954B6099E36F60F8EE95A99,11381,15,16,1,30,47,1547
11290,11290,9A1CB6044954B6099E36F60F8EE95A99,10951,16,21,5,29,48,1498
11291,11291,9A1CB6044954B6099E36F60F8EE95A99,11381,22,23,1,30,47,1547
11304,11304,BF866CAC6181D104CF2321FFD1D54D90,10292,1,7,6,30,47,1547
11305,11305,BF866CAC6181D104CF2321FFD1D54D90,42521,10,12,2,31,47,1597
11306,11306,BF866CAC6181D104CF2321FFD1D54D90,40171,16,22,6,38,48,1948
11307,11307,FF54487E0B5C80FA4088AB1638FB8194,42581,0,2,2,38,48,1948
11308,11308,FF54487E0B5C80FA4088AB1638FB8194,43181,3,4,1,39,48,1998
11309,11309,FF54487E0B5C80FA4088AB1638FB8194,42581,5,8,3,38,48,1948
11310,11310,FF54487E0B5C80FA4088AB1638FB8194,11914,14,17,3,37,48,1898
11311,11311,FF54487E0B5C80FA4088AB1638FB8194,42581,17,22,5,38,48,1948
11312,11312,F207093109E2696633DFD800C0BB164D,11074,0,6,6,37,47,1897
11313,11313,F207093109E2696633DFD800C0BB164D,11001,7,10,3,42,47,2147
11314,11314,F207093109E2696633DFD800C0BB164D,11074,14,23,9,37,47,1897
11315,11315,3C5BF8354C7B22C00BFA5438C070BC0F,13711,0,10,10,38,46,1946
11316,11316,3C5BF8354C7B22C00BFA5438C070BC0F,43241,10,12,2,36,46,1846
11317,11317,3C5BF8354C7B22C00BFA5438C070BC0F,13711,12,15,3,38,46,1946
11318,11318,3C5BF8354C7B22C00BFA5438C070BC0F,43241,16,19,3,36,46,1846
11319,11319,3C5BF8354C7B22C00BFA5438C070BC0F,10271,21,22,1,37,46,1896
11320,11320,6BDC16F7741CCEB825272BA9478A815F,13941,0,8,8,41,47,2097
11321,11321,6BDC16F7741CCEB825272BA9478A815F,42501,10,11,1,28,47,1447
11322,11322,6BDC16F7741CCEB825272BA9478A815F,13941,14,23,9,41,47,2097
11327,11327,44AA91905A7E8DBC24B0A51CC88C9204,42151,2,4,2,35,45,1795
11328,11328,44AA91905A7E8DBC24B0A51CC88C9204,12311,6,9,3,30,44,1544
11329,11329,44AA91905A7E8DBC24B0A51CC88C9204,42151,11,14,3,35,45,1795
11330,11330,44AA91905A7E8DBC24B0A51CC88C9204,12311,14,15,1,30,44,1544
11331,11331,44AA91905A7E8DBC24B0A51CC88C9204,42151,16,17,1,35,45,1795
11332,11332,44AA91905A7E8DBC24B0A51CC88C9204,12311,17,19,2,30,44,1544
11333,11333,44AA91905A7E8DBC24B0A51CC88C9204,42151,20,21,1,35,45,1795
11334,11334,E40FF661B4F3DA89AB28D734DF463F41,43021,0,6,6,16,43,843
11335,11335,E40FF661B4F3DA89AB28D734DF463F41,12921,7,18,11,9,41,491
11336,11336,E40FF661B4F3DA89AB28D734DF463F41,12641,20,21,1,10,43,543
11337,11337,E40FF661B4F3DA89AB28D734DF463F41,43021,21,23,2,16,43,843
11338,11338,C783F573219BE815B78681C436E8AC03,11871,0,8,8,29,46,1496
11339,11339,C783F573219BE815B78681C436E8AC03,12601,9,15,6,25,47,1297
11340,11340,C783F573219BE815B78681C436E8AC03,11871,18,23,5,29,46,1496
11348,11348,248ED3522A07D56FD2E9C46B1F9AB62D,42401,0,8,8,36,47,1847
11349,11349,248ED3522A07D56FD2E9C46B1F9AB62D,41007,9,10,1,37,47,1897
11350,11350,248ED3522A07D56FD2E9C46B1F9AB62D,40341,13,16,3,23,49,1199
11351,11351,248ED3522A07D56FD2E9C46B1F9AB62D,42401,16,18,2,36,47,1847
11352,11352,248ED3522A07D56FD2E9C46B1F9AB62D,11355,18,21,3,36,48,1848
11353,11353,946768BFA72752D5660750415178C67F,42161,3,8,5,36,47,1847
11354,11354,946768BFA72752D5660750415178C67F,10511,10,12,2,35,46,1796
11355,11355,946768BFA72752D5660750415178C67F,10781,15,17,2,35,47,1797
11356,11356,946768BFA72752D5660750415178C67F,40697,19,21,2,43,48,2198
11357,11357,946768BFA72752D5660750415178C67F,11651,22,23,1,33,47,1697
11358,11358,0CFE988ACC4C875C64FD106BD1BAEAD4,11081,0,8,8,35,46,1796
11359,11359,0CFE988ACC4C875C64FD106BD1BAEAD4,13951,8,14,6,47,45,2395
11360,11360,0CFE988ACC4C875C64FD106BD1BAEAD4,10511,18,21,3,35,46,1796
11369,11369,74EBB90FA1C414F58477B49370E7F73F,11861,0,6,6,32,47,1647
11370,11370,74EBB90FA1C414F58477B49370E7F73F,12311,10,16,6,30,44,1544
11371,11371,74EBB90FA1C414F58477B49370E7F73F,11861,19,23,4,32,47,1647
11372,11372,0B74EE0AD92C3F557AFC813D92630CBC,43761,0,8,8,32,47,1647
11373,11373,0B74EE0AD92C3F557AFC813D92630CBC,10061,10,12,2,20,46,1046
11374,11374,0B74EE0AD92C3F557AFC813D92630CBC,43761,14,20,6,32,47,1647
11375,11375,8C1AD0C4F249EDFD501E587432BC2EDD,43644,0,3,3,14,38,738
11376,11376,8C1AD0C4F249EDFD501E587432BC2EDD,19114,3,6,3,7,43,393
11377,11377,8C1AD0C4F249EDFD501E587432BC2EDD,19901,9,12,3,7,44,394
11378,11378,8C1AD0C4F249EDFD501E587432BC2EDD,19114,17,19,2,7,43,393
11379,11379,8C1AD0C4F249EDFD501E587432BC2EDD,12641,22,23,1,10,43,543
11380,11380,39179060954ADF536A44D5CDC3D7ADA4,10921,0,5,5,43,48,2198
11381,11381,39179060954ADF536A44D5CDC3D7ADA4,11261,5,9,4,36,46,1846
11382,11382,39179060954ADF536A44D5CDC3D7ADA4,12491,11,13,2,36,43,1843
11383,11383,39179060954ADF536A44D5CDC3D7ADA4,13911,13,17,4,39,46,1996
11384,11384,39179060954ADF536A44D5CDC3D7ADA4,11261,17,22,5,36,46,1846
11385,11385,BA6D45213D52989026A398B5D7995374,49201,0,4,4,7,41,391
11386,11386,BA6D45213D52989026A398B5D7995374,43644,4,5,1,14,38,738
11387,11387,BA6D45213D52989026A398B5D7995374,19181,9,10,1,8,40,440
11388,11388,BA6D45213D52989026A398B5D7995374,43644,12,13,1,14,38,738
11389,11389,BA6D45213D52989026A398B5D7995374,12921,17,19,2,9,41,491
11390,11390,BA6D45213D52989026A398B5D7995374,12641,20,21,1,10,43,543
11394,11394,A5A342C5B79B8AEE00BA80AE678B8EC5,10331,0,7,7,39,46,1996
11395,11395,A5A342C5B79B8AEE00BA80AE678B8EC5,11151,9,11,2,30,48,1548
11396,11396,A5A342C5B79B8AEE00BA80AE678B8EC5,10331,12,14,2,39,46,1996
11397,11397,A5A342C5B79B8AEE00BA80AE678B8EC5,11151,16,18,2,30,48,1548
11398,11398,A5A342C5B79B8AEE00BA80AE678B8EC5,10331,20,23,3,39,46,1996
11399,11399,2881834474B021D3CB48D66D6B38B4E5,11921,0,6,6,38,48,1948
11400,11400,2881834474B021D3CB48D66D6B38B4E5,42523,7,17,10,31,47,1597
11401,11401,2881834474B021D3CB48D66D6B38B4E5,11921,19,23,4,38,48,1948
11406,11406,9DF75BD4336800A216E8A9FB4E5FA693,43751,6,8,2,19,48,998
11407,11407,9DF75BD4336800A216E8A9FB4E5FA693,12581,8,9,1,24,48,1248
11408,11408,9DF75BD4336800A216E8A9FB4E5FA693,43751,10,19,9,19,48,998
11418,11418,E716DFCB27D2E8BF3D416B3DA1D9C640,43751,8,12,4,19,48,998
11419,11419,E716DFCB27D2E8BF3D416B3DA1D9C640,12581,13,14,1,24,48,1248
11420,11420,E716DFCB27D2E8BF3D416B3DA1D9C640,43751,17,22,5,19,48,998
11438,11438,37C29D4674FBC06EF76342F2283F4E15,42031,0,6,6,40,46,2046
11439,11439,37C29D4674FBC06EF76342F2283F4E15,12731,7,9,2,22,40,1140
11440,11440,37C29D4674FBC06EF76342F2283F4E15,13314,11,13,2,31,39,1589
11441,11441,37C29D4674FBC06EF76342F2283F4E15,42031,16,21,5,40,46,2046
11442,11442,37C29D4674FBC06EF76342F2283F4E15,13671,22,23,1,27,43,1393
11443,11443,615EDF25A924323AEF1D5C61D1C3550F,41393,0,9,9,43,49,2199
11444,11444,615EDF25A924323AEF1D5C61D1C3550F,42161,11,17,6,36,47,1847
11445,11445,615EDF25A924323AEF1D5C61D1C3550F,42641,19,20,1,33,49,1699
11446,11446,615EDF25A924323AEF1D5C61D1C3550F,13271,20,22,2,41,47,2097
11451,11451,6CA81E446D8D06A02BF3A70A33D72BFD,42021,6,8,2,33,47,1697
11452,11452,6CA81E446D8D06A02BF3A70A33D72BFD,11861,12,14,2,32,47,1647
11453,11453,6CA81E446D8D06A02BF3A70A33D72BFD,42021,14,15,1,33,47,1697
11454,11454,6CA81E446D8D06A02BF3A70A33D72BFD,11861,16,18,2,32,47,1647
11455,11455,6CA81E446D8D06A02BF3A70A33D72BFD,10691,20,22,2,33,48,1698
11459,11459,36B9A094E8D22C518990766A8F925428,19621,3,7,4,5,46,296
11460,11460,36B9A094E8D22C518990766A8F925428,12641,8,9,1,10,43,543
11461,11461,36B9A094E8D22C518990766A8F925428,19901,13,14,1,7,44,394
11462,11462,36B9A094E8D22C518990766A8F925428,12641,15,16,1,10,43,543
11463,11463,36B9A094E8D22C518990766A8F925428,19621,18,20,2,5,46,296
11464,11464,36B9A094E8D22C518990766A8F925428,12641,21,23,2,10,43,543
11475,11475,565E911568BF499034CE3AB0C1F32A25,11941,2,7,5,37,46,1896
11476,11476,565E911568BF499034CE3AB0C1F32A25,43101,7,18,11,46,40,2340
11477,11477,565E911568BF499034CE3AB0C1F32A25,11941,20,23,3,37,46,1896
11481,11481,EED28B3FB1115DAFC355A51E5FFFC7AB,12121,0,7,7,29,47,1497
11482,11482,EED28B3FB1115DAFC355A51E5FFFC7AB,11811,8,12,4,38,49,1949
11483,11483,EED28B3FB1115DAFC355A51E5FFFC7AB,41005,16,17,1,38,47,1947
11484,11484,EED28B3FB1115DAFC355A51E5FFFC7AB,12121,19,23,4,29,47,1497
11494,11494,C6A8E88AF4FAB8E3B900B709C1644500,10411,0,7,7,36,48,1848
11495,11495,C6A8E88AF4FAB8E3B900B709C1644500,13111,9,11,2,42,46,2146
11496,11496,C6A8E88AF4FAB8E3B900B709C1644500,10491,11,12,1,33,48,1698
11497,11497,C6A8E88AF4FAB8E3B900B709C1644500,10411,13,14,1,36,48,1848
11498,11498,C6A8E88AF4FAB8E3B900B709C1644500,11954,15,17,2,32,49,1649
11499,11499,C6A8E88AF4FAB8E3B900B709C1644500,11171,19,20,1,33,48,1698
11500,11500,C6A8E88AF4FAB8E3B900B709C1644500,42471,21,23,2,35,49,1799
11501,11501,3877B8E5CE9312BFA7CD973C0152DE3C,10841,0,10,10,37,47,1897
11502,11502,3877B8E5CE9312BFA7CD973C0152DE3C,10381,11,12,1,31,49,1599
11503,11503,3877B8E5CE9312BFA7CD973C0152DE3C,11211,15,16,1,34,49,1749
11504,11504,3877B8E5CE9312BFA7CD973C0152DE3C,10381,17,18,1,31,49,1599
11505,11505,3877B8E5CE9312BFA7CD973C0152DE3C,12511,19,23,4,39,47,1997
11509,11509,D9BD529C15B6C1C3809A564D34B0E0F2,10061,0,7,7,20,46,1046
11510,11510,D9BD529C15B6C1C3809A564D34B0E0F2,12601,7,9,2,25,47,1297
11511,11511,D9BD529C15B6C1C3809A564D34B0E0F2,13771,9,10,1,21,45,1095
11512,11512,D9BD529C15B6C1C3809A564D34B0E0F2,11871,14,16,2,29,46,1496
11513,11513,D9BD529C15B6C1C3809A564D34B0E0F2,13771,17,19,2,21,45,1095
11517,11517,EA63532F83E521722DEBB9A414E12CE9,42071,0,12,12,31,49,1599
11518,11518,EA63532F83E521722DEBB9A414E12CE9,42623,12,14,2,22,49,1149
11519,11519,EA63532F83E521722DEBB9A414E12CE9,11151,19,20,1,30,48,1548
11520,11520,644074FAED2D07B771DBBC3C2ED7ABF4,13411,0,5,5,49,42,2492
11521,11521,644074FAED2D07B771DBBC3C2ED7ABF4,43951,6,11,5,49,41,2491
11522,11522,644074FAED2D07B771DBBC3C2ED7ABF4,13411,11,13,2,49,42,2492
11523,11523,644074FAED2D07B771DBBC3C2ED7ABF4,43951,13,19,6,49,41,2491
11524,11524,644074FAED2D07B771DBBC3C2ED7ABF4,13411,19,22,3,49,42,2492
11528,11528,5B38B567B1C7BA8CD66BEFDF9C575D7A,11231,0,9,9,37,49,1899
11529,11529,5B38B567B1C7BA8CD66BEFDF9C575D7A,10191,11,12,1,40,48,2048
11530,11530,5B38B567B1C7BA8CD66BEFDF9C575D7A,11061,14,17,3,29,48,1498
11531,11531,5B38B567B1C7BA8CD66BEFDF9C575D7A,11151,19,20,1,30,48,1548
11532,11532,B9E927B8C825AF1AC2891B310330CB7E,42011,0,14,14,36,46,1846
11533,11533,B9E927B8C825AF1AC2891B310330CB7E,10921,15,16,1,43,48,2198
11534,11534,B9E927B8C825AF1AC2891B310330CB7E,13961,17,22,5,42,48,2148
11535,11535,6B06D901D974BEC75E000EB80A1DC6E2,42141,0,7,7,32,47,1647
11536,11536,6B06D901D974BEC75E000EB80A1DC6E2,42151,10,11,1,35,45,1795
11537,11537,6B06D901D974BEC75E000EB80A1DC6E2,42141,13,15,2,32,47,1647
11538,11538,6B06D901D974BEC75E000EB80A1DC6E2,40341,16,19,3,23,49,1199
11539,11539,6B06D901D974BEC75E000EB80A1DC6E2,10281,20,22,2,33,48,1698
11550,11550,B3D9D8E72FD92A77A76B6490766A3C36,19114,0,1,1,7,43,393
11551,11551,B3D9D8E72FD92A77A76B6490766A3C36,19901,2,3,1,7,44,394
11552,11552,B3D9D8E72FD92A77A76B6490766A3C36,12641,3,5,2,10,43,543
11553,11553,B3D9D8E72FD92A77A76B6490766A3C36,19114,8,20,12,7,43,393
11554,11554,B3D9D8E72FD92A77A76B6490766A3C36,12641,21,22,1,10,43,543
11558,11558,6FFBA4022D4D56F7F7F886454DFAC04B,11231,1,8,7,37,49,1899
11559,11559,6FFBA4022D4D56F7F7F886454DFAC04B,40463,11,13,2,38,49,1949
11560,11560,6FFBA4022D4D56F7F7F886454DFAC04B,11771,13,15,2,39,49,1999
11561,11561,6FFBA4022D4D56F7F7F886454DFAC04B,11231,16,17,1,37,49,1899
11562,11562,6FFBA4022D4D56F7F7F886454DFAC04B,10971,19,21,2,35,47,1797
11563,11563,6FFBA4022D4D56F7F7F886454DFAC04B,11231,22,23,1,37,49,1899
11570,11570,69CD6DFF769BF1A4417B2A8A6717D980,49181,0,1,1,21,31,1081
11571,11571,69CD6DFF769BF1A4417B2A8A6717D980,12871,4,11,7,22,33,1133
11572,11572,69CD6DFF769BF1A4417B2A8A6717D980,12792,13,21,8,34,30,1730
11576,11576,23179CE474279BF26E56795AAD67CA26,15191,0,2,2,36,27,1827
11577,11577,23179CE474279BF26E56795AAD67CA26,12792,6,11,5,34,30,1730
11578,11578,23179CE474279BF26E56795AAD67CA26,15391,13,14,1,35,26,1776
11579,11579,23179CE474279BF26E56795AAD67CA26,12792,17,23,6,34,30,1730
11580,11580,C401CC44C46E9CC0CD4E543F89D6EEBA,13371,0,9,9,41,47,2097
11581,11581,C401CC44C46E9CC0CD4E543F89D6EEBA,40341,13,16,3,23,49,1199
11582,11582,C401CC44C46E9CC0CD4E543F89D6EEBA,13371,17,23,6,41,47,2097
11589,11589,8D919DAD3A397736A2CF7D13317D0776,10621,0,6,6,41,49,2099
11590,11590,8D919DAD3A397736A2CF7D13317D0776,12491,7,16,9,36,43,1843
11591,11591,8D919DAD3A397736A2CF7D13317D0776,10621,19,23,4,41,49,2099
11592,11592,5601C1A44CC85C7B09354B38FD0628D1,12311,0,8,8,30,44,1544
11593,11593,5601C1A44CC85C7B09354B38FD0628D1,13731,10,11,1,33,49,1699
11594,11594,5601C1A44CC85C7B09354B38FD0628D1,12311,15,23,8,30,44,1544
11595,11595,DAE1E0D8D548FFF59A6530CC080E6B1E,42091,0,1,1,43,46,2196
11596,11596,DAE1E0D8D548FFF59A6530CC080E6B1E,13821,3,5,2,49,45,2495
11597,11597,DAE1E0D8D548FFF59A6530CC080E6B1E,42091,5,6,1,43,46,2196
11598,11598,DAE1E0D8D548FFF59A6530CC080E6B1E,42321,7,9,2,43,47,2197
11599,11599,DAE1E0D8D548FFF59A6530CC080E6B1E,42091,10,11,1,43,46,2196
11600,11600,DAE1E0D8D548FFF59A6530CC080E6B1E,40341,17,19,2,23,49,1199
11601,11601,DAE1E0D8D548FFF59A6530CC080E6B1E,42091,22,23,1,43,46,2196
11606,11606,0EA80F49CAFA9BFC58CF0D20F7967BFF,42871,0,5,5,30,45,1545
11607,11607,0EA80F49CAFA9BFC58CF0D20F7967BFF,12311,7,8,1,30,44,1544
11608,11608,0EA80F49CAFA9BFC58CF0D20F7967BFF,42871,11,13,2,30,45,1545
11609,11609,0EA80F49CAFA9BFC58CF0D20F7967BFF,12311,15,16,1,30,44,1544
11610,11610,0EA80F49CAFA9BFC58CF0D20F7967BFF,42871,20,23,3,30,45,1545
11611,11611,AFA0333D23B5F85E7F098B11A2F95AD8,42021,1,8,7,33,47,1697
11612,11612,AFA0333D23B5F85E7F098B11A2F95AD8,42801,11,13,2,40,49,2049
11613,11613,AFA0333D23B5F85E7F098B11A2F95AD8,42021,15,22,7,33,47,1697
11623,11623,3D7693F8E0E12EAFBB0F2BC4B30CFAE4,13941,8,9,1,41,47,2097
11624,11624,3D7693F8E0E12EAFBB0F2BC4B30CFAE4,40341,11,13,2,23,49,1199
11625,11625,3D7693F8E0E12EAFBB0F2BC4B30CFAE4,13371,16,23,7,41,47,2097
11629,11629,A0E829F4319BFCF37BA7414AFCB09FF1,11074,0,3,3,37,47,1897
11630,11630,A0E829F4319BFCF37BA7414AFCB09FF1,42221,4,7,3,38,48,1948
11631,11631,A0E829F4319BFCF37BA7414AFCB09FF1,10591,8,10,2,39,48,1998
11632,11632,A0E829F4319BFCF37BA7414AFCB09FF1,42221,11,15,4,38,48,1948
11633,11633,A0E829F4319BFCF37BA7414AFCB09FF1,11074,16,17,1,37,47,1897
11634,11634,A0E829F4319BFCF37BA7414AFCB09FF1,42221,17,18,1,38,48,1948
11635,11635,A0E829F4319BFCF37BA7414AFCB09FF1,11074,20,21,1,37,47,1897
11636,11636,D3A8E24567875F3C39102478CB1D4A49,42633,0,6,6,42,46,2146
11637,11637,D3A8E24567875F3C39102478CB1D4A49,11061,8,17,9,29,48,1498
11638,11638,D3A8E24567875F3C39102478CB1D4A49,42633,19,23,4,42,46,2146
11639,11639,69F41107244EDDE97DD1AAB2D554177A,12871,0,3,3,22,33,1133
11640,11640,69F41107244EDDE97DD1AAB2D554177A,12874,5,6,1,20,34,1034
11641,11641,69F41107244EDDE97DD1AAB2D554177A,19281,8,9,1,16,32,832
11642,11642,69F41107244EDDE97DD1AAB2D554177A,12871,14,18,4,22,33,1133
11643,11643,D53608326657C140C9801171477BB48D,12031,0,8,8,33,48,1698
11644,11644,D53608326657C140C9801171477BB48D,10107,9,12,3,38,49,1949
11645,11645,D53608326657C140C9801171477BB48D,10881,16,23,7,34,48,1748
11646,11646,775614B649ED7B2CA0ED6030686EC5AB,12521,1,17,16,35,41,1791
11647,11647,775614B649ED7B2CA0ED6030686EC5AB,43451,18,19,1,37,40,1890
11648,11648,775614B649ED7B2CA0ED6030686EC5AB,13071,21,22,1,41,41,2091
11649,11649,C493E8EAD829832CA31397E82BE4990B,43021,1,13,12,16,43,843
11650,11650,C493E8EAD829832CA31397E82BE4990B,12921,14,16,2,9,41,491
11651,11651,C493E8EAD829832CA31397E82BE4990B,12641,17,18,1,10,43,543
11652,11652,2FEA1A893FC3BC7728C599121855025A,13341,0,7,7,44,45,2245
11653,11653,2FEA1A893FC3BC7728C599121855025A,12131,9,17,8,32,47,1647
11654,11654,2FEA1A893FC3BC7728C599121855025A,13341,19,20,1,44,45,2245
11662,11662,F5336F0BC19120BD52E99ACE41BD5064,42071,0,1,1,31,49,1599
11663,11663,F5336F0BC19120BD52E99ACE41BD5064,42121,3,5,2,26,49,1349
11664,11664,F5336F0BC19120BD52E99ACE41BD5064,42071,9,19,10,31,49,1599
11665,11665,F5336F0BC19120BD52E99ACE41BD5064,42121,19,21,2,26,49,1349
11670,11670,C7E2D025BE9D6F67BF979B78BCD48C46,12661,0,13,13,32,45,1645
11671,11671,C7E2D025BE9D6F67BF979B78BCD48C46,11751,16,17,1,35,48,1798
11672,11672,C7E2D025BE9D6F67BF979B78BCD48C46,11201,18,23,5,35,49,1799
11673,11673,991FF47AEF28FD93E7A1046A910F896B,43311,0,7,7,31,48,1598
11674,11674,991FF47AEF28FD93E7A1046A910F896B,43281,16,17,1,37,48,1898
11675,11675,991FF47AEF28FD93E7A1046A910F896B,43311,17,20,3,31,48,1598
11676,11676,991FF47AEF28FD93E7A1046A910F896B,42523,21,22,1,31,47,1597
11680,11680,87F0A5B37D23577900D9D67376C1E962,10721,8,11,3,31,48,1598
11681,11681,87F0A5B37D23577900D9D67376C1E962,12161,12,15,3,32,46,1646
11682,11682,87F0A5B37D23577900D9D67376C1E962,11794,15,16,1,38,49,1949
11683,11683,87F0A5B37D23577900D9D67376C1E962,12161,18,20,2,32,46,1646
11684,11684,9615BA93BF31C1854AA16E0580A7CEEE,13511,0,1,1,34,48,1748
11685,11685,9615BA93BF31C1854AA16E0580A7CEEE,10107,3,15,12,38,49,1949
11686,11686,9615BA93BF31C1854AA16E0580A7CEEE,42161,18,19,1,36,47,1847
11687,11687,9615BA93BF31C1854AA16E0580A7CEEE,40343,20,22,2,24,49,1249
11703,11703,C187943D20D187183526E0228C45660E,11021,0,8,8,36,49,1849
11704,11704,C187943D20D187183526E0228C45660E,12381,11,15,4,32,48,1648
11705,11705,C187943D20D187183526E0228C45660E,11021,17,21,4,36,49,1849
11706,11706,67E463A97F2732907F7B14F7E69E6FDD,11861,0,8,8,32,47,1647
11707,11707,67E463A97F2732907F7B14F7E69E6FDD,13071,12,13,1,41,41,2091
11708,11708,67E463A97F2732907F7B14F7E69E6FDD,11861,16,23,7,32,47,1647
11709,11709,B27ACD37439FA0175615381A2A4522E0,16261,0,6,6,3,3,153
11710,11710,B27ACD37439FA0175615381A2A4522E0,16281,10,14,4,11,4,554
11711,11711,B27ACD37439FA0175615381A2A4522E0,15143,14,21,7,18,7,907
11712,11712,5ADEBEC73DE7ACAD39830025DACACCA0,15331,0,3,3,38,24,1924
11713,11713,5ADEBEC73DE7ACAD39830025DACACCA0,15401,3,5,2,39,25,1975
11714,11714,5ADEBEC73DE7ACAD39830025DACACCA0,15491,6,7,1,32,7,1607
11715,11715,5ADEBEC73DE7ACAD39830025DACACCA0,15051,11,12,1,19,4,954
11716,11716,5ADEBEC73DE7ACAD39830025DACACCA0,16281,13,14,1,11,4,554
11717,11717,5ADEBEC73DE7ACAD39830025DACACCA0,15331,16,22,6,38,24,1924
11718,11718,5767E0EE50B7CB3B0CFBFCA7463471BC,11806,0,6,6,41,48,2098
11719,11719,5767E0EE50B7CB3B0CFBFCA7463471BC,11861,8,19,11,32,47,1647
11720,11720,5767E0EE50B7CB3B0CFBFCA7463471BC,11806,21,23,2,41,48,2098
11729,11729,0EEF00D524FC221E0814F0ECEF97AD09,10544,0,7,7,28,48,1448
11730,11730,0EEF00D524FC221E0814F0ECEF97AD09,11361,10,12,2,22,48,1148
11731,11731,0EEF00D524FC221E0814F0ECEF97AD09,12051,12,14,2,20,47,1047
11732,11732,0EEF00D524FC221E0814F0ECEF97AD09,13601,19,21,2,34,47,1747
11742,11742,112D73984BEFF27B4D8267205C95643D,13121,0,7,7,38,46,1946
11743,11743,112D73984BEFF27B4D8267205C95643D,42631,12,14,2,43,45,2195
11744,11744,112D73984BEFF27B4D8267205C95643D,13121,21,23,2,38,46,1946
11745,11745,079871E9AF6039695E64910046159E20,10731,0,8,8,33,47,1697
11746,11746,079871E9AF6039695E64910046159E20,11291,12,13,1,40,49,2049
11747,11747,079871E9AF6039695E64910046159E20,42021,15,23,8,33,47,1697
11752,11752,070CCFB95BD7B5493FC205585FDC7AC9,42631,1,3,2,43,45,2195
11753,11753,070CCFB95BD7B5493FC205585FDC7AC9,13341,6,9,3,44,45,2245
11754,11754,070CCFB95BD7B5493FC205585FDC7AC9,42631,10,11,1,43,45,2195
11755,11755,070CCFB95BD7B5493FC205585FDC7AC9,13381,16,23,7,39,47,1997
11756,11756,70E50AA138C0538910E5623295B506D8,13231,2,3,1,39,46,1996
11757,11757,70E50AA138C0538910E5623295B506D8,42351,3,5,2,38,45,1945
11758,11758,70E50AA138C0538910E5623295B506D8,13911,5,8,3,39,46,1996
11759,11759,70E50AA138C0538910E5623295B506D8,42351,8,17,9,38,45,1945
11760,11760,70E50AA138C0538910E5623295B506D8,11261,18,21,3,36,46,1846
11761,11761,FB5DCADD18C1357A9B48C4313EAAEE50,19111,1,10,9,9,45,495
11762,11762,FB5DCADD18C1357A9B48C4313EAAEE50,12511,13,14,1,39,47,1997
11763,11763,FB5DCADD18C1357A9B48C4313EAAEE50,11481,14,16,2,41,48,2098
11764,11764,FB5DCADD18C1357A9B48C4313EAAEE50,40341,16,20,4,23,49,1199
11765,11765,FB5DCADD18C1357A9B48C4313EAAEE50,19111,21,23,2,9,45,495
11770,11770,E51EE41655D386174398555E16D6604B,11171,0,9,9,33,48,1698
11771,11771,E51EE41655D386174398555E16D6604B,12131,10,11,1,32,47,1647
11772,11772,E51EE41655D386174398555E16D6604B,12381,12,14,2,32,48,1648
11773,11773,E51EE41655D386174398555E16D6604B,10661,17,19,2,37,49,1899
11774,11774,E51EE41655D386174398555E16D6604B,40034,21,23,2,32,48,1648
11775,11775,43AA632E12ABCA3F01D2033AFFAEDEF3,10151,0,13,13,34,47,1747
11776,11776,43AA632E12ABCA3F01D2033AFFAEDEF3,43761,16,18,2,32,47,1647
11777,11777,43AA632E12ABCA3F01D2033AFFAEDEF3,10151,18,20,2,34,47,1747
11778,11778,43AA632E12ABCA3F01D2033AFFAEDEF3,11074,20,21,1,37,47,1897
11779,11779,43AA632E12ABCA3F01D2033AFFAEDEF3,10151,22,23,1,34,47,1747
11780,11780,6B614428F8D95ECFDE2207017437E97D,19281,0,8,8,16,32,832
11781,11781,6B614428F8D95ECFDE2207017437E97D,12871,10,13,3,22,33,1133
11782,11782,6B614428F8D95ECFDE2207017437E97D,19281,14,15,1,16,32,832
11783,11783,6B614428F8D95ECFDE2207017437E97D,12871,17,18,1,22,33,1133
11784,11784,F8A2EC8C9348BFB1362087B807B825C5,43971,6,7,1,30,48,1548
11785,11785,F8A2EC8C9348BFB1362087B807B825C5,42471,8,10,2,35,49,1799
11786,11786,F8A2EC8C9348BFB1362087B807B825C5,43971,13,15,2,30,48,1548
11787,11787,F8A2EC8C9348BFB1362087B807B825C5,11381,17,21,4,30,47,1547
11791,11791,666C6474C859B034AE49BB5E91C01140,42633,0,14,14,42,46,2146
11792,11792,666C6474C859B034AE49BB5E91C01140,11551,15,18,3,39,49,1999
11793,11793,666C6474C859B034AE49BB5E91C01140,42633,19,22,3,42,46,2146
11797,11797,F6332816251025BD7BE865D9790FDADB,43011,0,1,1,40,42,2042
11798,11798,F6332816251025BD7BE865D9790FDADB,10751,1,3,2,47,43,2393
11799,11799,F6332816251025BD7BE865D9790FDADB,43011,3,7,4,40,42,2042
11800,11800,F6332816251025BD7BE865D9790FDADB,12221,15,17,2,43,44,2194
11801,11801,F6332816251025BD7BE865D9790FDADB,12211,18,19,1,41,44,2094
11802,11802,6EF71BEF838729319BF8A5B0F1177367,11231,0,5,5,37,49,1899
11803,11803,6EF71BEF838729319BF8A5B0F1177367,10121,5,7,2,36,49,1849
11804,11804,6EF71BEF838729319BF8A5B0F1177367,11231,7,8,1,37,49,1899
11805,11805,6EF71BEF838729319BF8A5B0F1177367,40951,8,16,8,36,49,1849
11806,11806,6EF71BEF838729319BF8A5B0F1177367,11231,17,22,5,37,49,1899
11807,11807,9CE154E0E9981462DE8BB5E8103CB6DC,42581,0,6,6,38,48,1948
11808,11808,9CE154E0E9981462DE8BB5E8103CB6DC,11914,7,16,9,37,48,1898
11809,11809,9CE154E0E9981462DE8BB5E8103CB6DC,11901,19,23,4,42,49,2149
11810,11810,6BF85B7300ADAE0F83C20B2AF5821019,11021,6,17,11,36,49,1849
11811,11811,6BF85B7300ADAE0F83C20B2AF5821019,11381,18,21,3,30,47,1547
11812,11812,6BF85B7300ADAE0F83C20B2AF5821019,11021,21,22,1,36,49,1849
11826,11826,DDF363C64B8F6ACF3450F0B1AA087EA1,19621,0,6,6,5,46,296
11827,11827,DDF363C64B8F6ACF3450F0B1AA087EA1,19441,11,14,3,8,46,446
11828,11828,DDF363C64B8F6ACF3450F0B1AA087EA1,42041,15,17,2,10,47,547
11829,11829,DDF363C64B8F6ACF3450F0B1AA087EA1,19441,17,23,6,8,46,446
11830,11830,B0B36057F46B4664CBCA7B3A3FC6EBDD,43021,0,12,12,16,43,843
11831,11831,B0B36057F46B4664CBCA7B3A3FC6EBDD,19021,13,19,6,10,45,545
11832,11832,B0B36057F46B4664CBCA7B3A3FC6EBDD,43021,19,23,4,16,43,843
11837,11837,CB5B6B98973636834396900860590D74,42921,0,6,6,33,47,1697
11838,11838,CB5B6B98973636834396900860590D74,12561,9,10,1,45,43,2293
11839,11839,CB5B6B98973636834396900860590D74,42921,13,23,10,33,47,1697
11840,11840,966592CD48E24DD17B5B9C8B94D59F8F,19261,0,5,5,6,37,337
11841,11841,966592CD48E24DD17B5B9C8B94D59F8F,19741,8,10,2,5,44,294
11842,11842,966592CD48E24DD17B5B9C8B94D59F8F,16121,13,14,1,3,0,150
11843,11843,966592CD48E24DD17B5B9C8B94D59F8F,19571,19,23,4,1,36,86
11844,11844,AF57FD742700B6DD506E3D60F4DB6DD5,13101,0,11,11,40,47,2047
11845,11845,AF57FD742700B6DD506E3D60F4DB6DD5,13351,12,14,2,48,48,2448
11846,11846,AF57FD742700B6DD506E3D60F4DB6DD5,12514,18,19,1,38,47,1947
11856,11856,50285CAE0D25A369509D5D196FEBAE12,42081,1,5,4,24,49,1249
11857,11857,50285CAE0D25A369509D5D196FEBAE12,12514,9,10,1,38,47,1947
11858,11858,50285CAE0D25A369509D5D196FEBAE12,42511,10,13,3,37,47,1897
11859,11859,50285CAE0D25A369509D5D196FEBAE12,42081,14,15,1,24,49,1249
11860,11860,50285CAE0D25A369509D5D196FEBAE12,12514,19,20,1,38,47,1947
11865,11865,416A91B7DEFDE658C6F804F6E96AE459,42981,0,7,7,36,49,1849
11866,11866,416A91B7DEFDE658C6F804F6E96AE459,15311,8,9,1,43,25,2175
11867,11867,416A91B7DEFDE658C6F804F6E96AE459,10841,11,14,3,37,47,1897
11868,11868,416A91B7DEFDE658C6F804F6E96AE459,11751,15,19,4,35,48,1798
11869,11869,416A91B7DEFDE658C6F804F6E96AE459,42981,21,23,2,36,49,1849
11874,11874,B9F4C9D18F82BAF4FF50860E0E28B6F2,42401,0,3,3,36,47,1847
11875,11875,B9F4C9D18F82BAF4FF50860E0E28B6F2,40421,3,8,5,37,48,1898
11876,11876,B9F4C9D18F82BAF4FF50860E0E28B6F2,11231,11,14,3,37,49,1899
11877,11877,B9F4C9D18F82BAF4FF50860E0E28B6F2,12083,16,17,1,36,49,1849
11878,11878,B9F4C9D18F82BAF4FF50860E0E28B6F2,42401,18,19,1,36,47,1847
11879,11879,EB3039C415C508F2A2DCF6403E75C42C,12921,0,8,8,9,41,491
11880,11880,EB3039C415C508F2A2DCF6403E75C42C,43021,12,13,1,16,43,843
11881,11881,EB3039C415C508F2A2DCF6403E75C42C,12921,13,22,9,9,41,491
11882,11882,DA48F6EEC4784B4505CA1BBB58EA121A,10341,1,8,7,31,47,1597
11883,11883,DA48F6EEC4784B4505CA1BBB58EA121A,10292,9,11,2,30,47,1547
11884,11884,DA48F6EEC4784B4505CA1BBB58EA121A,10341,12,14,2,31,47,1597
11885,11885,DA48F6EEC4784B4505CA1BBB58EA121A,10292,14,17,3,30,47,1547
11886,11886,DA48F6EEC4784B4505CA1BBB58EA121A,10341,19,23,4,31,47,1597
11887,11887,671FB010BDB8AB18F1C7C189D2A5B267,42871,0,12,12,30,45,1545
11888,11888,671FB010BDB8AB18F1C7C189D2A5B267,10351,12,14,2,28,45,1445
11889,11889,671FB010BDB8AB18F1C7C189D2A5B267,42871,15,16,1,30,45,1545
11890,11890,671FB010BDB8AB18F1C7C189D2A5B267,11074,19,21,2,37,47,1897
11891,11891,7A04A13186C46A4BE6B54AB67E18C35D,10711,0,7,7,29,46,1496
11892,11892,7A04A13186C46A4BE6B54AB67E18C35D,10251,8,18,10,35,47,1797
11893,11893,7A04A13186C46A4BE6B54AB67E18C35D,10711,19,23,4,29,46,1496
11894,11894,29CCFF89800AD184CF93EA13427035C5,43621,0,1,1,46,48,2348
11895,11895,29CCFF89800AD184CF93EA13427035C5,42321,3,7,4,43,47,2197
11896,11896,29CCFF89800AD184CF93EA13427035C5,43621,7,12,5,46,48,2348
11897,11897,29CCFF89800AD184CF93EA13427035C5,13351,19,20,1,48,48,2448
11898,11898,29CCFF89800AD184CF93EA13427035C5,43621,21,23,2,46,48,2348
11902,11902,6328F7CDE1FD4A3418797D65E47142EC,13911,0,8,8,39,46,1996
11903,11903,6328F7CDE1FD4A3418797D65E47142EC,42351,8,11,3,38,45,1945
11904,11904,6328F7CDE1FD4A3418797D65E47142EC,42831,12,14,2,27,48,1398
11905,11905,6328F7CDE1FD4A3418797D65E47142EC,12051,16,18,2,20,47,1047
11906,11906,F475546FA2D112D7D0EDED3FAB477F8E,40801,0,7,7,43,46,2196
11907,11907,F475546FA2D112D7D0EDED3FAB477F8E,40302,12,13,1,40,49,2049
11908,11908,F475546FA2D112D7D0EDED3FAB477F8E,40801,13,23,10,43,46,2196
11926,11926,1A71FA18AA428C4DDAD1FCB8BD6DCCEA,11806,2,6,4,41,48,2098
11927,11927,1A71FA18AA428C4DDAD1FCB8BD6DCCEA,10401,8,10,2,33,49,1699
11928,11928,1A71FA18AA428C4DDAD1FCB8BD6DCCEA,43581,11,18,7,33,48,1698
11929,11929,1A71FA18AA428C4DDAD1FCB8BD6DCCEA,42281,20,23,3,40,48,2048
11930,11930,D27AD15B109272EBC96B3A5E9E02000F,13911,0,4,4,39,46,1996
11931,11931,D27AD15B109272EBC96B3A5E9E02000F,11261,5,11,6,36,46,1846
11932,11932,D27AD15B109272EBC96B3A5E9E02000F,13911,11,13,2,39,46,1996
11933,11933,D27AD15B109272EBC96B3A5E9E02000F,11261,14,20,6,36,46,1846
11934,11934,D27AD15B109272EBC96B3A5E9E02000F,13911,20,22,2,39,46,1996
11935,11935,7BD5666208D4C4EF90CAAD8A97E6ED7C,12491,3,6,3,36,43,1843
11936,11936,7BD5666208D4C4EF90CAAD8A97E6ED7C,13671,8,19,11,27,43,1393
11937,11937,7BD5666208D4C4EF90CAAD8A97E6ED7C,42151,20,21,1,35,45,1795
11938,11938,7779D5C4E5073D864A9050EB76A5AC64,11261,0,8,8,36,46,1846
11939,11939,7779D5C4E5073D864A9050EB76A5AC64,42081,9,11,2,24,49,1249
11940,11940,7779D5C4E5073D864A9050EB76A5AC64,11261,13,19,6,36,46,1846
11941,11941,7779D5C4E5073D864A9050EB76A5AC64,43341,22,23,1,41,46,2096
11945,11945,C2BF09A508085CF79F8681F2003EB0D5,11061,0,9,9,29,48,1498
11946,11946,C2BF09A508085CF79F8681F2003EB0D5,40341,10,13,3,23,49,1199
11947,11947,C2BF09A508085CF79F8681F2003EB0D5,10681,14,21,7,30,48,1548
11948,11948,D1C734A887FEA6FA5FA72DD89F2DF0BE,11061,0,7,7,29,48,1498
11949,11949,D1C734A887FEA6FA5FA72DD89F2DF0BE,10107,9,10,1,38,49,1949
11950,11950,D1C734A887FEA6FA5FA72DD89F2DF0BE,43391,12,18,6,29,48,1498
11951,11951,D1C734A887FEA6FA5FA72DD89F2DF0BE,10544,20,21,1,28,48,1448
11952,11952,2B52EBBB258BBA7EB10453D1DD2CF8EA,42521,0,1,1,31,47,1597
11953,11953,2B52EBBB258BBA7EB10453D1DD2CF8EA,11381,1,17,16,30,47,1547
11954,11954,2B52EBBB258BBA7EB10453D1DD2CF8EA,42521,18,21,3,31,47,1597
11955,11955,2B52EBBB258BBA7EB10453D1DD2CF8EA,11753,22,23,1,35,48,1798
11956,11956,7C8188B396B52CD983B1E33AB189561B,49031,0,1,1,4,27,227
11957,11957,7C8188B396B52CD983B1E33AB189561B,11871,4,13,9,29,46,1496
11958,11958,7C8188B396B52CD983B1E33AB189561B,11324,16,18,2,31,46,1596
11959,11959,7C8188B396B52CD983B1E33AB189561B,19281,22,23,1,16,32,832
11970,11970,A930CAF8C5499F69FC923E95F45D9E08,42501,5,6,1,28,47,1447
11971,11971,A930CAF8C5499F69FC923E95F45D9E08,11381,6,7,1,30,47,1547
11972,11972,A930CAF8C5499F69FC923E95F45D9E08,11061,9,10,1,29,48,1498
11973,11973,A930CAF8C5499F69FC923E95F45D9E08,11381,14,16,2,30,47,1547
11974,11974,A930CAF8C5499F69FC923E95F45D9E08,11061,16,20,4,29,48,1498
11975,11975,A930CAF8C5499F69FC923E95F45D9E08,40441,21,23,2,30,48,1548
11976,11976,7300FFB733BFFEA187DB110E4D4DC3D2,19181,1,3,2,8,40,440
11977,11977,7300FFB733BFFEA187DB110E4D4DC3D2,49201,3,7,4,7,41,391
11978,11978,7300FFB733BFFEA187DB110E4D4DC3D2,12921,8,9,1,9,41,491
11979,11979,7300FFB733BFFEA187DB110E4D4DC3D2,12641,9,11,2,10,43,543
11980,11980,7300FFB733BFFEA187DB110E4D4DC3D2,49201,12,14,2,7,41,391
11981,11981,7300FFB733BFFEA187DB110E4D4DC3D2,12921,14,16,2,9,41,491
11982,11982,7300FFB733BFFEA187DB110E4D4DC3D2,49201,21,22,1,7,41,391
11986,11986,27F132E818644D3933B7D51A13F3BE57,15561,1,5,4,32,22,1622
11987,11987,27F132E818644D3933B7D51A13F3BE57,15411,7,14,7,44,27,2227
11988,11988,27F132E818644D3933B7D51A13F3BE57,13691,17,19,2,47,30,2380
11989,11989,27F132E818644D3933B7D51A13F3BE57,12611,21,22,1,41,29,2079
11990,11990,D59A2A795558AA457F13EDE8D62837D5,11231,0,12,12,37,49,1899
11991,11991,D59A2A795558AA457F13EDE8D62837D5,13481,14,16,2,26,31,1331
11992,11992,D59A2A795558AA457F13EDE8D62837D5,43581,20,23,3,33,48,1698
11996,11996,AB35C432DC3D59E7929F031635A675AA,12601,0,3,3,25,47,1297
11997,11997,AB35C432DC3D59E7929F031635A675AA,10061,3,5,2,20,46,1046
11998,11998,AB35C432DC3D59E7929F031635A675AA,12601,5,21,16,25,47,1297
12010,12010,423F3FDE2DCCD4AAC04A36FDAB9E9DCC,42141,0,19,19,32,47,1647
12011,12011,423F3FDE2DCCD4AAC04A36FDAB9E9DCC,10107,20,21,1,38,49,1949
12012,12012,423F3FDE2DCCD4AAC04A36FDAB9E9DCC,43761,21,23,2,32,47,1647
12019,12019,F7B0DEB7BA567C33456EA83CB86454BE,13941,1,2,1,41,47,2097
12020,12020,F7B0DEB7BA567C33456EA83CB86454BE,10801,3,13,10,42,47,2147
12021,12021,F7B0DEB7BA567C33456EA83CB86454BE,12971,15,19,4,32,48,1648
12022,12022,F7B0DEB7BA567C33456EA83CB86454BE,42161,20,21,1,36,47,1847
12023,12023,35D37831D98433CB8D7D3AC06956E13A,42851,0,10,10,35,41,1791
12024,12024,35D37831D98433CB8D7D3AC06956E13A,11281,12,14,2,27,40,1390
12025,12025,35D37831D98433CB8D7D3AC06956E13A,40171,19,20,1,38,48,1948
12026,12026,78715CC424D36ACB63F48BBF1BBB7EB8,11061,1,9,8,29,48,1498
12027,12027,78715CC424D36ACB63F48BBF1BBB7EB8,10681,12,13,1,30,48,1548
12028,12028,78715CC424D36ACB63F48BBF1BBB7EB8,11061,17,19,2,29,48,1498
12029,12029,78715CC424D36ACB63F48BBF1BBB7EB8,10681,19,20,1,30,48,1548
12030,12030,78715CC424D36ACB63F48BBF1BBB7EB8,11061,22,23,1,29,48,1498
12031,12031,3727660626868128AABC9CD1BF9D20DE,10381,7,15,8,31,49,1599
12032,12032,3727660626868128AABC9CD1BF9D20DE,42623,20,21,1,22,49,1149
12033,12033,3727660626868128AABC9CD1BF9D20DE,11151,21,23,2,30,48,1548
12034,12034,78C0E1E992CFF9ECB9C6D46D3E929FD4,11381,0,3,3,30,47,1547
12035,12035,78C0E1E992CFF9ECB9C6D46D3E929FD4,12121,3,6,3,29,47,1497
12036,12036,78C0E1E992CFF9ECB9C6D46D3E929FD4,11381,6,8,2,30,47,1547
12037,12037,78C0E1E992CFF9ECB9C6D46D3E929FD4,12121,9,10,1,29,47,1497
12038,12038,78C0E1E992CFF9ECB9C6D46D3E929FD4,11381,13,20,7,30,47,1547
12059,12059,446AC7E279C6659F3E40FC9C0B9B7F45,13341,1,9,8,44,45,2245
12060,12060,446AC7E279C6659F3E40FC9C0B9B7F45,42631,10,11,1,43,45,2195
12061,12061,446AC7E279C6659F3E40FC9C0B9B7F45,13341,14,15,1,44,45,2245
12062,12062,446AC7E279C6659F3E40FC9C0B9B7F45,42631,16,17,1,43,45,2195
12063,12063,446AC7E279C6659F3E40FC9C0B9B7F45,13341,18,23,5,44,45,2245
12071,12071,E7C93B58159694942F208F853B794D34,10381,3,7,4,31,49,1599
12072,12072,E7C93B58159694942F208F853B794D34,11061,7,9,2,29,48,1498
12073,12073,E7C93B58159694942F208F853B794D34,11954,11,13,2,32,49,1649
12074,12074,E7C93B58159694942F208F853B794D34,10151,13,19,6,34,47,1747
12075,12075,E7C93B58159694942F208F853B794D34,11231,20,22,2,37,49,1899
12076,12076,C7D4935453BFEC1CB164593EE1B84EA4,15391,1,8,7,35,26,1776
12077,12077,C7D4935453BFEC1CB164593EE1B84EA4,12792,11,12,1,34,30,1730
12078,12078,C7D4935453BFEC1CB164593EE1B84EA4,15391,13,23,10,35,26,1776
12079,12079,5C96E9B05EB3EFE9DE3B43368A9F3BB9,42401,0,7,7,36,47,1847
12080,12080,5C96E9B05EB3EFE9DE3B43368A9F3BB9,11481,8,11,3,41,48,2098
12081,12081,5C96E9B05EB3EFE9DE3B43368A9F3BB9,42491,12,15,3,32,46,1646
12082,12082,5C96E9B05EB3EFE9DE3B43368A9F3BB9,42161,17,19,2,36,47,1847
12083,12083,EC5A6DF746AC421318D6AE3B8794E793,11231,0,14,14,37,49,1899
12084,12084,EC5A6DF746AC421318D6AE3B8794E793,11481,15,17,2,41,48,2098
12085,12085,EC5A6DF746AC421318D6AE3B8794E793,11231,20,23,3,37,49,1899
12089,12089,ED36A592544F9D3B4DC283835B5C723A,13381,0,1,1,39,47,1997
12090,12090,ED36A592544F9D3B4DC283835B5C723A,11481,4,5,1,41,48,2098
12091,12091,ED36A592544F9D3B4DC283835B5C723A,42271,6,11,5,40,47,2047
12092,12092,ED36A592544F9D3B4DC283835B5C723A,11481,17,22,5,41,48,2098
12093,12093,ED36A592544F9D3B4DC283835B5C723A,42271,22,23,1,40,47,2047
12094,12094,4A1E2DF13E9399DEAE7966E1EFE6FC6B,11481,0,2,2,41,48,2098
12095,12095,4A1E2DF13E9399DEAE7966E1EFE6FC6B,13271,2,4,2,41,47,2097
12096,12096,4A1E2DF13E9399DEAE7966E1EFE6FC6B,42151,5,8,3,35,45,1795
12097,12097,4A1E2DF13E9399DEAE7966E1EFE6FC6B,11481,18,23,5,41,48,2098
12115,12115,CCD9790592500DBEDEAEF122B82D26B8,13511,0,17,17,34,48,1748
12116,12116,CCD9790592500DBEDEAEF122B82D26B8,43391,18,21,3,29,48,1498
12117,12117,CCD9790592500DBEDEAEF122B82D26B8,10881,21,23,2,34,48,1748
12121,12121,47844E829FCB05D6E87386BF9A1380C3,13711,0,8,8,38,46,1946
12122,12122,47844E829FCB05D6E87386BF9A1380C3,11021,10,11,1,36,49,1849
12123,12123,47844E829FCB05D6E87386BF9A1380C3,42011,12,14,2,36,46,1846
12124,12124,47844E829FCB05D6E87386BF9A1380C3,11021,14,16,2,36,49,1849
12125,12125,47844E829FCB05D6E87386BF9A1380C3,11491,17,22,5,36,47,1847
12126,12126,47844E829FCB05D6E87386BF9A1380C3,10151,22,23,1,34,47,1747
12127,12127,F6D5F0720A4C82E72FD0C591B5570DDC,11951,0,8,8,31,49,1599
12128,12128,F6D5F0720A4C82E72FD0C591B5570DDC,10431,8,10,2,33,49,1699
12129,12129,F6D5F0720A4C82E72FD0C591B5570DDC,11381,13,17,4,30,47,1547
12130,12130,F6D5F0720A4C82E72FD0C591B5570DDC,10921,18,21,3,43,48,2198
12151,12151,9D7E28E179E5F5D009F8D277D0F434A8,11861,0,5,5,32,47,1647
12152,12152,9D7E28E179E5F5D009F8D277D0F434A8,42581,7,8,1,38,48,1948
12153,12153,9D7E28E179E5F5D009F8D277D0F434A8,10591,13,14,1,39,48,1998
12154,12154,9D7E28E179E5F5D009F8D277D0F434A8,42581,16,18,2,38,48,1948
12155,12155,9D7E28E179E5F5D009F8D277D0F434A8,11861,19,23,4,32,47,1647
12156,12156,92E1BAA88B052422B820ED36A9E8F107,11701,0,6,6,43,48,2198
12157,12157,92E1BAA88B052422B820ED36A9E8F107,40171,7,9,2,38,48,1948
12158,12158,92E1BAA88B052422B820ED36A9E8F107,41392,12,23,11,43,48,2198
12159,12159,ACD04627348D28EB014FAB46490D4B92,10351,3,6,3,28,45,1445
12160,12160,ACD04627348D28EB014FAB46490D4B92,12601,8,13,5,25,47,1297
12161,12161,ACD04627348D28EB014FAB46490D4B92,13771,14,15,1,21,45,1095
12162,12162,ACD04627348D28EB014FAB46490D4B92,12601,19,23,4,25,47,1297
12169,12169,618D9F41DE4EC96FBA6A3C4386221825,11201,0,8,8,35,49,1799
12170,12170,618D9F41DE4EC96FBA6A3C4386221825,10971,11,13,2,35,47,1797
12171,12171,618D9F41DE4EC96FBA6A3C4386221825,11261,14,16,2,36,46,1846
12172,12172,618D9F41DE4EC96FBA6A3C4386221825,43581,17,20,3,33,48,1698
12173,12173,618D9F41DE4EC96FBA6A3C4386221825,11201,22,23,1,35,49,1799
12174,12174,0C2E73493B95B864220B3E14F6C11E84,13314,0,7,7,31,39,1589
12175,12175,0C2E73493B95B864220B3E14F6C11E84,12521,8,15,7,35,41,1791
12176,12176,0C2E73493B95B864220B3E14F6C11E84,13314,18,23,5,31,39,1589
12180,12180,7A3B81BDAFB4DD2FC896155A8BEFF9BB,42411,0,7,7,40,49,2049
12181,12181,7A3B81BDAFB4DD2FC896155A8BEFF9BB,13941,10,15,5,41,47,2097
12182,12182,7A3B81BDAFB4DD2FC896155A8BEFF9BB,42411,16,18,2,40,49,2049
12183,12183,7A3B81BDAFB4DD2FC896155A8BEFF9BB,10951,19,23,4,29,48,1498
12190,12190,1AE278194B1E20A9DCFBA8E0E37A8D3E,19111,0,10,10,9,45,495
12191,12191,1AE278194B1E20A9DCFBA8E0E37A8D3E,43761,11,13,2,32,47,1647
12192,12192,1AE278194B1E20A9DCFBA8E0E37A8D3E,12511,13,14,1,39,47,1997
12193,12193,1AE278194B1E20A9DCFBA8E0E37A8D3E,11481,14,16,2,41,48,2098
12194,12194,1AE278194B1E20A9DCFBA8E0E37A8D3E,40341,16,19,3,23,49,1199
12198,12198,DE980DACA70C6198972643EFAF0AD63A,42531,10,14,4,31,45,1595
12199,12199,DE980DACA70C6198972643EFAF0AD63A,12311,15,16,1,30,44,1544
12200,12200,DE980DACA70C6198972643EFAF0AD63A,11261,18,19,1,36,46,1846
12201,12201,E962C3D0A8FC163364DD770DFBF0ADE9,13651,0,7,7,30,47,1547
12202,12202,E962C3D0A8FC163364DD770DFBF0ADE9,41591,8,12,4,34,49,1749
12203,12203,E962C3D0A8FC163364DD770DFBF0ADE9,40673,14,16,2,36,48,1848
12204,12204,E962C3D0A8FC163364DD770DFBF0ADE9,13651,19,23,4,30,47,1547
12205,12205,791234E587E0C86D41967E57B8EBA1DD,42321,0,7,7,43,47,2197
12206,12206,791234E587E0C86D41967E57B8EBA1DD,13711,11,13,2,38,46,1946
12207,12207,791234E587E0C86D41967E57B8EBA1DD,42321,13,16,3,43,47,2197
12208,12208,791234E587E0C86D41967E57B8EBA1DD,13711,18,23,5,38,46,1946
12212,12212,4EAEA07A12B611EF65EDB5896F86C5E3,42531,0,4,4,31,45,1595
12213,12213,4EAEA07A12B611EF65EDB5896F86C5E3,42521,8,10,2,31,47,1597
12214,12214,4EAEA07A12B611EF65EDB5896F86C5E3,12311,12,13,1,30,44,1544
12215,12215,4EAEA07A12B611EF65EDB5896F86C5E3,42531,18,19,1,31,45,1595
12216,12216,4EAEA07A12B611EF65EDB5896F86C5E3,13671,22,23,1,27,43,1393
12223,12223,43125D201B2090874D2E0EE6E6251F06,40171,0,1,1,38,48,1948
12224,12224,43125D201B2090874D2E0EE6E6251F06,11331,2,10,8,37,48,1898
12225,12225,43125D201B2090874D2E0EE6E6251F06,10491,12,13,1,33,48,1698
12226,12226,43125D201B2090874D2E0EE6E6251F06,11331,14,15,1,37,48,1898
12227,12227,43125D201B2090874D2E0EE6E6251F06,10491,18,20,2,33,48,1698
12228,12228,F3632CEFCEB99C36253996BED876A313,43501,0,7,7,27,48,1398
12229,12229,F3632CEFCEB99C36253996BED876A313,10351,10,15,5,28,45,1445
12230,12230,F3632CEFCEB99C36253996BED876A313,11631,20,23,3,12,49,649
12231,12231,C7CE7192CEA544B45335555D251F889F,13121,10,11,1,38,46,1946
12232,12232,C7CE7192CEA544B45335555D251F889F,42511,13,14,1,37,47,1897
12233,12233,C7CE7192CEA544B45335555D251F889F,11751,18,19,1,35,48,1798
12234,12234,C7CE7192CEA544B45335555D251F889F,42351,22,23,1,38,45,1945
12238,12238,8754D75561ECA9632B70CECEA43ED98F,43021,0,5,5,16,43,843
12239,12239,8754D75561ECA9632B70CECEA43ED98F,19021,5,6,1,10,45,545
12240,12240,8754D75561ECA9632B70CECEA43ED98F,11491,10,17,7,36,47,1847
12241,12241,8754D75561ECA9632B70CECEA43ED98F,10471,18,21,3,37,48,1898
12245,12245,F49EE04071D0B4FCCD4263F4C2BBEA7A,10681,0,6,6,30,48,1548
12246,12246,F49EE04071D0B4FCCD4263F4C2BBEA7A,11061,6,7,1,29,48,1498
12247,12247,F49EE04071D0B4FCCD4263F4C2BBEA7A,12121,8,11,3,29,47,1497
12248,12248,F49EE04071D0B4FCCD4263F4C2BBEA7A,43761,12,13,1,32,47,1647
12249,12249,F49EE04071D0B4FCCD4263F4C2BBEA7A,11161,17,19,2,32,48,1648
12250,12250,F49EE04071D0B4FCCD4263F4C2BBEA7A,11061,20,21,1,29,48,1498
12251,12251,F49EE04071D0B4FCCD4263F4C2BBEA7A,10681,21,23,2,30,48,1548
12260,12260,E648A6F090A3BE85617E0ED54A73B4F0,12671,0,8,8,21,43,1093
12261,12261,E648A6F090A3BE85617E0ED54A73B4F0,12601,8,12,4,25,47,1297
12262,12262,E648A6F090A3BE85617E0ED54A73B4F0,12671,13,14,1,21,43,1093
12263,12263,E648A6F090A3BE85617E0ED54A73B4F0,12601,15,23,8,25,47,1297
12268,12268,9C0ACC78786AB3EDB58D985A680EE622,13341,0,2,2,44,45,2245
12269,12269,9C0ACC78786AB3EDB58D985A680EE622,42031,3,9,6,40,46,2046
12270,12270,9C0ACC78786AB3EDB58D985A680EE622,13341,14,23,9,44,45,2245
12271,12271,2F66AC01887397A198C9CCA6611EA97B,12521,0,15,15,35,41,1791
12272,12272,2F66AC01887397A198C9CCA6611EA97B,13314,15,16,1,31,39,1589
12273,12273,2F66AC01887397A198C9CCA6611EA97B,12521,16,23,7,35,41,1791
12278,12278,4C277ABE9AAFFACC84B539B0700C1F48,10221,1,12,11,34,49,1749
12279,12279,4C277ABE9AAFFACC84B539B0700C1F48,11811,13,18,5,38,49,1949
12280,12280,4C277ABE9AAFFACC84B539B0700C1F48,42341,20,21,1,43,49,2199
12281,12281,586D98AD4F15CC2FB51D9D67A91C9D05,12521,0,1,1,35,41,1791
12282,12282,586D98AD4F15CC2FB51D9D67A91C9D05,13314,3,7,4,31,39,1589
12283,12283,586D98AD4F15CC2FB51D9D67A91C9D05,12521,11,23,12,35,41,1791
12284,12284,9641FF809BC99375A7EB0913A38DD4C9,11061,0,7,7,29,48,1498
12285,12285,9641FF809BC99375A7EB0913A38DD4C9,11151,11,13,2,30,48,1548
12286,12286,9641FF809BC99375A7EB0913A38DD4C9,40637,14,16,2,36,47,1847
12287,12287,9641FF809BC99375A7EB0913A38DD4C9,10251,17,19,2,35,47,1797
12288,12288,9641FF809BC99375A7EB0913A38DD4C9,11061,22,23,1,29,48,1498
12299,12299,C9CAC2C6335B37B2CDE3F43D7A7F9A91,42071,0,6,6,31,49,1599
12300,12300,C9CAC2C6335B37B2CDE3F43D7A7F9A91,11021,7,8,1,36,49,1849
12301,12301,C9CAC2C6335B37B2CDE3F43D7A7F9A91,42071,8,11,3,31,49,1599
12302,12302,C9CAC2C6335B37B2CDE3F43D7A7F9A91,11591,13,14,1,36,49,1849
12303,12303,C9CAC2C6335B37B2CDE3F43D7A7F9A91,42071,14,23,9,31,49,1599
12313,12313,8E04CA34920941791B1B2D80E2E36134,43581,0,10,10,33,48,1698
12314,12314,8E04CA34920941791B1B2D80E2E36134,11381,11,13,2,30,47,1547
12315,12315,8E04CA34920941791B1B2D80E2E36134,43361,13,15,2,38,48,1948
12316,12316,8E04CA34920941791B1B2D80E2E36134,41601,16,18,2,39,49,1999
12317,12317,8E04CA34920941791B1B2D80E2E36134,11211,20,21,1,34,49,1749
12326,12326,9B486689278BE374093A259A43CD5B5C,42141,0,8,8,32,47,1647
12327,12327,9B486689278BE374093A259A43CD5B5C,10351,11,14,3,28,45,1445
12328,12328,9B486689278BE374093A259A43CD5B5C,10634,16,18,2,27,45,1395
12329,12329,9B486689278BE374093A259A43CD5B5C,10351,18,20,2,28,45,1445
12330,12330,9B486689278BE374093A259A43CD5B5C,42141,21,23,2,32,47,1647
12335,12335,F9FE340AD192EDE0E7CC914D9F98789E,12491,0,7,7,36,43,1843
12336,12336,F9FE340AD192EDE0E7CC914D9F98789E,12731,8,10,2,22,40,1140
12337,12337,F9FE340AD192EDE0E7CC914D9F98789E,42381,11,12,1,39,41,1991
12338,12338,F9FE340AD192EDE0E7CC914D9F98789E,43011,19,20,1,40,42,2042
12339,12339,F9FE340AD192EDE0E7CC914D9F98789E,12491,20,21,1,36,43,1843
12340,12340,F9FE340AD192EDE0E7CC914D9F98789E,43011,22,23,1,40,42,2042
12341,12341,A796809FFC26797F0B17A0B66E102B15,12521,8,10,2,35,41,1791
12342,12342,A796809FFC26797F0B17A0B66E102B15,13314,12,13,1,31,39,1589
12343,12343,A796809FFC26797F0B17A0B66E102B15,12521,13,17,4,35,41,1791
12344,12344,A796809FFC26797F0B17A0B66E102B15,13314,18,23,5,31,39,1589
12352,12352,0BF9081B921E7C1EC68F2248D31F0D32,16281,0,7,7,11,4,554
12353,12353,0BF9081B921E7C1EC68F2248D31F0D32,15143,12,14,2,18,7,907
12354,12354,0BF9081B921E7C1EC68F2248D31F0D32,16281,15,22,7,11,4,554
12355,12355,B9DC46108EA0176B6B114AD4E312EB09,19441,10,11,1,8,46,446
12356,12356,B9DC46108EA0176B6B114AD4E312EB09,11571,11,12,1,13,46,696
12357,12357,B9DC46108EA0176B6B114AD4E312EB09,19441,17,19,2,8,46,446
12358,12358,B9DC46108EA0176B6B114AD4E312EB09,19901,21,23,2,7,44,394
12359,12359,DE2CF7635A4FCEF13695C4816E23FB11,10491,0,7,7,33,48,1698
12360,12360,DE2CF7635A4FCEF13695C4816E23FB11,10881,8,10,2,34,48,1748
12361,12361,DE2CF7635A4FCEF13695C4816E23FB11,42941,11,12,1,37,47,1897
12362,12362,DE2CF7635A4FCEF13695C4816E23FB11,13351,14,23,9,48,48,2448
12366,12366,27457C01D34B1EDCA18C71D8C9D9EF1D,12311,0,8,8,30,44,1544
12367,12367,27457C01D34B1EDCA18C71D8C9D9EF1D,11074,10,16,6,37,47,1897
12368,12368,27457C01D34B1EDCA18C71D8C9D9EF1D,12311,17,21,4,30,44,1544
12372,12372,8CB1004D998CCF836ACB02060541F17F,42161,0,8,8,36,47,1847
12373,12373,8CB1004D998CCF836ACB02060541F17F,43061,9,11,2,43,46,2196
12374,12374,8CB1004D998CCF836ACB02060541F17F,11074,15,16,1,37,47,1897
12375,12375,8CB1004D998CCF836ACB02060541F17F,10971,18,20,2,35,47,1797
12376,12376,0DD51EE42A065AE9C7264B2B66A89D4A,19021,0,3,3,10,45,545
12377,12377,0DD51EE42A065AE9C7264B2B66A89D4A,12921,4,7,3,9,41,491
12378,12378,0DD51EE42A065AE9C7264B2B66A89D4A,19021,11,23,12,10,45,545
12379,12379,04D73C3CD00D40CB611F6BA5801F802C,13314,0,7,7,31,39,1589
12380,12380,04D73C3CD00D40CB611F6BA5801F802C,12521,7,11,4,35,41,1791
12381,12381,04D73C3CD00D40CB611F6BA5801F802C,13314,11,13,2,31,39,1589
12382,12382,04D73C3CD00D40CB611F6BA5801F802C,12521,13,17,4,35,41,1791
12383,12383,04D73C3CD00D40CB611F6BA5801F802C,13314,20,23,3,31,39,1589
12384,12384,FF16D1104349162E539969031BE39A02,13221,0,2,2,40,47,2047
12385,12385,FF16D1104349162E539969031BE39A02,43481,3,4,1,39,48,1998
12386,12386,FF16D1104349162E539969031BE39A02,12514,6,7,1,38,47,1947
12387,12387,FF16D1104349162E539969031BE39A02,12511,8,10,2,39,47,1997
12388,12388,FF16D1104349162E539969031BE39A02,43481,12,13,1,39,48,1998
12389,12389,FF16D1104349162E539969031BE39A02,12514,14,17,3,38,47,1947
12390,12390,FF16D1104349162E539969031BE39A02,43481,21,22,1,39,48,1998
12391,12391,3167279CE8CFD8F4AA7B1E5335A41089,12601,0,5,5,25,47,1297
12392,12392,3167279CE8CFD8F4AA7B1E5335A41089,10471,7,19,12,37,48,1898
12393,12393,3167279CE8CFD8F4AA7B1E5335A41089,11231,21,23,2,37,49,1899
12394,12394,A2322C7E82C506086C86C7A37D702773,12381,0,7,7,32,48,1648
12395,12395,A2322C7E82C506086C86C7A37D702773,11074,8,9,1,37,47,1897
12396,12396,A2322C7E82C506086C86C7A37D702773,12381,12,23,11,32,48,1648
12406,12406,DB8401586004DE27BAE45C4ACC7E9E5E,42071,5,6,1,31,49,1599
12407,12407,DB8401586004DE27BAE45C4ACC7E9E5E,42623,8,9,1,22,49,1149
12408,12408,DB8401586004DE27BAE45C4ACC7E9E5E,42071,13,20,7,31,49,1599
12409,12409,DB8401586004DE27BAE45C4ACC7E9E5E,42261,21,22,1,25,49,1299
12410,12410,2E9ACB5217DEAC635E911A6AAEF6DCF5,11261,0,6,6,36,46,1846
12411,12411,2E9ACB5217DEAC635E911A6AAEF6DCF5,12021,8,16,8,37,49,1899
12412,12412,2E9ACB5217DEAC635E911A6AAEF6DCF5,11261,18,20,2,36,46,1846
12413,12413,2E9ACB5217DEAC635E911A6AAEF6DCF5,11951,21,22,1,31,49,1599
12423,12423,083E6F45CD758E55D59CE683A8831561,42381,0,14,14,39,41,1991
12424,12424,083E6F45CD758E55D59CE683A8831561,43011,17,19,2,40,42,2042
12425,12425,083E6F45CD758E55D59CE683A8831561,13121,20,21,1,38,46,1946
12432,12432,9AA09FAFA3A0B94587220E28842ADF00,10161,0,2,2,35,49,1799
12433,12433,9AA09FAFA3A0B94587220E28842ADF00,42801,3,13,10,40,49,2049
12434,12434,9AA09FAFA3A0B94587220E28842ADF00,11811,14,15,1,38,49,1949
12435,12435,9AA09FAFA3A0B94587220E28842ADF00,12083,15,17,2,36,49,1849
12436,12436,9AA09FAFA3A0B94587220E28842ADF00,40271,21,23,2,35,49,1799
12437,12437,85061C43999146706723F4E0700EE955,13911,0,3,3,39,46,1996
12438,12438,85061C43999146706723F4E0700EE955,11261,5,7,2,36,46,1846
12439,12439,85061C43999146706723F4E0700EE955,13911,7,10,3,39,46,1996
12440,12440,85061C43999146706723F4E0700EE955,11261,10,11,1,36,46,1846
12441,12441,85061C43999146706723F4E0700EE955,13911,13,17,4,39,46,1996
12442,12442,85061C43999146706723F4E0700EE955,11261,18,22,4,36,46,1846
12443,12443,85061C43999146706723F4E0700EE955,13911,22,23,1,39,46,1996
12448,12448,FCA3C665B5BF337F331669EDB597A6AC,42791,0,7,7,35,45,1795
12449,12449,FCA3C665B5BF337F331669EDB597A6AC,10271,8,10,2,37,46,1896
12450,12450,FCA3C665B5BF337F331669EDB597A6AC,13121,12,14,2,38,46,1946
12451,12451,FCA3C665B5BF337F331669EDB597A6AC,10271,15,18,3,37,46,1896
12452,12452,FCA3C665B5BF337F331669EDB597A6AC,42791,19,23,4,35,45,1795
12469,12469,C0A5FC6D99A04AB7CC2D865E46B186E7,40833,0,18,18,41,47,2097
12470,12470,C0A5FC6D99A04AB7CC2D865E46B186E7,40341,19,20,1,23,49,1199
12471,12471,C0A5FC6D99A04AB7CC2D865E46B186E7,11481,20,23,3,41,48,2098
12475,12475,5A6FFC46E8632CD94D18183E56F226E1,12083,3,6,3,36,49,1849
12476,12476,5A6FFC46E8632CD94D18183E56F226E1,10901,8,10,2,35,48,1798
12477,12477,5A6FFC46E8632CD94D18183E56F226E1,13121,11,12,1,38,46,1946
12478,12478,5A6FFC46E8632CD94D18183E56F226E1,11331,15,16,1,37,48,1898
12479,12479,5A6FFC46E8632CD94D18183E56F226E1,11231,18,21,3,37,49,1899
12484,12484,F2E0A788EC41736380A7AB3495E7AB34,42161,0,6,6,36,47,1847
12485,12485,F2E0A788EC41736380A7AB3495E7AB34,12051,7,8,1,20,47,1047
12486,12486,F2E0A788EC41736380A7AB3495E7AB34,42691,9,10,1,24,48,1248
12487,12487,F2E0A788EC41736380A7AB3495E7AB34,12051,13,17,4,20,47,1047
12488,12488,F2E0A788EC41736380A7AB3495E7AB34,10251,18,21,3,35,47,1797
12489,12489,9FD07F08B957B9919E73D64BBF49A52F,11781,0,9,9,38,49,1949
12490,12490,9FD07F08B957B9919E73D64BBF49A52F,10511,10,11,1,35,46,1796
12491,12491,9FD07F08B957B9919E73D64BBF49A52F,11791,12,15,3,38,49,1949
12492,12492,9FD07F08B957B9919E73D64BBF49A52F,10251,15,17,2,35,47,1797
12493,12493,9FD07F08B957B9919E73D64BBF49A52F,11781,17,22,5,38,49,1949
12494,12494,90692BFC9E8D2CC5D8B5F5F53764BF3A,11871,0,8,8,29,46,1496
12495,12495,90692BFC9E8D2CC5D8B5F5F53764BF3A,19021,8,12,4,10,45,545
12496,12496,90692BFC9E8D2CC5D8B5F5F53764BF3A,10491,14,15,1,33,48,1698
12497,12497,90692BFC9E8D2CC5D8B5F5F53764BF3A,19021,16,18,2,10,45,545
12498,12498,90692BFC9E8D2CC5D8B5F5F53764BF3A,43311,20,23,3,31,48,1598
12502,12502,2770DAF26F856B8C604C0FF1601A7902,12641,0,10,10,10,43,543
12503,12503,2770DAF26F856B8C604C0FF1601A7902,19181,11,12,1,8,40,440
12504,12504,2770DAF26F856B8C604C0FF1601A7902,12641,14,20,6,10,43,543
12505,12505,2770DAF26F856B8C604C0FF1601A7902,19744,21,22,1,6,43,343
12506,12506,1466136E752B9F4A2CBAAAB8A15DDB2A,40637,0,2,2,36,47,1847
12507,12507,1466136E752B9F4A2CBAAAB8A15DDB2A,12841,2,3,1,37,47,1897
12508,12508,1466136E752B9F4A2CBAAAB8A15DDB2A,42401,4,10,6,36,47,1847
12509,12509,1466136E752B9F4A2CBAAAB8A15DDB2A,10107,13,14,1,38,49,1949
12510,12510,1466136E752B9F4A2CBAAAB8A15DDB2A,42401,15,18,3,36,47,1847
12511,12511,1466136E752B9F4A2CBAAAB8A15DDB2A,40951,19,20,1,36,49,1849
12512,12512,214AC1F3D5605C0D7130343B840F5E8C,11151,0,7,7,30,48,1548
12513,12513,214AC1F3D5605C0D7130343B840F5E8C,11061,9,13,4,29,48,1498
12514,12514,214AC1F3D5605C0D7130343B840F5E8C,11151,13,14,1,30,48,1548
12515,12515,214AC1F3D5605C0D7130343B840F5E8C,11061,15,16,1,29,48,1498
12516,12516,214AC1F3D5605C0D7130343B840F5E8C,11151,18,23,5,30,48,1548
12517,12517,7D8BB90B66B5BB302B836A7DB354A71B,42601,0,6,6,44,48,2248
12518,12518,7D8BB90B66B5BB302B836A7DB354A71B,12651,7,10,3,43,47,2197
12519,12519,7D8BB90B66B5BB302B836A7DB354A71B,42601,12,14,2,44,48,2248
12520,12520,7D8BB90B66B5BB302B836A7DB354A71B,12651,16,18,2,43,47,2197
12521,12521,7D8BB90B66B5BB302B836A7DB354A71B,11701,20,22,2,43,48,2198
12522,12522,EEB3CBC85DF19031E292162C06516E43,10471,8,12,4,37,48,1898
12523,12523,EEB3CBC85DF19031E292162C06516E43,11381,14,18,4,30,47,1547
12524,12524,EEB3CBC85DF19031E292162C06516E43,10471,19,22,3,37,48,1898
12525,12525,B2837B3AF3B95C01477BCBE3B9A87733,11021,7,8,1,36,49,1849
12526,12526,B2837B3AF3B95C01477BCBE3B9A87733,11091,10,11,1,29,47,1497
12527,12527,B2837B3AF3B95C01477BCBE3B9A87733,11021,14,23,9,36,49,1849
12528,12528,11A1F6791BB139142B52DB3053B236D6,10281,1,8,7,33,48,1698
12529,12529,11A1F6791BB139142B52DB3053B236D6,40124,10,17,7,38,47,1947
12530,12530,11A1F6791BB139142B52DB3053B236D6,11861,19,23,4,32,47,1647
12531,12531,7AFF3AE389680B660B260F1E6B0BF0D8,10544,0,6,6,28,48,1448
12532,12532,7AFF3AE389680B660B260F1E6B0BF0D8,11481,8,10,2,41,48,2098
12533,12533,7AFF3AE389680B660B260F1E6B0BF0D8,10544,11,23,12,28,48,1448
12541,12541,2295C74F0BD2BB081A3FCDFFDED68B9C,12921,0,10,10,9,41,491
12542,12542,2295C74F0BD2BB081A3FCDFFDED68B9C,12641,13,14,1,10,43,543
12543,12543,2295C74F0BD2BB081A3FCDFFDED68B9C,19261,14,16,2,6,37,337
12544,12544,2295C74F0BD2BB081A3FCDFFDED68B9C,12921,16,23,7,9,41,491
12545,12545,E3B088F7DEFCCE4BD4EB6ADB8F0E5950,10841,0,7,7,37,47,1897
12546,12546,E3B088F7DEFCCE4BD4EB6ADB8F0E5950,12514,11,14,3,38,47,1947
12547,12547,E3B088F7DEFCCE4BD4EB6ADB8F0E5950,10691,17,19,2,33,48,1698
12548,12548,E3B088F7DEFCCE4BD4EB6ADB8F0E5950,11541,20,22,2,35,49,1799
12549,12549,656752102BA99654C7060CE5B2133D72,19114,0,5,5,7,43,393
12550,12550,656752102BA99654C7060CE5B2133D72,12921,6,8,2,9,41,491
12551,12551,656752102BA99654C7060CE5B2133D72,49201,8,10,2,7,41,391
12552,12552,656752102BA99654C7060CE5B2133D72,12921,13,17,4,9,41,491
12553,12553,656752102BA99654C7060CE5B2133D72,19114,18,22,4,7,43,393
12554,12554,95A50FC77E468146BAD45CC8BD317370,42921,2,5,3,33,47,1697
12555,12555,95A50FC77E468146BAD45CC8BD317370,11324,10,11,1,31,46,1596
12556,12556,95A50FC77E468146BAD45CC8BD317370,11871,14,16,2,29,46,1496
12557,12557,95A50FC77E468146BAD45CC8BD317370,13601,19,21,2,34,47,1747
12558,12558,D3B7E592123DB083081A1FE3F2020361,19741,0,5,5,5,44,294
12559,12559,D3B7E592123DB083081A1FE3F2020361,12921,6,15,9,9,41,491
12560,12560,D3B7E592123DB083081A1FE3F2020361,19744,19,20,1,6,43,343
12561,12561,D3B7E592123DB083081A1FE3F2020361,19741,21,23,2,5,44,294
12566,12566,4C580D78A88C28BCF4ADEB9168B64E1D,43011,1,5,4,40,42,2042
12567,12567,4C580D78A88C28BCF4ADEB9168B64E1D,42861,7,18,11,37,44,1894
12568,12568,4C580D78A88C28BCF4ADEB9168B64E1D,12661,19,20,1,32,45,1645
12569,12569,DEA13AE4E25C1F5535D501BC3C7ECF55,11631,0,7,7,12,49,649
12570,12570,DEA13AE4E25C1F5535D501BC3C7ECF55,11954,8,17,9,32,49,1649
12571,12571,DEA13AE4E25C1F5535D501BC3C7ECF55,11541,17,18,1,35,49,1799
12572,12572,DEA13AE4E25C1F5535D501BC3C7ECF55,42641,19,20,1,33,49,1699
12573,12573,DEA13AE4E25C1F5535D501BC3C7ECF55,10451,20,21,1,25,48,1298
12574,12574,6B8040EDBA3C7A3B7087183B1A963D8F,41393,0,7,7,43,49,2199
12575,12575,6B8040EDBA3C7A3B7087183B1A963D8F,11661,8,11,3,40,49,2049
12576,12576,6B8040EDBA3C7A3B7087183B1A963D8F,10924,14,15,1,43,49,2199
12577,12577,6B8040EDBA3C7A3B7087183B1A963D8F,11301,19,21,2,41,49,2099
12578,12578,6B8040EDBA3C7A3B7087183B1A963D8F,10924,21,23,2,43,49,2199
12579,12579,42BA5061E4766211857B487ABE83C295,13141,0,11,11,23,30,1180
12580,12580,42BA5061E4766211857B487ABE83C295,13221,13,20,7,40,47,2047
12581,12581,42BA5061E4766211857B487ABE83C295,13141,22,23,1,23,30,1180
12582,12582,2F8CA12038D8BFDAC42D43FF94213821,42381,0,5,5,39,41,1991
12583,12583,2F8CA12038D8BFDAC42D43FF94213821,43451,6,9,3,37,40,1890
12584,12584,2F8CA12038D8BFDAC42D43FF94213821,42381,10,12,2,39,41,1991
12585,12585,2F8CA12038D8BFDAC42D43FF94213821,43451,14,16,2,37,40,1890
12586,12586,2F8CA12038D8BFDAC42D43FF94213821,42381,19,22,3,39,41,1991
12590,12590,96056246DD9856C2DDE7E703B0D16D68,11381,0,10,10,30,47,1547
12591,12591,96056246DD9856C2DDE7E703B0D16D68,10107,12,13,1,38,49,1949
12592,12592,96056246DD9856C2DDE7E703B0D16D68,10951,14,17,3,29,48,1498
12593,12593,96056246DD9856C2DDE7E703B0D16D68,11381,21,23,2,30,47,1547
12594,12594,E572D34D15CCFF06895D9E2C410E6273,42371,8,9,1,34,46,1746
12595,12595,E572D34D15CCFF06895D9E2C410E6273,42151,13,17,4,35,45,1795
12596,12596,E572D34D15CCFF06895D9E2C410E6273,42381,19,20,1,39,41,1991
12597,12597,015977F21CA69DACA3E876A5F028B2A4,43051,0,4,4,46,45,2345
12598,12598,015977F21CA69DACA3E876A5F028B2A4,13351,5,11,6,48,48,2448
12599,12599,015977F21CA69DACA3E876A5F028B2A4,43051,12,14,2,46,45,2345
12600,12600,015977F21CA69DACA3E876A5F028B2A4,13351,15,20,5,48,48,2448
12601,12601,015977F21CA69DACA3E876A5F028B2A4,43051,21,23,2,46,45,2345
12622,12622,CC3FA096FA296BC301B8FB82BD507846,11531,7,9,2,34,49,1749
12623,12623,CC3FA096FA296BC301B8FB82BD507846,42471,13,15,2,35,49,1799
12624,12624,CC3FA096FA296BC301B8FB82BD507846,11021,17,18,1,36,49,1849
12625,12625,CC3FA096FA296BC301B8FB82BD507846,42831,20,22,2,27,48,1398
12632,12632,FA6572C8DE32EDFE4E3C8A62A168069B,11231,10,13,3,37,49,1899
12633,12633,FA6572C8DE32EDFE4E3C8A62A168069B,13091,14,17,3,20,42,1042
12634,12634,FA6572C8DE32EDFE4E3C8A62A168069B,11231,20,23,3,37,49,1899
12635,12635,18F85D1FF157146B3054BAA6982B6768,43061,0,11,11,43,46,2196
12636,12636,18F85D1FF157146B3054BAA6982B6768,13221,12,13,1,40,47,2047
12637,12637,18F85D1FF157146B3054BAA6982B6768,10271,17,22,5,37,46,1896
12638,12638,D454F61AD8B5A1CBE1E15CE597E2F528,11231,10,18,8,37,49,1899
12639,12639,D454F61AD8B5A1CBE1E15CE597E2F528,10531,19,20,1,34,46,1746
12640,12640,D454F61AD8B5A1CBE1E15CE597E2F528,11231,20,23,3,37,49,1899
12647,12647,B20D4CCCBBF9B534BB9F26A35B371E4C,13911,0,5,5,39,46,1996
12648,12648,B20D4CCCBBF9B534BB9F26A35B371E4C,10171,6,13,7,26,47,1347
12649,12649,B20D4CCCBBF9B534BB9F26A35B371E4C,10711,14,19,5,29,46,1496
12654,12654,07B5D0BAB4108A3440EC13D4A4739897,42521,0,1,1,31,47,1597
12655,12655,07B5D0BAB4108A3440EC13D4A4739897,11061,2,5,3,29,48,1498
12656,12656,07B5D0BAB4108A3440EC13D4A4739897,11381,6,16,10,30,47,1547
12657,12657,07B5D0BAB4108A3440EC13D4A4739897,42521,19,21,2,31,47,1597
12658,12658,07B5D0BAB4108A3440EC13D4A4739897,13511,22,23,1,34,48,1748
12659,12659,F7A05B3FECD253C9C578617425D22E9D,13351,0,6,6,48,48,2448
12660,12660,F7A05B3FECD253C9C578617425D22E9D,40302,7,11,4,40,49,2049
12661,12661,F7A05B3FECD253C9C578617425D22E9D,13351,13,18,5,48,48,2448
12662,12662,4E8CF0BE1A57E085938ED2B5916A9E34,11381,1,2,1,30,47,1547
12663,12663,4E8CF0BE1A57E085938ED2B5916A9E34,11061,2,4,2,29,48,1498
12664,12664,4E8CF0BE1A57E085938ED2B5916A9E34,11381,7,10,3,30,47,1547
12665,12665,4E8CF0BE1A57E085938ED2B5916A9E34,10281,12,17,5,33,48,1698
12666,12666,4E8CF0BE1A57E085938ED2B5916A9E34,11381,20,21,1,30,47,1547
12667,12667,1F49E26C341B3738FA1E54F232E557D3,11074,0,7,7,37,47,1897
12668,12668,1F49E26C341B3738FA1E54F232E557D3,12514,12,14,2,38,47,1947
12669,12669,1F49E26C341B3738FA1E54F232E557D3,11751,16,18,2,35,48,1798
12670,12670,1F49E26C341B3738FA1E54F232E557D3,11201,20,21,1,35,49,1799
12671,12671,1F49E26C341B3738FA1E54F232E557D3,12514,22,23,1,38,47,1947
12672,12672,9E3F301B3B5F9C23B8B0713E1BDF24BF,43281,0,14,14,37,48,1898
12673,12673,9E3F301B3B5F9C23B8B0713E1BDF24BF,13961,18,20,2,42,48,2148
12674,12674,9E3F301B3B5F9C23B8B0713E1BDF24BF,43281,21,23,2,37,48,1898
12675,12675,0102436000D6EFDA91A3939751E37135,42631,3,5,2,43,45,2195
12676,12676,0102436000D6EFDA91A3939751E37135,10751,7,10,3,47,43,2393
12677,12677,0102436000D6EFDA91A3939751E37135,13341,11,13,2,44,45,2245
12678,12678,0102436000D6EFDA91A3939751E37135,12514,14,16,2,38,47,1947
12679,12679,0102436000D6EFDA91A3939751E37135,42631,16,18,2,43,45,2195
12680,12680,6E89F326BDEF30AF8456FEEADC487B08,42151,0,9,9,35,45,1795
12681,12681,6E89F326BDEF30AF8456FEEADC487B08,11321,9,12,3,31,46,1596
12682,12682,6E89F326BDEF30AF8456FEEADC487B08,10251,14,17,3,35,47,1797
12683,12683,6E89F326BDEF30AF8456FEEADC487B08,42151,20,23,3,35,45,1795
12684,12684,AAF4696620C6353C66227214077A10B8,10971,0,7,7,35,47,1797
12685,12685,AAF4696620C6353C66227214077A10B8,40673,9,10,1,36,48,1848
12686,12686,AAF4696620C6353C66227214077A10B8,10634,11,12,1,27,45,1395
12687,12687,AAF4696620C6353C66227214077A10B8,12491,12,16,4,36,43,1843
12688,12688,AAF4696620C6353C66227214077A10B8,40637,19,23,4,36,47,1847
12689,12689,7B34C273E34CE1CA5EC462EE747405EC,42031,0,6,6,40,46,2046
12690,12690,7B34C273E34CE1CA5EC462EE747405EC,12641,7,17,10,10,43,543
12691,12691,7B34C273E34CE1CA5EC462EE747405EC,10191,19,22,3,40,48,2048
12692,12692,ADF3192E17023E2A1F9E5EA46E987F9F,13711,0,6,6,38,46,1946
12693,12693,ADF3192E17023E2A1F9E5EA46E987F9F,19031,7,9,2,1,42,92
12694,12694,ADF3192E17023E2A1F9E5EA46E987F9F,13711,12,22,10,38,46,1946
12695,12695,79F70A1AE08CEE215DA71360DE1B25EA,42191,0,6,6,38,49,1949
12696,12696,79F70A1AE08CEE215DA71360DE1B25EA,42231,6,9,3,37,46,1896
12697,12697,79F70A1AE08CEE215DA71360DE1B25EA,13911,9,10,1,39,46,1996
12698,12698,79F70A1AE08CEE215DA71360DE1B25EA,42231,11,19,8,37,46,1896
12699,12699,79F70A1AE08CEE215DA71360DE1B25EA,42191,20,23,3,38,49,1949
12707,12707,6F60DF43E72A344D99FCB3944A72DCC7,42871,2,8,6,30,45,1545
12708,12708,6F60DF43E72A344D99FCB3944A72DCC7,10716,11,12,1,30,46,1546
12709,12709,6F60DF43E72A344D99FCB3944A72DCC7,42871,12,16,4,30,45,1545
12710,12710,6F60DF43E72A344D99FCB3944A72DCC7,12601,18,23,5,25,47,1297
12711,12711,1078436CC9F31DFE63B8B6F9AEB69E32,42151,0,8,8,35,45,1795
12712,12712,1078436CC9F31DFE63B8B6F9AEB69E32,12641,10,12,2,10,43,543
12713,12713,1078436CC9F31DFE63B8B6F9AEB69E32,42151,14,17,3,35,45,1795
12714,12714,1078436CC9F31DFE63B8B6F9AEB69E32,42301,19,21,2,36,47,1847
12715,12715,1078436CC9F31DFE63B8B6F9AEB69E32,11231,22,23,1,37,49,1899
12716,12716,D256AE34DD31744D7365602849D9C40A,42491,0,7,7,32,46,1646
12717,12717,D256AE34DD31744D7365602849D9C40A,10351,9,10,1,28,45,1445
12718,12718,D256AE34DD31744D7365602849D9C40A,12601,10,15,5,25,47,1297
12719,12719,D256AE34DD31744D7365602849D9C40A,42491,19,22,3,32,46,1646
12726,12726,05286C4B5017A260B39768783F7D4555,42581,0,6,6,38,48,1948
12727,12727,05286C4B5017A260B39768783F7D4555,11914,8,15,7,37,48,1898
12728,12728,05286C4B5017A260B39768783F7D4555,42581,17,18,1,38,48,1948
12729,12729,05286C4B5017A260B39768783F7D4555,11811,19,20,1,38,49,1949
12730,12730,05286C4B5017A260B39768783F7D4555,42581,21,23,2,38,48,1948
12731,12731,F728E42B3FC103F48439702CC4DFDAA2,11701,0,10,10,43,48,2198
12732,12732,F728E42B3FC103F48439702CC4DFDAA2,13221,12,13,1,40,47,2047
12733,12733,F728E42B3FC103F48439702CC4DFDAA2,41392,14,16,2,43,48,2198
12734,12734,F728E42B3FC103F48439702CC4DFDAA2,10471,19,21,2,37,48,1898
12735,12735,E2F2F4143F844EB76521711717E3F1F1,12921,0,5,5,9,41,491
12736,12736,E2F2F4143F844EB76521711717E3F1F1,12641,8,11,3,10,43,543
12737,12737,E2F2F4143F844EB76521711717E3F1F1,12921,12,14,2,9,41,491
12738,12738,E2F2F4143F844EB76521711717E3F1F1,19441,17,18,1,8,46,446
12739,12739,E2F2F4143F844EB76521711717E3F1F1,19261,22,23,1,6,37,337
12740,12740,CD5F8D7604C7020A19DDE3C48998E9F5,13314,0,5,5,31,39,1589
12741,12741,CD5F8D7604C7020A19DDE3C48998E9F5,12521,6,19,13,35,41,1791
12742,12742,CD5F8D7604C7020A19DDE3C48998E9F5,13314,21,23,2,31,39,1589
12743,12743,A02CC63C83B0DB8DAC13DDD011BB9A96,11161,0,7,7,32,48,1648
12744,12744,A02CC63C83B0DB8DAC13DDD011BB9A96,10921,12,13,1,43,48,2198
12745,12745,A02CC63C83B0DB8DAC13DDD011BB9A96,13821,14,19,5,49,45,2495
12746,12746,A02CC63C83B0DB8DAC13DDD011BB9A96,11161,21,22,1,32,48,1648
12750,12750,6ED4E98618211CFD21914CBC7EBEB1E1,11011,8,9,1,39,49,1999
12751,12751,6ED4E98618211CFD21914CBC7EBEB1E1,12731,10,13,3,22,40,1140
12752,12752,6ED4E98618211CFD21914CBC7EBEB1E1,10681,13,15,2,30,48,1548
12753,12753,6ED4E98618211CFD21914CBC7EBEB1E1,40341,16,19,3,23,49,1199
12768,12768,333863A2CE0A7D471D7CF76BFFDAB0D7,12641,0,9,9,10,43,543
12769,12769,333863A2CE0A7D471D7CF76BFFDAB0D7,19744,12,14,2,6,43,343
12770,12770,333863A2CE0A7D471D7CF76BFFDAB0D7,12641,16,17,1,10,43,543
12771,12771,333863A2CE0A7D471D7CF76BFFDAB0D7,19744,18,19,1,6,43,343
12772,12772,333863A2CE0A7D471D7CF76BFFDAB0D7,12641,22,23,1,10,43,543
12773,12773,7011DE96B440B54BDA505351983BAF85,11021,1,13,12,36,49,1849
12774,12774,7011DE96B440B54BDA505351983BAF85,40463,14,18,4,38,49,1949
12775,12775,7011DE96B440B54BDA505351983BAF85,11021,18,21,3,36,49,1849
12776,12776,7011DE96B440B54BDA505351983BAF85,12511,21,23,2,39,47,1997
12780,12780,D9E1BE976A098208303DCF9E4ACF86DF,10107,3,9,6,38,49,1949
12781,12781,D9E1BE976A098208303DCF9E4ACF86DF,12021,12,15,3,37,49,1899
12782,12782,D9E1BE976A098208303DCF9E4ACF86DF,40341,16,20,4,23,49,1199
12783,12783,D9E1BE976A098208303DCF9E4ACF86DF,11811,21,23,2,38,49,1949
12788,12788,AD5871AA9EAD75878C606AE9C3D0E3D8,12561,1,2,1,45,43,2293
12789,12789,AD5871AA9EAD75878C606AE9C3D0E3D8,43951,6,9,3,49,41,2491
12790,12790,AD5871AA9EAD75878C606AE9C3D0E3D8,12561,12,13,1,45,43,2293
12791,12791,AD5871AA9EAD75878C606AE9C3D0E3D8,43951,14,19,5,49,41,2491
12795,12795,BC415555D98D18CBF281B54A45414433,11571,0,6,6,13,46,696
12796,12796,BC415555D98D18CBF281B54A45414433,19441,7,8,1,8,46,446
12797,12797,BC415555D98D18CBF281B54A45414433,11571,10,19,9,13,46,696
12798,12798,28AE6FF44E8686DC354D2E3DF7700FCC,42461,0,6,6,45,47,2297
12799,12799,28AE6FF44E8686DC354D2E3DF7700FCC,42321,6,11,5,43,47,2197
12800,12800,28AE6FF44E8686DC354D2E3DF7700FCC,42461,12,13,1,45,47,2297
12801,12801,28AE6FF44E8686DC354D2E3DF7700FCC,42321,13,17,4,43,47,2197
12802,12802,28AE6FF44E8686DC354D2E3DF7700FCC,42461,19,21,2,45,47,2297
12803,12803,13A7164293FF85790DE95E7876757302,42301,0,6,6,36,47,1847
12804,12804,13A7164293FF85790DE95E7876757302,10251,8,15,7,35,47,1797
12805,12805,13A7164293FF85790DE95E7876757302,42401,16,17,1,36,47,1847
12806,12806,13A7164293FF85790DE95E7876757302,10231,19,21,2,39,49,1999
12814,12814,31BCE8798560343407E163522AA3094F,42121,0,3,3,26,49,1349
12815,12815,31BCE8798560343407E163522AA3094F,42071,12,16,4,31,49,1599
12816,12816,31BCE8798560343407E163522AA3094F,42623,19,20,1,22,49,1149
12825,12825,7EA63201A47B68AA085BD7B8AF1F7767,10721,0,7,7,31,48,1598
12826,12826,7EA63201A47B68AA085BD7B8AF1F7767,11231,8,9,1,37,49,1899
12827,12827,7EA63201A47B68AA085BD7B8AF1F7767,10901,12,13,1,35,48,1798
12828,12828,7EA63201A47B68AA085BD7B8AF1F7767,11231,15,20,5,37,49,1899
12829,12829,7EA63201A47B68AA085BD7B8AF1F7767,10721,22,23,1,31,48,1598
12842,12842,4BAC07F5248FC45216D777AEA9C4E5CD,11151,3,5,2,30,48,1548
12843,12843,4BAC07F5248FC45216D777AEA9C4E5CD,40302,7,8,1,40,49,2049
12844,12844,4BAC07F5248FC45216D777AEA9C4E5CD,40341,11,12,1,23,49,1199
12845,12845,4BAC07F5248FC45216D777AEA9C4E5CD,40302,13,16,3,40,49,2049
12846,12846,4BAC07F5248FC45216D777AEA9C4E5CD,11301,19,20,1,41,49,2099
12847,12847,4BAC07F5248FC45216D777AEA9C4E5CD,40302,21,23,2,40,49,2049
12848,12848,2CB194F5C88F15739C3E83AF93DF02DF,10281,0,8,8,33,48,1698
12849,12849,2CB194F5C88F15739C3E83AF93DF02DF,11201,8,12,4,35,49,1799
12850,12850,2CB194F5C88F15739C3E83AF93DF02DF,11531,14,15,1,34,49,1749
12851,12851,2CB194F5C88F15739C3E83AF93DF02DF,10281,17,21,4,33,48,1698
12852,12852,2CB194F5C88F15739C3E83AF93DF02DF,11161,21,23,2,32,48,1648
12856,12856,658F51686040AA05DF52C044278C9795,15391,3,5,2,35,26,1776
12857,12857,658F51686040AA05DF52C044278C9795,12792,6,7,1,34,30,1730
12858,12858,658F51686040AA05DF52C044278C9795,15091,9,10,1,35,26,1776
12859,12859,658F51686040AA05DF52C044278C9795,12792,12,16,4,34,30,1730
12860,12860,658F51686040AA05DF52C044278C9795,15391,18,20,2,35,26,1776
12861,12861,658F51686040AA05DF52C044278C9795,43121,20,22,2,25,27,1277
12872,12872,790457C5143568F0FC168A94781493E9,19114,0,5,5,7,43,393
12873,12873,790457C5143568F0FC168A94781493E9,12641,5,9,4,10,43,543
12874,12874,790457C5143568F0FC168A94781493E9,12921,9,14,5,9,41,491
12875,12875,790457C5143568F0FC168A94781493E9,12641,14,16,2,10,43,543
12876,12876,790457C5143568F0FC168A94781493E9,12921,16,18,2,9,41,491
12883,12883,D4B4B4E3A7A4BCB80292B7DC4CB75F9E,11351,0,1,1,36,48,1848
12884,12884,D4B4B4E3A7A4BCB80292B7DC4CB75F9E,42401,1,16,15,36,47,1847
12885,12885,D4B4B4E3A7A4BCB80292B7DC4CB75F9E,42271,19,21,2,40,47,2047
12886,12886,CA376C13A61D259A65D593BAF6522A66,11061,2,3,1,29,48,1498
12887,12887,CA376C13A61D259A65D593BAF6522A66,11834,3,9,6,32,45,1645
12888,12888,CA376C13A61D259A65D593BAF6522A66,40925,12,13,1,35,49,1799
12889,12889,CA376C13A61D259A65D593BAF6522A66,40101,18,23,5,34,49,1749
12890,12890,34797CFFFF01C5BBAA897EA024781C27,11151,3,5,2,30,48,1548
12891,12891,34797CFFFF01C5BBAA897EA024781C27,40302,7,16,9,40,49,2049
12892,12892,34797CFFFF01C5BBAA897EA024781C27,11301,19,21,2,41,49,2099
12893,12893,34797CFFFF01C5BBAA897EA024781C27,40302,21,23,2,40,49,2049
12903,12903,B0CA59461CE535DA6C80DC6682EBEAFB,42271,0,6,6,40,47,2047
12904,12904,B0CA59461CE535DA6C80DC6682EBEAFB,40302,8,13,5,40,49,2049
12905,12905,B0CA59461CE535DA6C80DC6682EBEAFB,42271,15,16,1,40,47,2047
12906,12906,B0CA59461CE535DA6C80DC6682EBEAFB,11806,17,19,2,41,48,2098
12907,12907,B0CA59461CE535DA6C80DC6682EBEAFB,42271,19,23,4,40,47,2047
12908,12908,9F569681847AE1CB91DC5B95636EE88A,43021,0,2,2,16,43,843
12909,12909,9F569681847AE1CB91DC5B95636EE88A,19021,2,18,16,10,45,545
12910,12910,9F569681847AE1CB91DC5B95636EE88A,43021,21,22,1,16,43,843
12918,12918,4B5119258FB3482B746B53277561992F,12051,2,5,3,20,47,1047
12919,12919,4B5119258FB3482B746B53277561992F,12601,6,7,1,25,47,1297
12920,12920,4B5119258FB3482B746B53277561992F,12051,7,10,3,20,47,1047
12921,12921,4B5119258FB3482B746B53277561992F,12581,13,14,1,24,48,1248
12922,12922,4B5119258FB3482B746B53277561992F,12601,14,17,3,25,47,1297
12923,12923,4B5119258FB3482B746B53277561992F,12581,17,23,6,24,48,1248
12931,12931,A2FF2B3E007AEF697BBECF6D3F01B855,43021,4,6,2,16,43,843
12932,12932,A2FF2B3E007AEF697BBECF6D3F01B855,19021,6,8,2,10,45,545
12933,12933,A2FF2B3E007AEF697BBECF6D3F01B855,43021,8,13,5,16,43,843
12934,12934,A2FF2B3E007AEF697BBECF6D3F01B855,19021,14,16,2,10,45,545
12935,12935,A2FF2B3E007AEF697BBECF6D3F01B855,12641,18,20,2,10,43,543
12936,12936,A2FF2B3E007AEF697BBECF6D3F01B855,19021,21,22,1,10,45,545
12937,12937,B57FA6A577B54BB28114ABA28733D834,11061,0,7,7,29,48,1498
12938,12938,B57FA6A577B54BB28114ABA28733D834,42981,8,10,2,36,49,1849
12939,12939,B57FA6A577B54BB28114ABA28733D834,10681,11,12,1,30,48,1548
12940,12940,B57FA6A577B54BB28114ABA28733D834,10281,14,16,2,33,48,1698
12941,12941,B57FA6A577B54BB28114ABA28733D834,10681,18,19,1,30,48,1548
12942,12942,B57FA6A577B54BB28114ABA28733D834,42623,19,23,4,22,49,1149
12943,12943,D30D1A92B468035E0A9B032755CAA435,11781,0,12,12,38,49,1949
12944,12944,D30D1A92B468035E0A9B032755CAA435,11481,12,13,1,41,48,2098
12945,12945,D30D1A92B468035E0A9B032755CAA435,11151,17,19,2,30,48,1548
12953,12953,249945D8BC225A84B9C0C3C523B07C14,42381,0,13,13,39,41,1991
12954,12954,249945D8BC225A84B9C0C3C523B07C14,43451,15,17,2,37,40,1890
12955,12955,249945D8BC225A84B9C0C3C523B07C14,10911,21,23,2,39,46,1996
12959,12959,25A0E61F1DC4EDCA55BC31768CCB616A,13371,1,16,15,41,47,2097
12960,12960,25A0E61F1DC4EDCA55BC31768CCB616A,11201,18,20,2,35,49,1799
12961,12961,25A0E61F1DC4EDCA55BC31768CCB616A,11801,21,23,2,42,48,2148
12962,12962,753369D691B504B9F7186B2CDF290F06,12791,0,5,5,31,29,1579
12963,12963,753369D691B504B9F7186B2CDF290F06,15391,6,7,1,35,26,1776
12964,12964,753369D691B504B9F7186B2CDF290F06,12792,7,14,7,34,30,1730
12965,12965,753369D691B504B9F7186B2CDF290F06,15391,14,22,8,35,26,1776
12972,12972,6CC3FE89A8F1A15E71D203BFCADF8D3A,11701,0,7,7,43,48,2198
12973,12973,6CC3FE89A8F1A15E71D203BFCADF8D3A,10251,8,19,11,35,47,1797
12974,12974,6CC3FE89A8F1A15E71D203BFCADF8D3A,11701,21,22,1,43,48,2198
12978,12978,4C238BB7C5832FF7221019CFAA6E94A4,19024,0,8,8,9,45,495
12979,12979,4C238BB7C5832FF7221019CFAA6E94A4,19441,9,11,2,8,46,446
12980,12980,4C238BB7C5832FF7221019CFAA6E94A4,12021,14,16,2,37,49,1899
12981,12981,4C238BB7C5832FF7221019CFAA6E94A4,19024,18,23,5,9,45,495
12982,12982,CD087EF03F5E42C11EA6EA79A0BD17AC,11781,0,15,15,38,49,1949
12983,12983,CD087EF03F5E42C11EA6EA79A0BD17AC,11381,17,18,1,30,47,1547
12984,12984,CD087EF03F5E42C11EA6EA79A0BD17AC,10107,19,23,4,38,49,1949
12989,12989,A992065279A55CB166B571950C59E281,10191,0,10,10,40,48,2048
12990,12990,A992065279A55CB166B571950C59E281,11751,11,12,1,35,48,1798
12991,12991,A992065279A55CB166B571950C59E281,11021,16,23,7,36,49,1849
12995,12995,848C6C93E2EE69BB98A09FF629443AAA,11201,0,9,9,35,49,1799
12996,12996,848C6C93E2EE69BB98A09FF629443AAA,10771,13,14,1,41,46,2096
12997,12997,848C6C93E2EE69BB98A09FF629443AAA,13511,15,23,8,34,48,1748
13001,13001,7B001ACDE2062382019107DF0DCB7334,40841,0,8,8,33,49,1699
13002,13002,7B001ACDE2062382019107DF0DCB7334,42231,12,16,4,37,46,1896
13003,13003,7B001ACDE2062382019107DF0DCB7334,11211,17,23,6,34,49,1749
13008,13008,42B28AE3CCE12BA9A899758E7A189C34,11806,0,8,8,41,48,2098
13009,13009,42B28AE3CCE12BA9A899758E7A189C34,10121,10,12,2,36,49,1849
13010,13010,42B28AE3CCE12BA9A899758E7A189C34,11806,13,14,1,41,48,2098
13011,13011,42B28AE3CCE12BA9A899758E7A189C34,10121,15,16,1,36,49,1849
13012,13012,42B28AE3CCE12BA9A899758E7A189C34,11806,18,22,4,41,48,2098
13013,13013,BC71A128CC1D1FD204F1FA3A371EA53A,43021,0,6,6,16,43,843
13014,13014,BC71A128CC1D1FD204F1FA3A371EA53A,12921,8,16,8,9,41,491
13015,13015,BC71A128CC1D1FD204F1FA3A371EA53A,43021,19,22,3,16,43,843
13016,13016,39AF3644B5575CFA85818E74A5317361,13251,6,8,2,48,28,2428
13017,13017,39AF3644B5575CFA85818E74A5317361,15411,11,18,7,44,27,2227
13018,13018,39AF3644B5575CFA85818E74A5317361,13251,19,21,2,48,28,2428
13019,13019,39AF3644B5575CFA85818E74A5317361,15411,21,23,2,44,27,2227
13020,13020,1B550A18B0397F926248F9A2C7B0A9DE,42341,0,8,8,43,49,2199
13021,13021,1B550A18B0397F926248F9A2C7B0A9DE,11201,8,10,2,35,49,1799
13022,13022,1B550A18B0397F926248F9A2C7B0A9DE,11211,12,14,2,34,49,1749
13023,13023,1B550A18B0397F926248F9A2C7B0A9DE,43671,15,16,1,35,48,1798
13024,13024,1B550A18B0397F926248F9A2C7B0A9DE,42341,21,23,2,43,49,2199
13028,13028,9742F15B01F6B20FFF8B06E85DFC863A,19741,0,9,9,5,44,294
13029,13029,9742F15B01F6B20FFF8B06E85DFC863A,11381,11,18,7,30,47,1547
13030,13030,9742F15B01F6B20FFF8B06E85DFC863A,42291,20,21,1,29,48,1498
13041,13041,0E444D993B8E8F9A92F2EE4C5393F827,19114,0,10,10,7,43,393
13042,13042,0E444D993B8E8F9A92F2EE4C5393F827,11751,12,13,1,35,48,1798
13043,13043,0E444D993B8E8F9A92F2EE4C5393F827,19114,15,21,6,7,43,393
13053,13053,5A5B2CBA296E90D3798147AFE5312824,13741,0,7,7,37,49,1899
13054,13054,5A5B2CBA296E90D3798147AFE5312824,40637,10,11,1,36,47,1847
13055,13055,5A5B2CBA296E90D3798147AFE5312824,12481,12,14,2,37,49,1899
13056,13056,5A5B2CBA296E90D3798147AFE5312824,40637,15,17,2,36,47,1847
13057,13057,5A5B2CBA296E90D3798147AFE5312824,11324,19,21,2,31,46,1596
13058,13058,D65506EDDA59637632B53755416666C4,42583,1,6,5,40,48,2048
13059,13059,D65506EDDA59637632B53755416666C4,11914,7,9,2,37,48,1898
13060,13060,D65506EDDA59637632B53755416666C4,42583,12,15,3,40,48,2048
13061,13061,D65506EDDA59637632B53755416666C4,11914,15,18,3,37,48,1898
13062,13062,D65506EDDA59637632B53755416666C4,10191,20,21,1,40,48,2048
13067,13067,B9839CB042454210BC2C136EC5C01794,10841,1,14,13,37,47,1897
13068,13068,B9839CB042454210BC2C136EC5C01794,11641,18,20,2,22,49,1149
13069,13069,B9839CB042454210BC2C136EC5C01794,11231,21,23,2,37,49,1899
13073,13073,481E0074549879C8BF16A88D1586ADE0,42071,1,11,10,31,49,1599
13074,13074,481E0074549879C8BF16A88D1586ADE0,40341,13,15,2,23,49,1199
13075,13075,481E0074549879C8BF16A88D1586ADE0,10381,19,22,3,31,49,1599
13076,13076,2FCC231DE348255A3F9CDA8D77EEA7DC,12581,0,5,5,24,48,1248
13077,13077,2FCC231DE348255A3F9CDA8D77EEA7DC,12051,6,9,3,20,47,1047
13078,13078,2FCC231DE348255A3F9CDA8D77EEA7DC,12581,13,16,3,24,48,1248
13079,13079,2FCC231DE348255A3F9CDA8D77EEA7DC,12051,17,19,2,20,47,1047
13080,13080,2FCC231DE348255A3F9CDA8D77EEA7DC,12581,20,23,3,24,48,1248
13081,13081,3C5D029D57650D7A9CE83503042F1003,43011,0,2,2,40,42,2042
13082,13082,3C5D029D57650D7A9CE83503042F1003,11261,2,17,15,36,46,1846
13083,13083,3C5D029D57650D7A9CE83503042F1003,42864,20,21,1,38,44,1944
13090,13090,5F3681CA154176D9C587280037CBB99D,13561,0,8,8,37,49,1899
13091,13091,5F3681CA154176D9C587280037CBB99D,13094,11,13,2,21,42,1092
13092,13092,5F3681CA154176D9C587280037CBB99D,13091,13,16,3,20,42,1042
13093,13093,5F3681CA154176D9C587280037CBB99D,13561,20,23,3,37,49,1899
13098,13098,75D621E0C18697E4C8BF50C09B364A3D,16281,0,1,1,11,4,554
13099,13099,75D621E0C18697E4C8BF50C09B364A3D,15051,2,21,19,19,4,954
13100,13100,75D621E0C18697E4C8BF50C09B364A3D,16281,22,23,1,11,4,554
13108,13108,C2FBA65B3829E7C44694518847633282,11151,3,5,2,30,48,1548
13109,13109,C2FBA65B3829E7C44694518847633282,40302,7,16,9,40,49,2049
13110,13110,C2FBA65B3829E7C44694518847633282,11301,19,21,2,41,49,2099
13111,13111,C2FBA65B3829E7C44694518847633282,40302,21,22,1,40,49,2049
13112,13112,48D09EA1E123F030FD71CF37426D4799,12521,0,5,5,35,41,1791
13113,13113,48D09EA1E123F030FD71CF37426D4799,42151,6,13,7,35,45,1795
13114,13114,48D09EA1E123F030FD71CF37426D4799,43011,13,15,2,40,42,2042
13115,13115,48D09EA1E123F030FD71CF37426D4799,42151,15,21,6,35,45,1795
13116,13116,48D09EA1E123F030FD71CF37426D4799,43011,21,23,2,40,42,2042
13117,13117,7DDE2119A71FDAA78AE910A4980C3757,42161,0,14,14,36,47,1847
13118,13118,7DDE2119A71FDAA78AE910A4980C3757,12521,15,16,1,35,41,1791
13119,13119,7DDE2119A71FDAA78AE910A4980C3757,42161,19,21,2,36,47,1847
13124,13124,135EF939D99CED11694D71795A5772B0,19031,0,5,5,1,42,92
13125,13125,135EF939D99CED11694D71795A5772B0,12641,6,11,5,10,43,543
13126,13126,135EF939D99CED11694D71795A5772B0,19031,11,14,3,1,42,92
13127,13127,135EF939D99CED11694D71795A5772B0,12641,14,18,4,10,43,543
13128,13128,135EF939D99CED11694D71795A5772B0,19031,19,23,4,1,42,92
13155,13155,93C87ADE4FBD02048670A9DCD4C6ECEA,42864,0,5,5,38,44,1944
13156,13156,93C87ADE4FBD02048670A9DCD4C6ECEA,42861,9,10,1,37,44,1894
13157,13157,93C87ADE4FBD02048670A9DCD4C6ECEA,11261,11,12,1,36,46,1846
13158,13158,93C87ADE4FBD02048670A9DCD4C6ECEA,42864,12,13,1,38,44,1944
13159,13159,93C87ADE4FBD02048670A9DCD4C6ECEA,42861,16,21,5,37,44,1894
13160,13160,3AEA3CF422288C2FFB9C65FD7BE694C9,12921,5,6,1,9,41,491
13161,13161,3AEA3CF422288C2FFB9C65FD7BE694C9,19931,6,10,4,7,43,393
13162,13162,3AEA3CF422288C2FFB9C65FD7BE694C9,12921,11,15,4,9,41,491
13163,13163,3AEA3CF422288C2FFB9C65FD7BE694C9,13381,19,21,2,39,47,1997
13164,13164,80E764BD1AB344D5249D2A4A0F5F0950,11021,0,9,9,36,49,1849
13165,13165,80E764BD1AB344D5249D2A4A0F5F0950,10821,12,13,1,40,47,2047
13166,13166,80E764BD1AB344D5249D2A4A0F5F0950,16451,18,22,4,5,5,255
13167,13167,D96201B04F49DA8FE5B344343C2EC845,12601,0,2,2,25,47,1297
13168,13168,D96201B04F49DA8FE5B344343C2EC845,10501,2,4,2,22,46,1146
13169,13169,D96201B04F49DA8FE5B344343C2EC845,12601,6,7,1,25,47,1297
13170,13170,D96201B04F49DA8FE5B344343C2EC845,11861,8,15,7,32,47,1647
13171,13171,D96201B04F49DA8FE5B344343C2EC845,42151,17,23,6,35,45,1795
13172,13172,F335B5DE4FDA1E666E8A07D886D60D86,42261,0,8,8,25,49,1299
13173,13173,F335B5DE4FDA1E666E8A07D886D60D86,13841,9,10,1,40,46,2046
13174,13174,F335B5DE4FDA1E666E8A07D886D60D86,42261,11,23,12,25,49,1299
13175,13175,7B27DF400F344F6F46338A9F907AAD49,43021,0,1,1,16,43,843
13176,13176,7B27DF400F344F6F46338A9F907AAD49,19021,4,6,2,10,45,545
13177,13177,7B27DF400F344F6F46338A9F907AAD49,12641,9,15,6,10,43,543
13178,13178,7B27DF400F344F6F46338A9F907AAD49,19021,18,21,3,10,45,545
13179,13179,9397083C419903E30A62F5C06D299D5C,13071,3,7,4,41,41,2091
13180,13180,9397083C419903E30A62F5C06D299D5C,43451,8,17,9,37,40,1890
13181,13181,9397083C419903E30A62F5C06D299D5C,13071,18,22,4,41,41,2091
13182,13182,99C7ECB8A04AED18341CF71575998F26,10811,0,7,7,38,46,1946
13183,13183,99C7ECB8A04AED18341CF71575998F26,42091,8,11,3,43,46,2196
13184,13184,99C7ECB8A04AED18341CF71575998F26,10811,12,23,11,38,46,1946
13191,13191,AAC98D8EB5664A9B5DE56F266CB31991,15143,3,7,4,18,7,907
13192,13192,AAC98D8EB5664A9B5DE56F266CB31991,16281,7,12,5,11,4,554
13193,13193,AAC98D8EB5664A9B5DE56F266CB31991,15143,12,18,6,18,7,907
13194,13194,AAC98D8EB5664A9B5DE56F266CB31991,16281,20,21,1,11,4,554
13195,13195,AAC98D8EB5664A9B5DE56F266CB31991,15143,22,23,1,18,7,907
13196,13196,942A242C54C5AF79C66351D8C7F17676,42691,0,7,7,24,48,1248
13197,13197,942A242C54C5AF79C66351D8C7F17676,43161,8,18,10,35,47,1797
13198,13198,942A242C54C5AF79C66351D8C7F17676,12971,20,22,2,32,48,1648
13205,13205,C4DA25473510C59AF311C46DB13EDB15,10971,0,7,7,35,47,1797
13206,13206,C4DA25473510C59AF311C46DB13EDB15,11211,10,11,1,34,49,1749
13207,13207,C4DA25473510C59AF311C46DB13EDB15,43731,13,14,1,34,47,1747
13208,13208,C4DA25473510C59AF311C46DB13EDB15,13511,15,16,1,34,48,1748
13209,13209,C4DA25473510C59AF311C46DB13EDB15,10971,20,21,1,35,47,1797
13210,13210,29C5C7944A565741A7D5BD5CE10D2802,11261,1,10,9,36,46,1846
13211,13211,29C5C7944A565741A7D5BD5CE10D2802,42511,12,13,1,37,47,1897
13212,13212,29C5C7944A565741A7D5BD5CE10D2802,11941,14,15,1,37,46,1896
13213,13213,29C5C7944A565741A7D5BD5CE10D2802,42501,17,18,1,28,47,1447
13218,13218,BCCA36AC6DE92B5D284204C1D312B82A,42161,0,7,7,36,47,1847
13219,13219,BCCA36AC6DE92B5D284204C1D312B82A,10401,9,12,3,33,49,1699
13220,13220,BCCA36AC6DE92B5D284204C1D312B82A,42801,12,15,3,40,49,2049
13221,13221,BCCA36AC6DE92B5D284204C1D312B82A,43161,19,23,4,35,47,1797
13222,13222,4568F4CB3839A063AA85BE5AD656F1DE,13351,1,13,12,48,48,2448
13223,13223,4568F4CB3839A063AA85BE5AD656F1DE,11351,15,18,3,36,48,1848
13224,13224,4568F4CB3839A063AA85BE5AD656F1DE,11201,21,22,1,35,49,1799
13225,13225,406EDA02B30F2BAE6E77943EDDABB841,42461,0,8,8,45,47,2297
13226,13226,406EDA02B30F2BAE6E77943EDDABB841,43061,11,17,6,43,46,2196
13227,13227,406EDA02B30F2BAE6E77943EDDABB841,11201,19,20,1,35,49,1799
13228,13228,406EDA02B30F2BAE6E77943EDDABB841,43061,21,23,2,43,46,2196
13229,13229,46624C7A7A05E81084BABC40FE8F937C,13314,0,12,12,31,39,1589
13230,13230,46624C7A7A05E81084BABC40FE8F937C,12521,13,17,4,35,41,1791
13231,13231,46624C7A7A05E81084BABC40FE8F937C,13314,17,23,6,31,39,1589
13232,13232,10DC127CF632872CB720A257DA7279C0,10611,0,7,7,32,48,1648
13233,13233,10DC127CF632872CB720A257DA7279C0,11861,12,14,2,32,47,1647
13234,13234,10DC127CF632872CB720A257DA7279C0,10611,14,15,1,32,48,1648
13235,13235,10DC127CF632872CB720A257DA7279C0,40341,17,19,2,23,49,1199
13236,13236,10DC127CF632872CB720A257DA7279C0,11061,19,20,1,29,48,1498
13237,13237,10DC127CF632872CB720A257DA7279C0,10611,21,23,2,32,48,1648
13251,13251,7F0F7E01EE512C1A933F7133254355CA,43021,0,5,5,16,43,843
13252,13252,7F0F7E01EE512C1A933F7133254355CA,12921,6,14,8,9,41,491
13253,13253,7F0F7E01EE512C1A933F7133254355CA,12641,14,18,4,10,43,543
13254,13254,7F0F7E01EE512C1A933F7133254355CA,43021,19,23,4,16,43,843
13255,13255,FE72309A49FBEB6B76C0E42028E74707,19441,2,3,1,8,46,446
13256,13256,FE72309A49FBEB6B76C0E42028E74707,11571,5,10,5,13,46,696
13257,13257,FE72309A49FBEB6B76C0E42028E74707,42041,11,12,1,10,47,547
13258,13258,FE72309A49FBEB6B76C0E42028E74707,19441,14,23,9,8,46,446
13259,13259,70884D19952CA4B432FAA84B8636A296,42601,5,6,1,44,48,2248
13260,13260,70884D19952CA4B432FAA84B8636A296,13351,7,11,4,48,48,2448
13261,13261,70884D19952CA4B432FAA84B8636A296,42601,13,14,1,44,48,2248
13262,13262,70884D19952CA4B432FAA84B8636A296,13351,14,17,3,48,48,2448
13263,13263,70884D19952CA4B432FAA84B8636A296,42601,18,23,5,44,48,2248
13270,13270,B16AADC70667F1407A8020F9E0E0F89A,11914,0,5,5,37,48,1898
13271,13271,B16AADC70667F1407A8020F9E0E0F89A,43761,6,17,11,32,47,1647
13272,13272,B16AADC70667F1407A8020F9E0E0F89A,11921,17,19,2,38,48,1948
13273,13273,B16AADC70667F1407A8020F9E0E0F89A,11074,19,21,2,37,47,1897
13274,13274,B16AADC70667F1407A8020F9E0E0F89A,11921,21,23,2,38,48,1948
13275,13275,DFE0075BA441F09CC854C6FA18C2E9B5,11791,0,9,9,38,49,1949
13276,13276,DFE0075BA441F09CC854C6FA18C2E9B5,10151,13,16,3,34,47,1747
13277,13277,DFE0075BA441F09CC854C6FA18C2E9B5,11791,19,23,4,38,49,1949
13284,13284,4C8606088BA0309988602C32F6FDE0FF,42201,0,8,8,43,46,2196
13285,13285,4C8606088BA0309988602C32F6FDE0FF,10631,11,12,1,28,46,1446
13286,13286,4C8606088BA0309988602C32F6FDE0FF,10634,13,15,2,27,45,1395
13287,13287,4C8606088BA0309988602C32F6FDE0FF,11081,17,19,2,35,46,1796
13288,13288,4C8606088BA0309988602C32F6FDE0FF,10611,19,20,1,32,48,1648
13289,13289,4C8606088BA0309988602C32F6FDE0FF,42201,21,23,2,43,46,2196
13290,13290,F1249E9F0C0E4CFC8DF3A999C283E2E8,42791,0,7,7,35,45,1795
13291,13291,F1249E9F0C0E4CFC8DF3A999C283E2E8,10634,10,11,1,27,45,1395
13292,13292,F1249E9F0C0E4CFC8DF3A999C283E2E8,10351,14,16,2,28,45,1445
13293,13293,F1249E9F0C0E4CFC8DF3A999C283E2E8,42791,20,23,3,35,45,1795
13294,13294,5C72B0A7D2D9BEA9D0832F659C47AFA7,11021,3,7,4,36,49,1849
13295,13295,5C72B0A7D2D9BEA9D0832F659C47AFA7,42471,8,9,1,35,49,1799
13296,13296,5C72B0A7D2D9BEA9D0832F659C47AFA7,11591,10,12,2,36,49,1849
13297,13297,5C72B0A7D2D9BEA9D0832F659C47AFA7,42471,14,20,6,35,49,1799
13298,13298,5C72B0A7D2D9BEA9D0832F659C47AFA7,11591,21,23,2,36,49,1849
13308,13308,D9026A3CE10A3841EFEE0C49DAE389C6,12641,0,5,5,10,43,543
13309,13309,D9026A3CE10A3841EFEE0C49DAE389C6,19114,7,9,2,7,43,393
13310,13310,D9026A3CE10A3841EFEE0C49DAE389C6,12641,11,12,1,10,43,543
13311,13311,D9026A3CE10A3841EFEE0C49DAE389C6,19114,15,16,1,7,43,393
13312,13312,D9026A3CE10A3841EFEE0C49DAE389C6,12641,19,21,2,10,43,543
13316,13316,BD6657F79F4CDA54434187B4734865CB,11061,1,12,11,29,48,1498
13317,13317,BD6657F79F4CDA54434187B4734865CB,12121,12,14,2,29,47,1497
13318,13318,BD6657F79F4CDA54434187B4734865CB,40341,15,18,3,23,49,1199
13319,13319,BF3354E7653978B437BDBF5412A04932,12871,7,12,5,22,33,1133
13320,13320,BF3354E7653978B437BDBF5412A04932,19281,15,17,2,16,32,832
13321,13321,BF3354E7653978B437BDBF5412A04932,12871,18,21,3,22,33,1133
13334,13334,C7DA09D84BB6D5A3ABEAD976C8C0731E,42861,0,5,5,37,44,1894
13335,13335,C7DA09D84BB6D5A3ABEAD976C8C0731E,11261,6,8,2,36,46,1846
13336,13336,C7DA09D84BB6D5A3ABEAD976C8C0731E,42861,12,13,1,37,44,1894
13337,13337,C7DA09D84BB6D5A3ABEAD976C8C0731E,11261,16,17,1,36,46,1846
13338,13338,C7DA09D84BB6D5A3ABEAD976C8C0731E,42861,19,23,4,37,44,1894
13339,13339,81E9C3858C44D7DA57E9FCCB87C1B34F,10691,0,8,8,33,48,1698
13340,13340,81E9C3858C44D7DA57E9FCCB87C1B34F,10251,9,15,6,35,47,1797
13341,13341,81E9C3858C44D7DA57E9FCCB87C1B34F,11231,18,20,2,37,49,1899
13342,13342,92E340B82C56A45F91D53CD2B709557E,11914,1,2,1,37,48,1898
13343,13343,92E340B82C56A45F91D53CD2B709557E,42581,2,9,7,38,48,1948
13344,13344,92E340B82C56A45F91D53CD2B709557E,11914,10,11,1,37,48,1898
13345,13345,92E340B82C56A45F91D53CD2B709557E,42581,12,16,4,38,48,1948
13346,13346,92E340B82C56A45F91D53CD2B709557E,12514,19,20,1,38,47,1947
13347,13347,92E340B82C56A45F91D53CD2B709557E,42581,22,23,1,38,48,1948
13352,13352,DE562E077213566DA78895C5D4449486,10411,0,8,8,36,48,1848
13353,13353,DE562E077213566DA78895C5D4449486,12921,14,16,2,9,41,491
13354,13354,DE562E077213566DA78895C5D4449486,10411,20,23,3,36,48,1848
13355,13355,E03B05F0FB01917EEB19D58711FDBCBD,13071,1,7,6,41,41,2091
13356,13356,E03B05F0FB01917EEB19D58711FDBCBD,43101,7,9,2,46,40,2340
13357,13357,E03B05F0FB01917EEB19D58711FDBCBD,13071,14,17,3,41,41,2091
13358,13358,E03B05F0FB01917EEB19D58711FDBCBD,42331,21,23,2,39,46,1996
13359,13359,B07F9654999A27B565B093B7A4D6A968,11481,0,8,8,41,48,2098
13360,13360,B07F9654999A27B565B093B7A4D6A968,11021,12,16,4,36,49,1849
13361,13361,B07F9654999A27B565B093B7A4D6A968,11481,16,23,7,41,48,2098
13362,13362,4939079DBC41D72C03B48C02C72AD37E,43021,0,5,5,16,43,843
13363,13363,4939079DBC41D72C03B48C02C72AD37E,12921,7,10,3,9,41,491
13364,13364,4939079DBC41D72C03B48C02C72AD37E,43021,12,18,6,16,43,843
13365,13365,004D26DDA49F4E295E56D0D4EFA58427,16071,0,8,8,3,3,153
13366,13366,004D26DDA49F4E295E56D0D4EFA58427,42941,12,13,1,37,47,1897
13367,13367,004D26DDA49F4E295E56D0D4EFA58427,10661,16,17,1,37,49,1899
13368,13368,004D26DDA49F4E295E56D0D4EFA58427,16071,19,22,3,3,3,153
13369,13369,2C3A1C890B30FB06A95DD4A9EF742265,19801,0,5,5,19,26,976
13370,13370,2C3A1C890B30FB06A95DD4A9EF742265,43121,7,11,4,25,27,1277
13371,13371,2C3A1C890B30FB06A95DD4A9EF742265,19801,12,13,1,19,26,976
13372,13372,2C3A1C890B30FB06A95DD4A9EF742265,43121,14,21,7,25,27,1277
13376,13376,4553DB82DB16D1EEF0F01F3452B31772,11431,10,12,2,29,47,1497
13377,13377,4553DB82DB16D1EEF0F01F3452B31772,43731,13,15,2,34,47,1747
13378,13378,4553DB82DB16D1EEF0F01F3452B31772,43361,19,22,3,38,48,1948
13379,13379,DBE56CF804EFF98F06EBBF480586FC01,43021,0,5,5,16,43,843
13380,13380,DBE56CF804EFF98F06EBBF480586FC01,12921,7,8,1,9,41,491
13381,13381,DBE56CF804EFF98F06EBBF480586FC01,43021,10,13,3,16,43,843
13382,13382,DBE56CF804EFF98F06EBBF480586FC01,12921,18,19,1,9,41,491
13383,13383,7C6533C0224770EA8D8739703C562233,42471,0,8,8,35,49,1799
13384,13384,7C6533C0224770EA8D8739703C562233,42491,8,9,1,32,46,1646
13385,13385,7C6533C0224770EA8D8739703C562233,10295,10,12,2,30,47,1547
13386,13386,7C6533C0224770EA8D8739703C562233,42471,12,13,1,35,49,1799
13387,13387,7C6533C0224770EA8D8739703C562233,10295,14,19,5,30,47,1547
13398,13398,E311A49FD79CE1E67702DBA9B7887B92,12641,0,4,4,10,43,543
13399,13399,E311A49FD79CE1E67702DBA9B7887B92,19021,6,9,3,10,45,545
13400,13400,E311A49FD79CE1E67702DBA9B7887B92,12641,12,13,1,10,43,543
13401,13401,E311A49FD79CE1E67702DBA9B7887B92,19021,13,17,4,10,45,545
13402,13402,E311A49FD79CE1E67702DBA9B7887B92,12641,19,23,4,10,43,543
13403,13403,C1BC146C1B557BAE93465B186B08C3FA,42151,0,11,11,35,45,1795
13404,13404,C1BC146C1B557BAE93465B186B08C3FA,12661,14,16,2,32,45,1645
13405,13405,C1BC146C1B557BAE93465B186B08C3FA,42151,17,18,1,35,45,1795
13406,13406,C1BC146C1B557BAE93465B186B08C3FA,12311,19,20,1,30,44,1544
13407,13407,C1BC146C1B557BAE93465B186B08C3FA,12661,20,21,1,32,45,1645
13414,13414,ABB6F382C5C4E9BFCDB8D523D5E35622,42971,0,7,7,43,49,2199
13415,13415,ABB6F382C5C4E9BFCDB8D523D5E35622,11201,8,12,4,35,49,1799
13416,13416,ABB6F382C5C4E9BFCDB8D523D5E35622,42971,18,21,3,43,49,2199
13417,13417,ABB6F382C5C4E9BFCDB8D523D5E35622,13561,22,23,1,37,49,1899
13421,13421,59404EA989C80195134E154DBC843CAE,11151,4,5,1,30,48,1548
13422,13422,59404EA989C80195134E154DBC843CAE,40302,7,16,9,40,49,2049
13423,13423,59404EA989C80195134E154DBC843CAE,11301,19,21,2,41,49,2099
13428,13428,BC26B55CAB9087496A5FB61484951E63,13511,0,7,7,34,48,1748
13429,13429,BC26B55CAB9087496A5FB61484951E63,19441,8,16,8,8,46,446
13430,13430,BC26B55CAB9087496A5FB61484951E63,10881,21,23,2,34,48,1748
13441,13441,8B162D826614AE6B0D3DB5A304485836,12401,0,6,6,39,49,1999
13442,13442,8B162D826614AE6B0D3DB5A304485836,11914,8,10,2,37,48,1898
13443,13443,8B162D826614AE6B0D3DB5A304485836,42581,10,12,2,38,48,1948
13444,13444,8B162D826614AE6B0D3DB5A304485836,11771,12,15,3,39,49,1999
13445,13445,8B162D826614AE6B0D3DB5A304485836,10191,15,23,8,40,48,2048
13446,13446,E365DBCC78B916EAB2D02BB0A543AE87,11061,0,6,6,29,48,1498
13447,13447,E365DBCC78B916EAB2D02BB0A543AE87,41382,10,17,7,38,49,1949
13448,13448,E365DBCC78B916EAB2D02BB0A543AE87,10341,20,22,2,31,47,1597
13458,13458,EE45E57CC8EC74B54CD8BDAA9E2D38EE,12021,0,1,1,37,49,1899
13459,13459,EE45E57CC8EC74B54CD8BDAA9E2D38EE,13381,3,10,7,39,47,1997
13460,13460,EE45E57CC8EC74B54CD8BDAA9E2D38EE,11074,13,14,1,37,47,1897
13461,13461,EE45E57CC8EC74B54CD8BDAA9E2D38EE,42221,14,15,1,38,48,1948
13462,13462,EE45E57CC8EC74B54CD8BDAA9E2D38EE,15051,18,23,5,19,4,954
13466,13466,5408DC5B0AFBD23C3FA2E4CCFD3A9C81,42633,0,5,5,42,46,2146
13467,13467,5408DC5B0AFBD23C3FA2E4CCFD3A9C81,11261,7,10,3,36,46,1846
13468,13468,5408DC5B0AFBD23C3FA2E4CCFD3A9C81,42861,14,17,3,37,44,1894
13469,13469,5408DC5B0AFBD23C3FA2E4CCFD3A9C81,42351,19,22,3,38,45,1945
13470,13470,E6A8B36EA819F0A64C66840FF99B9AB3,42581,0,6,6,38,48,1948
13471,13471,E6A8B36EA819F0A64C66840FF99B9AB3,11914,7,9,2,37,48,1898
13472,13472,E6A8B36EA819F0A64C66840FF99B9AB3,42581,12,14,2,38,48,1948
13473,13473,E6A8B36EA819F0A64C66840FF99B9AB3,11914,14,16,2,37,48,1898
13474,13474,E6A8B36EA819F0A64C66840FF99B9AB3,42581,16,17,1,38,48,1948
13475,13475,E6A8B36EA819F0A64C66840FF99B9AB3,11914,18,20,2,37,48,1898
13479,13479,A0ABB6B6CBBF7812210D9E6FA5915038,12641,5,6,1,10,43,543
13480,13480,A0ABB6B6CBBF7812210D9E6FA5915038,12921,11,12,1,9,41,491
13481,13481,A0ABB6B6CBBF7812210D9E6FA5915038,19181,14,18,4,8,40,440
13482,13482,A0ABB6B6CBBF7812210D9E6FA5915038,12921,19,23,4,9,41,491
13483,13483,C6FF0C0C1DEE38711679574CEC9C3876,42501,0,7,7,28,47,1447
13484,13484,C6FF0C0C1DEE38711679574CEC9C3876,10351,9,10,1,28,45,1445
13485,13485,C6FF0C0C1DEE38711679574CEC9C3876,12601,11,12,1,25,47,1297
13486,13486,C6FF0C0C1DEE38711679574CEC9C3876,10351,15,17,2,28,45,1445
13487,13487,C6FF0C0C1DEE38711679574CEC9C3876,42501,20,21,1,28,47,1447
13488,13488,FBFB039BFE202B4D733B8197A5DE9AA1,43751,0,5,5,19,48,998
13489,13489,FBFB039BFE202B4D733B8197A5DE9AA1,12051,7,10,3,20,47,1047
13490,13490,FBFB039BFE202B4D733B8197A5DE9AA1,12581,12,18,6,24,48,1248
13491,13491,FBFB039BFE202B4D733B8197A5DE9AA1,43751,18,20,2,19,48,998
13495,13495,370BEBFAF0F07D0E48A05EAAA57C2ED7,42141,0,6,6,32,47,1647
13496,13496,370BEBFAF0F07D0E48A05EAAA57C2ED7,10634,9,19,10,27,45,1395
13497,13497,370BEBFAF0F07D0E48A05EAAA57C2ED7,11861,21,22,1,32,47,1647
13506,13506,DF9D2D20D481407020A94CC51F145932,19441,4,7,3,8,46,446
13507,13507,DF9D2D20D481407020A94CC51F145932,11571,9,11,2,13,46,696
13508,13508,DF9D2D20D481407020A94CC51F145932,42041,15,17,2,10,47,547
13509,13509,DF9D2D20D481407020A94CC51F145932,19441,18,19,1,8,46,446
13510,13510,DF9D2D20D481407020A94CC51F145932,11571,22,23,1,13,46,696
13518,13518,EC861FE21AFD755213652562865FFBF9,43101,0,17,17,46,40,2340
13519,13519,EC861FE21AFD755213652562865FFBF9,13071,19,21,2,41,41,2091
13520,13520,EC861FE21AFD755213652562865FFBF9,43101,21,22,1,46,40,2340
13524,13524,4C4B9606DA322AB7E5344DC9E4374DA1,43151,0,4,4,40,49,2049
13525,13525,4C4B9606DA322AB7E5344DC9E4374DA1,43731,7,12,5,34,47,1747
13526,13526,4C4B9606DA322AB7E5344DC9E4374DA1,43191,13,19,6,40,49,2049
13527,13527,4C4B9606DA322AB7E5344DC9E4374DA1,40833,20,22,2,41,47,2097
13528,13528,A9FAA4B4C51A5D14416D1899F40B6E9A,19801,0,9,9,19,26,976
13529,13529,A9FAA4B4C51A5D14416D1899F40B6E9A,13481,13,16,3,26,31,1331
13530,13530,A9FAA4B4C51A5D14416D1899F40B6E9A,19801,16,19,3,19,26,976
13531,13531,A9FAA4B4C51A5D14416D1899F40B6E9A,13481,20,22,2,26,31,1331
13539,13539,3E2728364EE0F8914C7020C6A1917CB0,11201,0,1,1,35,49,1799
13540,13540,3E2728364EE0F8914C7020C6A1917CB0,42161,1,14,13,36,47,1847
13541,13541,3E2728364EE0F8914C7020C6A1917CB0,43731,18,20,2,34,47,1747
13542,13542,3E2728364EE0F8914C7020C6A1917CB0,42161,20,22,2,36,47,1847
13543,13543,3E2728364EE0F8914C7020C6A1917CB0,10971,22,23,1,35,47,1797
13547,13547,5E020EB6BDF7543069C6DD3EF85E9818,42941,0,7,7,37,47,1897
13548,13548,5E020EB6BDF7543069C6DD3EF85E9818,42161,7,19,12,36,47,1847
13549,13549,5E020EB6BDF7543069C6DD3EF85E9818,11861,19,21,2,32,47,1647
13554,13554,C16911B04E69B2086DAE9402EB30D376,10381,0,14,14,31,49,1599
13555,13555,C16911B04E69B2086DAE9402EB30D376,11751,16,17,1,35,48,1798
13556,13556,C16911B04E69B2086DAE9402EB30D376,11461,18,21,3,37,49,1899
13557,13557,734BE21864A3611A04F28278A72C8D0B,42151,0,5,5,35,45,1795
13558,13558,734BE21864A3611A04F28278A72C8D0B,11261,6,9,3,36,46,1846
13559,13559,734BE21864A3611A04F28278A72C8D0B,42861,12,14,2,37,44,1894
13560,13560,734BE21864A3611A04F28278A72C8D0B,13791,15,19,4,42,47,2147
13561,13561,734BE21864A3611A04F28278A72C8D0B,42151,19,21,2,35,45,1795
13562,13562,8B6448FD7DB9F8E2F8F73AFDDD5BFD38,43021,0,5,5,16,43,843
13563,13563,8B6448FD7DB9F8E2F8F73AFDDD5BFD38,12921,9,11,2,9,41,491
13564,13564,8B6448FD7DB9F8E2F8F73AFDDD5BFD38,43021,13,15,2,16,43,843
13565,13565,8B6448FD7DB9F8E2F8F73AFDDD5BFD38,12641,16,17,1,10,43,543
13566,13566,8B6448FD7DB9F8E2F8F73AFDDD5BFD38,43021,21,23,2,16,43,843
13567,13567,1A7FF5DB1B81FEDB0BCD61CF65662173,11921,0,5,5,38,48,1948
13568,13568,1A7FF5DB1B81FEDB0BCD61CF65662173,11074,6,9,3,37,47,1897
13569,13569,1A7FF5DB1B81FEDB0BCD61CF65662173,11921,9,11,2,38,48,1948
13570,13570,1A7FF5DB1B81FEDB0BCD61CF65662173,43041,12,13,1,41,46,2096
13571,13571,1A7FF5DB1B81FEDB0BCD61CF65662173,11074,14,17,3,37,47,1897
13572,13572,1A7FF5DB1B81FEDB0BCD61CF65662173,11921,17,19,2,38,48,1948
13573,13573,1A7FF5DB1B81FEDB0BCD61CF65662173,11351,19,22,3,36,48,1848
13574,13574,8ACC50A8C55036CCB5F5CED9121C61C8,12791,0,5,5,31,29,1579
13575,13575,8ACC50A8C55036CCB5F5CED9121C61C8,15191,7,8,1,36,27,1827
13576,13576,8ACC50A8C55036CCB5F5CED9121C61C8,12791,9,11,2,31,29,1579
13577,13577,8ACC50A8C55036CCB5F5CED9121C61C8,12792,13,14,1,34,30,1730
13578,13578,8ACC50A8C55036CCB5F5CED9121C61C8,15191,14,16,2,36,27,1827
13579,13579,8ACC50A8C55036CCB5F5CED9121C61C8,12791,19,21,2,31,29,1579
13580,13580,64C897065E9EDCA8A69F38A94EFB9055,10151,0,5,5,34,47,1747
13581,13581,64C897065E9EDCA8A69F38A94EFB9055,13711,6,15,9,38,46,1946
13582,13582,64C897065E9EDCA8A69F38A94EFB9055,42941,18,20,2,37,47,1897
13583,13583,64C897065E9EDCA8A69F38A94EFB9055,13101,21,22,1,40,47,2047
13587,13587,CE29EB37C112E7F535813A697DFC251A,43751,0,6,6,19,48,998
13588,13588,CE29EB37C112E7F535813A697DFC251A,12581,7,8,1,24,48,1248
13589,13589,CE29EB37C112E7F535813A697DFC251A,43751,12,23,11,19,48,998
13590,13590,5C8BC65FBEC997ECEE79F768FED142E3,10491,0,14,14,33,48,1698
13591,13591,5C8BC65FBEC997ECEE79F768FED142E3,13561,17,19,2,37,49,1899
13592,13592,5C8BC65FBEC997ECEE79F768FED142E3,12381,22,23,1,32,48,1648
13597,13597,3685D6C71438FECB08DB0F37510D88D0,12514,0,7,7,38,47,1947
13598,13598,3685D6C71438FECB08DB0F37510D88D0,40271,11,14,3,35,49,1799
13599,13599,3685D6C71438FECB08DB0F37510D88D0,10841,14,16,2,37,47,1897
13600,13600,3685D6C71438FECB08DB0F37510D88D0,42961,19,21,2,35,49,1799
13601,13601,30262A94D4F59A9D0C4A06975DD2A4EF,19021,8,16,8,10,45,545
13602,13602,30262A94D4F59A9D0C4A06975DD2A4EF,19114,19,20,1,7,43,393
13603,13603,30262A94D4F59A9D0C4A06975DD2A4EF,11151,21,22,1,30,48,1548
13604,13604,A845F5E6E274947D69D978D433D48E69,11914,0,8,8,37,48,1898
13605,13605,A845F5E6E274947D69D978D433D48E69,12601,11,12,1,25,47,1297
13606,13606,A845F5E6E274947D69D978D433D48E69,11914,16,19,3,37,48,1898
13607,13607,A845F5E6E274947D69D978D433D48E69,10661,19,23,4,37,49,1899
13608,13608,B354D45F8A0C0C2D18A14C5F2B89CD9E,40891,0,1,1,37,47,1897
13609,13609,B354D45F8A0C0C2D18A14C5F2B89CD9E,43481,1,2,1,39,48,1998
13610,13610,B354D45F8A0C0C2D18A14C5F2B89CD9E,10841,2,9,7,37,47,1897
13611,13611,B354D45F8A0C0C2D18A14C5F2B89CD9E,13121,18,19,1,38,46,1946
13612,13612,B354D45F8A0C0C2D18A14C5F2B89CD9E,10841,20,23,3,37,47,1897
13613,13613,1E4ADDBFBD1C3EEA7DB4E1CBF005793C,40445,0,9,9,30,48,1548
13614,13614,1E4ADDBFBD1C3EEA7DB4E1CBF005793C,10921,13,17,4,43,48,2198
13615,13615,1E4ADDBFBD1C3EEA7DB4E1CBF005793C,40445,18,23,5,30,48,1548
13616,13616,40A3F567657A043546A2ED7A5DC91A85,15401,0,1,1,39,25,1975
13617,13617,40A3F567657A043546A2ED7A5DC91A85,12792,4,5,1,34,30,1730
13618,13618,40A3F567657A043546A2ED7A5DC91A85,15401,5,12,7,39,25,1975
13619,13619,40A3F567657A043546A2ED7A5DC91A85,12792,14,20,6,34,30,1730
13620,13620,40A3F567657A043546A2ED7A5DC91A85,15671,21,23,2,37,26,1876
13621,13621,329011D78CCD407A57D7741FD67F5153,10301,0,7,7,31,45,1595
13622,13622,329011D78CCD407A57D7741FD67F5153,11834,8,13,5,32,45,1645
13623,13623,329011D78CCD407A57D7741FD67F5153,10841,14,15,1,37,47,1897
13624,13624,329011D78CCD407A57D7741FD67F5153,11834,17,18,1,32,45,1645
13625,13625,78A4AA9407E763ED8D1652A4AFF74DAE,12921,0,1,1,9,41,491
13626,13626,78A4AA9407E763ED8D1652A4AFF74DAE,19114,1,8,7,7,43,393
13627,13627,78A4AA9407E763ED8D1652A4AFF74DAE,19021,8,10,2,10,45,545
13628,13628,78A4AA9407E763ED8D1652A4AFF74DAE,12641,10,21,11,10,43,543
13629,13629,78A4AA9407E763ED8D1652A4AFF74DAE,19114,22,23,1,7,43,393
13630,13630,CB6CE8B284764CB65EC4187E6FE5A3FF,43021,0,14,14,16,43,843
13631,13631,CB6CE8B284764CB65EC4187E6FE5A3FF,19021,14,19,5,10,45,545
13632,13632,CB6CE8B284764CB65EC4187E6FE5A3FF,11571,20,22,2,13,46,696
13633,13633,A6BBFE7886A6BFC52F86E58BBD2C0899,12871,0,7,7,22,33,1133
13634,13634,A6BBFE7886A6BFC52F86E58BBD2C0899,19281,8,10,2,16,32,832
13635,13635,A6BBFE7886A6BFC52F86E58BBD2C0899,16071,14,16,2,3,3,153
13636,13636,A6BBFE7886A6BFC52F86E58BBD2C0899,19281,18,20,2,16,32,832
13637,13637,BDFFDDBB64972F17B4F0F1D72B49314B,11151,4,5,1,30,48,1548
13638,13638,BDFFDDBB64972F17B4F0F1D72B49314B,40302,7,8,1,40,49,2049
13639,13639,BDFFDDBB64972F17B4F0F1D72B49314B,40341,11,12,1,23,49,1199
13640,13640,BDFFDDBB64972F17B4F0F1D72B49314B,40302,13,16,3,40,49,2049
13641,13641,BDFFDDBB64972F17B4F0F1D72B49314B,11301,19,23,4,41,49,2099
13645,13645,9CBF9B7BBDA02761C2FCA54EEB069B75,42511,0,14,14,37,47,1897
13646,13646,9CBF9B7BBDA02761C2FCA54EEB069B75,42523,14,16,2,31,47,1597
13647,13647,9CBF9B7BBDA02761C2FCA54EEB069B75,40801,18,23,5,43,46,2196
13648,13648,C3B6C2036FA95E9BFE91FAC8F16BA170,42981,0,9,9,36,49,1849
13649,13649,C3B6C2036FA95E9BFE91FAC8F16BA170,40341,11,14,3,23,49,1199
13650,13650,C3B6C2036FA95E9BFE91FAC8F16BA170,10121,14,23,9,36,49,1849
13658,13658,2DC192DC303083B8FEFB2CD2D1161047,42461,0,7,7,45,47,2297
13659,13659,2DC192DC303083B8FEFB2CD2D1161047,42201,7,9,2,43,46,2196
13660,13660,2DC192DC303083B8FEFB2CD2D1161047,42461,10,11,1,45,47,2297
13661,13661,2DC192DC303083B8FEFB2CD2D1161047,42201,13,15,2,43,46,2196
13662,13662,2DC192DC303083B8FEFB2CD2D1161047,42461,18,21,3,45,47,2297
13663,13663,2DC192DC303083B8FEFB2CD2D1161047,42201,21,23,2,43,46,2196
13664,13664,9F589AB01E58B6B2CA9FB997F96CB7F3,42381,1,6,5,39,41,1991
13665,13665,9F589AB01E58B6B2CA9FB997F96CB7F3,43451,6,9,3,37,40,1890
13666,13666,9F589AB01E58B6B2CA9FB997F96CB7F3,42381,11,13,2,39,41,1991
13667,13667,9F589AB01E58B6B2CA9FB997F96CB7F3,13071,15,17,2,41,41,2091
13668,13668,9F589AB01E58B6B2CA9FB997F96CB7F3,43451,17,18,1,37,40,1890
13669,13669,9F589AB01E58B6B2CA9FB997F96CB7F3,42381,21,22,1,39,41,1991
13674,13674,F40A23A3C64206CC00C54FEAD4057B67,11161,0,7,7,32,48,1648
13675,13675,F40A23A3C64206CC00C54FEAD4057B67,43581,13,16,3,33,48,1698
13676,13676,F40A23A3C64206CC00C54FEAD4057B67,11291,17,18,1,40,49,2049
13677,13677,F40A23A3C64206CC00C54FEAD4057B67,42321,18,21,3,43,47,2197
13678,13678,F40A23A3C64206CC00C54FEAD4057B67,10801,21,22,1,42,47,2147
13679,13679,936F3EAEFFE6D40274671E4FB3E6BD97,11941,0,6,6,37,46,1896
13680,13680,936F3EAEFFE6D40274671E4FB3E6BD97,42161,7,13,6,36,47,1847
13681,13681,936F3EAEFFE6D40274671E4FB3E6BD97,11941,14,18,4,37,46,1896
13682,13682,936F3EAEFFE6D40274671E4FB3E6BD97,13911,18,19,1,39,46,1996
13683,13683,936F3EAEFFE6D40274671E4FB3E6BD97,11941,21,23,2,37,46,1896
13687,13687,19FF976328DAF40B2191A4FAD8E693E1,43011,0,5,5,40,42,2042
13688,13688,19FF976328DAF40B2191A4FAD8E693E1,43451,6,17,11,37,40,1890
13689,13689,19FF976328DAF40B2191A4FAD8E693E1,42381,21,23,2,39,41,1991
13690,13690,1A8DFA9DA14422C77AB2C036FA719B1A,42461,0,7,7,45,47,2297
13691,13691,1A8DFA9DA14422C77AB2C036FA719B1A,42271,7,18,11,40,47,2047
13692,13692,1A8DFA9DA14422C77AB2C036FA719B1A,10841,21,23,2,37,47,1897
13696,13696,7404CB33B6B489E8439E814041DFD427,11074,1,2,1,37,47,1897
13697,13697,7404CB33B6B489E8439E814041DFD427,11941,4,11,7,37,46,1896
13698,13698,7404CB33B6B489E8439E814041DFD427,10431,12,14,2,33,49,1699
13699,13699,7404CB33B6B489E8439E814041DFD427,42601,18,20,2,44,48,2248
13703,13703,F5B51F953CD3F7A1DB23953A4B9121A3,12871,0,1,1,22,33,1133
13704,13704,F5B51F953CD3F7A1DB23953A4B9121A3,19281,2,4,2,16,32,832
13705,13705,F5B51F953CD3F7A1DB23953A4B9121A3,12871,4,10,6,22,33,1133
13706,13706,F5B51F953CD3F7A1DB23953A4B9121A3,42531,16,17,1,31,45,1595
13707,13707,F5B51F953CD3F7A1DB23953A4B9121A3,12731,21,23,2,22,40,1140
13708,13708,1B3132796849B42BCD4DBFC11B3ED3B3,12161,0,6,6,32,46,1646
13709,13709,1B3132796849B42BCD4DBFC11B3ED3B3,43311,7,9,2,31,48,1598
13710,13710,1B3132796849B42BCD4DBFC11B3ED3B3,11061,10,17,7,29,48,1498
13711,13711,1B3132796849B42BCD4DBFC11B3ED3B3,11324,21,23,2,31,46,1596
13721,13721,BEF31F045A546CF30A63CFBCD60FD3FA,13911,0,8,8,39,46,1996
13722,13722,BEF31F045A546CF30A63CFBCD60FD3FA,42231,11,13,2,37,46,1896
13723,13723,BEF31F045A546CF30A63CFBCD60FD3FA,13911,14,15,1,39,46,1996
13724,13724,BEF31F045A546CF30A63CFBCD60FD3FA,42231,16,17,1,37,46,1896
13725,13725,BEF31F045A546CF30A63CFBCD60FD3FA,11261,22,23,1,36,46,1846
13726,13726,3A0F7FB1010E3FDDB420B119D75B8958,10431,0,7,7,33,49,1699
13727,13727,3A0F7FB1010E3FDDB420B119D75B8958,10251,7,9,2,35,47,1797
13728,13728,3A0F7FB1010E3FDDB420B119D75B8958,42401,12,19,7,36,47,1847
13742,13742,AF556D3DF5704772003911D8D4601894,19621,0,7,7,5,46,296
13743,13743,AF556D3DF5704772003911D8D4601894,12641,14,17,3,10,43,543
13744,13744,AF556D3DF5704772003911D8D4601894,19621,20,22,2,5,46,296
13751,13751,27A0DD6A965A1FEA8EED4D0E73345414,12921,2,3,1,9,41,491
13752,13752,27A0DD6A965A1FEA8EED4D0E73345414,43644,3,5,2,14,38,738
13753,13753,27A0DD6A965A1FEA8EED4D0E73345414,12921,5,19,14,9,41,491
13754,13754,27A0DD6A965A1FEA8EED4D0E73345414,19744,20,22,2,6,43,343
13755,13755,3B843905DBA028028A69F37DCACAA60A,11861,1,2,1,32,47,1647
13756,13756,3B843905DBA028028A69F37DCACAA60A,42521,2,4,2,31,47,1597
13757,13757,3B843905DBA028028A69F37DCACAA60A,11861,6,14,8,32,47,1647
13758,13758,3B843905DBA028028A69F37DCACAA60A,42521,19,21,2,31,47,1597
13759,13759,3B843905DBA028028A69F37DCACAA60A,11861,21,23,2,32,47,1647
13760,13760,D88EA2A634C927FE2BD8ECB490F7D727,10811,0,14,14,38,46,1946
13761,13761,D88EA2A634C927FE2BD8ECB490F7D727,12131,15,16,1,32,47,1647
13762,13762,D88EA2A634C927FE2BD8ECB490F7D727,40637,19,21,2,36,47,1847
13763,13763,6D8B811321C7113D9F65C76BC639D080,19111,0,10,10,9,45,495
13764,13764,6D8B811321C7113D9F65C76BC639D080,43761,11,13,2,32,47,1647
13765,13765,6D8B811321C7113D9F65C76BC639D080,12511,13,14,1,39,47,1997
13766,13766,6D8B811321C7113D9F65C76BC639D080,11481,14,15,1,41,48,2098
13767,13767,6D8B811321C7113D9F65C76BC639D080,40341,16,20,4,23,49,1199
13768,13768,6D8B811321C7113D9F65C76BC639D080,19111,20,23,3,9,45,495
13781,13781,E090AE745FE0157CE235544725EE3E3A,42281,0,5,5,40,48,2048
13782,13782,E090AE745FE0157CE235544725EE3E3A,11021,7,17,10,36,49,1849
13783,13783,E090AE745FE0157CE235544725EE3E3A,42221,19,20,1,38,48,1948
13787,13787,E7F0BEFEB527574747952B709C847F2A,15051,0,11,11,19,4,954
13788,13788,E7F0BEFEB527574747952B709C847F2A,16281,15,16,1,11,4,554
13789,13789,E7F0BEFEB527574747952B709C847F2A,15051,16,18,2,19,4,954
13790,13790,E7F0BEFEB527574747952B709C847F2A,16281,19,20,1,11,4,554
13791,13791,E7F0BEFEB527574747952B709C847F2A,15051,21,23,2,19,4,954
13795,13795,2E37B6A823BB12DF110868FD413961C7,12031,0,13,13,33,48,1698
13796,13796,2E37B6A823BB12DF110868FD413961C7,10544,15,16,1,28,48,1448
13797,13797,2E37B6A823BB12DF110868FD413961C7,12031,20,23,3,33,48,1698
13805,13805,A18E604F6E21B36C655ED57648BC9F76,10121,1,6,5,36,49,1849
13806,13806,A18E604F6E21B36C655ED57648BC9F76,11231,8,9,1,37,49,1899
13807,13807,A18E604F6E21B36C655ED57648BC9F76,12083,10,12,2,36,49,1849
13808,13808,A18E604F6E21B36C655ED57648BC9F76,11231,13,14,1,37,49,1899
13809,13809,A18E604F6E21B36C655ED57648BC9F76,10251,16,19,3,35,47,1797
13810,13810,A18E604F6E21B36C655ED57648BC9F76,10121,20,22,2,36,49,1849
13815,13815,93C8A9BFC982F63705EDC3214DA05AC8,10411,0,7,7,36,48,1848
13816,13816,93C8A9BFC982F63705EDC3214DA05AC8,42081,11,14,3,24,49,1249
13817,13817,93C8A9BFC982F63705EDC3214DA05AC8,10411,18,20,2,36,48,1848
13818,13818,93C8A9BFC982F63705EDC3214DA05AC8,11551,20,23,3,39,49,1999
13819,13819,AB1E27033ABBCFEAE4B83A799FB358FD,19744,0,5,5,6,43,343
13820,13820,AB1E27033ABBCFEAE4B83A799FB358FD,12311,6,18,12,30,44,1544
13821,13821,AB1E27033ABBCFEAE4B83A799FB358FD,19744,19,23,4,6,43,343
13822,13822,F276DA0C0E39AE3BAD5B91AE46CB6EA8,42971,0,8,8,43,49,2199
13823,13823,F276DA0C0E39AE3BAD5B91AE46CB6EA8,42191,12,13,1,38,49,1949
13824,13824,F276DA0C0E39AE3BAD5B91AE46CB6EA8,11231,14,18,4,37,49,1899
13825,13825,6E930473CE7BAE7152B900D6FDA964CB,13911,0,7,7,39,46,1996
13826,13826,6E930473CE7BAE7152B900D6FDA964CB,13341,9,13,4,44,45,2245
13827,13827,6E930473CE7BAE7152B900D6FDA964CB,42111,13,15,2,44,46,2246
13828,13828,6E930473CE7BAE7152B900D6FDA964CB,13911,18,23,5,39,46,1996
13829,13829,665D84DE00719CFBCFE85E60D38EDE84,12514,0,3,3,38,47,1947
13830,13830,665D84DE00719CFBCFE85E60D38EDE84,10841,4,5,1,37,47,1897
13831,13831,665D84DE00719CFBCFE85E60D38EDE84,12514,7,12,5,38,47,1947
13832,13832,665D84DE00719CFBCFE85E60D38EDE84,11954,15,17,2,32,49,1649
13833,13833,665D84DE00719CFBCFE85E60D38EDE84,42471,19,23,4,35,49,1799
13834,13834,BBCB9918D42B41DEDF16DD7F5A9BE26F,11861,0,9,9,32,47,1647
13835,13835,BBCB9918D42B41DEDF16DD7F5A9BE26F,42161,9,11,2,36,47,1847
13836,13836,BBCB9918D42B41DEDF16DD7F5A9BE26F,11331,12,17,5,37,48,1898
13837,13837,BBCB9918D42B41DEDF16DD7F5A9BE26F,11861,17,23,6,32,47,1647
13838,13838,1D5FEB85097765A4DAC299D8A4D17B3D,10951,0,6,6,29,48,1498
13839,13839,1D5FEB85097765A4DAC299D8A4D17B3D,11161,7,14,7,32,48,1648
13840,13840,1D5FEB85097765A4DAC299D8A4D17B3D,10811,14,15,1,38,46,1946
13841,13841,1D5FEB85097765A4DAC299D8A4D17B3D,12381,18,20,2,32,48,1648
13842,13842,1D5FEB85097765A4DAC299D8A4D17B3D,12121,21,23,2,29,47,1497
13860,13860,A5267560F8241F40BFCB325C4ADBB18D,12601,0,10,10,25,47,1297
13861,13861,A5267560F8241F40BFCB325C4ADBB18D,10351,12,14,2,28,45,1445
13862,13862,A5267560F8241F40BFCB325C4ADBB18D,12601,15,16,1,25,47,1297
13863,13863,A5267560F8241F40BFCB325C4ADBB18D,10351,19,21,2,28,45,1445
13864,13864,A5267560F8241F40BFCB325C4ADBB18D,12601,22,23,1,25,47,1297
13865,13865,331736FE71666B7814EF475D313271C7,12641,0,1,1,10,43,543
13866,13866,331736FE71666B7814EF475D313271C7,19031,4,6,2,1,42,92
13867,13867,331736FE71666B7814EF475D313271C7,12921,18,20,2,9,41,491
13868,13868,331736FE71666B7814EF475D313271C7,12641,22,23,1,10,43,543
13877,13877,519F6943E245A3EEEF779EF46EE4C042,12141,0,7,7,42,45,2145
13878,13878,519F6943E245A3EEEF779EF46EE4C042,13481,10,12,2,26,31,1331
13879,13879,519F6943E245A3EEEF779EF46EE4C042,42623,18,20,2,22,49,1149
13883,13883,40A368CA34750DF505DA57A322872C86,12611,0,6,6,41,29,2079
13884,13884,40A368CA34750DF505DA57A322872C86,15411,6,14,8,44,27,2227
13885,13885,40A368CA34750DF505DA57A322872C86,12611,14,23,9,41,29,2079
13892,13892,B1886EF8F5487F8E8F1A6E89D17F4DF6,12311,0,4,4,30,44,1544
13893,13893,B1886EF8F5487F8E8F1A6E89D17F4DF6,42531,9,10,1,31,45,1595
13894,13894,B1886EF8F5487F8E8F1A6E89D17F4DF6,12311,11,12,1,30,44,1544
13895,13895,B1886EF8F5487F8E8F1A6E89D17F4DF6,42531,13,17,4,31,45,1595
13896,13896,B1886EF8F5487F8E8F1A6E89D17F4DF6,12311,22,23,1,30,44,1544
13897,13897,DFA829FE67684DF135596CD349A21665,19111,10,12,2,9,45,495
13898,13898,DFA829FE67684DF135596CD349A21665,42511,17,18,1,37,47,1897
13899,13899,DFA829FE67684DF135596CD349A21665,19114,19,22,3,7,43,393
13900,13900,B51B8C74A49BD6867CCC9145F07F78FF,12921,0,1,1,9,41,491
13901,13901,B51B8C74A49BD6867CCC9145F07F78FF,43644,2,9,7,14,38,738
13902,13902,B51B8C74A49BD6867CCC9145F07F78FF,43021,10,12,2,16,43,843
13903,13903,B51B8C74A49BD6867CCC9145F07F78FF,43644,13,23,10,14,38,738
13917,13917,56BF703F887E17790C3BEE3B65E096E0,42351,0,6,6,38,45,1945
13918,13918,56BF703F887E17790C3BEE3B65E096E0,43951,7,8,1,49,41,2491
13919,13919,56BF703F887E17790C3BEE3B65E096E0,43101,9,10,1,46,40,2340
13920,13920,56BF703F887E17790C3BEE3B65E096E0,42351,12,13,1,38,45,1945
13921,13921,56BF703F887E17790C3BEE3B65E096E0,43951,14,17,3,49,41,2491
13922,13922,56BF703F887E17790C3BEE3B65E096E0,42351,19,23,4,38,45,1945
13929,13929,EF06CFD15B1A16A6B42F221D8AE07E7D,16151,0,1,1,13,11,661
13930,13930,EF06CFD15B1A16A6B42F221D8AE07E7D,15145,1,3,2,22,9,1109
13931,13931,EF06CFD15B1A16A6B42F221D8AE07E7D,16151,3,21,18,13,11,661
13932,13932,5BC86F424BAF4B877A98262DEDE87053,10221,3,7,4,34,49,1749
13933,13933,5BC86F424BAF4B877A98262DEDE87053,42151,11,13,2,35,45,1795
13934,13934,5BC86F424BAF4B877A98262DEDE87053,42471,16,22,6,35,49,1799
13935,13935,E2FC80C995A3EFA4B2AF01BAD4B24C1C,11074,3,6,3,37,47,1897
13936,13936,E2FC80C995A3EFA4B2AF01BAD4B24C1C,12083,8,12,4,36,49,1849
13937,13937,E2FC80C995A3EFA4B2AF01BAD4B24C1C,10901,13,14,1,35,48,1798
13938,13938,E2FC80C995A3EFA4B2AF01BAD4B24C1C,12083,14,16,2,36,49,1849
13939,13939,E2FC80C995A3EFA4B2AF01BAD4B24C1C,42221,20,23,3,38,48,1948
13960,13960,A52680CFF3255B80F2E899094DC1E938,13951,0,7,7,47,45,2395
13961,13961,A52680CFF3255B80F2E899094DC1E938,43951,7,9,2,49,41,2491
13962,13962,A52680CFF3255B80F2E899094DC1E938,13951,12,13,1,47,45,2395
13963,13963,A52680CFF3255B80F2E899094DC1E938,43951,14,16,2,49,41,2491
13964,13964,A52680CFF3255B80F2E899094DC1E938,13411,19,20,1,49,42,2492
13965,13965,A52680CFF3255B80F2E899094DC1E938,13951,21,23,2,47,45,2395
13966,13966,E7A499EFF2705CCA8F4C4AD8B684EDF4,11201,0,7,7,35,49,1799
13967,13967,E7A499EFF2705CCA8F4C4AD8B684EDF4,43761,11,14,3,32,47,1647
13968,13968,E7A499EFF2705CCA8F4C4AD8B684EDF4,43731,18,20,2,34,47,1747
13969,13969,E7A499EFF2705CCA8F4C4AD8B684EDF4,11201,21,23,2,35,49,1799
13970,13970,C094282B525E0208A246EB62395EA9F5,12511,0,3,3,39,47,1997
13971,13971,C094282B525E0208A246EB62395EA9F5,10251,4,10,6,35,47,1797
13972,13972,C094282B525E0208A246EB62395EA9F5,11201,10,12,2,35,49,1799
13973,13973,C094282B525E0208A246EB62395EA9F5,40101,14,15,1,34,49,1749
13974,13974,C094282B525E0208A246EB62395EA9F5,10251,18,21,3,35,47,1797
13975,13975,C094282B525E0208A246EB62395EA9F5,12511,22,23,1,39,47,1997
13980,13980,7308A861032DD6CDA204025A180927B9,42151,2,12,10,35,45,1795
13981,13981,7308A861032DD6CDA204025A180927B9,13671,12,14,2,27,43,1393
13982,13982,7308A861032DD6CDA204025A180927B9,42151,17,19,2,35,45,1795
13983,13983,DE7BE47E05724D2B7B84051451E0119E,42301,8,14,6,36,47,1847
13984,13984,DE7BE47E05724D2B7B84051451E0119E,11631,15,16,1,12,49,649
13985,13985,DE7BE47E05724D2B7B84051451E0119E,10111,19,21,2,37,47,1897
13986,13986,DE7BE47E05724D2B7B84051451E0119E,12491,22,23,1,36,43,1843
13987,13987,08B6161A63F0BFCCF67BFC0EA5B81E44,42621,0,6,6,24,49,1249
13988,13988,08B6161A63F0BFCCF67BFC0EA5B81E44,40341,6,10,4,23,49,1199
13989,13989,08B6161A63F0BFCCF67BFC0EA5B81E44,42623,11,13,2,22,49,1149
13990,13990,08B6161A63F0BFCCF67BFC0EA5B81E44,40341,14,21,7,23,49,1199
13991,13991,08B6161A63F0BFCCF67BFC0EA5B81E44,42621,22,23,1,24,49,1249
13992,13992,A4F650955D0F2E8B3DBCA61C267939BC,13651,0,13,13,30,47,1547
13993,13993,A4F650955D0F2E8B3DBCA61C267939BC,10781,14,18,4,35,47,1797
13994,13994,A4F650955D0F2E8B3DBCA61C267939BC,13651,19,23,4,30,47,1547
13998,13998,C30BEEA9CA254D53A7149F2D7023764F,11781,3,12,9,38,49,1949
13999,13999,C30BEEA9CA254D53A7149F2D7023764F,10151,14,16,2,34,47,1747
14000,14000,C30BEEA9CA254D53A7149F2D7023764F,11771,18,20,2,39,49,1999
14001,14001,C30BEEA9CA254D53A7149F2D7023764F,43361,21,22,1,38,48,1948
14015,14015,EC8D784C19C185B8F2C30A9ECA831652,13911,0,8,8,39,46,1996
14016,14016,EC8D784C19C185B8F2C30A9ECA831652,11261,9,10,1,36,46,1846
14017,14017,EC8D784C19C185B8F2C30A9ECA831652,13911,10,13,3,39,46,1996
14018,14018,EC8D784C19C185B8F2C30A9ECA831652,11261,14,17,3,36,46,1846
14019,14019,EC8D784C19C185B8F2C30A9ECA831652,13911,17,23,6,39,46,1996
14020,14020,FC35DB32967AFC91DAED8F03683A2075,13961,0,7,7,42,48,2148
14021,14021,FC35DB32967AFC91DAED8F03683A2075,11914,9,11,2,37,48,1898
14022,14022,FC35DB32967AFC91DAED8F03683A2075,13961,12,13,1,42,48,2148
14023,14023,FC35DB32967AFC91DAED8F03683A2075,11914,14,16,2,37,48,1898
14024,14024,FC35DB32967AFC91DAED8F03683A2075,13961,17,23,6,42,48,2148
14025,14025,E528C1BCF7730647027A4A7EFB058975,42631,1,6,5,43,45,2195
14026,14026,E528C1BCF7730647027A4A7EFB058975,10211,9,12,3,16,49,849
14027,14027,E528C1BCF7730647027A4A7EFB058975,13341,13,22,9,44,45,2245
14036,14036,6D3D88C57BAED90EED5783D123F38AA1,11731,0,2,2,36,48,1848
14037,14037,6D3D88C57BAED90EED5783D123F38AA1,10251,2,11,9,35,47,1797
14038,14038,6D3D88C57BAED90EED5783D123F38AA1,11211,12,13,1,34,49,1749
14039,14039,6D3D88C57BAED90EED5783D123F38AA1,10251,13,15,2,35,47,1797
14040,14040,6D3D88C57BAED90EED5783D123F38AA1,11731,16,23,7,36,48,1848
14041,14041,026400BF77ED9426898CFF8EBE921A19,43751,0,6,6,19,48,998
14042,14042,026400BF77ED9426898CFF8EBE921A19,12581,7,10,3,24,48,1248
14043,14043,026400BF77ED9426898CFF8EBE921A19,43751,12,15,3,19,48,998
14044,14044,026400BF77ED9426898CFF8EBE921A19,12581,15,16,1,24,48,1248
14045,14045,026400BF77ED9426898CFF8EBE921A19,10211,20,21,1,16,49,849
14049,14049,E4A99F1C3E7ED34FBD67066F6ADB6F92,12311,0,6,6,30,44,1544
14050,14050,E4A99F1C3E7ED34FBD67066F6ADB6F92,10531,7,8,1,34,46,1746
14051,14051,E4A99F1C3E7ED34FBD67066F6ADB6F92,12311,11,23,12,30,44,1544
14052,14052,0622D3A6EF64A4952E6DCCD9F6EC7FF8,11074,0,9,9,37,47,1897
14053,14053,0622D3A6EF64A4952E6DCCD9F6EC7FF8,11331,12,15,3,37,48,1898
14054,14054,0622D3A6EF64A4952E6DCCD9F6EC7FF8,10841,17,18,1,37,47,1897
14055,14055,0622D3A6EF64A4952E6DCCD9F6EC7FF8,11271,18,20,2,37,48,1898
14056,14056,0622D3A6EF64A4952E6DCCD9F6EC7FF8,42981,20,23,3,36,49,1849
14057,14057,41A01DC1A08492F811E75051AA4EA6A5,12141,0,7,7,42,45,2145
14058,14058,41A01DC1A08492F811E75051AA4EA6A5,43731,11,12,1,34,47,1747
14059,14059,41A01DC1A08492F811E75051AA4EA6A5,10107,13,15,2,38,49,1949
14060,14060,41A01DC1A08492F811E75051AA4EA6A5,13121,15,23,8,38,46,1946
14064,14064,64FF3E93355E6DCA29977E04D316EABA,43671,0,1,1,35,48,1798
14065,14065,64FF3E93355E6DCA29977E04D316EABA,10971,2,7,5,35,47,1797
14066,14066,64FF3E93355E6DCA29977E04D316EABA,11021,9,12,3,36,49,1849
14067,14067,64FF3E93355E6DCA29977E04D316EABA,11781,13,15,2,38,49,1949
14068,14068,64FF3E93355E6DCA29977E04D316EABA,11231,15,18,3,37,49,1899
14069,14069,64FF3E93355E6DCA29977E04D316EABA,40925,19,23,4,35,49,1799
14070,14070,C8236143E8B93D5FDE499177CF2B28F7,11381,0,5,5,30,47,1547
14071,14071,C8236143E8B93D5FDE499177CF2B28F7,42861,7,18,11,37,44,1894
14072,14072,C8236143E8B93D5FDE499177CF2B28F7,11381,19,23,4,30,47,1547
14080,14080,0BE6D4AFC80D9EB63E9D1C0C2A62879B,10191,8,13,5,40,48,2048
14081,14081,0BE6D4AFC80D9EB63E9D1C0C2A62879B,43181,13,14,1,39,48,1998
14082,14082,0BE6D4AFC80D9EB63E9D1C0C2A62879B,11151,15,16,1,30,48,1548
14083,14083,0BE6D4AFC80D9EB63E9D1C0C2A62879B,40171,18,22,4,38,48,1948
14087,14087,D7B9E71E7659BF8A1A818E9EAC76C78D,13951,0,7,7,47,45,2395
14088,14088,D7B9E71E7659BF8A1A818E9EAC76C78D,11751,9,16,7,35,48,1798
14089,14089,D7B9E71E7659BF8A1A818E9EAC76C78D,12561,19,20,1,45,43,2293
14090,14090,756266AA2D3282E41A15D30D8262945F,10107,0,7,7,38,49,1949
14091,14091,756266AA2D3282E41A15D30D8262945F,42521,9,11,2,31,47,1597
14092,14092,756266AA2D3282E41A15D30D8262945F,43181,12,13,1,39,48,1998
14093,14093,756266AA2D3282E41A15D30D8262945F,12021,15,16,1,37,49,1899
14094,14094,756266AA2D3282E41A15D30D8262945F,11331,19,22,3,37,48,1898
14095,14095,C5CEA5CBE70F0BCBF75A48F426F2F5F5,12561,0,7,7,45,43,2293
14096,14096,C5CEA5CBE70F0BCBF75A48F426F2F5F5,12211,7,9,2,41,44,2094
14097,14097,C5CEA5CBE70F0BCBF75A48F426F2F5F5,43951,11,13,2,49,41,2491
14098,14098,C5CEA5CBE70F0BCBF75A48F426F2F5F5,43011,16,22,6,40,42,2042
14099,14099,414AA00EC00DAA3D830C87A4F3E4DD09,42021,0,1,1,33,47,1697
14100,14100,414AA00EC00DAA3D830C87A4F3E4DD09,11861,1,7,6,32,47,1647
14101,14101,414AA00EC00DAA3D830C87A4F3E4DD09,10731,9,10,1,33,47,1697
14102,14102,414AA00EC00DAA3D830C87A4F3E4DD09,10151,11,12,1,34,47,1747
14103,14103,414AA00EC00DAA3D830C87A4F3E4DD09,10651,13,19,6,36,49,1849
14104,14104,414AA00EC00DAA3D830C87A4F3E4DD09,10107,20,22,2,38,49,1949
14105,14105,C898CBC2B35F503BC424C75E27A5EB91,11331,0,10,10,37,48,1898
14106,14106,C898CBC2B35F503BC424C75E27A5EB91,42161,11,12,1,36,47,1847
14107,14107,C898CBC2B35F503BC424C75E27A5EB91,11331,14,16,2,37,48,1898
14108,14108,C898CBC2B35F503BC424C75E27A5EB91,42301,16,17,1,36,47,1847
14109,14109,C898CBC2B35F503BC424C75E27A5EB91,10111,20,22,2,37,47,1897
14110,14110,F0886A59FA683AF0B462E88F7E4BD6B8,10161,0,8,8,35,49,1799
14111,14111,F0886A59FA683AF0B462E88F7E4BD6B8,12601,9,15,6,25,47,1297
14112,14112,F0886A59FA683AF0B462E88F7E4BD6B8,10161,18,22,4,35,49,1799
14116,14116,7FC90A7046789407FE1CCFF00DDA96C6,40343,0,13,13,24,49,1249
14117,14117,7FC90A7046789407FE1CCFF00DDA96C6,11061,14,16,2,29,48,1498
14118,14118,7FC90A7046789407FE1CCFF00DDA96C6,40343,18,19,1,24,49,1249
14119,14119,7FC90A7046789407FE1CCFF00DDA96C6,42331,21,23,2,39,46,1996
14120,14120,624C4BFCBA6BE4C3D9056CCC16907DD9,12121,2,7,5,29,47,1497
14121,14121,624C4BFCBA6BE4C3D9056CCC16907DD9,11381,7,9,2,30,47,1547
14122,14122,624C4BFCBA6BE4C3D9056CCC16907DD9,49181,10,11,1,21,31,1081
14123,14123,624C4BFCBA6BE4C3D9056CCC16907DD9,13481,11,13,2,26,31,1331
14124,14124,624C4BFCBA6BE4C3D9056CCC16907DD9,11381,14,23,9,30,47,1547
14131,14131,33ED93023E3AD7A598E0E42FBD60B0B2,10151,0,3,3,34,47,1747
14132,14132,33ED93023E3AD7A598E0E42FBD60B0B2,10781,3,7,4,35,47,1797
14133,14133,33ED93023E3AD7A598E0E42FBD60B0B2,42151,12,14,2,35,45,1795
14134,14134,33ED93023E3AD7A598E0E42FBD60B0B2,12311,15,16,1,30,44,1544
14135,14135,33ED93023E3AD7A598E0E42FBD60B0B2,10781,19,21,2,35,47,1797
14143,14143,16C7E2BB7A5E5EDDEB0437BAEEE6DA98,42161,0,8,8,36,47,1847
14144,14144,16C7E2BB7A5E5EDDEB0437BAEEE6DA98,16261,11,15,4,3,3,153
14145,14145,16C7E2BB7A5E5EDDEB0437BAEEE6DA98,42401,20,23,3,36,47,1847
14146,14146,FEF1B208BFBEDDE7B3E7A77BB07513A4,10924,0,8,8,43,49,2199
14147,14147,FEF1B208BFBEDDE7B3E7A77BB07513A4,42091,9,11,2,43,46,2196
14148,14148,FEF1B208BFBEDDE7B3E7A77BB07513A4,10924,12,13,1,43,49,2199
14149,14149,FEF1B208BFBEDDE7B3E7A77BB07513A4,43361,21,23,2,38,48,1948
14156,14156,D5A1F589AD5A8A456E0D23A90489837D,11231,8,17,9,37,49,1899
14157,14157,D5A1F589AD5A8A456E0D23A90489837D,11771,19,21,2,39,49,1999
14158,14158,D5A1F589AD5A8A456E0D23A90489837D,43761,22,23,1,32,47,1647
14159,14159,4003E07D2A4AF66E84145561FFA003F3,40925,0,2,2,35,49,1799
14160,14160,4003E07D2A4AF66E84145561FFA003F3,11861,3,10,7,32,47,1647
14161,14161,4003E07D2A4AF66E84145561FFA003F3,42491,13,14,1,32,46,1646
14162,14162,4003E07D2A4AF66E84145561FFA003F3,10341,14,23,9,31,47,1597
14163,14163,E08992EE1FDBC9EFFA9475B4ECDB7A1C,43761,7,8,1,32,47,1647
14164,14164,E08992EE1FDBC9EFFA9475B4ECDB7A1C,10631,13,16,3,28,46,1446
14165,14165,E08992EE1FDBC9EFFA9475B4ECDB7A1C,10491,19,20,1,33,48,1698
14166,14166,E08992EE1FDBC9EFFA9475B4ECDB7A1C,43761,22,23,1,32,47,1647
14167,14167,0D9AA89290D1F445356B85B4B256A343,10521,2,5,3,41,47,2097
14168,14168,0D9AA89290D1F445356B85B4B256A343,10811,7,10,3,38,46,1946
14169,14169,0D9AA89290D1F445356B85B4B256A343,10521,12,13,1,41,47,2097
14170,14170,0D9AA89290D1F445356B85B4B256A343,10811,15,16,1,38,46,1946
14171,14171,0D9AA89290D1F445356B85B4B256A343,11001,19,22,3,42,47,2147
14182,14182,6D411464E8569334C6217011CDDAB47B,43661,0,5,5,33,47,1697
14183,14183,6D411464E8569334C6217011CDDAB47B,42201,6,14,8,43,46,2196
14184,14184,6D411464E8569334C6217011CDDAB47B,13911,15,16,1,39,46,1996
14185,14185,6D411464E8569334C6217011CDDAB47B,10281,21,23,2,33,48,1698
14186,14186,85E6B4DC96BFA3920E08895C266F386F,13121,0,6,6,38,46,1946
14187,14187,85E6B4DC96BFA3920E08895C266F386F,11701,11,16,5,43,48,2198
14188,14188,85E6B4DC96BFA3920E08895C266F386F,13681,19,23,4,38,47,1947
14189,14189,14C205DF57BD0AA586E26BE4ED695846,42581,0,5,5,38,48,1948
14190,14190,14C205DF57BD0AA586E26BE4ED695846,11914,6,7,1,37,48,1898
14191,14191,14C205DF57BD0AA586E26BE4ED695846,42581,7,10,3,38,48,1948
14192,14192,14C205DF57BD0AA586E26BE4ED695846,11914,10,11,1,37,48,1898
14193,14193,14C205DF57BD0AA586E26BE4ED695846,42581,12,17,5,38,48,1948
14194,14194,14C205DF57BD0AA586E26BE4ED695846,11914,17,18,1,37,48,1898
14195,14195,14C205DF57BD0AA586E26BE4ED695846,42581,19,20,1,38,48,1948
14211,14211,FF54487E0B5C80FA4088AB1638FB8194,12514,1,4,3,38,47,1947
14212,14212,FF54487E0B5C80FA4088AB1638FB8194,11914,6,8,2,37,48,1898
14213,14213,FF54487E0B5C80FA4088AB1638FB8194,42581,9,14,5,38,48,1948
14214,14214,FF54487E0B5C80FA4088AB1638FB8194,11914,14,17,3,37,48,1898
14215,14215,FF54487E0B5C80FA4088AB1638FB8194,42581,18,20,2,38,48,1948
14216,14216,86F83A4789830DBB7C5E8BC1D0F8B089,10214,1,14,13,15,49,799
14217,14217,86F83A4789830DBB7C5E8BC1D0F8B089,12921,17,20,3,9,41,491
14218,14218,86F83A4789830DBB7C5E8BC1D0F8B089,43021,20,23,3,16,43,843
14219,14219,E40FF661B4F3DA89AB28D734DF463F41,43021,0,6,6,16,43,843
14220,14220,E40FF661B4F3DA89AB28D734DF463F41,12921,7,10,3,9,41,491
14221,14221,E40FF661B4F3DA89AB28D734DF463F41,12641,12,13,1,10,43,543
14222,14222,E40FF661B4F3DA89AB28D734DF463F41,12921,13,19,6,9,41,491
14223,14223,E40FF661B4F3DA89AB28D734DF463F41,43021,22,23,1,16,43,843
14231,14231,08CB7DE7B454B11D0CD418122AABCC52,11521,0,10,10,41,48,2098
14232,14232,08CB7DE7B454B11D0CD418122AABCC52,13941,12,14,2,41,47,2097
14233,14233,08CB7DE7B454B11D0CD418122AABCC52,42161,16,19,3,36,47,1847
14234,14234,6C0E943C8B3CE3071E466B3888DE833C,12311,5,8,3,30,44,1544
14235,14235,6C0E943C8B3CE3071E466B3888DE833C,42531,8,15,7,31,45,1595
14236,14236,6C0E943C8B3CE3071E466B3888DE833C,12311,15,16,1,30,44,1544
14237,14237,6C0E943C8B3CE3071E466B3888DE833C,42531,17,18,1,31,45,1595
14238,14238,6C0E943C8B3CE3071E466B3888DE833C,19744,19,21,2,6,43,343
14243,14243,40DF80F4FACEE4C30F67E046C026885A,42301,0,9,9,36,47,1847
14244,14244,40DF80F4FACEE4C30F67E046C026885A,40341,11,15,4,23,49,1199
14245,14245,40DF80F4FACEE4C30F67E046C026885A,42301,16,19,3,36,47,1847
14246,14246,40DF80F4FACEE4C30F67E046C026885A,10841,20,21,1,37,47,1897
14247,14247,40DF80F4FACEE4C30F67E046C026885A,42301,22,23,1,36,47,1847
14248,14248,572FC1924B3D406C6B95088F85214228,11571,0,1,1,13,46,696
14249,14249,572FC1924B3D406C6B95088F85214228,42041,2,6,4,10,47,547
14250,14250,572FC1924B3D406C6B95088F85214228,19441,6,11,5,8,46,446
14251,14251,572FC1924B3D406C6B95088F85214228,42041,12,23,11,10,47,547
14258,14258,74EBB90FA1C414F58477B49370E7F73F,11861,0,6,6,32,47,1647
14259,14259,74EBB90FA1C414F58477B49370E7F73F,12311,7,18,11,30,44,1544
14260,14260,74EBB90FA1C414F58477B49370E7F73F,11861,19,23,4,32,47,1647
14261,14261,39179060954ADF536A44D5CDC3D7ADA4,11261,9,15,6,36,46,1846
14262,14262,39179060954ADF536A44D5CDC3D7ADA4,13911,15,17,2,39,46,1996
14263,14263,39179060954ADF536A44D5CDC3D7ADA4,11261,17,20,3,36,46,1846
14264,14264,39179060954ADF536A44D5CDC3D7ADA4,10921,21,23,2,43,48,2198
14265,14265,9A4B1016854BDBF7BB2BAF55931B49A9,13111,0,4,4,42,46,2146
14266,14266,9A4B1016854BDBF7BB2BAF55931B49A9,13671,5,8,3,27,43,1393
14267,14267,9A4B1016854BDBF7BB2BAF55931B49A9,11281,8,15,7,27,40,1390
14268,14268,9A4B1016854BDBF7BB2BAF55931B49A9,13111,18,20,2,42,46,2146
14269,14269,BA6D45213D52989026A398B5D7995374,43644,0,6,6,14,38,738
14270,14270,BA6D45213D52989026A398B5D7995374,19181,7,9,2,8,40,440
14271,14271,BA6D45213D52989026A398B5D7995374,49201,13,19,6,7,41,391
14272,14272,AF45D7FF91ADC8A42EE1BE638B4AB9CE,11701,0,3,3,43,48,2198
14273,14273,AF45D7FF91ADC8A42EE1BE638B4AB9CE,10691,4,12,8,33,48,1698
14274,14274,AF45D7FF91ADC8A42EE1BE638B4AB9CE,11481,16,18,2,41,48,2098
14275,14275,AF45D7FF91ADC8A42EE1BE638B4AB9CE,11701,19,21,2,43,48,2198
14276,14276,AF45D7FF91ADC8A42EE1BE638B4AB9CE,11521,21,23,2,41,48,2098
14277,14277,7D5CC73D25F6E655BA409FBE4F4072E1,13511,0,14,14,34,48,1748
14278,14278,7D5CC73D25F6E655BA409FBE4F4072E1,40341,19,20,1,23,49,1199
14279,14279,7D5CC73D25F6E655BA409FBE4F4072E1,13511,21,23,2,34,48,1748
14280,14280,A5A342C5B79B8AEE00BA80AE678B8EC5,10331,0,7,7,39,46,1996
14281,14281,A5A342C5B79B8AEE00BA80AE678B8EC5,11151,9,10,1,30,48,1548
14282,14282,A5A342C5B79B8AEE00BA80AE678B8EC5,10331,12,14,2,39,46,1996
14283,14283,A5A342C5B79B8AEE00BA80AE678B8EC5,11151,15,18,3,30,48,1548
14284,14284,A5A342C5B79B8AEE00BA80AE678B8EC5,10331,19,21,2,39,46,1996
14285,14285,19CE7C09753F84CC5572E9AF80FD4DB1,40302,1,13,12,40,49,2049
14286,14286,19CE7C09753F84CC5572E9AF80FD4DB1,10281,15,17,2,33,48,1698
14287,14287,19CE7C09753F84CC5572E9AF80FD4DB1,11861,17,19,2,32,47,1647
14288,14288,1D1306B59D2AF3D03EE502CE86B65E29,42071,0,14,14,31,49,1599
14289,14289,1D1306B59D2AF3D03EE502CE86B65E29,19621,15,18,3,5,46,296
14290,14290,1D1306B59D2AF3D03EE502CE86B65E29,10381,22,23,1,31,49,1599
14291,14291,246B9DA3EFDA0E64D291387D5A19302A,19114,0,3,3,7,43,393
14292,14292,246B9DA3EFDA0E64D291387D5A19302A,12641,4,5,1,10,43,543
14293,14293,246B9DA3EFDA0E64D291387D5A19302A,19931,6,8,2,7,43,393
14294,14294,246B9DA3EFDA0E64D291387D5A19302A,12641,9,15,6,10,43,543
14295,14295,246B9DA3EFDA0E64D291387D5A19302A,19114,16,19,3,7,43,393
14299,14299,E716DFCB27D2E8BF3D416B3DA1D9C640,43751,0,10,10,19,48,998
14300,14300,E716DFCB27D2E8BF3D416B3DA1D9C640,12581,13,14,1,24,48,1248
14301,14301,E716DFCB27D2E8BF3D416B3DA1D9C640,43751,17,21,4,19,48,998
14302,14302,F1B018296E8ED57E3EC7BBC1652329B6,12521,0,6,6,35,41,1791
14303,14303,F1B018296E8ED57E3EC7BBC1652329B6,13041,9,13,4,30,37,1537
14304,14304,F1B018296E8ED57E3EC7BBC1652329B6,12521,14,23,9,35,41,1791
14305,14305,2B0A8631DB83DF57E2AB65A944EF458B,43451,0,1,1,37,40,1890
14306,14306,2B0A8631DB83DF57E2AB65A944EF458B,13071,4,5,1,41,41,2091
14307,14307,2B0A8631DB83DF57E2AB65A944EF458B,43451,5,14,9,37,40,1890
14308,14308,2B0A8631DB83DF57E2AB65A944EF458B,42151,15,19,4,35,45,1795
14309,14309,2B0A8631DB83DF57E2AB65A944EF458B,13071,21,23,2,41,41,2091
14317,14317,37C29D4674FBC06EF76342F2283F4E15,13671,0,7,7,27,43,1393
14318,14318,37C29D4674FBC06EF76342F2283F4E15,12731,7,13,6,22,40,1140
14319,14319,37C29D4674FBC06EF76342F2283F4E15,13671,13,15,2,27,43,1393
14320,14320,37C29D4674FBC06EF76342F2283F4E15,42031,18,23,5,40,46,2046
14321,14321,53650105F7F25F79263F92D3A7D439AB,43061,2,10,8,43,46,2196
14322,14322,53650105F7F25F79263F92D3A7D439AB,42111,11,12,1,44,46,2246
14323,14323,53650105F7F25F79263F92D3A7D439AB,11001,13,16,3,42,47,2147
14324,14324,53650105F7F25F79263F92D3A7D439AB,11481,19,20,1,41,48,2098
14325,14325,53650105F7F25F79263F92D3A7D439AB,42461,20,22,2,45,47,2297
14326,14326,3ADF1F40A3E7D2F77A54CBF8A723358F,10292,0,9,9,30,47,1547
14327,14327,3ADF1F40A3E7D2F77A54CBF8A723358F,11331,13,14,1,37,48,1898
14328,14328,3ADF1F40A3E7D2F77A54CBF8A723358F,10292,18,20,2,30,47,1547
14329,14329,6BE02057004DF21ADDEBB4F02ECC524A,11861,0,9,9,32,47,1647
14330,14330,6BE02057004DF21ADDEBB4F02ECC524A,10251,11,12,1,35,47,1797
14331,14331,6BE02057004DF21ADDEBB4F02ECC524A,42401,12,15,3,36,47,1847
14332,14332,6BE02057004DF21ADDEBB4F02ECC524A,40341,16,18,2,23,49,1199
14333,14333,6BE02057004DF21ADDEBB4F02ECC524A,11861,20,23,3,32,47,1647
14341,14341,A18BBFB8111CE9788BEEE3B918FD7EDC,11074,0,6,6,37,47,1897
14342,14342,A18BBFB8111CE9788BEEE3B918FD7EDC,10411,8,10,2,36,48,1848
14343,14343,A18BBFB8111CE9788BEEE3B918FD7EDC,42941,11,13,2,37,47,1897
14344,14344,A18BBFB8111CE9788BEEE3B918FD7EDC,11911,15,16,1,37,48,1898
14345,14345,A18BBFB8111CE9788BEEE3B918FD7EDC,42941,18,19,1,37,47,1897
14346,14346,AF3D07AB03F7B1C25DCA14597732B7C3,11521,0,11,11,41,48,2098
14347,14347,AF3D07AB03F7B1C25DCA14597732B7C3,13941,12,14,2,41,47,2097
14348,14348,AF3D07AB03F7B1C25DCA14597732B7C3,42161,15,19,4,36,47,1847
14349,14349,AF3D07AB03F7B1C25DCA14597732B7C3,11801,20,23,3,42,48,2148
14350,14350,5B1C0BC031C302008BE737E10A20E45F,11481,0,7,7,41,48,2098
14351,14351,5B1C0BC031C302008BE737E10A20E45F,40381,8,11,3,32,46,1646
14352,14352,5B1C0BC031C302008BE737E10A20E45F,11291,12,20,8,40,49,2049
14357,14357,F209A399D7060EB5C592C672B5567F86,10711,9,10,1,29,46,1496
14358,14358,F209A399D7060EB5C592C672B5567F86,12921,13,17,4,9,41,491
14359,14359,F209A399D7060EB5C592C672B5567F86,12641,17,20,3,10,43,543
14360,14360,F209A399D7060EB5C592C672B5567F86,12921,21,22,1,9,41,491
14367,14367,3877B8E5CE9312BFA7CD973C0152DE3C,12514,0,8,8,38,47,1947
14368,14368,3877B8E5CE9312BFA7CD973C0152DE3C,40055,12,19,7,31,49,1599
14369,14369,3877B8E5CE9312BFA7CD973C0152DE3C,12514,21,23,2,38,47,1947
14374,14374,4F1CE0C1A5E6BF21E963500414770875,13331,0,8,8,38,47,1947
14375,14375,4F1CE0C1A5E6BF21E963500414770875,10841,9,12,3,37,47,1897
14376,14376,4F1CE0C1A5E6BF21E963500414770875,13681,12,14,2,38,47,1947
14377,14377,4F1CE0C1A5E6BF21E963500414770875,10841,14,19,5,37,47,1897
14378,14378,4F1CE0C1A5E6BF21E963500414770875,12514,21,23,2,38,47,1947
14379,14379,C1C9B221745BFCA4CC927246B51B8DF9,10121,0,11,11,36,49,1849
14380,14380,C1C9B221745BFCA4CC927246B51B8DF9,10681,12,14,2,30,48,1548
14381,14381,C1C9B221745BFCA4CC927246B51B8DF9,10121,17,23,6,36,49,1849
14382,14382,3FBA130DE96D19DDB92B7C1710211CF0,10611,0,7,7,32,48,1648
14383,14383,3FBA130DE96D19DDB92B7C1710211CF0,10251,7,10,3,35,47,1797
14384,14384,3FBA130DE96D19DDB92B7C1710211CF0,10611,12,15,3,32,48,1648
14385,14385,3FBA130DE96D19DDB92B7C1710211CF0,11201,18,20,2,35,49,1799
14386,14386,3FBA130DE96D19DDB92B7C1710211CF0,10611,21,22,1,32,48,1648
14387,14387,F28971FDAB727964A0F2E6CF36B0BD73,13671,0,14,14,27,43,1393
14388,14388,F28971FDAB727964A0F2E6CF36B0BD73,11074,15,16,1,37,47,1897
14389,14389,F28971FDAB727964A0F2E6CF36B0BD73,13671,20,23,3,27,43,1393
14390,14390,AA71E9A6AEA764D2564D532D0321512B,42041,0,2,2,10,47,547
14391,14391,AA71E9A6AEA764D2564D532D0321512B,11571,2,3,1,13,46,696
14392,14392,AA71E9A6AEA764D2564D532D0321512B,11471,8,9,1,12,48,648
14393,14393,AA71E9A6AEA764D2564D532D0321512B,42041,12,17,5,10,47,547
14394,14394,AA71E9A6AEA764D2564D532D0321512B,19441,17,18,1,8,46,446
14401,14401,71AB304A084EB4095E1F705C48CB0E23,11901,0,7,7,42,49,2149
14402,14402,71AB304A084EB4095E1F705C48CB0E23,11914,7,18,11,37,48,1898
14403,14403,71AB304A084EB4095E1F705C48CB0E23,11901,19,23,4,42,49,2149
14404,14404,5B38B567B1C7BA8CD66BEFDF9C575D7A,11231,0,15,15,37,49,1899
14405,14405,5B38B567B1C7BA8CD66BEFDF9C575D7A,12083,16,18,2,36,49,1849
14406,14406,5B38B567B1C7BA8CD66BEFDF9C575D7A,10681,21,23,2,30,48,1548
14407,14407,AA51DE94270AE4663B2578A38D4EECC9,13961,0,7,7,42,48,2148
14408,14408,AA51DE94270AE4663B2578A38D4EECC9,11914,9,11,2,37,48,1898
14409,14409,AA51DE94270AE4663B2578A38D4EECC9,13961,12,13,1,42,48,2148
14410,14410,AA51DE94270AE4663B2578A38D4EECC9,11914,15,16,1,37,48,1898
14411,14411,AA51DE94270AE4663B2578A38D4EECC9,13961,20,23,3,42,48,2148
14416,14416,AA8CC60B06B8E7A334E7FA04353D8EED,11261,3,14,11,36,46,1846
14417,14417,AA8CC60B06B8E7A334E7FA04353D8EED,43341,19,20,1,41,46,2096
14418,14418,AA8CC60B06B8E7A334E7FA04353D8EED,11261,21,22,1,36,46,1846
14432,14432,96E6A1C1C07658E8B77FA819ED76B569,42341,0,3,3,43,49,2199
14433,14433,96E6A1C1C07658E8B77FA819ED76B569,43761,8,19,11,32,47,1647
14434,14434,96E6A1C1C07658E8B77FA819ED76B569,42341,20,23,3,43,49,2199
14439,14439,B6F5BFB66F10CEAE2D4B40F82C74EE6E,11061,0,8,8,29,48,1498
14440,14440,B6F5BFB66F10CEAE2D4B40F82C74EE6E,42621,15,16,1,24,49,1249
14441,14441,B6F5BFB66F10CEAE2D4B40F82C74EE6E,11061,19,23,4,29,48,1498
14445,14445,F3355C7CE640AE85292C2A8D8E7E2415,13271,0,7,7,41,47,2097
14446,14446,F3355C7CE640AE85292C2A8D8E7E2415,10161,7,11,4,35,49,1799
14447,14447,F3355C7CE640AE85292C2A8D8E7E2415,13271,11,13,2,41,47,2097
14448,14448,F3355C7CE640AE85292C2A8D8E7E2415,11541,16,17,1,35,49,1799
14449,14449,F3355C7CE640AE85292C2A8D8E7E2415,11211,17,20,3,34,49,1749
14450,14450,F3355C7CE640AE85292C2A8D8E7E2415,13271,21,23,2,41,47,2097
14451,14451,D1D02DF9C1212407C948C37939001BC3,42531,9,10,1,31,45,1595
14452,14452,D1D02DF9C1212407C948C37939001BC3,13671,13,14,1,27,43,1393
14453,14453,D1D02DF9C1212407C948C37939001BC3,42531,14,17,3,31,45,1595
14454,14454,D1D02DF9C1212407C948C37939001BC3,13671,22,23,1,27,43,1393
14455,14455,9FC853D14B199D9AE09B3905110E90BD,12514,0,13,13,38,47,1947
14456,14456,9FC853D14B199D9AE09B3905110E90BD,19931,14,15,1,7,43,393
14457,14457,9FC853D14B199D9AE09B3905110E90BD,12921,15,17,2,9,41,491
14458,14458,9FC853D14B199D9AE09B3905110E90BD,19931,17,18,1,7,43,393
14459,14459,9FC853D14B199D9AE09B3905110E90BD,12514,19,22,3,38,47,1947
14460,14460,EC3702B6D1EF3E2036629A2FF6DCF74A,43761,8,9,1,32,47,1647
14461,14461,EC3702B6D1EF3E2036629A2FF6DCF74A,42021,11,13,2,33,47,1697
14462,14462,EC3702B6D1EF3E2036629A2FF6DCF74A,43761,13,14,1,32,47,1647
14463,14463,EC3702B6D1EF3E2036629A2FF6DCF74A,42021,17,18,1,33,47,1697
14464,14464,EC3702B6D1EF3E2036629A2FF6DCF74A,10251,19,21,2,35,47,1797
14469,14469,83BB102D42B106B02532A9E858086CAC,11061,0,7,7,29,48,1498
14470,14470,83BB102D42B106B02532A9E858086CAC,10901,9,12,3,35,48,1798
14471,14471,83BB102D42B106B02532A9E858086CAC,11061,15,23,8,29,48,1498
14472,14472,84BFDA5775B1A36CF113618F1669E73C,42521,0,6,6,31,47,1597
14473,14473,84BFDA5775B1A36CF113618F1669E73C,13651,6,8,2,30,47,1547
14474,14474,84BFDA5775B1A36CF113618F1669E73C,42521,11,14,3,31,47,1597
14475,14475,84BFDA5775B1A36CF113618F1669E73C,10295,15,18,3,30,47,1547
14476,14476,84BFDA5775B1A36CF113618F1669E73C,42521,19,22,3,31,47,1597
14477,14477,0EA80F49CAFA9BFC58CF0D20F7967BFF,42871,0,5,5,30,45,1545
14478,14478,0EA80F49CAFA9BFC58CF0D20F7967BFF,12311,6,9,3,30,44,1544
14479,14479,0EA80F49CAFA9BFC58CF0D20F7967BFF,42871,12,13,1,30,45,1545
14480,14480,0EA80F49CAFA9BFC58CF0D20F7967BFF,12311,15,16,1,30,44,1544
14481,14481,0EA80F49CAFA9BFC58CF0D20F7967BFF,42871,20,23,3,30,45,1545
14485,14485,C13EDA65C3B019881628338CF4BA6FEF,42523,0,2,2,31,47,1597
14486,14486,C13EDA65C3B019881628338CF4BA6FEF,10292,3,8,5,30,47,1547
14487,14487,C13EDA65C3B019881628338CF4BA6FEF,42523,9,11,2,31,47,1597
14488,14488,C13EDA65C3B019881628338CF4BA6FEF,42491,11,13,2,32,46,1646
14489,14489,C13EDA65C3B019881628338CF4BA6FEF,42523,13,15,2,31,47,1597
14490,14490,C13EDA65C3B019881628338CF4BA6FEF,42491,18,21,3,32,46,1646
14498,14498,4A64F91296EF8C1DAA19E0A02FF0729A,11011,0,8,8,39,49,1999
14499,14499,4A64F91296EF8C1DAA19E0A02FF0729A,10401,8,9,1,33,49,1699
14500,14500,4A64F91296EF8C1DAA19E0A02FF0729A,11231,11,12,1,37,49,1899
14501,14501,4A64F91296EF8C1DAA19E0A02FF0729A,11781,12,14,2,38,49,1949
14502,14502,4A64F91296EF8C1DAA19E0A02FF0729A,10231,21,23,2,39,49,1999
14515,14515,69F41107244EDDE97DD1AAB2D554177A,12871,0,7,7,22,33,1133
14516,14516,69F41107244EDDE97DD1AAB2D554177A,19281,11,13,2,16,32,832
14517,14517,69F41107244EDDE97DD1AAB2D554177A,12871,15,16,1,22,33,1133
14518,14518,69F41107244EDDE97DD1AAB2D554177A,19281,16,22,6,16,32,832
14525,14525,C60A92B9E4EA3B92240A484845EDC3BB,10295,0,9,9,30,47,1547
14526,14526,C60A92B9E4EA3B92240A484845EDC3BB,43281,9,12,3,37,48,1898
14527,14527,C60A92B9E4EA3B92240A484845EDC3BB,10107,12,13,1,38,49,1949
14528,14528,C60A92B9E4EA3B92240A484845EDC3BB,10295,14,15,1,30,47,1547
14529,14529,C60A92B9E4EA3B92240A484845EDC3BB,11331,15,22,7,37,48,1898
14530,14530,C493E8EAD829832CA31397E82BE4990B,43021,0,5,5,16,43,843
14531,14531,C493E8EAD829832CA31397E82BE4990B,12641,6,9,3,10,43,543
14532,14532,C493E8EAD829832CA31397E82BE4990B,43021,11,13,2,16,43,843
14533,14533,C493E8EAD829832CA31397E82BE4990B,12921,13,14,1,9,41,491
14534,14534,C493E8EAD829832CA31397E82BE4990B,12641,15,18,3,10,43,543
14535,14535,C493E8EAD829832CA31397E82BE4990B,43021,19,23,4,16,43,843
14545,14545,784F444F5486483DB15E6111C1301671,11011,0,9,9,39,49,1999
14546,14546,784F444F5486483DB15E6111C1301671,43391,10,13,3,29,48,1498
14547,14547,784F444F5486483DB15E6111C1301671,11151,14,15,1,30,48,1548
14548,14548,784F444F5486483DB15E6111C1301671,40094,16,23,7,29,48,1498
14552,14552,6164F469738A30A14CD373EB73D02471,11541,0,3,3,35,49,1799
14553,14553,6164F469738A30A14CD373EB73D02471,11801,5,9,4,42,48,2148
14554,14554,6164F469738A30A14CD373EB73D02471,11211,10,13,3,34,49,1749
14555,14555,6164F469738A30A14CD373EB73D02471,11801,13,14,1,42,48,2148
14556,14556,6164F469738A30A14CD373EB73D02471,10401,15,19,4,33,49,1699
14557,14557,6164F469738A30A14CD373EB73D02471,11801,19,23,4,42,48,2148
14564,14564,F5336F0BC19120BD52E99ACE41BD5064,42071,1,16,15,31,49,1599
14565,14565,F5336F0BC19120BD52E99ACE41BD5064,42261,17,19,2,25,49,1299
14566,14566,F5336F0BC19120BD52E99ACE41BD5064,42071,20,23,3,31,49,1599
14576,14576,01CC134751F2814A4398AAA734AF783B,15271,2,3,1,14,20,720
14577,14577,01CC134751F2814A4398AAA734AF783B,15421,4,5,1,20,18,1018
14578,14578,01CC134751F2814A4398AAA734AF783B,15271,5,18,13,14,20,720
14579,14579,01CC134751F2814A4398AAA734AF783B,15114,20,21,1,22,16,1116
14586,14586,350909571DAF40BC1326F0871B6F4AC2,42371,0,6,6,34,46,1746
14587,14587,350909571DAF40BC1326F0871B6F4AC2,42491,7,9,2,32,46,1646
14588,14588,350909571DAF40BC1326F0871B6F4AC2,42523,12,16,4,31,47,1597
14589,14589,350909571DAF40BC1326F0871B6F4AC2,12131,16,17,1,32,47,1647
14590,14590,350909571DAF40BC1326F0871B6F4AC2,42371,18,23,5,34,46,1746
14595,14595,F7752CA1B73DF28C3ED02C34596B4599,10451,0,9,9,25,48,1298
14596,14596,F7752CA1B73DF28C3ED02C34596B4599,10221,12,13,1,34,49,1749
14597,14597,F7752CA1B73DF28C3ED02C34596B4599,42631,14,18,4,43,45,2195
14598,14598,F7752CA1B73DF28C3ED02C34596B4599,10451,21,22,1,25,48,1298
14599,14599,8141A730EF01126DFD9282AFDEA49317,12121,0,7,7,29,47,1497
14600,14600,8141A730EF01126DFD9282AFDEA49317,11061,8,17,9,29,48,1498
14601,14601,8141A730EF01126DFD9282AFDEA49317,42971,19,21,2,43,49,2199
14602,14602,C7E598BFED6FB574843E537970B28C08,11151,0,7,7,30,48,1548
14603,14603,C7E598BFED6FB574843E537970B28C08,43391,8,10,2,29,48,1498
14604,14604,C7E598BFED6FB574843E537970B28C08,11151,11,12,1,30,48,1548
14605,14605,C7E598BFED6FB574843E537970B28C08,43391,13,14,1,29,48,1498
14606,14606,C7E598BFED6FB574843E537970B28C08,11151,17,18,1,30,48,1548
14607,14607,C7E598BFED6FB574843E537970B28C08,43391,19,20,1,29,48,1498
14608,14608,C7E598BFED6FB574843E537970B28C08,11151,21,23,2,30,48,1548
14609,14609,7598D32DC332293D35F2F6ACB7EBDD15,10251,0,5,5,35,47,1797
14610,14610,7598D32DC332293D35F2F6ACB7EBDD15,42081,7,8,1,24,49,1249
14611,14611,7598D32DC332293D35F2F6ACB7EBDD15,10251,11,23,12,35,47,1797
14612,14612,91C5B3238A8419D0CA530F7A4D0E4118,43061,2,7,5,43,46,2196
14613,14613,91C5B3238A8419D0CA530F7A4D0E4118,11794,16,17,1,38,49,1949
14614,14614,91C5B3238A8419D0CA530F7A4D0E4118,12514,18,20,2,38,47,1947
14615,14615,91C5B3238A8419D0CA530F7A4D0E4118,13111,21,23,2,42,46,2146
14616,14616,1DA79481C6B6D1D9223A378A0D81757A,10111,0,8,8,37,47,1897
14617,14617,1DA79481C6B6D1D9223A378A0D81757A,11211,12,16,4,34,49,1749
14618,14618,1DA79481C6B6D1D9223A378A0D81757A,10111,18,23,5,37,47,1897
14619,14619,C187943D20D187183526E0228C45660E,40691,0,2,2,42,48,2148
14620,14620,C187943D20D187183526E0228C45660E,11021,3,8,5,36,49,1849
14621,14621,C187943D20D187183526E0228C45660E,11271,10,13,3,37,48,1898
14622,14622,C187943D20D187183526E0228C45660E,40034,13,16,3,32,48,1648
14623,14623,C187943D20D187183526E0228C45660E,11021,16,22,6,36,49,1849
14628,14628,6E14D0E93CFE5E8B8CCB16C998A46287,11061,0,6,6,29,48,1498
14629,14629,6E14D0E93CFE5E8B8CCB16C998A46287,11151,7,8,1,30,48,1548
14630,14630,6E14D0E93CFE5E8B8CCB16C998A46287,11061,13,15,2,29,48,1498
14631,14631,6E14D0E93CFE5E8B8CCB16C998A46287,11151,16,18,2,30,48,1548
14632,14632,6E14D0E93CFE5E8B8CCB16C998A46287,11061,18,23,5,29,48,1498
14633,14633,E9E990F48245ACFDBDC8F1C95015FE95,42301,0,7,7,36,47,1847
14634,14634,E9E990F48245ACFDBDC8F1C95015FE95,13121,8,9,1,38,46,1946
14635,14635,E9E990F48245ACFDBDC8F1C95015FE95,13561,10,11,1,37,49,1899
14636,14636,E9E990F48245ACFDBDC8F1C95015FE95,10841,12,14,2,37,47,1897
14637,14637,E9E990F48245ACFDBDC8F1C95015FE95,40124,15,19,4,38,47,1947
14654,14654,DC11B465805E4B821937065119204055,12311,0,1,1,30,44,1544
14655,14655,DC11B465805E4B821937065119204055,13671,2,8,6,27,43,1393
14656,14656,DC11B465805E4B821937065119204055,42151,10,12,2,35,45,1795
14657,14657,DC11B465805E4B821937065119204055,12311,13,16,3,30,44,1544
14658,14658,DC11B465805E4B821937065119204055,10731,20,21,1,33,47,1697
14659,14659,05A52A7A7C35023EA789CA712FC9D5F7,42401,0,17,17,36,47,1847
14660,14660,05A52A7A7C35023EA789CA712FC9D5F7,12381,18,20,2,32,48,1648
14661,14661,05A52A7A7C35023EA789CA712FC9D5F7,42401,21,23,2,36,47,1847
14662,14662,F681B79833B44C7DE260E9A55ED030A3,19741,0,6,6,5,44,294
14663,14663,F681B79833B44C7DE260E9A55ED030A3,12921,7,18,11,9,41,491
14664,14664,F681B79833B44C7DE260E9A55ED030A3,19741,20,23,3,5,44,294
14669,14669,FEE5ACDB24DFF6E9A25C550C618C43AE,40637,2,5,3,36,47,1847
14670,14670,FEE5ACDB24DFF6E9A25C550C618C43AE,40673,9,10,1,36,48,1848
14671,14671,FEE5ACDB24DFF6E9A25C550C618C43AE,10251,12,13,1,35,47,1797
14672,14672,FEE5ACDB24DFF6E9A25C550C618C43AE,40673,14,18,4,36,48,1848
14673,14673,FEE5ACDB24DFF6E9A25C550C618C43AE,10251,18,23,5,35,47,1797
14681,14681,5198D6FAC22FF152C4DC9F65E0571C59,13651,1,5,4,30,47,1547
14682,14682,5198D6FAC22FF152C4DC9F65E0571C59,19811,7,12,5,10,34,534
14683,14683,5198D6FAC22FF152C4DC9F65E0571C59,19031,14,17,3,1,42,92
14684,14684,5198D6FAC22FF152C4DC9F65E0571C59,11151,18,20,2,30,48,1548
14685,14685,5198D6FAC22FF152C4DC9F65E0571C59,10381,21,22,1,31,49,1599
14700,14700,951E4A9F24E81DD7E0BF78CE09FD6CB8,12792,1,3,2,34,30,1730
14701,14701,951E4A9F24E81DD7E0BF78CE09FD6CB8,15191,7,10,3,36,27,1827
14702,14702,951E4A9F24E81DD7E0BF78CE09FD6CB8,15671,11,13,2,37,26,1876
14703,14703,951E4A9F24E81DD7E0BF78CE09FD6CB8,12611,14,22,8,41,29,2079
14711,14711,7A5DEDC7FE052035815232A8310135E2,11151,2,6,4,30,48,1548
14712,14712,7A5DEDC7FE052035815232A8310135E2,41591,10,12,2,34,49,1749
14713,14713,7A5DEDC7FE052035815232A8310135E2,11151,14,22,8,30,48,1548
14718,14718,B671273BF5D0429E749B3B0F044C7639,43751,0,10,10,19,48,998
14719,14719,B671273BF5D0429E749B3B0F044C7639,12581,15,16,1,24,48,1248
14720,14720,B671273BF5D0429E749B3B0F044C7639,11101,20,22,2,18,48,948
14721,14721,6B614428F8D95ECFDE2207017437E97D,19281,0,16,16,16,32,832
14722,14722,6B614428F8D95ECFDE2207017437E97D,12871,17,20,3,22,33,1133
14723,14723,6B614428F8D95ECFDE2207017437E97D,19281,20,23,3,16,32,832
14742,14742,4E6C38500D92199FC31204A2F7E1D475,42601,0,7,7,44,48,2248
14743,14743,4E6C38500D92199FC31204A2F7E1D475,43621,12,13,1,46,48,2348
14744,14744,4E6C38500D92199FC31204A2F7E1D475,13471,14,17,3,47,49,2399
14745,14745,4E6C38500D92199FC31204A2F7E1D475,10191,19,21,2,40,48,2048
14746,14746,4E6C38500D92199FC31204A2F7E1D475,13471,21,23,2,47,49,2399
14747,14747,15AF53FBA0C13FBD61024895398ED2FD,19441,9,14,5,8,46,446
14748,14748,15AF53FBA0C13FBD61024895398ED2FD,11471,14,16,2,12,48,648
14749,14749,15AF53FBA0C13FBD61024895398ED2FD,19441,18,19,1,8,46,446
14754,14754,44AF7E3F6FD3AFD3E254BC36398928E0,43011,8,10,2,40,42,2042
14755,14755,44AF7E3F6FD3AFD3E254BC36398928E0,12561,10,11,1,45,43,2293
14756,14756,44AF7E3F6FD3AFD3E254BC36398928E0,43011,14,15,1,40,42,2042
14757,14757,44AF7E3F6FD3AFD3E254BC36398928E0,12561,16,21,5,45,43,2293
14758,14758,7D7A12F5F833F85A7EE1C422265518C9,11901,0,4,4,42,49,2149
14759,14759,7D7A12F5F833F85A7EE1C422265518C9,42031,5,9,4,40,46,2046
14760,14760,7D7A12F5F833F85A7EE1C422265518C9,11901,12,15,3,42,49,2149
14761,14761,7D7A12F5F833F85A7EE1C422265518C9,40341,18,22,4,23,49,1199
14762,14762,29A3C9E428978BBE2ECF8EB615AF2DD1,11701,0,7,7,43,48,2198
14763,14763,29A3C9E428978BBE2ECF8EB615AF2DD1,11831,8,16,8,32,45,1645
14764,14764,29A3C9E428978BBE2ECF8EB615AF2DD1,10841,18,21,3,37,47,1897
14772,14772,966592CD48E24DD17B5B9C8B94D59F8F,19571,0,5,5,1,36,86
14773,14773,966592CD48E24DD17B5B9C8B94D59F8F,19741,8,17,9,5,44,294
14774,14774,966592CD48E24DD17B5B9C8B94D59F8F,12971,19,23,4,32,48,1648
14782,14782,8671664FCEA72D44791A077CF27C82B3,12921,4,10,6,9,41,491
14783,14783,8671664FCEA72D44791A077CF27C82B3,19901,14,16,2,7,44,394
14784,14784,8671664FCEA72D44791A077CF27C82B3,12921,19,20,1,9,41,491
14785,14785,1771A547345EBA6049CD0156398C7334,12651,1,9,8,43,47,2197
14786,14786,1771A547345EBA6049CD0156398C7334,40341,12,16,4,23,49,1199
14787,14787,1771A547345EBA6049CD0156398C7334,12651,21,22,1,43,47,2197
14788,14788,BDB18D500D8DE6AC2EF56E2D3677B566,42601,0,4,4,44,48,2248
14789,14789,BDB18D500D8DE6AC2EF56E2D3677B566,11701,5,7,2,43,48,2198
14790,14790,BDB18D500D8DE6AC2EF56E2D3677B566,43621,7,9,2,46,48,2348
14791,14791,BDB18D500D8DE6AC2EF56E2D3677B566,11701,9,16,7,43,48,2198
14792,14792,BDB18D500D8DE6AC2EF56E2D3677B566,43621,20,21,1,46,48,2348
14796,14796,0201CE4520382CBCE3D13726ED20CDF3,42633,0,7,7,42,46,2146
14797,14797,0201CE4520382CBCE3D13726ED20CDF3,42321,9,17,8,43,47,2197
14798,14798,0201CE4520382CBCE3D13726ED20CDF3,10161,19,22,3,35,49,1799
14808,14808,559777BBBCD664850DC1E8E7503633C6,42491,6,8,2,32,46,1646
14809,14809,559777BBBCD664850DC1E8E7503633C6,11861,12,18,6,32,47,1647
14810,14810,559777BBBCD664850DC1E8E7503633C6,10351,21,23,2,28,45,1445
14811,14811,D643B7354F0FDC1717D4ED8BF83D5C13,42221,0,6,6,38,48,1948
14812,14812,D643B7354F0FDC1717D4ED8BF83D5C13,11384,8,9,1,30,47,1547
14813,14813,D643B7354F0FDC1717D4ED8BF83D5C13,12514,10,12,2,38,47,1947
14814,14814,D643B7354F0FDC1717D4ED8BF83D5C13,11211,13,16,3,34,49,1749
14815,14815,D643B7354F0FDC1717D4ED8BF83D5C13,10191,18,19,1,40,48,2048
14816,14816,D643B7354F0FDC1717D4ED8BF83D5C13,12514,20,22,2,38,47,1947
14820,14820,7A04A13186C46A4BE6B54AB67E18C35D,10711,0,8,8,29,46,1496
14821,14821,7A04A13186C46A4BE6B54AB67E18C35D,10251,8,18,10,35,47,1797
14822,14822,7A04A13186C46A4BE6B54AB67E18C35D,10711,19,23,4,29,46,1496
14823,14823,2E18E8DF093288689E2805A1F3FB2A40,12921,0,6,6,9,41,491
14824,14824,2E18E8DF093288689E2805A1F3FB2A40,12641,7,12,5,10,43,543
14825,14825,2E18E8DF093288689E2805A1F3FB2A40,12921,13,14,1,9,41,491
14826,14826,2E18E8DF093288689E2805A1F3FB2A40,12641,14,18,4,10,43,543
14827,14827,2E18E8DF093288689E2805A1F3FB2A40,12921,19,20,1,9,41,491
14839,14839,B840292594AF9493A71A59EA7A649385,10544,0,14,14,28,48,1448
14840,14840,B840292594AF9493A71A59EA7A649385,10191,15,16,1,40,48,2048
14841,14841,B840292594AF9493A71A59EA7A649385,10381,18,19,1,31,49,1599
14842,14842,B840292594AF9493A71A59EA7A649385,10544,19,23,4,28,48,1448
14843,14843,E75DBC8FF69066A482B9B403023F9E0C,10281,1,2,1,33,48,1698
14844,14844,E75DBC8FF69066A482B9B403023F9E0C,11521,7,12,5,41,48,2098
14845,14845,E75DBC8FF69066A482B9B403023F9E0C,11291,13,18,5,40,49,2049
14846,14846,7779D5C4E5073D864A9050EB76A5AC64,43341,0,1,1,41,46,2096
14847,14847,7779D5C4E5073D864A9050EB76A5AC64,12211,2,5,3,41,44,2094
14848,14848,7779D5C4E5073D864A9050EB76A5AC64,11261,6,16,10,36,46,1846
14849,14849,7779D5C4E5073D864A9050EB76A5AC64,42864,16,18,2,38,44,1944
14850,14850,7779D5C4E5073D864A9050EB76A5AC64,12211,22,23,1,41,44,2094
14854,14854,2353E24278CC2C352AD768571A17B8C0,19181,0,2,2,8,40,440
14855,14855,2353E24278CC2C352AD768571A17B8C0,12921,2,3,1,9,41,491
14856,14856,2353E24278CC2C352AD768571A17B8C0,19181,4,5,1,8,40,440
14857,14857,2353E24278CC2C352AD768571A17B8C0,12921,7,11,4,9,41,491
14858,14858,2353E24278CC2C352AD768571A17B8C0,49201,18,21,3,7,41,391
14862,14862,4FB7544A1E67AE742452DB3735E5F7CF,10771,0,2,2,41,46,2096
14863,14863,4FB7544A1E67AE742452DB3735E5F7CF,42631,7,10,3,43,45,2195
14864,14864,4FB7544A1E67AE742452DB3735E5F7CF,10751,13,16,3,47,43,2393
14865,14865,4FB7544A1E67AE742452DB3735E5F7CF,10771,21,23,2,41,46,2096
14872,14872,445A90121514A82FCCD431DD3088A581,42921,0,5,5,33,47,1697
14873,14873,445A90121514A82FCCD431DD3088A581,11381,6,7,1,30,47,1547
14874,14874,445A90121514A82FCCD431DD3088A581,11861,11,13,2,32,47,1647
14875,14875,445A90121514A82FCCD431DD3088A581,11381,14,17,3,30,47,1547
14876,14876,445A90121514A82FCCD431DD3088A581,11861,18,23,5,32,47,1647
14891,14891,24CACD73BA8D75767DDD668E5EA165E2,40171,0,6,6,38,48,1948
14892,14892,24CACD73BA8D75767DDD668E5EA165E2,11914,6,10,4,37,48,1898
14893,14893,24CACD73BA8D75767DDD668E5EA165E2,42191,12,13,1,38,49,1949
14894,14894,24CACD73BA8D75767DDD668E5EA165E2,11914,14,16,2,37,48,1898
14895,14895,24CACD73BA8D75767DDD668E5EA165E2,40171,20,22,2,38,48,1948
14896,14896,02985C86D5E4F2BDA0171A63AF0B5416,13601,1,6,5,34,47,1747
14897,14897,02985C86D5E4F2BDA0171A63AF0B5416,10661,8,10,2,37,49,1899
14898,14898,02985C86D5E4F2BDA0171A63AF0B5416,11291,15,18,3,40,49,2049
14899,14899,02985C86D5E4F2BDA0171A63AF0B5416,43731,21,23,2,34,47,1747
14900,14900,E21AB700E8BE04F896E7CA6BA8292DA0,43051,0,13,13,46,45,2345
14901,14901,E21AB700E8BE04F896E7CA6BA8292DA0,42321,14,16,2,43,47,2197
14902,14902,E21AB700E8BE04F896E7CA6BA8292DA0,43051,19,23,4,46,45,2345
14903,14903,27F132E818644D3933B7D51A13F3BE57,15561,0,6,6,32,22,1622
14904,14904,27F132E818644D3933B7D51A13F3BE57,15411,7,9,2,44,27,2227
14905,14905,27F132E818644D3933B7D51A13F3BE57,13691,10,12,2,47,30,2380
14906,14906,27F132E818644D3933B7D51A13F3BE57,15411,12,22,10,44,27,2227
14921,14921,4ACECC2B9EC145419E108C6F4A54C789,10111,0,1,1,37,47,1897
14922,14922,4ACECC2B9EC145419E108C6F4A54C789,11331,2,6,4,37,48,1898
14923,14923,4ACECC2B9EC145419E108C6F4A54C789,10111,6,7,1,37,47,1897
14924,14924,4ACECC2B9EC145419E108C6F4A54C789,10107,13,15,2,38,49,1949
14925,14925,4ACECC2B9EC145419E108C6F4A54C789,42641,19,20,1,33,49,1699
14926,14926,4ACECC2B9EC145419E108C6F4A54C789,10111,21,23,2,37,47,1897
14934,14934,C0EBF471F94BEEDB1281493ACFF571D1,42401,0,8,8,36,47,1847
14935,14935,C0EBF471F94BEEDB1281493ACFF571D1,10921,12,13,1,43,48,2198
14936,14936,C0EBF471F94BEEDB1281493ACFF571D1,42401,18,22,4,36,47,1847
14937,14937,695C901EF582A136C9D913854F549CAF,13671,0,6,6,27,43,1393
14938,14938,695C901EF582A136C9D913854F549CAF,12311,7,9,2,30,44,1544
14939,14939,695C901EF582A136C9D913854F549CAF,15301,12,13,1,35,16,1766
14940,14940,695C901EF582A136C9D913854F549CAF,12311,17,19,2,30,44,1544
14951,14951,71EC48DD21126B9B6A22DDC82F149351,12921,0,1,1,9,41,491
14952,14952,71EC48DD21126B9B6A22DDC82F149351,49201,1,6,5,7,41,391
14953,14953,71EC48DD21126B9B6A22DDC82F149351,12921,7,8,1,9,41,491
14954,14954,71EC48DD21126B9B6A22DDC82F149351,43644,8,20,12,14,38,738
14964,14964,42450E4607B078BD3F39C67BF93F8737,11111,0,9,9,26,48,1348
14965,14965,42450E4607B078BD3F39C67BF93F8737,10451,9,17,8,25,48,1298
14966,14966,42450E4607B078BD3F39C67BF93F8737,10921,20,21,1,43,48,2198
14967,14967,E7C93B58159694942F208F853B794D34,11061,0,9,9,29,48,1498
14968,14968,E7C93B58159694942F208F853B794D34,11751,13,15,2,35,48,1798
14969,14969,E7C93B58159694942F208F853B794D34,11201,17,20,3,35,49,1799
14973,14973,294FB4B8E5D6BF128BF9CA2E5243FA86,10161,0,7,7,35,49,1799
14974,14974,294FB4B8E5D6BF128BF9CA2E5243FA86,11021,9,10,1,36,49,1849
14975,14975,294FB4B8E5D6BF128BF9CA2E5243FA86,40341,15,19,4,23,49,1199
14976,14976,294FB4B8E5D6BF128BF9CA2E5243FA86,10161,22,23,1,35,49,1799
14984,14984,0C97DCA8DB92223AD1C1FF48C921DE74,42151,0,9,9,35,45,1795
14985,14985,0C97DCA8DB92223AD1C1FF48C921DE74,40961,11,12,1,35,47,1797
14986,14986,0C97DCA8DB92223AD1C1FF48C921DE74,42791,14,16,2,35,45,1795
14987,14987,0C97DCA8DB92223AD1C1FF48C921DE74,42371,17,18,1,34,46,1746
14988,14988,0C97DCA8DB92223AD1C1FF48C921DE74,42791,19,23,4,35,45,1795
14989,14989,8E045568FF8161BA0E4C2440787C5906,42623,1,2,1,22,49,1149
14990,14990,8E045568FF8161BA0E4C2440787C5906,42071,6,15,9,31,49,1599
14991,14991,8E045568FF8161BA0E4C2440787C5906,11151,15,16,1,30,48,1548
14992,14992,8E045568FF8161BA0E4C2440787C5906,42071,17,18,1,31,49,1599
14993,14993,8E045568FF8161BA0E4C2440787C5906,11061,19,22,3,29,48,1498
14997,14997,7179E8D23C9EF0FE56A034B0F52DF3EB,42623,0,2,2,22,49,1149
14998,14998,7179E8D23C9EF0FE56A034B0F52DF3EB,42071,4,5,1,31,49,1599
14999,14999,7179E8D23C9EF0FE56A034B0F52DF3EB,42623,6,15,9,22,49,1149
15000,15000,7179E8D23C9EF0FE56A034B0F52DF3EB,42071,15,16,1,31,49,1599
15001,15001,7179E8D23C9EF0FE56A034B0F52DF3EB,42623,16,19,3,22,49,1149
15002,15002,82B9DE1C452C89862B559CE0DF4F04BF,15051,0,14,14,19,4,954
15003,15003,82B9DE1C452C89862B559CE0DF4F04BF,16281,16,17,1,11,4,554
15004,15004,82B9DE1C452C89862B559CE0DF4F04BF,15051,20,21,1,19,4,954
15008,15008,66A1757BF5A4116BA4BCC483D90F56EF,42231,0,4,4,37,46,1896
15009,15009,66A1757BF5A4116BA4BCC483D90F56EF,13911,6,7,1,39,46,1996
15010,15010,66A1757BF5A4116BA4BCC483D90F56EF,42351,9,10,1,38,45,1945
15011,15011,66A1757BF5A4116BA4BCC483D90F56EF,42231,11,20,9,37,46,1896
15012,15012,66A1757BF5A4116BA4BCC483D90F56EF,13911,21,22,1,39,46,1996
15013,15013,C332ACE59D95C5B7ACA16A093B91D4F8,13111,0,7,7,42,46,2146
15014,15014,C332ACE59D95C5B7ACA16A093B91D4F8,13101,8,11,3,40,47,2047
15015,15015,C332ACE59D95C5B7ACA16A093B91D4F8,13111,13,14,1,42,46,2146
15016,15016,C332ACE59D95C5B7ACA16A093B91D4F8,13101,15,17,2,40,47,2047
15017,15017,C332ACE59D95C5B7ACA16A093B91D4F8,11481,18,22,4,41,48,2098
15033,15033,C187A81AAFCBF70010CE2E6903736025,42201,0,8,8,43,46,2196
15034,15034,C187A81AAFCBF70010CE2E6903736025,10841,9,14,5,37,47,1897
15035,15035,C187A81AAFCBF70010CE2E6903736025,42201,18,20,2,43,46,2196
15036,15036,47844E829FCB05D6E87386BF9A1380C3,11941,0,6,6,37,46,1896
15037,15037,47844E829FCB05D6E87386BF9A1380C3,42011,8,9,1,36,46,1846
15038,15038,47844E829FCB05D6E87386BF9A1380C3,13711,12,14,2,38,46,1946
15039,15039,47844E829FCB05D6E87386BF9A1380C3,42011,15,18,3,36,46,1846
15040,15040,47844E829FCB05D6E87386BF9A1380C3,13711,18,19,1,38,46,1946
15041,15041,47844E829FCB05D6E87386BF9A1380C3,11941,22,23,1,37,46,1896
15057,15057,409EAD533DBB4CABE595F1357EB3A959,12141,1,2,1,42,45,2145
15058,15058,409EAD533DBB4CABE595F1357EB3A959,13341,5,6,1,44,45,2245
15059,15059,409EAD533DBB4CABE595F1357EB3A959,12141,6,14,8,42,45,2145
15060,15060,409EAD533DBB4CABE595F1357EB3A959,13341,14,17,3,44,45,2245
15061,15061,409EAD533DBB4CABE595F1357EB3A959,12141,21,23,2,42,45,2145
15062,15062,E5C4755AFC51366337D03EAE045AEE36,42161,2,10,8,36,47,1847
15063,15063,E5C4755AFC51366337D03EAE045AEE36,10251,14,17,3,35,47,1797
15064,15064,E5C4755AFC51366337D03EAE045AEE36,11031,18,20,2,42,49,2149
15065,15065,E5C4755AFC51366337D03EAE045AEE36,10151,21,23,2,34,47,1747
15072,15072,EA84EDCB7C9475F6273168934FDD6476,19441,0,6,6,8,46,446
15073,15073,EA84EDCB7C9475F6273168934FDD6476,11571,6,7,1,13,46,696
15074,15074,EA84EDCB7C9475F6273168934FDD6476,19441,7,23,16,8,46,446
15075,15075,EFBA511A9214E44A04294E91909F8240,13271,0,8,8,41,47,2097
15076,15076,EFBA511A9214E44A04294E91909F8240,10107,11,12,1,38,49,1949
15077,15077,EFBA511A9214E44A04294E91909F8240,13271,20,23,3,41,47,2097
15078,15078,03400E70232608A9491D68EE417E3691,11901,0,7,7,42,49,2149
15079,15079,03400E70232608A9491D68EE417E3691,42301,9,12,3,36,47,1847
15080,15080,03400E70232608A9491D68EE417E3691,10921,13,14,1,43,48,2198
15081,15081,03400E70232608A9491D68EE417E3691,42511,15,18,3,37,47,1897
15082,15082,525655B30753832E11A6455806FEB5D9,40094,0,6,6,29,48,1498
15083,15083,525655B30753832E11A6455806FEB5D9,13711,8,18,10,38,46,1946
15084,15084,525655B30753832E11A6455806FEB5D9,40094,21,23,2,29,48,1498
15088,15088,2647CD53C4F29CF005CC10771DDB3434,42071,10,11,1,31,49,1599
15089,15089,2647CD53C4F29CF005CC10771DDB3434,42121,13,15,2,26,49,1349
15090,15090,2647CD53C4F29CF005CC10771DDB3434,42261,17,19,2,25,49,1299
15091,15091,9D7E28E179E5F5D009F8D277D0F434A8,11861,0,5,5,32,47,1647
15092,15092,9D7E28E179E5F5D009F8D277D0F434A8,10591,9,11,2,39,48,1998
15093,15093,9D7E28E179E5F5D009F8D277D0F434A8,11861,12,23,11,32,47,1647
15100,15100,92E1BAA88B052422B820ED36A9E8F107,41392,0,6,6,43,48,2198
15101,15101,92E1BAA88B052422B820ED36A9E8F107,10471,7,8,1,37,48,1898
15102,15102,92E1BAA88B052422B820ED36A9E8F107,41392,10,14,4,43,48,2198
15103,15103,92E1BAA88B052422B820ED36A9E8F107,11271,15,16,1,37,48,1898
15104,15104,92E1BAA88B052422B820ED36A9E8F107,41392,19,23,4,43,48,2198
15105,15105,109CB2916F99E237684BCDD444B32C17,42321,0,15,15,43,47,2197
15106,15106,109CB2916F99E237684BCDD444B32C17,40341,17,20,3,23,49,1199
15107,15107,109CB2916F99E237684BCDD444B32C17,42321,21,23,2,43,47,2197
15112,15112,31C99BE35DAA7CC1D9A6D662CA3683F3,10841,1,14,13,37,47,1897
15113,15113,31C99BE35DAA7CC1D9A6D662CA3683F3,42523,15,16,1,31,47,1597
15114,15114,31C99BE35DAA7CC1D9A6D662CA3683F3,42331,18,19,1,39,46,1996
15115,15115,0C2E73493B95B864220B3E14F6C11E84,13314,0,7,7,31,39,1589
15116,15116,0C2E73493B95B864220B3E14F6C11E84,12521,8,9,1,35,41,1791
15117,15117,0C2E73493B95B864220B3E14F6C11E84,13314,9,23,14,31,39,1589
15122,15122,BDB346E741102B8FC6463AA30347FAF0,13821,0,1,1,49,45,2495
15123,15123,BDB346E741102B8FC6463AA30347FAF0,12561,14,16,2,45,43,2293
15124,15124,BDB346E741102B8FC6463AA30347FAF0,43951,20,22,2,49,41,2491
15128,15128,32E472ABE1AC8EE5712784968711993D,42623,2,7,5,22,49,1149
15129,15129,32E472ABE1AC8EE5712784968711993D,10721,8,10,2,31,48,1598
15130,15130,32E472ABE1AC8EE5712784968711993D,10251,12,13,1,35,47,1797
15131,15131,32E472ABE1AC8EE5712784968711993D,10721,15,17,2,31,48,1598
15132,15132,32E472ABE1AC8EE5712784968711993D,12511,19,20,1,39,47,1997
15133,15133,32E472ABE1AC8EE5712784968711993D,42623,21,23,2,22,49,1149
15134,15134,2FE3A658AB2B7A9048527F74C274D683,19024,3,4,1,9,45,495
15135,15135,2FE3A658AB2B7A9048527F74C274D683,19621,8,9,1,5,46,296
15136,15136,2FE3A658AB2B7A9048527F74C274D683,19024,11,17,6,9,45,495
15137,15137,2FE3A658AB2B7A9048527F74C274D683,42041,18,22,4,10,47,547
15138,15138,BC1C4C76663B580E82BC58287DEF604A,19281,0,8,8,16,32,832
15139,15139,BC1C4C76663B580E82BC58287DEF604A,11321,12,15,3,31,46,1596
15140,15140,BC1C4C76663B580E82BC58287DEF604A,19281,19,23,4,16,32,832
15145,15145,E962C3D0A8FC163364DD770DFBF0ADE9,11381,1,6,5,30,47,1547
15146,15146,E962C3D0A8FC163364DD770DFBF0ADE9,41591,8,15,7,34,49,1749
15147,15147,E962C3D0A8FC163364DD770DFBF0ADE9,10951,19,23,4,29,48,1498
15148,15148,F004825C5EEC7F8B7A184D4985895C55,13341,0,6,6,44,45,2245
15149,15149,F004825C5EEC7F8B7A184D4985895C55,42631,8,10,2,43,45,2195
15150,15150,F004825C5EEC7F8B7A184D4985895C55,13341,11,12,1,44,45,2245
15151,15151,F004825C5EEC7F8B7A184D4985895C55,42631,12,18,6,43,45,2195
15152,15152,F004825C5EEC7F8B7A184D4985895C55,13341,19,20,1,44,45,2245
15156,15156,43125D201B2090874D2E0EE6E6251F06,10111,3,9,6,37,47,1897
15157,15157,43125D201B2090874D2E0EE6E6251F06,10491,11,13,2,33,48,1698
15158,15158,43125D201B2090874D2E0EE6E6251F06,10111,14,17,3,37,47,1897
15159,15159,43125D201B2090874D2E0EE6E6251F06,10491,17,21,4,33,48,1698
15164,15164,34A498ECBF094B1655F6385A2FF4F5D2,11361,0,14,14,22,48,1148
15165,15165,34A498ECBF094B1655F6385A2FF4F5D2,11871,14,16,2,29,46,1496
15166,15166,34A498ECBF094B1655F6385A2FF4F5D2,11361,20,22,2,22,48,1148
15167,15167,F49EE04071D0B4FCCD4263F4C2BBEA7A,10681,0,6,6,30,48,1548
15168,15168,F49EE04071D0B4FCCD4263F4C2BBEA7A,11061,7,9,2,29,48,1498
15169,15169,F49EE04071D0B4FCCD4263F4C2BBEA7A,43761,10,12,2,32,47,1647
15170,15170,F49EE04071D0B4FCCD4263F4C2BBEA7A,12121,13,15,2,29,47,1497
15171,15171,F49EE04071D0B4FCCD4263F4C2BBEA7A,11061,16,23,7,29,48,1498
15172,15172,A6EF3AA52D2C883DD4C8A6E9BED0EE14,19901,0,5,5,7,44,394
15173,15173,A6EF3AA52D2C883DD4C8A6E9BED0EE14,12641,13,15,2,10,43,543
15174,15174,A6EF3AA52D2C883DD4C8A6E9BED0EE14,43021,18,23,5,16,43,843
15178,15178,4A05C11F924E5E77EEF26908B87D29D6,12031,0,6,6,33,48,1698
15179,15179,4A05C11F924E5E77EEF26908B87D29D6,12521,7,18,11,35,41,1791
15180,15180,4A05C11F924E5E77EEF26908B87D29D6,10881,19,23,4,34,48,1748
15185,15185,1C0548F40841AD0870DAD8EC7BECCBC6,13314,0,9,9,31,39,1589
15186,15186,1C0548F40841AD0870DAD8EC7BECCBC6,12521,10,11,1,35,41,1791
15187,15187,1C0548F40841AD0870DAD8EC7BECCBC6,13314,12,13,1,31,39,1589
15188,15188,1C0548F40841AD0870DAD8EC7BECCBC6,12521,14,16,2,35,41,1791
15189,15189,1C0548F40841AD0870DAD8EC7BECCBC6,13314,16,23,7,31,39,1589
15190,15190,E648A6F090A3BE85617E0ED54A73B4F0,12601,0,14,14,25,47,1297
15191,15191,E648A6F090A3BE85617E0ED54A73B4F0,12671,14,16,2,21,43,1093
15192,15192,E648A6F090A3BE85617E0ED54A73B4F0,12601,17,23,6,25,47,1297
15196,15196,B47F00E3E65AD07AA5A04965B3865285,43001,0,3,3,47,47,2397
15197,15197,B47F00E3E65AD07AA5A04965B3865285,43051,3,5,2,46,45,2345
15198,15198,B47F00E3E65AD07AA5A04965B3865285,43001,5,11,6,47,47,2397
15199,15199,B47F00E3E65AD07AA5A04965B3865285,11701,12,14,2,43,48,2198
15200,15200,B47F00E3E65AD07AA5A04965B3865285,42461,14,17,3,45,47,2297
15201,15201,B47F00E3E65AD07AA5A04965B3865285,43001,18,19,1,47,47,2397
15202,15202,65E419942CB504CDF61BED9B8F0B09E8,42351,0,5,5,38,45,1945
15203,15203,65E419942CB504CDF61BED9B8F0B09E8,13911,9,10,1,39,46,1996
15204,15204,65E419942CB504CDF61BED9B8F0B09E8,11381,14,16,2,30,47,1547
15205,15205,65E419942CB504CDF61BED9B8F0B09E8,42351,19,22,3,38,45,1945
15206,15206,66713B1DAC647B9BD111992FF8161912,11861,0,9,9,32,47,1647
15207,15207,66713B1DAC647B9BD111992FF8161912,42401,11,13,2,36,47,1847
15208,15208,66713B1DAC647B9BD111992FF8161912,40341,16,18,2,23,49,1199
15209,15209,66713B1DAC647B9BD111992FF8161912,11861,21,22,1,32,47,1647
15210,15210,2F66AC01887397A198C9CCA6611EA97B,12521,0,7,7,35,41,1791
15211,15211,2F66AC01887397A198C9CCA6611EA97B,13314,8,11,3,31,39,1589
15212,15212,2F66AC01887397A198C9CCA6611EA97B,12521,11,13,2,35,41,1791
15213,15213,2F66AC01887397A198C9CCA6611EA97B,13314,13,16,3,31,39,1589
15214,15214,2F66AC01887397A198C9CCA6611EA97B,43451,17,19,2,37,40,1890
15215,15215,2F66AC01887397A198C9CCA6611EA97B,12521,19,23,4,35,41,1791
15216,15216,A534FD7E51A551BE3196665029DD0400,19931,1,6,5,7,43,393
15217,15217,A534FD7E51A551BE3196665029DD0400,12641,7,16,9,10,43,543
15218,15218,A534FD7E51A551BE3196665029DD0400,19031,17,18,1,1,42,92
15219,15219,D88849FA1A4DDD432CB00E2B446B0C1A,40171,0,1,1,38,48,1948
15220,15220,D88849FA1A4DDD432CB00E2B446B0C1A,11461,2,3,1,37,49,1899
15221,15221,D88849FA1A4DDD432CB00E2B446B0C1A,40171,3,7,4,38,48,1948
15222,15222,D88849FA1A4DDD432CB00E2B446B0C1A,10107,13,14,1,38,49,1949
15223,15223,D88849FA1A4DDD432CB00E2B446B0C1A,11231,17,23,6,37,49,1899
15224,15224,7A429FD41560380E083A133973949DE2,42151,9,10,1,35,45,1795
15225,15225,7A429FD41560380E083A133973949DE2,10281,12,13,1,33,48,1698
15226,15226,7A429FD41560380E083A133973949DE2,12311,15,17,2,30,44,1544
15227,15227,7A429FD41560380E083A133973949DE2,42151,19,21,2,35,45,1795
15228,15228,290CF9B7E8E39B2A6D619522168B66C7,19441,0,7,7,8,46,446
15229,15229,290CF9B7E8E39B2A6D619522168B66C7,11201,9,11,2,35,49,1799
15230,15230,290CF9B7E8E39B2A6D619522168B66C7,10951,15,16,1,29,48,1498
15231,15231,290CF9B7E8E39B2A6D619522168B66C7,19441,18,23,5,8,46,446
15235,15235,0ACD42FBA28A767F44D73783967C8C23,10731,0,8,8,33,47,1697
15236,15236,0ACD42FBA28A767F44D73783967C8C23,10491,11,12,1,33,48,1698
15237,15237,0ACD42FBA28A767F44D73783967C8C23,42201,17,23,6,43,46,2196
15238,15238,4C277ABE9AAFFACC84B539B0700C1F48,43671,5,7,2,35,48,1798
15239,15239,4C277ABE9AAFFACC84B539B0700C1F48,10881,8,9,1,34,48,1748
15240,15240,4C277ABE9AAFFACC84B539B0700C1F48,10221,10,11,1,34,49,1749
15241,15241,4C277ABE9AAFFACC84B539B0700C1F48,12401,13,14,1,39,49,1999
15242,15242,4C277ABE9AAFFACC84B539B0700C1F48,43671,15,23,8,35,48,1798
15243,15243,29B536EE93C2E266619D50C15F53EE29,42531,0,6,6,31,45,1595
15244,15244,29B536EE93C2E266619D50C15F53EE29,12311,7,8,1,30,44,1544
15245,15245,29B536EE93C2E266619D50C15F53EE29,42531,8,13,5,31,45,1595
15246,15246,29B536EE93C2E266619D50C15F53EE29,12311,13,19,6,30,44,1544
15247,15247,29B536EE93C2E266619D50C15F53EE29,42531,20,22,2,31,45,1595
15248,15248,9442AAEA05C831A2075E8352FC15EF6E,43361,0,7,7,38,48,1948
15249,15249,9442AAEA05C831A2075E8352FC15EF6E,10351,10,11,1,28,45,1445
15250,15250,9442AAEA05C831A2075E8352FC15EF6E,10191,14,17,3,40,48,2048
15251,15251,9442AAEA05C831A2075E8352FC15EF6E,42941,18,21,3,37,47,1897
15252,15252,9442AAEA05C831A2075E8352FC15EF6E,10191,21,23,2,40,48,2048
15253,15253,9BBBC00C93BA6A3176E2B008E6F8A88E,42351,0,5,5,38,45,1945
15254,15254,9BBBC00C93BA6A3176E2B008E6F8A88E,11261,10,11,1,36,46,1846
15255,15255,9BBBC00C93BA6A3176E2B008E6F8A88E,42351,12,13,1,38,45,1945
15256,15256,9BBBC00C93BA6A3176E2B008E6F8A88E,11261,13,18,5,36,46,1846
15257,15257,9BBBC00C93BA6A3176E2B008E6F8A88E,42351,20,23,3,38,45,1945
15258,15258,C9CAC2C6335B37B2CDE3F43D7A7F9A91,42071,1,8,7,31,49,1599
15259,15259,C9CAC2C6335B37B2CDE3F43D7A7F9A91,42121,9,10,1,26,49,1349
15260,15260,C9CAC2C6335B37B2CDE3F43D7A7F9A91,42071,15,23,8,31,49,1599
15261,15261,8E04CA34920941791B1B2D80E2E36134,43581,0,10,10,33,48,1698
15262,15262,8E04CA34920941791B1B2D80E2E36134,10221,10,13,3,34,49,1749
15263,15263,8E04CA34920941791B1B2D80E2E36134,16071,15,19,4,3,3,153
15264,15264,EE107F15123C6DB132974358298F51B4,42583,0,6,6,40,48,2048
15265,15265,EE107F15123C6DB132974358298F51B4,40171,7,8,1,38,48,1948
15266,15266,EE107F15123C6DB132974358298F51B4,42583,12,13,1,40,48,2048
15267,15267,EE107F15123C6DB132974358298F51B4,10471,13,16,3,37,48,1898
15268,15268,EE107F15123C6DB132974358298F51B4,11291,20,21,1,40,49,2049
15269,15269,5DC656AE1F755A21D4CE0049D29039D4,12521,2,5,3,35,41,1791
15270,15270,5DC656AE1F755A21D4CE0049D29039D4,11261,8,20,12,36,46,1846
15271,15271,5DC656AE1F755A21D4CE0049D29039D4,12491,22,23,1,36,43,1843
15272,15272,247667C3836D06BFE77381F6E8AF78B9,13561,0,9,9,37,49,1899
15273,15273,247667C3836D06BFE77381F6E8AF78B9,10681,11,12,1,30,48,1548
15274,15274,247667C3836D06BFE77381F6E8AF78B9,10121,15,18,3,36,49,1849
15275,15275,247667C3836D06BFE77381F6E8AF78B9,11751,19,20,1,35,48,1798
15276,15276,247667C3836D06BFE77381F6E8AF78B9,13561,22,23,1,37,49,1899
15277,15277,A796809FFC26797F0B17A0B66E102B15,12521,8,10,2,35,41,1791
15278,15278,A796809FFC26797F0B17A0B66E102B15,13314,11,13,2,31,39,1589
15279,15279,A796809FFC26797F0B17A0B66E102B15,12521,13,16,3,35,41,1791
15280,15280,A796809FFC26797F0B17A0B66E102B15,13314,18,23,5,31,39,1589
15284,15284,76DA946F4DC1318DD46A32E1D303D6B7,12521,0,13,13,35,41,1791
15285,15285,76DA946F4DC1318DD46A32E1D303D6B7,13314,15,17,2,31,39,1589
15286,15286,76DA946F4DC1318DD46A32E1D303D6B7,12521,19,23,4,35,41,1791
15290,15290,9508FAE0B774FCD97D7CFB3C4BD72215,10251,3,6,3,35,47,1797
15291,15291,9508FAE0B774FCD97D7CFB3C4BD72215,42401,7,8,1,36,47,1847
15292,15292,9508FAE0B774FCD97D7CFB3C4BD72215,10111,11,14,3,37,47,1897
15293,15293,9508FAE0B774FCD97D7CFB3C4BD72215,42401,14,16,2,36,47,1847
15294,15294,9508FAE0B774FCD97D7CFB3C4BD72215,43971,18,20,2,30,48,1548
15295,15295,9508FAE0B774FCD97D7CFB3C4BD72215,10111,21,22,1,37,47,1897
15296,15296,DE69FEBC50432F9871EF62D07F7A5C1A,43021,0,2,2,16,43,843
15297,15297,DE69FEBC50432F9871EF62D07F7A5C1A,43644,3,5,2,14,38,738
15298,15298,DE69FEBC50432F9871EF62D07F7A5C1A,12921,6,7,1,9,41,491
15299,15299,DE69FEBC50432F9871EF62D07F7A5C1A,19181,8,10,2,8,40,440
15300,15300,DE69FEBC50432F9871EF62D07F7A5C1A,12921,14,15,1,9,41,491
15301,15301,DE69FEBC50432F9871EF62D07F7A5C1A,19181,18,20,2,8,40,440
15310,15310,04D73C3CD00D40CB611F6BA5801F802C,13314,0,13,13,31,39,1589
15311,15311,04D73C3CD00D40CB611F6BA5801F802C,12521,13,18,5,35,41,1791
15312,15312,04D73C3CD00D40CB611F6BA5801F802C,13314,19,23,4,31,39,1589
15313,15313,FF16D1104349162E539969031BE39A02,12511,0,7,7,39,47,1997
15314,15314,FF16D1104349162E539969031BE39A02,11074,9,11,2,37,47,1897
15315,15315,FF16D1104349162E539969031BE39A02,43481,12,13,1,39,48,1998
15316,15316,FF16D1104349162E539969031BE39A02,11074,17,18,1,37,47,1897
15317,15317,FF16D1104349162E539969031BE39A02,12511,19,21,2,39,47,1997
15325,15325,22300DEAB3F7A20A2F8DD7892A11C5B7,13271,0,5,5,41,47,2097
15326,15326,22300DEAB3F7A20A2F8DD7892A11C5B7,13101,8,10,2,40,47,2047
15327,15327,22300DEAB3F7A20A2F8DD7892A11C5B7,13271,11,16,5,41,47,2097
15328,15328,22300DEAB3F7A20A2F8DD7892A11C5B7,13101,19,20,1,40,47,2047
15329,15329,22300DEAB3F7A20A2F8DD7892A11C5B7,13271,21,22,1,41,47,2097
15330,15330,6697EF3151447D6C0998533B5EF897A0,43061,0,9,9,43,46,2196
15331,15331,6697EF3151447D6C0998533B5EF897A0,40341,14,16,2,23,49,1199
15332,15332,6697EF3151447D6C0998533B5EF897A0,12021,18,20,2,37,49,1899
15333,15333,BA6F089745133CF8740BC4E2A6BEA3D0,10251,0,6,6,35,47,1797
15334,15334,BA6F089745133CF8740BC4E2A6BEA3D0,12641,8,11,3,10,43,543
15335,15335,BA6F089745133CF8740BC4E2A6BEA3D0,11324,12,15,3,31,46,1596
15336,15336,BA6F089745133CF8740BC4E2A6BEA3D0,12641,17,19,2,10,43,543
15337,15337,BA6F089745133CF8740BC4E2A6BEA3D0,11324,20,21,1,31,46,1596
15338,15338,BA6F089745133CF8740BC4E2A6BEA3D0,10251,22,23,1,35,47,1797
15349,15349,84C94B2F533ED609B0C2666E73EA3142,13271,0,8,8,41,47,2097
15350,15350,84C94B2F533ED609B0C2666E73EA3142,11481,9,11,2,41,48,2098
15351,15351,84C94B2F533ED609B0C2666E73EA3142,13271,12,18,6,41,47,2097
15352,15352,84C94B2F533ED609B0C2666E73EA3142,11074,19,20,1,37,47,1897
15353,15353,84C94B2F533ED609B0C2666E73EA3142,13271,21,23,2,41,47,2097
15357,15357,FB6D357AE6E744B7566081ADA8598AEB,13601,1,6,5,34,47,1747
15358,15358,FB6D357AE6E744B7566081ADA8598AEB,11231,10,12,2,37,49,1899
15359,15359,FB6D357AE6E744B7566081ADA8598AEB,40463,16,18,2,38,49,1949
15360,15360,FB6D357AE6E744B7566081ADA8598AEB,13511,20,23,3,34,48,1748
15371,15371,9526CA84048ECDF651C5107129654F39,15145,0,1,1,22,9,1109
15372,15372,9526CA84048ECDF651C5107129654F39,16151,5,6,1,13,11,661
15373,15373,9526CA84048ECDF651C5107129654F39,15145,6,16,10,22,9,1109
15374,15374,9526CA84048ECDF651C5107129654F39,16151,17,19,2,13,11,661
15375,15375,9526CA84048ECDF651C5107129654F39,15145,20,21,1,22,9,1109
15376,15376,986C13A2F12ECE50CC64AF03E0A89D1C,10251,3,4,1,35,47,1797
15377,15377,986C13A2F12ECE50CC64AF03E0A89D1C,40891,6,11,5,37,47,1897
15378,15378,986C13A2F12ECE50CC64AF03E0A89D1C,10251,11,16,5,35,47,1797
15379,15379,986C13A2F12ECE50CC64AF03E0A89D1C,40891,17,18,1,37,47,1897
15380,15380,986C13A2F12ECE50CC64AF03E0A89D1C,10251,19,21,2,35,47,1797
15381,15381,986C13A2F12ECE50CC64AF03E0A89D1C,19901,22,23,1,7,44,394
15385,15385,2D9F8EEE0946858BEC66856CB73B8335,43021,0,5,5,16,43,843
15386,15386,2D9F8EEE0946858BEC66856CB73B8335,12921,6,11,5,9,41,491
15387,15387,2D9F8EEE0946858BEC66856CB73B8335,43021,11,12,1,16,43,843
15388,15388,2D9F8EEE0946858BEC66856CB73B8335,12641,13,15,2,10,43,543
15389,15389,2D9F8EEE0946858BEC66856CB73B8335,12921,15,17,2,9,41,491
15390,15390,2D9F8EEE0946858BEC66856CB73B8335,43021,20,21,1,16,43,843
15398,15398,E09A2EB70E1320F8C58EBB2C4083C66B,43471,0,15,15,31,49,1599
15399,15399,E09A2EB70E1320F8C58EBB2C4083C66B,40341,17,18,1,23,49,1199
15400,15400,E09A2EB70E1320F8C58EBB2C4083C66B,13221,20,22,2,40,47,2047
15404,15404,0E91A13D0E931F32EE1FFD96FA252798,13071,0,5,5,41,41,2091
15405,15405,0E91A13D0E931F32EE1FFD96FA252798,42151,8,10,2,35,45,1795
15406,15406,0E91A13D0E931F32EE1FFD96FA252798,42381,11,13,2,39,41,1991
15407,15407,0E91A13D0E931F32EE1FFD96FA252798,13071,17,18,1,41,41,2091
15408,15408,0E91A13D0E931F32EE1FFD96FA252798,42381,22,23,1,39,41,1991
15409,15409,720CFC4D793CA18FCEEE4B9594DF2FC9,10634,2,6,4,27,45,1395
15410,15410,720CFC4D793CA18FCEEE4B9594DF2FC9,12311,6,17,11,30,44,1544
15411,15411,720CFC4D793CA18FCEEE4B9594DF2FC9,11631,20,21,1,12,49,649
15412,15412,4D7F9A766459E315716EA1D053BCDCF8,13121,10,12,2,38,46,1946
15413,15413,4D7F9A766459E315716EA1D053BCDCF8,13671,14,18,4,27,43,1393
15414,15414,4D7F9A766459E315716EA1D053BCDCF8,11281,18,19,1,27,40,1390
15415,15415,4D7F9A766459E315716EA1D053BCDCF8,13671,21,23,2,27,43,1393
15416,15416,9ECA5557B94DDF8D494B58216329A377,42861,0,2,2,37,44,1894
15417,15417,9ECA5557B94DDF8D494B58216329A377,12561,6,7,1,45,43,2293
15418,15418,9ECA5557B94DDF8D494B58216329A377,11261,11,21,10,36,46,1846
15422,15422,23E7B51B197B2F53A6762756E4AC5287,42961,0,1,1,35,49,1799
15423,15423,23E7B51B197B2F53A6762756E4AC5287,12083,1,6,5,36,49,1849
15424,15424,23E7B51B197B2F53A6762756E4AC5287,11231,6,8,2,37,49,1899
15425,15425,23E7B51B197B2F53A6762756E4AC5287,10171,10,13,3,26,47,1347
15426,15426,23E7B51B197B2F53A6762756E4AC5287,12083,16,18,2,36,49,1849
15427,15427,23E7B51B197B2F53A6762756E4AC5287,11731,21,22,1,36,48,1848
15428,15428,29A10B3B101101DB07C47BDDEB2A90CA,19021,0,5,5,10,45,545
15429,15429,29A10B3B101101DB07C47BDDEB2A90CA,12641,7,8,1,10,43,543
15430,15430,29A10B3B101101DB07C47BDDEB2A90CA,19021,8,13,5,10,45,545
15431,15431,29A10B3B101101DB07C47BDDEB2A90CA,12641,15,17,2,10,43,543
15432,15432,29A10B3B101101DB07C47BDDEB2A90CA,10716,19,23,4,30,46,1546
15436,15436,F6C54C668FECD237DA87E4FC2243153A,42321,0,7,7,43,47,2197
15437,15437,F6C54C668FECD237DA87E4FC2243153A,11171,11,15,4,33,48,1698
15438,15438,F6C54C668FECD237DA87E4FC2243153A,12083,16,17,1,36,49,1849
15439,15439,F6C54C668FECD237DA87E4FC2243153A,42321,19,23,4,43,47,2197
15440,15440,D504F11B753A6CDDB38F05E0EF1C7A74,12401,0,7,7,39,49,1999
15441,15441,D504F11B753A6CDDB38F05E0EF1C7A74,11211,9,11,2,34,49,1749
15442,15442,D504F11B753A6CDDB38F05E0EF1C7A74,10191,11,13,2,40,48,2048
15443,15443,D504F11B753A6CDDB38F05E0EF1C7A74,11011,17,23,6,39,49,1999
15444,15444,9FD07F08B957B9919E73D64BBF49A52F,11771,0,9,9,39,49,1999
15445,15445,9FD07F08B957B9919E73D64BBF49A52F,10531,10,18,8,34,46,1746
15446,15446,9FD07F08B957B9919E73D64BBF49A52F,10107,19,20,1,38,49,1949
15457,15457,2DF13F3C6B51FEAFB9527CE1523C2712,11381,3,4,1,30,47,1547
15458,15458,2DF13F3C6B51FEAFB9527CE1523C2712,10951,7,10,3,29,48,1498
15459,15459,2DF13F3C6B51FEAFB9527CE1523C2712,12121,12,13,1,29,47,1497
15460,15460,2DF13F3C6B51FEAFB9527CE1523C2712,10951,16,18,2,29,48,1498
15461,15461,2DF13F3C6B51FEAFB9527CE1523C2712,11381,22,23,1,30,47,1547
15462,15462,7D8BB90B66B5BB302B836A7DB354A71B,11701,4,7,3,43,48,2198
15463,15463,7D8BB90B66B5BB302B836A7DB354A71B,42321,7,8,1,43,47,2197
15464,15464,7D8BB90B66B5BB302B836A7DB354A71B,42601,11,14,3,44,48,2248
15465,15465,7D8BB90B66B5BB302B836A7DB354A71B,42321,19,21,2,43,47,2197
15466,15466,7D8BB90B66B5BB302B836A7DB354A71B,11701,21,23,2,43,48,2198
15467,15467,EEB3CBC85DF19031E292162C06516E43,11381,0,7,7,30,47,1547
15468,15468,EEB3CBC85DF19031E292162C06516E43,10471,8,12,4,37,48,1898
15469,15469,EEB3CBC85DF19031E292162C06516E43,11381,13,18,5,30,47,1547
15470,15470,EEB3CBC85DF19031E292162C06516E43,11461,19,22,3,37,49,1899
15471,15471,809F6F59669EDEB4346F30E73D2BDABC,11001,0,5,5,42,47,2147
15472,15472,809F6F59669EDEB4346F30E73D2BDABC,19181,6,8,2,8,40,440
15473,15473,809F6F59669EDEB4346F30E73D2BDABC,12921,9,15,6,9,41,491
15474,15474,809F6F59669EDEB4346F30E73D2BDABC,19181,17,18,1,8,40,440
15475,15475,809F6F59669EDEB4346F30E73D2BDABC,12921,19,21,2,9,41,491
15476,15476,75625607897F7FC887EF2F1E9DD1385B,12131,0,7,7,32,47,1647
15477,15477,75625607897F7FC887EF2F1E9DD1385B,10421,15,16,1,41,48,2098
15478,15478,75625607897F7FC887EF2F1E9DD1385B,12131,17,23,6,32,47,1647
15488,15488,7C11C7CBC4724062CEFCE060A70E0F2E,12921,0,1,1,9,41,491
15489,15489,7C11C7CBC4724062CEFCE060A70E0F2E,12641,3,9,6,10,43,543
15490,15490,7C11C7CBC4724062CEFCE060A70E0F2E,12921,9,12,3,9,41,491
15491,15491,7C11C7CBC4724062CEFCE060A70E0F2E,12641,12,17,5,10,43,543
15492,15492,7C11C7CBC4724062CEFCE060A70E0F2E,10634,21,22,1,27,45,1395
15503,15503,B0FBA72251F80516E1A92D1893B7FB04,11061,0,6,6,29,48,1498
15504,15504,B0FBA72251F80516E1A92D1893B7FB04,10901,8,11,3,35,48,1798
15505,15505,B0FBA72251F80516E1A92D1893B7FB04,11061,15,18,3,29,48,1498
15506,15506,73381E155E915C2154F0DF9BC7F8768B,19181,9,10,1,8,40,440
15507,15507,73381E155E915C2154F0DF9BC7F8768B,43644,12,19,7,14,38,738
15508,15508,73381E155E915C2154F0DF9BC7F8768B,19244,20,21,1,1,43,93
15509,15509,891B28D5D9AD2C3E234CB17E4EAA69A2,11021,1,13,12,36,49,1849
15510,15510,891B28D5D9AD2C3E234CB17E4EAA69A2,40341,18,19,1,23,49,1199
15511,15511,891B28D5D9AD2C3E234CB17E4EAA69A2,11021,21,23,2,36,49,1849
15519,15519,0CE1530259EA66797A9FEEF237D2664E,42861,0,5,5,37,44,1894
15520,15520,0CE1530259EA66797A9FEEF237D2664E,11261,6,11,5,36,46,1846
15521,15521,0CE1530259EA66797A9FEEF237D2664E,42861,11,13,2,37,44,1894
15522,15522,0CE1530259EA66797A9FEEF237D2664E,11261,15,16,1,36,46,1846
15523,15523,0CE1530259EA66797A9FEEF237D2664E,42861,21,23,2,37,44,1894
15528,15528,E978944605FAE9C6CFC8A2DA156237C6,11551,0,7,7,39,49,1999
15529,15529,E978944605FAE9C6CFC8A2DA156237C6,43731,9,19,10,34,47,1747
15530,15530,E978944605FAE9C6CFC8A2DA156237C6,11551,21,23,2,39,49,1999
15531,15531,2F8CA12038D8BFDAC42D43FF94213821,13071,0,1,1,41,41,2091
15532,15532,2F8CA12038D8BFDAC42D43FF94213821,42381,1,3,2,39,41,1991
15533,15533,2F8CA12038D8BFDAC42D43FF94213821,43451,6,11,5,37,40,1890
15534,15534,2F8CA12038D8BFDAC42D43FF94213821,42381,11,13,2,39,41,1991
15535,15535,2F8CA12038D8BFDAC42D43FF94213821,43451,14,15,1,37,40,1890
15536,15536,2F8CA12038D8BFDAC42D43FF94213821,13071,15,16,1,41,41,2091
15537,15537,2F8CA12038D8BFDAC42D43FF94213821,42381,18,23,5,39,41,1991
15538,15538,583602182C31C8E2D985404EA5592339,12641,0,6,6,10,43,543
15539,15539,583602182C31C8E2D985404EA5592339,12921,6,8,2,9,41,491
15540,15540,583602182C31C8E2D985404EA5592339,43021,8,9,1,16,43,843
15541,15541,583602182C31C8E2D985404EA5592339,12921,13,20,7,9,41,491
15551,15551,E572D34D15CCFF06895D9E2C410E6273,42531,8,11,3,31,45,1595
15552,15552,E572D34D15CCFF06895D9E2C410E6273,13671,14,18,4,27,43,1393
15553,15553,E572D34D15CCFF06895D9E2C410E6273,43281,20,21,1,37,48,1898
15554,15554,CF06C225EF0C180ED354BF85B6BDA68F,12083,0,8,8,36,49,1849
15555,15555,CF06C225EF0C180ED354BF85B6BDA68F,11875,10,11,1,30,46,1546
15556,15556,CF06C225EF0C180ED354BF85B6BDA68F,40171,13,14,1,38,48,1948
15557,15557,CF06C225EF0C180ED354BF85B6BDA68F,11231,15,21,6,37,49,1899
15558,15558,E1B4D34F30518B1001C1CE57EBC5ED84,19351,0,12,12,2,18,118
15559,15559,E1B4D34F30518B1001C1CE57EBC5ED84,16233,13,14,1,5,15,265
15560,15560,E1B4D34F30518B1001C1CE57EBC5ED84,19351,15,23,8,2,18,118
15561,15561,015977F21CA69DACA3E876A5F028B2A4,43051,0,5,5,46,45,2345
15562,15562,015977F21CA69DACA3E876A5F028B2A4,13351,6,9,3,48,48,2448
15563,15563,015977F21CA69DACA3E876A5F028B2A4,43051,12,14,2,46,45,2345
15564,15564,015977F21CA69DACA3E876A5F028B2A4,13351,15,19,4,48,48,2448
15565,15565,015977F21CA69DACA3E876A5F028B2A4,43051,19,23,4,46,45,2345
15566,15566,AFB26E028A7D364AA3096B94F4E293F5,43761,0,5,5,32,47,1647
15567,15567,AFB26E028A7D364AA3096B94F4E293F5,11061,6,7,1,29,48,1498
15568,15568,AFB26E028A7D364AA3096B94F4E293F5,43761,11,13,2,32,47,1647
15569,15569,AFB26E028A7D364AA3096B94F4E293F5,42523,16,18,2,31,47,1597
15570,15570,AFB26E028A7D364AA3096B94F4E293F5,43761,18,21,3,32,47,1647
15610,15610,3E3400E81F33727D0845365703B2CDF7,40271,0,6,6,35,49,1799
15611,15611,3E3400E81F33727D0845365703B2CDF7,10924,8,17,9,43,49,2199
15612,15612,3E3400E81F33727D0845365703B2CDF7,42961,20,23,3,35,49,1799
15613,15613,4CFDB5043250FF070F11A4B75FA25717,10681,1,9,8,30,48,1548
15614,15614,4CFDB5043250FF070F11A4B75FA25717,19901,12,13,1,7,44,394
15615,15615,4CFDB5043250FF070F11A4B75FA25717,19111,16,18,2,9,45,495
15616,15616,4CFDB5043250FF070F11A4B75FA25717,12641,20,23,3,10,43,543
15617,15617,C67AD33695FBB59FE91EDDED93659237,42071,0,6,6,31,49,1599
15618,15618,C67AD33695FBB59FE91EDDED93659237,11331,7,15,8,37,48,1898
15619,15619,C67AD33695FBB59FE91EDDED93659237,11151,19,20,1,30,48,1548
15620,15620,EAC1D4A2CA6BC033BCE82C152098CC16,10471,10,18,8,37,48,1898
15621,15621,EAC1D4A2CA6BC033BCE82C152098CC16,42021,19,20,1,33,47,1697
15622,15622,EAC1D4A2CA6BC033BCE82C152098CC16,40211,21,23,2,36,49,1849
15623,15623,CBC8159D1FCA35AFB9DA003A5F4078C2,10301,0,7,7,31,45,1595
15624,15624,CBC8159D1FCA35AFB9DA003A5F4078C2,11834,8,9,1,32,45,1645
15625,15625,CBC8159D1FCA35AFB9DA003A5F4078C2,11061,9,10,1,29,48,1498
15626,15626,CBC8159D1FCA35AFB9DA003A5F4078C2,10301,11,18,7,31,45,1595
15627,15627,CBC8159D1FCA35AFB9DA003A5F4078C2,10531,19,21,2,34,46,1746
15628,15628,CBC8159D1FCA35AFB9DA003A5F4078C2,10301,22,23,1,31,45,1595
15629,15629,B400ACFA7232ADC3897E9004784F9482,12491,0,4,4,36,43,1843
15630,15630,B400ACFA7232ADC3897E9004784F9482,11261,6,10,4,36,46,1846
15631,15631,B400ACFA7232ADC3897E9004784F9482,12491,11,13,2,36,43,1843
15632,15632,B400ACFA7232ADC3897E9004784F9482,11261,15,16,1,36,46,1846
15633,15633,B400ACFA7232ADC3897E9004784F9482,13911,17,18,1,39,46,1996
15634,15634,B400ACFA7232ADC3897E9004784F9482,11261,19,21,2,36,46,1846
15635,15635,B400ACFA7232ADC3897E9004784F9482,12491,22,23,1,36,43,1843
15639,15639,601A51EA671623E5E466F858B3908746,10811,0,8,8,38,46,1946
15640,15640,601A51EA671623E5E466F858B3908746,10711,9,12,3,29,46,1496
15641,15641,601A51EA671623E5E466F858B3908746,12311,13,16,3,30,44,1544
15642,15642,601A51EA671623E5E466F858B3908746,13231,18,23,5,39,46,1996
15647,15647,B20D4CCCBBF9B534BB9F26A35B371E4C,11261,0,6,6,36,46,1846
15648,15648,B20D4CCCBBF9B534BB9F26A35B371E4C,10716,6,19,13,30,46,1546
15649,15649,B20D4CCCBBF9B534BB9F26A35B371E4C,11941,22,23,1,37,46,1896
15656,15656,E87A7725DB262F856F03D1312FDD2DD2,11531,10,11,1,34,49,1749
15657,15657,E87A7725DB262F856F03D1312FDD2DD2,11381,11,14,3,30,47,1547
15658,15658,E87A7725DB262F856F03D1312FDD2DD2,13314,17,20,3,31,39,1589
15659,15659,E87A7725DB262F856F03D1312FDD2DD2,12521,20,21,1,35,41,1791
15660,15660,6F7C6FCFD5043C0C2B8E10FFFF215E35,11841,0,7,7,33,46,1696
15661,15661,6F7C6FCFD5043C0C2B8E10FFFF215E35,12971,8,15,7,32,48,1648
15662,15662,6F7C6FCFD5043C0C2B8E10FFFF215E35,11954,16,17,1,32,49,1649
15663,15663,6F7C6FCFD5043C0C2B8E10FFFF215E35,10151,17,20,3,34,47,1747
15664,15664,6F7C6FCFD5043C0C2B8E10FFFF215E35,11841,21,23,2,33,46,1696
15665,15665,4E8CF0BE1A57E085938ED2B5916A9E34,11381,0,10,10,30,47,1547
15666,15666,4E8CF0BE1A57E085938ED2B5916A9E34,12051,15,16,1,20,47,1047
15667,15667,4E8CF0BE1A57E085938ED2B5916A9E34,11381,18,23,5,30,47,1547
15668,15668,F898B34C9FF3D681FFA1363A321CF375,42121,5,11,6,26,49,1349
15669,15669,F898B34C9FF3D681FFA1363A321CF375,42071,11,18,7,31,49,1599
15670,15670,F898B34C9FF3D681FFA1363A321CF375,11151,20,21,1,30,48,1548
15674,15674,9C8BA0F939DCC59D680DA02C98D88E8C,40124,4,10,6,38,47,1947
15675,15675,9C8BA0F939DCC59D680DA02C98D88E8C,40341,13,15,2,23,49,1199
15676,15676,9C8BA0F939DCC59D680DA02C98D88E8C,13781,18,21,3,48,32,2432
15680,15680,132DC2D4D5508D268FAA7D78222C6AF6,12514,0,7,7,38,47,1947
15681,15681,132DC2D4D5508D268FAA7D78222C6AF6,11481,9,11,2,41,48,2098
15682,15682,132DC2D4D5508D268FAA7D78222C6AF6,12514,12,15,3,38,47,1947
15683,15683,132DC2D4D5508D268FAA7D78222C6AF6,42231,17,18,1,37,46,1896
15684,15684,132DC2D4D5508D268FAA7D78222C6AF6,40123,22,23,1,38,47,1947
15685,15685,2FCEA8AFEE1EB24BBCF386268B1232AC,11161,1,2,1,32,48,1648
15686,15686,2FCEA8AFEE1EB24BBCF386268B1232AC,43311,3,4,1,31,48,1598
15687,15687,2FCEA8AFEE1EB24BBCF386268B1232AC,11061,7,11,4,29,48,1498
15688,15688,2FCEA8AFEE1EB24BBCF386268B1232AC,43311,19,20,1,31,48,1598
15689,15689,2FCEA8AFEE1EB24BBCF386268B1232AC,11161,21,23,2,32,48,1648
15690,15690,5FE1FAD559F6843700A0AA1D01D08561,13441,0,9,9,39,39,1989
15691,15691,5FE1FAD559F6843700A0AA1D01D08561,13071,11,12,1,41,41,2091
15692,15692,5FE1FAD559F6843700A0AA1D01D08561,12491,16,22,6,36,43,1843
15693,15693,5FE1FAD559F6843700A0AA1D01D08561,13441,22,23,1,39,39,1989
15697,15697,249DB118F8CB4071CDCAC383CAA1C5DB,19021,0,10,10,10,45,545
15698,15698,249DB118F8CB4071CDCAC383CAA1C5DB,12641,13,15,2,10,43,543
15699,15699,249DB118F8CB4071CDCAC383CAA1C5DB,11324,19,21,2,31,46,1596
15700,15700,249DB118F8CB4071CDCAC383CAA1C5DB,10716,21,23,2,30,46,1546
15701,15701,AB6EA8E0EB921375D4ACF50883707DA2,41721,0,8,8,39,48,1998
15702,15702,AB6EA8E0EB921375D4ACF50883707DA2,43581,9,10,1,33,48,1698
15703,15703,AB6EA8E0EB921375D4ACF50883707DA2,10681,11,13,2,30,48,1548
15704,15704,AB6EA8E0EB921375D4ACF50883707DA2,11211,16,18,2,34,49,1749
15708,15708,50673603A4E10F5F55E83AA75E1A8A25,10691,0,7,7,33,48,1698
15709,15709,50673603A4E10F5F55E83AA75E1A8A25,13561,9,10,1,37,49,1899
15710,15710,50673603A4E10F5F55E83AA75E1A8A25,11021,13,18,5,36,49,1849
15711,15711,50673603A4E10F5F55E83AA75E1A8A25,10691,19,23,4,33,48,1698
15716,15716,D256AE34DD31744D7365602849D9C40A,42491,0,7,7,32,46,1646
15717,15717,D256AE34DD31744D7365602849D9C40A,10351,11,13,2,28,45,1445
15718,15718,D256AE34DD31744D7365602849D9C40A,12971,16,18,2,32,48,1648
15719,15719,D256AE34DD31744D7365602849D9C40A,42491,19,23,4,32,46,1646
15723,15723,1DD07CF7FD5B3CCCB4E85025836774E4,11074,0,7,7,37,47,1897
15724,15724,1DD07CF7FD5B3CCCB4E85025836774E4,11231,8,9,1,37,49,1899
15725,15725,1DD07CF7FD5B3CCCB4E85025836774E4,13601,11,13,2,34,47,1747
15726,15726,1DD07CF7FD5B3CCCB4E85025836774E4,10371,13,18,5,37,49,1899
15727,15727,1DD07CF7FD5B3CCCB4E85025836774E4,10221,19,23,4,34,49,1749
15731,15731,0CED0A2998E753C043314DC59E2912AD,15114,0,4,4,22,16,1116
15732,15732,0CED0A2998E753C043314DC59E2912AD,16151,9,18,9,13,11,661
15733,15733,0CED0A2998E753C043314DC59E2912AD,15114,18,19,1,22,16,1116
15737,15737,6D63FF8A3FC1EAB372239FB0BF4A8ABC,11701,0,6,6,43,48,2198
15738,15738,6D63FF8A3FC1EAB372239FB0BF4A8ABC,10221,12,13,1,34,49,1749
15739,15739,6D63FF8A3FC1EAB372239FB0BF4A8ABC,11701,17,21,4,43,48,2198
15744,15744,22E0CD429C1B1E7AC6170F90C318BE33,40833,0,4,4,41,47,2097
15745,15745,22E0CD429C1B1E7AC6170F90C318BE33,43951,7,17,10,49,41,2491
15746,15746,22E0CD429C1B1E7AC6170F90C318BE33,40833,20,22,2,41,47,2097
15747,15747,CACCA958326BD145289AA6A855FE199B,43971,0,14,14,30,48,1548
15748,15748,CACCA958326BD145289AA6A855FE199B,11061,14,17,3,29,48,1498
15749,15749,CACCA958326BD145289AA6A855FE199B,43971,17,19,2,30,48,1548
15750,15750,CACCA958326BD145289AA6A855FE199B,11381,20,21,1,30,47,1547
15751,15751,CACCA958326BD145289AA6A855FE199B,43971,22,23,1,30,48,1548
15756,15756,7A7AEC35AE07D4110F6099DB218EF80C,10211,0,5,5,16,49,849
15757,15757,7A7AEC35AE07D4110F6099DB218EF80C,19021,8,9,1,10,45,545
15758,15758,7A7AEC35AE07D4110F6099DB218EF80C,11631,12,13,1,12,49,649
15759,15759,7A7AEC35AE07D4110F6099DB218EF80C,19021,16,18,2,10,45,545
15763,15763,7011DE96B440B54BDA505351983BAF85,12511,1,3,2,39,47,1997
15764,15764,7011DE96B440B54BDA505351983BAF85,11021,4,9,5,36,49,1849
15765,15765,7011DE96B440B54BDA505351983BAF85,10281,12,14,2,33,48,1698
15766,15766,7011DE96B440B54BDA505351983BAF85,11074,19,20,1,37,47,1897
15767,15767,7011DE96B440B54BDA505351983BAF85,40691,21,22,1,42,48,2148
15768,15768,52B9AC42F2D3553A53178CAD04C97C10,11861,1,6,5,32,47,1647
15769,15769,52B9AC42F2D3553A53178CAD04C97C10,40302,11,12,1,40,49,2049
15770,15770,52B9AC42F2D3553A53178CAD04C97C10,11861,18,23,5,32,47,1647
15778,15778,22DF08AB8625FB5CE36A655BC50A3649,40271,0,9,9,35,49,1799
15779,15779,22DF08AB8625FB5CE36A655BC50A3649,10721,14,17,3,31,48,1598
15780,15780,22DF08AB8625FB5CE36A655BC50A3649,40271,17,21,4,35,49,1799
15785,15785,AC63A44AAFE297AD4CD776B1B1348D18,12401,0,2,2,39,49,1999
15786,15786,AC63A44AAFE297AD4CD776B1B1348D18,42801,2,7,5,40,49,2049
15787,15787,AC63A44AAFE297AD4CD776B1B1348D18,10061,9,10,1,20,46,1046
15788,15788,AC63A44AAFE297AD4CD776B1B1348D18,12601,10,17,7,25,47,1297
15789,15789,AC63A44AAFE297AD4CD776B1B1348D18,12401,20,23,3,39,49,1999
15790,15790,13A7164293FF85790DE95E7876757302,42301,1,3,2,36,47,1847
15791,15791,13A7164293FF85790DE95E7876757302,13121,5,6,1,38,46,1946
15792,15792,13A7164293FF85790DE95E7876757302,42401,11,12,1,36,47,1847
15793,15793,13A7164293FF85790DE95E7876757302,10251,14,15,1,35,47,1797
15794,15794,13A7164293FF85790DE95E7876757302,11381,19,20,1,30,47,1547
15798,15798,4F3F717E93BC5AFE00C4421DCBF0AA01,13331,0,1,1,38,47,1947
15799,15799,4F3F717E93BC5AFE00C4421DCBF0AA01,42301,3,9,6,36,47,1847
15800,15800,4F3F717E93BC5AFE00C4421DCBF0AA01,11261,10,11,1,36,46,1846
15801,15801,4F3F717E93BC5AFE00C4421DCBF0AA01,42864,12,13,1,38,44,1944
15802,15802,4F3F717E93BC5AFE00C4421DCBF0AA01,11261,16,18,2,36,46,1846
15809,15809,0942BC2E54584A0B9A30A5F1D2A5E60D,41382,0,8,8,38,49,1949
15810,15810,0942BC2E54584A0B9A30A5F1D2A5E60D,10971,9,11,2,35,47,1797
15811,15811,0942BC2E54584A0B9A30A5F1D2A5E60D,10161,15,17,2,35,49,1799
15812,15812,0942BC2E54584A0B9A30A5F1D2A5E60D,11794,18,19,1,38,49,1949
15813,15813,A0C13743AF441FE8099AA940DA71C612,42581,0,5,5,38,48,1948
15814,15814,A0C13743AF441FE8099AA940DA71C612,11914,6,7,1,37,48,1898
15815,15815,A0C13743AF441FE8099AA940DA71C612,42581,8,9,1,38,48,1948
15816,15816,A0C13743AF441FE8099AA940DA71C612,11914,10,11,1,37,48,1898
15817,15817,A0C13743AF441FE8099AA940DA71C612,42581,13,22,9,38,48,1948
15818,15818,FC2CF44FB72CAD842657734968AC0CF0,13121,3,9,6,38,46,1946
15819,15819,FC2CF44FB72CAD842657734968AC0CF0,42523,10,12,2,31,47,1597
15820,15820,FC2CF44FB72CAD842657734968AC0CF0,10295,13,16,3,30,47,1547
15821,15821,FC2CF44FB72CAD842657734968AC0CF0,11751,18,19,1,35,48,1798
15828,15828,802D06E8811CDC65FDAB61E1A1D233B3,12601,0,7,7,25,47,1297
15829,15829,802D06E8811CDC65FDAB61E1A1D233B3,10501,8,9,1,22,46,1146
15830,15830,802D06E8811CDC65FDAB61E1A1D233B3,10691,11,18,7,33,48,1698
15831,15831,802D06E8811CDC65FDAB61E1A1D233B3,12601,20,21,1,25,47,1297
15832,15832,7EA63201A47B68AA085BD7B8AF1F7767,10721,0,7,7,31,48,1598
15833,15833,7EA63201A47B68AA085BD7B8AF1F7767,11231,9,11,2,37,49,1899
15834,15834,7EA63201A47B68AA085BD7B8AF1F7767,12083,14,17,3,36,49,1849
15835,15835,7EA63201A47B68AA085BD7B8AF1F7767,10721,19,23,4,31,48,1598
15850,15850,A8DFAF39A5A26AE1BCD9E9DE060BB315,11091,0,6,6,29,47,1497
15851,15851,A8DFAF39A5A26AE1BCD9E9DE060BB315,13651,7,8,1,30,47,1547
15852,15852,A8DFAF39A5A26AE1BCD9E9DE060BB315,11091,12,13,1,29,47,1497
15853,15853,A8DFAF39A5A26AE1BCD9E9DE060BB315,13651,16,17,1,30,47,1547
15854,15854,A8DFAF39A5A26AE1BCD9E9DE060BB315,11091,20,23,3,29,47,1497
15858,15858,770D33585063FE6255D25F568AC2B71E,40322,0,8,8,38,46,1946
15859,15859,770D33585063FE6255D25F568AC2B71E,42381,10,11,1,39,41,1991
15860,15860,770D33585063FE6255D25F568AC2B71E,40322,14,16,2,38,46,1946
15861,15861,770D33585063FE6255D25F568AC2B71E,42511,19,21,2,37,47,1897
15865,15865,3C0CB34A7E303948C8918CC6F892568C,10351,4,5,1,28,45,1445
15866,15866,3C0CB34A7E303948C8918CC6F892568C,13094,5,7,2,21,42,1092
15867,15867,3C0CB34A7E303948C8918CC6F892568C,12601,9,18,9,25,47,1297
15868,15868,24237E27D9EEEAC3116058CCA99BD0CC,42301,0,9,9,36,47,1847
15869,15869,24237E27D9EEEAC3116058CCA99BD0CC,40341,11,15,4,23,49,1199
15870,15870,24237E27D9EEEAC3116058CCA99BD0CC,42301,16,18,2,36,47,1847
15871,15871,6B4552856E8DB02B578DC06A6F8A2C2E,13351,0,1,1,48,48,2448
15872,15872,6B4552856E8DB02B578DC06A6F8A2C2E,42341,2,6,4,43,49,2199
15873,15873,6B4552856E8DB02B578DC06A6F8A2C2E,13351,6,8,2,48,48,2448
15874,15874,6B4552856E8DB02B578DC06A6F8A2C2E,13471,14,18,4,47,49,2399
15875,15875,6B4552856E8DB02B578DC06A6F8A2C2E,12401,19,21,2,39,49,1999
15876,15876,6B4552856E8DB02B578DC06A6F8A2C2E,13471,22,23,1,47,49,2399
15888,15888,FCF6425DA3F542476DF1F93935C075D8,42581,0,4,4,38,48,1948
15889,15889,FCF6425DA3F542476DF1F93935C075D8,11914,5,12,7,37,48,1898
15890,15890,FCF6425DA3F542476DF1F93935C075D8,42581,12,13,1,38,48,1948
15891,15891,FCF6425DA3F542476DF1F93935C075D8,11914,13,20,7,37,48,1898
15892,15892,FCF6425DA3F542476DF1F93935C075D8,42581,21,23,2,38,48,1948
15893,15893,B8EDEC6F665DEB478D0B21F34D151949,11074,0,1,1,37,47,1897
15894,15894,B8EDEC6F665DEB478D0B21F34D151949,13711,2,14,12,38,46,1946
15895,15895,B8EDEC6F665DEB478D0B21F34D151949,43311,16,18,2,31,48,1598
15896,15896,B8EDEC6F665DEB478D0B21F34D151949,11331,19,21,2,37,48,1898
15900,15900,A02E7FCD783D3B9FF6BA938561F51C11,42161,0,7,7,36,47,1847
15901,15901,A02E7FCD783D3B9FF6BA938561F51C11,10411,10,11,1,36,48,1848
15902,15902,A02E7FCD783D3B9FF6BA938561F51C11,42161,11,17,6,36,47,1847
15903,15903,A02E7FCD783D3B9FF6BA938561F51C11,12401,18,20,2,39,49,1999
15904,15904,A02E7FCD783D3B9FF6BA938561F51C11,42161,21,23,2,36,47,1847
15908,15908,4EE541C2C77ED64C3476846B8EC5E510,19431,7,10,3,8,29,429
15909,15909,4EE541C2C77ED64C3476846B8EC5E510,43121,14,15,1,25,27,1277
15910,15910,4EE541C2C77ED64C3476846B8EC5E510,19801,16,17,1,19,26,976
15911,15911,4EE541C2C77ED64C3476846B8EC5E510,43121,17,18,1,25,27,1277
15912,15912,1A64F5A3A265770889AAFFB5978121E9,42581,0,5,5,38,48,1948
15913,15913,1A64F5A3A265770889AAFFB5978121E9,11914,6,7,1,37,48,1898
15914,15914,1A64F5A3A265770889AAFFB5978121E9,42581,7,9,2,38,48,1948
15915,15915,1A64F5A3A265770889AAFFB5978121E9,11914,13,18,5,37,48,1898
15916,15916,1A64F5A3A265770889AAFFB5978121E9,42581,18,19,1,38,48,1948
15917,15917,1A64F5A3A265770889AAFFB5978121E9,11914,21,22,1,37,48,1898
15918,15918,64125BF70ADD2A9D2C91BE766AA2E78E,19741,2,6,4,5,44,294
15919,15919,64125BF70ADD2A9D2C91BE766AA2E78E,43971,8,10,2,30,48,1548
15920,15920,64125BF70ADD2A9D2C91BE766AA2E78E,11091,12,15,3,29,47,1497
15921,15921,64125BF70ADD2A9D2C91BE766AA2E78E,11261,17,19,2,36,46,1846
15922,15922,64125BF70ADD2A9D2C91BE766AA2E78E,13911,21,23,2,39,46,1996
15923,15923,EA1FD587726044750D83B82036123867,10191,0,8,8,40,48,2048
15924,15924,EA1FD587726044750D83B82036123867,11201,12,13,1,35,49,1799
15925,15925,EA1FD587726044750D83B82036123867,10231,15,18,3,39,49,1999
15926,15926,EA1FD587726044750D83B82036123867,42981,20,21,1,36,49,1849
15927,15927,EA1FD587726044750D83B82036123867,10191,22,23,1,40,48,2048
15931,15931,BA64D53C3FD12B453D14A89E7C99F093,10121,0,18,18,36,49,1849
15932,15932,BA64D53C3FD12B453D14A89E7C99F093,42623,18,20,2,22,49,1149
15933,15933,BA64D53C3FD12B453D14A89E7C99F093,12391,20,23,3,36,49,1849
15934,15934,B0CA59461CE535DA6C80DC6682EBEAFB,42271,0,6,6,40,47,2047
15935,15935,B0CA59461CE535DA6C80DC6682EBEAFB,40302,8,13,5,40,49,2049
15936,15936,B0CA59461CE535DA6C80DC6682EBEAFB,42271,14,15,1,40,47,2047
15937,15937,B0CA59461CE535DA6C80DC6682EBEAFB,11806,18,20,2,41,48,2098
15938,15938,B0CA59461CE535DA6C80DC6682EBEAFB,42271,20,23,3,40,47,2047
15939,15939,9F569681847AE1CB91DC5B95636EE88A,43021,0,10,10,16,43,843
15940,15940,9F569681847AE1CB91DC5B95636EE88A,19021,11,12,1,10,45,545
15941,15941,9F569681847AE1CB91DC5B95636EE88A,43021,13,17,4,16,43,843
15942,15942,9F569681847AE1CB91DC5B95636EE88A,11571,18,22,4,13,46,696
15943,15943,55F334EAF14C20A5AD710FF917E4B5BE,10841,0,11,11,37,47,1897
15944,15944,55F334EAF14C20A5AD710FF917E4B5BE,40341,12,18,6,23,49,1199
15945,15945,55F334EAF14C20A5AD710FF917E4B5BE,41021,20,23,3,38,47,1947
15949,15949,70E2D3595A1F4194CEF2CB5EBABB4C04,42523,0,4,4,31,47,1597
15950,15950,70E2D3595A1F4194CEF2CB5EBABB4C04,10716,9,10,1,30,46,1546
15951,15951,70E2D3595A1F4194CEF2CB5EBABB4C04,11321,11,12,1,31,46,1596
15952,15952,70E2D3595A1F4194CEF2CB5EBABB4C04,10716,15,19,4,30,46,1546
15953,15953,70E2D3595A1F4194CEF2CB5EBABB4C04,11324,20,22,2,31,46,1596
15958,15958,372314F0C809B847488F9056CCABB4D8,11001,0,3,3,42,47,2147
15959,15959,372314F0C809B847488F9056CCABB4D8,42321,3,5,2,43,47,2197
15960,15960,372314F0C809B847488F9056CCABB4D8,11001,6,7,1,42,47,2147
15961,15961,372314F0C809B847488F9056CCABB4D8,42321,8,9,1,43,47,2197
15962,15962,372314F0C809B847488F9056CCABB4D8,11001,11,21,10,42,47,2147
15963,15963,372314F0C809B847488F9056CCABB4D8,13941,21,23,2,41,47,2097
15967,15967,4B5119258FB3482B746B53277561992F,12601,6,7,1,25,47,1297
15968,15968,4B5119258FB3482B746B53277561992F,12051,7,19,12,20,47,1047
15969,15969,4B5119258FB3482B746B53277561992F,12581,20,21,1,24,48,1248
15970,15970,F5358205EE42099278B1C2EB33370E43,11061,0,1,1,29,48,1498
15971,15971,F5358205EE42099278B1C2EB33370E43,10681,3,4,1,30,48,1548
15972,15972,F5358205EE42099278B1C2EB33370E43,11061,4,5,1,29,48,1498
15973,15973,F5358205EE42099278B1C2EB33370E43,10681,6,10,4,30,48,1548
15974,15974,F5358205EE42099278B1C2EB33370E43,43311,12,13,1,31,48,1598
15975,15975,F5358205EE42099278B1C2EB33370E43,11061,13,21,8,29,48,1498
15979,15979,05986B1809FB5416951C16256229A152,42871,0,14,14,30,45,1545
15980,15980,05986B1809FB5416951C16256229A152,11531,16,17,1,34,49,1749
15981,15981,05986B1809FB5416951C16256229A152,42871,18,23,5,30,45,1545
15985,15985,A2FF2B3E007AEF697BBECF6D3F01B855,43021,3,6,3,16,43,843
15986,15986,A2FF2B3E007AEF697BBECF6D3F01B855,19021,6,8,2,10,45,545
15987,15987,A2FF2B3E007AEF697BBECF6D3F01B855,19111,11,12,1,9,45,495
15988,15988,A2FF2B3E007AEF697BBECF6D3F01B855,19021,12,22,10,10,45,545
15989,15989,6219AC88F04CB481B6A8F6B3653B0A84,10251,0,14,14,35,47,1797
15990,15990,6219AC88F04CB481B6A8F6B3653B0A84,42161,14,15,1,36,47,1847
15991,15991,6219AC88F04CB481B6A8F6B3653B0A84,11834,18,19,1,32,45,1645
15992,15992,6219AC88F04CB481B6A8F6B3653B0A84,10251,19,23,4,35,47,1797
16003,16003,B0EA338E7DC6DCA36F1815FAB86B9F0C,11921,0,9,9,38,48,1948
16004,16004,B0EA338E7DC6DCA36F1815FAB86B9F0C,42021,12,14,2,33,47,1697
16005,16005,B0EA338E7DC6DCA36F1815FAB86B9F0C,11861,16,19,3,32,47,1647
16010,16010,249945D8BC225A84B9C0C3C523B07C14,42381,0,3,3,39,41,1991
16011,16011,249945D8BC225A84B9C0C3C523B07C14,43011,3,4,1,40,42,2042
16012,16012,249945D8BC225A84B9C0C3C523B07C14,42381,5,6,1,39,41,1991
16013,16013,249945D8BC225A84B9C0C3C523B07C14,43451,8,10,2,37,40,1890
16014,16014,249945D8BC225A84B9C0C3C523B07C14,42381,10,23,13,39,41,1991
16015,16015,E93D8B02977789FF5BDAF0EE317471D5,10451,0,7,7,25,48,1298
16016,16016,E93D8B02977789FF5BDAF0EE317471D5,12311,9,10,1,30,44,1544
16017,16017,E93D8B02977789FF5BDAF0EE317471D5,10451,12,14,2,25,48,1298
16018,16018,E93D8B02977789FF5BDAF0EE317471D5,10151,18,23,5,34,47,1747
16022,16022,8E4E3B8CC467E6685A8CD2583B19D550,42121,5,8,3,26,49,1349
16023,16023,8E4E3B8CC467E6685A8CD2583B19D550,11151,11,13,2,30,48,1548
16024,16024,8E4E3B8CC467E6685A8CD2583B19D550,42623,18,19,1,22,49,1149
16025,16025,753369D691B504B9F7186B2CDF290F06,12792,2,6,4,34,30,1730
16026,16026,753369D691B504B9F7186B2CDF290F06,15391,6,9,3,35,26,1776
16027,16027,753369D691B504B9F7186B2CDF290F06,12791,11,14,3,31,29,1579
16028,16028,753369D691B504B9F7186B2CDF290F06,12792,15,18,3,34,30,1730
16029,16029,753369D691B504B9F7186B2CDF290F06,15391,21,22,1,35,26,1776
16030,16030,9E8454E3BE651FEBAAD2CFCFB76D7A82,11381,0,7,7,30,47,1547
16031,16031,9E8454E3BE651FEBAAD2CFCFB76D7A82,10221,8,14,6,34,49,1749
16032,16032,9E8454E3BE651FEBAAD2CFCFB76D7A82,42021,15,20,5,33,47,1697
16036,16036,A0789D196E09A69B6C595A0BD8CA3F11,43011,0,6,6,40,42,2042
16037,16037,A0789D196E09A69B6C595A0BD8CA3F11,40341,8,12,4,23,49,1199
16038,16038,A0789D196E09A69B6C595A0BD8CA3F11,43011,13,23,10,40,42,2042
16039,16039,6CC3FE89A8F1A15E71D203BFCADF8D3A,11701,0,6,6,43,48,2198
16040,16040,6CC3FE89A8F1A15E71D203BFCADF8D3A,10251,7,9,2,35,47,1797
16041,16041,6CC3FE89A8F1A15E71D203BFCADF8D3A,42161,10,16,6,36,47,1847
16042,16042,6CC3FE89A8F1A15E71D203BFCADF8D3A,10251,16,19,3,35,47,1797
16046,16046,CD087EF03F5E42C11EA6EA79A0BD17AC,11781,0,8,8,38,49,1949
16047,16047,CD087EF03F5E42C11EA6EA79A0BD17AC,13941,11,12,1,41,47,2097
16048,16048,CD087EF03F5E42C11EA6EA79A0BD17AC,11781,14,18,4,38,49,1949
16049,16049,CD087EF03F5E42C11EA6EA79A0BD17AC,43361,19,20,1,38,48,1948
16050,16050,CD087EF03F5E42C11EA6EA79A0BD17AC,10107,21,23,2,38,49,1949
16051,16051,42008AB0CA0A64BB6F1B6C2B7646E140,10811,8,10,2,38,46,1946
16052,16052,42008AB0CA0A64BB6F1B6C2B7646E140,13911,12,13,1,39,46,1996
16053,16053,42008AB0CA0A64BB6F1B6C2B7646E140,10811,14,16,2,38,46,1946
16054,16054,42008AB0CA0A64BB6F1B6C2B7646E140,42081,17,19,2,24,49,1249
16059,16059,72272CDC285000236363EA14A7DE70DE,42161,0,14,14,36,47,1847
16060,16060,72272CDC285000236363EA14A7DE70DE,13791,19,21,2,42,47,2147
16061,16061,72272CDC285000236363EA14A7DE70DE,43341,21,23,2,41,46,2096
16062,16062,7FA34DD33C166FEB0F0038FF695A5604,11571,1,6,5,13,46,696
16063,16063,7FA34DD33C166FEB0F0038FF695A5604,11324,7,9,2,31,46,1596
16064,16064,7FA34DD33C166FEB0F0038FF695A5604,10171,13,23,10,26,47,1347
16065,16065,5ED8949BAC5CDF05EDA1019FB7CA4B17,42401,0,9,9,36,47,1847
16066,16066,5ED8949BAC5CDF05EDA1019FB7CA4B17,42941,11,13,2,37,47,1897
16067,16067,5ED8949BAC5CDF05EDA1019FB7CA4B17,10471,14,18,4,37,48,1898
16068,16068,5ED8949BAC5CDF05EDA1019FB7CA4B17,42191,19,20,1,38,49,1949
16069,16069,5ED8949BAC5CDF05EDA1019FB7CA4B17,42941,21,22,1,37,47,1897
16084,16084,A282F8B8C498C4B735512F5B780D9B09,11061,0,11,11,29,48,1498
16085,16085,A282F8B8C498C4B735512F5B780D9B09,10491,14,16,2,33,48,1698
16086,16086,A282F8B8C498C4B735512F5B780D9B09,43731,18,19,1,34,47,1747
16093,16093,B40C23F05DF669D1A7928A9352D650F2,13511,1,8,7,34,48,1748
16094,16094,B40C23F05DF669D1A7928A9352D650F2,43481,12,13,1,39,48,1998
16095,16095,B40C23F05DF669D1A7928A9352D650F2,11021,18,20,2,36,49,1849
16096,16096,42B28AE3CCE12BA9A899758E7A189C34,11806,0,8,8,41,48,2098
16097,16097,42B28AE3CCE12BA9A899758E7A189C34,10121,8,11,3,36,49,1849
16098,16098,42B28AE3CCE12BA9A899758E7A189C34,11806,13,14,1,41,48,2098
16099,16099,42B28AE3CCE12BA9A899758E7A189C34,10121,15,17,2,36,49,1849
16100,16100,42B28AE3CCE12BA9A899758E7A189C34,11806,20,23,3,41,48,2098
16101,16101,3D39BFF619D555933510C63A4C03CAF1,13121,0,7,7,38,46,1946
16102,16102,3D39BFF619D555933510C63A4C03CAF1,42081,13,16,3,24,49,1249
16103,16103,3D39BFF619D555933510C63A4C03CAF1,10841,18,23,5,37,47,1897
16104,16104,3A1B49B490CA109FD4D5251F0C86C9CB,43581,0,14,14,33,48,1698
16105,16105,3A1B49B490CA109FD4D5251F0C86C9CB,12601,15,18,3,25,47,1297
16106,16106,3A1B49B490CA109FD4D5251F0C86C9CB,43581,19,23,4,33,48,1698
16107,16107,BC71A128CC1D1FD204F1FA3A371EA53A,43021,0,6,6,16,43,843
16108,16108,BC71A128CC1D1FD204F1FA3A371EA53A,12921,9,10,1,9,41,491
16109,16109,BC71A128CC1D1FD204F1FA3A371EA53A,43021,11,12,1,16,43,843
16110,16110,BC71A128CC1D1FD204F1FA3A371EA53A,12921,13,16,3,9,41,491
16111,16111,BC71A128CC1D1FD204F1FA3A371EA53A,43021,19,23,4,16,43,843
16118,16118,F7BA1E9C235C1D8A36FA4FE83DC9EFDD,10161,1,5,4,35,49,1799
16119,16119,F7BA1E9C235C1D8A36FA4FE83DC9EFDD,10411,8,18,10,36,48,1848
16120,16120,F7BA1E9C235C1D8A36FA4FE83DC9EFDD,11861,20,21,1,32,47,1647
16121,16121,98C61E3403B3AE1E33A205C18A98CF38,42981,2,13,11,36,49,1849
16122,16122,98C61E3403B3AE1E33A205C18A98CF38,40891,14,16,2,37,47,1897
16123,16123,98C61E3403B3AE1E33A205C18A98CF38,40171,16,18,2,38,48,1948
16124,16124,98C61E3403B3AE1E33A205C18A98CF38,12401,18,20,2,39,49,1999
16125,16125,98C61E3403B3AE1E33A205C18A98CF38,10251,22,23,1,35,47,1797
16126,16126,EF40E0066D2B74D398400E9B39CEC7B4,12221,1,2,1,43,44,2194
16127,16127,EF40E0066D2B74D398400E9B39CEC7B4,43051,4,5,1,46,45,2345
16128,16128,EF40E0066D2B74D398400E9B39CEC7B4,12221,6,7,1,43,44,2194
16129,16129,EF40E0066D2B74D398400E9B39CEC7B4,12211,19,21,2,41,44,2094
16130,16130,EF40E0066D2B74D398400E9B39CEC7B4,12221,21,23,2,43,44,2194
16134,16134,91EB59FA0D03DF92CD974EF6C6B73426,11381,0,10,10,30,47,1547
16135,16135,91EB59FA0D03DF92CD974EF6C6B73426,11061,13,14,1,29,48,1498
16136,16136,91EB59FA0D03DF92CD974EF6C6B73426,12021,18,19,1,37,49,1899
16137,16137,91EB59FA0D03DF92CD974EF6C6B73426,11061,20,22,2,29,48,1498
16141,16141,5BE8DAE666E6FE1DBC900EA067EC0564,10731,0,4,4,33,47,1697
16142,16142,5BE8DAE666E6FE1DBC900EA067EC0564,19401,6,8,2,7,30,380
16143,16143,5BE8DAE666E6FE1DBC900EA067EC0564,10731,10,14,4,33,47,1697
16144,16144,5BE8DAE666E6FE1DBC900EA067EC0564,19071,19,23,4,7,29,379
16148,16148,EC23EBB773BEE6584AEE775EDF4B82A4,16231,0,2,2,11,15,565
16149,16149,EC23EBB773BEE6584AEE775EDF4B82A4,16151,4,5,1,13,11,661
16150,16150,EC23EBB773BEE6584AEE775EDF4B82A4,15145,5,6,1,22,9,1109
16151,16151,EC23EBB773BEE6584AEE775EDF4B82A4,16151,7,22,15,13,11,661
16152,16152,5AF7A250F769DD424B6F153B49B360AA,11731,0,7,7,36,48,1848
16153,16153,5AF7A250F769DD424B6F153B49B360AA,12601,8,15,7,25,47,1297
16154,16154,5AF7A250F769DD424B6F153B49B360AA,10501,15,16,1,22,46,1146
16155,16155,5AF7A250F769DD424B6F153B49B360AA,10901,18,23,5,35,48,1798
16156,16156,F3EBB1CFE722422C83EBDE4383206F43,12641,10,11,1,10,43,543
16157,16157,F3EBB1CFE722422C83EBDE4383206F43,19021,11,14,3,10,45,545
16158,16158,F3EBB1CFE722422C83EBDE4383206F43,11061,17,18,1,29,48,1498
16159,16159,5A5B2CBA296E90D3798147AFE5312824,13741,0,7,7,37,49,1899
16160,16160,5A5B2CBA296E90D3798147AFE5312824,40637,8,12,4,36,47,1847
16161,16161,5A5B2CBA296E90D3798147AFE5312824,13561,13,14,1,37,49,1899
16162,16162,5A5B2CBA296E90D3798147AFE5312824,13511,15,19,4,34,48,1748
16163,16163,5A5B2CBA296E90D3798147AFE5312824,13561,19,21,2,37,49,1899
16164,16164,975044F06FB6D20C3A1CC6FE83F444C0,19114,0,7,7,7,43,393
16165,16165,975044F06FB6D20C3A1CC6FE83F444C0,10111,12,14,2,37,47,1897
16166,16166,975044F06FB6D20C3A1CC6FE83F444C0,10221,15,17,2,34,49,1749
16167,16167,975044F06FB6D20C3A1CC6FE83F444C0,19114,21,23,2,7,43,393
16168,16168,9253BBC034BF272556694068A2472CDB,13671,0,4,4,27,43,1393
16169,16169,9253BBC034BF272556694068A2472CDB,10121,9,13,4,36,49,1849
16170,16170,9253BBC034BF272556694068A2472CDB,42871,21,22,1,30,45,1545
16178,16178,1BDB1D4CDA7F5AD203462A91AC7884E4,42161,0,11,11,36,47,1847
16179,16179,1BDB1D4CDA7F5AD203462A91AC7884E4,10111,11,15,4,37,47,1897
16180,16180,1BDB1D4CDA7F5AD203462A91AC7884E4,41601,18,19,1,39,49,1999
16181,16181,1BDB1D4CDA7F5AD203462A91AC7884E4,42161,20,23,3,36,47,1847
16182,16182,C50F95F31F14C0EC9A55706C3B181C1C,15391,0,1,1,35,26,1776
16183,16183,C50F95F31F14C0EC9A55706C3B181C1C,12791,2,3,1,31,29,1579
16184,16184,C50F95F31F14C0EC9A55706C3B181C1C,12792,7,10,3,34,30,1730
16185,16185,C50F95F31F14C0EC9A55706C3B181C1C,15391,13,16,3,35,26,1776
16186,16186,C50F95F31F14C0EC9A55706C3B181C1C,12792,20,22,2,34,30,1730
16187,16187,C50F95F31F14C0EC9A55706C3B181C1C,15391,22,23,1,35,26,1776
16191,16191,B4CB7D775FD49872112583081BADF0AF,11001,0,10,10,42,47,2147
16192,16192,B4CB7D775FD49872112583081BADF0AF,13371,11,13,2,41,47,2097
16193,16193,B4CB7D775FD49872112583081BADF0AF,13511,16,17,1,34,48,1748
16194,16194,B4CB7D775FD49872112583081BADF0AF,13371,18,21,3,41,47,2097
16195,16195,A7B6F0B0D3774C48BB90BD614E267D14,11381,0,7,7,30,47,1547
16196,16196,A7B6F0B0D3774C48BB90BD614E267D14,10661,8,18,10,37,49,1899
16197,16197,A7B6F0B0D3774C48BB90BD614E267D14,11381,21,23,2,30,47,1547
16198,16198,439D8CB010A4086802C0243322BA6C31,11061,0,7,7,29,48,1498
16199,16199,439D8CB010A4086802C0243322BA6C31,40343,11,17,6,24,49,1249
16200,16200,439D8CB010A4086802C0243322BA6C31,11061,18,22,4,29,48,1498
16201,16201,3473FA09F0017B3BD24476C962AE1520,13314,0,6,6,31,39,1589
16202,16202,3473FA09F0017B3BD24476C962AE1520,12521,9,18,9,35,41,1791
16203,16203,3473FA09F0017B3BD24476C962AE1520,13314,21,23,2,31,39,1589
16204,16204,BAF87A0BC01C594FFAC1B35DD77FCF62,10471,0,1,1,37,48,1898
16205,16205,BAF87A0BC01C594FFAC1B35DD77FCF62,11461,1,4,3,37,49,1899
16206,16206,BAF87A0BC01C594FFAC1B35DD77FCF62,42191,5,6,1,38,49,1949
16207,16207,BAF87A0BC01C594FFAC1B35DD77FCF62,11461,6,7,1,37,49,1899
16208,16208,BAF87A0BC01C594FFAC1B35DD77FCF62,10471,10,23,13,37,48,1898
16209,16209,A27203DC664657DF4BBDCCF4AC9D93B1,19181,0,6,6,8,40,440
16210,16210,A27203DC664657DF4BBDCCF4AC9D93B1,12921,7,8,1,9,41,491
16211,16211,A27203DC664657DF4BBDCCF4AC9D93B1,49201,8,12,4,7,41,391
16212,16212,A27203DC664657DF4BBDCCF4AC9D93B1,12641,15,17,2,10,43,543
16213,16213,A27203DC664657DF4BBDCCF4AC9D93B1,12921,21,22,1,9,41,491
16214,16214,82F8C7A7BE49F804F1905B7958B09F69,19401,0,7,7,7,30,380
16215,16215,82F8C7A7BE49F804F1905B7958B09F69,10731,12,14,2,33,47,1697
16216,16216,82F8C7A7BE49F804F1905B7958B09F69,19071,20,21,1,7,29,379
16217,16217,82F8C7A7BE49F804F1905B7958B09F69,19431,22,23,1,8,29,429
16222,16222,78835555A1F3DD1461EF560F0EA88840,12561,0,7,7,45,43,2293
16223,16223,78835555A1F3DD1461EF560F0EA88840,10121,8,16,8,36,49,1849
16224,16224,78835555A1F3DD1461EF560F0EA88840,43951,18,19,1,49,41,2491
16225,16225,B628586ACCA037821F9C53B9BF884987,11151,0,8,8,30,48,1548
16226,16226,B628586ACCA037821F9C53B9BF884987,40341,12,15,3,23,49,1199
16227,16227,B628586ACCA037821F9C53B9BF884987,11151,20,23,3,30,48,1548
16232,16232,2FCC231DE348255A3F9CDA8D77EEA7DC,12581,0,5,5,24,48,1248
16233,16233,2FCC231DE348255A3F9CDA8D77EEA7DC,12051,5,9,4,20,47,1047
16234,16234,2FCC231DE348255A3F9CDA8D77EEA7DC,12581,11,22,11,24,48,1248
16238,16238,8D623891FD363ED9542404996A5AA525,10251,0,17,17,35,47,1797
16239,16239,8D623891FD363ED9542404996A5AA525,40341,19,20,1,23,49,1199
16240,16240,8D623891FD363ED9542404996A5AA525,10251,21,23,2,35,47,1797
16241,16241,85D152F1897A63243F91575C7A5903E5,11831,7,9,2,32,45,1645
16242,16242,85D152F1897A63243F91575C7A5903E5,43041,14,17,3,41,46,2096
16243,16243,85D152F1897A63243F91575C7A5903E5,11151,19,20,1,30,48,1548
16244,16244,27278737D09D5670A3F233313E8FF2D1,10341,0,8,8,31,47,1597
16245,16245,27278737D09D5670A3F233313E8FF2D1,11861,9,13,4,32,47,1647
16246,16246,27278737D09D5670A3F233313E8FF2D1,42021,14,15,1,33,47,1697
16247,16247,27278737D09D5670A3F233313E8FF2D1,11861,15,20,5,32,47,1647
16248,16248,27278737D09D5670A3F233313E8FF2D1,42021,20,21,1,33,47,1697
16261,16261,6562297688D8CD63CE654B7524AA8368,11861,1,8,7,32,47,1647
16262,16262,6562297688D8CD63CE654B7524AA8368,42021,11,13,2,33,47,1697
16263,16263,6562297688D8CD63CE654B7524AA8368,43761,13,15,2,32,47,1647
16264,16264,6562297688D8CD63CE654B7524AA8368,12021,19,21,2,37,49,1899
16265,16265,6562297688D8CD63CE654B7524AA8368,11861,21,23,2,32,47,1647
16266,16266,1788FF83230593384DFEF88881720D90,13551,0,6,6,45,38,2288
16267,16267,1788FF83230593384DFEF88881720D90,43101,6,14,8,46,40,2340
16268,16268,1788FF83230593384DFEF88881720D90,13551,14,19,5,45,38,2288
16269,16269,1788FF83230593384DFEF88881720D90,10771,21,22,1,41,46,2096
16276,16276,FC3FF2A4A79867965BF8FB27343C354A,42691,0,5,5,24,48,1248
16277,16277,FC3FF2A4A79867965BF8FB27343C354A,11641,7,9,2,22,49,1149
16278,16278,FC3FF2A4A79867965BF8FB27343C354A,42681,11,16,5,24,48,1248
16279,16279,FC3FF2A4A79867965BF8FB27343C354A,11641,18,19,1,22,49,1149
16280,16280,FC3FF2A4A79867965BF8FB27343C354A,11361,20,23,3,22,48,1148
16290,16290,F933276E840F8E84214D3C6BDA6A4447,11151,2,10,8,30,48,1548
16291,16291,F933276E840F8E84214D3C6BDA6A4447,11061,10,14,4,29,48,1498
16292,16292,F933276E840F8E84214D3C6BDA6A4447,10721,14,16,2,31,48,1598
16293,16293,F933276E840F8E84214D3C6BDA6A4447,10401,16,17,1,33,49,1699
16294,16294,F933276E840F8E84214D3C6BDA6A4447,11201,18,19,1,35,49,1799
16295,16295,F933276E840F8E84214D3C6BDA6A4447,11061,21,23,2,29,48,1498
16296,16296,ADBEBD9F50B74BC3A14F12C35A5C8159,11491,6,8,2,36,47,1847
16297,16297,ADBEBD9F50B74BC3A14F12C35A5C8159,11731,11,12,1,36,48,1848
16298,16298,ADBEBD9F50B74BC3A14F12C35A5C8159,11491,16,19,3,36,47,1847
16299,16299,ADBEBD9F50B74BC3A14F12C35A5C8159,43731,19,21,2,34,47,1747
16300,16300,ADBEBD9F50B74BC3A14F12C35A5C8159,12511,21,22,1,39,47,1997
16301,16301,0DFD98C5BF618352145AEF64606DF221,10251,0,8,8,35,47,1797
16302,16302,0DFD98C5BF618352145AEF64606DF221,40673,8,10,2,36,48,1848
16303,16303,0DFD98C5BF618352145AEF64606DF221,42161,11,15,4,36,47,1847
16304,16304,0DFD98C5BF618352145AEF64606DF221,43731,18,19,1,34,47,1747
16305,16305,0DFD98C5BF618352145AEF64606DF221,42161,19,23,4,36,47,1847
16306,16306,E9C5D67F82A2CCBA27E905D3F4A2B0C8,43581,0,8,8,33,48,1698
16307,16307,E9C5D67F82A2CCBA27E905D3F4A2B0C8,43751,9,10,1,19,48,998
16308,16308,E9C5D67F82A2CCBA27E905D3F4A2B0C8,12083,11,12,1,36,49,1849
16309,16309,E9C5D67F82A2CCBA27E905D3F4A2B0C8,11791,13,14,1,38,49,1949
16310,16310,E9C5D67F82A2CCBA27E905D3F4A2B0C8,10431,15,16,1,33,49,1699
16311,16311,E9C5D67F82A2CCBA27E905D3F4A2B0C8,10221,16,19,3,34,49,1749
16312,16312,E9C5D67F82A2CCBA27E905D3F4A2B0C8,11291,20,22,2,40,49,2049
16313,16313,4D5D3F015222D9A4A636663FE67FCAD4,10171,3,7,4,26,47,1347
16314,16314,4D5D3F015222D9A4A636663FE67FCAD4,41591,11,16,5,34,49,1749
16315,16315,4D5D3F015222D9A4A636663FE67FCAD4,10171,18,23,5,26,47,1347
16319,16319,135EF939D99CED11694D71795A5772B0,19031,0,5,5,1,42,92
16320,16320,135EF939D99CED11694D71795A5772B0,12641,6,10,4,10,43,543
16321,16321,135EF939D99CED11694D71795A5772B0,19031,11,15,4,1,42,92
16322,16322,135EF939D99CED11694D71795A5772B0,12641,15,19,4,10,43,543
16323,16323,135EF939D99CED11694D71795A5772B0,19031,20,23,3,1,42,92
16327,16327,ABEBA1A5B16E08932674829AFD3AE0E8,10821,0,9,9,40,47,2047
16328,16328,ABEBA1A5B16E08932674829AFD3AE0E8,42031,10,12,2,40,46,2046
16329,16329,ABEBA1A5B16E08932674829AFD3AE0E8,40341,14,18,4,23,49,1199
16330,16330,ABEBA1A5B16E08932674829AFD3AE0E8,10601,20,21,1,39,47,1997
16331,16331,ABEBA1A5B16E08932674829AFD3AE0E8,10821,21,22,1,40,47,2047
16332,16332,0EC1D2502267B7D6F36C8EA9D8EC3DDA,10171,0,8,8,26,47,1347
16333,16333,0EC1D2502267B7D6F36C8EA9D8EC3DDA,10801,9,17,8,42,47,2147
16334,16334,0EC1D2502267B7D6F36C8EA9D8EC3DDA,10171,20,22,2,26,47,1347
16335,16335,8C9C3A43BC2EBDBBBDD3F1F88A0D65DE,16421,4,5,1,8,2,402
16336,16336,8C9C3A43BC2EBDBBBDD3F1F88A0D65DE,16281,6,7,1,11,4,554
16337,16337,8C9C3A43BC2EBDBBBDD3F1F88A0D65DE,16251,8,9,1,15,13,763
16338,16338,8C9C3A43BC2EBDBBBDD3F1F88A0D65DE,15145,10,11,1,22,9,1109
16339,16339,8C9C3A43BC2EBDBBBDD3F1F88A0D65DE,16151,11,18,7,13,11,661
16340,16340,2D9490E1E73264DD4DD5DDE95A580FC1,13371,0,19,19,41,47,2097
16341,16341,2D9490E1E73264DD4DD5DDE95A580FC1,10281,20,22,2,33,48,1698
16342,16342,2D9490E1E73264DD4DD5DDE95A580FC1,13371,22,23,1,41,47,2097
16343,16343,0324B4BC4AC52B5FF38CABDD51C922F7,42141,0,6,6,32,47,1647
16344,16344,0324B4BC4AC52B5FF38CABDD51C922F7,42631,7,8,1,43,45,2195
16345,16345,0324B4BC4AC52B5FF38CABDD51C922F7,12561,13,15,2,45,43,2293
16346,16346,0324B4BC4AC52B5FF38CABDD51C922F7,42141,20,23,3,32,47,1647
16351,16351,93C87ADE4FBD02048670A9DCD4C6ECEA,11261,1,5,4,36,46,1846
16352,16352,93C87ADE4FBD02048670A9DCD4C6ECEA,42861,6,8,2,37,44,1894
16353,16353,93C87ADE4FBD02048670A9DCD4C6ECEA,11261,9,13,4,36,46,1846
16354,16354,93C87ADE4FBD02048670A9DCD4C6ECEA,42861,17,18,1,37,44,1894
16355,16355,93C87ADE4FBD02048670A9DCD4C6ECEA,11261,18,20,2,36,46,1846
16362,16362,B8989CFFC223BB64D623BE9489BA8A6F,11091,0,8,8,29,47,1497
16363,16363,B8989CFFC223BB64D623BE9489BA8A6F,42341,16,17,1,43,49,2199
16364,16364,B8989CFFC223BB64D623BE9489BA8A6F,11151,21,22,1,30,48,1548
16368,16368,D51C6C6BE8A8903D8184ED5A28006B69,11231,0,3,3,37,49,1899
16369,16369,D51C6C6BE8A8903D8184ED5A28006B69,42191,4,8,4,38,49,1949
16370,16370,D51C6C6BE8A8903D8184ED5A28006B69,11461,10,13,3,37,49,1899
16371,16371,D51C6C6BE8A8903D8184ED5A28006B69,42191,14,19,5,38,49,1949
16372,16372,D51C6C6BE8A8903D8184ED5A28006B69,11231,20,23,3,37,49,1899
16373,16373,8244C739056CFAB1A42C3D6A00AFAF26,19031,0,14,14,1,42,92
16374,16374,8244C739056CFAB1A42C3D6A00AFAF26,12641,18,19,1,10,43,543
16375,16375,8244C739056CFAB1A42C3D6A00AFAF26,19031,21,23,2,1,42,92
16379,16379,5D1A5E53046B81CB432237D0DC14FD79,42081,4,8,4,24,49,1249
16380,16380,5D1A5E53046B81CB432237D0DC14FD79,42071,8,11,3,31,49,1599
16381,16381,5D1A5E53046B81CB432237D0DC14FD79,42623,14,16,2,22,49,1149
16382,16382,5D1A5E53046B81CB432237D0DC14FD79,42121,17,18,1,26,49,1349
16383,16383,25B6AD6E6A0FC6B9342D4FFF9B399EB2,13671,0,3,3,27,43,1393
16384,16384,25B6AD6E6A0FC6B9342D4FFF9B399EB2,12311,4,5,1,30,44,1544
16385,16385,25B6AD6E6A0FC6B9342D4FFF9B399EB2,42531,6,23,17,31,45,1595
16389,16389,B1ECF52E7FC73FA8FDDAF37B7E59DF32,10521,0,10,10,41,47,2097
16390,16390,B1ECF52E7FC73FA8FDDAF37B7E59DF32,10107,12,13,1,38,49,1949
16391,16391,B1ECF52E7FC73FA8FDDAF37B7E59DF32,40341,14,18,4,23,49,1199
16392,16392,B1ECF52E7FC73FA8FDDAF37B7E59DF32,11001,20,21,1,42,47,2147
16393,16393,4BEB96C1A6F8B99181CDADEF48D75275,42501,0,6,6,28,47,1447
16394,16394,4BEB96C1A6F8B99181CDADEF48D75275,42081,7,16,9,24,49,1249
16395,16395,4BEB96C1A6F8B99181CDADEF48D75275,42501,20,23,3,28,47,1447
16396,16396,9E2EB523208A345DE4509D7FD0839517,13351,0,6,6,48,48,2448
16397,16397,9E2EB523208A345DE4509D7FD0839517,43621,9,10,1,46,48,2348
16398,16398,9E2EB523208A345DE4509D7FD0839517,13351,11,14,3,48,48,2448
16399,16399,9E2EB523208A345DE4509D7FD0839517,43621,14,20,6,46,48,2348
16400,16400,9E2EB523208A345DE4509D7FD0839517,11701,21,22,1,43,48,2198
16404,16404,498AEB8C5CDB051A4EF3DB88AD487C35,13651,0,7,7,30,47,1547
16405,16405,498AEB8C5CDB051A4EF3DB88AD487C35,42221,8,9,1,38,48,1948
16406,16406,498AEB8C5CDB051A4EF3DB88AD487C35,10721,10,12,2,31,48,1598
16407,16407,498AEB8C5CDB051A4EF3DB88AD487C35,10292,12,23,11,30,47,1547
16408,16408,BCCA36AC6DE92B5D284204C1D312B82A,43161,0,7,7,35,47,1797
16409,16409,BCCA36AC6DE92B5D284204C1D312B82A,11531,7,8,1,34,49,1749
16410,16410,BCCA36AC6DE92B5D284204C1D312B82A,42801,10,17,7,40,49,2049
16411,16411,BCCA36AC6DE92B5D284204C1D312B82A,42161,21,23,2,36,47,1847
16412,16412,46624C7A7A05E81084BABC40FE8F937C,13314,0,12,12,31,39,1589
16413,16413,46624C7A7A05E81084BABC40FE8F937C,12521,12,17,5,35,41,1791
16414,16414,46624C7A7A05E81084BABC40FE8F937C,13314,18,22,4,31,39,1589
16424,16424,C9FF8A5216EA719617BFA5E0EC5EC68F,19441,0,7,7,8,46,446
16425,16425,C9FF8A5216EA719617BFA5E0EC5EC68F,11571,9,10,1,13,46,696
16426,16426,C9FF8A5216EA719617BFA5E0EC5EC68F,19441,13,15,2,8,46,446
16427,16427,C9FF8A5216EA719617BFA5E0EC5EC68F,42041,16,18,2,10,47,547
16428,16428,C9FF8A5216EA719617BFA5E0EC5EC68F,19901,19,20,1,7,44,394
16429,16429,C9FF8A5216EA719617BFA5E0EC5EC68F,19441,22,23,1,8,46,446
16430,16430,3A20391B26ABDC24493C4A2BC50C35D2,42691,0,2,2,24,48,1248
16431,16431,3A20391B26ABDC24493C4A2BC50C35D2,12051,2,9,7,20,47,1047
16432,16432,3A20391B26ABDC24493C4A2BC50C35D2,42481,11,12,1,22,49,1149
16433,16433,3A20391B26ABDC24493C4A2BC50C35D2,42681,14,16,2,24,48,1248
16434,16434,3A20391B26ABDC24493C4A2BC50C35D2,40691,20,22,2,42,48,2148
16442,16442,906075D6233195F1F9099F6FBB81286D,42523,0,5,5,31,47,1597
16443,16443,906075D6233195F1F9099F6FBB81286D,43761,7,8,1,32,47,1647
16444,16444,906075D6233195F1F9099F6FBB81286D,10341,9,10,1,31,47,1597
16445,16445,906075D6233195F1F9099F6FBB81286D,43761,13,14,1,32,47,1647
16446,16446,906075D6233195F1F9099F6FBB81286D,10341,18,20,2,31,47,1597
16447,16447,906075D6233195F1F9099F6FBB81286D,43761,20,21,1,32,47,1647
16451,16451,7F0F7E01EE512C1A933F7133254355CA,43021,0,10,10,16,43,843
16452,16452,7F0F7E01EE512C1A933F7133254355CA,12921,10,12,2,9,41,491
16453,16453,7F0F7E01EE512C1A933F7133254355CA,43021,12,13,1,16,43,843
16454,16454,7F0F7E01EE512C1A933F7133254355CA,12921,17,19,2,9,41,491
16455,16455,7F0F7E01EE512C1A933F7133254355CA,43021,20,21,1,16,43,843
16456,16456,3AD7761AC0BF53FAE0D33B0D8FF02F47,42221,0,6,6,38,48,1948
16457,16457,3AD7761AC0BF53FAE0D33B0D8FF02F47,42271,6,7,1,40,47,2047
16458,16458,3AD7761AC0BF53FAE0D33B0D8FF02F47,11921,9,12,3,38,48,1948
16459,16459,3AD7761AC0BF53FAE0D33B0D8FF02F47,42271,13,16,3,40,47,2047
16460,16460,3AD7761AC0BF53FAE0D33B0D8FF02F47,42221,16,22,6,38,48,1948
16465,16465,DFE0075BA441F09CC854C6FA18C2E9B5,11791,0,10,10,38,49,1949
16466,16466,DFE0075BA441F09CC854C6FA18C2E9B5,10151,12,16,4,34,47,1747
16467,16467,DFE0075BA441F09CC854C6FA18C2E9B5,11791,21,23,2,38,49,1949
16471,16471,8802B7EB7746AB1A934A16AB94A21A3C,43731,0,9,9,34,47,1747
16472,16472,8802B7EB7746AB1A934A16AB94A21A3C,42523,13,15,2,31,47,1597
16473,16473,8802B7EB7746AB1A934A16AB94A21A3C,13121,19,21,2,38,46,1946
16480,16480,718F9C02C6A67F792D4A34A4E958BCFE,11201,1,3,2,35,49,1799
16481,16481,718F9C02C6A67F792D4A34A4E958BCFE,13011,5,18,13,39,47,1997
16482,16482,718F9C02C6A67F792D4A34A4E958BCFE,10221,20,23,3,34,49,1749
16486,16486,4CF066261432C270F36DBBDE4444AA31,13651,0,6,6,30,47,1547
16487,16487,4CF066261432C270F36DBBDE4444AA31,42141,7,9,2,32,47,1647
16488,16488,4CF066261432C270F36DBBDE4444AA31,13651,12,14,2,30,47,1547
16489,16489,4CF066261432C270F36DBBDE4444AA31,19281,16,18,2,16,32,832
16490,16490,4CF066261432C270F36DBBDE4444AA31,13651,20,22,2,30,47,1547
16495,16495,EECB7510E2F1A50FBF2C7F4547480446,43581,0,9,9,33,48,1698
16496,16496,EECB7510E2F1A50FBF2C7F4547480446,10221,12,13,1,34,49,1749
16497,16497,EECB7510E2F1A50FBF2C7F4547480446,10214,19,20,1,15,49,799
16498,16498,EECB7510E2F1A50FBF2C7F4547480446,43581,22,23,1,33,48,1698
16505,16505,86D79D690C2F1F8AD0DA3D3F5AF4C54F,10521,0,5,5,41,47,2097
16506,16506,86D79D690C2F1F8AD0DA3D3F5AF4C54F,12491,10,11,1,36,43,1843
16507,16507,86D79D690C2F1F8AD0DA3D3F5AF4C54F,11001,16,18,2,42,47,2147
16508,16508,86D79D690C2F1F8AD0DA3D3F5AF4C54F,13231,19,20,1,39,46,1996
16509,16509,70E36A4B82878626B569C66E46C7827C,11271,0,11,11,37,48,1898
16510,16510,70E36A4B82878626B569C66E46C7827C,42931,13,15,2,41,49,2099
16511,16511,70E36A4B82878626B569C66E46C7827C,12083,15,17,2,36,49,1849
16512,16512,70E36A4B82878626B569C66E46C7827C,42321,17,22,5,43,47,2197
16513,16513,D1D17D5D9BFCC31F977BBD335E5C0CDA,43311,0,8,8,31,48,1598
16514,16514,D1D17D5D9BFCC31F977BBD335E5C0CDA,10431,11,14,3,33,49,1699
16515,16515,D1D17D5D9BFCC31F977BBD335E5C0CDA,43731,14,15,1,34,47,1747
16516,16516,D1D17D5D9BFCC31F977BBD335E5C0CDA,40112,17,18,1,32,48,1648
16517,16517,D1D17D5D9BFCC31F977BBD335E5C0CDA,11061,19,20,1,29,48,1498
16518,16518,D1D17D5D9BFCC31F977BBD335E5C0CDA,11381,21,22,1,30,47,1547
16519,16519,BF3354E7653978B437BDBF5412A04932,12871,2,6,4,22,33,1133
16520,16520,BF3354E7653978B437BDBF5412A04932,19281,7,8,1,16,32,832
16521,16521,BF3354E7653978B437BDBF5412A04932,12871,10,14,4,22,33,1133
16522,16522,BF3354E7653978B437BDBF5412A04932,19281,19,22,3,16,32,832
16537,16537,49F504B5CA7404CFC2EFCE41A636B3EF,10271,3,10,7,37,46,1896
16538,16538,49F504B5CA7404CFC2EFCE41A636B3EF,40341,13,15,2,23,49,1199
16539,16539,49F504B5CA7404CFC2EFCE41A636B3EF,13691,19,23,4,47,30,2380
16540,16540,7EFF4C1F410EC0093C0E819DD0DC2E31,10471,0,7,7,37,48,1898
16541,16541,7EFF4C1F410EC0093C0E819DD0DC2E31,42581,8,10,2,38,48,1948
16542,16542,7EFF4C1F410EC0093C0E819DD0DC2E31,10471,10,15,5,37,48,1898
16543,16543,7EFF4C1F410EC0093C0E819DD0DC2E31,40463,16,17,1,38,49,1949
16544,16544,7EFF4C1F410EC0093C0E819DD0DC2E31,10471,18,21,3,37,48,1898
16545,16545,D72197F9972B6D5BB4AA8E5482CC045B,11381,1,5,4,30,47,1547
16546,16546,D72197F9972B6D5BB4AA8E5482CC045B,10951,8,11,3,29,48,1498
16547,16547,D72197F9972B6D5BB4AA8E5482CC045B,11381,12,13,1,30,47,1547
16548,16548,D72197F9972B6D5BB4AA8E5482CC045B,10951,15,17,2,29,48,1498
16549,16549,D72197F9972B6D5BB4AA8E5482CC045B,11381,18,23,5,30,47,1547
16550,16550,C7DA09D84BB6D5A3ABEAD976C8C0731E,42861,0,5,5,37,44,1894
16551,16551,C7DA09D84BB6D5A3ABEAD976C8C0731E,11261,6,8,2,36,46,1846
16552,16552,C7DA09D84BB6D5A3ABEAD976C8C0731E,42861,12,13,1,37,44,1894
16553,16553,C7DA09D84BB6D5A3ABEAD976C8C0731E,11261,14,18,4,36,46,1846
16554,16554,C7DA09D84BB6D5A3ABEAD976C8C0731E,42861,20,23,3,37,44,1894
16559,16559,807312F59B7950B5F423D8A780189538,13651,0,7,7,30,47,1547
16560,16560,807312F59B7950B5F423D8A780189538,42523,7,8,1,31,47,1597
16561,16561,807312F59B7950B5F423D8A780189538,13091,9,10,1,20,42,1042
16562,16562,807312F59B7950B5F423D8A780189538,13651,17,18,1,30,47,1547
16563,16563,5097D28E1C98454DC0C0BA1FE079F027,12671,2,4,2,21,43,1093
16564,16564,5097D28E1C98454DC0C0BA1FE079F027,13094,7,9,2,21,42,1092
16565,16565,5097D28E1C98454DC0C0BA1FE079F027,12601,9,12,3,25,47,1297
16566,16566,5097D28E1C98454DC0C0BA1FE079F027,12671,13,14,1,21,43,1093
16567,16567,5097D28E1C98454DC0C0BA1FE079F027,12601,17,18,1,25,47,1297
16572,16572,E03B05F0FB01917EEB19D58711FDBCBD,13071,2,13,11,41,41,2091
16573,16573,E03B05F0FB01917EEB19D58711FDBCBD,43101,14,17,3,46,40,2340
16574,16574,E03B05F0FB01917EEB19D58711FDBCBD,13071,18,19,1,41,41,2091
16575,16575,E03B05F0FB01917EEB19D58711FDBCBD,43101,21,23,2,46,40,2340
16579,16579,004D26DDA49F4E295E56D0D4EFA58427,16071,0,8,8,3,3,153
16580,16580,004D26DDA49F4E295E56D0D4EFA58427,42941,12,14,2,37,47,1897
16581,16581,004D26DDA49F4E295E56D0D4EFA58427,16071,18,19,1,3,3,153
16582,16582,004D26DDA49F4E295E56D0D4EFA58427,40171,22,23,1,38,48,1948
16597,16597,7CB0B32DAF4FB11599158FE9175B08E3,11951,0,17,17,31,49,1599
16598,16598,7CB0B32DAF4FB11599158FE9175B08E3,42511,18,20,2,37,47,1897
16599,16599,7CB0B32DAF4FB11599158FE9175B08E3,11951,21,23,2,31,49,1599
16600,16600,78520B675436202D640A52F7BAC3D2C7,12792,1,13,12,34,30,1730
16601,16601,78520B675436202D640A52F7BAC3D2C7,15391,15,16,1,35,26,1776
16602,16602,78520B675436202D640A52F7BAC3D2C7,12792,16,18,2,34,30,1730
16607,16607,8665021DD94E6EE982300393F2FB76CC,42191,5,7,2,38,49,1949
16608,16608,8665021DD94E6EE982300393F2FB76CC,11481,9,10,1,41,48,2098
16609,16609,8665021DD94E6EE982300393F2FB76CC,13094,11,13,2,21,42,1092
16610,16610,8665021DD94E6EE982300393F2FB76CC,10107,15,17,2,38,49,1949
16611,16611,8665021DD94E6EE982300393F2FB76CC,13121,17,20,3,38,46,1946
16612,16612,8665021DD94E6EE982300393F2FB76CC,40463,21,22,1,38,49,1949
16613,16613,94EC8DD1154031CCB6D21F3A095D1A8B,10471,0,6,6,37,48,1898
16614,16614,94EC8DD1154031CCB6D21F3A095D1A8B,11831,7,9,2,32,45,1645
16615,16615,94EC8DD1154031CCB6D21F3A095D1A8B,10471,12,15,3,37,48,1898
16616,16616,94EC8DD1154031CCB6D21F3A095D1A8B,11831,15,17,2,32,45,1645
16617,16617,94EC8DD1154031CCB6D21F3A095D1A8B,10471,18,21,3,37,48,1898
16618,16618,7C6533C0224770EA8D8739703C562233,42471,0,8,8,35,49,1799
16619,16619,7C6533C0224770EA8D8739703C562233,10292,8,10,2,30,47,1547
16620,16620,7C6533C0224770EA8D8739703C562233,10716,12,14,2,30,46,1546
16621,16621,7C6533C0224770EA8D8739703C562233,42471,16,22,6,35,49,1799
16622,16622,EF3D743CCC57E603C7EAE8E058222BC4,43061,1,7,6,43,46,2196
16623,16623,EF3D743CCC57E603C7EAE8E058222BC4,42471,9,19,10,35,49,1799
16624,16624,EF3D743CCC57E603C7EAE8E058222BC4,43061,19,22,3,43,46,2196
16625,16625,84E097DF782FE990259E1DE5027828BD,13371,0,7,7,41,47,2097
16626,16626,84E097DF782FE990259E1DE5027828BD,40201,9,16,7,32,49,1649
16627,16627,84E097DF782FE990259E1DE5027828BD,13371,19,22,3,41,47,2097
16638,16638,A5A090591E63A367211B3058D6F881BC,43021,1,10,9,16,43,843
16639,16639,A5A090591E63A367211B3058D6F881BC,12921,10,11,1,9,41,491
16640,16640,A5A090591E63A367211B3058D6F881BC,43021,15,19,4,16,43,843
16641,16641,6657340E3E8EAFBE8630D734C7DFAA0A,19181,1,2,1,8,40,440
16642,16642,6657340E3E8EAFBE8630D734C7DFAA0A,19264,2,5,3,10,36,536
16643,16643,6657340E3E8EAFBE8630D734C7DFAA0A,12641,8,9,1,10,43,543
16644,16644,6657340E3E8EAFBE8630D734C7DFAA0A,19021,10,17,7,10,45,545
16645,16645,6657340E3E8EAFBE8630D734C7DFAA0A,12921,21,23,2,9,41,491
16677,16677,13FE336F780D5F9F83776798BCE67144,42351,7,15,8,38,45,1945
16678,16678,13FE336F780D5F9F83776798BCE67144,11261,15,16,1,36,46,1846
16679,16679,13FE336F780D5F9F83776798BCE67144,12311,19,21,2,30,44,1544
16680,16680,13FE336F780D5F9F83776798BCE67144,42351,22,23,1,38,45,1945
16688,16688,75219378BBB10FFE07C7301517B53FE1,42271,0,8,8,40,47,2047
16689,16689,75219378BBB10FFE07C7301517B53FE1,11231,8,19,11,37,49,1899
16690,16690,75219378BBB10FFE07C7301517B53FE1,13101,21,22,1,40,47,2047
16700,16700,5408DC5B0AFBD23C3FA2E4CCFD3A9C81,42633,0,4,4,42,46,2146
16701,16701,5408DC5B0AFBD23C3FA2E4CCFD3A9C81,12221,4,6,2,43,44,2194
16702,16702,5408DC5B0AFBD23C3FA2E4CCFD3A9C81,11261,7,10,3,36,46,1846
16703,16703,5408DC5B0AFBD23C3FA2E4CCFD3A9C81,42633,11,12,1,42,46,2146
16704,16704,5408DC5B0AFBD23C3FA2E4CCFD3A9C81,11261,14,17,3,36,46,1846
16705,16705,5408DC5B0AFBD23C3FA2E4CCFD3A9C81,42351,21,23,2,38,45,1945
16706,16706,B2E1A9593E19D988BDD0EE32D9CE9188,13311,1,3,2,27,39,1389
16707,16707,B2E1A9593E19D988BDD0EE32D9CE9188,11281,4,8,4,27,40,1390
16708,16708,B2E1A9593E19D988BDD0EE32D9CE9188,12601,8,12,4,25,47,1297
16709,16709,B2E1A9593E19D988BDD0EE32D9CE9188,11281,15,16,1,27,40,1390
16710,16710,B2E1A9593E19D988BDD0EE32D9CE9188,13311,19,20,1,27,39,1389
16711,16711,B2E1A9593E19D988BDD0EE32D9CE9188,12731,21,22,1,22,40,1140
16712,16712,560DFCBDB07F2D026230A41F510B3170,12381,0,7,7,32,48,1648
16713,16713,560DFCBDB07F2D026230A41F510B3170,19741,8,17,9,5,44,294
16714,16714,560DFCBDB07F2D026230A41F510B3170,40302,18,19,1,40,49,2049
16715,16715,560DFCBDB07F2D026230A41F510B3170,12971,20,23,3,32,48,1648
16716,16716,236B9E8C5424DA5BF58A23C00FDC2C24,43761,0,13,13,32,47,1647
16717,16717,236B9E8C5424DA5BF58A23C00FDC2C24,40341,18,20,2,23,49,1199
16718,16718,236B9E8C5424DA5BF58A23C00FDC2C24,11631,22,23,1,12,49,649
16719,16719,617CDCBB763C8E42460705E2218A65BF,42141,0,7,7,32,47,1647
16720,16720,617CDCBB763C8E42460705E2218A65BF,42523,8,10,2,31,47,1597
16721,16721,617CDCBB763C8E42460705E2218A65BF,43761,13,14,1,32,47,1647
16722,16722,617CDCBB763C8E42460705E2218A65BF,42491,14,16,2,32,46,1646
16723,16723,617CDCBB763C8E42460705E2218A65BF,43761,18,21,3,32,47,1647
16724,16724,CA7675D4504FF649E5D3C79C1D770D57,10901,0,6,6,35,48,1798
16725,16725,CA7675D4504FF649E5D3C79C1D770D57,11151,6,7,1,30,48,1548
16726,16726,CA7675D4504FF649E5D3C79C1D770D57,10901,11,23,12,35,48,1798
16727,16727,FBFB039BFE202B4D733B8197A5DE9AA1,43751,0,5,5,19,48,998
16728,16728,FBFB039BFE202B4D733B8197A5DE9AA1,12581,6,17,11,24,48,1248
16729,16729,FBFB039BFE202B4D733B8197A5DE9AA1,43751,18,19,1,19,48,998
16730,16730,FBFB039BFE202B4D733B8197A5DE9AA1,12051,22,23,1,20,47,1047
16731,16731,7A3CCBEE1EF7E270B4B301C75856D62F,43761,1,13,12,32,47,1647
16732,16732,7A3CCBEE1EF7E270B4B301C75856D62F,11231,16,17,1,37,49,1899
16733,16733,7A3CCBEE1EF7E270B4B301C75856D62F,10281,18,23,5,33,48,1698
16741,16741,B330B6F87FA34F7466DC67C7BC5F8853,11921,6,12,6,38,48,1948
16742,16742,B330B6F87FA34F7466DC67C7BC5F8853,11954,16,17,1,32,49,1649
16743,16743,B330B6F87FA34F7466DC67C7BC5F8853,11921,21,22,1,38,48,1948
16744,16744,CFF4943452741BA085C68AD1AAC66347,10331,0,7,7,39,46,1996
16745,16745,CFF4943452741BA085C68AD1AAC66347,11481,7,11,4,41,48,2098
16746,16746,CFF4943452741BA085C68AD1AAC66347,10331,12,13,1,39,46,1996
16747,16747,CFF4943452741BA085C68AD1AAC66347,11806,16,17,1,41,48,2098
16748,16748,CFF4943452741BA085C68AD1AAC66347,10331,19,23,4,39,46,1996
16749,16749,A99656E991272E2D0207AAB7A175C1B5,42981,2,9,7,36,49,1849
16750,16750,A99656E991272E2D0207AAB7A175C1B5,10471,9,11,2,37,48,1898
16751,16751,A99656E991272E2D0207AAB7A175C1B5,42981,14,16,2,36,49,1849
16752,16752,A99656E991272E2D0207AAB7A175C1B5,11531,18,20,2,34,49,1749
16753,16753,A99656E991272E2D0207AAB7A175C1B5,42981,21,23,2,36,49,1849
16754,16754,3CAF3E8124CD86E1D6173DC5C3A9CB89,10971,1,2,1,35,47,1797
16755,16755,3CAF3E8124CD86E1D6173DC5C3A9CB89,10151,3,4,1,34,47,1747
16756,16756,3CAF3E8124CD86E1D6173DC5C3A9CB89,42161,5,7,2,36,47,1847
16757,16757,3CAF3E8124CD86E1D6173DC5C3A9CB89,43161,8,19,11,35,47,1797
16758,16758,3CAF3E8124CD86E1D6173DC5C3A9CB89,42161,20,22,2,36,47,1847
16765,16765,E262F366757F1506354A3105F4ECFC3B,11701,0,7,7,43,48,2198
16766,16766,E262F366757F1506354A3105F4ECFC3B,11231,7,17,10,37,49,1899
16767,16767,E262F366757F1506354A3105F4ECFC3B,11701,19,23,4,43,48,2198
16768,16768,86B49E0F0DB5DD8F0703EF0949413D4C,43311,3,12,9,31,48,1598
16769,16769,86B49E0F0DB5DD8F0703EF0949413D4C,40341,16,18,2,23,49,1199
16770,16770,86B49E0F0DB5DD8F0703EF0949413D4C,10491,21,23,2,33,48,1698
16774,16774,6C2A3F3E6C9F2CBF53A9742DD61E78E2,12971,0,9,9,32,48,1648
16775,16775,6C2A3F3E6C9F2CBF53A9742DD61E78E2,10107,10,11,1,38,49,1949
16776,16776,6C2A3F3E6C9F2CBF53A9742DD61E78E2,40941,13,18,5,32,48,1648
16777,16777,6C2A3F3E6C9F2CBF53A9742DD61E78E2,43281,18,20,2,37,48,1898
16778,16778,6C2A3F3E6C9F2CBF53A9742DD61E78E2,40941,20,23,3,32,48,1648
16779,16779,494D4CE05480984DBEB3A2073E0D7F93,42411,2,12,10,40,49,2049
16780,16780,494D4CE05480984DBEB3A2073E0D7F93,12381,13,18,5,32,48,1648
16781,16781,494D4CE05480984DBEB3A2073E0D7F93,42411,21,23,2,40,49,2049
16782,16782,8B6448FD7DB9F8E2F8F73AFDDD5BFD38,43021,0,4,4,16,43,843
16783,16783,8B6448FD7DB9F8E2F8F73AFDDD5BFD38,19901,7,9,2,7,44,394
16784,16784,8B6448FD7DB9F8E2F8F73AFDDD5BFD38,12921,10,11,1,9,41,491
16785,16785,8B6448FD7DB9F8E2F8F73AFDDD5BFD38,12641,12,16,4,10,43,543
16786,16786,8B6448FD7DB9F8E2F8F73AFDDD5BFD38,12921,18,19,1,9,41,491
16787,16787,27B6DDFE3A356062F221ABD7AD70BB14,11061,0,6,6,29,48,1498
16788,16788,27B6DDFE3A356062F221ABD7AD70BB14,10681,9,10,1,30,48,1548
16789,16789,27B6DDFE3A356062F221ABD7AD70BB14,11061,11,12,1,29,48,1498
16790,16790,27B6DDFE3A356062F221ABD7AD70BB14,10681,13,15,2,30,48,1548
16791,16791,27B6DDFE3A356062F221ABD7AD70BB14,11061,19,23,4,29,48,1498
16796,16796,A2DD7BA75FCE1B5306A377D198F94491,15391,0,5,5,35,26,1776
16797,16797,A2DD7BA75FCE1B5306A377D198F94491,43121,8,9,1,25,27,1277
16798,16798,A2DD7BA75FCE1B5306A377D198F94491,15391,11,14,3,35,26,1776
16799,16799,A2DD7BA75FCE1B5306A377D198F94491,43121,15,16,1,25,27,1277
16800,16800,A2DD7BA75FCE1B5306A377D198F94491,15391,19,22,3,35,26,1776
16801,16801,C48AF9FD92249AFBDE30934410FF853B,10471,0,11,11,37,48,1898
16802,16802,C48AF9FD92249AFBDE30934410FF853B,11381,12,17,5,30,47,1547
16803,16803,C48AF9FD92249AFBDE30934410FF853B,10471,18,23,5,37,48,1898
16804,16804,CE29EB37C112E7F535813A697DFC251A,43751,0,13,13,19,48,998
16805,16805,CE29EB37C112E7F535813A697DFC251A,10951,14,17,3,29,48,1498
16806,16806,CE29EB37C112E7F535813A697DFC251A,43751,19,23,4,19,48,998
16810,16810,1EAE8E0D28D79DCFE0DA0CD7004A4A71,11571,0,1,1,13,46,696
16811,16811,1EAE8E0D28D79DCFE0DA0CD7004A4A71,19441,1,2,1,8,46,446
16812,16812,1EAE8E0D28D79DCFE0DA0CD7004A4A71,11571,3,6,3,13,46,696
16813,16813,1EAE8E0D28D79DCFE0DA0CD7004A4A71,19441,10,11,1,8,46,446
16814,16814,1EAE8E0D28D79DCFE0DA0CD7004A4A71,11571,12,13,1,13,46,696
16815,16815,1EAE8E0D28D79DCFE0DA0CD7004A4A71,19441,15,23,8,8,46,446
16816,16816,E5C174D2FF195FD116006ADE577A953D,11061,0,6,6,29,48,1498
16817,16817,E5C174D2FF195FD116006ADE577A953D,11151,7,9,2,30,48,1548
16818,16818,E5C174D2FF195FD116006ADE577A953D,11061,11,12,1,29,48,1498
16819,16819,E5C174D2FF195FD116006ADE577A953D,11151,13,20,7,30,48,1548
16820,16820,E5C174D2FF195FD116006ADE577A953D,11061,21,22,1,29,48,1498
16821,16821,40A3F567657A043546A2ED7A5DC91A85,15671,0,4,4,37,26,1876
16822,16822,40A3F567657A043546A2ED7A5DC91A85,12792,5,9,4,34,30,1730
16823,16823,40A3F567657A043546A2ED7A5DC91A85,15331,9,20,11,38,24,1924
16824,16824,40A3F567657A043546A2ED7A5DC91A85,12792,21,23,2,34,30,1730
16825,16825,F075803A6C36A9D2864358E78F8DF986,15051,0,14,14,19,4,954
16826,16826,F075803A6C36A9D2864358E78F8DF986,16281,17,20,3,11,4,554
16827,16827,F075803A6C36A9D2864358E78F8DF986,15051,20,22,2,19,4,954
16828,16828,78A4AA9407E763ED8D1652A4AFF74DAE,19114,0,8,8,7,43,393
16829,16829,78A4AA9407E763ED8D1652A4AFF74DAE,12641,11,13,2,10,43,543
16830,16830,78A4AA9407E763ED8D1652A4AFF74DAE,19021,13,15,2,10,45,545
16831,16831,78A4AA9407E763ED8D1652A4AFF74DAE,19114,17,23,6,7,43,393
16832,16832,CB6CE8B284764CB65EC4187E6FE5A3FF,43021,0,5,5,16,43,843
16833,16833,CB6CE8B284764CB65EC4187E6FE5A3FF,19021,7,10,3,10,45,545
16834,16834,CB6CE8B284764CB65EC4187E6FE5A3FF,43021,13,14,1,16,43,843
16835,16835,CB6CE8B284764CB65EC4187E6FE5A3FF,19021,14,19,5,10,45,545
16843,16843,694AE58BB8FA7D73732050F947690888,11261,0,11,11,36,46,1846
16844,16844,694AE58BB8FA7D73732050F947690888,13461,12,13,1,39,44,1994
16845,16845,694AE58BB8FA7D73732050F947690888,11261,13,18,5,36,46,1846
16846,16846,9CBF9B7BBDA02761C2FCA54EEB069B75,40801,0,7,7,43,46,2196
16847,16847,9CBF9B7BBDA02761C2FCA54EEB069B75,10511,8,10,2,35,46,1796
16848,16848,9CBF9B7BBDA02761C2FCA54EEB069B75,40801,12,15,3,43,46,2196
16849,16849,9CBF9B7BBDA02761C2FCA54EEB069B75,42321,15,16,1,43,47,2197
16850,16850,9CBF9B7BBDA02761C2FCA54EEB069B75,43581,18,20,2,33,48,1698
16851,16851,9CBF9B7BBDA02761C2FCA54EEB069B75,10841,20,23,3,37,47,1897
16852,16852,AB57CFBC7FBBD1B4F46C04046F726522,15171,0,2,2,42,21,2121
16853,16853,AB57CFBC7FBBD1B4F46C04046F726522,12881,4,5,1,47,22,2372
16854,16854,AB57CFBC7FBBD1B4F46C04046F726522,15021,6,15,9,46,18,2318
16855,16855,AB57CFBC7FBBD1B4F46C04046F726522,12881,18,20,2,47,22,2372
16863,16863,F40A23A3C64206CC00C54FEAD4057B67,11161,0,7,7,32,48,1648
16864,16864,F40A23A3C64206CC00C54FEAD4057B67,10221,7,18,11,34,49,1749
16865,16865,F40A23A3C64206CC00C54FEAD4057B67,10107,19,21,2,38,49,1949
16866,16866,F40A23A3C64206CC00C54FEAD4057B67,11161,22,23,1,32,48,1648
16867,16867,936F3EAEFFE6D40274671E4FB3E6BD97,11941,0,6,6,37,46,1896
16868,16868,936F3EAEFFE6D40274671E4FB3E6BD97,42161,7,14,7,36,47,1847
16869,16869,936F3EAEFFE6D40274671E4FB3E6BD97,10111,14,15,1,37,47,1897
16870,16870,936F3EAEFFE6D40274671E4FB3E6BD97,42771,15,17,2,36,47,1847
16871,16871,936F3EAEFFE6D40274671E4FB3E6BD97,11941,19,23,4,37,46,1896
16878,16878,59644621240D60A0095CD2C9DBFE93CE,12871,9,12,3,22,33,1133
16879,16879,59644621240D60A0095CD2C9DBFE93CE,49181,12,13,1,21,31,1081
16880,16880,59644621240D60A0095CD2C9DBFE93CE,19801,14,16,2,19,26,976
16881,16881,59644621240D60A0095CD2C9DBFE93CE,12871,17,19,2,22,33,1133
16885,16885,D5C98D28246C767D0FFD7F7274CFF193,13314,0,8,8,31,39,1589
16886,16886,D5C98D28246C767D0FFD7F7274CFF193,12521,8,9,1,35,41,1791
16887,16887,D5C98D28246C767D0FFD7F7274CFF193,13314,12,13,1,31,39,1589
16888,16888,D5C98D28246C767D0FFD7F7274CFF193,12521,14,17,3,35,41,1791
16889,16889,D5C98D28246C767D0FFD7F7274CFF193,13314,19,23,4,31,39,1589
16890,16890,1B3132796849B42BCD4DBFC11B3ED3B3,12161,0,6,6,32,46,1646
16891,16891,1B3132796849B42BCD4DBFC11B3ED3B3,43311,9,10,1,31,48,1598
16892,16892,1B3132796849B42BCD4DBFC11B3ED3B3,11061,14,16,2,29,48,1498
16893,16893,1B3132796849B42BCD4DBFC11B3ED3B3,43311,18,19,1,31,48,1598
16894,16894,5C7872947538FD21C5B6506FBE006EFB,40302,0,8,8,40,49,2049
16895,16895,5C7872947538FD21C5B6506FBE006EFB,10621,11,18,7,41,49,2099
16896,16896,5C7872947538FD21C5B6506FBE006EFB,11841,19,21,2,33,46,1696
16897,16897,5C7872947538FD21C5B6506FBE006EFB,11531,22,23,1,34,49,1749
16898,16898,90AC20E6CC0B4ABA3A4EAC5C3086C030,13741,0,8,8,37,49,1899
16899,16899,90AC20E6CC0B4ABA3A4EAC5C3086C030,42971,9,10,1,43,49,2199
16900,16900,90AC20E6CC0B4ABA3A4EAC5C3086C030,13741,11,23,12,37,49,1899
16904,16904,7DCF2029374B65B3A0F7E543F6FC03BD,15421,0,4,4,20,18,1018
16905,16905,7DCF2029374B65B3A0F7E543F6FC03BD,15271,5,7,2,14,20,720
16906,16906,7DCF2029374B65B3A0F7E543F6FC03BD,16441,9,11,2,15,17,767
16907,16907,7DCF2029374B65B3A0F7E543F6FC03BD,15421,13,21,8,20,18,1018
16908,16908,0A27EAE690B1EA20001899CE496B6598,19744,0,12,12,6,43,343
16909,16909,0A27EAE690B1EA20001899CE496B6598,12921,13,15,2,9,41,491
16910,16910,0A27EAE690B1EA20001899CE496B6598,19744,19,21,2,6,43,343
16918,16918,1237DDBD7CED54FE23BBCD0348E8F511,42161,2,7,5,36,47,1847
16919,16919,1237DDBD7CED54FE23BBCD0348E8F511,12381,11,13,2,32,48,1648
16920,16920,1237DDBD7CED54FE23BBCD0348E8F511,10431,15,16,1,33,49,1699
16921,16921,1237DDBD7CED54FE23BBCD0348E8F511,42161,18,23,5,36,47,1847
16922,16922,DA8436200047D98073F757F4D1C3CDF7,40322,0,9,9,38,46,1946
16923,16923,DA8436200047D98073F757F4D1C3CDF7,10841,12,14,2,37,47,1897
16924,16924,DA8436200047D98073F757F4D1C3CDF7,40322,14,16,2,38,46,1946
16925,16925,DA8436200047D98073F757F4D1C3CDF7,42511,19,20,1,37,47,1897
16926,16926,DA8436200047D98073F757F4D1C3CDF7,40322,21,23,2,38,46,1946
16927,16927,D88EA2A634C927FE2BD8ECB490F7D727,10811,0,5,5,38,46,1946
16928,16928,D88EA2A634C927FE2BD8ECB490F7D727,10331,7,12,5,39,46,1996
16929,16929,D88EA2A634C927FE2BD8ECB490F7D727,10292,15,16,1,30,47,1547
16930,16930,D88EA2A634C927FE2BD8ECB490F7D727,10811,17,23,6,38,46,1946
16938,16938,4BE69A0662141B6D95CBDE416B3D83C0,40361,0,8,8,42,48,2148
16939,16939,4BE69A0662141B6D95CBDE416B3D83C0,11211,18,20,2,34,49,1749
16940,16940,4BE69A0662141B6D95CBDE416B3D83C0,13511,21,23,2,34,48,1748
16941,16941,1B914EA19E608B834149612681BFDCB4,43011,0,7,7,40,42,2042
16942,16942,1B914EA19E608B834149612681BFDCB4,12221,8,10,2,43,44,2194
16943,16943,1B914EA19E608B834149612681BFDCB4,43011,14,15,1,40,42,2042
16944,16944,1B914EA19E608B834149612681BFDCB4,13231,20,22,2,39,46,1996
16945,16945,880AD44DF9B4E770F566CF7DCA131A04,11151,0,7,7,30,48,1548
16946,16946,880AD44DF9B4E770F566CF7DCA131A04,43391,9,11,2,29,48,1498
16947,16947,880AD44DF9B4E770F566CF7DCA131A04,40341,12,15,3,23,49,1199
16948,16948,880AD44DF9B4E770F566CF7DCA131A04,11151,16,23,7,30,48,1548
16956,16956,B87FB85E8C7FF4656D0809BF48E9EA66,19031,0,6,6,1,42,92
16957,16957,B87FB85E8C7FF4656D0809BF48E9EA66,19744,9,12,3,6,43,343
16958,16958,B87FB85E8C7FF4656D0809BF48E9EA66,12921,14,16,2,9,41,491
16959,16959,B87FB85E8C7FF4656D0809BF48E9EA66,19031,20,22,2,1,42,92
16966,16966,0F8527F74C5F3D18A12D931F275C5702,11631,5,8,3,12,49,649
16967,16967,0F8527F74C5F3D18A12D931F275C5702,11951,10,16,6,31,49,1599
16968,16968,0F8527F74C5F3D18A12D931F275C5702,42521,19,21,2,31,47,1597
16973,16973,09C2A5500F5ABAEEAC932C07F5628EC4,11021,0,1,1,36,49,1849
16974,16974,09C2A5500F5ABAEEAC932C07F5628EC4,43161,8,12,4,35,47,1797
16975,16975,09C2A5500F5ABAEEAC932C07F5628EC4,11021,13,14,1,36,49,1849
16976,16976,09C2A5500F5ABAEEAC932C07F5628EC4,43161,14,18,4,35,47,1797
16977,16977,09C2A5500F5ABAEEAC932C07F5628EC4,11021,19,22,3,36,49,1849
16978,16978,BBCB9918D42B41DEDF16DD7F5A9BE26F,11861,0,11,11,32,47,1647
16979,16979,BBCB9918D42B41DEDF16DD7F5A9BE26F,42161,11,12,1,36,47,1847
16980,16980,BBCB9918D42B41DEDF16DD7F5A9BE26F,11331,13,16,3,37,48,1898
16981,16981,BBCB9918D42B41DEDF16DD7F5A9BE26F,11861,17,23,6,32,47,1647
16988,16988,62A81BAE02AD26F7FD1065485EC5610B,42321,0,5,5,43,47,2197
16989,16989,62A81BAE02AD26F7FD1065485EC5610B,42401,7,9,2,36,47,1847
16990,16990,62A81BAE02AD26F7FD1065485EC5610B,11351,9,18,9,36,48,1848
16991,16991,62A81BAE02AD26F7FD1065485EC5610B,42321,19,22,3,43,47,2197
16995,16995,E42D7380BBA7B204667A2743B10B7AC0,40277,0,1,1,35,49,1799
16996,16996,E42D7380BBA7B204667A2743B10B7AC0,12521,2,15,13,35,41,1791
16997,16997,E42D7380BBA7B204667A2743B10B7AC0,13071,19,21,2,41,41,2091
17001,17001,39EB4D3A98BB31BC89AD2CF96D05916B,11021,8,12,4,36,49,1849
17002,17002,39EB4D3A98BB31BC89AD2CF96D05916B,13731,14,16,2,33,49,1699
17003,17003,39EB4D3A98BB31BC89AD2CF96D05916B,12971,18,20,2,32,48,1648
17004,17004,39EB4D3A98BB31BC89AD2CF96D05916B,11021,20,22,2,36,49,1849
17005,17005,81565F9704E60766FEFBB47B416D00DF,12581,0,5,5,24,48,1248
17006,17006,81565F9704E60766FEFBB47B416D00DF,12051,6,7,1,20,47,1047
17007,17007,81565F9704E60766FEFBB47B416D00DF,42691,8,23,15,24,48,1248
17011,17011,A57EE631CA007FCA2295C6A6A2702AAC,10731,1,4,3,33,47,1697
17012,17012,A57EE631CA007FCA2295C6A6A2702AAC,42631,6,7,1,43,45,2195
17013,17013,A57EE631CA007FCA2295C6A6A2702AAC,10731,9,11,2,33,47,1697
17014,17014,A57EE631CA007FCA2295C6A6A2702AAC,11201,12,13,1,35,49,1799
17015,17015,A57EE631CA007FCA2295C6A6A2702AAC,42921,13,18,5,33,47,1697
17020,17020,CABDD8B2A8DF9C3C6F2F674E6DD5C884,11061,2,6,4,29,48,1498
17021,17021,CABDD8B2A8DF9C3C6F2F674E6DD5C884,11381,6,10,4,30,47,1547
17022,17022,CABDD8B2A8DF9C3C6F2F674E6DD5C884,40445,11,12,1,30,48,1548
17023,17023,CABDD8B2A8DF9C3C6F2F674E6DD5C884,10601,13,17,4,39,47,1997
17024,17024,CABDD8B2A8DF9C3C6F2F674E6DD5C884,11381,22,23,1,30,47,1547
17028,17028,435E98F8E4BA1C5ED5B064CF22D1AAF1,40302,0,9,9,40,49,2049
17029,17029,435E98F8E4BA1C5ED5B064CF22D1AAF1,40673,10,11,1,36,48,1848
17030,17030,435E98F8E4BA1C5ED5B064CF22D1AAF1,11771,16,21,5,39,49,1999
17035,17035,E4FD608720CF14FACCAF73A22E758728,13671,0,4,4,27,43,1393
17036,17036,E4FD608720CF14FACCAF73A22E758728,13314,6,8,2,31,39,1589
17037,17037,E4FD608720CF14FACCAF73A22E758728,13671,11,23,12,27,43,1393
17038,17038,3BFDEE5AA767E9C0C7179A3FAC680D84,43281,0,1,1,37,48,1898
17039,17039,3BFDEE5AA767E9C0C7179A3FAC680D84,11231,2,15,13,37,49,1899
17040,17040,3BFDEE5AA767E9C0C7179A3FAC680D84,11861,17,22,5,32,47,1647
17057,17057,340B7C40FCCF4779F4D216433BD5DF4B,42021,0,12,12,33,47,1697
17058,17058,340B7C40FCCF4779F4D216433BD5DF4B,11861,12,17,5,32,47,1647
17059,17059,340B7C40FCCF4779F4D216433BD5DF4B,43731,19,21,2,34,47,1747
17060,17060,340B7C40FCCF4779F4D216433BD5DF4B,11231,21,22,1,37,49,1899
17061,17061,D0472C9DD91559BE905CC394F1918AAD,10801,0,13,13,42,47,2147
17062,17062,D0472C9DD91559BE905CC394F1918AAD,42321,14,15,1,43,47,2197
17063,17063,D0472C9DD91559BE905CC394F1918AAD,11461,19,20,1,37,49,1899
17064,17064,1B6723837907F055291E1A5D25B38EE1,11201,1,5,4,35,49,1799
17065,17065,1B6723837907F055291E1A5D25B38EE1,40101,5,10,5,34,49,1749
17066,17066,1B6723837907F055291E1A5D25B38EE1,11151,14,18,4,30,48,1548
17067,17067,1B6723837907F055291E1A5D25B38EE1,11061,20,23,3,29,48,1498
17074,17074,68A24D68E1EE6F85D7484BA18462FF82,10292,6,7,1,30,47,1547
17075,17075,68A24D68E1EE6F85D7484BA18462FF82,13951,10,16,6,47,45,2395
17076,17076,68A24D68E1EE6F85D7484BA18462FF82,42523,16,18,2,31,47,1597
17077,17077,F81C2032F29455BDF8D1503096B79343,19901,0,9,9,7,44,394
17078,17078,F81C2032F29455BDF8D1503096B79343,40341,14,19,5,23,49,1199
17079,17079,F81C2032F29455BDF8D1503096B79343,11571,21,22,1,13,46,696
17080,17080,EF06CFD15B1A16A6B42F221D8AE07E7D,15145,3,5,2,22,9,1109
17081,17081,EF06CFD15B1A16A6B42F221D8AE07E7D,16251,7,9,2,15,13,763
17082,17082,EF06CFD15B1A16A6B42F221D8AE07E7D,16151,10,20,10,13,11,661
17083,17083,EF06CFD15B1A16A6B42F221D8AE07E7D,15145,21,22,1,22,9,1109
17088,17088,4E7614A4B91A30F096E19E723EE62442,10634,0,5,5,27,45,1395
17089,17089,4E7614A4B91A30F096E19E723EE62442,10351,5,7,2,28,45,1445
17090,17090,4E7614A4B91A30F096E19E723EE62442,10634,8,13,5,27,45,1395
17091,17091,4E7614A4B91A30F096E19E723EE62442,10171,15,17,2,26,47,1347
17092,17092,4E7614A4B91A30F096E19E723EE62442,10634,22,23,1,27,45,1395
17102,17102,A52680CFF3255B80F2E899094DC1E938,13951,0,6,6,47,45,2395
17103,17103,A52680CFF3255B80F2E899094DC1E938,43951,8,17,9,49,41,2491
17104,17104,A52680CFF3255B80F2E899094DC1E938,13951,19,21,2,47,45,2395
17105,17105,E92442C28CB44C67B1AFA3BE5AC81485,19261,2,11,9,6,37,337
17106,17106,E92442C28CB44C67B1AFA3BE5AC81485,19114,13,15,2,7,43,393
17107,17107,E92442C28CB44C67B1AFA3BE5AC81485,19181,16,20,4,8,40,440
17108,17108,E7A499EFF2705CCA8F4C4AD8B684EDF4,11201,0,8,8,35,49,1799
17109,17109,E7A499EFF2705CCA8F4C4AD8B684EDF4,10341,13,14,1,31,47,1597
17110,17110,E7A499EFF2705CCA8F4C4AD8B684EDF4,12381,15,16,1,32,48,1648
17111,17111,E7A499EFF2705CCA8F4C4AD8B684EDF4,11951,17,18,1,31,49,1599
17112,17112,E7A499EFF2705CCA8F4C4AD8B684EDF4,10221,19,20,1,34,49,1749
17116,17116,894242D805A17024D8C651CB94680B12,43361,0,1,1,38,48,1948
17117,17117,894242D805A17024D8C651CB94680B12,43181,3,4,1,39,48,1998
17118,17118,894242D805A17024D8C651CB94680B12,41601,8,9,1,39,49,1999
17119,17119,894242D805A17024D8C651CB94680B12,11481,13,15,2,41,48,2098
17120,17120,894242D805A17024D8C651CB94680B12,13101,15,17,2,40,47,2047
17121,17121,894242D805A17024D8C651CB94680B12,43181,19,21,2,39,48,1998
17122,17122,894242D805A17024D8C651CB94680B12,10191,21,23,2,40,48,2048
17133,17133,7308A861032DD6CDA204025A180927B9,11061,1,4,3,29,48,1498
17134,17134,7308A861032DD6CDA204025A180927B9,11381,4,9,5,30,47,1547
17135,17135,7308A861032DD6CDA204025A180927B9,42371,11,13,2,34,46,1746
17136,17136,7308A861032DD6CDA204025A180927B9,12311,14,17,3,30,44,1544
17137,17137,7308A861032DD6CDA204025A180927B9,42151,17,19,2,35,45,1795
17138,17138,085A54B112E93B58F53705ABE7F444E7,43621,0,6,6,46,48,2348
17139,17139,085A54B112E93B58F53705ABE7F444E7,42601,6,10,4,44,48,2248
17140,17140,085A54B112E93B58F53705ABE7F444E7,11701,14,15,1,43,48,2198
17141,17141,085A54B112E93B58F53705ABE7F444E7,43621,15,17,2,46,48,2348
17142,17142,085A54B112E93B58F53705ABE7F444E7,11701,17,20,3,43,48,2198
17143,17143,085A54B112E93B58F53705ABE7F444E7,42601,21,22,1,44,48,2248
17144,17144,5F1A334A366515FDAB700528394506CD,43731,0,13,13,34,47,1747
17145,17145,5F1A334A366515FDAB700528394506CD,10731,13,15,2,33,47,1697
17146,17146,5F1A334A366515FDAB700528394506CD,13314,17,19,2,31,39,1589
17147,17147,5F1A334A366515FDAB700528394506CD,42921,22,23,1,33,47,1697
17148,17148,CBDF034E68463476FF7CF3BFCDC64EE8,10271,0,7,7,37,46,1896
17149,17149,CBDF034E68463476FF7CF3BFCDC64EE8,40101,8,10,2,34,49,1749
17150,17150,CBDF034E68463476FF7CF3BFCDC64EE8,42511,11,13,2,37,47,1897
17151,17151,CBDF034E68463476FF7CF3BFCDC64EE8,40101,15,17,2,34,49,1749
17152,17152,CBDF034E68463476FF7CF3BFCDC64EE8,12514,19,20,1,38,47,1947
17153,17153,CBDF034E68463476FF7CF3BFCDC64EE8,11491,21,23,2,36,47,1847
17154,17154,27FD8A6CDE751A5F2BC12F75826C7985,12641,8,15,7,10,43,543
17155,17155,27FD8A6CDE751A5F2BC12F75826C7985,12921,15,16,1,9,41,491
17156,17156,27FD8A6CDE751A5F2BC12F75826C7985,43021,20,22,2,16,43,843
17164,17164,B33429D7A00DB66721EA07FF9AC9AB45,11861,0,9,9,32,47,1647
17165,17165,B33429D7A00DB66721EA07FF9AC9AB45,40077,10,22,12,37,49,1899
17166,17166,B33429D7A00DB66721EA07FF9AC9AB45,11861,22,23,1,32,47,1647
17167,17167,08B6161A63F0BFCCF67BFC0EA5B81E44,42081,0,6,6,24,49,1249
17168,17168,08B6161A63F0BFCCF67BFC0EA5B81E44,40341,6,10,4,23,49,1199
17169,17169,08B6161A63F0BFCCF67BFC0EA5B81E44,42081,11,13,2,24,49,1249
17170,17170,08B6161A63F0BFCCF67BFC0EA5B81E44,40341,14,21,7,23,49,1199
17171,17171,08B6161A63F0BFCCF67BFC0EA5B81E44,42621,21,23,2,24,49,1249
17180,17180,B24C1F0A2AC9F45C51191765E740A84A,42321,4,5,1,43,47,2197
17181,17181,B24C1F0A2AC9F45C51191765E740A84A,13351,9,10,1,48,48,2448
17182,17182,B24C1F0A2AC9F45C51191765E740A84A,42461,14,23,9,45,47,2297
17187,17187,50A8D48EEDC025C19A5AA5E39B3A8340,43761,0,7,7,32,47,1647
17188,17188,50A8D48EEDC025C19A5AA5E39B3A8340,13821,9,15,6,49,45,2495
17189,17189,50A8D48EEDC025C19A5AA5E39B3A8340,40951,18,20,2,36,49,1849
17190,17190,50A8D48EEDC025C19A5AA5E39B3A8340,11861,21,23,2,32,47,1647
17194,17194,F503E603617F2C8DE95DF3F33038AA90,11151,0,8,8,30,48,1548
17195,17195,F503E603617F2C8DE95DF3F33038AA90,40341,12,15,3,23,49,1199
17196,17196,F503E603617F2C8DE95DF3F33038AA90,11151,17,18,1,30,48,1548
17197,17197,1AF3413905A2A8813EEB1CD65CEC34FB,10531,0,14,14,34,46,1746
17198,17198,1AF3413905A2A8813EEB1CD65CEC34FB,13221,15,17,2,40,47,2047
17199,17199,1AF3413905A2A8813EEB1CD65CEC34FB,10331,18,20,2,39,46,1996
17204,17204,DAC6EE0BF01CC883CF0F199AE8233E29,11021,1,8,7,36,49,1849
17205,17205,DAC6EE0BF01CC883CF0F199AE8233E29,10221,9,17,8,34,49,1749
17206,17206,DAC6EE0BF01CC883CF0F199AE8233E29,11151,18,21,3,30,48,1548
17227,17227,34EF95CF2EE50BDF3E705BB4CA163ADD,11481,0,10,10,41,48,2098
17228,17228,34EF95CF2EE50BDF3E705BB4CA163ADD,10371,11,13,2,37,49,1899
17229,17229,34EF95CF2EE50BDF3E705BB4CA163ADD,10191,13,15,2,40,48,2048
17230,17230,34EF95CF2EE50BDF3E705BB4CA163ADD,10371,18,23,5,37,49,1899
17231,17231,7A880FE847C48EF3051E04A866E8ED9A,11741,0,1,1,42,49,2149
17232,17232,7A880FE847C48EF3051E04A866E8ED9A,10251,2,4,2,35,47,1797
17233,17233,7A880FE847C48EF3051E04A866E8ED9A,11741,5,9,4,42,49,2149
17234,17234,7A880FE847C48EF3051E04A866E8ED9A,42971,11,12,1,43,49,2199
17235,17235,7A880FE847C48EF3051E04A866E8ED9A,11741,13,14,1,42,49,2149
17236,17236,7A880FE847C48EF3051E04A866E8ED9A,13841,20,21,1,40,46,2046
17237,17237,7A880FE847C48EF3051E04A866E8ED9A,13221,22,23,1,40,47,2047
17258,17258,38EAD9C71E0631172BE43F523D61F0B8,42971,0,6,6,43,49,2199
17259,17259,38EAD9C71E0631172BE43F523D61F0B8,11061,8,10,2,29,48,1498
17260,17260,38EAD9C71E0631172BE43F523D61F0B8,42971,12,13,1,43,49,2199
17261,17261,38EAD9C71E0631172BE43F523D61F0B8,11061,15,18,3,29,48,1498
17262,17262,38EAD9C71E0631172BE43F523D61F0B8,42971,19,23,4,43,49,2199
17263,17263,46ECC1FB4BFD7A9CE6754D1733E3770C,43661,0,5,5,33,47,1697
17264,17264,46ECC1FB4BFD7A9CE6754D1733E3770C,42371,6,9,3,34,46,1746
17265,17265,46ECC1FB4BFD7A9CE6754D1733E3770C,10731,9,10,1,33,47,1697
17266,17266,46ECC1FB4BFD7A9CE6754D1733E3770C,42371,11,16,5,34,46,1746
17267,17267,46ECC1FB4BFD7A9CE6754D1733E3770C,11861,19,23,4,32,47,1647
17268,17268,B5980B50E16CAA8A40D53500802F1FEF,10111,4,10,6,37,47,1897
17269,17269,B5980B50E16CAA8A40D53500802F1FEF,10107,13,17,4,38,49,1949
17270,17270,B5980B50E16CAA8A40D53500802F1FEF,12051,20,23,3,20,47,1047
17271,17271,1C60CB0F57E29CF26D99169B6CE00B11,11381,1,8,7,30,47,1547
17272,17272,1C60CB0F57E29CF26D99169B6CE00B11,10781,10,18,8,35,47,1797
17273,17273,1C60CB0F57E29CF26D99169B6CE00B11,10107,19,22,3,38,49,1949
17283,17283,414AA00EC00DAA3D830C87A4F3E4DD09,11861,0,10,10,32,47,1647
17284,17284,414AA00EC00DAA3D830C87A4F3E4DD09,43981,12,15,3,36,49,1849
17285,17285,414AA00EC00DAA3D830C87A4F3E4DD09,13561,17,19,2,37,49,1899
17286,17286,414AA00EC00DAA3D830C87A4F3E4DD09,13601,22,23,1,34,47,1747
17293,17293,A26526FCE25758DA240C3B314B205E8A,19024,0,6,6,9,45,495
17294,17294,A26526FCE25758DA240C3B314B205E8A,12641,7,8,1,10,43,543
17295,17295,A26526FCE25758DA240C3B314B205E8A,19114,8,12,4,7,43,393
17296,17296,A26526FCE25758DA240C3B314B205E8A,19741,13,15,2,5,44,294
17297,17297,A26526FCE25758DA240C3B314B205E8A,19114,15,20,5,7,43,393
17298,17298,A26526FCE25758DA240C3B314B205E8A,19024,21,23,2,9,45,495
17305,17305,2C4C69FF2D37C8E0A5BE3260BCFBEED1,11261,1,7,6,36,46,1846
17306,17306,2C4C69FF2D37C8E0A5BE3260BCFBEED1,12491,7,9,2,36,43,1843
17307,17307,2C4C69FF2D37C8E0A5BE3260BCFBEED1,42151,13,14,1,35,45,1795
17308,17308,2C4C69FF2D37C8E0A5BE3260BCFBEED1,13071,16,17,1,41,41,2091
17309,17309,2C4C69FF2D37C8E0A5BE3260BCFBEED1,12491,21,22,1,36,43,1843
17310,17310,D5A1F589AD5A8A456E0D23A90489837D,43761,0,3,3,32,47,1647
17311,17311,D5A1F589AD5A8A456E0D23A90489837D,42921,4,5,1,33,47,1697
17312,17312,D5A1F589AD5A8A456E0D23A90489837D,43761,6,7,1,32,47,1647
17313,17313,D5A1F589AD5A8A456E0D23A90489837D,11231,11,17,6,37,49,1899
17314,17314,D5A1F589AD5A8A456E0D23A90489837D,43761,21,22,1,32,47,1647
17315,17315,1BEBD7DF37EE7B82E2300539E727A56A,10841,0,2,2,37,47,1897
17316,17316,1BEBD7DF37EE7B82E2300539E727A56A,13331,3,7,4,38,47,1947
17317,17317,1BEBD7DF37EE7B82E2300539E727A56A,10841,7,11,4,37,47,1897
17318,17318,1BEBD7DF37EE7B82E2300539E727A56A,10601,14,15,1,39,47,1997
17319,17319,1BEBD7DF37EE7B82E2300539E727A56A,10841,15,21,6,37,47,1897
17324,17324,9DA7BAB7FB3814204B7C4507A07E372B,10151,0,16,16,34,47,1747
17325,17325,9DA7BAB7FB3814204B7C4507A07E372B,43951,17,19,2,49,41,2491
17326,17326,9DA7BAB7FB3814204B7C4507A07E372B,10151,22,23,1,34,47,1747
17327,17327,0D9AA89290D1F445356B85B4B256A343,11001,0,6,6,42,47,2147
17328,17328,0D9AA89290D1F445356B85B4B256A343,10811,8,10,2,38,46,1946
17329,17329,0D9AA89290D1F445356B85B4B256A343,10521,11,13,2,41,47,2097
17330,17330,0D9AA89290D1F445356B85B4B256A343,10811,16,17,1,38,46,1946
17331,17331,0D9AA89290D1F445356B85B4B256A343,11001,19,20,1,42,47,2147
17332,17332,0D9AA89290D1F445356B85B4B256A343,13941,20,21,1,41,47,2097
17340,17340,2089CCBC2F855C8416A68A67F03D7345,11561,1,7,6,32,49,1649
17341,17341,2089CCBC2F855C8416A68A67F03D7345,10161,7,10,3,35,49,1799
17342,17342,2089CCBC2F855C8416A68A67F03D7345,11231,14,17,3,37,49,1899
17343,17343,2089CCBC2F855C8416A68A67F03D7345,43731,18,20,2,34,47,1747
17344,17344,6D411464E8569334C6217011CDDAB47B,43661,0,5,5,33,47,1697
17345,17345,6D411464E8569334C6217011CDDAB47B,42231,8,10,2,37,46,1896
17346,17346,6D411464E8569334C6217011CDDAB47B,42161,14,15,1,36,47,1847
17347,17347,6D411464E8569334C6217011CDDAB47B,43161,18,19,1,35,47,1797
17348,17348,6D411464E8569334C6217011CDDAB47B,43661,20,22,2,33,47,1697
17362,17362,BF866CAC6181D104CF2321FFD1D54D90,10292,0,12,12,30,47,1547
17363,17363,BF866CAC6181D104CF2321FFD1D54D90,11211,16,17,1,34,49,1749
17364,17364,BF866CAC6181D104CF2321FFD1D54D90,42521,19,21,2,31,47,1597
17365,17365,3C5BF8354C7B22C00BFA5438C070BC0F,13711,0,8,8,38,46,1946
17366,17366,3C5BF8354C7B22C00BFA5438C070BC0F,43241,8,10,2,36,46,1846
17367,17367,3C5BF8354C7B22C00BFA5438C070BC0F,13711,13,15,2,38,46,1946
17368,17368,3C5BF8354C7B22C00BFA5438C070BC0F,43241,15,19,4,36,46,1846
17369,17369,3C5BF8354C7B22C00BFA5438C070BC0F,13711,19,22,3,38,46,1946
17385,17385,86F83A4789830DBB7C5E8BC1D0F8B089,12671,2,4,2,21,43,1093
17386,17386,86F83A4789830DBB7C5E8BC1D0F8B089,12921,5,9,4,9,41,491
17387,17387,86F83A4789830DBB7C5E8BC1D0F8B089,13091,10,11,1,20,42,1042
17388,17388,86F83A4789830DBB7C5E8BC1D0F8B089,12921,13,18,5,9,41,491
17389,17389,44AA91905A7E8DBC24B0A51CC88C9204,42151,0,8,8,35,45,1795
17390,17390,44AA91905A7E8DBC24B0A51CC88C9204,11381,10,16,6,30,47,1547
17391,17391,44AA91905A7E8DBC24B0A51CC88C9204,42151,19,21,2,35,45,1795
17392,17392,96B100113D40E22B39686C026F5DA397,13461,0,6,6,39,44,1994
17393,17393,96B100113D40E22B39686C026F5DA397,11261,7,8,1,36,46,1846
17394,17394,96B100113D40E22B39686C026F5DA397,42864,8,10,2,38,44,1944
17395,17395,96B100113D40E22B39686C026F5DA397,11261,11,15,4,36,46,1846
17396,17396,96B100113D40E22B39686C026F5DA397,42864,16,17,1,38,44,1944
17397,17397,96B100113D40E22B39686C026F5DA397,11261,20,21,1,36,46,1846
17402,17402,05AF8A9F0E8A06352A19F98381EEE035,12131,0,7,7,32,47,1647
17403,17403,05AF8A9F0E8A06352A19F98381EEE035,43751,8,14,6,19,48,998
17404,17404,05AF8A9F0E8A06352A19F98381EEE035,42491,18,20,2,32,46,1646
17405,17405,6C0E943C8B3CE3071E466B3888DE833C,42531,6,9,3,31,45,1595
17406,17406,6C0E943C8B3CE3071E466B3888DE833C,12311,14,17,3,30,44,1544
17407,17407,6C0E943C8B3CE3071E466B3888DE833C,19744,19,21,2,6,43,343
17408,17408,B8DCAC0FC6FA981D871032E55C240C8E,11914,5,15,10,37,48,1898
17409,17409,B8DCAC0FC6FA981D871032E55C240C8E,42581,15,17,2,38,48,1948
17410,17410,B8DCAC0FC6FA981D871032E55C240C8E,10471,18,20,2,37,48,1898
17411,17411,B8DCAC0FC6FA981D871032E55C240C8E,42191,20,22,2,38,49,1949
17412,17412,B8DCAC0FC6FA981D871032E55C240C8E,11914,22,23,1,37,48,1898
17413,17413,E129E250452098C10CCF7A03E7B60A11,42071,3,6,3,31,49,1599
17414,17414,E129E250452098C10CCF7A03E7B60A11,42261,11,13,2,25,49,1299
17415,17415,E129E250452098C10CCF7A03E7B60A11,42071,17,19,2,31,49,1599
17416,17416,946768BFA72752D5660750415178C67F,11081,1,3,2,35,46,1796
17417,17417,946768BFA72752D5660750415178C67F,43731,4,7,3,34,47,1747
17418,17418,946768BFA72752D5660750415178C67F,10511,9,17,8,35,46,1796
17419,17419,946768BFA72752D5660750415178C67F,43731,19,20,1,34,47,1747
17420,17420,946768BFA72752D5660750415178C67F,11651,22,23,1,33,47,1697
17421,17421,62FC933E25D26B5E42DD5C2C2597D1C7,12121,0,8,8,29,47,1497
17422,17422,62FC933E25D26B5E42DD5C2C2597D1C7,13671,11,14,3,27,43,1393
17423,17423,62FC933E25D26B5E42DD5C2C2597D1C7,11791,15,17,2,38,49,1949
17424,17424,62FC933E25D26B5E42DD5C2C2597D1C7,11061,19,20,1,29,48,1498
17425,17425,62FC933E25D26B5E42DD5C2C2597D1C7,12121,20,23,3,29,47,1497
17426,17426,74EBB90FA1C414F58477B49370E7F73F,11861,0,7,7,32,47,1647
17427,17427,74EBB90FA1C414F58477B49370E7F73F,12311,7,13,6,30,44,1544
17428,17428,74EBB90FA1C414F58477B49370E7F73F,11861,18,23,5,32,47,1647
17429,17429,139E705FEB960DA0C2327BA21AC8A84C,40171,0,1,1,38,48,1948
17430,17430,139E705FEB960DA0C2327BA21AC8A84C,42031,2,6,4,40,46,2046
17431,17431,139E705FEB960DA0C2327BA21AC8A84C,13941,7,8,1,41,47,2097
17432,17432,139E705FEB960DA0C2327BA21AC8A84C,11806,8,14,6,41,48,2098
17433,17433,139E705FEB960DA0C2327BA21AC8A84C,13371,15,17,2,41,47,2097
17434,17434,139E705FEB960DA0C2327BA21AC8A84C,11481,21,23,2,41,48,2098
17439,17439,39179060954ADF536A44D5CDC3D7ADA4,10921,0,5,5,43,48,2198
17440,17440,39179060954ADF536A44D5CDC3D7ADA4,13911,6,9,3,39,46,1996
17441,17441,39179060954ADF536A44D5CDC3D7ADA4,11261,10,11,1,36,46,1846
17442,17442,39179060954ADF536A44D5CDC3D7ADA4,42351,11,12,1,38,45,1945
17443,17443,39179060954ADF536A44D5CDC3D7ADA4,13911,13,18,5,39,46,1996
17444,17444,39179060954ADF536A44D5CDC3D7ADA4,11261,18,20,2,36,46,1846
17449,17449,639EA486291B8A87A84D90343A87732A,10451,0,6,6,25,48,1298
17450,17450,639EA486291B8A87A84D90343A87732A,13091,10,12,2,20,42,1042
17451,17451,639EA486291B8A87A84D90343A87732A,10661,14,15,1,37,49,1899
17452,17452,639EA486291B8A87A84D90343A87732A,10491,18,19,1,33,48,1698
17453,17453,639EA486291B8A87A84D90343A87732A,11111,19,22,3,26,48,1348
17457,17457,A5A342C5B79B8AEE00BA80AE678B8EC5,10331,0,7,7,39,46,1996
17458,17458,A5A342C5B79B8AEE00BA80AE678B8EC5,10151,11,15,4,34,47,1747
17459,17459,A5A342C5B79B8AEE00BA80AE678B8EC5,11151,15,18,3,30,48,1548
17460,17460,A5A342C5B79B8AEE00BA80AE678B8EC5,10331,19,23,4,39,46,1996
17461,17461,2881834474B021D3CB48D66D6B38B4E5,11921,0,6,6,38,48,1948
17462,17462,2881834474B021D3CB48D66D6B38B4E5,42523,9,15,6,31,47,1597
17463,17463,2881834474B021D3CB48D66D6B38B4E5,12131,15,16,1,32,47,1647
17464,17464,2881834474B021D3CB48D66D6B38B4E5,11921,18,23,5,38,48,1948
17465,17465,B83BCE458ADDCFED4DD9A769B8669EC2,10711,8,10,2,29,46,1496
17466,17466,B83BCE458ADDCFED4DD9A769B8669EC2,13671,10,11,1,27,43,1393
17467,17467,B83BCE458ADDCFED4DD9A769B8669EC2,11781,14,22,8,38,49,1949
17468,17468,6DFBF28C4BB1FC2BFED5E053C4C14307,43581,0,6,6,33,48,1698
17469,17469,6DFBF28C4BB1FC2BFED5E053C4C14307,19441,9,13,4,8,46,446
17470,17470,6DFBF28C4BB1FC2BFED5E053C4C14307,43581,17,23,6,33,48,1698
17471,17471,9C819019C9FBB04766CC6EE29C66CE0E,11331,2,5,3,37,48,1898
17472,17472,9C819019C9FBB04766CC6EE29C66CE0E,12514,10,17,7,38,47,1947
17473,17473,9C819019C9FBB04766CC6EE29C66CE0E,10841,17,18,1,37,47,1897
17474,17474,9C819019C9FBB04766CC6EE29C66CE0E,10191,19,21,2,40,48,2048
17475,17475,9C819019C9FBB04766CC6EE29C66CE0E,40636,21,23,2,35,48,1798
17479,17479,1A6A180FC1652CDA8F079E8572A81E38,42501,1,7,6,28,47,1447
17480,17480,1A6A180FC1652CDA8F079E8572A81E38,12083,8,17,9,36,49,1849
17481,17481,1A6A180FC1652CDA8F079E8572A81E38,12121,19,22,3,29,47,1497
17482,17482,5FA17670CF7B34EAE6DE8FBA5C753F49,12661,0,8,8,32,45,1645
17483,17483,5FA17670CF7B34EAE6DE8FBA5C753F49,11231,12,14,2,37,49,1899
17484,17484,5FA17670CF7B34EAE6DE8FBA5C753F49,40891,18,21,3,37,47,1897
17488,17488,EA6B8CBE634579C9093B157538F58AA2,42021,1,2,1,33,47,1697
17489,17489,EA6B8CBE634579C9093B157538F58AA2,43761,4,6,2,32,47,1647
17490,17490,EA6B8CBE634579C9093B157538F58AA2,10281,11,12,1,33,48,1698
17491,17491,EA6B8CBE634579C9093B157538F58AA2,10731,14,18,4,33,47,1697
17492,17492,EA6B8CBE634579C9093B157538F58AA2,40341,19,21,2,23,49,1199
17502,17502,BADA272DF2446FC7721DEAA4CB34876B,11461,0,6,6,37,49,1899
17503,17503,BADA272DF2446FC7721DEAA4CB34876B,12121,6,10,4,29,47,1497
17504,17504,BADA272DF2446FC7721DEAA4CB34876B,43761,14,15,1,32,47,1647
17505,17505,BADA272DF2446FC7721DEAA4CB34876B,10251,17,19,2,35,47,1797
17506,17506,BADA272DF2446FC7721DEAA4CB34876B,42191,19,23,4,38,49,1949
17517,17517,A910A64B88EF93AE4B4F67D39EA167CE,10471,0,16,16,37,48,1898
17518,17518,A910A64B88EF93AE4B4F67D39EA167CE,40341,17,19,2,23,49,1199
17519,17519,A910A64B88EF93AE4B4F67D39EA167CE,43361,20,23,3,38,48,1948
17530,17530,FB55B20B748C0A1CF26B4BE2B509424A,13671,10,12,2,27,43,1393
17531,17531,FB55B20B748C0A1CF26B4BE2B509424A,12761,12,13,1,25,40,1290
17532,17532,FB55B20B748C0A1CF26B4BE2B509424A,13671,14,18,4,27,43,1393
17533,17533,FB55B20B748C0A1CF26B4BE2B509424A,12761,21,23,2,25,40,1290
17534,17534,5F17942389EDB952EA52D3EC24EE812F,10341,0,13,13,31,47,1597
17535,17535,5F17942389EDB952EA52D3EC24EE812F,12514,14,16,2,38,47,1947
17536,17536,5F17942389EDB952EA52D3EC24EE812F,10341,18,23,5,31,47,1597
17537,17537,9860684852E504726B6048155048EB49,42151,7,15,8,35,45,1795
17538,17538,9860684852E504726B6048155048EB49,11001,16,18,2,42,47,2147
17539,17539,9860684852E504726B6048155048EB49,42151,21,23,2,35,45,1795
17540,17540,98029F333AC5519D4BA1B7A7F8079304,41721,0,8,8,39,48,1998
17541,17541,98029F333AC5519D4BA1B7A7F8079304,10431,10,12,2,33,49,1699
17542,17542,98029F333AC5519D4BA1B7A7F8079304,41721,12,14,2,39,48,1998
17543,17543,98029F333AC5519D4BA1B7A7F8079304,11731,18,22,4,36,48,1848
17544,17544,C6A8E88AF4FAB8E3B900B709C1644500,40673,0,7,7,36,48,1848
17545,17545,C6A8E88AF4FAB8E3B900B709C1644500,10107,12,14,2,38,49,1949
17546,17546,C6A8E88AF4FAB8E3B900B709C1644500,13961,16,18,2,42,48,2148
17547,17547,C6A8E88AF4FAB8E3B900B709C1644500,42021,18,23,5,33,47,1697
17558,17558,71AB304A084EB4095E1F705C48CB0E23,11901,0,7,7,42,49,2149
17559,17559,71AB304A084EB4095E1F705C48CB0E23,11914,7,8,1,37,48,1898
17560,17560,71AB304A084EB4095E1F705C48CB0E23,42581,9,10,1,38,48,1948
17561,17561,71AB304A084EB4095E1F705C48CB0E23,11914,12,17,5,37,48,1898
17562,17562,71AB304A084EB4095E1F705C48CB0E23,11901,18,22,4,42,49,2149
17563,17563,644074FAED2D07B771DBBC3C2ED7ABF4,13411,0,5,5,49,42,2492
17564,17564,644074FAED2D07B771DBBC3C2ED7ABF4,43951,6,11,5,49,41,2491
17565,17565,644074FAED2D07B771DBBC3C2ED7ABF4,13411,12,13,1,49,42,2492
17566,17566,644074FAED2D07B771DBBC3C2ED7ABF4,43951,14,18,4,49,41,2491
17567,17567,644074FAED2D07B771DBBC3C2ED7ABF4,13411,20,23,3,49,42,2492
17568,17568,94E4CE9A5B386DF53468648670EAB773,42151,0,1,1,35,45,1795
17569,17569,94E4CE9A5B386DF53468648670EAB773,13111,2,8,6,42,46,2146
17570,17570,94E4CE9A5B386DF53468648670EAB773,13791,8,12,4,42,47,2147
17571,17571,94E4CE9A5B386DF53468648670EAB773,42151,14,18,4,35,45,1795
17572,17572,94E4CE9A5B386DF53468648670EAB773,11861,22,23,1,32,47,1647
17573,17573,5B38B567B1C7BA8CD66BEFDF9C575D7A,11231,1,8,7,37,49,1899
17574,17574,5B38B567B1C7BA8CD66BEFDF9C575D7A,12971,9,10,1,32,48,1648
17575,17575,5B38B567B1C7BA8CD66BEFDF9C575D7A,12083,10,12,2,36,49,1849
17576,17576,5B38B567B1C7BA8CD66BEFDF9C575D7A,11231,13,17,4,37,49,1899
17577,17577,5B38B567B1C7BA8CD66BEFDF9C575D7A,12083,17,19,2,36,49,1849
17578,17578,5B38B567B1C7BA8CD66BEFDF9C575D7A,11151,20,21,1,30,48,1548
17585,17585,8420BC80E057341A3D646D0572754A34,12514,0,2,2,38,47,1947
17586,17586,8420BC80E057341A3D646D0572754A34,11074,3,5,2,37,47,1897
17587,17587,8420BC80E057341A3D646D0572754A34,12514,5,6,1,38,47,1947
17588,17588,8420BC80E057341A3D646D0572754A34,11921,18,19,1,38,48,1948
17589,17589,8420BC80E057341A3D646D0572754A34,12514,20,21,1,38,47,1947
17597,17597,394D700E14C58A7853C10805B183B24E,11381,0,1,1,30,47,1547
17598,17598,394D700E14C58A7853C10805B183B24E,11061,1,3,2,29,48,1498
17599,17599,394D700E14C58A7853C10805B183B24E,11381,3,7,4,30,47,1547
17600,17600,394D700E14C58A7853C10805B183B24E,11871,8,17,9,29,46,1496
17601,17601,394D700E14C58A7853C10805B183B24E,11061,19,20,1,29,48,1498
17602,17602,394D700E14C58A7853C10805B183B24E,11381,20,22,2,30,47,1547
17606,17606,AE75926099C9D8D8FF34F46584B3662D,13671,5,7,2,27,43,1393
17607,17607,AE75926099C9D8D8FF34F46584B3662D,10634,9,19,10,27,45,1395
17608,17608,AE75926099C9D8D8FF34F46584B3662D,10681,21,22,1,30,48,1548
17612,17612,9B628FEA6BCA8EB97BB3F7B5F63CD306,13911,0,6,6,39,46,1996
17613,17613,9B628FEA6BCA8EB97BB3F7B5F63CD306,12601,9,10,1,25,47,1297
17614,17614,9B628FEA6BCA8EB97BB3F7B5F63CD306,10351,11,16,5,28,45,1445
17615,17615,9B628FEA6BCA8EB97BB3F7B5F63CD306,13911,19,23,4,39,46,1996
17619,17619,52A3E1CE4491060F392925C38B78647A,10221,0,7,7,34,49,1749
17620,17620,52A3E1CE4491060F392925C38B78647A,10841,8,18,10,37,47,1897
17621,17621,52A3E1CE4491060F392925C38B78647A,43581,20,21,1,33,48,1698
17622,17622,75B6D91479467607B0BA166BDAF35CA1,10431,0,6,6,33,49,1699
17623,17623,75B6D91479467607B0BA166BDAF35CA1,42141,7,8,1,32,47,1647
17624,17624,75B6D91479467607B0BA166BDAF35CA1,10431,11,12,1,33,49,1699
17625,17625,75B6D91479467607B0BA166BDAF35CA1,11861,14,15,1,32,47,1647
17626,17626,75B6D91479467607B0BA166BDAF35CA1,10431,17,19,2,33,49,1699
17627,17627,75B6D91479467607B0BA166BDAF35CA1,12031,19,20,1,33,48,1698
17628,17628,75B6D91479467607B0BA166BDAF35CA1,10431,21,22,1,33,49,1699
17629,17629,83D4CEED38BB3CF6CFCB6A83B566A9F4,13411,0,10,10,49,42,2492
17630,17630,83D4CEED38BB3CF6CFCB6A83B566A9F4,12561,13,19,6,45,43,2293
17631,17631,83D4CEED38BB3CF6CFCB6A83B566A9F4,43951,19,21,2,49,41,2491
17635,17635,1DA09CF3DD846164BECC97C839AAFF35,42961,0,2,2,35,49,1799
17636,17636,1DA09CF3DD846164BECC97C839AAFF35,12221,3,13,10,43,44,2194
17637,17637,1DA09CF3DD846164BECC97C839AAFF35,12561,14,15,1,45,43,2293
17638,17638,1DA09CF3DD846164BECC97C839AAFF35,13551,20,21,1,45,38,2288
17639,17639,1DA09CF3DD846164BECC97C839AAFF35,42191,22,23,1,38,49,1949
17643,17643,06EE14C8EFDE3AC12BFED6C37CF48014,11661,0,7,7,40,49,2049
17644,17644,06EE14C8EFDE3AC12BFED6C37CF48014,10511,7,11,4,35,46,1796
17645,17645,06EE14C8EFDE3AC12BFED6C37CF48014,42471,15,16,1,35,49,1799
17646,17646,06EE14C8EFDE3AC12BFED6C37CF48014,41382,18,20,2,38,49,1949
17647,17647,06EE14C8EFDE3AC12BFED6C37CF48014,11661,21,23,2,40,49,2049
17663,17663,177168A1104485CCD77EDFA93575365C,12381,0,9,9,32,48,1648
17664,17664,177168A1104485CCD77EDFA93575365C,10411,9,10,1,36,48,1848
17665,17665,177168A1104485CCD77EDFA93575365C,42341,11,12,1,43,49,2199
17666,17666,177168A1104485CCD77EDFA93575365C,12381,14,17,3,32,48,1648
17667,17667,177168A1104485CCD77EDFA93575365C,43311,21,23,2,31,48,1598
17671,17671,746CB0CCED9D118622CC6B5A24F5A58B,42601,6,7,1,44,48,2248
17672,17672,746CB0CCED9D118622CC6B5A24F5A58B,40171,16,18,2,38,48,1948
17673,17673,746CB0CCED9D118622CC6B5A24F5A58B,10661,18,20,2,37,49,1899
17674,17674,746CB0CCED9D118622CC6B5A24F5A58B,10651,21,23,2,36,49,1849
17675,17675,ECBC886277109C0582E65AB313F27C1C,13314,0,5,5,31,39,1589
17676,17676,ECBC886277109C0582E65AB313F27C1C,12521,8,20,12,35,41,1791
17677,17677,ECBC886277109C0582E65AB313F27C1C,13314,20,23,3,31,39,1589
17682,17682,C493E8EAD829832CA31397E82BE4990B,43021,0,8,8,16,43,843
17683,17683,C493E8EAD829832CA31397E82BE4990B,19901,9,10,1,7,44,394
17684,17684,C493E8EAD829832CA31397E82BE4990B,43021,12,19,7,16,43,843
17685,17685,C493E8EAD829832CA31397E82BE4990B,12641,19,22,3,10,43,543
17692,17692,8061B58A3DB1EED7FDE662D9B2D7F5BF,10221,0,11,11,34,49,1749
17693,17693,8061B58A3DB1EED7FDE662D9B2D7F5BF,12792,13,14,1,34,30,1730
17694,17694,8061B58A3DB1EED7FDE662D9B2D7F5BF,10221,18,23,5,34,49,1749
17695,17695,091497AD7ED956A0C3F93F46CFB651F5,43021,0,19,19,16,43,843
17696,17696,091497AD7ED956A0C3F93F46CFB651F5,12921,20,21,1,9,41,491
17697,17697,091497AD7ED956A0C3F93F46CFB651F5,43021,22,23,1,16,43,843
17712,17712,1DA79481C6B6D1D9223A378A0D81757A,10111,0,7,7,37,47,1897
17713,17713,1DA79481C6B6D1D9223A378A0D81757A,40882,9,17,8,34,49,1749
17714,17714,1DA79481C6B6D1D9223A378A0D81757A,10111,17,23,6,37,47,1897
17715,17715,D6553FC98A27307181CDBCB3E58A1E0C,42031,0,17,17,40,46,2046
17716,17716,D6553FC98A27307181CDBCB3E58A1E0C,10811,17,19,2,38,46,1946
17717,17717,D6553FC98A27307181CDBCB3E58A1E0C,11461,20,22,2,37,49,1899
17718,17718,ABB7908504B9826617EB863831FE84A7,19441,0,6,6,8,46,446
17719,17719,ABB7908504B9826617EB863831FE84A7,43241,11,12,1,36,46,1846
17720,17720,ABB7908504B9826617EB863831FE84A7,19441,16,23,7,8,46,446
17724,17724,F4A5CE128B0276BA64A57CF9F5D60F74,42831,0,14,14,27,48,1398
17725,17725,F4A5CE128B0276BA64A57CF9F5D60F74,12401,18,20,2,39,49,1999
17726,17726,F4A5CE128B0276BA64A57CF9F5D60F74,42831,20,23,3,27,48,1398
17727,17727,F0D6A0DD95FECBA9B8057DD90C2A5CED,11381,1,2,1,30,47,1547
17728,17728,F0D6A0DD95FECBA9B8057DD90C2A5CED,10681,3,4,1,30,48,1548
17729,17729,F0D6A0DD95FECBA9B8057DD90C2A5CED,11381,7,10,3,30,47,1547
17730,17730,F0D6A0DD95FECBA9B8057DD90C2A5CED,11061,12,16,4,29,48,1498
17731,17731,F0D6A0DD95FECBA9B8057DD90C2A5CED,11381,20,23,3,30,47,1547
17732,17732,5767E0EE50B7CB3B0CFBFCA7463471BC,11806,0,7,7,41,48,2098
17733,17733,5767E0EE50B7CB3B0CFBFCA7463471BC,13791,8,11,3,42,47,2147
17734,17734,5767E0EE50B7CB3B0CFBFCA7463471BC,11806,12,14,2,41,48,2098
17735,17735,5767E0EE50B7CB3B0CFBFCA7463471BC,13791,14,17,3,42,47,2147
17736,17736,5767E0EE50B7CB3B0CFBFCA7463471BC,42271,18,19,1,40,47,2047
17740,17740,37249EB4739B3E256BC3BA3615F71B48,10107,0,13,13,38,49,1949
17741,17741,37249EB4739B3E256BC3BA3615F71B48,40341,14,18,4,23,49,1199
17742,17742,37249EB4739B3E256BC3BA3615F71B48,10107,19,22,3,38,49,1949
17767,17767,F681B79833B44C7DE260E9A55ED030A3,19741,0,6,6,5,44,294
17768,17768,F681B79833B44C7DE260E9A55ED030A3,12921,7,10,3,9,41,491
17769,17769,F681B79833B44C7DE260E9A55ED030A3,19741,12,14,2,5,44,294
17770,17770,F681B79833B44C7DE260E9A55ED030A3,19111,16,18,2,9,45,495
17771,17771,F681B79833B44C7DE260E9A55ED030A3,19741,22,23,1,5,44,294
17772,17772,2F1C8D9FAE6F590877A6B56A0F3BCFE5,13601,0,8,8,34,47,1747
17773,17773,2F1C8D9FAE6F590877A6B56A0F3BCFE5,11061,9,18,9,29,48,1498
17774,17774,2F1C8D9FAE6F590877A6B56A0F3BCFE5,10381,22,23,1,31,49,1599
17775,17775,112D73984BEFF27B4D8267205C95643D,13711,0,7,7,38,46,1946
17776,17776,112D73984BEFF27B4D8267205C95643D,42631,13,14,1,43,45,2195
17777,17777,112D73984BEFF27B4D8267205C95643D,42633,16,21,5,42,46,2146
17778,17778,951E4A9F24E81DD7E0BF78CE09FD6CB8,15671,4,5,1,37,26,1876
17779,17779,951E4A9F24E81DD7E0BF78CE09FD6CB8,12792,6,10,4,34,30,1730
17780,17780,951E4A9F24E81DD7E0BF78CE09FD6CB8,12611,10,21,11,41,29,2079
17781,17781,951E4A9F24E81DD7E0BF78CE09FD6CB8,12792,22,23,1,34,30,1730
17805,17805,F8A2EC8C9348BFB1362087B807B825C5,43971,1,7,6,30,48,1548
17806,17806,F8A2EC8C9348BFB1362087B807B825C5,40271,8,15,7,35,49,1799
17807,17807,F8A2EC8C9348BFB1362087B807B825C5,43971,18,20,2,30,48,1548
17808,17808,7861278735CDA91B9BABB196FBF7605C,43951,0,2,2,49,41,2491
17809,17809,7861278735CDA91B9BABB196FBF7605C,13951,12,17,5,47,45,2395
17810,17810,7861278735CDA91B9BABB196FBF7605C,43951,18,20,2,49,41,2491
17830,17830,15AF53FBA0C13FBD61024895398ED2FD,19441,5,14,9,8,46,446
17831,17831,15AF53FBA0C13FBD61024895398ED2FD,11471,15,17,2,12,48,648
17832,17832,15AF53FBA0C13FBD61024895398ED2FD,42041,18,19,1,10,47,547
17833,17833,F6947486712885EDC02BCA122A5A6DB5,15061,0,10,10,41,25,2075
17834,17834,F6947486712885EDC02BCA122A5A6DB5,12881,10,20,10,47,22,2372
17835,17835,F6947486712885EDC02BCA122A5A6DB5,15061,21,22,1,41,25,2075
17836,17836,6AD981E757B177FB5B64F1D1D2EAA27F,40637,0,1,1,36,47,1847
17837,17837,6AD981E757B177FB5B64F1D1D2EAA27F,12651,2,8,6,43,47,2197
17838,17838,6AD981E757B177FB5B64F1D1D2EAA27F,10161,11,14,3,35,49,1799
17839,17839,6AD981E757B177FB5B64F1D1D2EAA27F,41591,18,20,2,34,49,1749
17846,17846,DC15358175A492C6F21AAEFAD4CD0BB7,42161,0,9,9,36,47,1847
17847,17847,DC15358175A492C6F21AAEFAD4CD0BB7,42521,13,18,5,31,47,1597
17848,17848,DC15358175A492C6F21AAEFAD4CD0BB7,42161,18,23,5,36,47,1847
17849,17849,25EAED890491CE9B7F2C263D1F2F3911,11461,3,7,4,37,49,1899
17850,17850,25EAED890491CE9B7F2C263D1F2F3911,10471,8,12,4,37,48,1898
17851,17851,25EAED890491CE9B7F2C263D1F2F3911,42941,14,18,4,37,47,1897
17852,17852,25EAED890491CE9B7F2C263D1F2F3911,40341,19,21,2,23,49,1199
17853,17853,25EAED890491CE9B7F2C263D1F2F3911,42941,22,23,1,37,47,1897
17854,17854,1F586282DD0AC03725A5E548411F5D82,10841,0,2,2,37,47,1897
17855,17855,1F586282DD0AC03725A5E548411F5D82,12514,5,13,8,38,47,1947
17856,17856,1F586282DD0AC03725A5E548411F5D82,10841,16,17,1,37,47,1897
17857,17857,1F586282DD0AC03725A5E548411F5D82,12514,18,20,2,38,47,1947
17858,17858,1F586282DD0AC03725A5E548411F5D82,10841,21,22,1,37,47,1897
17863,17863,A6FD529C3EA66C1845775EA07FC46A8F,12581,1,2,1,24,48,1248
17864,17864,A6FD529C3EA66C1845775EA07FC46A8F,12601,3,12,9,25,47,1297
17865,17865,A6FD529C3EA66C1845775EA07FC46A8F,10341,13,14,1,31,47,1597
17866,17866,A6FD529C3EA66C1845775EA07FC46A8F,12581,17,23,6,24,48,1248
17873,17873,A5A8A52E12DA723A69762D9D14542129,13711,0,6,6,38,46,1946
17874,17874,A5A8A52E12DA723A69762D9D14542129,13771,8,15,7,21,45,1095
17875,17875,A5A8A52E12DA723A69762D9D14542129,13711,18,23,5,38,46,1946
17880,17880,AA9DDBAE747C0C61A76E689DD898E315,42301,0,7,7,36,47,1847
17881,17881,AA9DDBAE747C0C61A76E689DD898E315,10301,9,10,1,31,45,1595
17882,17882,AA9DDBAE747C0C61A76E689DD898E315,42871,12,16,4,30,45,1545
17883,17883,AA9DDBAE747C0C61A76E689DD898E315,42301,17,22,5,36,47,1847
17908,17908,45D6DC753A70E5EDE4E9A4A90E8F23A4,42301,0,9,9,36,47,1847
17909,17909,45D6DC753A70E5EDE4E9A4A90E8F23A4,42201,10,12,2,43,46,2196
17910,17910,45D6DC753A70E5EDE4E9A4A90E8F23A4,13341,12,15,3,44,45,2245
17911,17911,45D6DC753A70E5EDE4E9A4A90E8F23A4,12391,17,18,1,36,49,1849
17912,17912,45D6DC753A70E5EDE4E9A4A90E8F23A4,42201,20,21,1,43,46,2196
17913,17913,5D3AB87CDE152EA5E956E4DDC06AC59B,43361,0,7,7,38,48,1948
17914,17914,5D3AB87CDE152EA5E956E4DDC06AC59B,10471,9,11,2,37,48,1898
17915,17915,5D3AB87CDE152EA5E956E4DDC06AC59B,43361,13,15,2,38,48,1948
17916,17916,5D3AB87CDE152EA5E956E4DDC06AC59B,40341,16,19,3,23,49,1199
17917,17917,5D3AB87CDE152EA5E956E4DDC06AC59B,43361,20,23,3,38,48,1948
17918,17918,B257F4D0344B4DAA39282390EEDCF06C,11001,2,5,3,42,47,2147
17919,17919,B257F4D0344B4DAA39282390EEDCF06C,13941,6,15,9,41,47,2097
17920,17920,B257F4D0344B4DAA39282390EEDCF06C,16071,16,18,2,3,3,153
17921,17921,B257F4D0344B4DAA39282390EEDCF06C,16041,19,20,1,1,5,55
17942,17942,01BC501351E3F1FC7B6E95606FC74A3B,12381,0,1,1,32,48,1648
17943,17943,01BC501351E3F1FC7B6E95606FC74A3B,40343,1,9,8,24,49,1249
17944,17944,01BC501351E3F1FC7B6E95606FC74A3B,11541,15,16,1,35,49,1799
17945,17945,01BC501351E3F1FC7B6E95606FC74A3B,11531,19,22,3,34,49,1749
17946,17946,F120543092B35B2CEC8CD6D39505FF1A,16441,0,3,3,15,17,767
17947,17947,F120543092B35B2CEC8CD6D39505FF1A,16233,7,17,10,5,15,265
17948,17948,F120543092B35B2CEC8CD6D39505FF1A,16441,19,20,1,15,17,767
17949,17949,F120543092B35B2CEC8CD6D39505FF1A,15271,22,23,1,14,20,720
17953,17953,99A6F2BFC43DC2A47DFE76E77682AD15,13491,0,8,8,48,39,2439
17954,17954,99A6F2BFC43DC2A47DFE76E77682AD15,13941,13,15,2,41,47,2097
17955,17955,99A6F2BFC43DC2A47DFE76E77682AD15,13491,19,23,4,48,39,2439
17959,17959,8D188B1328CA03E5FCB5F80DC745FFDD,42523,1,14,13,31,47,1597
17960,17960,8D188B1328CA03E5FCB5F80DC745FFDD,11201,14,19,5,35,49,1799
17961,17961,8D188B1328CA03E5FCB5F80DC745FFDD,42523,20,22,2,31,47,1597
17962,17962,0C653DC860B823A0FBD73915967D7A74,10751,1,4,3,47,43,2393
17963,17963,0C653DC860B823A0FBD73915967D7A74,12221,7,9,2,43,44,2194
17964,17964,0C653DC860B823A0FBD73915967D7A74,43051,11,12,1,46,45,2345
17965,17965,0C653DC860B823A0FBD73915967D7A74,12221,17,18,1,43,44,2194
17966,17966,0C653DC860B823A0FBD73915967D7A74,43051,20,21,1,46,45,2345
17967,17967,5E8BB1A9FDE1AFD08848003FB8A60E0E,40673,0,8,8,36,48,1848
17968,17968,5E8BB1A9FDE1AFD08848003FB8A60E0E,10971,10,11,1,35,47,1797
17969,17969,5E8BB1A9FDE1AFD08848003FB8A60E0E,43731,14,15,1,34,47,1747
17970,17970,5E8BB1A9FDE1AFD08848003FB8A60E0E,10971,15,16,1,35,47,1797
17971,17971,5E8BB1A9FDE1AFD08848003FB8A60E0E,43731,17,19,2,34,47,1747
17972,17972,5E8BB1A9FDE1AFD08848003FB8A60E0E,40673,20,23,3,36,48,1848
17973,17973,8BCCE93183443DE519FB4A461FB5DD09,42161,0,7,7,36,47,1847
17974,17974,8BCCE93183443DE519FB4A461FB5DD09,10731,12,13,1,33,47,1697
17975,17975,8BCCE93183443DE519FB4A461FB5DD09,42161,14,16,2,36,47,1847
17976,17976,8BCCE93183443DE519FB4A461FB5DD09,11151,17,20,3,30,48,1548
17977,17977,2648C45FE5CC239A366DE45F7AAB1FCB,13911,2,3,1,39,46,1996
17978,17978,2648C45FE5CC239A366DE45F7AAB1FCB,42864,3,5,2,38,44,1944
17979,17979,2648C45FE5CC239A366DE45F7AAB1FCB,42351,9,10,1,38,45,1945
17980,17980,2648C45FE5CC239A366DE45F7AAB1FCB,13911,12,14,2,39,46,1996
17981,17981,2648C45FE5CC239A366DE45F7AAB1FCB,11261,15,20,5,36,46,1846
17991,17991,1A71FA18AA428C4DDAD1FCB8BD6DCCEA,42281,0,7,7,40,48,2048
17992,17992,1A71FA18AA428C4DDAD1FCB8BD6DCCEA,11211,10,16,6,34,49,1749
17993,17993,1A71FA18AA428C4DDAD1FCB8BD6DCCEA,42281,20,21,1,40,48,2048
17998,17998,39AF22EB815610BD997E0FA9D8297017,12841,0,7,7,37,47,1897
17999,17999,39AF22EB815610BD997E0FA9D8297017,11231,7,11,4,37,49,1899
18000,18000,39AF22EB815610BD997E0FA9D8297017,42961,12,14,2,35,49,1799
18001,18001,39AF22EB815610BD997E0FA9D8297017,11231,14,17,3,37,49,1899
18002,18002,39AF22EB815610BD997E0FA9D8297017,42021,18,20,2,33,47,1697
18003,18003,39AF22EB815610BD997E0FA9D8297017,12841,21,22,1,37,47,1897
18007,18007,50897C798DD981F790935635A0EC3137,13094,0,4,4,21,42,1092
18008,18008,50897C798DD981F790935635A0EC3137,12601,4,6,2,25,47,1297
18009,18009,50897C798DD981F790935635A0EC3137,42501,8,17,9,28,47,1447
18010,18010,50897C798DD981F790935635A0EC3137,12601,17,18,1,25,47,1297
18011,18011,50897C798DD981F790935635A0EC3137,10501,21,22,1,22,46,1146
18015,18015,649FEFFE4003812757E70B888EF1FEFA,10821,6,16,10,40,47,2047
18016,18016,649FEFFE4003812757E70B888EF1FEFA,42623,17,18,1,22,49,1149
18017,18017,649FEFFE4003812757E70B888EF1FEFA,10821,21,23,2,40,47,2047
18018,18018,445A90121514A82FCCD431DD3088A581,43161,1,2,1,35,47,1797
18019,18019,445A90121514A82FCCD431DD3088A581,11381,7,9,2,30,47,1547
18020,18020,445A90121514A82FCCD431DD3088A581,11861,11,19,8,32,47,1647
18021,18021,445A90121514A82FCCD431DD3088A581,40637,21,23,2,36,47,1847
18025,18025,7AE2DA1C0D1D74CE4806222A6B56EA99,10421,0,7,7,41,48,2098
18026,18026,7AE2DA1C0D1D74CE4806222A6B56EA99,42461,10,11,1,45,47,2297
18027,18027,7AE2DA1C0D1D74CE4806222A6B56EA99,10421,12,14,2,41,48,2098
18028,18028,7AE2DA1C0D1D74CE4806222A6B56EA99,42091,15,17,2,43,46,2196
18029,18029,7AE2DA1C0D1D74CE4806222A6B56EA99,10421,21,22,1,41,48,2098
18034,18034,6E78EE40F353B0171B2F2505B2510D90,11861,0,1,1,32,47,1647
18035,18035,6E78EE40F353B0171B2F2505B2510D90,10281,1,8,7,33,48,1698
18036,18036,6E78EE40F353B0171B2F2505B2510D90,42941,8,9,1,37,47,1897
18037,18037,6E78EE40F353B0171B2F2505B2510D90,42301,13,17,4,36,47,1847
18038,18038,6E78EE40F353B0171B2F2505B2510D90,42941,20,22,2,37,47,1897
18057,18057,AB35C432DC3D59E7929F031635A675AA,12601,2,15,13,25,47,1297
18058,18058,AB35C432DC3D59E7929F031635A675AA,11381,17,18,1,30,47,1547
18059,18059,AB35C432DC3D59E7929F031635A675AA,12601,20,23,3,25,47,1297
18060,18060,F215AAB0B16E542437E27E71561ECCA0,10161,0,7,7,35,49,1799
18061,18061,F215AAB0B16E542437E27E71561ECCA0,40201,8,17,9,32,49,1649
18062,18062,F215AAB0B16E542437E27E71561ECCA0,40124,19,21,2,38,47,1947
18063,18063,D9FE1B4B71FD59124F1BA25E295945DD,40124,0,6,6,38,47,1947
18064,18064,D9FE1B4B71FD59124F1BA25E295945DD,12391,7,9,2,36,49,1849
18065,18065,D9FE1B4B71FD59124F1BA25E295945DD,11491,13,14,1,36,47,1847
18066,18066,D9FE1B4B71FD59124F1BA25E295945DD,10271,16,17,1,37,46,1896
18067,18067,D9FE1B4B71FD59124F1BA25E295945DD,11751,19,20,1,35,48,1798
18071,18071,55F85E00994ECFAD65BAE405A846AFFE,42221,0,7,7,38,48,1948
18072,18072,55F85E00994ECFAD65BAE405A846AFFE,43721,13,16,3,32,34,1634
18073,18073,55F85E00994ECFAD65BAE405A846AFFE,42271,18,19,1,40,47,2047
18074,18074,7CFF5C75DCDD1D2FB2C03AE0B8C8F694,10716,0,7,7,30,46,1546
18075,18075,7CFF5C75DCDD1D2FB2C03AE0B8C8F694,40951,12,14,2,36,49,1849
18076,18076,7CFF5C75DCDD1D2FB2C03AE0B8C8F694,11541,15,18,3,35,49,1799
18077,18077,7CFF5C75DCDD1D2FB2C03AE0B8C8F694,10901,18,19,1,35,48,1798
18078,18078,7CFF5C75DCDD1D2FB2C03AE0B8C8F694,10716,20,23,3,30,46,1546
18094,18094,1E2BD89B14216EAAE9A7A5DF26224523,10491,0,16,16,33,48,1698
18095,18095,1E2BD89B14216EAAE9A7A5DF26224523,11074,18,20,2,37,47,1897
18096,18096,1E2BD89B14216EAAE9A7A5DF26224523,11131,20,23,3,33,48,1698
18097,18097,DC9866094212A637CCAC17CF01FE4B5F,42861,0,5,5,37,44,1894
18098,18098,DC9866094212A637CCAC17CF01FE4B5F,11261,6,7,1,36,46,1846
18099,18099,DC9866094212A637CCAC17CF01FE4B5F,13231,7,10,3,39,46,1996
18100,18100,DC9866094212A637CCAC17CF01FE4B5F,11261,10,16,6,36,46,1846
18101,18101,DC9866094212A637CCAC17CF01FE4B5F,42861,19,23,4,37,44,1894
18102,18102,2BC714C204CBBFEE616B46CC493E087B,12641,0,5,5,10,43,543
18103,18103,2BC714C204CBBFEE616B46CC493E087B,12921,7,8,1,9,41,491
18104,18104,2BC714C204CBBFEE616B46CC493E087B,12641,12,13,1,10,43,543
18105,18105,2BC714C204CBBFEE616B46CC493E087B,12921,16,19,3,9,41,491
18106,18106,2BC714C204CBBFEE616B46CC493E087B,12641,19,21,2,10,43,543
18107,18107,0BC1BC9FA127A76D4558FF0A0EC8FEFB,42921,0,6,6,33,47,1697
18108,18108,0BC1BC9FA127A76D4558FF0A0EC8FEFB,10281,7,9,2,33,48,1698
18109,18109,0BC1BC9FA127A76D4558FF0A0EC8FEFB,42921,10,17,7,33,47,1697
18110,18110,0BC1BC9FA127A76D4558FF0A0EC8FEFB,11631,19,21,2,12,49,649
18111,18111,024AB2D90319DF57F94996854D076E3D,13271,0,7,7,41,47,2097
18112,18112,024AB2D90319DF57F94996854D076E3D,11531,8,13,5,34,49,1749
18113,18113,024AB2D90319DF57F94996854D076E3D,11201,16,17,1,35,49,1799
18114,18114,024AB2D90319DF57F94996854D076E3D,11751,19,21,2,35,48,1798
18122,18122,03D70F9FF806551B6E0567FCC1F6C737,43061,0,6,6,43,46,2196
18123,18123,03D70F9FF806551B6E0567FCC1F6C737,43101,8,18,10,46,40,2340
18124,18124,03D70F9FF806551B6E0567FCC1F6C737,43061,20,23,3,43,46,2196
18125,18125,746607B162E7EB25AA57FCC2A7B9163E,11861,0,8,8,32,47,1647
18126,18126,746607B162E7EB25AA57FCC2A7B9163E,43671,8,10,2,35,48,1798
18127,18127,746607B162E7EB25AA57FCC2A7B9163E,42301,20,21,1,36,47,1847
18128,18128,746607B162E7EB25AA57FCC2A7B9163E,10111,22,23,1,37,47,1897
18129,18129,86560F742D0B6614BAAD3213C96AFC27,40833,1,9,8,41,47,2097
18130,18130,86560F742D0B6614BAAD3213C96AFC27,43241,10,11,1,36,46,1846
18131,18131,86560F742D0B6614BAAD3213C96AFC27,40833,18,19,1,41,47,2097
18132,18132,4E4FA3262DF5F7B6F1852C92067A0539,11875,0,6,6,30,46,1546
18133,18133,4E4FA3262DF5F7B6F1852C92067A0539,12311,7,11,4,30,44,1544
18134,18134,4E4FA3262DF5F7B6F1852C92067A0539,11875,11,13,2,30,46,1546
18135,18135,4E4FA3262DF5F7B6F1852C92067A0539,12311,13,18,5,30,44,1544
18136,18136,4E4FA3262DF5F7B6F1852C92067A0539,11875,18,19,1,30,46,1546
18137,18137,4E4FA3262DF5F7B6F1852C92067A0539,11321,20,21,1,31,46,1596
18138,18138,4E4FA3262DF5F7B6F1852C92067A0539,11875,21,23,2,30,46,1546
18139,18139,7179E8D23C9EF0FE56A034B0F52DF3EB,42623,2,4,2,22,49,1149
18140,18140,7179E8D23C9EF0FE56A034B0F52DF3EB,42081,5,6,1,24,49,1249
18141,18141,7179E8D23C9EF0FE56A034B0F52DF3EB,42623,7,10,3,22,49,1149
18142,18142,7179E8D23C9EF0FE56A034B0F52DF3EB,42071,12,13,1,31,49,1599
18143,18143,7179E8D23C9EF0FE56A034B0F52DF3EB,42623,13,19,6,22,49,1149
18144,18144,46BC747A6EE9AEB4D0A4EFA1B7308B4E,43971,0,5,5,30,48,1548
18145,18145,46BC747A6EE9AEB4D0A4EFA1B7308B4E,40302,8,9,1,40,49,2049
18146,18146,46BC747A6EE9AEB4D0A4EFA1B7308B4E,11381,15,19,4,30,47,1547
18147,18147,1B07591FD91BB6CC4456958534AA55B3,42161,0,16,16,36,47,1847
18148,18148,1B07591FD91BB6CC4456958534AA55B3,10381,16,18,2,31,49,1599
18149,18149,1B07591FD91BB6CC4456958534AA55B3,42771,18,23,5,36,47,1847
18150,18150,147599E3EAA87ADB4E275EB1D4FAF10F,11231,0,7,7,37,49,1899
18151,18151,147599E3EAA87ADB4E275EB1D4FAF10F,10107,9,13,4,38,49,1949
18152,18152,147599E3EAA87ADB4E275EB1D4FAF10F,11231,13,19,6,37,49,1899
18153,18153,147599E3EAA87ADB4E275EB1D4FAF10F,43731,19,20,1,34,47,1747
18154,18154,147599E3EAA87ADB4E275EB1D4FAF10F,11021,21,22,1,36,49,1849
18155,18155,4A1E2DF13E9399DEAE7966E1EFE6FC6B,11481,1,2,1,41,48,2098
18156,18156,4A1E2DF13E9399DEAE7966E1EFE6FC6B,40833,3,4,1,41,47,2097
18157,18157,4A1E2DF13E9399DEAE7966E1EFE6FC6B,42861,5,9,4,37,44,1894
18158,18158,4A1E2DF13E9399DEAE7966E1EFE6FC6B,11261,10,11,1,36,46,1846
18159,18159,4A1E2DF13E9399DEAE7966E1EFE6FC6B,42861,12,16,4,37,44,1894
18160,18160,4A1E2DF13E9399DEAE7966E1EFE6FC6B,13271,18,21,3,41,47,2097
18161,18161,82B9DE1C452C89862B559CE0DF4F04BF,15051,0,6,6,19,4,954
18162,18162,82B9DE1C452C89862B559CE0DF4F04BF,16281,8,11,3,11,4,554
18163,18163,82B9DE1C452C89862B559CE0DF4F04BF,15051,13,14,1,19,4,954
18164,18164,82B9DE1C452C89862B559CE0DF4F04BF,16281,15,16,1,11,4,554
18165,18165,82B9DE1C452C89862B559CE0DF4F04BF,15051,17,19,2,19,4,954
18166,18166,82B9DE1C452C89862B559CE0DF4F04BF,16281,19,21,2,11,4,554
18167,18167,9378E7BD385AF2CAF8CB26920C2EE355,10951,0,2,2,29,48,1498
18168,18168,9378E7BD385AF2CAF8CB26920C2EE355,10681,3,4,1,30,48,1548
18169,18169,9378E7BD385AF2CAF8CB26920C2EE355,11061,5,6,1,29,48,1498
18170,18170,9378E7BD385AF2CAF8CB26920C2EE355,10681,9,10,1,30,48,1548
18171,18171,9378E7BD385AF2CAF8CB26920C2EE355,11061,15,17,2,29,48,1498
18172,18172,9378E7BD385AF2CAF8CB26920C2EE355,10681,20,23,3,30,48,1548
18190,18190,7B7EC78C492826B1A2F98257774A5C01,11061,1,6,5,29,48,1498
18191,18191,7B7EC78C492826B1A2F98257774A5C01,11381,7,8,1,30,47,1547
18192,18192,7B7EC78C492826B1A2F98257774A5C01,11061,9,16,7,29,48,1498
18193,18193,7B7EC78C492826B1A2F98257774A5C01,11231,17,18,1,37,49,1899
18194,18194,7B7EC78C492826B1A2F98257774A5C01,43971,19,20,1,30,48,1548
18195,18195,7B7EC78C492826B1A2F98257774A5C01,40951,21,23,2,36,49,1849
18196,18196,E43A1713BA9589398F5DEA7CD1BD08F1,43061,0,7,7,43,46,2196
18197,18197,E43A1713BA9589398F5DEA7CD1BD08F1,11011,8,12,4,39,49,1999
18198,18198,E43A1713BA9589398F5DEA7CD1BD08F1,11781,13,19,6,38,49,1949
18199,18199,E43A1713BA9589398F5DEA7CD1BD08F1,42601,21,22,1,44,48,2248
18200,18200,F9B50F8C0BC548F341BD45D3142A9731,43671,0,7,7,35,48,1798
18201,18201,F9B50F8C0BC548F341BD45D3142A9731,10221,11,14,3,34,49,1749
18202,18202,F9B50F8C0BC548F341BD45D3142A9731,11151,18,19,1,30,48,1548
18203,18203,F9B50F8C0BC548F341BD45D3142A9731,11954,22,23,1,32,49,1649
18204,18204,47844E829FCB05D6E87386BF9A1380C3,11941,0,7,7,37,46,1896
18205,18205,47844E829FCB05D6E87386BF9A1380C3,11021,9,11,2,36,49,1849
18206,18206,47844E829FCB05D6E87386BF9A1380C3,10111,15,16,1,37,47,1897
18207,18207,47844E829FCB05D6E87386BF9A1380C3,10431,18,20,2,33,49,1699
18208,18208,47844E829FCB05D6E87386BF9A1380C3,40861,20,23,3,34,48,1748
18209,18209,C96B765381E324A25326D6AF54D87A5F,40431,0,8,8,36,47,1847
18210,18210,C96B765381E324A25326D6AF54D87A5F,10292,9,11,2,30,47,1547
18211,18211,C96B765381E324A25326D6AF54D87A5F,10781,11,16,5,35,47,1797
18212,18212,C96B765381E324A25326D6AF54D87A5F,40431,19,23,4,36,47,1847
18217,18217,ED54D9A6448FF51B585DC3225EB6058D,19181,0,7,7,8,40,440
18218,18218,ED54D9A6448FF51B585DC3225EB6058D,43644,9,10,1,14,38,738
18219,18219,ED54D9A6448FF51B585DC3225EB6058D,19181,10,11,1,8,40,440
18220,18220,ED54D9A6448FF51B585DC3225EB6058D,43644,14,15,1,14,38,738
18221,18221,ED54D9A6448FF51B585DC3225EB6058D,19264,20,21,1,10,36,536
18228,18228,D7349708A10855AEF98FEB8D22C33E59,40833,0,7,7,41,47,2097
18229,18229,D7349708A10855AEF98FEB8D22C33E59,11231,8,18,10,37,49,1899
18230,18230,D7349708A10855AEF98FEB8D22C33E59,40491,19,21,2,39,49,1999
18231,18231,D7349708A10855AEF98FEB8D22C33E59,40833,22,23,1,41,47,2097
18232,18232,282B52FFE1CE5CBB44F6F3C92F8281B0,13711,0,7,7,38,46,1946
18233,18233,282B52FFE1CE5CBB44F6F3C92F8281B0,12601,8,18,10,25,47,1297
18234,18234,282B52FFE1CE5CBB44F6F3C92F8281B0,13711,19,21,2,38,46,1946
18244,18244,B85925194CCD3AA75198C6F99FAC935A,13651,0,7,7,30,47,1547
18245,18245,B85925194CCD3AA75198C6F99FAC935A,13121,9,11,2,38,46,1946
18246,18246,B85925194CCD3AA75198C6F99FAC935A,10951,12,13,1,29,48,1498
18247,18247,B85925194CCD3AA75198C6F99FAC935A,13121,15,17,2,38,46,1946
18248,18248,B85925194CCD3AA75198C6F99FAC935A,42711,19,23,4,26,48,1348
18249,18249,FCC36AE94FA2C83F44DDE4096FB84829,11941,0,7,7,37,46,1896
18250,18250,FCC36AE94FA2C83F44DDE4096FB84829,13711,8,9,1,38,46,1946
18251,18251,FCC36AE94FA2C83F44DDE4096FB84829,11941,12,15,3,37,46,1896
18252,18252,FCC36AE94FA2C83F44DDE4096FB84829,13711,17,18,1,38,46,1946
18253,18253,FCC36AE94FA2C83F44DDE4096FB84829,11941,19,23,4,37,46,1896
18254,18254,92E1BAA88B052422B820ED36A9E8F107,41392,0,14,14,43,48,2198
18255,18255,92E1BAA88B052422B820ED36A9E8F107,11271,15,17,2,37,48,1898
18256,18256,92E1BAA88B052422B820ED36A9E8F107,40171,17,18,1,38,48,1948
18257,18257,92E1BAA88B052422B820ED36A9E8F107,41392,19,23,4,43,48,2198
18258,18258,3044AD5F90932CCE405DE87EFA97D7EF,19021,4,13,9,10,45,545
18259,18259,3044AD5F90932CCE405DE87EFA97D7EF,43021,14,16,2,16,43,843
18260,18260,3044AD5F90932CCE405DE87EFA97D7EF,19021,16,18,2,10,45,545
18267,18267,E45B0EC44E00842EDD865C65A561543D,11791,0,7,7,38,49,1949
18268,18268,E45B0EC44E00842EDD865C65A561543D,10471,8,13,5,37,48,1898
18269,18269,E45B0EC44E00842EDD865C65A561543D,11231,15,17,2,37,49,1899
18270,18270,E45B0EC44E00842EDD865C65A561543D,10471,17,18,1,37,48,1898
18271,18271,E45B0EC44E00842EDD865C65A561543D,10661,18,20,2,37,49,1899
18272,18272,9FDE2E911BF49A6996BBEFBC05B62D08,42071,0,14,14,31,49,1599
18273,18273,9FDE2E911BF49A6996BBEFBC05B62D08,42261,16,19,3,25,49,1299
18274,18274,9FDE2E911BF49A6996BBEFBC05B62D08,11151,21,23,2,30,48,1548
18275,18275,53199EC48B52002628DF1EE750935CA6,11021,0,1,1,36,49,1849
18276,18276,53199EC48B52002628DF1EE750935CA6,40891,1,19,18,37,47,1897
18277,18277,53199EC48B52002628DF1EE750935CA6,40341,21,22,1,23,49,1199
18278,18278,AB14BC401B3FA9794B158BF50CA33665,13341,0,1,1,44,45,2245
18279,18279,AB14BC401B3FA9794B158BF50CA33665,42201,3,8,5,43,46,2196
18280,18280,AB14BC401B3FA9794B158BF50CA33665,13341,10,11,1,44,45,2245
18281,18281,AB14BC401B3FA9794B158BF50CA33665,42201,14,15,1,43,46,2196
18282,18282,AB14BC401B3FA9794B158BF50CA33665,13341,19,20,1,44,45,2245
18286,18286,3B86E1CB99F9A063FEA255A004EE193F,11261,0,1,1,36,46,1846
18287,18287,3B86E1CB99F9A063FEA255A004EE193F,42864,2,3,1,38,44,1944
18288,18288,3B86E1CB99F9A063FEA255A004EE193F,42861,4,5,1,37,44,1894
18289,18289,3B86E1CB99F9A063FEA255A004EE193F,42351,9,11,2,38,45,1945
18290,18290,3B86E1CB99F9A063FEA255A004EE193F,11261,14,18,4,36,46,1846
18304,18304,90CAE68E57E6D6254F2E8F80F351FD91,11954,0,7,7,32,49,1649
18305,18305,90CAE68E57E6D6254F2E8F80F351FD91,11061,8,16,8,29,48,1498
18306,18306,90CAE68E57E6D6254F2E8F80F351FD91,11231,20,22,2,37,49,1899
18307,18307,BF5EFB3BDBF5437ACD467C87E9038A8B,43021,1,5,4,16,43,843
18308,18308,BF5EFB3BDBF5437ACD467C87E9038A8B,12921,7,14,7,9,41,491
18309,18309,BF5EFB3BDBF5437ACD467C87E9038A8B,43021,14,23,9,16,43,843
18310,18310,7A426BBFF741028FA052D72279726B7D,42121,3,6,3,26,49,1349
18311,18311,7A426BBFF741028FA052D72279726B7D,42071,8,9,1,31,49,1599
18312,18312,7A426BBFF741028FA052D72279726B7D,42121,10,12,2,26,49,1349
18313,18313,7A426BBFF741028FA052D72279726B7D,11091,16,22,6,29,47,1497
18334,18334,1C0548F40841AD0870DAD8EC7BECCBC6,13314,0,13,13,31,39,1589
18335,18335,1C0548F40841AD0870DAD8EC7BECCBC6,12521,14,18,4,35,41,1791
18336,18336,1C0548F40841AD0870DAD8EC7BECCBC6,13314,21,23,2,31,39,1589
18337,18337,4BF0C019E22CA49D04010F7453961A41,10716,1,6,5,30,46,1546
18338,18338,4BF0C019E22CA49D04010F7453961A41,12601,8,10,2,25,47,1297
18339,18339,4BF0C019E22CA49D04010F7453961A41,10716,10,13,3,30,46,1546
18340,18340,4BF0C019E22CA49D04010F7453961A41,12601,15,17,2,25,47,1297
18341,18341,4BF0C019E22CA49D04010F7453961A41,10716,19,21,2,30,46,1546
18342,18342,FD112B5156FECF6460254CADD94A5EF4,12641,5,15,10,10,43,543
18343,18343,FD112B5156FECF6460254CADD94A5EF4,19031,16,19,3,1,42,92
18344,18344,FD112B5156FECF6460254CADD94A5EF4,12641,20,23,3,10,43,543
18348,18348,E648A6F090A3BE85617E0ED54A73B4F0,12601,0,3,3,25,47,1297
18349,18349,E648A6F090A3BE85617E0ED54A73B4F0,13094,3,7,4,21,42,1092
18350,18350,E648A6F090A3BE85617E0ED54A73B4F0,12601,9,23,14,25,47,1297
18351,18351,3B8FB8720B738954F0287E8A91FB9A89,42691,1,5,4,24,48,1248
18352,18352,3B8FB8720B738954F0287E8A91FB9A89,43751,8,10,2,19,48,998
18353,18353,3B8FB8720B738954F0287E8A91FB9A89,42691,12,23,11,24,48,1248
18354,18354,E599FEB56FA765D8959145E7D77CF1E9,11301,0,8,8,41,49,2099
18355,18355,E599FEB56FA765D8959145E7D77CF1E9,16071,12,13,1,3,3,153
18356,18356,E599FEB56FA765D8959145E7D77CF1E9,11301,17,23,6,41,49,2099
18357,18357,3DA516A8A81F26FB478665A477628F88,19491,0,6,6,14,27,727
18358,18358,3DA516A8A81F26FB478665A477628F88,10111,11,14,3,37,47,1897
18359,18359,3DA516A8A81F26FB478665A477628F88,10331,15,19,4,39,46,1996
18360,18360,3DA516A8A81F26FB478665A477628F88,10821,19,21,2,40,47,2047
18365,18365,2B91CE075511AA193C56841317FE0707,12491,0,1,1,36,43,1843
18366,18366,2B91CE075511AA193C56841317FE0707,43011,1,2,1,40,42,2042
18367,18367,2B91CE075511AA193C56841317FE0707,12491,3,21,18,36,43,1843
18368,18368,F1963AEA885B5866766ECEFAF7772DB4,13671,0,7,7,27,43,1393
18369,18369,F1963AEA885B5866766ECEFAF7772DB4,13314,10,11,1,31,39,1589
18370,18370,F1963AEA885B5866766ECEFAF7772DB4,13671,12,21,9,27,43,1393
18371,18371,65E419942CB504CDF61BED9B8F0B09E8,42351,0,7,7,38,45,1945
18372,18372,65E419942CB504CDF61BED9B8F0B09E8,43751,8,9,1,19,48,998
18373,18373,65E419942CB504CDF61BED9B8F0B09E8,13911,10,11,1,39,46,1996
18374,18374,65E419942CB504CDF61BED9B8F0B09E8,42351,11,12,1,38,45,1945
18375,18375,65E419942CB504CDF61BED9B8F0B09E8,43751,15,17,2,19,48,998
18376,18376,65E419942CB504CDF61BED9B8F0B09E8,11261,18,19,1,36,46,1846
18377,18377,2F66AC01887397A198C9CCA6611EA97B,12521,0,6,6,35,41,1791
18378,18378,2F66AC01887397A198C9CCA6611EA97B,13314,7,9,2,31,39,1589
18379,18379,2F66AC01887397A198C9CCA6611EA97B,12521,12,23,11,35,41,1791
18387,18387,C7C431E83C90A041B3FA2A63798CE4F8,43021,5,8,3,16,43,843
18388,18388,C7C431E83C90A041B3FA2A63798CE4F8,19261,8,10,2,6,37,337
18389,18389,C7C431E83C90A041B3FA2A63798CE4F8,12921,11,13,2,9,41,491
18390,18390,C7C431E83C90A041B3FA2A63798CE4F8,19261,14,16,2,6,37,337
18391,18391,C7C431E83C90A041B3FA2A63798CE4F8,12921,19,20,1,9,41,491
18392,18392,034BF108F7447DC54755E0BD15E86728,42351,0,7,7,38,45,1945
18393,18393,034BF108F7447DC54755E0BD15E86728,11261,7,11,4,36,46,1846
18394,18394,034BF108F7447DC54755E0BD15E86728,42351,11,14,3,38,45,1945
18395,18395,034BF108F7447DC54755E0BD15E86728,13841,16,17,1,40,46,2046
18396,18396,034BF108F7447DC54755E0BD15E86728,42511,19,21,2,37,47,1897
18397,18397,9BBBC00C93BA6A3176E2B008E6F8A88E,13911,1,5,4,39,46,1996
18398,18398,9BBBC00C93BA6A3176E2B008E6F8A88E,11261,6,10,4,36,46,1846
18399,18399,9BBBC00C93BA6A3176E2B008E6F8A88E,42351,12,13,1,38,45,1945
18400,18400,9BBBC00C93BA6A3176E2B008E6F8A88E,11261,16,18,2,36,46,1846
18401,18401,9BBBC00C93BA6A3176E2B008E6F8A88E,13911,21,23,2,39,46,1996
18405,18405,35CCDE2C2F4A0E20342697F46E4DEF65,13331,0,8,8,38,47,1947
18406,18406,35CCDE2C2F4A0E20342697F46E4DEF65,10841,10,18,8,37,47,1897
18407,18407,35CCDE2C2F4A0E20342697F46E4DEF65,42461,20,21,1,45,47,2297
18408,18408,01067BD464140B42D6F1D4D82F8B8EE7,43481,0,6,6,39,48,1998
18409,18409,01067BD464140B42D6F1D4D82F8B8EE7,11231,9,17,8,37,49,1899
18410,18410,01067BD464140B42D6F1D4D82F8B8EE7,42501,19,20,1,28,47,1447
18411,18411,EE107F15123C6DB132974358298F51B4,42583,0,6,6,40,48,2048
18412,18412,EE107F15123C6DB132974358298F51B4,11914,9,11,2,37,48,1898
18413,18413,EE107F15123C6DB132974358298F51B4,42583,12,13,1,40,48,2048
18414,18414,EE107F15123C6DB132974358298F51B4,40171,13,16,3,38,48,1948
18415,18415,EE107F15123C6DB132974358298F51B4,10191,21,22,1,40,48,2048
18416,18416,05C3A7EB5EF4E026B421540B8AC90475,12491,0,6,6,36,43,1843
18417,18417,05C3A7EB5EF4E026B421540B8AC90475,12311,6,8,2,30,44,1544
18418,18418,05C3A7EB5EF4E026B421540B8AC90475,42151,8,11,3,35,45,1795
18419,18419,05C3A7EB5EF4E026B421540B8AC90475,42531,12,13,1,31,45,1595
18420,18420,05C3A7EB5EF4E026B421540B8AC90475,12311,16,17,1,30,44,1544
18421,18421,05C3A7EB5EF4E026B421540B8AC90475,12491,21,22,1,36,43,1843
18422,18422,8F73236152C8063BFF3D92B22F15FEBF,10841,0,9,9,37,47,1897
18423,18423,8F73236152C8063BFF3D92B22F15FEBF,10191,12,14,2,40,48,2048
18424,18424,8F73236152C8063BFF3D92B22F15FEBF,13111,18,19,1,42,46,2146
18425,18425,8F73236152C8063BFF3D92B22F15FEBF,10841,19,22,3,37,47,1897
18429,18429,9B486689278BE374093A259A43CD5B5C,10281,0,14,14,33,48,1698
18430,18430,9B486689278BE374093A259A43CD5B5C,10351,15,17,2,28,45,1445
18431,18431,9B486689278BE374093A259A43CD5B5C,42141,18,19,1,32,47,1647
18432,18432,9B486689278BE374093A259A43CD5B5C,10281,19,20,1,33,48,1698
18433,18433,9B486689278BE374093A259A43CD5B5C,43761,22,23,1,32,47,1647
18434,18434,184C01DF5AF7FEEE2B90AA7395647187,42151,0,2,2,35,45,1795
18435,18435,184C01DF5AF7FEEE2B90AA7395647187,12491,2,6,4,36,43,1843
18436,18436,184C01DF5AF7FEEE2B90AA7395647187,42861,8,10,2,37,44,1894
18437,18437,184C01DF5AF7FEEE2B90AA7395647187,42151,13,16,3,35,45,1795
18438,18438,184C01DF5AF7FEEE2B90AA7395647187,42861,16,17,1,37,44,1894
18439,18439,184C01DF5AF7FEEE2B90AA7395647187,42151,18,22,4,35,45,1795
18440,18440,247667C3836D06BFE77381F6E8AF78B9,13561,0,7,7,37,49,1899
18441,18441,247667C3836D06BFE77381F6E8AF78B9,11801,17,19,2,42,48,2148
18442,18442,247667C3836D06BFE77381F6E8AF78B9,11781,19,22,3,38,49,1949
18443,18443,50106B23DBDD336DDBB0AD33136B2DE9,11021,0,17,17,36,49,1849
18444,18444,50106B23DBDD336DDBB0AD33136B2DE9,40341,18,20,2,23,49,1199
18445,18445,50106B23DBDD336DDBB0AD33136B2DE9,11021,21,23,2,36,49,1849
18446,18446,A796809FFC26797F0B17A0B66E102B15,12521,7,10,3,35,41,1791
18447,18447,A796809FFC26797F0B17A0B66E102B15,13314,12,13,1,31,39,1589
18448,18448,A796809FFC26797F0B17A0B66E102B15,12521,14,17,3,35,41,1791
18449,18449,A796809FFC26797F0B17A0B66E102B15,13314,19,23,4,31,39,1589
18450,18450,CB479BFBFB8F9E0E311DAA14A8B33405,10107,1,7,6,38,49,1949
18451,18451,CB479BFBFB8F9E0E311DAA14A8B33405,11481,12,13,1,41,48,2098
18452,18452,CB479BFBFB8F9E0E311DAA14A8B33405,11061,16,19,3,29,48,1498
18453,18453,CB479BFBFB8F9E0E311DAA14A8B33405,40341,19,20,1,23,49,1199
18454,18454,649CA0B4C9C73F10630BCAC6C100E533,42151,1,7,6,35,45,1795
18455,18455,649CA0B4C9C73F10630BCAC6C100E533,12311,8,10,2,30,44,1544
18456,18456,649CA0B4C9C73F10630BCAC6C100E533,42531,13,16,3,31,45,1595
18457,18457,649CA0B4C9C73F10630BCAC6C100E533,12311,16,17,1,30,44,1544
18458,18458,649CA0B4C9C73F10630BCAC6C100E533,11381,20,21,1,30,47,1547
18459,18459,2CAC956E5C79D46540256C7FA4D98476,13511,7,11,4,34,48,1748
18460,18460,2CAC956E5C79D46540256C7FA4D98476,11061,15,16,1,29,48,1498
18461,18461,2CAC956E5C79D46540256C7FA4D98476,13511,20,23,3,34,48,1748
18462,18462,9508FAE0B774FCD97D7CFB3C4BD72215,10111,0,5,5,37,47,1897
18463,18463,9508FAE0B774FCD97D7CFB3C4BD72215,10251,6,7,1,35,47,1797
18464,18464,9508FAE0B774FCD97D7CFB3C4BD72215,10111,8,11,3,37,47,1897
18465,18465,9508FAE0B774FCD97D7CFB3C4BD72215,42401,12,14,2,36,47,1847
18466,18466,9508FAE0B774FCD97D7CFB3C4BD72215,10111,16,18,2,37,47,1897
18467,18467,9508FAE0B774FCD97D7CFB3C4BD72215,42161,19,23,4,36,47,1847
18468,18468,DE2CF7635A4FCEF13695C4816E23FB11,10491,0,14,14,33,48,1698
18469,18469,DE2CF7635A4FCEF13695C4816E23FB11,10211,16,17,1,16,49,849
18470,18470,DE2CF7635A4FCEF13695C4816E23FB11,10491,20,23,3,33,48,1698
18471,18471,68D66AC2F31097852E1113FCAC38B096,12311,1,5,4,30,44,1544
18472,18472,68D66AC2F31097852E1113FCAC38B096,12121,5,6,1,29,47,1497
18473,18473,68D66AC2F31097852E1113FCAC38B096,42531,9,10,1,31,45,1595
18474,18474,68D66AC2F31097852E1113FCAC38B096,12311,12,14,2,30,44,1544
18475,18475,68D66AC2F31097852E1113FCAC38B096,42531,17,23,6,31,45,1595
18476,18476,0DD51EE42A065AE9C7264B2B66A89D4A,12921,5,7,2,9,41,491
18477,18477,0DD51EE42A065AE9C7264B2B66A89D4A,19021,7,18,11,10,45,545
18478,18478,0DD51EE42A065AE9C7264B2B66A89D4A,12921,20,23,3,9,41,491
18485,18485,0F2E7737761FB5772278335D9DA9FBBB,15321,0,6,6,29,26,1476
18486,18486,0F2E7737761FB5772278335D9DA9FBBB,15091,9,17,8,35,26,1776
18487,18487,0F2E7737761FB5772278335D9DA9FBBB,43121,18,20,2,25,27,1277
18495,18495,0781E535CBB143640477269330BEC7EE,43671,0,2,2,35,48,1798
18496,18496,0781E535CBB143640477269330BEC7EE,11331,4,6,2,37,48,1898
18497,18497,0781E535CBB143640477269330BEC7EE,42161,7,8,1,36,47,1847
18498,18498,0781E535CBB143640477269330BEC7EE,11081,9,11,2,35,46,1796
18499,18499,0781E535CBB143640477269330BEC7EE,43671,14,19,5,35,48,1798
18500,18500,0781E535CBB143640477269330BEC7EE,42161,22,23,1,36,47,1847
18501,18501,2E9ACB5217DEAC635E911A6AAEF6DCF5,11261,0,7,7,36,46,1846
18502,18502,2E9ACB5217DEAC635E911A6AAEF6DCF5,12021,9,11,2,37,49,1899
18503,18503,2E9ACB5217DEAC635E911A6AAEF6DCF5,11261,11,13,2,36,46,1846
18504,18504,2E9ACB5217DEAC635E911A6AAEF6DCF5,11301,16,17,1,41,49,2099
18505,18505,2E9ACB5217DEAC635E911A6AAEF6DCF5,11261,18,23,5,36,46,1846
18506,18506,68A1105E45875228253ACCFACF581238,15143,0,14,14,18,7,907
18507,18507,68A1105E45875228253ACCFACF581238,16281,16,20,4,11,4,554
18508,18508,68A1105E45875228253ACCFACF581238,15143,22,23,1,18,7,907
18509,18509,491F26A17D9EDEEE5D002133D7BEBC78,12511,0,6,6,39,47,1997
18510,18510,491F26A17D9EDEEE5D002133D7BEBC78,11381,6,15,9,30,47,1547
18511,18511,491F26A17D9EDEEE5D002133D7BEBC78,12511,16,23,7,39,47,1997
18523,18523,A8049D244A31A42504E3694EA2F03C03,11201,2,4,2,35,49,1799
18524,18524,A8049D244A31A42504E3694EA2F03C03,42281,5,11,6,40,48,2048
18525,18525,A8049D244A31A42504E3694EA2F03C03,10661,14,15,1,37,49,1899
18526,18526,A8049D244A31A42504E3694EA2F03C03,40073,15,23,8,37,48,1898
18539,18539,319C385C256C2264D15D0D4ABF1C5A6B,11261,9,11,2,36,46,1846
18540,18540,319C385C256C2264D15D0D4ABF1C5A6B,13791,13,17,4,42,47,2147
18541,18541,319C385C256C2264D15D0D4ABF1C5A6B,11811,20,21,1,38,49,1949
18542,18542,7875A34DC3B1C1A6D18480769685A825,13911,1,8,7,39,46,1996
18543,18543,7875A34DC3B1C1A6D18480769685A825,42231,8,10,2,37,46,1896
18544,18544,7875A34DC3B1C1A6D18480769685A825,13911,12,14,2,39,46,1996
18545,18545,7875A34DC3B1C1A6D18480769685A825,42231,14,16,2,37,46,1896
18546,18546,7875A34DC3B1C1A6D18480769685A825,13911,19,23,4,39,46,1996
18547,18547,90B13C1A71DF735753681820FCEBD200,43451,2,5,3,37,40,1890
18548,18548,90B13C1A71DF735753681820FCEBD200,12521,10,11,1,35,41,1791
18549,18549,90B13C1A71DF735753681820FCEBD200,12491,14,15,1,36,43,1843
18550,18550,90B13C1A71DF735753681820FCEBD200,11261,17,18,1,36,46,1846
18551,18551,90B13C1A71DF735753681820FCEBD200,12491,19,23,4,36,43,1843
18552,18552,85061C43999146706723F4E0700EE955,13911,1,8,7,39,46,1996
18553,18553,85061C43999146706723F4E0700EE955,42351,11,12,1,38,45,1945
18554,18554,85061C43999146706723F4E0700EE955,13911,13,15,2,39,46,1996
18555,18555,85061C43999146706723F4E0700EE955,42231,15,16,1,37,46,1896
18556,18556,85061C43999146706723F4E0700EE955,13911,16,22,6,39,46,1996
18557,18557,E6F8B18996A93B41942201687916F106,11231,0,6,6,37,49,1899
18558,18558,E6F8B18996A93B41942201687916F106,10471,9,10,1,37,48,1898
18559,18559,E6F8B18996A93B41942201687916F106,11231,12,13,1,37,49,1899
18560,18560,E6F8B18996A93B41942201687916F106,10471,15,18,3,37,48,1898
18561,18561,E6F8B18996A93B41942201687916F106,11231,18,21,3,37,49,1899
18562,18562,FCA3C665B5BF337F331669EDB597A6AC,42791,0,7,7,35,45,1795
18563,18563,FCA3C665B5BF337F331669EDB597A6AC,13121,8,9,1,38,46,1946
18564,18564,FCA3C665B5BF337F331669EDB597A6AC,10271,9,10,1,37,46,1896
18565,18565,FCA3C665B5BF337F331669EDB597A6AC,13121,11,12,1,38,46,1946
18566,18566,FCA3C665B5BF337F331669EDB597A6AC,10271,15,16,1,37,46,1896
18567,18567,FCA3C665B5BF337F331669EDB597A6AC,13121,16,23,7,38,46,1946
18568,18568,9A2347A65F46E3675A9270194F272951,13111,0,13,13,42,46,2146
18569,18569,9A2347A65F46E3675A9270194F272951,40341,15,17,2,23,49,1199
18570,18570,9A2347A65F46E3675A9270194F272951,42801,20,23,3,40,49,2049
18571,18571,72728458BA71393F557B9B934896CD12,13011,0,7,7,39,47,1997
18572,18572,72728458BA71393F557B9B934896CD12,13121,7,9,2,38,46,1946
18573,18573,72728458BA71393F557B9B934896CD12,13011,12,16,4,39,47,1997
18574,18574,72728458BA71393F557B9B934896CD12,13681,17,18,1,38,47,1947
18575,18575,72728458BA71393F557B9B934896CD12,10841,21,23,2,37,47,1897
18576,18576,4784D97F3C276E4A1D7A7813E1000E1E,10811,0,6,6,38,46,1946
18577,18577,4784D97F3C276E4A1D7A7813E1000E1E,11061,8,12,4,29,48,1498
18578,18578,4784D97F3C276E4A1D7A7813E1000E1E,13911,12,13,1,39,46,1996
18579,18579,4784D97F3C276E4A1D7A7813E1000E1E,42231,14,17,3,37,46,1896
18580,18580,4784D97F3C276E4A1D7A7813E1000E1E,10811,19,23,4,38,46,1946
18581,18581,2D9F8EEE0946858BEC66856CB73B8335,43021,0,5,5,16,43,843
18582,18582,2D9F8EEE0946858BEC66856CB73B8335,12921,6,8,2,9,41,491
18583,18583,2D9F8EEE0946858BEC66856CB73B8335,43021,8,10,2,16,43,843
18584,18584,2D9F8EEE0946858BEC66856CB73B8335,12921,13,21,8,9,41,491
18585,18585,2D9F8EEE0946858BEC66856CB73B8335,43021,22,23,1,16,43,843
18586,18586,43D5A4B21D49F330FF46E8A3E900BDBD,10721,0,7,7,31,48,1598
18587,18587,43D5A4B21D49F330FF46E8A3E900BDBD,10901,12,14,2,35,48,1798
18588,18588,43D5A4B21D49F330FF46E8A3E900BDBD,11231,18,23,5,37,49,1899
18589,18589,35DAC6756C7F4B57C2B1C6F65896CD31,42501,0,1,1,28,47,1447
18590,18590,35DAC6756C7F4B57C2B1C6F65896CD31,12601,2,3,1,25,47,1297
18591,18591,35DAC6756C7F4B57C2B1C6F65896CD31,10634,7,16,9,27,45,1395
18592,18592,35DAC6756C7F4B57C2B1C6F65896CD31,12601,16,19,3,25,47,1297
18593,18593,35DAC6756C7F4B57C2B1C6F65896CD31,10351,20,23,3,28,45,1445
18598,18598,84DDAB60D0DE384DC44B1CD74BF8AB83,42151,0,6,6,35,45,1795
18599,18599,84DDAB60D0DE384DC44B1CD74BF8AB83,42861,6,7,1,37,44,1894
18600,18600,84DDAB60D0DE384DC44B1CD74BF8AB83,42151,8,9,1,35,45,1795
18601,18601,84DDAB60D0DE384DC44B1CD74BF8AB83,42861,11,12,1,37,44,1894
18602,18602,84DDAB60D0DE384DC44B1CD74BF8AB83,42151,16,23,7,35,45,1795
18603,18603,6F881E54FD8247C10253271465BFC769,10111,0,6,6,37,47,1897
18604,18604,6F881E54FD8247C10253271465BFC769,42161,7,11,4,36,47,1847
18605,18605,6F881E54FD8247C10253271465BFC769,10111,11,13,2,37,47,1897
18606,18606,6F881E54FD8247C10253271465BFC769,43161,14,18,4,35,47,1797
18607,18607,6F881E54FD8247C10253271465BFC769,10111,18,23,5,37,47,1897
18612,18612,F0D3FEBF4CC350A5851C8C36AA32D49C,11331,0,7,7,37,48,1898
18613,18613,F0D3FEBF4CC350A5851C8C36AA32D49C,10111,7,9,2,37,47,1897
18614,18614,F0D3FEBF4CC350A5851C8C36AA32D49C,40673,11,14,3,36,48,1848
18615,18615,F0D3FEBF4CC350A5851C8C36AA32D49C,11301,16,23,7,41,49,2099
18616,18616,4D7F9A766459E315716EA1D053BCDCF8,13671,0,14,14,27,43,1393
18617,18617,4D7F9A766459E315716EA1D053BCDCF8,13314,15,18,3,31,39,1589
18618,18618,4D7F9A766459E315716EA1D053BCDCF8,13671,20,23,3,27,43,1393
18619,18619,9ECA5557B94DDF8D494B58216329A377,42864,0,6,6,38,44,1944
18620,18620,9ECA5557B94DDF8D494B58216329A377,11261,6,7,1,36,46,1846
18621,18621,9ECA5557B94DDF8D494B58216329A377,42864,12,14,2,38,44,1944
18622,18622,9ECA5557B94DDF8D494B58216329A377,42861,16,17,1,37,44,1894
18623,18623,9ECA5557B94DDF8D494B58216329A377,11261,20,21,1,36,46,1846
18627,18627,E78E0ABBE194ABEE97C2D7DD94378A1C,10121,0,15,15,36,49,1849
18628,18628,E78E0ABBE194ABEE97C2D7DD94378A1C,11061,16,18,2,29,48,1498
18629,18629,E78E0ABBE194ABEE97C2D7DD94378A1C,10121,19,21,2,36,49,1849
18633,18633,F2E0A788EC41736380A7AB3495E7AB34,10251,1,2,1,35,47,1797
18634,18634,F2E0A788EC41736380A7AB3495E7AB34,10411,3,5,2,36,48,1848
18635,18635,F2E0A788EC41736380A7AB3495E7AB34,12051,7,11,4,20,47,1047
18636,18636,F2E0A788EC41736380A7AB3495E7AB34,10251,13,21,8,35,47,1797
18647,18647,3CEDD9F281DC77B01703F7776FC0CEB7,43121,0,1,1,25,27,1277
18648,18648,3CEDD9F281DC77B01703F7776FC0CEB7,15391,2,15,13,35,26,1776
18649,18649,3CEDD9F281DC77B01703F7776FC0CEB7,43121,18,19,1,25,27,1277
18650,18650,3CEDD9F281DC77B01703F7776FC0CEB7,15091,21,22,1,35,26,1776
18651,18651,60268F7A02ED65A28DFDDFCBD631880E,42351,0,7,7,38,45,1945
18652,18652,60268F7A02ED65A28DFDDFCBD631880E,42231,10,11,1,37,46,1896
18653,18653,60268F7A02ED65A28DFDDFCBD631880E,11201,12,15,3,35,49,1799
18654,18654,60268F7A02ED65A28DFDDFCBD631880E,42231,18,22,4,37,46,1896
18655,18655,7D8BB90B66B5BB302B836A7DB354A71B,11701,0,7,7,43,48,2198
18656,18656,7D8BB90B66B5BB302B836A7DB354A71B,42321,7,8,1,43,47,2197
18657,18657,7D8BB90B66B5BB302B836A7DB354A71B,11701,10,16,6,43,48,2198
18658,18658,7D8BB90B66B5BB302B836A7DB354A71B,43621,17,18,1,46,48,2348
18659,18659,7D8BB90B66B5BB302B836A7DB354A71B,42601,22,23,1,44,48,2248
18660,18660,94092014F9DD3213271810B8D19555BE,49201,0,5,5,7,41,391
18661,18661,94092014F9DD3213271810B8D19555BE,12921,5,7,2,9,41,491
18662,18662,94092014F9DD3213271810B8D19555BE,49201,11,13,2,7,41,391
18663,18663,94092014F9DD3213271810B8D19555BE,12921,16,17,1,9,41,491
18664,18664,94092014F9DD3213271810B8D19555BE,49201,20,22,2,7,41,391
18665,18665,94DF6D416CC5B92A0E5062ABBAC5B786,11074,0,6,6,37,47,1897
18666,18666,94DF6D416CC5B92A0E5062ABBAC5B786,12514,7,10,3,38,47,1947
18667,18667,94DF6D416CC5B92A0E5062ABBAC5B786,42071,14,19,5,31,49,1599
18668,18668,EEB3CBC85DF19031E292162C06516E43,11381,0,7,7,30,47,1547
18669,18669,EEB3CBC85DF19031E292162C06516E43,10471,7,12,5,37,48,1898
18670,18670,EEB3CBC85DF19031E292162C06516E43,11381,14,19,5,30,47,1547
18671,18671,EEB3CBC85DF19031E292162C06516E43,10471,19,22,3,37,48,1898
18676,18676,B4648DE29EB5459B43C6116F1F723DB4,42511,0,5,5,37,47,1897
18677,18677,B4648DE29EB5459B43C6116F1F723DB4,13711,6,8,2,38,46,1946
18678,18678,B4648DE29EB5459B43C6116F1F723DB4,42511,8,13,5,37,47,1897
18679,18679,B4648DE29EB5459B43C6116F1F723DB4,13711,14,15,1,38,46,1946
18680,18680,B4648DE29EB5459B43C6116F1F723DB4,42511,15,16,1,37,47,1897
18681,18681,B4648DE29EB5459B43C6116F1F723DB4,13711,17,22,5,38,46,1946
18682,18682,809F6F59669EDEB4346F30E73D2BDABC,11001,0,6,6,42,47,2147
18683,18683,809F6F59669EDEB4346F30E73D2BDABC,19181,9,10,1,8,40,440
18684,18684,809F6F59669EDEB4346F30E73D2BDABC,12921,10,12,2,9,41,491
18685,18685,809F6F59669EDEB4346F30E73D2BDABC,19181,12,15,3,8,40,440
18686,18686,809F6F59669EDEB4346F30E73D2BDABC,11001,17,23,6,42,47,2147
18687,18687,6EF3FF760E19F4779DBA83689DEC9B2B,42521,0,5,5,31,47,1597
18688,18688,6EF3FF760E19F4779DBA83689DEC9B2B,11381,8,10,2,30,47,1547
18689,18689,6EF3FF760E19F4779DBA83689DEC9B2B,42521,11,12,1,31,47,1597
18690,18690,6EF3FF760E19F4779DBA83689DEC9B2B,11384,16,18,2,30,47,1547
18691,18691,6EF3FF760E19F4779DBA83689DEC9B2B,42521,19,20,1,31,47,1597
18703,18703,D6932FB45D03368B8FD3FCD5E6F4054F,11531,0,2,2,34,49,1749
18704,18704,D6932FB45D03368B8FD3FCD5E6F4054F,11481,3,14,11,41,48,2098
18705,18705,D6932FB45D03368B8FD3FCD5E6F4054F,11261,16,17,1,36,46,1846
18706,18706,D6932FB45D03368B8FD3FCD5E6F4054F,43341,19,20,1,41,46,2096
18707,18707,D6932FB45D03368B8FD3FCD5E6F4054F,11531,21,23,2,34,49,1749
18708,18708,656752102BA99654C7060CE5B2133D72,19114,0,6,6,7,43,393
18709,18709,656752102BA99654C7060CE5B2133D72,12921,7,11,4,9,41,491
18710,18710,656752102BA99654C7060CE5B2133D72,19114,12,13,1,7,43,393
18711,18711,656752102BA99654C7060CE5B2133D72,12921,13,15,2,9,41,491
18712,18712,656752102BA99654C7060CE5B2133D72,19114,18,23,5,7,43,393
18713,18713,E3B088F7DEFCCE4BD4EB6ADB8F0E5950,10591,2,7,5,39,48,1998
18714,18714,E3B088F7DEFCCE4BD4EB6ADB8F0E5950,12514,7,9,2,38,47,1947
18715,18715,E3B088F7DEFCCE4BD4EB6ADB8F0E5950,41061,20,22,2,34,49,1749
18716,18716,F8ACAFE7389E9DDE128BDDCF7D216693,10292,10,12,2,30,47,1547
18717,18717,F8ACAFE7389E9DDE128BDDCF7D216693,42521,13,14,1,31,47,1597
18718,18718,F8ACAFE7389E9DDE128BDDCF7D216693,10292,15,17,2,30,47,1547
18719,18719,F8ACAFE7389E9DDE128BDDCF7D216693,42681,19,20,1,24,48,1248
18723,18723,9EF4A95256B94781E773FD041E0B016F,11131,0,9,9,33,48,1698
18724,18724,9EF4A95256B94781E773FD041E0B016F,11381,9,12,3,30,47,1547
18725,18725,9EF4A95256B94781E773FD041E0B016F,10841,13,17,4,37,47,1897
18726,18726,9EF4A95256B94781E773FD041E0B016F,10491,18,23,5,33,48,1698
18730,18730,6B8040EDBA3C7A3B7087183B1A963D8F,10971,8,10,2,35,47,1797
18731,18731,6B8040EDBA3C7A3B7087183B1A963D8F,41392,12,14,2,43,48,2198
18732,18732,6B8040EDBA3C7A3B7087183B1A963D8F,11661,16,19,3,40,49,2049
18733,18733,6B8040EDBA3C7A3B7087183B1A963D8F,41392,20,23,3,43,48,2198
18737,18737,E2E5D847403EB3AF1EB811FC6C59A600,42691,0,6,6,24,48,1248
18738,18738,E2E5D847403EB3AF1EB811FC6C59A600,43751,8,17,9,19,48,998
18739,18739,E2E5D847403EB3AF1EB811FC6C59A600,42681,22,23,1,24,48,1248
18740,18740,3CF7B0916CDE9473EE3871FE908999F3,19901,2,5,3,7,44,394
18741,18741,3CF7B0916CDE9473EE3871FE908999F3,19111,6,8,2,9,45,495
18742,18742,3CF7B0916CDE9473EE3871FE908999F3,19114,9,10,1,7,43,393
18743,18743,3CF7B0916CDE9473EE3871FE908999F3,19021,15,17,2,10,45,545
18744,18744,3CF7B0916CDE9473EE3871FE908999F3,19901,22,23,1,7,44,394
18745,18745,2F8CA12038D8BFDAC42D43FF94213821,42381,0,6,6,39,41,1991
18746,18746,2F8CA12038D8BFDAC42D43FF94213821,43451,6,10,4,37,40,1890
18747,18747,2F8CA12038D8BFDAC42D43FF94213821,42381,11,12,1,39,41,1991
18748,18748,2F8CA12038D8BFDAC42D43FF94213821,43451,14,17,3,37,40,1890
18749,18749,2F8CA12038D8BFDAC42D43FF94213821,42381,20,23,3,39,41,1991
18753,18753,015977F21CA69DACA3E876A5F028B2A4,43051,0,5,5,46,45,2345
18754,18754,015977F21CA69DACA3E876A5F028B2A4,13351,5,10,5,48,48,2448
18755,18755,015977F21CA69DACA3E876A5F028B2A4,43051,11,23,12,46,45,2345
18756,18756,E572D34D15CCFF06895D9E2C410E6273,11541,0,1,1,35,49,1799
18757,18757,E572D34D15CCFF06895D9E2C410E6273,42381,12,13,1,39,41,1991
18758,18758,E572D34D15CCFF06895D9E2C410E6273,42151,14,18,4,35,45,1795
18762,18762,C0D3D746EE362DF9092390E1B22CCC4A,11061,1,4,3,29,48,1498
18763,18763,C0D3D746EE362DF9092390E1B22CCC4A,12311,8,19,11,30,44,1544
18764,18764,C0D3D746EE362DF9092390E1B22CCC4A,40445,21,23,2,30,48,1548
18765,18765,C77F23D19DAEA5BB8ADE1BB3D3C261B4,12311,4,6,2,30,44,1544
18766,18766,C77F23D19DAEA5BB8ADE1BB3D3C261B4,42151,6,7,1,35,45,1795
18767,18767,C77F23D19DAEA5BB8ADE1BB3D3C261B4,13911,7,17,10,39,46,1996
18768,18768,C77F23D19DAEA5BB8ADE1BB3D3C261B4,42531,20,22,2,31,45,1595
18769,18769,CDA1EB7B89E47C48A7CAC823B0773234,12661,0,15,15,32,45,1645
18770,18770,CDA1EB7B89E47C48A7CAC823B0773234,10221,17,18,1,34,49,1749
18771,18771,CDA1EB7B89E47C48A7CAC823B0773234,12661,20,21,1,32,45,1645
18782,18782,735AC6A81B1D92C565ED849CD65C0FF3,10301,0,13,13,31,45,1595
18783,18783,735AC6A81B1D92C565ED849CD65C0FF3,11171,16,17,1,33,48,1698
18784,18784,735AC6A81B1D92C565ED849CD65C0FF3,10301,18,21,3,31,45,1595
18785,18785,28C2D2FE4D28624F13409918B749F4EA,42231,1,6,5,37,46,1896
18786,18786,28C2D2FE4D28624F13409918B749F4EA,13121,7,9,2,38,46,1946
18787,18787,28C2D2FE4D28624F13409918B749F4EA,41401,9,11,2,37,46,1896
18788,18788,28C2D2FE4D28624F13409918B749F4EA,13711,11,13,2,38,46,1946
18789,18789,28C2D2FE4D28624F13409918B749F4EA,42231,13,14,1,37,46,1896
18790,18790,28C2D2FE4D28624F13409918B749F4EA,13711,15,18,3,38,46,1946
18791,18791,28C2D2FE4D28624F13409918B749F4EA,11941,18,21,3,37,46,1896
18792,18792,62F6BE848412C7FADEB816AFD62C431F,15141,0,7,7,26,11,1311
18793,18793,62F6BE848412C7FADEB816AFD62C431F,16151,11,19,8,13,11,661
18794,18794,62F6BE848412C7FADEB816AFD62C431F,15121,22,23,1,27,19,1369
18802,18802,7B860BA7EAE0140DDFA28F3E51AB5303,10381,0,5,5,31,49,1599
18803,18803,7B860BA7EAE0140DDFA28F3E51AB5303,10681,6,8,2,30,48,1548
18804,18804,7B860BA7EAE0140DDFA28F3E51AB5303,11291,10,14,4,40,49,2049
18805,18805,7B860BA7EAE0140DDFA28F3E51AB5303,12792,19,23,4,34,30,1730
18825,18825,B400ACFA7232ADC3897E9004784F9482,12491,0,5,5,36,43,1843
18826,18826,B400ACFA7232ADC3897E9004784F9482,11261,5,16,11,36,46,1846
18827,18827,B400ACFA7232ADC3897E9004784F9482,13911,16,17,1,39,46,1996
18828,18828,B400ACFA7232ADC3897E9004784F9482,11261,19,21,2,36,46,1846
18829,18829,B400ACFA7232ADC3897E9004784F9482,12491,21,23,2,36,43,1843
18830,18830,E603F2A5C33E998CCFC11652830903D6,10161,0,13,13,35,49,1799
18831,18831,E603F2A5C33E998CCFC11652830903D6,40341,13,18,5,23,49,1199
18832,18832,E603F2A5C33E998CCFC11652830903D6,40234,21,23,2,35,49,1799
18836,18836,BA06C6DB1A8D5242DF18546BCDE19F8A,13371,0,18,18,41,47,2097
18837,18837,BA06C6DB1A8D5242DF18546BCDE19F8A,10531,19,20,1,34,46,1746
18838,18838,BA06C6DB1A8D5242DF18546BCDE19F8A,11591,21,22,1,36,49,1849
18839,18839,CD8A0BC62566C90CE43992912F799E43,13651,0,12,12,30,47,1547
18840,18840,CD8A0BC62566C90CE43992912F799E43,40341,15,16,1,23,49,1199
18841,18841,CD8A0BC62566C90CE43992912F799E43,13651,21,23,2,30,47,1547
18842,18842,FA6FB9CC3390587BE78898B6D9822B2F,40234,0,13,13,35,49,1799
18843,18843,FA6FB9CC3390587BE78898B6D9822B2F,40341,13,19,6,23,49,1199
18844,18844,FA6FB9CC3390587BE78898B6D9822B2F,40234,20,22,2,35,49,1799
18862,18862,A4FCBCF980DDFAB12455C63BF3680812,11231,0,9,9,37,49,1899
18863,18863,A4FCBCF980DDFAB12455C63BF3680812,11481,11,12,1,41,48,2098
18864,18864,A4FCBCF980DDFAB12455C63BF3680812,11231,12,23,11,37,49,1899
18865,18865,7B34C273E34CE1CA5EC462EE747405EC,12921,1,15,14,9,41,491
18866,18866,7B34C273E34CE1CA5EC462EE747405EC,13231,18,20,2,39,46,1996
18867,18867,7B34C273E34CE1CA5EC462EE747405EC,42031,22,23,1,40,46,2046
18868,18868,D8F61CF3289E3928FCE68B7F3A3EF9A7,43341,0,1,1,41,46,2096
18869,18869,D8F61CF3289E3928FCE68B7F3A3EF9A7,12141,4,6,2,42,45,2145
18870,18870,D8F61CF3289E3928FCE68B7F3A3EF9A7,11074,7,18,11,37,47,1897
18871,18871,D8F61CF3289E3928FCE68B7F3A3EF9A7,43041,20,21,1,41,46,2096
18879,18879,D429753EEB35077FBB0F7FD7B24671DA,42381,4,6,2,39,41,1991
18880,18880,D429753EEB35077FBB0F7FD7B24671DA,43451,6,8,2,37,40,1890
18881,18881,D429753EEB35077FBB0F7FD7B24671DA,42381,12,13,1,39,41,1991
18882,18882,D429753EEB35077FBB0F7FD7B24671DA,43451,15,17,2,37,40,1890
18883,18883,D429753EEB35077FBB0F7FD7B24671DA,42381,22,23,1,39,41,1991
18887,18887,D256AE34DD31744D7365602849D9C40A,42491,0,7,7,32,46,1646
18888,18888,D256AE34DD31744D7365602849D9C40A,10351,8,10,2,28,45,1445
18889,18889,D256AE34DD31744D7365602849D9C40A,12601,11,12,1,25,47,1297
18890,18890,D256AE34DD31744D7365602849D9C40A,10351,12,17,5,28,45,1445
18891,18891,D256AE34DD31744D7365602849D9C40A,42491,20,22,2,32,46,1646
18895,18895,C10EEFAF39D689A1C1E5FEB245DEDC71,40872,0,15,15,30,49,1549
18896,18896,C10EEFAF39D689A1C1E5FEB245DEDC71,11061,16,18,2,29,48,1498
18897,18897,C10EEFAF39D689A1C1E5FEB245DEDC71,43341,19,21,2,41,46,2096
18898,18898,C10EEFAF39D689A1C1E5FEB245DEDC71,11061,22,23,1,29,48,1498
18899,18899,FF60FE79253341509D843369653D3F9C,10921,0,7,7,43,48,2198
18900,18900,FF60FE79253341509D843369653D3F9C,12391,11,13,2,36,49,1849
18901,18901,FF60FE79253341509D843369653D3F9C,10921,14,18,4,43,48,2198
18902,18902,FF60FE79253341509D843369653D3F9C,42471,18,20,2,35,49,1799
18903,18903,59E8BD2B3B6F40BDD7AA0B26E7BC6262,13351,2,3,1,48,48,2448
18904,18904,59E8BD2B3B6F40BDD7AA0B26E7BC6262,13471,3,4,1,47,49,2399
18905,18905,59E8BD2B3B6F40BDD7AA0B26E7BC6262,13351,5,6,1,48,48,2448
18906,18906,59E8BD2B3B6F40BDD7AA0B26E7BC6262,11701,8,18,10,43,48,2198
18907,18907,59E8BD2B3B6F40BDD7AA0B26E7BC6262,43621,19,20,1,46,48,2348
18908,18908,B584ECCE32EE4C49FF68F8E796132301,10801,0,1,1,42,47,2147
18909,18909,B584ECCE32EE4C49FF68F8E796132301,43061,2,12,10,43,46,2196
18910,18910,B584ECCE32EE4C49FF68F8E796132301,10801,16,18,2,42,47,2147
18911,18911,B584ECCE32EE4C49FF68F8E796132301,11301,19,21,2,41,49,2099
18912,18912,B584ECCE32EE4C49FF68F8E796132301,10801,21,23,2,42,47,2147
18922,18922,2FD7CB563CD330B8757D30F36F5DB42E,13111,0,6,6,42,46,2146
18923,18923,2FD7CB563CD330B8757D30F36F5DB42E,43951,7,10,3,49,41,2491
18924,18924,2FD7CB563CD330B8757D30F36F5DB42E,13111,12,23,11,42,46,2146
18925,18925,58FF60972C1637520443DC5766A2AB67,13411,0,5,5,49,42,2492
18926,18926,58FF60972C1637520443DC5766A2AB67,43951,6,10,4,49,41,2491
18927,18927,58FF60972C1637520443DC5766A2AB67,13411,11,13,2,49,42,2492
18928,18928,58FF60972C1637520443DC5766A2AB67,43951,13,14,1,49,41,2491
18929,18929,58FF60972C1637520443DC5766A2AB67,13411,18,23,5,49,42,2492
18930,18930,D3F6CC79419CB8E677F2F17C3DF072CD,13121,0,6,6,38,46,1946
18931,18931,D3F6CC79419CB8E677F2F17C3DF072CD,42331,6,10,4,39,46,1996
18932,18932,D3F6CC79419CB8E677F2F17C3DF072CD,10271,10,11,1,37,46,1896
18933,18933,D3F6CC79419CB8E677F2F17C3DF072CD,13121,12,13,1,38,46,1946
18934,18934,D3F6CC79419CB8E677F2F17C3DF072CD,42301,16,17,1,36,47,1847
18935,18935,D3F6CC79419CB8E677F2F17C3DF072CD,13121,21,23,2,38,46,1946
18939,18939,7011DE96B440B54BDA505351983BAF85,40691,0,1,1,42,48,2148
18940,18940,7011DE96B440B54BDA505351983BAF85,11021,2,15,13,36,49,1849
18941,18941,7011DE96B440B54BDA505351983BAF85,11751,15,16,1,35,48,1798
18942,18942,7011DE96B440B54BDA505351983BAF85,11021,17,19,2,36,49,1849
18949,18949,AE64A3DFBE9C3342907BF204A8902B7B,12311,0,1,1,30,44,1544
18950,18950,AE64A3DFBE9C3342907BF204A8902B7B,42531,2,3,1,31,45,1595
18951,18951,AE64A3DFBE9C3342907BF204A8902B7B,12311,5,17,12,30,44,1544
18952,18952,AE64A3DFBE9C3342907BF204A8902B7B,42531,19,21,2,31,45,1595
18953,18953,AE64A3DFBE9C3342907BF204A8902B7B,12311,21,23,2,30,44,1544
18954,18954,830BA59E393410359A3D87FC0A13EB43,11074,0,1,1,37,47,1897
18955,18955,830BA59E393410359A3D87FC0A13EB43,42301,2,6,4,36,47,1847
18956,18956,830BA59E393410359A3D87FC0A13EB43,11074,7,9,2,37,47,1897
18957,18957,830BA59E393410359A3D87FC0A13EB43,10107,17,19,2,38,49,1949
18958,18958,830BA59E393410359A3D87FC0A13EB43,11074,20,21,1,37,47,1897
18962,18962,AC63A44AAFE297AD4CD776B1B1348D18,11551,1,7,6,39,49,1999
18963,18963,AC63A44AAFE297AD4CD776B1B1348D18,12601,10,15,5,25,47,1297
18964,18964,AC63A44AAFE297AD4CD776B1B1348D18,11381,20,21,1,30,47,1547
18969,18969,04ED2C698002ED049877B001216EC992,42971,0,14,14,43,49,2199
18970,18970,04ED2C698002ED049877B001216EC992,42191,15,18,3,38,49,1949
18971,18971,04ED2C698002ED049877B001216EC992,42971,19,23,4,43,49,2199
18972,18972,23A21A73FEBD9CCFAF6CD9924910EBC0,10901,2,5,3,35,48,1798
18973,18973,23A21A73FEBD9CCFAF6CD9924910EBC0,12083,5,6,1,36,49,1849
18974,18974,23A21A73FEBD9CCFAF6CD9924910EBC0,10251,9,12,3,35,47,1797
18975,18975,23A21A73FEBD9CCFAF6CD9924910EBC0,10107,12,14,2,38,49,1949
18976,18976,23A21A73FEBD9CCFAF6CD9924910EBC0,10251,15,20,5,35,47,1797
18977,18977,23A21A73FEBD9CCFAF6CD9924910EBC0,11781,20,22,2,38,49,1949
18978,18978,9C35C609BEEB7023F559DA7824DEFA84,11061,1,5,4,29,48,1498
18979,18979,9C35C609BEEB7023F559DA7824DEFA84,10681,7,8,1,30,48,1548
18980,18980,9C35C609BEEB7023F559DA7824DEFA84,11061,10,14,4,29,48,1498
18981,18981,9C35C609BEEB7023F559DA7824DEFA84,16451,18,19,1,5,5,255
18982,18982,F4F868B9360D29EF169CCB1C386B42DC,10351,2,3,1,28,45,1445
18983,18983,F4F868B9360D29EF169CCB1C386B42DC,13771,5,6,1,21,45,1095
18984,18984,F4F868B9360D29EF169CCB1C386B42DC,12601,7,20,13,25,47,1297
18985,18985,4FA7E2AF35091649A8D61648BF92F5C0,42521,0,1,1,31,47,1597
18986,18986,4FA7E2AF35091649A8D61648BF92F5C0,42581,2,17,15,38,48,1948
18987,18987,4FA7E2AF35091649A8D61648BF92F5C0,10471,19,20,1,37,48,1898
18994,18994,7EA63201A47B68AA085BD7B8AF1F7767,10721,0,7,7,31,48,1598
18995,18995,7EA63201A47B68AA085BD7B8AF1F7767,12083,8,17,9,36,49,1849
18996,18996,7EA63201A47B68AA085BD7B8AF1F7767,11231,17,18,1,37,49,1899
18997,18997,7EA63201A47B68AA085BD7B8AF1F7767,10721,19,23,4,31,48,1598
19008,19008,5C04F6FD3F97ABC2FBFD2ECD3C21BB3B,10491,0,7,7,33,48,1698
19009,19009,5C04F6FD3F97ABC2FBFD2ECD3C21BB3B,10471,9,11,2,37,48,1898
19010,19010,5C04F6FD3F97ABC2FBFD2ECD3C21BB3B,13121,13,14,1,38,46,1946
19011,19011,5C04F6FD3F97ABC2FBFD2ECD3C21BB3B,11201,16,17,1,35,49,1799
19012,19012,5C04F6FD3F97ABC2FBFD2ECD3C21BB3B,10491,18,19,1,33,48,1698
19013,19013,5C04F6FD3F97ABC2FBFD2ECD3C21BB3B,11951,20,21,1,31,49,1599
19014,19014,5C04F6FD3F97ABC2FBFD2ECD3C21BB3B,10491,22,23,1,33,48,1698
19015,19015,4A9A38580859CB2B42032E604DDC1F1E,11231,1,3,2,37,49,1899
19016,19016,4A9A38580859CB2B42032E604DDC1F1E,11591,4,6,2,36,49,1849
19017,19017,4A9A38580859CB2B42032E604DDC1F1E,11231,8,16,8,37,49,1899
19018,19018,4A9A38580859CB2B42032E604DDC1F1E,11875,19,20,1,30,46,1546
19019,19019,2FC158799FF19F821FBD3DC4EFE863DB,13551,1,5,4,45,38,2288
19020,19020,2FC158799FF19F821FBD3DC4EFE863DB,43101,6,10,4,46,40,2340
19021,19021,2FC158799FF19F821FBD3DC4EFE863DB,13551,10,11,1,45,38,2288
19022,19022,2FC158799FF19F821FBD3DC4EFE863DB,43101,13,19,6,46,40,2340
19023,19023,2FC158799FF19F821FBD3DC4EFE863DB,13551,19,20,1,45,38,2288
19024,19024,2FC158799FF19F821FBD3DC4EFE863DB,43101,21,22,1,46,40,2340
19025,19025,3C0CB34A7E303948C8918CC6F892568C,13094,0,5,5,21,42,1092
19026,19026,3C0CB34A7E303948C8918CC6F892568C,12601,6,9,3,25,47,1297
19027,19027,3C0CB34A7E303948C8918CC6F892568C,40951,18,19,1,36,49,1849
19031,19031,794591C4B55811A42DDE51329306C4D0,40636,0,5,5,35,48,1798
19032,19032,794591C4B55811A42DDE51329306C4D0,11831,8,9,1,32,45,1645
19033,19033,794591C4B55811A42DDE51329306C4D0,13511,11,13,2,34,48,1748
19034,19034,794591C4B55811A42DDE51329306C4D0,10924,17,19,2,43,49,2199
19041,19041,7E9A69DC2C0BD2AEF8D59ED488EE9F9C,10171,0,12,12,26,47,1347
19042,19042,7E9A69DC2C0BD2AEF8D59ED488EE9F9C,43281,13,17,4,37,48,1898
19043,19043,7E9A69DC2C0BD2AEF8D59ED488EE9F9C,10107,20,22,2,38,49,1949
19044,19044,658F51686040AA05DF52C044278C9795,12792,0,10,10,34,30,1730
19045,19045,658F51686040AA05DF52C044278C9795,15391,12,17,5,35,26,1776
19046,19046,658F51686040AA05DF52C044278C9795,12792,19,20,1,34,30,1730
19047,19047,5AC626748B148F3C250146053DCA3D88,12311,5,6,1,30,44,1544
19048,19048,5AC626748B148F3C250146053DCA3D88,12871,10,13,3,22,33,1133
19049,19049,5AC626748B148F3C250146053DCA3D88,19281,13,18,5,16,32,832
19050,19050,A4CBFA774BBCB1E081978588796288CA,10681,0,7,7,30,48,1548
19051,19051,A4CBFA774BBCB1E081978588796288CA,11231,8,15,7,37,49,1899
19052,19052,A4CBFA774BBCB1E081978588796288CA,10901,18,23,5,35,48,1798
19059,19059,D6DF6508961D56D6ADF21B3B5E7B843B,10154,1,8,7,33,47,1697
19060,19060,D6DF6508961D56D6ADF21B3B5E7B843B,13601,8,9,1,34,47,1747
19061,19061,D6DF6508961D56D6ADF21B3B5E7B843B,43761,10,11,1,32,47,1647
19062,19062,D6DF6508961D56D6ADF21B3B5E7B843B,13511,18,20,2,34,48,1748
19063,19063,D6DF6508961D56D6ADF21B3B5E7B843B,42921,21,23,2,33,47,1697
19070,19070,315EE087A7D3E5A0308BA99609B9790D,42531,0,7,7,31,45,1595
19071,19071,315EE087A7D3E5A0308BA99609B9790D,12661,8,10,2,32,45,1645
19072,19072,315EE087A7D3E5A0308BA99609B9790D,12491,10,12,2,36,43,1843
19073,19073,315EE087A7D3E5A0308BA99609B9790D,12661,15,17,2,32,45,1645
19074,19074,315EE087A7D3E5A0308BA99609B9790D,42531,20,23,3,31,45,1595
19086,19086,9F569681847AE1CB91DC5B95636EE88A,19021,3,4,1,10,45,545
19087,19087,9F569681847AE1CB91DC5B95636EE88A,43021,7,18,11,16,43,843
19088,19088,9F569681847AE1CB91DC5B95636EE88A,11571,19,20,1,13,46,696
19092,19092,D7D05175178ECCC354BF6E061771BD76,11491,0,7,7,36,47,1847
19093,19093,D7D05175178ECCC354BF6E061771BD76,19441,9,16,7,8,46,446
19094,19094,D7D05175178ECCC354BF6E061771BD76,42091,18,20,2,43,46,2196
19095,19095,D7D05175178ECCC354BF6E061771BD76,42941,21,23,2,37,47,1897
19096,19096,EB6AB320D42F3A567B39AAAFD2B62EB6,42081,10,12,2,24,49,1249
19097,19097,EB6AB320D42F3A567B39AAAFD2B62EB6,42121,14,15,1,26,49,1349
19098,19098,EB6AB320D42F3A567B39AAAFD2B62EB6,42071,16,18,2,31,49,1599
19099,19099,4B5119258FB3482B746B53277561992F,12051,2,3,1,20,47,1047
19100,19100,4B5119258FB3482B746B53277561992F,12601,7,8,1,25,47,1297
19101,19101,4B5119258FB3482B746B53277561992F,12581,10,11,1,24,48,1248
19102,19102,4B5119258FB3482B746B53277561992F,12051,14,16,2,20,47,1047
19103,19103,4B5119258FB3482B746B53277561992F,12601,20,23,3,25,47,1297
19107,19107,2E12D33071EE9A8F39B5823A4CAB25EC,40124,10,11,1,38,47,1947
19108,19108,2E12D33071EE9A8F39B5823A4CAB25EC,10724,15,17,2,32,48,1648
19109,19109,2E12D33071EE9A8F39B5823A4CAB25EC,11201,18,22,4,35,49,1799
19110,19110,2E12D33071EE9A8F39B5823A4CAB25EC,11591,22,23,1,36,49,1849
19121,19121,CABE08DD3D6685CC86F112C668C4339B,42921,0,5,5,33,47,1697
19122,19122,CABE08DD3D6685CC86F112C668C4339B,16233,9,13,4,5,15,265
19123,19123,CABE08DD3D6685CC86F112C668C4339B,13651,16,17,1,30,47,1547
19124,19124,CABE08DD3D6685CC86F112C668C4339B,12121,19,20,1,29,47,1497
19125,19125,07BDD3FC9C0370EC0810F6F38EA5874D,42871,0,4,4,30,45,1545
19126,19126,07BDD3FC9C0370EC0810F6F38EA5874D,11875,4,6,2,30,46,1546
19127,19127,07BDD3FC9C0370EC0810F6F38EA5874D,42871,6,7,1,30,45,1545
19128,19128,07BDD3FC9C0370EC0810F6F38EA5874D,11875,10,14,4,30,46,1546
19129,19129,07BDD3FC9C0370EC0810F6F38EA5874D,42531,14,21,7,31,45,1595
19137,19137,1189315DA9241337F02D02A6E4EB64F7,11321,0,1,1,31,46,1596
19138,19138,1189315DA9241337F02D02A6E4EB64F7,11871,1,5,4,29,46,1496
19139,19139,1189315DA9241337F02D02A6E4EB64F7,11321,5,7,2,31,46,1596
19140,19140,1189315DA9241337F02D02A6E4EB64F7,11941,11,13,2,37,46,1896
19141,19141,1189315DA9241337F02D02A6E4EB64F7,12311,13,14,1,30,44,1544
19142,19142,1189315DA9241337F02D02A6E4EB64F7,11941,17,18,1,37,46,1896
19150,19150,56380B9BCFA6857A7D3E4BBFC0E5BBBD,12514,0,2,2,38,47,1947
19151,19151,56380B9BCFA6857A7D3E4BBFC0E5BBBD,12841,2,4,2,37,47,1897
19152,19152,56380B9BCFA6857A7D3E4BBFC0E5BBBD,12514,4,10,6,38,47,1947
19153,19153,56380B9BCFA6857A7D3E4BBFC0E5BBBD,12841,10,12,2,37,47,1897
19154,19154,56380B9BCFA6857A7D3E4BBFC0E5BBBD,41005,13,14,1,38,47,1947
19155,19155,56380B9BCFA6857A7D3E4BBFC0E5BBBD,11074,16,21,5,37,47,1897
19156,19156,56380B9BCFA6857A7D3E4BBFC0E5BBBD,41005,21,23,2,38,47,1947
19157,19157,17F16B9945DA25C24769F99FED15A3C2,10711,1,5,4,29,46,1496
19158,19158,17F16B9945DA25C24769F99FED15A3C2,11875,6,8,2,30,46,1546
19159,19159,17F16B9945DA25C24769F99FED15A3C2,12311,8,14,6,30,44,1544
19160,19160,17F16B9945DA25C24769F99FED15A3C2,13671,15,16,1,27,43,1393
19161,19161,17F16B9945DA25C24769F99FED15A3C2,42531,17,19,2,31,45,1595
19162,19162,C97051E6FB48C1025E34799B4F49424B,42351,0,6,6,38,45,1945
19163,19163,C97051E6FB48C1025E34799B4F49424B,42231,6,10,4,37,46,1896
19164,19164,C97051E6FB48C1025E34799B4F49424B,42351,11,13,2,38,45,1945
19165,19165,C97051E6FB48C1025E34799B4F49424B,42231,13,17,4,37,46,1896
19166,19166,C97051E6FB48C1025E34799B4F49424B,42351,22,23,1,38,45,1945
19167,19167,A1F76E9AE160B1A2577BA1E3948B2B29,42864,2,9,7,38,44,1944
19168,19168,A1F76E9AE160B1A2577BA1E3948B2B29,11261,10,11,1,36,46,1846
19169,19169,A1F76E9AE160B1A2577BA1E3948B2B29,42864,12,14,2,38,44,1944
19170,19170,A1F76E9AE160B1A2577BA1E3948B2B29,11261,17,18,1,36,46,1846
19171,19171,A1F76E9AE160B1A2577BA1E3948B2B29,42864,20,23,3,38,44,1944
19172,19172,A2F2C135FB8A85AE2B600186750DF2A5,11231,0,14,14,37,49,1899
19173,19173,A2F2C135FB8A85AE2B600186750DF2A5,40341,18,19,1,23,49,1199
19174,19174,A2F2C135FB8A85AE2B600186750DF2A5,11231,21,23,2,37,49,1899
19175,19175,72272CDC285000236363EA14A7DE70DE,43341,0,2,2,41,46,2096
19176,19176,72272CDC285000236363EA14A7DE70DE,42301,2,7,5,36,47,1847
19177,19177,72272CDC285000236363EA14A7DE70DE,11521,8,9,1,41,48,2098
19178,19178,72272CDC285000236363EA14A7DE70DE,42301,11,15,4,36,47,1847
19179,19179,72272CDC285000236363EA14A7DE70DE,11521,16,21,5,41,48,2098
19184,19184,5ED8949BAC5CDF05EDA1019FB7CA4B17,42401,0,7,7,36,47,1847
19185,19185,5ED8949BAC5CDF05EDA1019FB7CA4B17,42941,7,9,2,37,47,1897
19186,19186,5ED8949BAC5CDF05EDA1019FB7CA4B17,42401,10,11,1,36,47,1847
19187,19187,5ED8949BAC5CDF05EDA1019FB7CA4B17,42941,12,14,2,37,47,1897
19188,19188,5ED8949BAC5CDF05EDA1019FB7CA4B17,42191,15,16,1,38,49,1949
19189,19189,5ED8949BAC5CDF05EDA1019FB7CA4B17,10471,16,20,4,37,48,1898
19190,19190,5ED8949BAC5CDF05EDA1019FB7CA4B17,42941,21,22,1,37,47,1897
19191,19191,8AB561279CAFD673B81CFFF6F25401C3,12221,0,5,5,43,44,2194
19192,19192,8AB561279CAFD673B81CFFF6F25401C3,43011,8,9,1,40,42,2042
19193,19193,8AB561279CAFD673B81CFFF6F25401C3,13951,12,15,3,47,45,2395
19194,19194,8AB561279CAFD673B81CFFF6F25401C3,43011,17,23,6,40,42,2042
19195,19195,DD4D28FDBCFFE930AF28BD3956ED9308,11381,0,9,9,30,47,1547
19196,19196,DD4D28FDBCFFE930AF28BD3956ED9308,42521,12,13,1,31,47,1597
19197,19197,DD4D28FDBCFFE930AF28BD3956ED9308,11381,14,16,2,30,47,1547
19198,19198,DD4D28FDBCFFE930AF28BD3956ED9308,11831,18,20,2,32,45,1645
19199,19199,DD4D28FDBCFFE930AF28BD3956ED9308,11381,22,23,1,30,47,1547
19200,19200,54E9147B0F88496112EA8083546467E6,12661,0,15,15,32,45,1645
19201,19201,54E9147B0F88496112EA8083546467E6,43451,16,17,1,37,40,1890
19202,19202,54E9147B0F88496112EA8083546467E6,40381,20,21,1,32,46,1646
19203,19203,6EC25BB5BAEED237275896EB7FD004D5,10341,0,7,7,31,47,1597
19204,19204,6EC25BB5BAEED237275896EB7FD004D5,11541,11,17,6,35,49,1799
19205,19205,6EC25BB5BAEED237275896EB7FD004D5,11531,20,21,1,34,49,1749
19221,19221,7B7808F449A709BA37633BF3E740E9A3,43051,0,5,5,46,45,2345
19222,19222,7B7808F449A709BA37633BF3E740E9A3,12211,6,10,4,41,44,2094
19223,19223,7B7808F449A709BA37633BF3E740E9A3,43051,12,13,1,46,45,2345
19224,19224,7B7808F449A709BA37633BF3E740E9A3,12211,17,19,2,41,44,2094
19225,19225,7B7808F449A709BA37633BF3E740E9A3,43051,22,23,1,46,45,2345
19226,19226,F89B6A4AE0D695ACACC8DA318E680D35,10221,0,10,10,34,49,1749
19227,19227,F89B6A4AE0D695ACACC8DA318E680D35,40341,11,14,3,23,49,1199
19228,19228,F89B6A4AE0D695ACACC8DA318E680D35,10221,16,23,7,34,49,1749
19233,19233,01AC0A4D33D82D8BBF22F99622A8A450,42301,0,7,7,36,47,1847
19234,19234,01AC0A4D33D82D8BBF22F99622A8A450,10841,7,10,3,37,47,1897
19235,19235,01AC0A4D33D82D8BBF22F99622A8A450,42221,12,20,8,38,48,1948
19236,19236,01AC0A4D33D82D8BBF22F99622A8A450,13731,21,23,2,33,49,1699
19243,19243,F7BA1E9C235C1D8A36FA4FE83DC9EFDD,10161,0,1,1,35,49,1799
19244,19244,F7BA1E9C235C1D8A36FA4FE83DC9EFDD,11351,4,6,2,36,48,1848
19245,19245,F7BA1E9C235C1D8A36FA4FE83DC9EFDD,10161,7,8,1,35,49,1799
19246,19246,F7BA1E9C235C1D8A36FA4FE83DC9EFDD,11731,8,10,2,36,48,1848
19247,19247,F7BA1E9C235C1D8A36FA4FE83DC9EFDD,40951,14,15,1,36,49,1849
19248,19248,F7BA1E9C235C1D8A36FA4FE83DC9EFDD,11541,17,23,6,35,49,1799
19249,19249,E4DAC22C285EE7DCF2A6491936A72882,43061,3,4,1,43,46,2196
19250,19250,E4DAC22C285EE7DCF2A6491936A72882,42461,5,9,4,45,47,2297
19251,19251,E4DAC22C285EE7DCF2A6491936A72882,40991,14,15,1,39,47,1997
19252,19252,E4DAC22C285EE7DCF2A6491936A72882,13121,20,21,1,38,46,1946
19253,19253,B407E10E40F14F417BB48241B7C62C97,13271,0,7,7,41,47,2097
19254,19254,B407E10E40F14F417BB48241B7C62C97,12971,8,10,2,32,48,1648
19255,19255,B407E10E40F14F417BB48241B7C62C97,42583,13,14,1,40,48,2048
19256,19256,B407E10E40F14F417BB48241B7C62C97,13271,19,22,3,41,47,2097
19263,19263,4D5F3AD35DC755EFFA8D428280AF81F0,42491,1,7,6,32,46,1646
19264,19264,4D5F3AD35DC755EFFA8D428280AF81F0,10107,8,15,7,38,49,1949
19265,19265,4D5F3AD35DC755EFFA8D428280AF81F0,12511,16,17,1,39,47,1997
19266,19266,4D5F3AD35DC755EFFA8D428280AF81F0,11074,19,20,1,37,47,1897
19267,19267,4D5F3AD35DC755EFFA8D428280AF81F0,12511,22,23,1,39,47,1997
19268,19268,2E8172F150A9CB734EA29311F057551D,40697,0,9,9,43,48,2198
19269,19269,2E8172F150A9CB734EA29311F057551D,10191,13,14,1,40,48,2048
19270,19270,2E8172F150A9CB734EA29311F057551D,40341,16,18,2,23,49,1199
19271,19271,2E8172F150A9CB734EA29311F057551D,10911,21,23,2,39,46,1996
19279,19279,A0FB1A35C6EC10006C4179C92313F035,11074,1,4,3,37,47,1897
19280,19280,A0FB1A35C6EC10006C4179C92313F035,19821,6,11,5,4,46,246
19281,19281,A0FB1A35C6EC10006C4179C92313F035,11331,14,17,3,37,48,1898
19282,19282,A0FB1A35C6EC10006C4179C92313F035,11074,18,19,1,37,47,1897
19283,19283,A0FB1A35C6EC10006C4179C92313F035,11331,22,23,1,37,48,1898
19284,19284,401DBF9291C70DB6E3FE8385830F996E,13791,0,6,6,42,47,2147
19285,19285,401DBF9291C70DB6E3FE8385830F996E,11151,7,11,4,30,48,1548
19286,19286,401DBF9291C70DB6E3FE8385830F996E,11021,11,14,3,36,49,1849
19287,19287,401DBF9291C70DB6E3FE8385830F996E,10221,15,18,3,34,49,1749
19288,19288,401DBF9291C70DB6E3FE8385830F996E,13791,19,23,4,42,47,2147
19298,19298,439D8CB010A4086802C0243322BA6C31,11061,3,7,4,29,48,1498
19299,19299,439D8CB010A4086802C0243322BA6C31,40343,7,18,11,24,49,1249
19300,19300,439D8CB010A4086802C0243322BA6C31,11061,20,23,3,29,48,1498
19301,19301,103E83B36F4F1A0A16AEE8F68284E109,12601,1,2,1,25,47,1297
19302,19302,103E83B36F4F1A0A16AEE8F68284E109,12671,6,7,1,21,43,1093
19303,19303,103E83B36F4F1A0A16AEE8F68284E109,12601,10,11,1,25,47,1297
19304,19304,103E83B36F4F1A0A16AEE8F68284E109,13094,15,18,3,21,42,1092
19305,19305,A7B6F0B0D3774C48BB90BD614E267D14,11381,0,8,8,30,47,1547
19306,19306,A7B6F0B0D3774C48BB90BD614E267D14,10107,11,12,1,38,49,1949
19307,19307,A7B6F0B0D3774C48BB90BD614E267D14,11381,13,23,10,30,47,1547
19311,19311,3473FA09F0017B3BD24476C962AE1520,13314,0,6,6,31,39,1589
19312,19312,3473FA09F0017B3BD24476C962AE1520,12521,11,14,3,35,41,1791
19313,19313,3473FA09F0017B3BD24476C962AE1520,43451,15,16,1,37,40,1890
19314,19314,3473FA09F0017B3BD24476C962AE1520,13314,20,22,2,31,39,1589
19315,19315,CA601ED32D4DA950EA12F7A37DA37141,12221,0,8,8,43,44,2194
19316,19316,CA601ED32D4DA950EA12F7A37DA37141,10471,8,18,10,37,48,1898
19317,19317,CA601ED32D4DA950EA12F7A37DA37141,12221,19,23,4,43,44,2194
19318,19318,6D9FB4ED2E7AEE11F6487047937EFA12,43311,0,8,8,31,48,1598
19319,19319,6D9FB4ED2E7AEE11F6487047937EFA12,42081,10,11,1,24,49,1249
19320,19320,6D9FB4ED2E7AEE11F6487047937EFA12,42071,13,15,2,31,49,1599
19321,19321,6D9FB4ED2E7AEE11F6487047937EFA12,43311,18,23,5,31,48,1598
19329,19329,39E8FB5C4AE9A0E0783441178F244CD5,10341,0,7,7,31,47,1597
19330,19330,39E8FB5C4AE9A0E0783441178F244CD5,11201,9,10,1,35,49,1799
19331,19331,39E8FB5C4AE9A0E0783441178F244CD5,10341,11,14,3,31,47,1597
19332,19332,39E8FB5C4AE9A0E0783441178F244CD5,11201,15,19,4,35,49,1799
19333,19333,DF341E60FE23ABEB43136A6E3F43280F,40673,3,11,8,36,48,1848
19334,19334,DF341E60FE23ABEB43136A6E3F43280F,42381,16,17,1,39,41,1991
19335,19335,DF341E60FE23ABEB43136A6E3F43280F,42623,19,20,1,22,49,1149
19336,19336,DF341E60FE23ABEB43136A6E3F43280F,10191,21,22,1,40,48,2048
19337,19337,314FB4A6DA6D4C6188B7BC6C319ABAA8,13371,0,18,18,41,47,2097
19338,19338,314FB4A6DA6D4C6188B7BC6C319ABAA8,10151,19,20,1,34,47,1747
19339,19339,314FB4A6DA6D4C6188B7BC6C319ABAA8,11021,21,23,2,36,49,1849
19340,19340,1C2E5D35E874E2C86003118172405D96,15081,0,14,14,27,1,1351
19341,19341,1C2E5D35E874E2C86003118172405D96,42161,17,19,2,36,47,1847
19342,19342,1C2E5D35E874E2C86003118172405D96,10251,19,23,4,35,47,1797
19343,19343,F8584A5277683398A2423E9367C858A2,10151,0,13,13,34,47,1747
19344,19344,F8584A5277683398A2423E9367C858A2,13371,14,18,4,41,47,2097
19345,19345,F8584A5277683398A2423E9367C858A2,10121,19,20,1,36,49,1849
19346,19346,5F3681CA154176D9C587280037CBB99D,13561,0,8,8,37,49,1899
19347,19347,5F3681CA154176D9C587280037CBB99D,13091,10,20,10,20,42,1042
19348,19348,5F3681CA154176D9C587280037CBB99D,13561,21,23,2,37,49,1899
19349,19349,27278737D09D5670A3F233313E8FF2D1,10341,0,9,9,31,47,1597
19350,19350,27278737D09D5670A3F233313E8FF2D1,42511,9,13,4,37,47,1897
19351,19351,27278737D09D5670A3F233313E8FF2D1,11861,14,19,5,32,47,1647
19352,19352,27278737D09D5670A3F233313E8FF2D1,42021,21,22,1,33,47,1697
19353,19353,2EF6C0FB2DECBC4A57AE198EC3FD678A,10971,0,8,8,35,47,1797
19354,19354,2EF6C0FB2DECBC4A57AE198EC3FD678A,42021,9,11,2,33,47,1697
19355,19355,2EF6C0FB2DECBC4A57AE198EC3FD678A,10971,13,14,1,35,47,1797
19356,19356,2EF6C0FB2DECBC4A57AE198EC3FD678A,42021,15,17,2,33,47,1697
19357,19357,2EF6C0FB2DECBC4A57AE198EC3FD678A,10971,18,23,5,35,47,1797
19375,19375,70BC072844C7CA9E90555B310CFF3C22,10511,1,6,5,35,46,1796
19376,19376,70BC072844C7CA9E90555B310CFF3C22,12381,9,17,8,32,48,1648
19377,19377,70BC072844C7CA9E90555B310CFF3C22,43731,18,23,5,34,47,1747
19384,19384,1034E32537CD89A54195B02D13F8F6C7,42581,4,7,3,38,48,1948
19385,19385,1034E32537CD89A54195B02D13F8F6C7,11914,10,12,2,37,48,1898
19386,19386,1034E32537CD89A54195B02D13F8F6C7,42581,16,17,1,38,48,1948
19387,19387,1034E32537CD89A54195B02D13F8F6C7,11914,17,19,2,37,48,1898
19388,19388,1034E32537CD89A54195B02D13F8F6C7,42581,19,20,1,38,48,1948
19389,19389,FCB3F67711CEBAA3447F5F56A47CDE2C,41031,0,8,8,32,49,1649
19390,19390,FCB3F67711CEBAA3447F5F56A47CDE2C,10651,9,18,9,36,49,1849
19391,19391,FCB3F67711CEBAA3447F5F56A47CDE2C,13711,18,19,1,38,46,1946
19392,19392,FCB3F67711CEBAA3447F5F56A47CDE2C,41031,21,23,2,32,49,1649
19400,19400,48D09EA1E123F030FD71CF37426D4799,12661,4,7,3,32,45,1645
19401,19401,48D09EA1E123F030FD71CF37426D4799,43011,8,15,7,40,42,2042
19402,19402,48D09EA1E123F030FD71CF37426D4799,42151,17,18,1,35,45,1795
19403,19403,227CF90E190A804F43263E2E6F09CFEC,10681,0,8,8,30,48,1548
19404,19404,227CF90E190A804F43263E2E6F09CFEC,11061,8,9,1,29,48,1498
19405,19405,227CF90E190A804F43263E2E6F09CFEC,10681,11,13,2,30,48,1548
19406,19406,227CF90E190A804F43263E2E6F09CFEC,11061,18,19,1,29,48,1498
19407,19407,227CF90E190A804F43263E2E6F09CFEC,10681,19,23,4,30,48,1548
19408,19408,B75BCB143B608EA57EF37455962D78CA,10381,5,6,1,31,49,1599
19409,19409,B75BCB143B608EA57EF37455962D78CA,42121,6,9,3,26,49,1349
19410,19410,B75BCB143B608EA57EF37455962D78CA,42261,10,11,1,25,49,1299
19411,19411,B75BCB143B608EA57EF37455962D78CA,42121,13,14,1,26,49,1349
19412,19412,B75BCB143B608EA57EF37455962D78CA,10381,16,18,2,31,49,1599
19413,19413,41A2C6E6D23A79E0E83BD50C9E9BD283,43061,0,8,8,43,46,2196
19414,19414,41A2C6E6D23A79E0E83BD50C9E9BD283,42381,10,11,1,39,41,1991
19415,19415,41A2C6E6D23A79E0E83BD50C9E9BD283,43061,13,14,1,43,46,2196
19416,19416,41A2C6E6D23A79E0E83BD50C9E9BD283,40341,15,18,3,23,49,1199
19417,19417,C416994B9DC2E3F8C8BB43A19558B9AA,16281,1,2,1,11,4,554
19418,19418,C416994B9DC2E3F8C8BB43A19558B9AA,15143,3,4,1,18,7,907
19419,19419,C416994B9DC2E3F8C8BB43A19558B9AA,16281,4,5,1,11,4,554
19420,19420,C416994B9DC2E3F8C8BB43A19558B9AA,15143,6,8,2,18,7,907
19421,19421,C416994B9DC2E3F8C8BB43A19558B9AA,16431,12,13,1,8,6,406
19422,19422,C416994B9DC2E3F8C8BB43A19558B9AA,16281,16,17,1,11,4,554
19423,19423,C416994B9DC2E3F8C8BB43A19558B9AA,15081,18,22,4,27,1,1351
19424,19424,135EF939D99CED11694D71795A5772B0,19031,0,5,5,1,42,92
19425,19425,135EF939D99CED11694D71795A5772B0,12641,6,11,5,10,43,543
19426,19426,135EF939D99CED11694D71795A5772B0,19031,12,14,2,1,42,92
19427,19427,135EF939D99CED11694D71795A5772B0,12641,14,19,5,10,43,543
19428,19428,135EF939D99CED11694D71795A5772B0,19031,19,20,1,1,42,92
19429,19429,67BCB76F611F63115F44CBB7619B7D68,42161,0,6,6,36,47,1847
19430,19430,67BCB76F611F63115F44CBB7619B7D68,11641,6,13,7,22,49,1149
19431,19431,67BCB76F611F63115F44CBB7619B7D68,43161,15,23,8,35,47,1797
19432,19432,C26E8813A9B156CA76EEA4209607C4C4,11541,0,10,10,35,49,1799
19433,19433,C26E8813A9B156CA76EEA4209607C4C4,13091,10,12,2,20,42,1042
19434,19434,C26E8813A9B156CA76EEA4209607C4C4,10471,13,14,1,37,48,1898
19435,19435,C26E8813A9B156CA76EEA4209607C4C4,10161,15,23,8,35,49,1799
19436,19436,97FCA27FBAB61054BFDE4D656BD2C4E9,10381,1,6,5,31,49,1599
19437,19437,97FCA27FBAB61054BFDE4D656BD2C4E9,42261,10,11,1,25,49,1299
19438,19438,97FCA27FBAB61054BFDE4D656BD2C4E9,42071,15,23,8,31,49,1599
19439,19439,1AA7DB20B834ED966293F55CB7953375,10381,1,8,7,31,49,1599
19440,19440,1AA7DB20B834ED966293F55CB7953375,42261,9,18,9,25,49,1299
19441,19441,1AA7DB20B834ED966293F55CB7953375,10381,21,22,1,31,49,1599
19442,19442,0324B4BC4AC52B5FF38CABDD51C922F7,42141,0,5,5,32,47,1647
19443,19443,0324B4BC4AC52B5FF38CABDD51C922F7,12561,7,8,1,45,43,2293
19444,19444,0324B4BC4AC52B5FF38CABDD51C922F7,12221,12,13,1,43,44,2194
19445,19445,0324B4BC4AC52B5FF38CABDD51C922F7,13341,14,15,1,44,45,2245
19446,19446,0324B4BC4AC52B5FF38CABDD51C922F7,42141,20,23,3,32,47,1647
19447,19447,4CA1188698B5DD1E66E2EDCA80216CDE,12571,0,6,6,48,39,2439
19448,19448,4CA1188698B5DD1E66E2EDCA80216CDE,13071,11,14,3,41,41,2091
19449,19449,4CA1188698B5DD1E66E2EDCA80216CDE,43101,15,21,6,46,40,2340
19453,19453,7B27DF400F344F6F46338A9F907AAD49,19021,0,6,6,10,45,545
19454,19454,7B27DF400F344F6F46338A9F907AAD49,12641,6,15,9,10,43,543
19455,19455,7B27DF400F344F6F46338A9F907AAD49,43021,18,20,2,16,43,843
19456,19456,7B27DF400F344F6F46338A9F907AAD49,19021,21,23,2,10,45,545
19461,19461,D8EB6BE19D6F1BE7A38B119F9A32FCB2,12661,3,6,3,32,45,1645
19462,19462,D8EB6BE19D6F1BE7A38B119F9A32FCB2,42531,11,13,2,31,45,1595
19463,19463,D8EB6BE19D6F1BE7A38B119F9A32FCB2,42931,17,22,5,41,49,2099
19471,19471,970C5B25507CD6DAD2276870EE5AE8B6,13511,0,8,8,34,48,1748
19472,19472,970C5B25507CD6DAD2276870EE5AE8B6,42531,10,13,3,31,45,1595
19473,19473,970C5B25507CD6DAD2276870EE5AE8B6,11875,14,17,3,30,46,1546
19474,19474,970C5B25507CD6DAD2276870EE5AE8B6,11381,20,22,2,30,47,1547
19481,19481,4BEB96C1A6F8B99181CDADEF48D75275,42501,0,6,6,28,47,1447
19482,19482,4BEB96C1A6F8B99181CDADEF48D75275,40343,6,19,13,24,49,1249
19483,19483,4BEB96C1A6F8B99181CDADEF48D75275,42501,19,23,4,28,47,1447
19484,19484,29C5C7944A565741A7D5BD5CE10D2802,11261,2,14,12,36,46,1846
19485,19485,29C5C7944A565741A7D5BD5CE10D2802,42501,15,18,3,28,47,1447
19486,19486,29C5C7944A565741A7D5BD5CE10D2802,11871,19,20,1,29,46,1496
19487,19487,363A82BAE71164A59173C26849BB9939,11001,0,1,1,42,47,2147
19488,19488,363A82BAE71164A59173C26849BB9939,13371,6,16,10,41,47,2097
19489,19489,363A82BAE71164A59173C26849BB9939,11631,18,20,2,12,49,649
19494,19494,B9018EA824B4FF258C72DC98ACC2D365,42071,2,4,2,31,49,1599
19495,19495,B9018EA824B4FF258C72DC98ACC2D365,10951,5,7,2,29,48,1498
19496,19496,B9018EA824B4FF258C72DC98ACC2D365,42071,7,10,3,31,49,1599
19497,19497,B9018EA824B4FF258C72DC98ACC2D365,10951,12,14,2,29,48,1498
19498,19498,B9018EA824B4FF258C72DC98ACC2D365,40341,16,18,2,23,49,1199
19499,19499,B9018EA824B4FF258C72DC98ACC2D365,11061,18,21,3,29,48,1498
19503,19503,A53DAA006542212C0F792E33874BF547,42801,0,8,8,40,49,2049
19504,19504,A53DAA006542212C0F792E33874BF547,42161,9,12,3,36,47,1847
19505,19505,A53DAA006542212C0F792E33874BF547,10231,13,15,2,39,49,1999
19506,19506,A53DAA006542212C0F792E33874BF547,42161,15,18,3,36,47,1847
19527,19527,7C46E639818D9018A7FC0F2856E8C040,42021,2,10,8,33,47,1697
19528,19528,7C46E639818D9018A7FC0F2856E8C040,42541,13,16,3,25,47,1297
19529,19529,7C46E639818D9018A7FC0F2856E8C040,40341,19,20,1,23,49,1199
19536,19536,FE72309A49FBEB6B76C0E42028E74707,19441,6,10,4,8,46,446
19537,19537,FE72309A49FBEB6B76C0E42028E74707,42041,11,12,1,10,47,547
19538,19538,FE72309A49FBEB6B76C0E42028E74707,11571,14,18,4,13,46,696
19539,19539,FE72309A49FBEB6B76C0E42028E74707,19441,20,22,2,8,46,446
19548,19548,DFE0075BA441F09CC854C6FA18C2E9B5,11791,0,8,8,38,49,1949
19549,19549,DFE0075BA441F09CC854C6FA18C2E9B5,19741,11,15,4,5,44,294
19550,19550,DFE0075BA441F09CC854C6FA18C2E9B5,40261,18,23,5,35,49,1799
19561,19561,5ABC7476B829907717164C7F4D7F76B4,10681,7,8,1,30,48,1548
19562,19562,5ABC7476B829907717164C7F4D7F76B4,42291,12,16,4,29,48,1498
19563,19563,5ABC7476B829907717164C7F4D7F76B4,15261,21,22,1,39,13,1963
19568,19568,96B398BCE821D0E1508347A9D7207669,12641,0,6,6,10,43,543
19569,19569,96B398BCE821D0E1508347A9D7207669,19931,11,12,1,7,43,393
19570,19570,96B398BCE821D0E1508347A9D7207669,12641,12,14,2,10,43,543
19571,19571,96B398BCE821D0E1508347A9D7207669,19931,16,17,1,7,43,393
19572,19572,96B398BCE821D0E1508347A9D7207669,12641,19,22,3,10,43,543
19573,19573,3E98933C589157FCDDD2AEF7643E6F5D,11231,0,6,6,37,49,1899
19574,19574,3E98933C589157FCDDD2AEF7643E6F5D,10121,7,9,2,36,49,1849
19575,19575,3E98933C589157FCDDD2AEF7643E6F5D,42961,13,14,1,35,49,1799
19576,19576,3E98933C589157FCDDD2AEF7643E6F5D,11231,14,16,2,37,49,1899
19577,19577,3E98933C589157FCDDD2AEF7643E6F5D,42961,19,20,1,35,49,1799
19578,19578,51E47FDE51716EB36BE96125516194AB,11021,0,9,9,36,49,1849
19579,19579,51E47FDE51716EB36BE96125516194AB,10191,11,14,3,40,48,2048
19580,19580,51E47FDE51716EB36BE96125516194AB,11021,14,17,3,36,49,1849
19581,19581,51E47FDE51716EB36BE96125516194AB,41601,18,21,3,39,49,1999
19582,19582,C26832B26CF325B999FB991628AA9579,13651,0,8,8,30,47,1547
19583,19583,C26832B26CF325B999FB991628AA9579,12641,9,11,2,10,43,543
19584,19584,C26832B26CF325B999FB991628AA9579,13651,12,23,11,30,47,1547
19585,19585,718F9C02C6A67F792D4A34A4E958BCFE,10221,2,3,1,34,49,1749
19586,19586,718F9C02C6A67F792D4A34A4E958BCFE,10721,3,5,2,31,48,1598
19587,19587,718F9C02C6A67F792D4A34A4E958BCFE,13221,6,7,1,40,47,2047
19588,19588,718F9C02C6A67F792D4A34A4E958BCFE,13011,21,22,1,39,47,1997
19589,19589,9B49BEB65E16F10DE8E30D5D01D652E3,10811,0,8,8,38,46,1946
19590,19590,9B49BEB65E16F10DE8E30D5D01D652E3,12311,11,14,3,30,44,1544
19591,19591,9B49BEB65E16F10DE8E30D5D01D652E3,43341,16,17,1,41,46,2096
19592,19592,9B49BEB65E16F10DE8E30D5D01D652E3,10811,22,23,1,38,46,1946
19593,19593,AEA05D79C334BD115A25E3762D31015E,10251,2,8,6,35,47,1797
19594,19594,AEA05D79C334BD115A25E3762D31015E,12514,12,13,1,38,47,1947
19595,19595,AEA05D79C334BD115A25E3762D31015E,10251,16,17,1,35,47,1797
19596,19596,AEA05D79C334BD115A25E3762D31015E,40491,21,22,1,39,49,1999
19597,19597,405425CB3107629C743592DE469E38AA,42581,0,11,11,38,48,1948
19598,19598,405425CB3107629C743592DE469E38AA,11914,12,13,1,37,48,1898
19599,19599,405425CB3107629C743592DE469E38AA,42581,14,19,5,38,48,1948
19600,19600,405425CB3107629C743592DE469E38AA,11914,19,20,1,37,48,1898
19601,19601,405425CB3107629C743592DE469E38AA,42581,20,23,3,38,48,1948
19602,19602,8FFD2DF4D0D65440B473467D2E627EDF,10951,0,7,7,29,48,1498
19603,19603,8FFD2DF4D0D65440B473467D2E627EDF,10111,8,17,9,37,47,1897
19604,19604,8FFD2DF4D0D65440B473467D2E627EDF,42291,19,22,3,29,48,1498
19605,19605,7EBD3BA762C40F1F8A712F803B7D8FD3,12491,0,8,8,36,43,1843
19606,19606,7EBD3BA762C40F1F8A712F803B7D8FD3,42151,10,12,2,35,45,1795
19607,19607,7EBD3BA762C40F1F8A712F803B7D8FD3,10811,16,18,2,38,46,1946
19608,19608,7EBD3BA762C40F1F8A712F803B7D8FD3,42151,20,21,1,35,45,1795
19612,19612,8EC6592A5302140A9CA2CC55F2BCF8B9,42201,0,7,7,43,46,2196
19613,19613,8EC6592A5302140A9CA2CC55F2BCF8B9,10971,13,15,2,35,47,1797
19614,19614,8EC6592A5302140A9CA2CC55F2BCF8B9,42491,15,16,1,32,46,1646
19615,19615,8EC6592A5302140A9CA2CC55F2BCF8B9,10971,18,22,4,35,47,1797
19620,19620,63F985E28B6BF267DD5908C1767E3BF7,42151,6,8,2,35,45,1795
19621,19621,63F985E28B6BF267DD5908C1767E3BF7,11261,10,11,1,36,46,1846
19622,19622,63F985E28B6BF267DD5908C1767E3BF7,13231,12,14,2,39,46,1996
19623,19623,63F985E28B6BF267DD5908C1767E3BF7,11261,19,22,3,36,46,1846
19624,19624,0113038D97A9C8509BD9AEFD7B175D37,13461,0,6,6,39,44,1994
19625,19625,0113038D97A9C8509BD9AEFD7B175D37,11261,10,12,2,36,46,1846
19626,19626,0113038D97A9C8509BD9AEFD7B175D37,42861,14,17,3,37,44,1894
19627,19627,0113038D97A9C8509BD9AEFD7B175D37,13461,20,21,1,39,44,1994
19631,19631,839E5B2416DDB60AF8D62A7EA6186138,42021,0,1,1,33,47,1697
19632,19632,839E5B2416DDB60AF8D62A7EA6186138,13601,2,3,1,34,47,1747
19633,19633,839E5B2416DDB60AF8D62A7EA6186138,42921,4,16,12,33,47,1697
19634,19634,839E5B2416DDB60AF8D62A7EA6186138,40073,18,19,1,37,48,1898
19635,19635,839E5B2416DDB60AF8D62A7EA6186138,42021,20,23,3,33,47,1697
19636,19636,062DB82DC0B3D584AB2529F1637FF6A0,41121,2,15,13,25,49,1299
19637,19637,062DB82DC0B3D584AB2529F1637FF6A0,10721,16,17,1,31,48,1598
19638,19638,062DB82DC0B3D584AB2529F1637FF6A0,10971,19,21,2,35,47,1797
19639,19639,062DB82DC0B3D584AB2529F1637FF6A0,11751,21,23,2,35,48,1798
19640,19640,DAF070E37522449552E837969D087804,10691,0,6,6,33,48,1698
19641,19641,DAF070E37522449552E837969D087804,40171,7,10,3,38,48,1948
19642,19642,DAF070E37522449552E837969D087804,11171,11,13,2,33,48,1698
19643,19643,DAF070E37522449552E837969D087804,10471,14,18,4,37,48,1898
19644,19644,DAF070E37522449552E837969D087804,10491,21,23,2,33,48,1698
19645,19645,9729155B675B7267A904B856BBB5B811,11801,1,7,6,42,48,2148
19646,19646,9729155B675B7267A904B856BBB5B811,41101,8,13,5,32,48,1648
19647,19647,9729155B675B7267A904B856BBB5B811,11641,15,18,3,22,49,1149
19648,19648,9729155B675B7267A904B856BBB5B811,11801,22,23,1,42,48,2148
19649,19649,307972374222EEAFB07F9DAB83700C3B,10161,0,12,12,35,49,1799
19650,19650,307972374222EEAFB07F9DAB83700C3B,40341,13,18,5,23,49,1199
19651,19651,307972374222EEAFB07F9DAB83700C3B,10161,20,23,3,35,49,1799
19655,19655,A2204D3110D31C0CBA540B6D43FCB5C6,12661,0,8,8,32,45,1645
19656,19656,A2204D3110D31C0CBA540B6D43FCB5C6,42151,8,9,1,35,45,1795
19657,19657,A2204D3110D31C0CBA540B6D43FCB5C6,12661,10,14,4,32,45,1645
19658,19658,A2204D3110D31C0CBA540B6D43FCB5C6,42511,16,17,1,37,47,1897
19659,19659,A2204D3110D31C0CBA540B6D43FCB5C6,12661,19,20,1,32,45,1645
19660,19660,C7DA09D84BB6D5A3ABEAD976C8C0731E,42861,0,5,5,37,44,1894
19661,19661,C7DA09D84BB6D5A3ABEAD976C8C0731E,11261,7,10,3,36,46,1846
19662,19662,C7DA09D84BB6D5A3ABEAD976C8C0731E,42861,11,13,2,37,44,1894
19663,19663,C7DA09D84BB6D5A3ABEAD976C8C0731E,11261,16,17,1,36,46,1846
19664,19664,C7DA09D84BB6D5A3ABEAD976C8C0731E,42861,19,23,4,37,44,1894
19682,19682,2A8CA6F11C450B23235B353369F9B4CE,42221,3,8,5,38,48,1948
19683,19683,2A8CA6F11C450B23235B353369F9B4CE,11914,11,15,4,37,48,1898
19684,19684,2A8CA6F11C450B23235B353369F9B4CE,40341,17,22,5,23,49,1199
19685,19685,DE562E077213566DA78895C5D4449486,10411,0,8,8,36,48,1848
19686,19686,DE562E077213566DA78895C5D4449486,49201,10,12,2,7,41,391
19687,19687,DE562E077213566DA78895C5D4449486,12921,13,17,4,9,41,491
19688,19688,DE562E077213566DA78895C5D4449486,10411,19,23,4,36,48,1848
19700,19700,5E6AB6B686A00A7ED3B8EAE75C21937D,42864,0,9,9,38,44,1944
19701,19701,5E6AB6B686A00A7ED3B8EAE75C21937D,10061,13,15,2,20,46,1046
19702,19702,5E6AB6B686A00A7ED3B8EAE75C21937D,42864,17,18,1,38,44,1944
19703,19703,8FAD0C1D7595BBC5604BC21FB1B8075D,11001,5,7,2,42,47,2147
19704,19704,8FAD0C1D7595BBC5604BC21FB1B8075D,43061,10,13,3,43,46,2196
19705,19705,8FAD0C1D7595BBC5604BC21FB1B8075D,11001,14,15,1,42,47,2147
19706,19706,8FAD0C1D7595BBC5604BC21FB1B8075D,42461,16,18,2,45,47,2297
19707,19707,8FAD0C1D7595BBC5604BC21FB1B8075D,43061,19,23,4,43,46,2196
19708,19708,3363E9F13C7F276A0289EFBC903B46B1,10921,0,8,8,43,48,2198
19709,19709,3363E9F13C7F276A0289EFBC903B46B1,42401,11,16,5,36,47,1847
19710,19710,3363E9F13C7F276A0289EFBC903B46B1,10921,16,23,7,43,48,2198
19711,19711,E2C4795BF86D8DDF54D3618A77485523,42161,0,16,16,36,47,1847
19712,19712,E2C4795BF86D8DDF54D3618A77485523,10111,18,19,1,37,47,1897
19713,19713,E2C4795BF86D8DDF54D3618A77485523,40341,21,22,1,23,49,1199
19714,19714,D03724912A29E1C2014EFB85035996BD,12971,0,2,2,32,48,1648
19715,19715,D03724912A29E1C2014EFB85035996BD,11801,4,8,4,42,48,2148
19716,19716,D03724912A29E1C2014EFB85035996BD,12971,16,21,5,32,48,1648
19717,19717,D03724912A29E1C2014EFB85035996BD,10421,22,23,1,41,48,2098
19718,19718,E5492E07A4862AD700B0EAC8DC132879,42121,10,11,1,26,49,1349
19719,19719,E5492E07A4862AD700B0EAC8DC132879,42623,12,14,2,22,49,1149
19720,19720,E5492E07A4862AD700B0EAC8DC132879,40094,18,19,1,29,48,1498
19721,19721,E5492E07A4862AD700B0EAC8DC132879,10381,20,23,3,31,49,1599
19735,19735,78520B675436202D640A52F7BAC3D2C7,12792,0,16,16,34,30,1730
19736,19736,78520B675436202D640A52F7BAC3D2C7,15391,17,19,2,35,26,1776
19737,19737,78520B675436202D640A52F7BAC3D2C7,12792,20,21,1,34,30,1730
19738,19738,C2875B036EF11350C84A956D5F7E5E6B,11061,0,1,1,29,48,1498
19739,19739,C2875B036EF11350C84A956D5F7E5E6B,40445,1,2,1,30,48,1548
19740,19740,C2875B036EF11350C84A956D5F7E5E6B,11061,2,9,7,29,48,1498
19741,19741,C2875B036EF11350C84A956D5F7E5E6B,40445,12,15,3,30,48,1548
19742,19742,C2875B036EF11350C84A956D5F7E5E6B,11061,17,21,4,29,48,1498
19743,19743,7C6533C0224770EA8D8739703C562233,42471,6,7,1,35,49,1799
19744,19744,7C6533C0224770EA8D8739703C562233,10716,12,14,2,30,46,1546
19745,19745,7C6533C0224770EA8D8739703C562233,10292,14,23,9,30,47,1547
19752,19752,0DD480B5A13E261C7A404CA1C7C938C6,42511,0,7,7,37,47,1897
19753,19753,0DD480B5A13E261C7A404CA1C7C938C6,13121,8,9,1,38,46,1946
19754,19754,0DD480B5A13E261C7A404CA1C7C938C6,42511,10,11,1,37,47,1897
19755,19755,0DD480B5A13E261C7A404CA1C7C938C6,13121,12,15,3,38,46,1946
19756,19756,0DD480B5A13E261C7A404CA1C7C938C6,41382,17,19,2,38,49,1949
19757,19757,0DD480B5A13E261C7A404CA1C7C938C6,13121,20,23,3,38,46,1946
19764,19764,6657340E3E8EAFBE8630D734C7DFAA0A,19741,1,8,7,5,44,294
19765,19765,6657340E3E8EAFBE8630D734C7DFAA0A,43021,9,10,1,16,43,843
19766,19766,6657340E3E8EAFBE8630D734C7DFAA0A,19021,15,19,4,10,45,545
19767,19767,50654F68D94497D10A1C2B9ADDEB1DF4,11551,1,8,7,39,49,1999
19768,19768,50654F68D94497D10A1C2B9ADDEB1DF4,12381,8,14,6,32,48,1648
19769,19769,50654F68D94497D10A1C2B9ADDEB1DF4,10161,15,17,2,35,49,1799
19770,19770,50654F68D94497D10A1C2B9ADDEB1DF4,11771,19,23,4,39,49,1999
19771,19771,E311A49FD79CE1E67702DBA9B7887B92,19021,6,9,3,10,45,545
19772,19772,E311A49FD79CE1E67702DBA9B7887B92,43021,9,11,2,16,43,843
19773,19773,E311A49FD79CE1E67702DBA9B7887B92,19021,13,18,5,10,45,545
19774,19774,E311A49FD79CE1E67702DBA9B7887B92,12641,18,22,4,10,43,543
19778,19778,8D42F7A960FB88E9FFF2D5AE3D7495A7,12581,10,15,5,24,48,1248
19779,19779,8D42F7A960FB88E9FFF2D5AE3D7495A7,11361,15,17,2,22,48,1148
19780,19780,8D42F7A960FB88E9FFF2D5AE3D7495A7,12051,20,21,1,20,47,1047
19781,19781,93789CDBB122DA3904CEB9B349C66F76,42491,0,7,7,32,46,1646
19782,19782,93789CDBB122DA3904CEB9B349C66F76,11201,8,14,6,35,49,1799
19783,19783,93789CDBB122DA3904CEB9B349C66F76,16211,17,23,6,4,3,203
19791,19791,65161D8F8A2EE0E4F87D9472311EE576,12514,0,3,3,38,47,1947
19792,19792,65161D8F8A2EE0E4F87D9472311EE576,10841,3,5,2,37,47,1897
19793,19793,65161D8F8A2EE0E4F87D9472311EE576,10271,5,7,2,37,46,1896
19794,19794,65161D8F8A2EE0E4F87D9472311EE576,10841,7,11,4,37,47,1897
19795,19795,65161D8F8A2EE0E4F87D9472311EE576,12514,12,15,3,38,47,1947
19796,19796,65161D8F8A2EE0E4F87D9472311EE576,10841,18,20,2,37,47,1897
19797,19797,BC26B55CAB9087496A5FB61484951E63,10881,0,7,7,34,48,1748
19798,19798,BC26B55CAB9087496A5FB61484951E63,19441,9,17,8,8,46,446
19799,19799,BC26B55CAB9087496A5FB61484951E63,11271,20,21,1,37,48,1898
19810,19810,9CAF9D4766C52431BBA0063BD723C357,13101,0,7,7,40,47,2047
19811,19811,9CAF9D4766C52431BBA0063BD723C357,13271,9,10,1,41,47,2097
19812,19812,9CAF9D4766C52431BBA0063BD723C357,13101,14,17,3,40,47,2047
19813,19813,9CAF9D4766C52431BBA0063BD723C357,40341,19,21,2,23,49,1199
19814,19814,ED65A300DD773DDAFD8EC00698F31A3B,42121,0,8,8,26,49,1349
19815,19815,ED65A300DD773DDAFD8EC00698F31A3B,10451,8,9,1,25,48,1298
19816,19816,ED65A300DD773DDAFD8EC00698F31A3B,42121,11,12,1,26,49,1349
19817,19817,ED65A300DD773DDAFD8EC00698F31A3B,10451,14,16,2,25,48,1298
19818,19818,ED65A300DD773DDAFD8EC00698F31A3B,42121,17,18,1,26,49,1349
19819,19819,D246B107853B0F4D941EBF1F8081E653,11331,0,13,13,37,48,1898
19820,19820,D246B107853B0F4D941EBF1F8081E653,43161,13,16,3,35,47,1797
19821,19821,D246B107853B0F4D941EBF1F8081E653,11861,17,18,1,32,47,1647
19822,19822,6C7DE4B4696563CBDA9D3C6E4FCAB652,10341,0,7,7,31,47,1597
19823,19823,6C7DE4B4696563CBDA9D3C6E4FCAB652,10292,8,11,3,30,47,1547
19824,19824,6C7DE4B4696563CBDA9D3C6E4FCAB652,42523,12,13,1,31,47,1597
19825,19825,6C7DE4B4696563CBDA9D3C6E4FCAB652,10292,14,18,4,30,47,1547
19826,19826,6C7DE4B4696563CBDA9D3C6E4FCAB652,43731,19,21,2,34,47,1747
19827,19827,6C7DE4B4696563CBDA9D3C6E4FCAB652,10341,21,23,2,31,47,1597
19832,19832,B2E1A9593E19D988BDD0EE32D9CE9188,13311,0,5,5,27,39,1389
19833,19833,B2E1A9593E19D988BDD0EE32D9CE9188,12601,9,12,3,25,47,1297
19834,19834,B2E1A9593E19D988BDD0EE32D9CE9188,13311,16,18,2,27,39,1389
19835,19835,B2E1A9593E19D988BDD0EE32D9CE9188,10841,21,23,2,37,47,1897
19836,19836,C2E86EFC64EB6193632DD1776BAD5A6A,12971,0,8,8,32,48,1648
19837,19837,C2E86EFC64EB6193632DD1776BAD5A6A,42981,11,12,1,36,49,1849
19838,19838,C2E86EFC64EB6193632DD1776BAD5A6A,11954,16,23,7,32,49,1649
19852,19852,EB07CB83E88B0CE975FB2A96C1DB7FCF,10681,0,8,8,30,48,1548
19853,19853,EB07CB83E88B0CE975FB2A96C1DB7FCF,42161,10,12,2,36,47,1847
19854,19854,EB07CB83E88B0CE975FB2A96C1DB7FCF,11061,13,16,3,29,48,1498
19855,19855,EB07CB83E88B0CE975FB2A96C1DB7FCF,40341,17,18,1,23,49,1199
19856,19856,EB07CB83E88B0CE975FB2A96C1DB7FCF,40441,20,23,3,30,48,1548
19860,19860,C6FF0C0C1DEE38711679574CEC9C3876,42501,1,8,7,28,47,1447
19861,19861,C6FF0C0C1DEE38711679574CEC9C3876,10634,11,12,1,27,45,1395
19862,19862,C6FF0C0C1DEE38711679574CEC9C3876,10351,12,17,5,28,45,1445
19863,19863,C6FF0C0C1DEE38711679574CEC9C3876,11381,17,18,1,30,47,1547
19864,19864,C6FF0C0C1DEE38711679574CEC9C3876,42501,19,22,3,28,47,1447
19865,19865,CA7675D4504FF649E5D3C79C1D770D57,10901,0,13,13,35,48,1798
19866,19866,CA7675D4504FF649E5D3C79C1D770D57,11151,14,15,1,30,48,1548
19867,19867,CA7675D4504FF649E5D3C79C1D770D57,10901,19,23,4,35,48,1798
19868,19868,9E0BC029EC05D2AAE89376F962A1E2ED,11324,3,8,5,31,46,1596
19869,19869,9E0BC029EC05D2AAE89376F962A1E2ED,12601,9,11,2,25,47,1297
19870,19870,9E0BC029EC05D2AAE89376F962A1E2ED,42523,15,17,2,31,47,1597
19871,19871,9E0BC029EC05D2AAE89376F962A1E2ED,11324,19,23,4,31,46,1596
19872,19872,A447A45B90D6E3A14CAE8CC78AAACCC0,11701,0,7,7,43,48,2198
19873,19873,A447A45B90D6E3A14CAE8CC78AAACCC0,19021,9,14,5,10,45,545
19874,19874,A447A45B90D6E3A14CAE8CC78AAACCC0,42091,18,20,2,43,46,2196
19875,19875,A447A45B90D6E3A14CAE8CC78AAACCC0,11701,21,23,2,43,48,2198
19879,19879,2F380CE2E674806561EC26C449F15D1B,41393,0,14,14,43,49,2199
19880,19880,2F380CE2E674806561EC26C449F15D1B,10431,16,17,1,33,49,1699
19881,19881,2F380CE2E674806561EC26C449F15D1B,40271,18,20,2,35,49,1799
19882,19882,2F380CE2E674806561EC26C449F15D1B,10107,21,22,1,38,49,1949
19883,19883,A60E51B2BB36D63F6E34260285BCBDB6,42531,0,1,1,31,45,1595
19884,19884,A60E51B2BB36D63F6E34260285BCBDB6,12661,3,6,3,32,45,1645
19885,19885,A60E51B2BB36D63F6E34260285BCBDB6,12311,7,8,1,30,44,1544
19886,19886,A60E51B2BB36D63F6E34260285BCBDB6,42531,14,18,4,31,45,1595
19887,19887,A60E51B2BB36D63F6E34260285BCBDB6,12661,18,20,2,32,45,1645
19897,19897,EC861FE21AFD755213652562865FFBF9,43951,0,1,1,49,41,2491
19898,19898,EC861FE21AFD755213652562865FFBF9,43101,2,7,5,46,40,2340
19899,19899,EC861FE21AFD755213652562865FFBF9,13071,9,11,2,41,41,2091
19900,19900,EC861FE21AFD755213652562865FFBF9,43101,15,17,2,46,40,2340
19901,19901,EC861FE21AFD755213652562865FFBF9,13071,19,22,3,41,41,2091
19917,19917,79AB37E4BA910BB73519FC84F2A35B1A,43021,0,5,5,16,43,843
19918,19918,79AB37E4BA910BB73519FC84F2A35B1A,12641,7,17,10,10,43,543
19919,19919,79AB37E4BA910BB73519FC84F2A35B1A,12921,18,19,1,9,41,491
19928,19928,3E2728364EE0F8914C7020C6A1917CB0,10251,1,7,6,35,47,1797
19929,19929,3E2728364EE0F8914C7020C6A1917CB0,12601,8,9,1,25,47,1297
19930,19930,3E2728364EE0F8914C7020C6A1917CB0,42161,13,15,2,36,47,1847
19931,19931,3E2728364EE0F8914C7020C6A1917CB0,10251,15,18,3,35,47,1797
19932,19932,3E2728364EE0F8914C7020C6A1917CB0,11791,20,23,3,38,49,1949
19933,19933,5E020EB6BDF7543069C6DD3EF85E9818,42941,2,11,9,37,47,1897
19934,19934,5E020EB6BDF7543069C6DD3EF85E9818,11861,13,14,1,32,47,1647
19935,19935,5E020EB6BDF7543069C6DD3EF85E9818,10111,17,18,1,37,47,1897
19936,19936,99A7BBA810AFB486FC2F55B62A3B4005,11074,0,6,6,37,47,1897
19937,19937,99A7BBA810AFB486FC2F55B62A3B4005,42281,7,16,9,40,48,2048
19938,19938,99A7BBA810AFB486FC2F55B62A3B4005,10421,16,18,2,41,48,2098
19939,19939,99A7BBA810AFB486FC2F55B62A3B4005,11074,21,23,2,37,47,1897
19940,19940,C5BE39F043AAB34786E4C31AB48CACA0,43751,0,2,2,19,48,998
19941,19941,C5BE39F043AAB34786E4C31AB48CACA0,12051,2,16,14,20,47,1047
19942,19942,C5BE39F043AAB34786E4C31AB48CACA0,43751,16,18,2,19,48,998
19943,19943,C5BE39F043AAB34786E4C31AB48CACA0,42691,20,22,2,24,48,1248
19944,19944,8ACC50A8C55036CCB5F5CED9121C61C8,15191,0,1,1,36,27,1827
19945,19945,8ACC50A8C55036CCB5F5CED9121C61C8,12792,1,4,3,34,30,1730
19946,19946,8ACC50A8C55036CCB5F5CED9121C61C8,15191,7,15,8,36,27,1827
19947,19947,8ACC50A8C55036CCB5F5CED9121C61C8,12792,19,20,1,34,30,1730
19951,19951,E83888D24F9B489390D1BDDD69FB71BE,42861,0,14,14,37,44,1894
19952,19952,E83888D24F9B489390D1BDDD69FB71BE,11261,14,16,2,36,46,1846
19953,19953,E83888D24F9B489390D1BDDD69FB71BE,42371,19,20,1,34,46,1746
19954,19954,E83888D24F9B489390D1BDDD69FB71BE,12561,21,22,1,45,43,2293
19958,19958,3ED67593C3E8D3414A11B30830CB9FC5,11791,0,7,7,38,49,1949
19959,19959,3ED67593C3E8D3414A11B30830CB9FC5,13091,9,12,3,20,42,1042
19960,19960,3ED67593C3E8D3414A11B30830CB9FC5,11791,13,15,2,38,49,1949
19961,19961,3ED67593C3E8D3414A11B30830CB9FC5,40341,17,19,2,23,49,1199
19962,19962,3ED67593C3E8D3414A11B30830CB9FC5,11781,20,23,3,38,49,1949
19963,19963,3F0BC94142F99C8A0613C02F5CC52CE1,19441,0,6,6,8,46,446
19964,19964,3F0BC94142F99C8A0613C02F5CC52CE1,19111,9,12,3,9,45,495
19965,19965,3F0BC94142F99C8A0613C02F5CC52CE1,40341,12,16,4,23,49,1199
19966,19966,3F0BC94142F99C8A0613C02F5CC52CE1,19024,21,23,2,9,45,495
19973,19973,96452439FA8965CAF4B8DE42BC3B7A33,12971,1,14,13,32,48,1648
19974,19974,96452439FA8965CAF4B8DE42BC3B7A33,11331,15,17,2,37,48,1898
19975,19975,96452439FA8965CAF4B8DE42BC3B7A33,40925,18,20,2,35,49,1799
19976,19976,E5C174D2FF195FD116006ADE577A953D,11061,0,6,6,29,48,1498
19977,19977,E5C174D2FF195FD116006ADE577A953D,11151,8,10,2,30,48,1548
19978,19978,E5C174D2FF195FD116006ADE577A953D,11061,11,13,2,29,48,1498
19979,19979,E5C174D2FF195FD116006ADE577A953D,11151,17,19,2,30,48,1548
19980,19980,E5C174D2FF195FD116006ADE577A953D,11061,22,23,1,29,48,1498
19981,19981,F075803A6C36A9D2864358E78F8DF986,15051,0,6,6,19,4,954
19982,19982,F075803A6C36A9D2864358E78F8DF986,16281,7,17,10,11,4,554
19983,19983,F075803A6C36A9D2864358E78F8DF986,15051,17,23,6,19,4,954
19987,19987,81946AFE1D298F3B40176C804AE3EF84,19801,0,11,11,19,26,976
19988,19988,81946AFE1D298F3B40176C804AE3EF84,43121,11,14,3,25,27,1277
19989,19989,81946AFE1D298F3B40176C804AE3EF84,19801,17,21,4,19,26,976
19993,19993,AAEC3A86A83EFAC2B6654D9C63C7AC8F,10381,8,14,6,31,49,1599
19994,19994,AAEC3A86A83EFAC2B6654D9C63C7AC8F,10951,14,15,1,29,48,1498
19995,19995,AAEC3A86A83EFAC2B6654D9C63C7AC8F,40341,16,18,2,23,49,1199
19996,19996,AAEC3A86A83EFAC2B6654D9C63C7AC8F,40094,18,20,2,29,48,1498
20000,20000,9CBF9B7BBDA02761C2FCA54EEB069B75,40801,2,10,8,43,46,2196
20001,20001,9CBF9B7BBDA02761C2FCA54EEB069B75,42321,15,16,1,43,47,2197
20002,20002,9CBF9B7BBDA02761C2FCA54EEB069B75,11201,20,22,2,35,49,1799
20003,20003,AB57CFBC7FBBD1B4F46C04046F726522,15021,9,10,1,46,18,2318
20004,20004,AB57CFBC7FBBD1B4F46C04046F726522,12881,11,18,7,47,22,2372
20005,20005,AB57CFBC7FBBD1B4F46C04046F726522,15171,21,22,1,42,21,2121
20010,20010,088A5A92ADE6A4628DA6B29AE4289C36,42521,0,6,6,31,47,1597
20011,20011,088A5A92ADE6A4628DA6B29AE4289C36,10292,11,18,7,30,47,1547
20012,20012,088A5A92ADE6A4628DA6B29AE4289C36,10107,19,20,1,38,49,1949
20013,20013,088A5A92ADE6A4628DA6B29AE4289C36,10295,21,22,1,30,47,1547
20014,20014,68ECB70298C6E4D475D968AB947DC166,12514,0,11,11,38,47,1947
20015,20015,68ECB70298C6E4D475D968AB947DC166,43451,13,15,2,37,40,1890
20016,20016,68ECB70298C6E4D475D968AB947DC166,12514,17,23,6,38,47,1947
20020,20020,44F2B5779CE4D1EE32CE48AF4EB272C9,10161,0,13,13,35,49,1799
20021,20021,44F2B5779CE4D1EE32CE48AF4EB272C9,40341,13,19,6,23,49,1199
20022,20022,44F2B5779CE4D1EE32CE48AF4EB272C9,10161,20,23,3,35,49,1799
20026,20026,613003C29F5ECB3B4F31D482E607B051,42071,0,1,1,31,49,1599
20027,20027,613003C29F5ECB3B4F31D482E607B051,42121,5,6,1,26,49,1349
20028,20028,613003C29F5ECB3B4F31D482E607B051,42071,6,19,13,31,49,1599
20032,20032,447E8976787B9D80BAD87C5D15602FDC,12921,0,5,5,9,41,491
20033,20033,447E8976787B9D80BAD87C5D15602FDC,12641,5,12,7,10,43,543
20034,20034,447E8976787B9D80BAD87C5D15602FDC,12921,17,18,1,9,41,491
20035,20035,447E8976787B9D80BAD87C5D15602FDC,12641,20,22,2,10,43,543
20036,20036,447E8976787B9D80BAD87C5D15602FDC,12921,22,23,1,9,41,491
20037,20037,D5C98D28246C767D0FFD7F7274CFF193,13314,0,7,7,31,39,1589
20038,20038,D5C98D28246C767D0FFD7F7274CFF193,12521,8,11,3,35,41,1791
20039,20039,D5C98D28246C767D0FFD7F7274CFF193,13314,12,13,1,31,39,1589
20040,20040,D5C98D28246C767D0FFD7F7274CFF193,43451,14,15,1,37,40,1890
20041,20041,D5C98D28246C767D0FFD7F7274CFF193,13314,18,23,5,31,39,1589
20042,20042,DBE824B61173F6DDC9B93492DF44D2A0,43191,0,20,20,40,49,2049
20043,20043,DBE824B61173F6DDC9B93492DF44D2A0,10731,20,21,1,33,47,1697
20044,20044,DBE824B61173F6DDC9B93492DF44D2A0,43191,22,23,1,40,49,2049
20045,20045,09803726F3C2A40BEF93389F75159E93,10281,0,7,7,33,48,1698
20046,20046,09803726F3C2A40BEF93389F75159E93,42161,8,10,2,36,47,1847
20047,20047,09803726F3C2A40BEF93389F75159E93,10281,12,13,1,33,48,1698
20048,20048,09803726F3C2A40BEF93389F75159E93,42161,16,17,1,36,47,1847
20049,20049,09803726F3C2A40BEF93389F75159E93,10281,19,23,4,33,48,1698
20053,20053,68CBF4973E612A79902148CC05F36307,40431,0,6,6,36,47,1847
20054,20054,68CBF4973E612A79902148CC05F36307,42523,10,11,1,31,47,1597
20055,20055,68CBF4973E612A79902148CC05F36307,40431,12,23,11,36,47,1847
20059,20059,0A27EAE690B1EA20001899CE496B6598,19744,2,14,12,6,43,343
20060,20060,0A27EAE690B1EA20001899CE496B6598,12921,14,19,5,9,41,491
20061,20061,0A27EAE690B1EA20001899CE496B6598,19744,20,23,3,6,43,343
20065,20065,0C3B0F465A7BDE89311DCA3821959FAE,10924,0,7,7,43,49,2199
20066,20066,0C3B0F465A7BDE89311DCA3821959FAE,11954,9,10,1,32,49,1649
20067,20067,0C3B0F465A7BDE89311DCA3821959FAE,11301,19,20,1,41,49,2099
20068,20068,0C3B0F465A7BDE89311DCA3821959FAE,10924,20,23,3,43,49,2199
20069,20069,09E699D92C1B74117CEF3FDCB9379C2B,40094,0,7,7,29,48,1498
20070,20070,09E699D92C1B74117CEF3FDCB9379C2B,40341,12,15,3,23,49,1199
20071,20071,09E699D92C1B74117CEF3FDCB9379C2B,40094,18,21,3,29,48,1498
20075,20075,92D731B11080166AE9677089A81E2175,10491,0,8,8,33,48,1698
20076,20076,92D731B11080166AE9677089A81E2175,11771,9,11,2,39,49,1999
20077,20077,92D731B11080166AE9677089A81E2175,10491,13,23,10,33,48,1698
20078,20078,27A0DD6A965A1FEA8EED4D0E73345414,19181,0,6,6,8,40,440
20079,20079,27A0DD6A965A1FEA8EED4D0E73345414,12921,6,10,4,9,41,491
20080,20080,27A0DD6A965A1FEA8EED4D0E73345414,12641,15,16,1,10,43,543
20081,20081,27A0DD6A965A1FEA8EED4D0E73345414,12921,18,20,2,9,41,491
20082,20082,6EB03DEC41F60785258F0AA9E4E23DB1,12731,1,8,7,22,40,1140
20083,20083,6EB03DEC41F60785258F0AA9E4E23DB1,12521,11,15,4,35,41,1791
20084,20084,6EB03DEC41F60785258F0AA9E4E23DB1,11281,20,21,1,27,40,1390
20088,20088,7CB7FF64BE81A0CF357C12C917AEAFB5,13071,0,3,3,41,41,2091
20089,20089,7CB7FF64BE81A0CF357C12C917AEAFB5,42381,4,18,14,39,41,1991
20090,20090,7CB7FF64BE81A0CF357C12C917AEAFB5,43451,21,23,2,37,40,1890
20094,20094,CCC9E3BFC07B5F90A220A4A2A363FD6B,42321,0,11,11,43,47,2197
20095,20095,CCC9E3BFC07B5F90A220A4A2A363FD6B,41601,13,14,1,39,49,1999
20096,20096,CCC9E3BFC07B5F90A220A4A2A363FD6B,10161,14,16,2,35,49,1799
20097,20097,CCC9E3BFC07B5F90A220A4A2A363FD6B,13951,20,22,2,47,45,2395
20101,20101,597064D826C3E01F204980F028CA1A17,42861,0,5,5,37,44,1894
20102,20102,597064D826C3E01F204980F028CA1A17,11261,8,10,2,36,46,1846
20103,20103,597064D826C3E01F204980F028CA1A17,42861,11,13,2,37,44,1894
20104,20104,597064D826C3E01F204980F028CA1A17,11074,18,20,2,37,47,1897
20105,20105,597064D826C3E01F204980F028CA1A17,42861,21,23,2,37,44,1894
20116,20116,BBCB9918D42B41DEDF16DD7F5A9BE26F,11861,0,9,9,32,47,1647
20117,20117,BBCB9918D42B41DEDF16DD7F5A9BE26F,10111,10,12,2,37,47,1897
20118,20118,BBCB9918D42B41DEDF16DD7F5A9BE26F,11911,12,16,4,37,48,1898
20119,20119,BBCB9918D42B41DEDF16DD7F5A9BE26F,11861,16,23,7,32,47,1647
20124,20124,B6496BCCE3A57C699ED33A0796C193D6,42623,0,1,1,22,49,1149
20125,20125,B6496BCCE3A57C699ED33A0796C193D6,13731,16,18,2,33,49,1699
20126,20126,B6496BCCE3A57C699ED33A0796C193D6,11951,19,21,2,31,49,1599
20127,20127,424595F1C8846A1CBAEDBFB8FB93F25B,11061,1,4,3,29,48,1498
20128,20128,424595F1C8846A1CBAEDBFB8FB93F25B,12121,7,8,1,29,47,1497
20129,20129,424595F1C8846A1CBAEDBFB8FB93F25B,42501,9,12,3,28,47,1447
20130,20130,424595F1C8846A1CBAEDBFB8FB93F25B,12121,13,16,3,29,47,1497
20131,20131,424595F1C8846A1CBAEDBFB8FB93F25B,11061,16,23,7,29,48,1498
20132,20132,69C834810CF6013D091E0B9EA99E4EF4,40637,0,2,2,36,47,1847
20133,20133,69C834810CF6013D091E0B9EA99E4EF4,40673,2,4,2,36,48,1848
20134,20134,69C834810CF6013D091E0B9EA99E4EF4,40637,4,7,3,36,47,1847
20135,20135,69C834810CF6013D091E0B9EA99E4EF4,12131,11,14,3,32,47,1647
20136,20136,69C834810CF6013D091E0B9EA99E4EF4,12641,16,18,2,10,43,543
20137,20137,69C834810CF6013D091E0B9EA99E4EF4,40637,20,23,3,36,47,1847
20138,20138,7593D7AED856FF2FC2E20D8E8570438A,10471,0,10,10,37,48,1898
20139,20139,7593D7AED856FF2FC2E20D8E8570438A,42581,15,16,1,38,48,1948
20140,20140,7593D7AED856FF2FC2E20D8E8570438A,11914,16,17,1,37,48,1898
20141,20141,7593D7AED856FF2FC2E20D8E8570438A,42581,19,20,1,38,48,1948
20142,20142,7593D7AED856FF2FC2E20D8E8570438A,10471,21,23,2,37,48,1898
20143,20143,39EB4D3A98BB31BC89AD2CF96D05916B,11021,0,13,13,36,49,1849
20144,20144,39EB4D3A98BB31BC89AD2CF96D05916B,40341,17,19,2,23,49,1199
20145,20145,39EB4D3A98BB31BC89AD2CF96D05916B,11021,19,23,4,36,49,1849
20150,20150,A5267560F8241F40BFCB325C4ADBB18D,12601,0,4,4,25,47,1297
20151,20151,A5267560F8241F40BFCB325C4ADBB18D,10634,7,16,9,27,45,1395
20152,20152,A5267560F8241F40BFCB325C4ADBB18D,12601,18,19,1,25,47,1297
20153,20153,A5267560F8241F40BFCB325C4ADBB18D,42871,20,23,3,30,45,1545
20154,20154,C7D7B8368ECFDD4E151B86392208FA63,12311,0,8,8,30,44,1544
20155,20155,C7D7B8368ECFDD4E151B86392208FA63,12521,12,14,2,35,41,1791
20156,20156,C7D7B8368ECFDD4E151B86392208FA63,12311,16,23,7,30,44,1544
20157,20157,CABDD8B2A8DF9C3C6F2F674E6DD5C884,11061,0,8,8,29,48,1498
20158,20158,CABDD8B2A8DF9C3C6F2F674E6DD5C884,11381,10,12,2,30,47,1547
20159,20159,CABDD8B2A8DF9C3C6F2F674E6DD5C884,10601,14,18,4,39,47,1997
20160,20160,CABDD8B2A8DF9C3C6F2F674E6DD5C884,11381,19,21,2,30,47,1547
20161,20161,CABDD8B2A8DF9C3C6F2F674E6DD5C884,11061,22,23,1,29,48,1498
20162,20162,2FA6B0403E72F0FA91FFC7A71FC53030,10221,0,8,8,34,49,1749
20163,20163,2FA6B0403E72F0FA91FFC7A71FC53030,10544,9,10,1,28,48,1448
20164,20164,2FA6B0403E72F0FA91FFC7A71FC53030,10221,10,23,13,34,49,1749
20171,20171,DAF636981F54B0D7B799502F718975F9,10711,0,7,7,29,46,1496
20172,20172,DAF636981F54B0D7B799502F718975F9,11231,8,10,2,37,49,1899
20173,20173,DAF636981F54B0D7B799502F718975F9,10471,10,11,1,37,48,1898
20174,20174,DAF636981F54B0D7B799502F718975F9,11231,12,15,3,37,49,1899
20175,20175,DAF636981F54B0D7B799502F718975F9,10471,16,19,3,37,48,1898
20176,20176,DAF636981F54B0D7B799502F718975F9,10711,20,23,3,29,46,1496
20180,20180,BAA5B42B25E843FF1263D61D7DD09FFB,10681,1,8,7,30,48,1548
20181,20181,BAA5B42B25E843FF1263D61D7DD09FFB,42161,9,12,3,36,47,1847
20182,20182,BAA5B42B25E843FF1263D61D7DD09FFB,10681,13,23,10,30,48,1548
20189,20189,4C6EBE1C4B2FAAFACD17B57BF7692986,42161,4,6,2,36,47,1847
20190,20190,4C6EBE1C4B2FAAFACD17B57BF7692986,43731,6,7,1,34,47,1747
20191,20191,4C6EBE1C4B2FAAFACD17B57BF7692986,42161,11,12,1,36,47,1847
20192,20192,4C6EBE1C4B2FAAFACD17B57BF7692986,43731,13,18,5,34,47,1747
20193,20193,4C6EBE1C4B2FAAFACD17B57BF7692986,42161,18,20,2,36,47,1847
20194,20194,78B9DCFA4CFE02297486B374939C4654,11261,0,7,7,36,46,1846
20195,20195,78B9DCFA4CFE02297486B374939C4654,13911,7,8,1,39,46,1996
20196,20196,78B9DCFA4CFE02297486B374939C4654,11261,8,14,6,36,46,1846
20197,20197,78B9DCFA4CFE02297486B374939C4654,13911,15,17,2,39,46,1996
20198,20198,78B9DCFA4CFE02297486B374939C4654,11261,17,23,6,36,46,1846
20199,20199,2AC8E4C41FCDCF53C09A83820985C782,10171,0,8,8,26,47,1347
20200,20200,2AC8E4C41FCDCF53C09A83820985C782,11381,9,11,2,30,47,1547
20201,20201,2AC8E4C41FCDCF53C09A83820985C782,42521,12,18,6,31,47,1597
20202,20202,EECEFBE8E72857E6DE1490F46F63F8B0,10431,0,1,1,33,49,1699
20203,20203,EECEFBE8E72857E6DE1490F46F63F8B0,11171,1,8,7,33,48,1698
20204,20204,EECEFBE8E72857E6DE1490F46F63F8B0,12381,10,14,4,32,48,1648
20205,20205,EECEFBE8E72857E6DE1490F46F63F8B0,42681,19,22,3,24,48,1248
20210,20210,C49A9758546D4A1E535835DF12DB9652,42491,0,1,1,32,46,1646
20211,20211,C49A9758546D4A1E535835DF12DB9652,10295,1,2,1,30,47,1547
20212,20212,C49A9758546D4A1E535835DF12DB9652,42491,3,8,5,32,46,1646
20213,20213,C49A9758546D4A1E535835DF12DB9652,10292,8,17,9,30,47,1547
20214,20214,C49A9758546D4A1E535835DF12DB9652,42491,20,23,3,32,46,1646
20215,20215,58F88D24C8D34253C1CFFF1E39E8BF81,10681,0,7,7,30,48,1548
20216,20216,58F88D24C8D34253C1CFFF1E39E8BF81,11061,9,16,7,29,48,1498
20217,20217,58F88D24C8D34253C1CFFF1E39E8BF81,43731,20,21,1,34,47,1747
20218,20218,58F88D24C8D34253C1CFFF1E39E8BF81,11061,22,23,1,29,48,1498
20219,20219,FDF3A555382668B3FCFD730AFF8664D2,11911,0,11,11,37,48,1898
20220,20220,FDF3A555382668B3FCFD730AFF8664D2,11231,11,13,2,37,49,1899
20221,20221,FDF3A555382668B3FCFD730AFF8664D2,10411,13,14,1,36,48,1848
20222,20222,FDF3A555382668B3FCFD730AFF8664D2,11231,14,17,3,37,49,1899
20223,20223,FDF3A555382668B3FCFD730AFF8664D2,10411,19,22,3,36,48,1848
20228,20228,0B31CF81CF33B732C2FDE334CC0C0EA8,42633,0,6,6,42,46,2146
20229,20229,0B31CF81CF33B732C2FDE334CC0C0EA8,13491,8,12,4,48,39,2439
20230,20230,0B31CF81CF33B732C2FDE334CC0C0EA8,10511,13,15,2,35,46,1796
20231,20231,0B31CF81CF33B732C2FDE334CC0C0EA8,42633,19,23,4,42,46,2146
20242,20242,A52680CFF3255B80F2E899094DC1E938,13951,3,7,4,47,45,2395
20243,20243,A52680CFF3255B80F2E899094DC1E938,43951,7,10,3,49,41,2491
20244,20244,A52680CFF3255B80F2E899094DC1E938,43051,12,13,1,46,45,2345
20245,20245,A52680CFF3255B80F2E899094DC1E938,43951,14,18,4,49,41,2491
20246,20246,A52680CFF3255B80F2E899094DC1E938,13951,19,23,4,47,45,2395
20247,20247,1C78870D668C804BBD342874ED35FD15,42961,0,3,3,35,49,1799
20248,20248,1C78870D668C804BBD342874ED35FD15,11231,4,6,2,37,49,1899
20249,20249,1C78870D668C804BBD342874ED35FD15,42961,6,7,1,35,49,1799
20250,20250,1C78870D668C804BBD342874ED35FD15,11231,8,10,2,37,49,1899
20251,20251,1C78870D668C804BBD342874ED35FD15,12083,11,12,1,36,49,1849
20252,20252,1C78870D668C804BBD342874ED35FD15,42961,13,19,6,35,49,1799
20253,20253,1C78870D668C804BBD342874ED35FD15,12083,22,23,1,36,49,1849
20254,20254,E3949F7D14A5EEEFE4F316FE73D3ABAC,42151,0,5,5,35,45,1795
20255,20255,E3949F7D14A5EEEFE4F316FE73D3ABAC,12311,6,10,4,30,44,1544
20256,20256,E3949F7D14A5EEEFE4F316FE73D3ABAC,42151,11,13,2,35,45,1795
20257,20257,E3949F7D14A5EEEFE4F316FE73D3ABAC,12311,14,15,1,30,44,1544
20258,20258,E3949F7D14A5EEEFE4F316FE73D3ABAC,11861,19,21,2,32,47,1647
20259,20259,C094282B525E0208A246EB62395EA9F5,10251,1,12,11,35,47,1797
20260,20260,C094282B525E0208A246EB62395EA9F5,10107,13,16,3,38,49,1949
20261,20261,C094282B525E0208A246EB62395EA9F5,10251,18,20,2,35,47,1797
20262,20262,C094282B525E0208A246EB62395EA9F5,12511,21,23,2,39,47,1997
20263,20263,0B48A85C2E63306F2732FBA1CEDC76FB,11021,0,7,7,36,49,1849
20264,20264,0B48A85C2E63306F2732FBA1CEDC76FB,42021,12,13,1,33,47,1697
20265,20265,0B48A85C2E63306F2732FBA1CEDC76FB,11021,16,23,7,36,49,1849
20270,20270,CBDF034E68463476FF7CF3BFCDC64EE8,11491,0,7,7,36,47,1847
20271,20271,CBDF034E68463476FF7CF3BFCDC64EE8,40101,8,11,3,34,49,1749
20272,20272,CBDF034E68463476FF7CF3BFCDC64EE8,42511,12,13,1,37,47,1897
20273,20273,CBDF034E68463476FF7CF3BFCDC64EE8,10221,14,17,3,34,49,1749
20274,20274,CBDF034E68463476FF7CF3BFCDC64EE8,12511,20,21,1,39,47,1997
20275,20275,CBDF034E68463476FF7CF3BFCDC64EE8,10271,21,23,2,37,46,1896
20280,20280,B33429D7A00DB66721EA07FF9AC9AB45,11861,0,9,9,32,47,1647
20281,20281,B33429D7A00DB66721EA07FF9AC9AB45,11461,12,22,10,37,49,1899
20282,20282,B33429D7A00DB66721EA07FF9AC9AB45,11861,22,23,1,32,47,1647
20286,20286,08B6161A63F0BFCCF67BFC0EA5B81E44,42621,0,6,6,24,49,1249
20287,20287,08B6161A63F0BFCCF67BFC0EA5B81E44,40341,6,10,4,23,49,1199
20288,20288,08B6161A63F0BFCCF67BFC0EA5B81E44,42621,11,13,2,24,49,1249
20289,20289,08B6161A63F0BFCCF67BFC0EA5B81E44,40341,14,21,7,23,49,1199
20290,20290,08B6161A63F0BFCCF67BFC0EA5B81E44,42621,22,23,1,24,49,1249
20291,20291,50A8D48EEDC025C19A5AA5E39B3A8340,43761,1,6,5,32,47,1647
20292,20292,50A8D48EEDC025C19A5AA5E39B3A8340,13821,9,15,6,49,45,2495
20293,20293,50A8D48EEDC025C19A5AA5E39B3A8340,11861,18,23,5,32,47,1647
20294,20294,1F6BCFEB56D245CBF5160F742055C8A2,11151,1,6,5,30,48,1548
20295,20295,1F6BCFEB56D245CBF5160F742055C8A2,10971,9,10,1,35,47,1797
20296,20296,1F6BCFEB56D245CBF5160F742055C8A2,11151,12,23,11,30,48,1548
20309,20309,FF0C11254BA355CCA708C36EE5C4353D,11381,5,7,2,30,47,1547
20310,20310,FF0C11254BA355CCA708C36EE5C4353D,11261,8,14,6,36,46,1846
20311,20311,FF0C11254BA355CCA708C36EE5C4353D,42231,15,16,1,37,46,1896
20312,20312,FF0C11254BA355CCA708C36EE5C4353D,11381,18,23,5,30,47,1547
20316,20316,EB1AC56141CA652265E84E8CE95D7080,42871,0,8,8,30,45,1545
20317,20317,EB1AC56141CA652265E84E8CE95D7080,42801,12,14,2,40,49,2049
20318,20318,EB1AC56141CA652265E84E8CE95D7080,42871,16,23,7,30,45,1545
20319,20319,E528C1BCF7730647027A4A7EFB058975,42631,0,3,3,43,45,2195
20320,20320,E528C1BCF7730647027A4A7EFB058975,13341,3,4,1,44,45,2245
20321,20321,E528C1BCF7730647027A4A7EFB058975,42631,5,7,2,43,45,2195
20322,20322,E528C1BCF7730647027A4A7EFB058975,43061,8,10,2,43,46,2196
20323,20323,E528C1BCF7730647027A4A7EFB058975,13341,11,13,2,44,45,2245
20324,20324,E528C1BCF7730647027A4A7EFB058975,43061,14,16,2,43,46,2196
20325,20325,E528C1BCF7730647027A4A7EFB058975,13341,19,20,1,44,45,2245
20329,20329,6F3F4688F888FF4011915135083334C6,12641,0,5,5,10,43,543
20330,20330,6F3F4688F888FF4011915135083334C6,19114,10,15,5,7,43,393
20331,20331,6F3F4688F888FF4011915135083334C6,12641,18,19,1,10,43,543
20332,20332,6F3F4688F888FF4011915135083334C6,19114,20,21,1,7,43,393
20333,20333,6F3F4688F888FF4011915135083334C6,12641,22,23,1,10,43,543
20337,20337,2AA2EBD5B59B2AAF33B9CF8E5CE3BCBA,19181,1,3,2,8,40,440
20338,20338,2AA2EBD5B59B2AAF33B9CF8E5CE3BCBA,12921,6,11,5,9,41,491
20339,20339,2AA2EBD5B59B2AAF33B9CF8E5CE3BCBA,19181,13,14,1,8,40,440
20340,20340,2AA2EBD5B59B2AAF33B9CF8E5CE3BCBA,12921,14,16,2,9,41,491
20341,20341,2AA2EBD5B59B2AAF33B9CF8E5CE3BCBA,19901,17,20,3,7,44,394
20342,20342,2AA2EBD5B59B2AAF33B9CF8E5CE3BCBA,19181,20,23,3,8,40,440
20343,20343,5094EF8F1C475513036C68175706D08F,42151,2,7,5,35,45,1795
20344,20344,5094EF8F1C475513036C68175706D08F,13911,10,12,2,39,46,1996
20345,20345,5094EF8F1C475513036C68175706D08F,42151,14,16,2,35,45,1795
20346,20346,5094EF8F1C475513036C68175706D08F,13911,17,19,2,39,46,1996
20347,20347,5094EF8F1C475513036C68175706D08F,12211,21,23,2,41,44,2094
20361,20361,4E00AC493B65007C5054404BE89B2262,11231,0,11,11,37,49,1899
20362,20362,4E00AC493B65007C5054404BE89B2262,11481,12,15,3,41,48,2098
20363,20363,4E00AC493B65007C5054404BE89B2262,10661,16,19,3,37,49,1899
20364,20364,C8236143E8B93D5FDE499177CF2B28F7,11381,0,5,5,30,47,1547
20365,20365,C8236143E8B93D5FDE499177CF2B28F7,12661,6,8,2,32,45,1645
20366,20366,C8236143E8B93D5FDE499177CF2B28F7,42861,11,16,5,37,44,1894
20367,20367,C8236143E8B93D5FDE499177CF2B28F7,11381,18,23,5,30,47,1547
20371,20371,0ABF15EDFCAA333ABA775777DB9BDACA,43471,1,8,7,31,49,1599
20372,20372,0ABF15EDFCAA333ABA775777DB9BDACA,43981,10,14,4,36,49,1849
20373,20373,0ABF15EDFCAA333ABA775777DB9BDACA,12971,14,16,2,32,48,1648
20374,20374,0ABF15EDFCAA333ABA775777DB9BDACA,40925,18,21,3,35,49,1799
20375,20375,0ABF15EDFCAA333ABA775777DB9BDACA,10121,21,23,2,36,49,1849
20390,20390,CE3F81446CD14A2DF1A7AFAE577526FC,11061,0,5,5,29,48,1498
20391,20391,CE3F81446CD14A2DF1A7AFAE577526FC,11381,8,10,2,30,47,1547
20392,20392,CE3F81446CD14A2DF1A7AFAE577526FC,11061,11,12,1,29,48,1498
20393,20393,CE3F81446CD14A2DF1A7AFAE577526FC,11381,12,18,6,30,47,1547
20394,20394,CE3F81446CD14A2DF1A7AFAE577526FC,11061,19,23,4,29,48,1498
20401,20401,82EFEE8C48953CCFABA92D42A14AA9D9,15391,3,5,2,35,26,1776
20402,20402,82EFEE8C48953CCFABA92D42A14AA9D9,15411,8,14,6,44,27,2227
20403,20403,82EFEE8C48953CCFABA92D42A14AA9D9,15391,14,23,9,35,26,1776
20404,20404,59553EDCBC9A31B6DCDB9C78911399CE,42161,0,6,6,36,47,1847
20405,20405,59553EDCBC9A31B6DCDB9C78911399CE,10251,7,10,3,35,47,1797
20406,20406,59553EDCBC9A31B6DCDB9C78911399CE,11431,13,19,6,29,47,1497
20407,20407,59553EDCBC9A31B6DCDB9C78911399CE,10251,21,23,2,35,47,1797
20408,20408,26E97CCAAB10F50751FB25FC2D6D6457,11261,0,2,2,36,46,1846
20409,20409,26E97CCAAB10F50751FB25FC2D6D6457,42861,6,10,4,37,44,1894
20410,20410,26E97CCAAB10F50751FB25FC2D6D6457,11261,12,15,3,36,46,1846
20411,20411,26E97CCAAB10F50751FB25FC2D6D6457,42861,15,21,6,37,44,1894
20412,20412,26E97CCAAB10F50751FB25FC2D6D6457,11261,21,22,1,36,46,1846
20413,20413,273E194878CE130DC9C04220F5068056,10841,0,6,6,37,47,1897
20414,20414,273E194878CE130DC9C04220F5068056,15653,11,12,1,40,25,2025
20415,20415,273E194878CE130DC9C04220F5068056,10661,16,17,1,37,49,1899
20416,20416,273E194878CE130DC9C04220F5068056,10251,17,19,2,35,47,1797
20421,20421,D5A1F589AD5A8A456E0D23A90489837D,43761,0,8,8,32,47,1647
20422,20422,D5A1F589AD5A8A456E0D23A90489837D,11231,8,15,7,37,49,1899
20423,20423,D5A1F589AD5A8A456E0D23A90489837D,40491,19,21,2,39,49,1999
20424,20424,4003E07D2A4AF66E84145561FFA003F3,11651,0,1,1,33,47,1697
20425,20425,4003E07D2A4AF66E84145561FFA003F3,10341,1,16,15,31,47,1597
20426,20426,4003E07D2A4AF66E84145561FFA003F3,10292,16,18,2,30,47,1547
20427,20427,4003E07D2A4AF66E84145561FFA003F3,10341,18,19,1,31,47,1597
20428,20428,4003E07D2A4AF66E84145561FFA003F3,13601,21,22,1,34,47,1747
20429,20429,891C63A7FCD795A9067DDBCBE0342E42,42231,0,8,8,37,46,1896
20430,20430,891C63A7FCD795A9067DDBCBE0342E42,40203,9,10,1,33,49,1699
20431,20431,891C63A7FCD795A9067DDBCBE0342E42,10107,11,13,2,38,49,1949
20432,20432,891C63A7FCD795A9067DDBCBE0342E42,15404,15,16,1,40,24,2024
20433,20433,891C63A7FCD795A9067DDBCBE0342E42,42231,21,23,2,37,46,1896
20438,20438,E08992EE1FDBC9EFFA9475B4ECDB7A1C,42921,1,4,3,33,47,1697
20439,20439,E08992EE1FDBC9EFFA9475B4ECDB7A1C,10634,9,12,3,27,45,1395
20440,20440,E08992EE1FDBC9EFFA9475B4ECDB7A1C,12601,13,16,3,25,47,1297
20441,20441,E08992EE1FDBC9EFFA9475B4ECDB7A1C,12131,17,22,5,32,47,1647
20445,20445,221F9C243AB84B9C492B5517A9CC71A3,42141,3,5,2,32,47,1647
20446,20446,221F9C243AB84B9C492B5517A9CC71A3,11331,7,15,8,37,48,1898
20447,20447,221F9C243AB84B9C492B5517A9CC71A3,10544,17,19,2,28,48,1448
20448,20448,221F9C243AB84B9C492B5517A9CC71A3,43761,20,21,1,32,47,1647
20449,20449,E6FF42AEECF0CDA6C42BDBDEFD456416,43051,2,9,7,46,45,2345
20450,20450,E6FF42AEECF0CDA6C42BDBDEFD456416,43951,10,16,6,49,41,2491
20451,20451,E6FF42AEECF0CDA6C42BDBDEFD456416,13951,19,23,4,47,45,2395
20455,20455,6D411464E8569334C6217011CDDAB47B,10281,0,6,6,33,48,1698
20456,20456,6D411464E8569334C6217011CDDAB47B,12641,8,12,4,10,43,543
20457,20457,6D411464E8569334C6217011CDDAB47B,19114,14,15,1,7,43,393
20458,20458,6D411464E8569334C6217011CDDAB47B,42161,20,23,3,36,47,1847
20473,20473,E748F2254AC2A75A1317C0ED54387A7E,42831,0,7,7,27,48,1398
20474,20474,E748F2254AC2A75A1317C0ED54387A7E,10381,7,10,3,31,49,1599
20475,20475,E748F2254AC2A75A1317C0ED54387A7E,42831,12,23,11,27,48,1398
20479,20479,D75859C5199E26E4E069299921FEC112,42921,1,8,7,33,47,1697
20480,20480,D75859C5199E26E4E069299921FEC112,10251,10,11,1,35,47,1797
20481,20481,D75859C5199E26E4E069299921FEC112,43761,12,15,3,32,47,1647
20482,20482,D75859C5199E26E4E069299921FEC112,42021,19,20,1,33,47,1697
20483,20483,D75859C5199E26E4E069299921FEC112,43761,20,22,2,32,47,1647
20484,20484,FDA9D6C3558498784AFFBE22F15784BA,10491,0,8,8,33,48,1698
20485,20485,FDA9D6C3558498784AFFBE22F15784BA,13791,10,11,1,42,47,2147
20486,20486,FDA9D6C3558498784AFFBE22F15784BA,42461,13,15,2,45,47,2297
20487,20487,FDA9D6C3558498784AFFBE22F15784BA,12031,19,22,3,33,48,1698
20488,20488,44AA91905A7E8DBC24B0A51CC88C9204,42151,1,13,12,35,45,1795
20489,20489,44AA91905A7E8DBC24B0A51CC88C9204,12311,13,16,3,30,44,1544
20490,20490,44AA91905A7E8DBC24B0A51CC88C9204,42151,18,23,5,35,45,1795
20491,20491,E40FF661B4F3DA89AB28D734DF463F41,19021,0,5,5,10,45,545
20492,20492,E40FF661B4F3DA89AB28D734DF463F41,12921,6,17,11,9,41,491
20493,20493,E40FF661B4F3DA89AB28D734DF463F41,11151,17,18,1,30,48,1548
20500,20500,C783F573219BE815B78681C436E8AC03,11871,0,7,7,29,46,1496
20501,20501,C783F573219BE815B78681C436E8AC03,10501,8,10,2,22,46,1146
20502,20502,C783F573219BE815B78681C436E8AC03,12601,10,14,4,25,47,1297
20503,20503,C783F573219BE815B78681C436E8AC03,11871,16,19,3,29,46,1496
20504,20504,3809DF865AE1A6DDD760F4685D4EB08C,11631,6,13,7,12,49,649
20505,20505,3809DF865AE1A6DDD760F4685D4EB08C,12641,15,17,2,10,43,543
20506,20506,3809DF865AE1A6DDD760F4685D4EB08C,49201,18,19,1,7,41,391
20507,20507,846BF5BBBFB90AB741897297FC805D01,42631,0,7,7,43,45,2195
20508,20508,846BF5BBBFB90AB741897297FC805D01,42633,8,9,1,42,46,2146
20509,20509,846BF5BBBFB90AB741897297FC805D01,42461,13,15,2,45,47,2297
20510,20510,846BF5BBBFB90AB741897297FC805D01,42633,16,18,2,42,46,2146
20511,20511,846BF5BBBFB90AB741897297FC805D01,42631,19,21,2,43,45,2195
20512,20512,846BF5BBBFB90AB741897297FC805D01,42633,21,22,1,42,46,2146
20513,20513,6C0E943C8B3CE3071E466B3888DE833C,42531,7,8,1,31,45,1595
20514,20514,6C0E943C8B3CE3071E466B3888DE833C,12311,12,13,1,30,44,1544
20515,20515,6C0E943C8B3CE3071E466B3888DE833C,42531,15,18,3,31,45,1595
20516,20516,6C0E943C8B3CE3071E466B3888DE833C,19744,19,21,2,6,43,343
20523,20523,EA7259828C59286A0C8476F89AAE54B8,11261,3,8,5,36,46,1846
20524,20524,EA7259828C59286A0C8476F89AAE54B8,42351,8,9,1,38,45,1945
20525,20525,EA7259828C59286A0C8476F89AAE54B8,11261,10,21,11,36,46,1846
20526,20526,EA7259828C59286A0C8476F89AAE54B8,42351,21,22,1,38,45,1945
20527,20527,EA7259828C59286A0C8476F89AAE54B8,11261,22,23,1,36,46,1846
20528,20528,6B301C33659FC7DDF1FEBEFD22E1FEA8,42931,0,9,9,41,49,2099
20529,20529,6B301C33659FC7DDF1FEBEFD22E1FEA8,43761,11,20,9,32,47,1647
20530,20530,6B301C33659FC7DDF1FEBEFD22E1FEA8,42021,21,22,1,33,47,1697
20538,20538,62FC933E25D26B5E42DD5C2C2597D1C7,12121,2,10,8,29,47,1497
20539,20539,62FC933E25D26B5E42DD5C2C2597D1C7,13671,13,14,1,27,43,1393
20540,20540,62FC933E25D26B5E42DD5C2C2597D1C7,11061,18,23,5,29,48,1498
20541,20541,74EBB90FA1C414F58477B49370E7F73F,11861,0,4,4,32,47,1647
20542,20542,74EBB90FA1C414F58477B49370E7F73F,10281,5,6,1,33,48,1698
20543,20543,74EBB90FA1C414F58477B49370E7F73F,12311,7,17,10,30,44,1544
20544,20544,74EBB90FA1C414F58477B49370E7F73F,11861,18,23,5,32,47,1647
20548,20548,F19EB67B80E918E14D885286800F46C3,11381,0,11,11,30,47,1547
20549,20549,F19EB67B80E918E14D885286800F46C3,40341,12,13,1,23,49,1199
20550,20550,F19EB67B80E918E14D885286800F46C3,11381,16,23,7,30,47,1547
20551,20551,E6EB0FFE7655FB9A9B77EC908104A8C3,11381,0,15,15,30,47,1547
20552,20552,E6EB0FFE7655FB9A9B77EC908104A8C3,11211,16,17,1,34,49,1749
20553,20553,E6EB0FFE7655FB9A9B77EC908104A8C3,11381,18,23,5,30,47,1547
20554,20554,2881834474B021D3CB48D66D6B38B4E5,11921,0,6,6,38,48,1948
20555,20555,2881834474B021D3CB48D66D6B38B4E5,42523,7,8,1,31,47,1597
20556,20556,2881834474B021D3CB48D66D6B38B4E5,12131,8,10,2,32,47,1647
20557,20557,2881834474B021D3CB48D66D6B38B4E5,42523,10,14,4,31,47,1597
20558,20558,2881834474B021D3CB48D66D6B38B4E5,11921,18,23,5,38,48,1948
20559,20559,5B8CBEACCD78B1DC2D333EF70A4C155C,42521,0,5,5,31,47,1597
20560,20560,5B8CBEACCD78B1DC2D333EF70A4C155C,13651,6,8,2,30,47,1547
20561,20561,5B8CBEACCD78B1DC2D333EF70A4C155C,42521,10,16,6,31,47,1597
20562,20562,5B8CBEACCD78B1DC2D333EF70A4C155C,11381,16,17,1,30,47,1547
20563,20563,5B8CBEACCD78B1DC2D333EF70A4C155C,42521,19,23,4,31,47,1597
20570,20570,1A6A180FC1652CDA8F079E8572A81E38,42501,1,7,6,28,47,1447
20571,20571,1A6A180FC1652CDA8F079E8572A81E38,11231,8,17,9,37,49,1899
20572,20572,1A6A180FC1652CDA8F079E8572A81E38,42501,18,19,1,28,47,1447
20573,20573,1A6A180FC1652CDA8F079E8572A81E38,12121,20,23,3,29,47,1497
20581,20581,37C29D4674FBC06EF76342F2283F4E15,42031,0,6,6,40,46,2046
20582,20582,37C29D4674FBC06EF76342F2283F4E15,13671,9,12,3,27,43,1393
20583,20583,37C29D4674FBC06EF76342F2283F4E15,12971,15,16,1,32,48,1648
20584,20584,37C29D4674FBC06EF76342F2283F4E15,11781,19,23,4,38,49,1949
20605,20605,4E22CAE8774A9F064D48507CF8FECB20,11901,0,6,6,42,49,2149
20606,20606,4E22CAE8774A9F064D48507CF8FECB20,42271,8,9,1,40,47,2047
20607,20607,4E22CAE8774A9F064D48507CF8FECB20,11901,12,13,1,42,49,2149
20608,20608,4E22CAE8774A9F064D48507CF8FECB20,43671,19,20,1,35,48,1798
20609,20609,4E22CAE8774A9F064D48507CF8FECB20,11901,21,23,2,42,49,2149
20610,20610,8C77E624D8AFCC432BD5DA6A66C68868,10381,0,14,14,31,49,1599
20611,20611,8C77E624D8AFCC432BD5DA6A66C68868,42641,17,18,1,33,49,1699
20612,20612,8C77E624D8AFCC432BD5DA6A66C68868,13561,20,21,1,37,49,1899
20613,20613,98029F333AC5519D4BA1B7A7F8079304,41721,0,7,7,39,48,1998
20614,20614,98029F333AC5519D4BA1B7A7F8079304,12971,9,12,3,32,48,1648
20615,20615,98029F333AC5519D4BA1B7A7F8079304,41721,12,13,1,39,48,1998
20616,20616,98029F333AC5519D4BA1B7A7F8079304,40343,14,18,4,24,49,1249
20617,20617,98029F333AC5519D4BA1B7A7F8079304,10221,19,21,2,34,49,1749
20618,20618,98029F333AC5519D4BA1B7A7F8079304,41721,22,23,1,39,48,1998
20622,20622,DA0E697AE4448608B08E47D0D6104EB1,43951,0,13,13,49,41,2491
20623,20623,DA0E697AE4448608B08E47D0D6104EB1,12561,15,16,1,45,43,2293
20624,20624,DA0E697AE4448608B08E47D0D6104EB1,43951,17,23,6,49,41,2491
20628,20628,440A5BC995406F5A39B97937FE6675EC,19744,0,2,2,6,43,343
20629,20629,440A5BC995406F5A39B97937FE6675EC,12641,6,7,1,10,43,543
20630,20630,440A5BC995406F5A39B97937FE6675EC,19744,8,9,1,6,43,343
20631,20631,440A5BC995406F5A39B97937FE6675EC,12641,12,13,1,10,43,543
20632,20632,440A5BC995406F5A39B97937FE6675EC,19744,14,19,5,6,43,343
20640,20640,86F6E7160B731084AE86635A509FA6B8,10681,0,15,15,30,48,1548
20641,20641,86F6E7160B731084AE86635A509FA6B8,10411,16,18,2,36,48,1848
20642,20642,86F6E7160B731084AE86635A509FA6B8,10681,20,22,2,30,48,1548
20643,20643,1A1DDE162A7A24F8ACBD57961D6CC9F9,42141,0,12,12,32,47,1647
20644,20644,1A1DDE162A7A24F8ACBD57961D6CC9F9,40341,13,15,2,23,49,1199
20645,20645,1A1DDE162A7A24F8ACBD57961D6CC9F9,43761,16,23,7,32,47,1647
20646,20646,71AB304A084EB4095E1F705C48CB0E23,11901,0,7,7,42,49,2149
20647,20647,71AB304A084EB4095E1F705C48CB0E23,11914,8,11,3,37,48,1898
20648,20648,71AB304A084EB4095E1F705C48CB0E23,42581,11,13,2,38,48,1948
20649,20649,71AB304A084EB4095E1F705C48CB0E23,11914,14,15,1,37,48,1898
20650,20650,71AB304A084EB4095E1F705C48CB0E23,11901,20,23,3,42,49,2149
20651,20651,0D4E5CAACBFE6D00674B26CEDD653432,42623,10,12,2,22,49,1149
20652,20652,0D4E5CAACBFE6D00674B26CEDD653432,42071,12,14,2,31,49,1599
20653,20653,0D4E5CAACBFE6D00674B26CEDD653432,11061,19,20,1,29,48,1498
20654,20654,B9E927B8C825AF1AC2891B310330CB7E,13121,0,6,6,38,46,1946
20655,20655,B9E927B8C825AF1AC2891B310330CB7E,42011,6,8,2,36,46,1846
20656,20656,B9E927B8C825AF1AC2891B310330CB7E,13511,15,17,2,34,48,1748
20657,20657,B9E927B8C825AF1AC2891B310330CB7E,10107,18,20,2,38,49,1949
20658,20658,963D3FC841F63E14E513E0B8C4C21628,13121,0,5,5,38,46,1946
20659,20659,963D3FC841F63E14E513E0B8C4C21628,12521,7,10,3,35,41,1791
20660,20660,963D3FC841F63E14E513E0B8C4C21628,12491,15,16,1,36,43,1843
20661,20661,963D3FC841F63E14E513E0B8C4C21628,42861,18,19,1,37,44,1894
20680,20680,697EB06F67653D08CFE9378AC3AAB5E4,11001,1,10,9,42,47,2147
20681,20681,697EB06F67653D08CFE9378AC3AAB5E4,13941,11,12,1,41,47,2097
20682,20682,697EB06F67653D08CFE9378AC3AAB5E4,11001,12,14,2,42,47,2147
20683,20683,697EB06F67653D08CFE9378AC3AAB5E4,13941,15,19,4,41,47,2097
20684,20684,697EB06F67653D08CFE9378AC3AAB5E4,11001,20,23,3,42,47,2147
20692,20692,D1D02DF9C1212407C948C37939001BC3,13671,0,6,6,27,43,1393
20693,20693,D1D02DF9C1212407C948C37939001BC3,42531,6,8,2,31,45,1595
20694,20694,D1D02DF9C1212407C948C37939001BC3,13671,12,13,1,27,43,1393
20695,20695,D1D02DF9C1212407C948C37939001BC3,42531,16,18,2,31,45,1595
20708,20708,5601C1A44CC85C7B09354B38FD0628D1,12311,4,12,8,30,44,1544
20709,20709,5601C1A44CC85C7B09354B38FD0628D1,42501,12,13,1,28,47,1447
20710,20710,5601C1A44CC85C7B09354B38FD0628D1,12311,14,23,9,30,44,1544
20711,20711,512DE607F507A1D207A0A124977FA626,11281,0,5,5,27,40,1390
20712,20712,512DE607F507A1D207A0A124977FA626,13671,7,10,3,27,43,1393
20713,20713,512DE607F507A1D207A0A124977FA626,11281,14,15,1,27,40,1390
20714,20714,512DE607F507A1D207A0A124977FA626,13671,17,19,2,27,43,1393
20715,20715,512DE607F507A1D207A0A124977FA626,11281,19,22,3,27,40,1390
20722,20722,0EA80F49CAFA9BFC58CF0D20F7967BFF,42871,0,5,5,30,45,1545
20723,20723,0EA80F49CAFA9BFC58CF0D20F7967BFF,12311,8,9,1,30,44,1544
20724,20724,0EA80F49CAFA9BFC58CF0D20F7967BFF,42871,12,13,1,30,45,1545
20725,20725,0EA80F49CAFA9BFC58CF0D20F7967BFF,12311,15,16,1,30,44,1544
20726,20726,0EA80F49CAFA9BFC58CF0D20F7967BFF,42871,21,23,2,30,45,1545
20727,20727,C13EDA65C3B019881628338CF4BA6FEF,42491,0,8,8,32,46,1646
20728,20728,C13EDA65C3B019881628338CF4BA6FEF,42523,9,13,4,31,47,1597
20729,20729,C13EDA65C3B019881628338CF4BA6FEF,42491,14,17,3,32,46,1646
20730,20730,C13EDA65C3B019881628338CF4BA6FEF,42523,20,21,1,31,47,1597
20731,20731,C13EDA65C3B019881628338CF4BA6FEF,42491,22,23,1,32,46,1646
20735,20735,6EF69708DD923556D4EF232AA0406F1C,13911,1,6,5,39,46,1996
20736,20736,6EF69708DD923556D4EF232AA0406F1C,42231,9,13,4,37,46,1896
20737,20737,6EF69708DD923556D4EF232AA0406F1C,13911,15,16,1,39,46,1996
20738,20738,6EF69708DD923556D4EF232AA0406F1C,42231,16,18,2,37,46,1896
20739,20739,6EF69708DD923556D4EF232AA0406F1C,10841,20,21,1,37,47,1897
20740,20740,6EF69708DD923556D4EF232AA0406F1C,11941,22,23,1,37,46,1896
20741,20741,C023F913EB9B0A9F89808DF1EFA2F477,43501,9,14,5,27,48,1398
20742,20742,C023F913EB9B0A9F89808DF1EFA2F477,12561,15,16,1,45,43,2293
20743,20743,C023F913EB9B0A9F89808DF1EFA2F477,10971,19,20,1,35,47,1797
20744,20744,A0E829F4319BFCF37BA7414AFCB09FF1,11074,0,1,1,37,47,1897
20745,20745,A0E829F4319BFCF37BA7414AFCB09FF1,42221,2,3,1,38,48,1948
20746,20746,A0E829F4319BFCF37BA7414AFCB09FF1,12514,3,5,2,38,47,1947
20747,20747,A0E829F4319BFCF37BA7414AFCB09FF1,11074,5,7,2,37,47,1897
20748,20748,A0E829F4319BFCF37BA7414AFCB09FF1,42221,8,9,1,38,48,1948
20749,20749,A0E829F4319BFCF37BA7414AFCB09FF1,11074,12,13,1,37,47,1897
20750,20750,A0E829F4319BFCF37BA7414AFCB09FF1,42221,14,20,6,38,48,1948
20751,20751,A0E829F4319BFCF37BA7414AFCB09FF1,11074,21,22,1,37,47,1897
20752,20752,D3A8E24567875F3C39102478CB1D4A49,42633,0,6,6,42,46,2146
20753,20753,D3A8E24567875F3C39102478CB1D4A49,11061,6,15,9,29,48,1498
20754,20754,D3A8E24567875F3C39102478CB1D4A49,10681,16,17,1,30,48,1548
20755,20755,D3A8E24567875F3C39102478CB1D4A49,42633,18,21,3,42,46,2146
20756,20756,177168A1104485CCD77EDFA93575365C,43311,0,9,9,31,48,1598
20757,20757,177168A1104485CCD77EDFA93575365C,11161,14,18,4,32,48,1648
20758,20758,177168A1104485CCD77EDFA93575365C,41591,19,20,1,34,49,1749
20759,20759,177168A1104485CCD77EDFA93575365C,11731,21,22,1,36,48,1848
20767,20767,58DD29620A36856900D278AA525EEA23,16281,1,16,15,11,4,554
20768,20768,58DD29620A36856900D278AA525EEA23,15143,17,19,2,18,7,907
20769,20769,58DD29620A36856900D278AA525EEA23,16281,21,23,2,11,4,554
20776,20776,7DFCA2932B390D69ABC0E415A2260097,42531,0,1,1,31,45,1595
20777,20777,7DFCA2932B390D69ABC0E415A2260097,10351,4,8,4,28,45,1445
20778,20778,7DFCA2932B390D69ABC0E415A2260097,42531,8,11,3,31,45,1595
20779,20779,7DFCA2932B390D69ABC0E415A2260097,12311,16,19,3,30,44,1544
20780,20780,7DFCA2932B390D69ABC0E415A2260097,42531,22,23,1,31,45,1595
20788,20788,1DA79481C6B6D1D9223A378A0D81757A,10111,0,7,7,37,47,1897
20789,20789,1DA79481C6B6D1D9223A378A0D81757A,40882,11,17,6,34,49,1749
20790,20790,1DA79481C6B6D1D9223A378A0D81757A,10111,17,23,6,37,47,1897
20791,20791,C187943D20D187183526E0228C45660E,11021,0,8,8,36,49,1849
20792,20792,C187943D20D187183526E0228C45660E,11081,9,10,1,35,46,1796
20793,20793,C187943D20D187183526E0228C45660E,12381,14,15,1,32,48,1648
20794,20794,C187943D20D187183526E0228C45660E,11021,16,23,7,36,49,1849
20795,20795,67E463A97F2732907F7B14F7E69E6FDD,11861,0,8,8,32,47,1647
20796,20796,67E463A97F2732907F7B14F7E69E6FDD,13491,13,16,3,48,39,2439
20797,20797,67E463A97F2732907F7B14F7E69E6FDD,11861,20,23,3,32,47,1647
20819,20819,650442A22C16CE1CBE59A7C852E33483,15411,0,1,1,44,27,2227
20820,20820,650442A22C16CE1CBE59A7C852E33483,12611,2,8,6,41,29,2079
20821,20821,650442A22C16CE1CBE59A7C852E33483,15411,8,22,14,44,27,2227
20822,20822,C5ED324891B8B95E257970408E8D4150,12491,0,7,7,36,43,1843
20823,20823,C5ED324891B8B95E257970408E8D4150,13911,10,12,2,39,46,1996
20824,20824,C5ED324891B8B95E257970408E8D4150,11261,12,17,5,36,46,1846
20825,20825,C5ED324891B8B95E257970408E8D4150,12491,21,22,1,36,43,1843
20832,20832,055392723CC93B49A610878855A95D5B,11471,0,3,3,12,48,648
20833,20833,055392723CC93B49A610878855A95D5B,19441,3,5,2,8,46,446
20834,20834,055392723CC93B49A610878855A95D5B,11471,6,13,7,12,48,648
20835,20835,055392723CC93B49A610878855A95D5B,19441,13,15,2,8,46,446
20836,20836,055392723CC93B49A610878855A95D5B,42041,15,16,1,10,47,547
20837,20837,055392723CC93B49A610878855A95D5B,19441,19,23,4,8,46,446
20854,20854,FF6453120169D434065FC71F9C461009,42864,0,6,6,38,44,1944
20855,20855,FF6453120169D434065FC71F9C461009,43451,11,18,7,37,40,1890
20856,20856,FF6453120169D434065FC71F9C461009,10041,20,23,3,39,49,1999
20857,20857,951E4A9F24E81DD7E0BF78CE09FD6CB8,12792,0,2,2,34,30,1730
20858,20858,951E4A9F24E81DD7E0BF78CE09FD6CB8,15191,5,7,2,36,27,1827
20859,20859,951E4A9F24E81DD7E0BF78CE09FD6CB8,15394,8,9,1,35,26,1776
20860,20860,951E4A9F24E81DD7E0BF78CE09FD6CB8,15191,14,16,2,36,27,1827
20861,20861,951E4A9F24E81DD7E0BF78CE09FD6CB8,12611,18,20,2,41,29,2079
20871,20871,7A5DEDC7FE052035815232A8310135E2,11151,0,14,14,30,48,1548
20872,20872,7A5DEDC7FE052035815232A8310135E2,10901,17,18,1,35,48,1798
20873,20873,7A5DEDC7FE052035815232A8310135E2,11151,20,23,3,30,48,1548
20877,20877,6B614428F8D95ECFDE2207017437E97D,19281,0,10,10,16,32,832
20878,20878,6B614428F8D95ECFDE2207017437E97D,12871,10,12,2,22,33,1133
20879,20879,6B614428F8D95ECFDE2207017437E97D,19281,13,22,9,16,32,832
20880,20880,6B614428F8D95ECFDE2207017437E97D,12871,22,23,1,22,33,1133
20891,20891,E1D9DCC26BD9E70C84DC1D28D9FFAAE6,19621,0,9,9,5,46,296
20892,20892,E1D9DCC26BD9E70C84DC1D28D9FFAAE6,19114,10,11,1,7,43,393
20893,20893,E1D9DCC26BD9E70C84DC1D28D9FFAAE6,12641,12,13,1,10,43,543
20894,20894,E1D9DCC26BD9E70C84DC1D28D9FFAAE6,19621,17,20,3,5,46,296
20895,20895,E1D9DCC26BD9E70C84DC1D28D9FFAAE6,19114,21,23,2,7,43,393
20896,20896,59BAD7D0307255207187442691451EAD,13094,0,7,7,21,42,1092
20897,20897,59BAD7D0307255207187442691451EAD,13091,7,12,5,20,42,1042
20898,20898,59BAD7D0307255207187442691451EAD,13094,12,14,2,21,42,1092
20899,20899,59BAD7D0307255207187442691451EAD,13091,18,20,2,20,42,1042
20900,20900,59BAD7D0307255207187442691451EAD,13094,21,23,2,21,42,1092
20904,20904,B008950D13439AAF34B6D4BE3B059216,13651,3,10,7,30,47,1547
20905,20905,B008950D13439AAF34B6D4BE3B059216,42523,12,15,3,31,47,1597
20906,20906,B008950D13439AAF34B6D4BE3B059216,13651,17,20,3,30,47,1547
20907,20907,B008950D13439AAF34B6D4BE3B059216,42523,21,22,1,31,47,1597
20908,20908,B008950D13439AAF34B6D4BE3B059216,13651,22,23,1,30,47,1547
20909,20909,15AF53FBA0C13FBD61024895398ED2FD,42551,2,6,4,14,48,748
20910,20910,15AF53FBA0C13FBD61024895398ED2FD,19441,7,15,8,8,46,446
20911,20911,15AF53FBA0C13FBD61024895398ED2FD,42041,17,19,2,10,47,547
20912,20912,15AF53FBA0C13FBD61024895398ED2FD,11471,22,23,1,12,48,648
20913,20913,8AFA4E0A72E9BBF4EA3A6CFA24644593,11151,5,15,10,30,48,1548
20914,20914,8AFA4E0A72E9BBF4EA3A6CFA24644593,11531,17,18,1,34,49,1749
20915,20915,8AFA4E0A72E9BBF4EA3A6CFA24644593,11151,21,22,1,30,48,1548
20916,20916,917D5FCF1AE860782609B135624C2B5E,10411,0,7,7,36,48,1848
20917,20917,917D5FCF1AE860782609B135624C2B5E,19441,8,11,3,8,46,446
20918,20918,917D5FCF1AE860782609B135624C2B5E,42041,12,17,5,10,47,547
20919,20919,917D5FCF1AE860782609B135624C2B5E,10411,19,22,3,36,48,1848
20920,20920,DC15358175A492C6F21AAEFAD4CD0BB7,42401,0,8,8,36,47,1847
20921,20921,DC15358175A492C6F21AAEFAD4CD0BB7,43501,13,14,1,27,48,1398
20922,20922,DC15358175A492C6F21AAEFAD4CD0BB7,42521,15,18,3,31,47,1597
20923,20923,DC15358175A492C6F21AAEFAD4CD0BB7,42161,19,23,4,36,47,1847
20924,20924,1F586282DD0AC03725A5E548411F5D82,10841,0,3,3,37,47,1897
20925,20925,1F586282DD0AC03725A5E548411F5D82,12514,5,10,5,38,47,1947
20926,20926,1F586282DD0AC03725A5E548411F5D82,12511,14,16,2,39,47,1997
20927,20927,1F586282DD0AC03725A5E548411F5D82,12514,18,20,2,38,47,1947
20928,20928,1F586282DD0AC03725A5E548411F5D82,10841,21,23,2,37,47,1897
20929,20929,3EEFB7BDF8C8012BA246A804A35191A0,15671,0,5,5,37,26,1876
20930,20930,3EEFB7BDF8C8012BA246A804A35191A0,12611,10,12,2,41,29,2079
20931,20931,3EEFB7BDF8C8012BA246A804A35191A0,15191,14,15,1,36,27,1827
20932,20932,3EEFB7BDF8C8012BA246A804A35191A0,12792,16,18,2,34,30,1730
20933,20933,3EEFB7BDF8C8012BA246A804A35191A0,15671,21,23,2,37,26,1876
20934,20934,B7E1FA8163F9E5C37489B32682514507,10295,0,9,9,30,47,1547
20935,20935,B7E1FA8163F9E5C37489B32682514507,42081,13,16,3,24,49,1249
20936,20936,B7E1FA8163F9E5C37489B32682514507,10295,18,22,4,30,47,1547
20940,20940,A7D9C28461137D2FC40006F87C9506F9,13671,10,11,1,27,43,1393
20941,20941,A7D9C28461137D2FC40006F87C9506F9,12311,12,16,4,30,44,1544
20942,20942,A7D9C28461137D2FC40006F87C9506F9,42531,19,23,4,31,45,1595
20943,20943,CB5B6B98973636834396900860590D74,42921,0,7,7,33,47,1697
20944,20944,CB5B6B98973636834396900860590D74,42461,9,10,1,45,47,2297
20945,20945,CB5B6B98973636834396900860590D74,42921,12,23,11,33,47,1697
20946,20946,966592CD48E24DD17B5B9C8B94D59F8F,12971,0,7,7,32,48,1648
20947,20947,966592CD48E24DD17B5B9C8B94D59F8F,19741,10,13,3,5,44,294
20948,20948,966592CD48E24DD17B5B9C8B94D59F8F,16181,14,16,2,4,2,202
20949,20949,966592CD48E24DD17B5B9C8B94D59F8F,19741,19,23,4,5,44,294
20966,20966,400659CE2E6F8BFF6D95D6F52F73DF5B,42921,0,5,5,33,47,1697
20967,20967,400659CE2E6F8BFF6D95D6F52F73DF5B,11861,5,11,6,32,47,1647
20968,20968,400659CE2E6F8BFF6D95D6F52F73DF5B,42921,12,13,1,33,47,1697
20969,20969,400659CE2E6F8BFF6D95D6F52F73DF5B,11861,13,19,6,32,47,1647
20970,20970,400659CE2E6F8BFF6D95D6F52F73DF5B,42921,19,23,4,33,47,1697
20993,20993,01BC501351E3F1FC7B6E95606FC74A3B,40343,0,8,8,24,49,1249
20994,20994,01BC501351E3F1FC7B6E95606FC74A3B,10431,9,13,4,33,49,1699
20995,20995,01BC501351E3F1FC7B6E95606FC74A3B,11301,13,14,1,41,49,2099
20996,20996,01BC501351E3F1FC7B6E95606FC74A3B,40302,15,16,1,40,49,2049
20997,20997,01BC501351E3F1FC7B6E95606FC74A3B,11541,17,18,1,35,49,1799
20998,20998,7A04A13186C46A4BE6B54AB67E18C35D,10711,0,8,8,29,46,1496
20999,20999,7A04A13186C46A4BE6B54AB67E18C35D,10251,10,18,8,35,47,1797
21000,21000,7A04A13186C46A4BE6B54AB67E18C35D,10711,21,23,2,29,46,1496
21001,21001,D1D9C3B2D7E81318417584D466D6BC31,42041,1,6,5,10,47,547
21002,21002,D1D9C3B2D7E81318417584D466D6BC31,19441,9,10,1,8,46,446
21003,21003,D1D9C3B2D7E81318417584D466D6BC31,42801,15,18,3,40,49,2049
21004,21004,71CDB42BF8ABF4C8B89BDC81F92C39B7,10634,0,6,6,27,45,1395
21005,21005,71CDB42BF8ABF4C8B89BDC81F92C39B7,12601,8,9,1,25,47,1297
21006,21006,71CDB42BF8ABF4C8B89BDC81F92C39B7,13771,10,11,1,21,45,1095
21007,21007,71CDB42BF8ABF4C8B89BDC81F92C39B7,10634,12,21,9,27,45,1395
21011,21011,F66EBAC9EE1CB5E174070796CFB61D9B,12491,0,7,7,36,43,1843
21012,21012,F66EBAC9EE1CB5E174070796CFB61D9B,12661,11,12,1,32,45,1645
21013,21013,F66EBAC9EE1CB5E174070796CFB61D9B,12491,13,15,2,36,43,1843
21014,21014,F66EBAC9EE1CB5E174070796CFB61D9B,42151,16,20,4,35,45,1795
21032,21032,7779D5C4E5073D864A9050EB76A5AC64,12211,3,4,1,41,44,2094
21033,21033,7779D5C4E5073D864A9050EB76A5AC64,11261,5,9,4,36,46,1846
21034,21034,7779D5C4E5073D864A9050EB76A5AC64,42351,9,11,2,38,45,1945
21035,21035,7779D5C4E5073D864A9050EB76A5AC64,11261,14,22,8,36,46,1846
21040,21040,4FB7544A1E67AE742452DB3735E5F7CF,13111,0,4,4,42,46,2146
21041,21041,4FB7544A1E67AE742452DB3735E5F7CF,43951,8,11,3,49,41,2491
21042,21042,4FB7544A1E67AE742452DB3735E5F7CF,12561,13,16,3,45,43,2293
21043,21043,4FB7544A1E67AE742452DB3735E5F7CF,10771,19,22,3,41,46,2096
21054,21054,2FA830A3F4936C72A1774CB1227927A5,42161,0,6,6,36,47,1847
21055,21055,2FA830A3F4936C72A1774CB1227927A5,42271,7,12,5,40,47,2047
21056,21056,2FA830A3F4936C72A1774CB1227927A5,42281,12,13,1,40,48,2048
21057,21057,2FA830A3F4936C72A1774CB1227927A5,42271,14,15,1,40,47,2047
21058,21058,2FA830A3F4936C72A1774CB1227927A5,42161,18,23,5,36,47,1847
21066,21066,BB18F06A13016E09393A61EDC4B2B216,12971,2,11,9,32,48,1648
21067,21067,BB18F06A13016E09393A61EDC4B2B216,10107,13,14,1,38,49,1949
21068,21068,BB18F06A13016E09393A61EDC4B2B216,10841,19,22,3,37,47,1897
21069,21069,CEA501FA7BDE5D84B551C94F16C00DA1,10651,0,7,7,36,49,1849
21070,21070,CEA501FA7BDE5D84B551C94F16C00DA1,13791,8,17,9,42,47,2147
21071,21071,CEA501FA7BDE5D84B551C94F16C00DA1,10901,20,23,3,35,48,1798
21072,21072,9793A85FD5F8245DB87C881D3A802622,12661,0,5,5,32,45,1645
21073,21073,9793A85FD5F8245DB87C881D3A802622,10634,9,17,8,27,45,1395
21074,21074,9793A85FD5F8245DB87C881D3A802622,12311,21,22,1,30,44,1544
21079,21079,27F132E818644D3933B7D51A13F3BE57,15411,6,16,10,44,27,2227
21080,21080,27F132E818644D3933B7D51A13F3BE57,12611,16,17,1,41,29,2079
21081,21081,27F132E818644D3933B7D51A13F3BE57,15411,17,23,6,44,27,2227
21082,21082,D59A2A795558AA457F13EDE8D62837D5,11461,0,17,17,37,49,1899
21083,21083,D59A2A795558AA457F13EDE8D62837D5,42501,19,20,1,28,47,1447
21084,21084,D59A2A795558AA457F13EDE8D62837D5,11461,21,22,1,37,49,1899
21088,21088,C429C76D36FD2D5A1BAFD43C2F39D796,11201,0,8,8,35,49,1799
21089,21089,C429C76D36FD2D5A1BAFD43C2F39D796,11074,12,13,1,37,47,1897
21090,21090,C429C76D36FD2D5A1BAFD43C2F39D796,11201,14,15,1,35,49,1799
21091,21091,C429C76D36FD2D5A1BAFD43C2F39D796,43361,16,17,1,38,48,1948
21092,21092,C429C76D36FD2D5A1BAFD43C2F39D796,12481,21,23,2,37,49,1899
21093,21093,5070C1A380F75CAF6835A3D83240A24D,19024,0,6,6,9,45,495
21094,21094,5070C1A380F75CAF6835A3D83240A24D,19441,7,8,1,8,46,446
21095,21095,5070C1A380F75CAF6835A3D83240A24D,42041,13,14,1,10,47,547
21096,21096,5070C1A380F75CAF6835A3D83240A24D,19441,15,16,1,8,46,446
21097,21097,5070C1A380F75CAF6835A3D83240A24D,19021,18,20,2,10,45,545
21098,21098,5070C1A380F75CAF6835A3D83240A24D,19024,21,23,2,9,45,495
21099,21099,65C1604BB67F0F47E8EDA9EA4716D601,42864,0,6,6,38,44,1944
21100,21100,65C1604BB67F0F47E8EDA9EA4716D601,11261,7,9,2,36,46,1846
21101,21101,65C1604BB67F0F47E8EDA9EA4716D601,13461,9,11,2,39,44,1994
21102,21102,65C1604BB67F0F47E8EDA9EA4716D601,11261,13,14,1,36,46,1846
21103,21103,65C1604BB67F0F47E8EDA9EA4716D601,10161,19,20,1,35,49,1799
21104,21104,65C1604BB67F0F47E8EDA9EA4716D601,42864,22,23,1,38,44,1944
21105,21105,D55F924A3939D724D8DDE47849C6936E,42031,0,8,8,40,46,2046
21106,21106,D55F924A3939D724D8DDE47849C6936E,43581,9,11,2,33,48,1698
21107,21107,D55F924A3939D724D8DDE47849C6936E,10161,12,14,2,35,49,1799
21108,21108,D55F924A3939D724D8DDE47849C6936E,42031,17,22,5,40,46,2046
21112,21112,CE155B610E3EDB8ECA1DCB73ED422C8D,12571,0,4,4,48,39,2439
21113,21113,CE155B610E3EDB8ECA1DCB73ED422C8D,13821,5,7,2,49,45,2495
21114,21114,CE155B610E3EDB8ECA1DCB73ED422C8D,43101,8,10,2,46,40,2340
21115,21115,CE155B610E3EDB8ECA1DCB73ED422C8D,12571,10,15,5,48,39,2439
21116,21116,CE155B610E3EDB8ECA1DCB73ED422C8D,43101,16,17,1,46,40,2340
21117,21117,CE155B610E3EDB8ECA1DCB73ED422C8D,12571,18,22,4,48,39,2439
21121,21121,16D740AE27D92BE968DE244652195181,13671,1,11,10,27,43,1393
21122,21122,16D740AE27D92BE968DE244652195181,12761,11,12,1,25,40,1290
21123,21123,16D740AE27D92BE968DE244652195181,13671,12,17,5,27,43,1393
21124,21124,16D740AE27D92BE968DE244652195181,12731,20,21,1,22,40,1140
21132,21132,024AB2D90319DF57F94996854D076E3D,13271,0,7,7,41,47,2097
21133,21133,024AB2D90319DF57F94996854D076E3D,10451,9,10,1,25,48,1298
21134,21134,024AB2D90319DF57F94996854D076E3D,11531,12,14,2,34,49,1749
21135,21135,024AB2D90319DF57F94996854D076E3D,40833,19,23,4,41,47,2097
21157,21157,9378E7BD385AF2CAF8CB26920C2EE355,10681,0,3,3,30,48,1548
21158,21158,9378E7BD385AF2CAF8CB26920C2EE355,10951,5,12,7,29,48,1498
21159,21159,9378E7BD385AF2CAF8CB26920C2EE355,10681,15,18,3,30,48,1548
21160,21160,9378E7BD385AF2CAF8CB26920C2EE355,10451,20,21,1,25,48,1298
21161,21161,DC202B6E6FEBB44F8F053C76074DEC47,42021,0,1,1,33,47,1697
21162,21162,DC202B6E6FEBB44F8F053C76074DEC47,40691,4,14,10,42,48,2148
21163,21163,DC202B6E6FEBB44F8F053C76074DEC47,42501,15,16,1,28,47,1447
21164,21164,DC202B6E6FEBB44F8F053C76074DEC47,10471,21,23,2,37,48,1898
21172,21172,7B7EC78C492826B1A2F98257774A5C01,11061,0,9,9,29,48,1498
21173,21173,7B7EC78C492826B1A2F98257774A5C01,40171,12,18,6,38,48,1948
21174,21174,7B7EC78C492826B1A2F98257774A5C01,42623,19,21,2,22,49,1149
21179,21179,47844E829FCB05D6E87386BF9A1380C3,40861,0,2,2,34,48,1748
21180,21180,47844E829FCB05D6E87386BF9A1380C3,13711,2,8,6,38,46,1946
21181,21181,47844E829FCB05D6E87386BF9A1380C3,42011,9,14,5,36,46,1846
21182,21182,47844E829FCB05D6E87386BF9A1380C3,11021,14,20,6,36,49,1849
21183,21183,47844E829FCB05D6E87386BF9A1380C3,10971,21,23,2,35,47,1797
21184,21184,C31349466BA07D977B67949E24E2A3A9,11861,0,12,12,32,47,1647
21185,21185,C31349466BA07D977B67949E24E2A3A9,40341,14,17,3,23,49,1199
21186,21186,C31349466BA07D977B67949E24E2A3A9,42021,18,19,1,33,47,1697
21187,21187,C31349466BA07D977B67949E24E2A3A9,11861,20,23,3,32,47,1647
21191,21191,5EE3D828F4DF96AFADD4A0BC53349128,11461,0,2,2,37,49,1899
21192,21192,5EE3D828F4DF96AFADD4A0BC53349128,13601,15,17,2,34,47,1747
21193,21193,5EE3D828F4DF96AFADD4A0BC53349128,40341,19,21,2,23,49,1199
21194,21194,ED54D9A6448FF51B585DC3225EB6058D,19181,0,15,15,8,40,440
21195,21195,ED54D9A6448FF51B585DC3225EB6058D,43644,19,20,1,14,38,738
21196,21196,ED54D9A6448FF51B585DC3225EB6058D,19181,22,23,1,8,40,440
21197,21197,F06DFBD0C294FEBF164A70611C8885E4,11491,0,7,7,36,47,1847
21198,21198,F06DFBD0C294FEBF164A70611C8885E4,13121,8,9,1,38,46,1946
21199,21199,F06DFBD0C294FEBF164A70611C8885E4,42511,12,13,1,37,47,1897
21200,21200,F06DFBD0C294FEBF164A70611C8885E4,10271,14,16,2,37,46,1896
21201,21201,F06DFBD0C294FEBF164A70611C8885E4,13121,18,19,1,38,46,1946
21202,21202,8CD5156CF883DA15618BAFE58DDCF2A7,42581,0,12,12,38,48,1948
21203,21203,8CD5156CF883DA15618BAFE58DDCF2A7,11914,12,15,3,37,48,1898
21204,21204,8CD5156CF883DA15618BAFE58DDCF2A7,42581,15,16,1,38,48,1948
21205,21205,8CD5156CF883DA15618BAFE58DDCF2A7,11914,17,19,2,37,48,1898
21206,21206,8CD5156CF883DA15618BAFE58DDCF2A7,42581,19,21,2,38,48,1948
21207,21207,D7349708A10855AEF98FEB8D22C33E59,13941,0,7,7,41,47,2097
21208,21208,D7349708A10855AEF98FEB8D22C33E59,11231,8,13,5,37,49,1899
21209,21209,D7349708A10855AEF98FEB8D22C33E59,12083,14,15,1,36,49,1849
21210,21210,D7349708A10855AEF98FEB8D22C33E59,11231,15,17,2,37,49,1899
21211,21211,D7349708A10855AEF98FEB8D22C33E59,10601,19,23,4,39,47,1997
21212,21212,4BF9DBB7DA156A03B683DD639CD01EA6,12121,0,8,8,29,47,1497
21213,21213,4BF9DBB7DA156A03B683DD639CD01EA6,11074,12,16,4,37,47,1897
21214,21214,4BF9DBB7DA156A03B683DD639CD01EA6,10151,17,18,1,34,47,1747
21215,21215,4BF9DBB7DA156A03B683DD639CD01EA6,10841,19,21,2,37,47,1897
21216,21216,4BF9DBB7DA156A03B683DD639CD01EA6,42221,21,23,2,38,48,1948
21217,21217,13593D379347B080E00A2547E2225557,42521,0,8,8,31,47,1597
21218,21218,13593D379347B080E00A2547E2225557,11541,8,18,10,35,49,1799
21219,21219,13593D379347B080E00A2547E2225557,43971,20,23,3,30,48,1548
21223,21223,BD7BD9DD53A8C4BC18B2D1A889695B07,19024,0,8,8,9,45,495
21224,21224,BD7BD9DD53A8C4BC18B2D1A889695B07,11541,9,15,6,35,49,1799
21225,21225,BD7BD9DD53A8C4BC18B2D1A889695B07,11021,16,22,6,36,49,1849
21226,21226,58098C95EBB5313B1B7006269C40D97A,10121,0,7,7,36,49,1849
21227,21227,58098C95EBB5313B1B7006269C40D97A,11231,8,9,1,37,49,1899
21228,21228,58098C95EBB5313B1B7006269C40D97A,10121,10,18,8,36,49,1849
21229,21229,58098C95EBB5313B1B7006269C40D97A,42641,19,21,2,33,49,1699
21230,21230,58098C95EBB5313B1B7006269C40D97A,10121,21,23,2,36,49,1849
21234,21234,6E393276634E5B0B2A68B7AC0F0F48CF,10491,0,6,6,33,48,1698
21235,21235,6E393276634E5B0B2A68B7AC0F0F48CF,11861,6,7,1,32,47,1647
21236,21236,6E393276634E5B0B2A68B7AC0F0F48CF,10491,12,13,1,33,48,1698
21237,21237,6E393276634E5B0B2A68B7AC0F0F48CF,11861,14,17,3,32,47,1647
21238,21238,6E393276634E5B0B2A68B7AC0F0F48CF,10491,19,23,4,33,48,1698
21246,21246,ACD04627348D28EB014FAB46490D4B92,12601,0,1,1,25,47,1297
21247,21247,ACD04627348D28EB014FAB46490D4B92,10351,3,7,4,28,45,1445
21248,21248,ACD04627348D28EB014FAB46490D4B92,12601,10,20,10,25,47,1297
21249,21249,ACD04627348D28EB014FAB46490D4B92,13771,22,23,1,21,45,1095
21254,21254,A3D354AB29AB8D89081F66E60B2073E8,15441,0,8,8,44,20,2220
21255,21255,A3D354AB29AB8D89081F66E60B2073E8,12881,8,10,2,47,22,2372
21256,21256,A3D354AB29AB8D89081F66E60B2073E8,15441,10,20,10,44,20,2220
21257,21257,A3D354AB29AB8D89081F66E60B2073E8,12881,21,22,1,47,22,2372
21258,21258,0C2E73493B95B864220B3E14F6C11E84,13314,0,9,9,31,39,1589
21259,21259,0C2E73493B95B864220B3E14F6C11E84,12521,9,11,2,35,41,1791
21260,21260,0C2E73493B95B864220B3E14F6C11E84,13314,11,23,12,31,39,1589
21265,21265,0155AB609FC587AB2F3A79E4F3BD4F10,13094,10,11,1,21,42,1092
21266,21266,0155AB609FC587AB2F3A79E4F3BD4F10,13091,11,12,1,20,42,1042
21267,21267,0155AB609FC587AB2F3A79E4F3BD4F10,40341,15,17,2,23,49,1199
21268,21268,0155AB609FC587AB2F3A79E4F3BD4F10,12021,17,19,2,37,49,1899
21269,21269,53199EC48B52002628DF1EE750935CA6,40891,0,10,10,37,47,1897
21270,21270,53199EC48B52002628DF1EE750935CA6,13094,12,13,1,21,42,1092
21271,21271,53199EC48B52002628DF1EE750935CA6,40891,18,20,2,37,47,1897
21287,21287,F004825C5EEC7F8B7A184D4985895C55,13341,0,6,6,44,45,2245
21288,21288,F004825C5EEC7F8B7A184D4985895C55,42631,6,10,4,43,45,2195
21289,21289,F004825C5EEC7F8B7A184D4985895C55,13341,11,13,2,44,45,2245
21290,21290,F004825C5EEC7F8B7A184D4985895C55,42631,18,20,2,43,45,2195
21291,21291,F004825C5EEC7F8B7A184D4985895C55,13341,22,23,1,44,45,2245
21301,21301,DE3ACBBFFF90250B316F62451B8DF01D,10901,0,7,7,35,48,1798
21302,21302,DE3ACBBFFF90250B316F62451B8DF01D,12381,8,12,4,32,48,1648
21303,21303,DE3ACBBFFF90250B316F62451B8DF01D,10161,14,17,3,35,49,1799
21304,21304,DE3ACBBFFF90250B316F62451B8DF01D,10731,18,20,2,33,47,1697
21305,21305,DE3ACBBFFF90250B316F62451B8DF01D,11954,21,22,1,32,49,1649
21306,21306,0C2B805EE888E91F034AB21F925F07C4,19901,0,5,5,7,44,394
21307,21307,0C2B805EE888E91F034AB21F925F07C4,12641,8,9,1,10,43,543
21308,21308,0C2B805EE888E91F034AB21F925F07C4,19901,12,15,3,7,44,394
21309,21309,0C2B805EE888E91F034AB21F925F07C4,19114,18,19,1,7,43,393
21310,21310,0C2B805EE888E91F034AB21F925F07C4,12641,21,22,1,10,43,543
21314,21314,AD3EE3BD5870AF753A3A96B6C340F5E0,11381,0,1,1,30,47,1547
21315,21315,AD3EE3BD5870AF753A3A96B6C340F5E0,10951,1,7,6,29,48,1498
21316,21316,AD3EE3BD5870AF753A3A96B6C340F5E0,11381,7,10,3,30,47,1547
21317,21317,AD3EE3BD5870AF753A3A96B6C340F5E0,10951,14,17,3,29,48,1498
21318,21318,AD3EE3BD5870AF753A3A96B6C340F5E0,11381,18,23,5,30,47,1547
21319,21319,1C0548F40841AD0870DAD8EC7BECCBC6,13314,0,7,7,31,39,1589
21320,21320,1C0548F40841AD0870DAD8EC7BECCBC6,12521,7,8,1,35,41,1791
21321,21321,1C0548F40841AD0870DAD8EC7BECCBC6,13314,8,13,5,31,39,1589
21322,21322,1C0548F40841AD0870DAD8EC7BECCBC6,12521,15,17,2,35,41,1791
21323,21323,1C0548F40841AD0870DAD8EC7BECCBC6,13314,18,23,5,31,39,1589
21324,21324,4C479F308A99C28A9312A97B8F351EC7,16011,0,14,14,3,4,154
21325,21325,4C479F308A99C28A9312A97B8F351EC7,16016,14,15,1,4,5,205
21326,21326,4C479F308A99C28A9312A97B8F351EC7,10161,19,20,1,35,49,1799
21344,21344,2F66AC01887397A198C9CCA6611EA97B,12521,0,8,8,35,41,1791
21345,21345,2F66AC01887397A198C9CCA6611EA97B,13314,8,10,2,31,39,1589
21346,21346,2F66AC01887397A198C9CCA6611EA97B,12521,11,14,3,35,41,1791
21347,21347,2F66AC01887397A198C9CCA6611EA97B,13314,14,16,2,31,39,1589
21348,21348,2F66AC01887397A198C9CCA6611EA97B,12521,17,23,6,35,41,1791
21352,21352,AC604569EDEC121EE97D76ACCBB6C578,12521,0,13,13,35,41,1791
21353,21353,AC604569EDEC121EE97D76ACCBB6C578,42231,15,16,1,37,46,1896
21354,21354,AC604569EDEC121EE97D76ACCBB6C578,12521,18,22,4,35,41,1791
21355,21355,34742BC5A2A667B03D313FF35D998A11,11074,0,8,8,37,47,1897
21356,21356,34742BC5A2A667B03D313FF35D998A11,42161,8,11,3,36,47,1847
21357,21357,34742BC5A2A667B03D313FF35D998A11,13331,12,13,1,38,47,1947
21358,21358,34742BC5A2A667B03D313FF35D998A11,11074,16,18,2,37,47,1897
21359,21359,34742BC5A2A667B03D313FF35D998A11,41591,19,20,1,34,49,1749
21360,21360,9BBBC00C93BA6A3176E2B008E6F8A88E,42351,0,5,5,38,45,1945
21361,21361,9BBBC00C93BA6A3176E2B008E6F8A88E,13911,5,8,3,39,46,1996
21362,21362,9BBBC00C93BA6A3176E2B008E6F8A88E,11261,8,10,2,36,46,1846
21363,21363,9BBBC00C93BA6A3176E2B008E6F8A88E,42351,12,13,1,38,45,1945
21364,21364,9BBBC00C93BA6A3176E2B008E6F8A88E,11261,13,20,7,36,46,1846
21365,21365,9BBBC00C93BA6A3176E2B008E6F8A88E,42351,22,23,1,38,45,1945
21366,21366,698D330828DDD2FCACF2F1C2224B1477,10811,0,8,8,38,46,1946
21367,21367,698D330828DDD2FCACF2F1C2224B1477,12601,9,10,1,25,47,1297
21368,21368,698D330828DDD2FCACF2F1C2224B1477,10811,13,14,1,38,46,1946
21369,21369,698D330828DDD2FCACF2F1C2224B1477,42521,16,18,2,31,47,1597
21370,21370,698D330828DDD2FCACF2F1C2224B1477,12971,18,20,2,32,48,1648
21377,21377,A796809FFC26797F0B17A0B66E102B15,13314,0,8,8,31,39,1589
21378,21378,A796809FFC26797F0B17A0B66E102B15,12521,13,16,3,35,41,1791
21379,21379,A796809FFC26797F0B17A0B66E102B15,13314,20,23,3,31,39,1589
21387,21387,67E1BA2E9ECD7EB7906375A0DCF9B61D,42231,0,9,9,37,46,1896
21388,21388,67E1BA2E9ECD7EB7906375A0DCF9B61D,11861,11,17,6,32,47,1647
21389,21389,67E1BA2E9ECD7EB7906375A0DCF9B61D,42231,17,21,4,37,46,1896
21397,21397,DE69FEBC50432F9871EF62D07F7A5C1A,19021,0,5,5,10,45,545
21398,21398,DE69FEBC50432F9871EF62D07F7A5C1A,12921,6,8,2,9,41,491
21399,21399,DE69FEBC50432F9871EF62D07F7A5C1A,19181,9,18,9,8,40,440
21400,21400,E98F4CD93DDE6F42B6667EDEBD3A34DB,10841,2,11,9,37,47,1897
21401,21401,E98F4CD93DDE6F42B6667EDEBD3A34DB,11271,13,14,1,37,48,1898
21402,21402,E98F4CD93DDE6F42B6667EDEBD3A34DB,40951,15,17,2,36,49,1849
21403,21403,E98F4CD93DDE6F42B6667EDEBD3A34DB,43341,19,20,1,41,46,2096
21407,21407,D9B08428B230A26F9D8108567961B570,13671,1,6,5,27,43,1393
21408,21408,D9B08428B230A26F9D8108567961B570,11281,8,10,2,27,40,1390
21409,21409,D9B08428B230A26F9D8108567961B570,13671,11,13,2,27,43,1393
21410,21410,D9B08428B230A26F9D8108567961B570,10951,14,16,2,29,48,1498
21411,21411,D9B08428B230A26F9D8108567961B570,11281,20,22,2,27,40,1390
21412,21412,68D66AC2F31097852E1113FCAC38B096,42531,1,4,3,31,45,1595
21413,21413,68D66AC2F31097852E1113FCAC38B096,12121,5,6,1,29,47,1497
21414,21414,68D66AC2F31097852E1113FCAC38B096,42531,8,10,2,31,45,1595
21415,21415,68D66AC2F31097852E1113FCAC38B096,12311,13,14,1,30,44,1544
21416,21416,68D66AC2F31097852E1113FCAC38B096,42531,16,17,1,31,45,1595
21417,21417,68D66AC2F31097852E1113FCAC38B096,12311,18,23,5,30,44,1544
21418,21418,7B654C3798CB89CF9AFEC7720C14AC66,42461,0,1,1,45,47,2297
21419,21419,7B654C3798CB89CF9AFEC7720C14AC66,40833,1,2,1,41,47,2097
21420,21420,7B654C3798CB89CF9AFEC7720C14AC66,43621,3,5,2,46,48,2348
21421,21421,7B654C3798CB89CF9AFEC7720C14AC66,43051,9,10,1,46,45,2345
21422,21422,7B654C3798CB89CF9AFEC7720C14AC66,13471,14,23,9,47,49,2399
21433,21433,AE9DABC8C76DE8782FA56379E8CBF939,11291,0,7,7,40,49,2049
21434,21434,AE9DABC8C76DE8782FA56379E8CBF939,11631,10,15,5,12,49,649
21435,21435,AE9DABC8C76DE8782FA56379E8CBF939,13741,20,22,2,37,49,1899
21436,21436,A91D753DEB5BEBF3343BA20504460C91,10111,0,8,8,37,47,1897
21437,21437,A91D753DEB5BEBF3343BA20504460C91,10221,11,14,3,34,49,1749
21438,21438,A91D753DEB5BEBF3343BA20504460C91,10341,17,19,2,31,47,1597
21439,21439,A91D753DEB5BEBF3343BA20504460C91,10111,21,23,2,37,47,1897
21440,21440,68A1105E45875228253ACCFACF581238,15143,0,8,8,18,7,907
21441,21441,68A1105E45875228253ACCFACF581238,16281,11,20,9,11,4,554
21442,21442,68A1105E45875228253ACCFACF581238,15143,21,23,2,18,7,907
21443,21443,491F26A17D9EDEEE5D002133D7BEBC78,12511,0,6,6,39,47,1997
21444,21444,491F26A17D9EDEEE5D002133D7BEBC78,11381,6,12,6,30,47,1547
21445,21445,491F26A17D9EDEEE5D002133D7BEBC78,42521,13,14,1,31,47,1597
21446,21446,491F26A17D9EDEEE5D002133D7BEBC78,11381,14,17,3,30,47,1547
21447,21447,491F26A17D9EDEEE5D002133D7BEBC78,12511,19,23,4,39,47,1997
21448,21448,0B929ACA970011AFF649AD1CE667839A,12921,1,6,5,9,41,491
21449,21449,0B929ACA970011AFF649AD1CE667839A,43021,8,10,2,16,43,843
21450,21450,0B929ACA970011AFF649AD1CE667839A,12921,12,14,2,9,41,491
21451,21451,0B929ACA970011AFF649AD1CE667839A,43021,14,17,3,16,43,843
21452,21452,0B929ACA970011AFF649AD1CE667839A,11751,18,23,5,35,48,1798
21456,21456,19544F9BC0BE20E6141BDD062D6E05AC,13071,0,8,8,41,41,2091
21457,21457,19544F9BC0BE20E6141BDD062D6E05AC,43451,11,14,3,37,40,1890
21458,21458,19544F9BC0BE20E6141BDD062D6E05AC,42381,17,18,1,39,41,1991
21459,21459,19544F9BC0BE20E6141BDD062D6E05AC,43451,21,23,2,37,40,1890
21466,21466,9526CA84048ECDF651C5107129654F39,15145,3,6,3,22,9,1109
21467,21467,9526CA84048ECDF651C5107129654F39,16321,8,9,1,8,7,407
21468,21468,9526CA84048ECDF651C5107129654F39,15145,12,14,2,22,9,1109
21469,21469,9526CA84048ECDF651C5107129654F39,16151,19,21,2,13,11,661
21470,21470,9526CA84048ECDF651C5107129654F39,15145,22,23,1,22,9,1109
21471,21471,CEAC6C818D7651ADBA37DD2B6097C732,42351,0,7,7,38,45,1945
21472,21472,CEAC6C818D7651ADBA37DD2B6097C732,42231,7,8,1,37,46,1896
21473,21473,CEAC6C818D7651ADBA37DD2B6097C732,42351,8,10,2,38,45,1945
21474,21474,CEAC6C818D7651ADBA37DD2B6097C732,42231,12,13,1,37,46,1896
21475,21475,CEAC6C818D7651ADBA37DD2B6097C732,13911,16,18,2,39,46,1996
21476,21476,CEAC6C818D7651ADBA37DD2B6097C732,42231,20,23,3,37,46,1896
21486,21486,BB152C1AD575B8A4C5FF45C8B74EF48A,43581,0,14,14,33,48,1698
21487,21487,BB152C1AD575B8A4C5FF45C8B74EF48A,40341,16,17,1,23,49,1199
21488,21488,BB152C1AD575B8A4C5FF45C8B74EF48A,10381,18,19,1,31,49,1599
21489,21489,BB152C1AD575B8A4C5FF45C8B74EF48A,43581,21,22,1,33,48,1698
21493,21493,35DAC6756C7F4B57C2B1C6F65896CD31,12601,1,13,12,25,47,1297
21494,21494,35DAC6756C7F4B57C2B1C6F65896CD31,10351,13,17,4,28,45,1445
21495,21495,35DAC6756C7F4B57C2B1C6F65896CD31,12601,17,18,1,25,47,1297
21502,21502,C029826C5BB7E45FB7F0BA61E1CA759A,12381,0,8,8,32,48,1648
21503,21503,C029826C5BB7E45FB7F0BA61E1CA759A,10151,10,12,2,34,47,1747
21504,21504,C029826C5BB7E45FB7F0BA61E1CA759A,12381,12,16,4,32,48,1648
21505,21505,C029826C5BB7E45FB7F0BA61E1CA759A,10841,18,20,2,37,47,1897
21506,21506,C029826C5BB7E45FB7F0BA61E1CA759A,12381,21,23,2,32,48,1648
21516,21516,2770DAF26F856B8C604C0FF1601A7902,12641,0,9,9,10,43,543
21517,21517,2770DAF26F856B8C604C0FF1601A7902,43644,11,12,1,14,38,738
21518,21518,2770DAF26F856B8C604C0FF1601A7902,12641,14,17,3,10,43,543
21519,21519,2770DAF26F856B8C604C0FF1601A7902,19031,19,22,3,1,42,92
21520,21520,4364FD2FFA8DEA8FEB9F5B53C4AAF0AF,11321,0,2,2,31,46,1596
21521,21521,4364FD2FFA8DEA8FEB9F5B53C4AAF0AF,10351,3,4,1,28,45,1445
21522,21522,4364FD2FFA8DEA8FEB9F5B53C4AAF0AF,42151,8,23,15,35,45,1795
21523,21523,94092014F9DD3213271810B8D19555BE,49201,0,14,14,7,41,391
21524,21524,94092014F9DD3213271810B8D19555BE,19021,17,18,1,10,45,545
21525,21525,94092014F9DD3213271810B8D19555BE,49201,19,23,4,7,41,391
21529,21529,EEB3CBC85DF19031E292162C06516E43,10471,7,12,5,37,48,1898
21530,21530,EEB3CBC85DF19031E292162C06516E43,11381,13,15,2,30,47,1547
21531,21531,EEB3CBC85DF19031E292162C06516E43,10471,19,22,3,37,48,1898
21535,21535,BCCF2CDFD6C9D7A77ABBD1757075B8AB,11081,7,8,1,35,46,1796
21536,21536,BCCF2CDFD6C9D7A77ABBD1757075B8AB,11781,12,15,3,38,49,1949
21537,21537,BCCF2CDFD6C9D7A77ABBD1757075B8AB,11461,19,20,1,37,49,1899
21541,21541,9D2F8B673CF5A851F245B3DD21FD08F4,42161,0,6,6,36,47,1847
21542,21542,9D2F8B673CF5A851F245B3DD21FD08F4,10111,8,10,2,37,47,1897
21543,21543,9D2F8B673CF5A851F245B3DD21FD08F4,10191,12,14,2,40,48,2048
21544,21544,9D2F8B673CF5A851F245B3DD21FD08F4,10111,17,23,6,37,47,1897
21545,21545,D4FFD3DBF31169ED7795F657992DBA3A,10111,0,1,1,37,47,1897
21546,21546,D4FFD3DBF31169ED7795F657992DBA3A,11161,2,8,6,32,48,1648
21547,21547,D4FFD3DBF31169ED7795F657992DBA3A,11331,9,18,9,37,48,1898
21548,21548,831CEF471029417D091D2BE9F78234DD,42321,3,12,9,43,47,2197
21549,21549,831CEF471029417D091D2BE9F78234DD,13941,15,19,4,41,47,2097
21550,21550,831CEF471029417D091D2BE9F78234DD,40073,22,23,1,37,48,1898
21551,21551,6EF3FF760E19F4779DBA83689DEC9B2B,42521,1,3,2,31,47,1597
21552,21552,6EF3FF760E19F4779DBA83689DEC9B2B,10295,3,10,7,30,47,1547
21553,21553,6EF3FF760E19F4779DBA83689DEC9B2B,42521,11,12,1,31,47,1597
21554,21554,6EF3FF760E19F4779DBA83689DEC9B2B,13651,14,15,1,30,47,1547
21555,21555,6EF3FF760E19F4779DBA83689DEC9B2B,42521,18,22,4,31,47,1597
21562,21562,09D4E4AC27B1C2BD71280354244F178D,42121,2,7,5,26,49,1349
21563,21563,09D4E4AC27B1C2BD71280354244F178D,42461,12,14,2,45,47,2297
21564,21564,09D4E4AC27B1C2BD71280354244F178D,42121,16,20,4,26,49,1349
21565,21565,09D4E4AC27B1C2BD71280354244F178D,10731,21,23,2,33,47,1697
21575,21575,B0FBA72251F80516E1A92D1893B7FB04,10681,1,2,1,30,48,1548
21576,21576,B0FBA72251F80516E1A92D1893B7FB04,11061,5,8,3,29,48,1498
21577,21577,B0FBA72251F80516E1A92D1893B7FB04,11551,10,11,1,39,49,1999
21578,21578,B0FBA72251F80516E1A92D1893B7FB04,11061,12,17,5,29,48,1498
21579,21579,B0FBA72251F80516E1A92D1893B7FB04,10681,17,19,2,30,48,1548
21580,21580,B0FBA72251F80516E1A92D1893B7FB04,11061,19,22,3,29,48,1498
21581,21581,D6932FB45D03368B8FD3FCD5E6F4054F,11531,0,1,1,34,49,1749
21582,21582,D6932FB45D03368B8FD3FCD5E6F4054F,42281,2,7,5,40,48,2048
21583,21583,D6932FB45D03368B8FD3FCD5E6F4054F,11541,11,12,1,35,49,1799
21584,21584,D6932FB45D03368B8FD3FCD5E6F4054F,43981,13,15,2,36,49,1849
21585,21585,D6932FB45D03368B8FD3FCD5E6F4054F,11805,18,20,2,41,48,2098
21586,21586,9F61D9D4906A70FC9D3DF4707EFB07CE,13711,8,10,2,38,46,1946
21587,21587,9F61D9D4906A70FC9D3DF4707EFB07CE,42351,13,14,1,38,45,1945
21588,21588,9F61D9D4906A70FC9D3DF4707EFB07CE,13711,15,16,1,38,46,1946
21589,21589,9F61D9D4906A70FC9D3DF4707EFB07CE,41591,18,19,1,34,49,1749
21590,21590,9F61D9D4906A70FC9D3DF4707EFB07CE,40951,20,21,1,36,49,1849
21594,21594,84D6F944A9720742D92DF6BE4B5D36E6,12141,1,7,6,42,45,2145
21595,21595,84D6F944A9720742D92DF6BE4B5D36E6,13341,7,10,3,44,45,2245
21596,21596,84D6F944A9720742D92DF6BE4B5D36E6,12561,14,17,3,45,43,2293
21597,21597,84D6F944A9720742D92DF6BE4B5D36E6,12141,17,18,1,42,45,2145
21602,21602,95A50FC77E468146BAD45CC8BD317370,42921,1,5,4,33,47,1697
21603,21603,95A50FC77E468146BAD45CC8BD317370,43731,7,10,3,34,47,1747
21604,21604,95A50FC77E468146BAD45CC8BD317370,11061,15,16,1,29,48,1498
21605,21605,95A50FC77E468146BAD45CC8BD317370,43731,18,19,1,34,47,1747
21606,21606,D3B7E592123DB083081A1FE3F2020361,12641,0,2,2,10,43,543
21607,21607,D3B7E592123DB083081A1FE3F2020361,19114,4,11,7,7,43,393
21608,21608,D3B7E592123DB083081A1FE3F2020361,12921,14,15,1,9,41,491
21609,21609,D3B7E592123DB083081A1FE3F2020361,19114,17,18,1,7,43,393
21610,21610,D3B7E592123DB083081A1FE3F2020361,12641,19,20,1,10,43,543
21624,21624,015977F21CA69DACA3E876A5F028B2A4,43051,0,5,5,46,45,2345
21625,21625,015977F21CA69DACA3E876A5F028B2A4,13351,5,11,6,48,48,2448
21626,21626,015977F21CA69DACA3E876A5F028B2A4,43051,12,14,2,46,45,2345
21627,21627,015977F21CA69DACA3E876A5F028B2A4,13351,15,20,5,48,48,2448
21628,21628,015977F21CA69DACA3E876A5F028B2A4,43051,21,23,2,46,45,2345
21629,21629,E1B4D34F30518B1001C1CE57EBC5ED84,19351,0,7,7,2,18,118
21630,21630,E1B4D34F30518B1001C1CE57EBC5ED84,16233,7,8,1,5,15,265
21631,21631,E1B4D34F30518B1001C1CE57EBC5ED84,19351,10,21,11,2,18,118
21632,21632,DD295DE566AAA9C59DEFFE23B30C8780,12514,0,6,6,38,47,1947
21633,21633,DD295DE566AAA9C59DEFFE23B30C8780,41601,7,14,7,39,49,1999
21634,21634,DD295DE566AAA9C59DEFFE23B30C8780,12731,15,16,1,22,40,1140
21635,21635,DD295DE566AAA9C59DEFFE23B30C8780,10191,19,23,4,40,48,2048
21636,21636,C77F23D19DAEA5BB8ADE1BB3D3C261B4,13671,0,4,4,27,43,1393
21637,21637,C77F23D19DAEA5BB8ADE1BB3D3C261B4,13911,7,17,10,39,46,1996
21638,21638,C77F23D19DAEA5BB8ADE1BB3D3C261B4,42531,18,19,1,31,45,1595
21639,21639,C77F23D19DAEA5BB8ADE1BB3D3C261B4,11651,21,22,1,33,47,1697
21640,21640,FB473FBE3EAFD3A14A7452241F377171,19901,0,5,5,7,44,394
21641,21641,FB473FBE3EAFD3A14A7452241F377171,12641,7,9,2,10,43,543
21642,21642,FB473FBE3EAFD3A14A7452241F377171,19901,10,11,1,7,44,394
21643,21643,FB473FBE3EAFD3A14A7452241F377171,19621,12,14,2,5,46,296
21644,21644,FB473FBE3EAFD3A14A7452241F377171,12641,15,18,3,10,43,543
21645,21645,FB473FBE3EAFD3A14A7452241F377171,19901,18,20,2,7,44,394
21649,21649,A5B231222D204E4A7A93518B8E9C4817,13511,0,6,6,34,48,1748
21650,21650,A5B231222D204E4A7A93518B8E9C4817,40341,10,16,6,23,49,1199
21651,21651,A5B231222D204E4A7A93518B8E9C4817,13511,20,23,3,34,48,1748
21655,21655,4EABE655BE26B3EDCCD7B6B2C89F187F,10161,0,7,7,35,49,1799
21656,21656,4EABE655BE26B3EDCCD7B6B2C89F187F,42981,7,12,5,36,49,1849
21657,21657,4EABE655BE26B3EDCCD7B6B2C89F187F,11231,13,14,1,37,49,1899
21658,21658,4EABE655BE26B3EDCCD7B6B2C89F187F,10161,16,19,3,35,49,1799
21659,21659,4EABE655BE26B3EDCCD7B6B2C89F187F,40951,19,21,2,36,49,1849
21660,21660,28C2D2FE4D28624F13409918B749F4EA,42231,0,4,4,37,46,1896
21661,21661,28C2D2FE4D28624F13409918B749F4EA,42511,8,10,2,37,47,1897
21662,21662,28C2D2FE4D28624F13409918B749F4EA,11941,15,16,1,37,46,1896
21663,21663,28C2D2FE4D28624F13409918B749F4EA,13941,19,23,4,41,47,2097
21673,21673,CD52B23153B32DF9098DFA2E090DCA75,12381,1,7,6,32,48,1648
21674,21674,CD52B23153B32DF9098DFA2E090DCA75,42864,9,10,1,38,44,1944
21675,21675,CD52B23153B32DF9098DFA2E090DCA75,42523,11,13,2,31,47,1597
21676,21676,CD52B23153B32DF9098DFA2E090DCA75,42864,14,17,3,38,44,1944
21677,21677,CD52B23153B32DF9098DFA2E090DCA75,12381,18,23,5,32,48,1648
21678,21678,27E5652E2BA40D37FBD9A0AA720456AC,13121,0,7,7,38,46,1946
21679,21679,27E5652E2BA40D37FBD9A0AA720456AC,43241,8,10,2,36,46,1846
21680,21680,27E5652E2BA40D37FBD9A0AA720456AC,13121,15,17,2,38,46,1946
21681,21681,27E5652E2BA40D37FBD9A0AA720456AC,43241,18,20,2,36,46,1846
21682,21682,27E5652E2BA40D37FBD9A0AA720456AC,13121,20,21,1,38,46,1946
21690,21690,3E3400E81F33727D0845365703B2CDF7,42961,0,7,7,35,49,1799
21691,21691,3E3400E81F33727D0845365703B2CDF7,10924,8,16,8,43,49,2199
21692,21692,3E3400E81F33727D0845365703B2CDF7,42471,20,23,3,35,49,1799
21703,21703,C67AD33695FBB59FE91EDDED93659237,10544,2,3,1,28,48,1448
21704,21704,C67AD33695FBB59FE91EDDED93659237,11151,3,4,1,30,48,1548
21705,21705,C67AD33695FBB59FE91EDDED93659237,11331,8,20,12,37,48,1898
21710,21710,62FCB15297A7724012720DDE29CC0405,13111,0,7,7,42,46,2146
21711,21711,62FCB15297A7724012720DDE29CC0405,10251,11,13,2,35,47,1797
21712,21712,62FCB15297A7724012720DDE29CC0405,42541,14,16,2,25,47,1297
21713,21713,62FCB15297A7724012720DDE29CC0405,11781,19,21,2,38,49,1949
21724,21724,49905612962077A48EBEDD8D158E8323,12381,0,11,11,32,48,1648
21725,21725,49905612962077A48EBEDD8D158E8323,40951,12,14,2,36,49,1849
21726,21726,49905612962077A48EBEDD8D158E8323,12381,17,23,6,32,48,1648
21730,21730,71216C3E1F8418C02DB017A852AAEF0E,43021,0,8,8,16,43,843
21731,21731,71216C3E1F8418C02DB017A852AAEF0E,12921,9,11,2,9,41,491
21732,21732,71216C3E1F8418C02DB017A852AAEF0E,43021,12,15,3,16,43,843
21733,21733,71216C3E1F8418C02DB017A852AAEF0E,19114,17,19,2,7,43,393
21737,21737,CC63EA7467D4A1FC7EF1BC76C9DAF092,42861,0,3,3,37,44,1894
21738,21738,CC63EA7467D4A1FC7EF1BC76C9DAF092,42864,5,8,3,38,44,1944
21739,21739,CC63EA7467D4A1FC7EF1BC76C9DAF092,11261,13,17,4,36,46,1846
21740,21740,CC63EA7467D4A1FC7EF1BC76C9DAF092,12211,19,20,1,41,44,2094
21741,21741,CC63EA7467D4A1FC7EF1BC76C9DAF092,11261,21,22,1,36,46,1846
21742,21742,D8F61CF3289E3928FCE68B7F3A3EF9A7,43041,0,7,7,41,46,2096
21743,21743,D8F61CF3289E3928FCE68B7F3A3EF9A7,10841,8,17,9,37,47,1897
21744,21744,D8F61CF3289E3928FCE68B7F3A3EF9A7,43041,18,23,5,41,46,2096
21758,21758,F42B2DCE76ABCE6C5C6837EF4D7BF4CB,11091,5,9,4,29,47,1497
21759,21759,F42B2DCE76ABCE6C5C6837EF4D7BF4CB,11061,13,15,2,29,48,1498
21760,21760,F42B2DCE76ABCE6C5C6837EF4D7BF4CB,11091,16,18,2,29,47,1497
21761,21761,F42B2DCE76ABCE6C5C6837EF4D7BF4CB,40341,19,21,2,23,49,1199
21762,21762,F42B2DCE76ABCE6C5C6837EF4D7BF4CB,11091,22,23,1,29,47,1497
21763,21763,B289C6428E0D98B8D720F0FA5499A67A,15121,0,1,1,27,19,1369
21764,21764,B289C6428E0D98B8D720F0FA5499A67A,15421,2,3,1,20,18,1018
21765,21765,B289C6428E0D98B8D720F0FA5499A67A,15271,5,9,4,14,20,720
21766,21766,B289C6428E0D98B8D720F0FA5499A67A,16441,12,16,4,15,17,767
21767,21767,B289C6428E0D98B8D720F0FA5499A67A,15271,21,23,2,14,20,720
21776,21776,503C825874017B94AAE9067BE859DEB7,19901,9,11,2,7,44,394
21777,21777,503C825874017B94AAE9067BE859DEB7,19181,15,16,1,8,40,440
21778,21778,503C825874017B94AAE9067BE859DEB7,10801,21,22,1,42,47,2147
21779,21779,503C825874017B94AAE9067BE859DEB7,42321,22,23,1,43,47,2197
21780,21780,53DE27C3988F5D22526FCC360F8F3A99,11321,0,5,5,31,46,1596
21781,21781,53DE27C3988F5D22526FCC360F8F3A99,42523,10,16,6,31,47,1597
21782,21782,53DE27C3988F5D22526FCC360F8F3A99,40341,20,21,1,23,49,1199
21783,21783,04E25EABAF57B3731144C024B2F68618,42631,1,9,8,43,45,2195
21784,21784,04E25EABAF57B3731144C024B2F68618,13341,10,12,2,44,45,2245
21785,21785,04E25EABAF57B3731144C024B2F68618,12601,14,16,2,25,47,1297
21786,21786,04E25EABAF57B3731144C024B2F68618,13341,19,20,1,44,45,2245
21796,21796,29ACCDFAEB79F0C1A4DC4642AA4D44B8,10801,0,2,2,42,47,2147
21797,21797,29ACCDFAEB79F0C1A4DC4642AA4D44B8,40833,4,8,4,41,47,2097
21798,21798,29ACCDFAEB79F0C1A4DC4642AA4D44B8,43041,12,18,6,41,46,2096
21799,21799,29ACCDFAEB79F0C1A4DC4642AA4D44B8,10924,18,21,3,43,49,2199
21800,21800,29ACCDFAEB79F0C1A4DC4642AA4D44B8,10801,22,23,1,42,47,2147
21804,21804,2FD7CB563CD330B8757D30F36F5DB42E,13111,0,6,6,42,46,2146
21805,21805,2FD7CB563CD330B8757D30F36F5DB42E,43951,7,8,1,49,41,2491
21806,21806,2FD7CB563CD330B8757D30F36F5DB42E,13411,10,11,1,49,42,2492
21807,21807,2FD7CB563CD330B8757D30F36F5DB42E,13111,12,23,11,42,46,2146
21808,21808,7A7AEC35AE07D4110F6099DB218EF80C,10211,0,2,2,16,49,849
21809,21809,7A7AEC35AE07D4110F6099DB218EF80C,11631,3,6,3,12,49,649
21810,21810,7A7AEC35AE07D4110F6099DB218EF80C,19441,9,15,6,8,46,446
21811,21811,7A7AEC35AE07D4110F6099DB218EF80C,19021,16,17,1,10,45,545
21812,21812,7A7AEC35AE07D4110F6099DB218EF80C,11851,22,23,1,13,47,697
21819,21819,EE4B1F6FA31F6EC3CF34CDE4DFC6A84E,10251,1,8,7,35,47,1797
21820,21820,EE4B1F6FA31F6EC3CF34CDE4DFC6A84E,10221,12,13,1,34,49,1749
21821,21821,EE4B1F6FA31F6EC3CF34CDE4DFC6A84E,13101,13,15,2,40,47,2047
21822,21822,EE4B1F6FA31F6EC3CF34CDE4DFC6A84E,10401,17,20,3,33,49,1699
21823,21823,EE4B1F6FA31F6EC3CF34CDE4DFC6A84E,11531,20,21,1,34,49,1749
21833,21833,27E1696654D42171AC2D414EFBBE4CC3,10781,0,8,8,35,47,1797
21834,21834,27E1696654D42171AC2D414EFBBE4CC3,40637,8,11,3,36,47,1847
21835,21835,27E1696654D42171AC2D414EFBBE4CC3,10781,13,16,3,35,47,1797
21836,21836,27E1696654D42171AC2D414EFBBE4CC3,10591,18,20,2,39,48,1998
21837,21837,CAB47C85629646AC05B696BEE2F5B14A,10211,1,7,6,16,49,849
21838,21838,CAB47C85629646AC05B696BEE2F5B14A,10214,7,8,1,15,49,799
21839,21839,CAB47C85629646AC05B696BEE2F5B14A,11101,9,15,6,18,48,948
21840,21840,CAB47C85629646AC05B696BEE2F5B14A,11861,16,23,7,32,47,1647
21841,21841,AA2AAE26F1B48002865B69CE7B480FED,42523,1,2,1,31,47,1597
21842,21842,AA2AAE26F1B48002865B69CE7B480FED,10292,2,10,8,30,47,1547
21843,21843,AA2AAE26F1B48002865B69CE7B480FED,42523,13,15,2,31,47,1597
21844,21844,AA2AAE26F1B48002865B69CE7B480FED,10292,15,17,2,30,47,1547
21845,21845,AA2AAE26F1B48002865B69CE7B480FED,42523,20,22,2,31,47,1597
21846,21846,CAC95EFB43F5E49190A4EAC08FB5B4EF,40637,0,4,4,36,47,1847
21847,21847,CAC95EFB43F5E49190A4EAC08FB5B4EF,10251,7,10,3,35,47,1797
21848,21848,CAC95EFB43F5E49190A4EAC08FB5B4EF,40637,11,15,4,36,47,1847
21849,21849,CAC95EFB43F5E49190A4EAC08FB5B4EF,10251,17,19,2,35,47,1797
21850,21850,CAC95EFB43F5E49190A4EAC08FB5B4EF,40637,19,21,2,36,47,1847
21851,21851,CAC95EFB43F5E49190A4EAC08FB5B4EF,12841,21,23,2,37,47,1897
21852,21852,28AE6FF44E8686DC354D2E3DF7700FCC,42461,0,6,6,45,47,2297
21853,21853,28AE6FF44E8686DC354D2E3DF7700FCC,42321,6,8,2,43,47,2197
21854,21854,28AE6FF44E8686DC354D2E3DF7700FCC,42461,12,13,1,45,47,2297
21855,21855,28AE6FF44E8686DC354D2E3DF7700FCC,42321,13,17,4,43,47,2197
21856,21856,28AE6FF44E8686DC354D2E3DF7700FCC,42461,19,23,4,45,47,2297
21857,21857,057935907C2B481CA4E4D08E6E9B9029,11841,3,9,6,33,46,1696
21858,21858,057935907C2B481CA4E4D08E6E9B9029,11834,10,12,2,32,45,1645
21859,21859,057935907C2B481CA4E4D08E6E9B9029,43761,14,16,2,32,47,1647
21860,21860,057935907C2B481CA4E4D08E6E9B9029,11841,17,19,2,33,46,1696
21861,21861,057935907C2B481CA4E4D08E6E9B9029,43761,20,21,1,32,47,1647
21862,21862,057935907C2B481CA4E4D08E6E9B9029,10531,22,23,1,34,46,1746
21876,21876,27C8C8C59A45FD62972467F08CD2763D,11231,0,8,8,37,49,1899
21877,21877,27C8C8C59A45FD62972467F08CD2763D,11331,8,10,2,37,48,1898
21878,21878,27C8C8C59A45FD62972467F08CD2763D,11921,11,14,3,38,48,1948
21879,21879,27C8C8C59A45FD62972467F08CD2763D,13071,18,19,1,41,41,2091
21880,21880,EC1141E725A7198CD46488DFBB2FD884,42531,2,6,4,31,45,1595
21881,21881,EC1141E725A7198CD46488DFBB2FD884,12311,9,10,1,30,44,1544
21882,21882,EC1141E725A7198CD46488DFBB2FD884,42531,11,12,1,31,45,1595
21883,21883,EC1141E725A7198CD46488DFBB2FD884,12311,13,18,5,30,44,1544
21884,21884,EC1141E725A7198CD46488DFBB2FD884,42531,18,23,5,31,45,1595
21888,21888,7EA63201A47B68AA085BD7B8AF1F7767,10721,0,7,7,31,48,1598
21889,21889,7EA63201A47B68AA085BD7B8AF1F7767,11231,8,17,9,37,49,1899
21890,21890,7EA63201A47B68AA085BD7B8AF1F7767,10721,19,23,4,31,48,1598
21902,21902,9A365F6CD1EED4A94D460D848C733912,19181,0,5,5,8,40,440
21903,21903,9A365F6CD1EED4A94D460D848C733912,43021,5,9,4,16,43,843
21904,21904,9A365F6CD1EED4A94D460D848C733912,12921,9,19,10,9,41,491
21905,21905,9A365F6CD1EED4A94D460D848C733912,43021,22,23,1,16,43,843
21909,21909,33EC6862A4D3A83DD8E8B00DCA26EE3C,43241,0,13,13,36,46,1846
21910,21910,33EC6862A4D3A83DD8E8B00DCA26EE3C,12661,14,15,1,32,45,1645
21911,21911,33EC6862A4D3A83DD8E8B00DCA26EE3C,43241,18,19,1,36,46,1846
21915,21915,C44A844815EDFF1B8B49CFB3C71F380E,42161,0,8,8,36,47,1847
21916,21916,C44A844815EDFF1B8B49CFB3C71F380E,13481,11,16,5,26,31,1331
21917,21917,C44A844815EDFF1B8B49CFB3C71F380E,11074,17,19,2,37,47,1897
21918,21918,C44A844815EDFF1B8B49CFB3C71F380E,42161,20,23,3,36,47,1847
21922,21922,DD6885B9B6EF8237178DC323E1E2BC30,11261,4,5,1,36,46,1846
21923,21923,DD6885B9B6EF8237178DC323E1E2BC30,12491,8,12,4,36,43,1843
21924,21924,DD6885B9B6EF8237178DC323E1E2BC30,11261,15,16,1,36,46,1846
21925,21925,DD6885B9B6EF8237178DC323E1E2BC30,13221,20,21,1,40,47,2047
21926,21926,FCF6425DA3F542476DF1F93935C075D8,42581,0,8,8,38,48,1948
21927,21927,FCF6425DA3F542476DF1F93935C075D8,11914,10,12,2,37,48,1898
21928,21928,FCF6425DA3F542476DF1F93935C075D8,42581,13,14,1,38,48,1948
21929,21929,FCF6425DA3F542476DF1F93935C075D8,11914,14,17,3,37,48,1898
21930,21930,FCF6425DA3F542476DF1F93935C075D8,42581,17,23,6,38,48,1948
21938,21938,195324DC402E462BD776716235C0A16D,12121,0,1,1,29,47,1497
21939,21939,195324DC402E462BD776716235C0A16D,42141,3,5,2,32,47,1647
21940,21940,195324DC402E462BD776716235C0A16D,11651,6,9,3,33,47,1697
21941,21941,195324DC402E462BD776716235C0A16D,42141,10,12,2,32,47,1647
21942,21942,195324DC402E462BD776716235C0A16D,11651,13,15,2,33,47,1697
21943,21943,195324DC402E462BD776716235C0A16D,10281,17,19,2,33,48,1698
21944,21944,195324DC402E462BD776716235C0A16D,11861,21,23,2,32,47,1647
21945,21945,FB86D612373D394FB9CB10B4E044DE17,13121,0,1,1,38,46,1946
21946,21946,FB86D612373D394FB9CB10B4E044DE17,42511,1,7,6,37,47,1897
21947,21947,FB86D612373D394FB9CB10B4E044DE17,13121,8,13,5,38,46,1946
21948,21948,FB86D612373D394FB9CB10B4E044DE17,10271,16,18,2,37,46,1896
21949,21949,FB86D612373D394FB9CB10B4E044DE17,13121,18,22,4,38,46,1946
21950,21950,4EE541C2C77ED64C3476846B8EC5E510,19431,0,4,4,8,29,429
21951,21951,4EE541C2C77ED64C3476846B8EC5E510,19801,6,7,1,19,26,976
21952,21952,4EE541C2C77ED64C3476846B8EC5E510,19431,9,10,1,8,29,429
21953,21953,4EE541C2C77ED64C3476846B8EC5E510,19801,13,14,1,19,26,976
21954,21954,4EE541C2C77ED64C3476846B8EC5E510,12871,15,17,2,22,33,1133
21955,21955,4EE541C2C77ED64C3476846B8EC5E510,19801,17,18,1,19,26,976
21956,21956,CA376C13A61D259A65D593BAF6522A66,42151,1,5,4,35,45,1795
21957,21957,CA376C13A61D259A65D593BAF6522A66,11834,5,17,12,32,45,1645
21958,21958,CA376C13A61D259A65D593BAF6522A66,11381,19,21,2,30,47,1547
21959,21959,BA68D19087DD7682E8C396165511A278,11381,0,8,8,30,47,1547
21960,21960,BA68D19087DD7682E8C396165511A278,42521,9,11,2,31,47,1597
21961,21961,BA68D19087DD7682E8C396165511A278,11061,11,13,2,29,48,1498
21962,21962,BA68D19087DD7682E8C396165511A278,11161,14,17,3,32,48,1648
21963,21963,BA68D19087DD7682E8C396165511A278,11753,19,21,2,35,48,1798
21970,21970,9F569681847AE1CB91DC5B95636EE88A,19021,3,7,4,10,45,545
21971,21971,9F569681847AE1CB91DC5B95636EE88A,43021,7,9,2,16,43,843
21972,21972,9F569681847AE1CB91DC5B95636EE88A,19021,10,18,8,10,45,545
21973,21973,9F569681847AE1CB91DC5B95636EE88A,11571,18,21,3,13,46,696
21977,21977,36008D94577CF891B61F4F697BF6EF46,10292,0,7,7,30,47,1547
21978,21978,36008D94577CF891B61F4F697BF6EF46,19111,13,14,1,9,45,495
21979,21979,36008D94577CF891B61F4F697BF6EF46,42521,22,23,1,31,47,1597
21983,21983,4B5119258FB3482B746B53277561992F,12051,0,1,1,20,47,1047
21984,21984,4B5119258FB3482B746B53277561992F,12601,1,4,3,25,47,1297
21985,21985,4B5119258FB3482B746B53277561992F,12051,5,8,3,20,47,1047
21986,21986,4B5119258FB3482B746B53277561992F,12601,11,17,6,25,47,1297
21987,21987,4B5119258FB3482B746B53277561992F,12581,18,19,1,24,48,1248
21988,21988,4B5119258FB3482B746B53277561992F,12051,20,22,2,20,47,1047
22014,22014,B207D5D3140535CF644F21B83755D02D,10471,0,1,1,37,48,1898
22015,22015,B207D5D3140535CF644F21B83755D02D,42981,1,5,4,36,49,1849
22016,22016,B207D5D3140535CF644F21B83755D02D,10471,7,8,1,37,48,1898
22017,22017,B207D5D3140535CF644F21B83755D02D,43361,9,17,8,38,48,1948
22018,22018,B207D5D3140535CF644F21B83755D02D,10471,20,23,3,37,48,1898
22019,22019,6CC3FE89A8F1A15E71D203BFCADF8D3A,11701,0,6,6,43,48,2198
22020,22020,6CC3FE89A8F1A15E71D203BFCADF8D3A,10251,7,19,12,35,47,1797
22021,22021,6CC3FE89A8F1A15E71D203BFCADF8D3A,11701,21,22,1,43,48,2198
22025,22025,52221E22AD28309A597E4174323345F2,40611,0,8,8,35,47,1797
22026,22026,52221E22AD28309A597E4174323345F2,11301,10,11,1,41,49,2099
22027,22027,52221E22AD28309A597E4174323345F2,11021,15,17,2,36,49,1849
22028,22028,52221E22AD28309A597E4174323345F2,42341,18,19,1,43,49,2199
22029,22029,52221E22AD28309A597E4174323345F2,40454,20,22,2,35,49,1799
22030,22030,A1F76E9AE160B1A2577BA1E3948B2B29,42864,0,5,5,38,44,1944
22031,22031,A1F76E9AE160B1A2577BA1E3948B2B29,42861,7,9,2,37,44,1894
22032,22032,A1F76E9AE160B1A2577BA1E3948B2B29,42864,12,14,2,38,44,1944
22033,22033,A1F76E9AE160B1A2577BA1E3948B2B29,11261,17,18,1,36,46,1846
22034,22034,A1F76E9AE160B1A2577BA1E3948B2B29,42861,18,20,2,37,44,1894
22035,22035,E0D41457C8D4504CBCFD58670A0877B7,10634,0,6,6,27,45,1395
22036,22036,E0D41457C8D4504CBCFD58670A0877B7,10351,7,9,2,28,45,1445
22037,22037,E0D41457C8D4504CBCFD58670A0877B7,11481,10,11,1,41,48,2098
22038,22038,E0D41457C8D4504CBCFD58670A0877B7,10634,13,23,10,27,45,1395
22043,22043,8AB561279CAFD673B81CFFF6F25401C3,12221,0,6,6,43,44,2194
22044,22044,8AB561279CAFD673B81CFFF6F25401C3,43011,7,9,2,40,42,2042
22045,22045,8AB561279CAFD673B81CFFF6F25401C3,13951,12,14,2,47,45,2395
22046,22046,8AB561279CAFD673B81CFFF6F25401C3,43011,15,18,3,40,42,2042
22047,22047,8AB561279CAFD673B81CFFF6F25401C3,12221,19,20,1,43,44,2194
22048,22048,C2EED89F322B08EE68257E7620F2CAA6,13841,0,10,10,40,46,2046
22049,22049,C2EED89F322B08EE68257E7620F2CAA6,43101,12,14,2,46,40,2340
22050,22050,C2EED89F322B08EE68257E7620F2CAA6,13841,15,22,7,40,46,2046
22054,22054,073EBE93660DAEAA6A02C36811E4AA2E,12381,0,12,12,32,48,1648
22055,22055,073EBE93660DAEAA6A02C36811E4AA2E,10471,13,17,4,37,48,1898
22056,22056,073EBE93660DAEAA6A02C36811E4AA2E,12381,21,23,2,32,48,1648
22057,22057,8A92802CD5A9CAF544C441DBF5EB2408,13951,0,1,1,47,45,2395
22058,22058,8A92802CD5A9CAF544C441DBF5EB2408,42091,2,16,14,43,46,2196
22059,22059,8A92802CD5A9CAF544C441DBF5EB2408,42461,16,18,2,45,47,2297
22060,22060,8A92802CD5A9CAF544C441DBF5EB2408,42201,19,20,1,43,46,2196
22064,22064,7B001ACDE2062382019107DF0DCB7334,40841,0,7,7,33,49,1699
22065,22065,7B001ACDE2062382019107DF0DCB7334,11201,9,11,2,35,49,1799
22066,22066,7B001ACDE2062382019107DF0DCB7334,42231,12,13,1,37,46,1896
22067,22067,7B001ACDE2062382019107DF0DCB7334,11201,14,17,3,35,49,1799
22068,22068,7B001ACDE2062382019107DF0DCB7334,11211,17,18,1,34,49,1749
22069,22069,7B001ACDE2062382019107DF0DCB7334,40841,19,23,4,33,49,1699
22073,22073,3A1B49B490CA109FD4D5251F0C86C9CB,43581,0,13,13,33,48,1698
22074,22074,3A1B49B490CA109FD4D5251F0C86C9CB,12601,14,16,2,25,47,1297
22075,22075,3A1B49B490CA109FD4D5251F0C86C9CB,43581,18,22,4,33,48,1698
22076,22076,0E9E7AFF4422B633BEB9D687C008FCF0,42491,0,8,8,32,46,1646
22077,22077,0E9E7AFF4422B633BEB9D687C008FCF0,42523,8,9,1,31,47,1597
22078,22078,0E9E7AFF4422B633BEB9D687C008FCF0,12311,10,13,3,30,44,1544
22079,22079,0E9E7AFF4422B633BEB9D687C008FCF0,42523,14,15,1,31,47,1597
22080,22080,0E9E7AFF4422B633BEB9D687C008FCF0,43761,16,19,3,32,47,1647
22081,22081,0E9E7AFF4422B633BEB9D687C008FCF0,10341,21,23,2,31,47,1597
22085,22085,75B1706710DBB7B243F1BFC47F521F2D,11021,1,7,6,36,49,1849
22086,22086,75B1706710DBB7B243F1BFC47F521F2D,40341,9,11,2,23,49,1199
22087,22087,75B1706710DBB7B243F1BFC47F521F2D,11021,12,18,6,36,49,1849
22091,22091,C1664BA564BC8FF7C20F47733006D06C,40302,0,7,7,40,49,2049
22092,22092,C1664BA564BC8FF7C20F47733006D06C,40101,8,10,2,34,49,1749
22093,22093,C1664BA564BC8FF7C20F47733006D06C,40302,21,23,2,40,49,2049
22094,22094,39E88EB570EB659FFBD649910A2018DF,42201,0,2,2,43,46,2196
22095,22095,39E88EB570EB659FFBD649910A2018DF,42111,4,14,10,44,46,2246
22096,22096,39E88EB570EB659FFBD649910A2018DF,13951,15,17,2,47,45,2395
22097,22097,39E88EB570EB659FFBD649910A2018DF,42111,18,19,1,44,46,2246
22098,22098,39E88EB570EB659FFBD649910A2018DF,42201,21,22,1,43,46,2196
22102,22102,EC23EBB773BEE6584AEE775EDF4B82A4,16151,0,13,13,13,11,661
22103,22103,EC23EBB773BEE6584AEE775EDF4B82A4,15145,15,18,3,22,9,1109
22104,22104,EC23EBB773BEE6584AEE775EDF4B82A4,16151,18,20,2,13,11,661
22105,22105,5AF7A250F769DD424B6F153B49B360AA,11331,0,7,7,37,48,1898
22106,22106,5AF7A250F769DD424B6F153B49B360AA,12601,8,14,6,25,47,1297
22107,22107,5AF7A250F769DD424B6F153B49B360AA,11731,18,23,5,36,48,1848
22112,22112,C5C866B840AB1E710A19532E1F1DAD43,42523,0,6,6,31,47,1597
22113,22113,C5C866B840AB1E710A19532E1F1DAD43,43181,8,9,1,39,48,1998
22114,22114,C5C866B840AB1E710A19532E1F1DAD43,42523,13,23,10,31,47,1597
22115,22115,A0A012149D97D44E003E2426A046D4A2,13651,0,13,13,30,47,1547
22116,22116,A0A012149D97D44E003E2426A046D4A2,42161,13,14,1,36,47,1847
22117,22117,A0A012149D97D44E003E2426A046D4A2,13651,15,23,8,30,47,1547
22129,22129,C8FB6DD91273145B18290C22A7A7A7B5,42311,0,6,6,41,46,2096
22130,22130,C8FB6DD91273145B18290C22A7A7A7B5,10521,6,7,1,41,47,2097
22131,22131,C8FB6DD91273145B18290C22A7A7A7B5,12641,10,11,1,10,43,543
22132,22132,C8FB6DD91273145B18290C22A7A7A7B5,19931,16,20,4,7,43,393
22136,22136,110523D3A36CC62B4CCBD8B06189C155,10781,0,10,10,35,47,1797
22137,22137,110523D3A36CC62B4CCBD8B06189C155,42161,14,18,4,36,47,1847
22138,22138,110523D3A36CC62B4CCBD8B06189C155,13791,19,23,4,42,47,2147
22139,22139,0A252836FA6DFCFDFC50B5267919BF05,43021,0,2,2,16,43,843
22140,22140,0A252836FA6DFCFDFC50B5267919BF05,12641,4,10,6,10,43,543
22141,22141,0A252836FA6DFCFDFC50B5267919BF05,43021,12,23,11,16,43,843
22142,22142,963B5B270E1CFE03DCA262EB3B40F063,41031,0,8,8,32,49,1649
22143,22143,963B5B270E1CFE03DCA262EB3B40F063,42231,8,11,3,37,46,1896
22144,22144,963B5B270E1CFE03DCA262EB3B40F063,13911,13,14,1,39,46,1996
22145,22145,963B5B270E1CFE03DCA262EB3B40F063,42231,14,21,7,37,46,1896
22149,22149,439D8CB010A4086802C0243322BA6C31,11061,0,7,7,29,48,1498
22150,22150,439D8CB010A4086802C0243322BA6C31,40343,10,17,7,24,49,1249
22151,22151,439D8CB010A4086802C0243322BA6C31,10251,21,23,2,35,47,1797
22152,22152,481E0074549879C8BF16A88D1586ADE0,42071,1,2,1,31,49,1599
22153,22153,481E0074549879C8BF16A88D1586ADE0,42623,3,4,1,22,49,1149
22154,22154,481E0074549879C8BF16A88D1586ADE0,42071,4,22,18,31,49,1599
22155,22155,AF85AB0F84B58F4A12483525349C1572,43121,0,6,6,25,27,1277
22156,22156,AF85AB0F84B58F4A12483525349C1572,15191,6,10,4,36,27,1827
22157,22157,AF85AB0F84B58F4A12483525349C1572,43121,11,16,5,25,27,1277
22158,22158,AF85AB0F84B58F4A12483525349C1572,15321,18,19,1,29,26,1476
22159,22159,AF85AB0F84B58F4A12483525349C1572,43121,20,23,3,25,27,1277
22171,22171,2FCC231DE348255A3F9CDA8D77EEA7DC,12581,0,6,6,24,48,1248
22172,22172,2FCC231DE348255A3F9CDA8D77EEA7DC,12051,6,9,3,20,47,1047
22173,22173,2FCC231DE348255A3F9CDA8D77EEA7DC,12581,9,10,1,24,48,1248
22174,22174,2FCC231DE348255A3F9CDA8D77EEA7DC,42541,17,18,1,25,47,1297
22175,22175,2FCC231DE348255A3F9CDA8D77EEA7DC,12581,19,20,1,24,48,1248
22186,22186,5F3681CA154176D9C587280037CBB99D,13561,0,15,15,37,49,1899
22187,22187,5F3681CA154176D9C587280037CBB99D,13091,16,19,3,20,42,1042
22188,22188,5F3681CA154176D9C587280037CBB99D,13561,21,23,2,37,49,1899
22192,22192,A82EF40B6CA543B101BB610C92444D16,10161,0,9,9,35,49,1799
22193,22193,A82EF40B6CA543B101BB610C92444D16,40341,10,16,6,23,49,1199
22194,22194,A82EF40B6CA543B101BB610C92444D16,13511,20,23,3,34,48,1748
22195,22195,2D936AD1D5A2176A143EF0970EE2AEF0,19021,1,12,11,10,45,545
22196,22196,2D936AD1D5A2176A143EF0970EE2AEF0,43021,13,16,3,16,43,843
22197,22197,2D936AD1D5A2176A143EF0970EE2AEF0,19021,16,18,2,10,45,545
22198,22198,7EB2318BFBFA6E60DC605038F27F2530,42071,9,19,10,31,49,1599
22199,22199,7EB2318BFBFA6E60DC605038F27F2530,42623,20,21,1,22,49,1149
22200,22200,7EB2318BFBFA6E60DC605038F27F2530,42071,22,23,1,31,49,1599
22204,22204,6674D07D10608B5E348782D3250F103A,11381,0,1,1,30,47,1547
22205,22205,6674D07D10608B5E348782D3250F103A,10951,2,3,1,29,48,1498
22206,22206,6674D07D10608B5E348782D3250F103A,11381,5,16,11,30,47,1547
22207,22207,6674D07D10608B5E348782D3250F103A,42521,19,20,1,31,47,1597
22208,22208,6674D07D10608B5E348782D3250F103A,11381,21,23,2,30,47,1547
22209,22209,BEEAA3B87171A5B1C7DAD529B35430CD,13111,1,8,7,42,46,2146
22210,22210,BEEAA3B87171A5B1C7DAD529B35430CD,42381,10,11,1,39,41,1991
22211,22211,BEEAA3B87171A5B1C7DAD529B35430CD,13111,14,15,1,42,46,2146
22212,22212,BEEAA3B87171A5B1C7DAD529B35430CD,42623,18,19,1,22,49,1149
22216,22216,FCB3F67711CEBAA3447F5F56A47CDE2C,41031,0,8,8,32,49,1649
22217,22217,FCB3F67711CEBAA3447F5F56A47CDE2C,11021,8,14,6,36,49,1849
22218,22218,FCB3F67711CEBAA3447F5F56A47CDE2C,42801,15,17,2,40,49,2049
22219,22219,FCB3F67711CEBAA3447F5F56A47CDE2C,11061,18,19,1,29,48,1498
22220,22220,FCB3F67711CEBAA3447F5F56A47CDE2C,41031,21,22,1,32,49,1649
22227,22227,840BBB6A2B02773021BB5F8ED5812B92,11074,2,9,7,37,47,1897
22228,22228,840BBB6A2B02773021BB5F8ED5812B92,13481,12,14,2,26,31,1331
22229,22229,840BBB6A2B02773021BB5F8ED5812B92,11074,15,19,4,37,47,1897
22230,22230,840BBB6A2B02773021BB5F8ED5812B92,10381,20,21,1,31,49,1599
22235,22235,172F302F5199600F927C0E74978E3B3A,42401,0,7,7,36,47,1847
22236,22236,172F302F5199600F927C0E74978E3B3A,13911,9,10,1,39,46,1996
22237,22237,172F302F5199600F927C0E74978E3B3A,42401,11,13,2,36,47,1847
22238,22238,172F302F5199600F927C0E74978E3B3A,10111,14,15,1,37,47,1897
22239,22239,172F302F5199600F927C0E74978E3B3A,42771,16,19,3,36,47,1847
22243,22243,C416994B9DC2E3F8C8BB43A19558B9AA,16281,1,6,5,11,4,554
22244,22244,C416994B9DC2E3F8C8BB43A19558B9AA,15143,7,9,2,18,7,907
22245,22245,C416994B9DC2E3F8C8BB43A19558B9AA,16281,9,11,2,11,4,554
22246,22246,C416994B9DC2E3F8C8BB43A19558B9AA,15081,11,13,2,27,1,1351
22247,22247,C416994B9DC2E3F8C8BB43A19558B9AA,15143,14,16,2,18,7,907
22248,22248,C416994B9DC2E3F8C8BB43A19558B9AA,16431,20,23,3,8,6,406
22249,22249,135EF939D99CED11694D71795A5772B0,19031,5,10,5,1,42,92
22250,22250,135EF939D99CED11694D71795A5772B0,12641,10,11,1,10,43,543
22251,22251,135EF939D99CED11694D71795A5772B0,19031,11,16,5,1,42,92
22252,22252,135EF939D99CED11694D71795A5772B0,12641,16,18,2,10,43,543
22253,22253,135EF939D99CED11694D71795A5772B0,19031,19,23,4,1,42,92
22254,22254,0EC1D2502267B7D6F36C8EA9D8EC3DDA,10171,0,7,7,26,47,1347
22255,22255,0EC1D2502267B7D6F36C8EA9D8EC3DDA,11001,9,16,7,42,47,2147
22256,22256,0EC1D2502267B7D6F36C8EA9D8EC3DDA,10171,18,23,5,26,47,1347
22257,22257,93FF4AA9CB8426C5B12228AD84154DEC,12083,0,9,9,36,49,1849
22258,22258,93FF4AA9CB8426C5B12228AD84154DEC,10901,12,15,3,35,48,1798
22259,22259,93FF4AA9CB8426C5B12228AD84154DEC,10721,17,18,1,31,48,1598
22260,22260,93FF4AA9CB8426C5B12228AD84154DEC,10431,19,23,4,33,49,1699
22261,22261,94659C4C1B1A469E566B81B441E10C1D,10841,0,14,14,37,47,1897
22262,22262,94659C4C1B1A469E566B81B441E10C1D,11301,15,16,1,41,49,2099
22263,22263,94659C4C1B1A469E566B81B441E10C1D,11074,19,23,4,37,47,1897
22264,22264,D96201B04F49DA8FE5B344343C2EC845,10501,3,5,2,22,46,1146
22265,22265,D96201B04F49DA8FE5B344343C2EC845,11861,5,15,10,32,47,1647
22266,22266,D96201B04F49DA8FE5B344343C2EC845,42151,17,22,5,35,45,1795
22270,22270,9397083C419903E30A62F5C06D299D5C,42381,1,5,4,39,41,1991
22271,22271,9397083C419903E30A62F5C06D299D5C,43451,7,9,2,37,40,1890
22272,22272,9397083C419903E30A62F5C06D299D5C,42151,10,11,1,35,45,1795
22273,22273,9397083C419903E30A62F5C06D299D5C,42381,12,23,11,39,41,1991
22277,22277,0B63E5F4C6BAABFD3157EB6DEAD83AE0,10231,1,8,7,39,49,1999
22278,22278,0B63E5F4C6BAABFD3157EB6DEAD83AE0,10471,11,12,1,37,48,1898
22279,22279,0B63E5F4C6BAABFD3157EB6DEAD83AE0,10107,13,14,1,38,49,1949
22280,22280,0B63E5F4C6BAABFD3157EB6DEAD83AE0,42381,15,18,3,39,41,1991
22281,22281,0B63E5F4C6BAABFD3157EB6DEAD83AE0,10471,21,22,1,37,48,1898
22291,22291,4DDBC8A3158AB8C770BE44DD5AC774BB,41393,0,8,8,43,49,2199
22292,22292,4DDBC8A3158AB8C770BE44DD5AC774BB,11794,12,14,2,38,49,1949
22293,22293,4DDBC8A3158AB8C770BE44DD5AC774BB,11231,14,16,2,37,49,1899
22294,22294,4DDBC8A3158AB8C770BE44DD5AC774BB,10924,16,23,7,43,49,2199
22295,22295,4BEB96C1A6F8B99181CDADEF48D75275,42501,0,6,6,28,47,1447
22296,22296,4BEB96C1A6F8B99181CDADEF48D75275,40343,6,19,13,24,49,1249
22297,22297,4BEB96C1A6F8B99181CDADEF48D75275,42501,20,23,3,28,47,1447
22298,22298,217E6EEB3DA820F7605484800E559E70,12121,1,6,5,29,47,1497
22299,22299,217E6EEB3DA820F7605484800E559E70,12581,9,13,4,24,48,1248
22300,22300,217E6EEB3DA820F7605484800E559E70,42481,17,18,1,22,49,1149
22301,22301,217E6EEB3DA820F7605484800E559E70,12121,19,21,2,29,47,1497
22302,22302,0DC30FA0CCDAD859C724130675369152,42351,2,9,7,38,45,1945
22303,22303,0DC30FA0CCDAD859C724130675369152,12211,10,11,1,41,44,2094
22304,22304,0DC30FA0CCDAD859C724130675369152,42351,12,13,1,38,45,1945
22305,22305,0DC30FA0CCDAD859C724130675369152,42864,15,16,1,38,44,1944
22306,22306,0DC30FA0CCDAD859C724130675369152,42351,19,20,1,38,45,1945
22307,22307,BCCA36AC6DE92B5D284204C1D312B82A,43161,0,6,6,35,47,1797
22308,22308,BCCA36AC6DE92B5D284204C1D312B82A,42801,8,14,6,40,49,2049
22309,22309,BCCA36AC6DE92B5D284204C1D312B82A,43161,18,23,5,35,47,1797
22310,22310,3885379CE5BB0B5FB9D47D881E0A9F37,10221,0,15,15,34,49,1749
22311,22311,3885379CE5BB0B5FB9D47D881E0A9F37,42121,20,21,1,26,49,1349
22312,22312,3885379CE5BB0B5FB9D47D881E0A9F37,10221,22,23,1,34,49,1749
22319,22319,7C46E639818D9018A7FC0F2856E8C040,42021,1,10,9,33,47,1697
22320,22320,7C46E639818D9018A7FC0F2856E8C040,42541,13,15,2,25,47,1297
22321,22321,7C46E639818D9018A7FC0F2856E8C040,40341,16,18,2,23,49,1199
22322,22322,7C46E639818D9018A7FC0F2856E8C040,11861,19,21,2,32,47,1647
22323,22323,7C46E639818D9018A7FC0F2856E8C040,42021,21,22,1,33,47,1697
22324,22324,906075D6233195F1F9099F6FBB81286D,42523,0,10,10,31,47,1597
22325,22325,906075D6233195F1F9099F6FBB81286D,11381,10,12,2,30,47,1547
22326,22326,906075D6233195F1F9099F6FBB81286D,42523,15,17,2,31,47,1597
22327,22327,906075D6233195F1F9099F6FBB81286D,11531,18,19,1,34,49,1749
22328,22328,906075D6233195F1F9099F6FBB81286D,11201,20,21,1,35,49,1799
22340,22340,487315C9A10EA017D67B443311820F7A,12401,0,8,8,39,49,1999
22341,22341,487315C9A10EA017D67B443311820F7A,11914,9,18,9,37,48,1898
22342,22342,487315C9A10EA017D67B443311820F7A,11751,19,21,2,35,48,1798
22343,22343,487315C9A10EA017D67B443311820F7A,12401,22,23,1,39,49,1999
22344,22344,B3B2A62E38CBAF40B040383E801282C5,11521,1,6,5,41,48,2098
22345,22345,B3B2A62E38CBAF40B040383E801282C5,42981,7,8,1,36,49,1849
22346,22346,B3B2A62E38CBAF40B040383E801282C5,12131,9,13,4,32,47,1647
22347,22347,B3B2A62E38CBAF40B040383E801282C5,10731,13,15,2,33,47,1697
22348,22348,B3B2A62E38CBAF40B040383E801282C5,10107,16,17,1,38,49,1949
22349,22349,B3B2A62E38CBAF40B040383E801282C5,12131,20,22,2,32,47,1647
22350,22350,76F7C446B68B6BBABD2F117088E4326D,42501,0,5,5,28,47,1447
22351,22351,76F7C446B68B6BBABD2F117088E4326D,10171,6,7,1,26,47,1347
22352,22352,76F7C446B68B6BBABD2F117088E4326D,11061,15,16,1,29,48,1498
22353,22353,76F7C446B68B6BBABD2F117088E4326D,12031,18,20,2,33,48,1698
22354,22354,96B398BCE821D0E1508347A9D7207669,19931,0,2,2,7,43,393
22355,22355,96B398BCE821D0E1508347A9D7207669,12641,2,3,1,10,43,543
22356,22356,96B398BCE821D0E1508347A9D7207669,19931,3,4,1,7,43,393
22357,22357,96B398BCE821D0E1508347A9D7207669,12641,8,9,1,10,43,543
22358,22358,96B398BCE821D0E1508347A9D7207669,19931,11,18,7,7,43,393
22359,22359,96B398BCE821D0E1508347A9D7207669,12641,21,23,2,10,43,543
22363,22363,F1249E9F0C0E4CFC8DF3A999C283E2E8,42151,0,8,8,35,45,1795
22364,22364,F1249E9F0C0E4CFC8DF3A999C283E2E8,10351,9,10,1,28,45,1445
22365,22365,F1249E9F0C0E4CFC8DF3A999C283E2E8,10634,15,18,3,27,45,1395
22366,22366,F1249E9F0C0E4CFC8DF3A999C283E2E8,42151,19,20,1,35,45,1795
22370,22370,405425CB3107629C743592DE469E38AA,42581,0,10,10,38,48,1948
22371,22371,405425CB3107629C743592DE469E38AA,11811,12,13,1,38,49,1949
22372,22372,405425CB3107629C743592DE469E38AA,42581,14,16,2,38,48,1948
22373,22373,405425CB3107629C743592DE469E38AA,11914,16,18,2,37,48,1898
22374,22374,405425CB3107629C743592DE469E38AA,42581,21,23,2,38,48,1948
22386,22386,9C5B279BE1C036865CD2D3C2701CEF63,10151,5,6,1,34,47,1747
22387,22387,9C5B279BE1C036865CD2D3C2701CEF63,10951,9,16,7,29,48,1498
22388,22388,9C5B279BE1C036865CD2D3C2701CEF63,10171,16,18,2,26,47,1347
22389,22389,8EC6592A5302140A9CA2CC55F2BCF8B9,42201,0,4,4,43,46,2196
22390,22390,8EC6592A5302140A9CA2CC55F2BCF8B9,42351,4,5,1,38,45,1945
22391,22391,8EC6592A5302140A9CA2CC55F2BCF8B9,42201,6,7,1,43,46,2196
22392,22392,8EC6592A5302140A9CA2CC55F2BCF8B9,10471,19,20,1,37,48,1898
22393,22393,8EC6592A5302140A9CA2CC55F2BCF8B9,42201,21,23,2,43,46,2196
22400,22400,B6E7C171F31AC83E97D52FCA6843D257,11201,9,12,3,35,49,1799
22401,22401,B6E7C171F31AC83E97D52FCA6843D257,10681,15,16,1,30,48,1548
22402,22402,B6E7C171F31AC83E97D52FCA6843D257,11521,21,22,1,41,48,2098
22403,22403,ACE6CA8B487669BE8A7949AA7EA2747D,12381,1,11,10,32,48,1648
22404,22404,ACE6CA8B487669BE8A7949AA7EA2747D,10331,14,16,2,39,46,1996
22405,22405,ACE6CA8B487669BE8A7949AA7EA2747D,11201,17,23,6,35,49,1799
22412,22412,61CBFACD57158ABA503BBDE9C9C5FD95,42071,0,8,8,31,49,1599
22413,22413,61CBFACD57158ABA503BBDE9C9C5FD95,42623,11,13,2,22,49,1149
22414,22414,61CBFACD57158ABA503BBDE9C9C5FD95,42071,13,23,10,31,49,1599
22421,22421,D14484DB6515E86DA2EC37443AB9F264,12211,0,6,6,41,44,2094
22422,22422,D14484DB6515E86DA2EC37443AB9F264,11261,10,12,2,36,46,1846
22423,22423,D14484DB6515E86DA2EC37443AB9F264,10841,12,13,1,37,47,1897
22424,22424,D14484DB6515E86DA2EC37443AB9F264,13911,16,17,1,39,46,1996
22425,22425,D14484DB6515E86DA2EC37443AB9F264,11261,18,21,3,36,46,1846
22426,22426,07815E504E2AE025D7C40FE3C561B8BA,11074,0,7,7,37,47,1897
22427,22427,07815E504E2AE025D7C40FE3C561B8BA,10151,9,10,1,34,47,1747
22428,22428,07815E504E2AE025D7C40FE3C561B8BA,42491,12,13,1,32,46,1646
22429,22429,07815E504E2AE025D7C40FE3C561B8BA,10841,16,23,7,37,47,1897
22433,22433,A6FED4E386822DEAD939F8507075DAA9,11061,0,11,11,29,48,1498
22434,22434,A6FED4E386822DEAD939F8507075DAA9,11151,11,14,3,30,48,1548
22435,22435,A6FED4E386822DEAD939F8507075DAA9,10901,16,18,2,35,48,1798
22436,22436,A6FED4E386822DEAD939F8507075DAA9,11151,18,23,5,30,48,1548
22444,22444,66E04FE458E7F0A691F219A1307BA20F,19111,0,6,6,9,45,495
22445,22445,66E04FE458E7F0A691F219A1307BA20F,42041,7,10,3,10,47,547
22446,22446,66E04FE458E7F0A691F219A1307BA20F,43751,14,15,1,19,48,998
22447,22447,66E04FE458E7F0A691F219A1307BA20F,19441,20,22,2,8,46,446
22448,22448,A6A800017064C84269444E9C91FE0895,11061,1,6,5,29,48,1498
22449,22449,A6A800017064C84269444E9C91FE0895,10211,8,9,1,16,49,849
22450,22450,A6A800017064C84269444E9C91FE0895,11061,12,13,1,29,48,1498
22451,22451,A6A800017064C84269444E9C91FE0895,11151,13,15,2,30,48,1548
22452,22452,A6A800017064C84269444E9C91FE0895,11861,19,21,2,32,47,1647
22453,22453,78520B675436202D640A52F7BAC3D2C7,12792,0,8,8,34,30,1730
22454,22454,78520B675436202D640A52F7BAC3D2C7,15391,8,10,2,35,26,1776
22455,22455,78520B675436202D640A52F7BAC3D2C7,12792,10,14,4,34,30,1730
22456,22456,78520B675436202D640A52F7BAC3D2C7,15391,19,20,1,35,26,1776
22457,22457,78520B675436202D640A52F7BAC3D2C7,12792,21,22,1,34,30,1730
22458,22458,DBE56CF804EFF98F06EBBF480586FC01,43021,3,16,13,16,43,843
22459,22459,DBE56CF804EFF98F06EBBF480586FC01,12921,16,17,1,9,41,491
22460,22460,DBE56CF804EFF98F06EBBF480586FC01,43021,18,22,4,16,43,843
22467,22467,6504F1F0C122D0816D84E7F4E32ECF8A,13651,0,7,7,30,47,1547
22468,22468,6504F1F0C122D0816D84E7F4E32ECF8A,10785,15,16,1,35,47,1797
22469,22469,6504F1F0C122D0816D84E7F4E32ECF8A,12381,20,22,2,32,48,1648
22470,22470,1211E691D3C595AFBB037C54F55B9F54,43161,2,6,4,35,47,1797
22471,22471,1211E691D3C595AFBB037C54F55B9F54,42161,6,8,2,36,47,1847
22472,22472,1211E691D3C595AFBB037C54F55B9F54,43161,9,12,3,35,47,1797
22473,22473,1211E691D3C595AFBB037C54F55B9F54,42161,15,18,3,36,47,1847
22474,22474,1211E691D3C595AFBB037C54F55B9F54,10251,20,21,1,35,47,1797
22487,22487,31343C404ECDF84B7682C8839FAEA457,10634,1,7,6,27,45,1395
22488,22488,31343C404ECDF84B7682C8839FAEA457,11061,10,11,1,29,48,1498
22489,22489,31343C404ECDF84B7682C8839FAEA457,40341,13,16,3,23,49,1199
22490,22490,31343C404ECDF84B7682C8839FAEA457,11061,19,23,4,29,48,1498
22491,22491,F725A3F859B25741A70E1B3AC0517A8A,10111,1,11,10,37,47,1897
22492,22492,F725A3F859B25741A70E1B3AC0517A8A,42301,11,13,2,36,47,1847
22493,22493,F725A3F859B25741A70E1B3AC0517A8A,10111,17,19,2,37,47,1897
22494,22494,F725A3F859B25741A70E1B3AC0517A8A,42301,20,22,2,36,47,1847
22495,22495,F725A3F859B25741A70E1B3AC0517A8A,10111,22,23,1,37,47,1897
22507,22507,1439D71C3B1C0FF45CC1AED4C666D5BA,13071,0,8,8,41,41,2091
22508,22508,1439D71C3B1C0FF45CC1AED4C666D5BA,12521,13,14,1,35,41,1791
22509,22509,1439D71C3B1C0FF45CC1AED4C666D5BA,13071,18,23,5,41,41,2091
22510,22510,C6BEDB0AA22911E7502A9397AAD03007,11301,0,7,7,41,49,2099
22511,22511,C6BEDB0AA22911E7502A9397AAD03007,40302,8,9,1,40,49,2049
22512,22512,C6BEDB0AA22911E7502A9397AAD03007,11481,9,10,1,41,48,2098
22513,22513,C6BEDB0AA22911E7502A9397AAD03007,40341,15,17,2,23,49,1199
22514,22514,C6BEDB0AA22911E7502A9397AAD03007,11061,18,19,1,29,48,1498
22515,22515,C6BEDB0AA22911E7502A9397AAD03007,11301,21,23,2,41,49,2099
22516,22516,6C7DE4B4696563CBDA9D3C6E4FCAB652,10341,0,8,8,31,47,1597
22517,22517,6C7DE4B4696563CBDA9D3C6E4FCAB652,10292,8,12,4,30,47,1547
22518,22518,6C7DE4B4696563CBDA9D3C6E4FCAB652,10341,17,18,1,31,47,1597
22519,22519,6C7DE4B4696563CBDA9D3C6E4FCAB652,42141,18,19,1,32,47,1647
22520,22520,6C7DE4B4696563CBDA9D3C6E4FCAB652,42523,20,23,3,31,47,1597
22521,22521,21D3B5E0C9E50D70FF4672218EBA9699,42851,8,10,2,35,41,1791
22522,22522,21D3B5E0C9E50D70FF4672218EBA9699,12671,11,18,7,21,43,1093
22523,22523,21D3B5E0C9E50D70FF4672218EBA9699,12761,19,21,2,25,40,1290
22524,22524,21D3B5E0C9E50D70FF4672218EBA9699,12671,22,23,1,21,43,1093
22525,22525,441E401293D6FFC8E080552D376784E1,42581,0,4,4,38,48,1948
22526,22526,441E401293D6FFC8E080552D376784E1,11914,6,11,5,37,48,1898
22527,22527,441E401293D6FFC8E080552D376784E1,40171,14,17,3,38,48,1948
22528,22528,441E401293D6FFC8E080552D376784E1,11914,18,21,3,37,48,1898
22529,22529,441E401293D6FFC8E080552D376784E1,42581,22,23,1,38,48,1948
22530,22530,0AA9A21AE5592E43C5386C31A83CC971,11021,0,7,7,36,49,1849
22531,22531,0AA9A21AE5592E43C5386C31A83CC971,11751,8,13,5,35,48,1798
22532,22532,0AA9A21AE5592E43C5386C31A83CC971,40951,14,19,5,36,49,1849
22533,22533,0AA9A21AE5592E43C5386C31A83CC971,11751,20,21,1,35,48,1798
22534,22534,0AA9A21AE5592E43C5386C31A83CC971,11021,22,23,1,36,49,1849
22535,22535,5408DC5B0AFBD23C3FA2E4CCFD3A9C81,42633,0,6,6,42,46,2146
22536,22536,5408DC5B0AFBD23C3FA2E4CCFD3A9C81,11261,6,16,10,36,46,1846
22537,22537,5408DC5B0AFBD23C3FA2E4CCFD3A9C81,42633,21,23,2,42,46,2146
22538,22538,03FE0D0BD52A528C1B4DF1F3C44F085B,43241,1,5,4,36,46,1846
22539,22539,03FE0D0BD52A528C1B4DF1F3C44F085B,11941,6,9,3,37,46,1896
22540,22540,03FE0D0BD52A528C1B4DF1F3C44F085B,42351,11,13,2,38,45,1945
22541,22541,03FE0D0BD52A528C1B4DF1F3C44F085B,11941,15,17,2,37,46,1896
22542,22542,03FE0D0BD52A528C1B4DF1F3C44F085B,42351,20,23,3,38,45,1945
22547,22547,636D66B9C2DD39D28485A7810A6E1528,12381,1,18,17,32,48,1648
22548,22548,636D66B9C2DD39D28485A7810A6E1528,42971,19,20,1,43,49,2199
22549,22549,636D66B9C2DD39D28485A7810A6E1528,12381,21,23,2,32,48,1648
22560,22560,A447A45B90D6E3A14CAE8CC78AAACCC0,11701,0,7,7,43,48,2198
22561,22561,A447A45B90D6E3A14CAE8CC78AAACCC0,19021,13,15,2,10,45,545
22562,22562,A447A45B90D6E3A14CAE8CC78AAACCC0,42091,17,19,2,43,46,2196
22563,22563,A447A45B90D6E3A14CAE8CC78AAACCC0,11701,22,23,1,43,48,2198
22564,22564,370BEBFAF0F07D0E48A05EAAA57C2ED7,42141,0,6,6,32,47,1647
22565,22565,370BEBFAF0F07D0E48A05EAAA57C2ED7,10351,9,10,1,28,45,1445
22566,22566,370BEBFAF0F07D0E48A05EAAA57C2ED7,10634,13,18,5,27,45,1395
22567,22567,86744C480C3CB5BC297A6B62B8E5C276,12311,0,6,6,30,44,1544
22568,22568,86744C480C3CB5BC297A6B62B8E5C276,10151,8,10,2,34,47,1747
22569,22569,86744C480C3CB5BC297A6B62B8E5C276,12311,12,23,11,30,44,1544
22579,22579,3CDE88E41494ADADB515291429110B2E,12511,0,2,2,39,47,1997
22580,22580,3CDE88E41494ADADB515291429110B2E,43481,2,13,11,39,48,1998
22581,22581,3CDE88E41494ADADB515291429110B2E,10801,14,16,2,42,47,2147
22582,22582,3CDE88E41494ADADB515291429110B2E,10901,18,21,3,35,48,1798
22583,22583,3CDE88E41494ADADB515291429110B2E,43481,21,22,1,39,48,1998
22584,22584,0D594301700CDDCA20283C1D86002F67,12971,1,6,5,32,48,1648
22585,22585,0D594301700CDDCA20283C1D86002F67,11806,7,9,2,41,48,2098
22586,22586,0D594301700CDDCA20283C1D86002F67,12971,12,14,2,32,48,1648
22587,22587,0D594301700CDDCA20283C1D86002F67,13381,15,18,3,39,47,1997
22588,22588,0D594301700CDDCA20283C1D86002F67,12971,19,20,1,32,48,1648
22589,22589,A9FAA4B4C51A5D14416D1899F40B6E9A,19801,0,2,2,19,26,976
22590,22590,A9FAA4B4C51A5D14416D1899F40B6E9A,13481,5,7,2,26,31,1331
22591,22591,A9FAA4B4C51A5D14416D1899F40B6E9A,19801,8,23,15,19,26,976
22592,22592,79AB37E4BA910BB73519FC84F2A35B1A,12641,1,11,10,10,43,543
22593,22593,79AB37E4BA910BB73519FC84F2A35B1A,12921,13,21,8,9,41,491
22594,22594,79AB37E4BA910BB73519FC84F2A35B1A,43021,21,23,2,16,43,843
22595,22595,4FB3AE7B67BAD2FEBD4AEC56147A5602,42401,0,4,4,36,47,1847
22596,22596,4FB3AE7B67BAD2FEBD4AEC56147A5602,10251,4,9,5,35,47,1797
22597,22597,4FB3AE7B67BAD2FEBD4AEC56147A5602,40673,13,14,1,36,48,1848
22598,22598,4FB3AE7B67BAD2FEBD4AEC56147A5602,10251,14,16,2,35,47,1797
22599,22599,4FB3AE7B67BAD2FEBD4AEC56147A5602,13511,18,19,1,34,48,1748
22600,22600,4FB3AE7B67BAD2FEBD4AEC56147A5602,10251,21,23,2,35,47,1797
22601,22601,DF034F57FA5C1FCBE0179C4156624820,13511,0,6,6,34,48,1748
22602,22602,DF034F57FA5C1FCBE0179C4156624820,11381,7,12,5,30,47,1547
22603,22603,DF034F57FA5C1FCBE0179C4156624820,13511,12,13,1,34,48,1748
22604,22604,DF034F57FA5C1FCBE0179C4156624820,10951,14,17,3,29,48,1498
22605,22605,DF034F57FA5C1FCBE0179C4156624820,13511,20,21,1,34,48,1748
22606,22606,DF034F57FA5C1FCBE0179C4156624820,10491,22,23,1,33,48,1698
22607,22607,A2DD7BA75FCE1B5306A377D198F94491,15391,0,5,5,35,26,1776
22608,22608,A2DD7BA75FCE1B5306A377D198F94491,12792,5,15,10,34,30,1730
22609,22609,A2DD7BA75FCE1B5306A377D198F94491,15091,18,23,5,35,26,1776
22616,22616,1DD1A250791E8DE9D0B949B1DAE230C8,11861,0,13,13,32,47,1647
22617,22617,1DD1A250791E8DE9D0B949B1DAE230C8,42021,14,15,1,33,47,1697
22618,22618,1DD1A250791E8DE9D0B949B1DAE230C8,10281,15,17,2,33,48,1698
22619,22619,1DD1A250791E8DE9D0B949B1DAE230C8,11861,17,20,3,32,47,1647
22620,22620,1DD1A250791E8DE9D0B949B1DAE230C8,10151,20,23,3,34,47,1747
22621,22621,AB57CFBC7FBBD1B4F46C04046F726522,15171,0,6,6,42,21,2121
22622,22622,AB57CFBC7FBBD1B4F46C04046F726522,12881,7,10,3,47,22,2372
22623,22623,AB57CFBC7FBBD1B4F46C04046F726522,15021,14,15,1,46,18,2318
22624,22624,AB57CFBC7FBBD1B4F46C04046F726522,15171,20,22,2,42,21,2121
22625,22625,0CEDFC599FE515911C8AF1ADD0F867C7,42301,6,8,2,36,47,1847
22626,22626,0CEDFC599FE515911C8AF1ADD0F867C7,42511,9,10,1,37,47,1897
22627,22627,0CEDFC599FE515911C8AF1ADD0F867C7,42301,10,12,2,36,47,1847
22628,22628,0CEDFC599FE515911C8AF1ADD0F867C7,10841,15,19,4,37,47,1897
22629,22629,0CEDFC599FE515911C8AF1ADD0F867C7,42301,19,21,2,36,47,1847
22630,22630,A87D8419360267EB29F6BFB17A04E1F8,13011,0,8,8,39,47,1997
22631,22631,A87D8419360267EB29F6BFB17A04E1F8,12561,10,14,4,45,43,2293
22632,22632,A87D8419360267EB29F6BFB17A04E1F8,13371,17,19,2,41,47,2097
22633,22633,A87D8419360267EB29F6BFB17A04E1F8,12481,20,23,3,37,49,1899
22643,22643,ADCFA7AD0066907CE67A8137B2428AD5,42121,7,12,5,26,49,1349
22644,22644,ADCFA7AD0066907CE67A8137B2428AD5,10451,13,15,2,25,48,1298
22645,22645,ADCFA7AD0066907CE67A8137B2428AD5,13731,21,23,2,33,49,1699
22650,22650,D65B56CD876348E28FA444869EDB5DD6,10111,0,13,13,37,47,1897
22651,22651,D65B56CD876348E28FA444869EDB5DD6,42381,15,17,2,39,41,1991
22652,22652,D65B56CD876348E28FA444869EDB5DD6,10111,19,23,4,37,47,1897
22653,22653,E675A65705B47E64E764764AA7201F3F,15561,0,6,6,32,22,1622
22654,22654,E675A65705B47E64E764764AA7201F3F,15411,7,20,13,44,27,2227
22655,22655,E675A65705B47E64E764764AA7201F3F,12611,21,22,1,41,29,2079
22663,22663,8C54F679DD59F109DAF19BDB41D1658A,10711,0,18,18,29,46,1496
22664,22664,8C54F679DD59F109DAF19BDB41D1658A,40341,19,22,3,23,49,1199
22665,22665,8C54F679DD59F109DAF19BDB41D1658A,12971,22,23,1,32,48,1648
22679,22679,51F0E62050E7626D9F0BB439C4D3A24F,11811,1,6,5,38,49,1949
22680,22680,51F0E62050E7626D9F0BB439C4D3A24F,10471,7,9,2,37,48,1898
22681,22681,51F0E62050E7626D9F0BB439C4D3A24F,10841,11,14,3,37,47,1897
22682,22682,51F0E62050E7626D9F0BB439C4D3A24F,10491,16,19,3,33,48,1698
22683,22683,51F0E62050E7626D9F0BB439C4D3A24F,11811,22,23,1,38,49,1949
22684,22684,88FE361D84BF34DD1AB79F3DA14ADA96,43281,0,1,1,37,48,1898
22685,22685,88FE361D84BF34DD1AB79F3DA14ADA96,11231,1,10,9,37,49,1899
22686,22686,88FE361D84BF34DD1AB79F3DA14ADA96,43281,11,17,6,37,48,1898
22687,22687,88FE361D84BF34DD1AB79F3DA14ADA96,11461,18,19,1,37,49,1899
22688,22688,88FE361D84BF34DD1AB79F3DA14ADA96,10471,21,23,2,37,48,1898
22693,22693,EC01E891D59C95928B2003366B117F4E,40277,0,7,7,35,49,1799
22694,22694,EC01E891D59C95928B2003366B117F4E,10401,8,14,6,33,49,1699
22695,22695,EC01E891D59C95928B2003366B117F4E,11871,15,20,5,29,46,1496
22696,22696,EC01E891D59C95928B2003366B117F4E,40277,20,23,3,35,49,1799
22697,22697,FABAC504C25A76E20AB282D8B04C1F8D,11381,0,7,7,30,47,1547
22698,22698,FABAC504C25A76E20AB282D8B04C1F8D,43311,8,10,2,31,48,1598
22699,22699,FABAC504C25A76E20AB282D8B04C1F8D,10491,10,13,3,33,48,1698
22700,22700,FABAC504C25A76E20AB282D8B04C1F8D,12661,17,19,2,32,45,1645
22701,22701,FABAC504C25A76E20AB282D8B04C1F8D,11381,22,23,1,30,47,1547
22702,22702,5507696F58BC6418FBC190B0A108A918,19114,0,5,5,7,43,393
22703,22703,5507696F58BC6418FBC190B0A108A918,19571,7,9,2,1,36,86
22704,22704,5507696F58BC6418FBC190B0A108A918,10251,11,12,1,35,47,1797
22705,22705,5507696F58BC6418FBC190B0A108A918,19571,16,17,1,1,36,86
22706,22706,5507696F58BC6418FBC190B0A108A918,19114,20,23,3,7,43,393
22707,22707,B4384B03AA2ADCFD4B5B44E462DB395A,42141,0,6,6,32,47,1647
22708,22708,B4384B03AA2ADCFD4B5B44E462DB395A,42523,6,11,5,31,47,1597
22709,22709,B4384B03AA2ADCFD4B5B44E462DB395A,43761,11,14,3,32,47,1647
22710,22710,B4384B03AA2ADCFD4B5B44E462DB395A,42523,14,18,4,31,47,1597
22711,22711,B4384B03AA2ADCFD4B5B44E462DB395A,42141,20,22,2,32,47,1647
22712,22712,0C3B0F465A7BDE89311DCA3821959FAE,10924,0,7,7,43,49,2199
22713,22713,0C3B0F465A7BDE89311DCA3821959FAE,11541,16,17,1,35,49,1799
22714,22714,0C3B0F465A7BDE89311DCA3821959FAE,10191,17,19,2,40,48,2048
22715,22715,0C3B0F465A7BDE89311DCA3821959FAE,10924,19,22,3,43,49,2199
22716,22716,334215C8018B9C59A4BC561FC24FF2FA,12611,3,5,2,41,29,2079
22717,22717,334215C8018B9C59A4BC561FC24FF2FA,15411,7,10,3,44,27,2227
22718,22718,334215C8018B9C59A4BC561FC24FF2FA,12611,11,12,1,41,29,2079
22719,22719,334215C8018B9C59A4BC561FC24FF2FA,15411,13,18,5,44,27,2227
22720,22720,92D731B11080166AE9677089A81E2175,10491,0,14,14,33,48,1698
22721,22721,92D731B11080166AE9677089A81E2175,42971,17,19,2,43,49,2199
22722,22722,92D731B11080166AE9677089A81E2175,10491,20,23,3,33,48,1698
22734,22734,3B843905DBA028028A69F37DCACAA60A,11861,8,12,4,32,47,1647
22735,22735,3B843905DBA028028A69F37DCACAA60A,10211,14,15,1,16,49,849
22736,22736,3B843905DBA028028A69F37DCACAA60A,19441,16,17,1,8,46,446
22737,22737,3B843905DBA028028A69F37DCACAA60A,10211,18,19,1,16,49,849
22738,22738,1FF80D2D93D85E7E7CD7674A4424222F,43501,0,8,8,27,48,1398
22739,22739,1FF80D2D93D85E7E7CD7674A4424222F,49201,12,13,1,7,41,391
22740,22740,1FF80D2D93D85E7E7CD7674A4424222F,12921,13,14,1,9,41,491
22741,22741,1FF80D2D93D85E7E7CD7674A4424222F,43501,18,21,3,27,48,1398
22742,22742,D2729AB4C70132F423F41A3669BBCC53,42521,0,5,5,31,47,1597
22743,22743,D2729AB4C70132F423F41A3669BBCC53,43761,9,15,6,32,47,1647
22744,22744,D2729AB4C70132F423F41A3669BBCC53,19801,18,19,1,19,26,976
22745,22745,D2729AB4C70132F423F41A3669BBCC53,43761,21,23,2,32,47,1647
22746,22746,1B914EA19E608B834149612681BFDCB4,43011,3,5,2,40,42,2042
22747,22747,1B914EA19E608B834149612681BFDCB4,12221,9,11,2,43,44,2194
22748,22748,1B914EA19E608B834149612681BFDCB4,43011,11,14,3,40,42,2042
22749,22749,1B914EA19E608B834149612681BFDCB4,12221,17,19,2,43,44,2194
22758,22758,086873B6FDDAA95F5D97B0E7D1FDE099,12514,1,13,12,38,47,1947
22759,22759,086873B6FDDAA95F5D97B0E7D1FDE099,12651,15,16,1,43,47,2197
22760,22760,086873B6FDDAA95F5D97B0E7D1FDE099,40402,20,23,3,41,46,2096
22764,22764,0769BE090F00FC081F24F992941EA3B4,10521,1,7,6,41,47,2097
22765,22765,0769BE090F00FC081F24F992941EA3B4,42031,11,17,6,40,46,2046
22766,22766,0769BE090F00FC081F24F992941EA3B4,40341,19,22,3,23,49,1199
22767,22767,9871A4E75F73236F4B956DD429010B52,16311,0,9,9,2,11,111
22768,22768,9871A4E75F73236F4B956DD429010B52,16233,14,15,1,5,15,265
22769,22769,9871A4E75F73236F4B956DD429010B52,16311,19,23,4,2,11,111
22770,22770,4D40F212167D9F23A44F0067C577F303,42161,6,7,1,36,47,1847
22771,22771,4D40F212167D9F23A44F0067C577F303,10251,7,12,5,35,47,1797
22772,22772,4D40F212167D9F23A44F0067C577F303,42161,13,15,2,36,47,1847
22773,22773,4D40F212167D9F23A44F0067C577F303,10251,15,17,2,35,47,1797
22774,22774,4D40F212167D9F23A44F0067C577F303,10881,18,19,1,34,48,1748
22775,22775,4D40F212167D9F23A44F0067C577F303,40636,20,23,3,35,48,1798
22776,22776,BBCB9918D42B41DEDF16DD7F5A9BE26F,11861,0,10,10,32,47,1647
22777,22777,BBCB9918D42B41DEDF16DD7F5A9BE26F,42161,10,11,1,36,47,1847
22778,22778,BBCB9918D42B41DEDF16DD7F5A9BE26F,11331,12,16,4,37,48,1898
22779,22779,BBCB9918D42B41DEDF16DD7F5A9BE26F,11861,17,23,6,32,47,1647
22788,22788,A5267560F8241F40BFCB325C4ADBB18D,42871,0,6,6,30,45,1545
22789,22789,A5267560F8241F40BFCB325C4ADBB18D,12601,9,12,3,25,47,1297
22790,22790,A5267560F8241F40BFCB325C4ADBB18D,10351,12,14,2,28,45,1445
22791,22791,A5267560F8241F40BFCB325C4ADBB18D,12601,14,23,9,25,47,1297
22792,22792,331736FE71666B7814EF475D313271C7,12641,0,1,1,10,43,543
22793,22793,331736FE71666B7814EF475D313271C7,19031,16,18,2,1,42,92
22794,22794,331736FE71666B7814EF475D313271C7,12641,19,23,4,10,43,543
22795,22795,1BDF0107A2327F38B6DA40C46E3EA795,10451,1,7,6,25,48,1298
22796,22796,1BDF0107A2327F38B6DA40C46E3EA795,42121,9,12,3,26,49,1349
22797,22797,1BDF0107A2327F38B6DA40C46E3EA795,10451,12,13,1,25,48,1298
22798,22798,1BDF0107A2327F38B6DA40C46E3EA795,13731,21,22,1,33,49,1699
22805,22805,5B005239AD91B224060A740123F8C94E,13231,1,3,2,39,46,1996
22806,22806,5B005239AD91B224060A740123F8C94E,42231,4,5,1,37,46,1896
22807,22807,5B005239AD91B224060A740123F8C94E,13231,8,9,1,39,46,1996
22808,22808,5B005239AD91B224060A740123F8C94E,42231,17,18,1,37,46,1896
22809,22809,5B005239AD91B224060A740123F8C94E,13231,21,22,1,39,46,1996
22810,22810,FA73CEEF86E3045F96788E3868F3C71A,10161,1,9,8,35,49,1799
22811,22811,FA73CEEF86E3045F96788E3868F3C71A,12141,10,12,2,42,45,2145
22812,22812,FA73CEEF86E3045F96788E3868F3C71A,11331,13,18,5,37,48,1898
22813,22813,FA73CEEF86E3045F96788E3868F3C71A,40341,20,22,2,23,49,1199
22814,22814,55C510C52B18398823C2B84BE6C85384,13711,0,1,1,38,46,1946
22815,22815,55C510C52B18398823C2B84BE6C85384,42231,1,3,2,37,46,1896
22816,22816,55C510C52B18398823C2B84BE6C85384,13711,7,9,2,38,46,1946
22817,22817,55C510C52B18398823C2B84BE6C85384,42231,11,14,3,37,46,1896
22818,22818,55C510C52B18398823C2B84BE6C85384,13711,14,17,3,38,46,1946
22819,22819,55C510C52B18398823C2B84BE6C85384,42231,19,20,1,37,46,1896
22826,22826,15351107348D533F1A62174A9ED24724,13314,0,7,7,31,39,1589
22827,22827,15351107348D533F1A62174A9ED24724,12521,7,16,9,35,41,1791
22828,22828,15351107348D533F1A62174A9ED24724,13314,21,23,2,31,39,1589
22829,22829,5BC86F424BAF4B877A98262DEDE87053,12971,0,2,2,32,48,1648
22830,22830,5BC86F424BAF4B877A98262DEDE87053,11021,3,12,9,36,49,1849
22831,22831,5BC86F424BAF4B877A98262DEDE87053,10221,13,15,2,34,49,1749
22832,22832,5BC86F424BAF4B877A98262DEDE87053,11201,15,23,8,35,49,1799
22833,22833,98BA7F3F4273010D1D66E32FADA4A17B,43751,0,13,13,19,48,998
22834,22834,98BA7F3F4273010D1D66E32FADA4A17B,12581,15,16,1,24,48,1248
22835,22835,98BA7F3F4273010D1D66E32FADA4A17B,43751,19,23,4,19,48,998
22836,22836,58F88D24C8D34253C1CFFF1E39E8BF81,10681,0,10,10,30,48,1548
22837,22837,58F88D24C8D34253C1CFFF1E39E8BF81,40341,11,14,3,23,49,1199
22838,22838,58F88D24C8D34253C1CFFF1E39E8BF81,11061,17,18,1,29,48,1498
22839,22839,58F88D24C8D34253C1CFFF1E39E8BF81,10681,19,21,2,30,48,1548
22848,22848,012D304B65BB1C01DC9FFE26FE6AEE56,10111,1,6,5,37,47,1897
22849,22849,012D304B65BB1C01DC9FFE26FE6AEE56,13511,7,10,3,34,48,1748
22850,22850,012D304B65BB1C01DC9FFE26FE6AEE56,11531,14,17,3,34,49,1749
22851,22851,012D304B65BB1C01DC9FFE26FE6AEE56,11861,19,20,1,32,47,1647
22852,22852,012D304B65BB1C01DC9FFE26FE6AEE56,11591,21,23,2,36,49,1849
22856,22856,220A83B4C0760D0CE7D499DE7174338C,11324,0,7,7,31,46,1596
22857,22857,220A83B4C0760D0CE7D499DE7174338C,42401,8,9,1,36,47,1847
22858,22858,220A83B4C0760D0CE7D499DE7174338C,11011,10,11,1,39,49,1999
22859,22859,220A83B4C0760D0CE7D499DE7174338C,11331,13,14,1,37,48,1898
22860,22860,220A83B4C0760D0CE7D499DE7174338C,10781,15,17,2,35,47,1797
22861,22861,220A83B4C0760D0CE7D499DE7174338C,11324,19,22,3,31,46,1596
22865,22865,6A5315660D9B469BEC66B2E434056CB6,10431,0,8,8,33,49,1699
22866,22866,6A5315660D9B469BEC66B2E434056CB6,10251,9,11,2,35,47,1797
22867,22867,6A5315660D9B469BEC66B2E434056CB6,42401,11,14,3,36,47,1847
22868,22868,6A5315660D9B469BEC66B2E434056CB6,10431,17,22,5,33,49,1699
22869,22869,9F22CEAACF5F9765BA896D571A934437,43021,1,5,4,16,43,843
22870,22870,9F22CEAACF5F9765BA896D571A934437,12121,6,7,1,29,47,1497
22871,22871,9F22CEAACF5F9765BA896D571A934437,12921,7,9,2,9,41,491
22872,22872,9F22CEAACF5F9765BA896D571A934437,43021,10,11,1,16,43,843
22873,22873,9F22CEAACF5F9765BA896D571A934437,12921,12,13,1,9,41,491
22874,22874,9F22CEAACF5F9765BA896D571A934437,43021,18,19,1,16,43,843
22878,22878,7308A861032DD6CDA204025A180927B9,42371,0,1,1,34,46,1746
22879,22879,7308A861032DD6CDA204025A180927B9,42151,1,6,5,35,45,1795
22880,22880,7308A861032DD6CDA204025A180927B9,12311,6,13,7,30,44,1544
22881,22881,7308A861032DD6CDA204025A180927B9,42151,14,22,8,35,45,1795
22882,22882,085A54B112E93B58F53705ABE7F444E7,13471,0,2,2,47,49,2399
22883,22883,085A54B112E93B58F53705ABE7F444E7,43621,7,11,4,46,48,2348
22884,22884,085A54B112E93B58F53705ABE7F444E7,13471,12,14,2,47,49,2399
22885,22885,085A54B112E93B58F53705ABE7F444E7,42601,20,21,1,44,48,2248
22886,22886,085A54B112E93B58F53705ABE7F444E7,13471,21,22,1,47,49,2399
22891,22891,97F9A42E560FA1C6BC3CCFDCCF400455,11231,0,9,9,37,49,1899
22892,22892,97F9A42E560FA1C6BC3CCFDCCF400455,42621,11,13,2,24,49,1249
22893,22893,97F9A42E560FA1C6BC3CCFDCCF400455,11231,16,23,7,37,49,1899
22897,22897,A4F650955D0F2E8B3DBCA61C267939BC,13651,0,13,13,30,47,1547
22898,22898,A4F650955D0F2E8B3DBCA61C267939BC,10781,16,19,3,35,47,1797
22899,22899,A4F650955D0F2E8B3DBCA61C267939BC,13651,20,23,3,30,47,1547
22920,22920,5540EC4B9A79A2803AEA3D2399D9018F,43061,1,7,6,43,46,2196
22921,22921,5540EC4B9A79A2803AEA3D2399D9018F,13671,10,11,1,27,43,1393
22922,22922,5540EC4B9A79A2803AEA3D2399D9018F,11261,12,23,11,36,46,1846
22930,22930,7A880FE847C48EF3051E04A866E8ED9A,10251,1,2,1,35,47,1797
22931,22931,7A880FE847C48EF3051E04A866E8ED9A,42971,3,8,5,43,49,2199
22932,22932,7A880FE847C48EF3051E04A866E8ED9A,11031,8,11,3,42,49,2149
22933,22933,7A880FE847C48EF3051E04A866E8ED9A,10191,16,17,1,40,48,2048
22934,22934,7A880FE847C48EF3051E04A866E8ED9A,11741,20,22,2,42,49,2149
22938,22938,FD96223C1268D365CA71DF0247C96272,11061,1,13,12,29,48,1498
22939,22939,FD96223C1268D365CA71DF0247C96272,11211,14,15,1,34,49,1749
22940,22940,FD96223C1268D365CA71DF0247C96272,11061,19,21,2,29,48,1498
22941,22941,487F2816BBDBF1A2F07D97C22CB5ADD7,40463,0,7,7,38,49,1949
22942,22942,487F2816BBDBF1A2F07D97C22CB5ADD7,41271,8,15,7,38,48,1948
22943,22943,487F2816BBDBF1A2F07D97C22CB5ADD7,43731,18,21,3,34,47,1747
22944,22944,6F2B87364A5FB9C5DFEF11838C9DD6DB,12311,0,3,3,30,44,1544
22945,22945,6F2B87364A5FB9C5DFEF11838C9DD6DB,42861,6,15,9,37,44,1894
22946,22946,6F2B87364A5FB9C5DFEF11838C9DD6DB,13671,20,22,2,27,43,1393
22950,22950,1030D8F4FE8CF10A7F5B83AE8CE6624F,42401,0,5,5,36,47,1847
22951,22951,1030D8F4FE8CF10A7F5B83AE8CE6624F,11331,8,9,1,37,48,1898
22952,22952,1030D8F4FE8CF10A7F5B83AE8CE6624F,40637,10,12,2,36,47,1847
22953,22953,1030D8F4FE8CF10A7F5B83AE8CE6624F,11331,12,14,2,37,48,1898
22954,22954,1030D8F4FE8CF10A7F5B83AE8CE6624F,42401,18,23,5,36,47,1847
22961,22961,ECC55A41DE7DF4FF6A356DE1634B0C55,19264,0,5,5,10,36,536
22962,22962,ECC55A41DE7DF4FF6A356DE1634B0C55,19261,9,12,3,6,37,337
22963,22963,ECC55A41DE7DF4FF6A356DE1634B0C55,19264,13,14,1,10,36,536
22964,22964,ECC55A41DE7DF4FF6A356DE1634B0C55,19261,16,17,1,6,37,337
22965,22965,ECC55A41DE7DF4FF6A356DE1634B0C55,19264,21,23,2,10,36,536
22966,22966,1C60CB0F57E29CF26D99169B6CE00B11,11381,0,8,8,30,47,1547
22967,22967,1C60CB0F57E29CF26D99169B6CE00B11,42161,9,11,2,36,47,1847
22968,22968,1C60CB0F57E29CF26D99169B6CE00B11,10971,14,17,3,35,47,1797
22969,22969,1C60CB0F57E29CF26D99169B6CE00B11,43361,19,23,4,38,48,1948
22970,22970,D1667DF22993F8505FC05C3A153D0F71,13651,1,3,2,30,47,1547
22971,22971,D1667DF22993F8505FC05C3A153D0F71,11875,3,4,1,30,46,1546
22972,22972,D1667DF22993F8505FC05C3A153D0F71,13651,5,6,1,30,47,1547
22973,22973,D1667DF22993F8505FC05C3A153D0F71,13671,14,19,5,27,43,1393
22974,22974,D1667DF22993F8505FC05C3A153D0F71,10381,21,22,1,31,49,1599
22979,22979,64FF3E93355E6DCA29977E04D316EABA,42471,0,11,11,35,49,1799
22980,22980,64FF3E93355E6DCA29977E04D316EABA,11531,16,17,1,34,49,1749
22981,22981,64FF3E93355E6DCA29977E04D316EABA,12083,17,19,2,36,49,1849
22982,22982,64FF3E93355E6DCA29977E04D316EABA,11531,19,20,1,34,49,1749
22983,22983,64FF3E93355E6DCA29977E04D316EABA,40673,21,23,2,36,48,1848
22988,22988,CA9F3291ABF3939E405884AD2ABE2445,11651,0,7,7,33,47,1697
22989,22989,CA9F3291ABF3939E405884AD2ABE2445,10107,15,17,2,38,49,1949
22990,22990,CA9F3291ABF3939E405884AD2ABE2445,11651,19,23,4,33,47,1697
22995,22995,414AA00EC00DAA3D830C87A4F3E4DD09,11861,0,10,10,32,47,1647
22996,22996,414AA00EC00DAA3D830C87A4F3E4DD09,10121,12,21,9,36,49,1849
22997,22997,414AA00EC00DAA3D830C87A4F3E4DD09,10151,22,23,1,34,47,1747
23001,23001,1D20B498D42204F7DA0BA75047AF3620,11271,0,8,8,37,48,1898
23002,23002,1D20B498D42204F7DA0BA75047AF3620,12971,8,10,2,32,48,1648
23003,23003,1D20B498D42204F7DA0BA75047AF3620,11271,11,19,8,37,48,1898
23004,23004,1D20B498D42204F7DA0BA75047AF3620,11954,19,21,2,32,49,1649
23008,23008,CE3F81446CD14A2DF1A7AFAE577526FC,11061,1,7,6,29,48,1498
23009,23009,CE3F81446CD14A2DF1A7AFAE577526FC,11381,9,16,7,30,47,1547
23010,23010,CE3F81446CD14A2DF1A7AFAE577526FC,11061,18,19,1,29,48,1498
23011,23011,CE3F81446CD14A2DF1A7AFAE577526FC,11631,22,23,1,12,49,649
23015,23015,B102C0DE74C332B825BA73D2F1843F9F,11151,4,14,10,30,48,1548
23016,23016,B102C0DE74C332B825BA73D2F1843F9F,11531,17,18,1,34,49,1749
23017,23017,B102C0DE74C332B825BA73D2F1843F9F,11151,21,23,2,30,48,1548
23018,23018,C56F88E442CA52D12F7DED656C94C0A5,42231,0,5,5,37,46,1896
23019,23019,C56F88E442CA52D12F7DED656C94C0A5,13911,6,10,4,39,46,1996
23020,23020,C56F88E442CA52D12F7DED656C94C0A5,42231,11,12,1,37,46,1896
23021,23021,C56F88E442CA52D12F7DED656C94C0A5,13911,15,18,3,39,46,1996
23022,23022,C56F88E442CA52D12F7DED656C94C0A5,42231,19,23,4,37,46,1896
23026,23026,2013A24F073FAEF6693722C97CB5FD3E,11431,0,9,9,29,47,1497
23027,23027,2013A24F073FAEF6693722C97CB5FD3E,11061,11,13,2,29,48,1498
23028,23028,2013A24F073FAEF6693722C97CB5FD3E,11381,14,15,1,30,47,1547
23029,23029,2013A24F073FAEF6693722C97CB5FD3E,11061,18,19,1,29,48,1498
23030,23030,2013A24F073FAEF6693722C97CB5FD3E,10107,21,22,1,38,49,1949
23037,23037,0D9AA89290D1F445356B85B4B256A343,11001,2,6,4,42,47,2147
23038,23038,0D9AA89290D1F445356B85B4B256A343,10811,7,9,2,38,46,1946
23039,23039,0D9AA89290D1F445356B85B4B256A343,11001,12,14,2,42,47,2147
23040,23040,0D9AA89290D1F445356B85B4B256A343,10811,15,17,2,38,46,1946
23041,23041,0D9AA89290D1F445356B85B4B256A343,13941,19,22,3,41,47,2097
23042,23042,BA91B9470249EAFC3720D0B9152253D7,41631,0,8,8,28,47,1447
23043,23043,BA91B9470249EAFC3720D0B9152253D7,13651,8,10,2,30,47,1547
23044,23044,BA91B9470249EAFC3720D0B9152253D7,42501,12,14,2,28,47,1447
23045,23045,BA91B9470249EAFC3720D0B9152253D7,42771,15,16,1,36,47,1847
23046,23046,BA91B9470249EAFC3720D0B9152253D7,42501,17,19,2,28,47,1447
23047,23047,BA91B9470249EAFC3720D0B9152253D7,13651,20,21,1,30,47,1547
23048,23048,BA91B9470249EAFC3720D0B9152253D7,11061,22,23,1,29,48,1498
23049,23049,883DFAEC3F162850CD6BAEF4493650A8,10731,0,7,7,33,47,1697
23050,23050,883DFAEC3F162850CD6BAEF4493650A8,10231,12,14,2,39,49,1999
23051,23051,883DFAEC3F162850CD6BAEF4493650A8,10731,15,19,4,33,47,1697
23052,23052,883DFAEC3F162850CD6BAEF4493650A8,11011,20,22,2,39,49,1999
23070,23070,247BAFEF3667203D5C3609ED1200A56F,10716,10,12,2,30,46,1546
23071,23071,247BAFEF3667203D5C3609ED1200A56F,42471,14,20,6,35,49,1799
23072,23072,247BAFEF3667203D5C3609ED1200A56F,11261,21,23,2,36,46,1846
23076,23076,487A62E76A99728DF0C08197456F9487,12521,1,9,8,35,41,1791
23077,23077,487A62E76A99728DF0C08197456F9487,16071,12,13,1,3,3,153
23078,23078,487A62E76A99728DF0C08197456F9487,11541,15,17,2,35,49,1799
23079,23079,487A62E76A99728DF0C08197456F9487,10191,18,23,5,40,48,2048
23086,23086,916BC4263959BF562E5C6764781E4744,12311,0,1,1,30,44,1544
23087,23087,916BC4263959BF562E5C6764781E4744,42531,4,10,6,31,45,1595
23088,23088,916BC4263959BF562E5C6764781E4744,12311,11,16,5,30,44,1544
23089,23089,916BC4263959BF562E5C6764781E4744,42531,17,19,2,31,45,1595
23090,23090,916BC4263959BF562E5C6764781E4744,12311,20,21,1,30,44,1544
23098,23098,E748F2254AC2A75A1317C0ED54387A7E,42831,0,7,7,27,48,1398
23099,23099,E748F2254AC2A75A1317C0ED54387A7E,42071,10,11,1,31,49,1599
23100,23100,E748F2254AC2A75A1317C0ED54387A7E,42831,11,13,2,27,48,1398
23101,23101,E748F2254AC2A75A1317C0ED54387A7E,10381,14,18,4,31,49,1599
23102,23102,E748F2254AC2A75A1317C0ED54387A7E,42831,18,20,2,27,48,1398
23103,23103,D70B599B2DC6AADF34C273ACBD3A4312,19571,0,1,1,1,36,86
23104,23104,D70B599B2DC6AADF34C273ACBD3A4312,42401,3,15,12,36,47,1847
23105,23105,D70B599B2DC6AADF34C273ACBD3A4312,40341,16,18,2,23,49,1199
23106,23106,D70B599B2DC6AADF34C273ACBD3A4312,42401,19,23,4,36,47,1847
23107,23107,D96C351A2D3BF2CB9C84E8F01C9997B6,19904,1,5,4,9,44,494
23108,23108,D96C351A2D3BF2CB9C84E8F01C9997B6,19021,7,8,1,10,45,545
23109,23109,D96C351A2D3BF2CB9C84E8F01C9997B6,12641,11,14,3,10,43,543
23110,23110,D96C351A2D3BF2CB9C84E8F01C9997B6,19021,15,16,1,10,45,545
23111,23111,D96C351A2D3BF2CB9C84E8F01C9997B6,12641,19,22,3,10,43,543
23112,23112,404DDDC348C1422DB089F959259F7CED,11841,0,10,10,33,46,1696
23113,23113,404DDDC348C1422DB089F959259F7CED,10151,15,16,1,34,47,1747
23114,23114,404DDDC348C1422DB089F959259F7CED,40171,17,18,1,38,48,1948
23115,23115,404DDDC348C1422DB089F959259F7CED,10281,19,23,4,33,48,1698
23116,23116,44AA91905A7E8DBC24B0A51CC88C9204,42151,0,3,3,35,45,1795
23117,23117,44AA91905A7E8DBC24B0A51CC88C9204,42531,5,10,5,31,45,1595
23118,23118,44AA91905A7E8DBC24B0A51CC88C9204,42151,11,13,2,35,45,1795
23119,23119,44AA91905A7E8DBC24B0A51CC88C9204,42531,13,19,6,31,45,1595
23120,23120,44AA91905A7E8DBC24B0A51CC88C9204,12311,21,23,2,30,44,1544
23121,23121,229D7F28D40B520A93ABA27B13E559D2,40891,0,9,9,37,47,1897
23122,23122,229D7F28D40B520A93ABA27B13E559D2,11151,10,11,1,30,48,1548
23123,23123,229D7F28D40B520A93ABA27B13E559D2,10841,14,23,9,37,47,1897
23127,23127,6799040E1EB4DE2B70177F4DB8B9E92C,13071,1,4,3,41,41,2091
23128,23128,6799040E1EB4DE2B70177F4DB8B9E92C,43451,5,7,2,37,40,1890
23129,23129,6799040E1EB4DE2B70177F4DB8B9E92C,42381,7,10,3,39,41,1991
23130,23130,6799040E1EB4DE2B70177F4DB8B9E92C,13071,16,17,1,41,41,2091
23131,23131,6799040E1EB4DE2B70177F4DB8B9E92C,43451,19,23,4,37,40,1890
23132,23132,192E43D3C90BEA44284C74625E1B7A8A,13271,0,9,9,41,47,2097
23133,23133,192E43D3C90BEA44284C74625E1B7A8A,13351,11,12,1,48,48,2448
23134,23134,192E43D3C90BEA44284C74625E1B7A8A,11801,16,18,2,42,48,2148
23135,23135,192E43D3C90BEA44284C74625E1B7A8A,13271,19,23,4,41,47,2097
23136,23136,96B100113D40E22B39686C026F5DA397,42864,0,6,6,38,44,1944
23137,23137,96B100113D40E22B39686C026F5DA397,11261,8,12,4,36,46,1846
23138,23138,96B100113D40E22B39686C026F5DA397,42864,12,15,3,38,44,1944
23139,23139,96B100113D40E22B39686C026F5DA397,11261,17,18,1,36,46,1846
23140,23140,96B100113D40E22B39686C026F5DA397,42864,19,20,1,38,44,1944
23141,23141,96B100113D40E22B39686C026F5DA397,11231,20,22,2,37,49,1899
23146,23146,C783F573219BE815B78681C436E8AC03,11875,1,7,6,30,46,1546
23147,23147,C783F573219BE815B78681C436E8AC03,12601,8,16,8,25,47,1297
23148,23148,C783F573219BE815B78681C436E8AC03,11871,21,23,2,29,46,1496
23149,23149,BBA32475D3085E8E51FFD381A56F9DBA,13314,0,10,10,31,39,1589
23150,23150,BBA32475D3085E8E51FFD381A56F9DBA,11211,13,15,2,34,49,1749
23151,23151,BBA32475D3085E8E51FFD381A56F9DBA,11201,16,20,4,35,49,1799
23152,23152,E129E250452098C10CCF7A03E7B60A11,42261,4,6,2,25,49,1299
23153,23153,E129E250452098C10CCF7A03E7B60A11,42071,7,9,2,31,49,1599
23154,23154,E129E250452098C10CCF7A03E7B60A11,42121,11,12,1,26,49,1349
23155,23155,E129E250452098C10CCF7A03E7B60A11,42071,14,19,5,31,49,1599
23159,23159,EDBEDCDD3729803D79956D4495DD48D8,11261,2,6,4,36,46,1846
23160,23160,EDBEDCDD3729803D79956D4495DD48D8,42864,6,7,1,38,44,1944
23161,23161,EDBEDCDD3729803D79956D4495DD48D8,11261,11,12,1,36,46,1846
23162,23162,EDBEDCDD3729803D79956D4495DD48D8,42861,16,17,1,37,44,1894
23163,23163,EDBEDCDD3729803D79956D4495DD48D8,11261,18,20,2,36,46,1846
23167,23167,9732AAAE01C1D221A25A4D45059565D7,10924,0,7,7,43,49,2199
23168,23168,9732AAAE01C1D221A25A4D45059565D7,10231,9,10,1,39,49,1999
23169,23169,9732AAAE01C1D221A25A4D45059565D7,19901,14,18,4,7,44,394
23173,23173,09111B635170EC4072310ADB48522169,10161,0,15,15,35,49,1799
23174,23174,09111B635170EC4072310ADB48522169,11021,17,18,1,36,49,1849
23175,23175,09111B635170EC4072310ADB48522169,42971,19,21,2,43,49,2199
23176,23176,3821B66A00758CF4502F36B7CE2D17D9,43011,0,1,1,40,42,2042
23177,23177,3821B66A00758CF4502F36B7CE2D17D9,43451,1,3,2,37,40,1890
23178,23178,3821B66A00758CF4502F36B7CE2D17D9,12491,7,17,10,36,43,1843
23179,23179,3821B66A00758CF4502F36B7CE2D17D9,43451,19,20,1,37,40,1890
23180,23180,23ABF703203C13FF4E7D4138F071B5BC,11914,0,7,7,37,48,1898
23181,23181,23ABF703203C13FF4E7D4138F071B5BC,42861,8,9,1,37,44,1894
23182,23182,23ABF703203C13FF4E7D4138F071B5BC,11331,11,13,2,37,48,1898
23183,23183,23ABF703203C13FF4E7D4138F071B5BC,42861,13,14,1,37,44,1894
23184,23184,23ABF703203C13FF4E7D4138F071B5BC,11914,17,23,6,37,48,1898
23185,23185,74EBB90FA1C414F58477B49370E7F73F,11861,0,6,6,32,47,1647
23186,23186,74EBB90FA1C414F58477B49370E7F73F,12311,7,14,7,30,44,1544
23187,23187,74EBB90FA1C414F58477B49370E7F73F,11861,18,23,5,32,47,1647
23188,23188,14BBDB0704CF0D2FD157B3B84AED470A,43761,0,17,17,32,47,1647
23189,23189,14BBDB0704CF0D2FD157B3B84AED470A,42511,18,20,2,37,47,1897
23190,23190,14BBDB0704CF0D2FD157B3B84AED470A,42471,22,23,1,35,49,1799
23191,23191,0E002027D741B8AED4EE58E469659344,12601,0,14,14,25,47,1297
23192,23192,0E002027D741B8AED4EE58E469659344,10061,14,16,2,20,46,1046
23193,23193,0E002027D741B8AED4EE58E469659344,10501,20,23,3,22,46,1146
23200,23200,639EA486291B8A87A84D90343A87732A,10451,0,8,8,25,48,1298
23201,23201,639EA486291B8A87A84D90343A87732A,11791,11,12,1,38,49,1949
23202,23202,639EA486291B8A87A84D90343A87732A,11801,15,16,1,42,48,2148
23203,23203,639EA486291B8A87A84D90343A87732A,10451,20,23,3,25,48,1298
23204,23204,59C9891991D18AB42F5CA2A676EAFEE0,42501,0,8,8,28,47,1447
23205,23205,59C9891991D18AB42F5CA2A676EAFEE0,19441,13,15,2,8,46,446
23206,23206,59C9891991D18AB42F5CA2A676EAFEE0,42501,17,23,6,28,47,1447
23207,23207,CFB5B91AB0CD7543884ADBE535AD19D6,43021,3,5,2,16,43,843
23208,23208,CFB5B91AB0CD7543884ADBE535AD19D6,12641,7,11,4,10,43,543
23209,23209,CFB5B91AB0CD7543884ADBE535AD19D6,43021,12,17,5,16,43,843
23210,23210,CFB5B91AB0CD7543884ADBE535AD19D6,12921,19,21,2,9,41,491
23211,23211,6B748AE049D3A90C84556BB4A991266E,13111,0,2,2,42,46,2146
23212,23212,6B748AE049D3A90C84556BB4A991266E,11001,4,5,1,42,47,2147
23213,23213,6B748AE049D3A90C84556BB4A991266E,13271,6,16,10,41,47,2097
23214,23214,6B748AE049D3A90C84556BB4A991266E,13111,16,18,2,42,46,2146
23215,23215,6B748AE049D3A90C84556BB4A991266E,13271,19,20,1,41,47,2097
23216,23216,2BDE8FA893331A6AAEB29301A411BFB4,11541,0,2,2,35,49,1799
23217,23217,2BDE8FA893331A6AAEB29301A411BFB4,10281,2,6,4,33,48,1698
23218,23218,2BDE8FA893331A6AAEB29301A411BFB4,43761,9,22,13,32,47,1647
23222,23222,50ECD847200B52350C144A0DCA259D4D,12641,0,1,1,10,43,543
23223,23223,50ECD847200B52350C144A0DCA259D4D,12921,2,6,4,9,41,491
23224,23224,50ECD847200B52350C144A0DCA259D4D,12641,9,10,1,10,43,543
23225,23225,50ECD847200B52350C144A0DCA259D4D,19181,12,14,2,8,40,440
23226,23226,50ECD847200B52350C144A0DCA259D4D,12921,14,23,9,9,41,491
23227,23227,186CF3F72BF5BCEFF09B67C038E3D167,10331,0,7,7,39,46,1996
23228,23228,186CF3F72BF5BCEFF09B67C038E3D167,10381,10,11,1,31,49,1599
23229,23229,186CF3F72BF5BCEFF09B67C038E3D167,10121,12,13,1,36,49,1849
23230,23230,186CF3F72BF5BCEFF09B67C038E3D167,10331,14,20,6,39,46,1996
23235,23235,E859A0BF6FB37F9B42DF06EC7EE8FF9D,42461,0,6,6,45,47,2297
23236,23236,E859A0BF6FB37F9B42DF06EC7EE8FF9D,42321,7,8,1,43,47,2197
23237,23237,E859A0BF6FB37F9B42DF06EC7EE8FF9D,42461,9,11,2,45,47,2297
23238,23238,E859A0BF6FB37F9B42DF06EC7EE8FF9D,42321,12,15,3,43,47,2197
23239,23239,E859A0BF6FB37F9B42DF06EC7EE8FF9D,42461,18,22,4,45,47,2297
23240,23240,48BFDAC45FFDDC1EE0721263D1AD77D7,42511,0,7,7,37,47,1897
23241,23241,48BFDAC45FFDDC1EE0721263D1AD77D7,10107,7,9,2,38,49,1949
23242,23242,48BFDAC45FFDDC1EE0721263D1AD77D7,12381,11,14,3,32,48,1648
23243,23243,48BFDAC45FFDDC1EE0721263D1AD77D7,10251,14,16,2,35,47,1797
23244,23244,48BFDAC45FFDDC1EE0721263D1AD77D7,10841,17,23,6,37,47,1897
23245,23245,5FA17670CF7B34EAE6DE8FBA5C753F49,11834,0,8,8,32,45,1645
23246,23246,5FA17670CF7B34EAE6DE8FBA5C753F49,10721,11,13,2,31,48,1598
23247,23247,5FA17670CF7B34EAE6DE8FBA5C753F49,11491,15,16,1,36,47,1847
23248,23248,5FA17670CF7B34EAE6DE8FBA5C753F49,10107,17,19,2,38,49,1949
23249,23249,5FA17670CF7B34EAE6DE8FBA5C753F49,42531,22,23,1,31,45,1595
23250,23250,BBFBED4560EF4AFE11B68B05EA0321A4,43011,0,18,18,40,42,2042
23251,23251,BBFBED4560EF4AFE11B68B05EA0321A4,11261,19,21,2,36,46,1846
23252,23252,BBFBED4560EF4AFE11B68B05EA0321A4,43011,22,23,1,40,42,2042
23259,23259,C21368AEF2B1627E369E83844CDD61BF,42051,0,6,6,42,48,2148
23260,23260,C21368AEF2B1627E369E83844CDD61BF,11701,14,16,2,43,48,2198
23261,23261,C21368AEF2B1627E369E83844CDD61BF,10221,17,19,2,34,49,1749
23262,23262,C21368AEF2B1627E369E83844CDD61BF,10191,22,23,1,40,48,2048
23270,23270,565E911568BF499034CE3AB0C1F32A25,42231,0,14,14,37,46,1896
23271,23271,565E911568BF499034CE3AB0C1F32A25,13311,16,17,1,27,39,1389
23272,23272,565E911568BF499034CE3AB0C1F32A25,42231,20,23,3,37,46,1896
23273,23273,48E848BEC812456E7DD8396BAFEE6761,10801,0,16,16,42,47,2147
23274,23274,48E848BEC812456E7DD8396BAFEE6761,11074,16,18,2,37,47,1897
23275,23275,48E848BEC812456E7DD8396BAFEE6761,11491,18,20,2,36,47,1847
23276,23276,0700EE450626D71DB77FED542493F969,11061,6,15,9,29,48,1498
23277,23277,0700EE450626D71DB77FED542493F969,40341,16,18,2,23,49,1199
23278,23278,0700EE450626D71DB77FED542493F969,43391,22,23,1,29,48,1498
23279,23279,5B1C0BC031C302008BE737E10A20E45F,10421,0,11,11,41,48,2098
23280,23280,5B1C0BC031C302008BE737E10A20E45F,13101,11,12,1,40,47,2047
23281,23281,5B1C0BC031C302008BE737E10A20E45F,13771,16,18,2,21,45,1095
23282,23282,5B1C0BC031C302008BE737E10A20E45F,10151,20,23,3,34,47,1747
23298,23298,990F89A555478F97C2E0E123BB133187,49201,0,8,8,7,41,391
23299,23299,990F89A555478F97C2E0E123BB133187,12921,9,11,2,9,41,491
23300,23300,990F89A555478F97C2E0E123BB133187,49201,14,15,1,7,41,391
23301,23301,990F89A555478F97C2E0E123BB133187,19181,15,20,5,8,40,440
23302,23302,990F89A555478F97C2E0E123BB133187,12921,21,22,1,9,41,491
23303,23303,3BA5FA710EA7575C057415E520D57C01,10221,3,4,1,34,49,1749
23304,23304,3BA5FA710EA7575C057415E520D57C01,13101,6,8,2,40,47,2047
23305,23305,3BA5FA710EA7575C057415E520D57C01,10111,13,23,10,37,47,1897
23306,23306,D72B55960EF782CD78E5D61FC88F7FD0,10491,0,7,7,33,48,1698
23307,23307,D72B55960EF782CD78E5D61FC88F7FD0,11901,19,20,1,42,49,2149
23308,23308,D72B55960EF782CD78E5D61FC88F7FD0,10491,21,23,2,33,48,1698
23315,23315,F5C2FA9E1532B9D3DBF4BE9660B66D0F,43341,0,8,8,41,46,2096
23316,23316,F5C2FA9E1532B9D3DBF4BE9660B66D0F,10841,14,16,2,37,47,1897
23317,23317,F5C2FA9E1532B9D3DBF4BE9660B66D0F,43341,16,21,5,41,46,2096
23318,23318,F5C2FA9E1532B9D3DBF4BE9660B66D0F,42511,21,23,2,37,47,1897
23329,23329,AD3EDA3142ED65E7DCEA2ECC9D2EC5AC,12921,0,6,6,9,41,491
23330,23330,AD3EDA3142ED65E7DCEA2ECC9D2EC5AC,19031,7,12,5,1,42,92
23331,23331,AD3EDA3142ED65E7DCEA2ECC9D2EC5AC,12921,15,23,8,9,41,491
23335,23335,E779DF22EB61C0D4BA72F0FBA1762DF8,42583,0,6,6,40,48,2048
23336,23336,E779DF22EB61C0D4BA72F0FBA1762DF8,40171,7,9,2,38,48,1948
23337,23337,E779DF22EB61C0D4BA72F0FBA1762DF8,42583,11,13,2,40,48,2048
23338,23338,E779DF22EB61C0D4BA72F0FBA1762DF8,40171,14,16,2,38,48,1948
23339,23339,E779DF22EB61C0D4BA72F0FBA1762DF8,42583,18,23,5,40,48,2048
23340,23340,19FEA72E933762654AA8076BEF887027,42521,3,4,1,31,47,1597
23341,23341,19FEA72E933762654AA8076BEF887027,10292,6,7,1,30,47,1547
23342,23342,19FEA72E933762654AA8076BEF887027,10691,16,17,1,33,48,1698
23343,23343,19FEA72E933762654AA8076BEF887027,42261,19,20,1,25,49,1299
23344,23344,19FEA72E933762654AA8076BEF887027,10295,22,23,1,30,47,1547
23366,23366,4ABA99D6A62884CB0B8CB2A0246467C6,13121,0,7,7,38,46,1946
23367,23367,4ABA99D6A62884CB0B8CB2A0246467C6,42021,9,11,2,33,47,1697
23368,23368,4ABA99D6A62884CB0B8CB2A0246467C6,11081,11,15,4,35,46,1796
23369,23369,4ABA99D6A62884CB0B8CB2A0246467C6,12514,17,19,2,38,47,1947
23370,23370,4ABA99D6A62884CB0B8CB2A0246467C6,13121,20,23,3,38,46,1946
23371,23371,2A20A80CB1667EB806B490329F0D01F9,11801,0,6,6,42,48,2148
23372,23372,2A20A80CB1667EB806B490329F0D01F9,13941,12,15,3,41,47,2097
23373,23373,2A20A80CB1667EB806B490329F0D01F9,10151,15,17,2,34,47,1747
23374,23374,2A20A80CB1667EB806B490329F0D01F9,11801,20,23,3,42,48,2148
23375,23375,84BFDA5775B1A36CF113618F1669E73C,42521,0,6,6,31,47,1597
23376,23376,84BFDA5775B1A36CF113618F1669E73C,11384,7,8,1,30,47,1547
23377,23377,84BFDA5775B1A36CF113618F1669E73C,42521,10,14,4,31,47,1597
23378,23378,84BFDA5775B1A36CF113618F1669E73C,11381,16,17,1,30,47,1547
23379,23379,84BFDA5775B1A36CF113618F1669E73C,42521,21,23,2,31,47,1597
23386,23386,06EE14C8EFDE3AC12BFED6C37CF48014,42801,0,8,8,40,49,2049
23387,23387,06EE14C8EFDE3AC12BFED6C37CF48014,42461,11,13,2,45,47,2297
23388,23388,06EE14C8EFDE3AC12BFED6C37CF48014,11661,17,23,6,40,49,2049
23396,23396,4EADD239E7EC06F253EFEC51F5D4CE62,42021,8,13,5,33,47,1697
23397,23397,4EADD239E7EC06F253EFEC51F5D4CE62,40341,15,16,1,23,49,1199
23398,23398,4EADD239E7EC06F253EFEC51F5D4CE62,41691,17,23,6,33,47,1697
23406,23406,0576900C4D0FA559C4C3ACF6E9F4048D,43341,0,15,15,41,46,2096
23407,23407,0576900C4D0FA559C4C3ACF6E9F4048D,10401,15,17,2,33,49,1699
23408,23408,0576900C4D0FA559C4C3ACF6E9F4048D,43341,20,23,3,41,46,2096
23409,23409,2AFC720AAFB2BE97F1D6052D5B781D23,42831,1,7,6,27,48,1398
23410,23410,2AFC720AAFB2BE97F1D6052D5B781D23,12561,10,13,3,45,43,2293
23411,23411,2AFC720AAFB2BE97F1D6052D5B781D23,11951,14,22,8,31,49,1599
23412,23412,7EF8399B7744B26431FFE3070C9BD313,19441,2,11,9,8,46,446
23413,23413,7EF8399B7744B26431FFE3070C9BD313,42041,13,17,4,10,47,547
23414,23414,7EF8399B7744B26431FFE3070C9BD313,19031,21,22,1,1,42,92
23415,23415,C493E8EAD829832CA31397E82BE4990B,43021,0,5,5,16,43,843
23416,23416,C493E8EAD829832CA31397E82BE4990B,12921,6,9,3,9,41,491
23417,23417,C493E8EAD829832CA31397E82BE4990B,43021,10,13,3,16,43,843
23418,23418,C493E8EAD829832CA31397E82BE4990B,12921,14,15,1,9,41,491
23419,23419,C493E8EAD829832CA31397E82BE4990B,43021,15,23,8,16,43,843
23420,23420,D8DCFF78BA67097F4D9471927F4813FD,10211,0,2,2,16,49,849
23421,23421,D8DCFF78BA67097F4D9471927F4813FD,43751,4,6,2,19,48,998
23422,23422,D8DCFF78BA67097F4D9471927F4813FD,12581,6,20,14,24,48,1248
23429,23429,C61DEA67F18A0C036AB9F6C39DDBC40C,42583,0,2,2,40,48,2048
23430,23430,C61DEA67F18A0C036AB9F6C39DDBC40C,42411,2,8,6,40,49,2049
23431,23431,C61DEA67F18A0C036AB9F6C39DDBC40C,42583,12,14,2,40,48,2048
23432,23432,C61DEA67F18A0C036AB9F6C39DDBC40C,11301,15,18,3,41,49,2099
23433,23433,C61DEA67F18A0C036AB9F6C39DDBC40C,40171,19,20,1,38,48,1948
23434,23434,2D408F32CC4CD45CDF430A23DE2FCE4B,43391,0,14,14,29,48,1498
23435,23435,2D408F32CC4CD45CDF430A23DE2FCE4B,42623,17,18,1,22,49,1149
23436,23436,2D408F32CC4CD45CDF430A23DE2FCE4B,43391,21,23,2,29,48,1498
23437,23437,8F536A436C76F6FB05A605DDF592D792,19031,9,11,2,1,42,92
23438,23438,8F536A436C76F6FB05A605DDF592D792,12641,11,12,1,10,43,543
23439,23439,8F536A436C76F6FB05A605DDF592D792,11021,17,18,1,36,49,1849
23440,23440,1CC182A2F9019F456D64C9BB630289F4,10111,10,11,1,37,47,1897
23441,23441,1CC182A2F9019F456D64C9BB630289F4,11701,12,13,1,43,48,2198
23442,23442,1CC182A2F9019F456D64C9BB630289F4,10971,14,16,2,35,47,1797
23443,23443,1CC182A2F9019F456D64C9BB630289F4,42301,16,19,3,36,47,1847
23444,23444,1CC182A2F9019F456D64C9BB630289F4,10971,20,22,2,35,47,1797
23448,23448,99C4A7B6CDD79381238ABE75ABD6ADD0,11291,7,9,2,40,49,2049
23449,23449,99C4A7B6CDD79381238ABE75ABD6ADD0,10107,15,16,1,38,49,1949
23450,23450,99C4A7B6CDD79381238ABE75ABD6ADD0,10841,19,21,2,37,47,1897
23451,23451,99C4A7B6CDD79381238ABE75ABD6ADD0,42231,22,23,1,37,46,1896
23452,23452,508DF001F529FBF83DF8D4A342350BFA,11261,6,7,1,36,46,1846
23453,23453,508DF001F529FBF83DF8D4A342350BFA,42861,8,9,1,37,44,1894
23454,23454,508DF001F529FBF83DF8D4A342350BFA,11261,10,11,1,36,46,1846
23455,23455,508DF001F529FBF83DF8D4A342350BFA,42861,13,18,5,37,44,1894
23456,23456,508DF001F529FBF83DF8D4A342350BFA,13841,19,20,1,40,46,2046
23457,23457,87F0A5B37D23577900D9D67376C1E962,19744,10,12,2,6,43,343
23458,23458,87F0A5B37D23577900D9D67376C1E962,19741,13,15,2,5,44,294
23459,23459,87F0A5B37D23577900D9D67376C1E962,12381,16,21,5,32,48,1648
23460,23460,DC108CA51A8D783261AB9156C36F59F1,10351,3,5,2,28,45,1445
23461,23461,DC108CA51A8D783261AB9156C36F59F1,13771,5,20,15,21,45,1095
23462,23462,DC108CA51A8D783261AB9156C36F59F1,12601,22,23,1,25,47,1297
23463,23463,E88B3320D5DB9B353136C87713851D2A,42341,0,7,7,43,49,2199
23464,23464,E88B3320D5DB9B353136C87713851D2A,10151,11,14,3,34,47,1747
23465,23465,E88B3320D5DB9B353136C87713851D2A,10491,16,18,2,33,48,1698
23466,23466,E88B3320D5DB9B353136C87713851D2A,43311,19,20,1,31,48,1598
23467,23467,E88B3320D5DB9B353136C87713851D2A,42341,21,23,2,43,49,2199
23468,23468,05BD882F25219A49EB57A8F905CE344B,43281,0,7,7,37,48,1898
23469,23469,05BD882F25219A49EB57A8F905CE344B,42491,8,9,1,32,46,1646
23470,23470,05BD882F25219A49EB57A8F905CE344B,12131,13,15,2,32,47,1647
23471,23471,05BD882F25219A49EB57A8F905CE344B,12161,15,19,4,32,46,1646
23472,23472,05BD882F25219A49EB57A8F905CE344B,13101,20,21,1,40,47,2047
23473,23473,05BD882F25219A49EB57A8F905CE344B,12083,21,22,1,36,49,1849
23474,23474,119196C18578341D0084AF6B48A62632,12641,0,3,3,10,43,543
23475,23475,119196C18578341D0084AF6B48A62632,11631,12,15,3,12,49,649
23476,23476,119196C18578341D0084AF6B48A62632,42551,16,17,1,14,48,748
23477,23477,119196C18578341D0084AF6B48A62632,11631,18,22,4,12,49,649
23481,23481,716E147864DA9F85D37B8E8702B8BBEE,11901,0,9,9,42,49,2149
23482,23482,716E147864DA9F85D37B8E8702B8BBEE,40341,12,19,7,23,49,1199
23483,23483,716E147864DA9F85D37B8E8702B8BBEE,11901,21,23,2,42,49,2149
23487,23487,668B25EA27DB62433F6B97341A2F29D6,10251,0,8,8,35,47,1797
23488,23488,668B25EA27DB62433F6B97341A2F29D6,10634,9,11,2,27,45,1395
23489,23489,668B25EA27DB62433F6B97341A2F29D6,43731,13,20,7,34,47,1747
23490,23490,668B25EA27DB62433F6B97341A2F29D6,10251,21,23,2,35,47,1797
23491,23491,D5E9BDC8FA219234703CDBDA1084CD0E,43581,0,6,6,33,48,1698
23492,23492,D5E9BDC8FA219234703CDBDA1084CD0E,43731,8,10,2,34,47,1747
23493,23493,D5E9BDC8FA219234703CDBDA1084CD0E,42941,12,13,1,37,47,1897
23494,23494,D5E9BDC8FA219234703CDBDA1084CD0E,11861,14,18,4,32,47,1647
23495,23495,D5E9BDC8FA219234703CDBDA1084CD0E,12031,19,23,4,33,48,1698
23506,23506,C5ED324891B8B95E257970408E8D4150,13911,0,2,2,39,46,1996
23507,23507,C5ED324891B8B95E257970408E8D4150,12491,3,9,6,36,43,1843
23508,23508,C5ED324891B8B95E257970408E8D4150,11261,12,23,11,36,46,1846
23525,23525,8114B285FF12FB4DB91B26D88B5B2F0B,16281,0,8,8,11,4,554
23526,23526,8114B285FF12FB4DB91B26D88B5B2F0B,15051,9,10,1,19,4,954
23527,23527,8114B285FF12FB4DB91B26D88B5B2F0B,16281,12,23,11,11,4,554
23528,23528,E02F64059E677B81EAF8B96D760DDB0F,15143,0,6,6,18,7,907
23529,23529,E02F64059E677B81EAF8B96D760DDB0F,16281,9,10,1,11,4,554
23530,23530,E02F64059E677B81EAF8B96D760DDB0F,15143,15,21,6,18,7,907
23531,23531,E02F64059E677B81EAF8B96D760DDB0F,16281,22,23,1,11,4,554
23535,23535,2B201A374FCCD298AB94704A43E90627,10331,0,12,12,39,46,1996
23536,23536,2B201A374FCCD298AB94704A43E90627,10841,12,13,1,37,47,1897
23537,23537,2B201A374FCCD298AB94704A43E90627,40341,14,20,6,23,49,1199
23538,23538,2B201A374FCCD298AB94704A43E90627,10331,21,23,2,39,46,1996
23542,23542,AFB83B245E30F3051A42272B92833F59,42511,0,9,9,37,47,1897
23543,23543,AFB83B245E30F3051A42272B92833F59,11301,9,11,2,41,49,2099
23544,23544,AFB83B245E30F3051A42272B92833F59,11291,13,15,2,40,49,2049
23545,23545,AFB83B245E30F3051A42272B92833F59,12514,18,21,3,38,47,1947
23546,23546,AFB83B245E30F3051A42272B92833F59,42301,21,23,2,36,47,1847
23554,23554,951E4A9F24E81DD7E0BF78CE09FD6CB8,12792,10,11,1,34,30,1730
23555,23555,951E4A9F24E81DD7E0BF78CE09FD6CB8,12611,12,13,1,41,29,2079
23556,23556,951E4A9F24E81DD7E0BF78CE09FD6CB8,12792,16,18,2,34,30,1730
23557,23557,7A7976C668D0EB24AB546298DF5E61BE,12661,0,15,15,32,45,1645
23558,23558,7A7976C668D0EB24AB546298DF5E61BE,12731,16,17,1,22,40,1140
23559,23559,7A7976C668D0EB24AB546298DF5E61BE,42151,21,22,1,35,45,1795
23563,23563,7DDA656552AE070D2770D67B9C65C807,42531,2,5,3,31,45,1595
23564,23564,7DDA656552AE070D2770D67B9C65C807,19811,8,16,8,10,34,534
23565,23565,7DDA656552AE070D2770D67B9C65C807,42071,20,21,1,31,49,1599
23566,23566,2873DE93703B028193B7B9719DCFE691,12521,0,7,7,35,41,1791
23567,23567,2873DE93703B028193B7B9719DCFE691,43451,7,10,3,37,40,1890
23568,23568,2873DE93703B028193B7B9719DCFE691,12521,12,13,1,35,41,1791
23569,23569,2873DE93703B028193B7B9719DCFE691,43451,14,17,3,37,40,1890
23570,23570,2873DE93703B028193B7B9719DCFE691,12521,18,22,4,35,41,1791
23571,23571,70E50AA138C0538910E5623295B506D8,11261,1,5,4,36,46,1846
23572,23572,70E50AA138C0538910E5623295B506D8,42351,6,14,8,38,45,1945
23573,23573,70E50AA138C0538910E5623295B506D8,13231,15,16,1,39,46,1996
23574,23574,70E50AA138C0538910E5623295B506D8,11261,17,18,1,36,46,1846
23575,23575,70E50AA138C0538910E5623295B506D8,42351,18,20,2,38,45,1945
23576,23576,784B731FB48DA266D31BFD4ACBDB8A39,11021,0,8,8,36,49,1849
23577,23577,784B731FB48DA266D31BFD4ACBDB8A39,13941,9,10,1,41,47,2097
23578,23578,784B731FB48DA266D31BFD4ACBDB8A39,11021,13,22,9,36,49,1849
23583,23583,4A63BD8790639E943B30CD82E5123621,11151,0,5,5,30,48,1548
23584,23584,4A63BD8790639E943B30CD82E5123621,40094,12,14,2,29,48,1498
23585,23585,4A63BD8790639E943B30CD82E5123621,10151,15,18,3,34,47,1747
23586,23586,4A63BD8790639E943B30CD82E5123621,12381,18,19,1,32,48,1648
23587,23587,4A63BD8790639E943B30CD82E5123621,11061,20,23,3,29,48,1498
23588,23588,5E213895BB9047A5EA6304DA9285DA04,11791,1,8,7,38,49,1949
23589,23589,5E213895BB9047A5EA6304DA9285DA04,11381,11,16,5,30,47,1547
23590,23590,5E213895BB9047A5EA6304DA9285DA04,11791,17,22,5,38,49,1949
23591,23591,6B614428F8D95ECFDE2207017437E97D,19281,0,13,13,16,32,832
23592,23592,6B614428F8D95ECFDE2207017437E97D,12871,13,14,1,22,33,1133
23593,23593,6B614428F8D95ECFDE2207017437E97D,19281,14,16,2,16,32,832
23594,23594,6B614428F8D95ECFDE2207017437E97D,12871,16,18,2,22,33,1133
23595,23595,2D473AEE4EAA77528353079765891883,13371,0,8,8,41,47,2097
23596,23596,2D473AEE4EAA77528353079765891883,13411,11,12,1,49,42,2492
23597,23597,2D473AEE4EAA77528353079765891883,43951,14,15,1,49,41,2491
23598,23598,2D473AEE4EAA77528353079765891883,13411,16,18,2,49,42,2492
23599,23599,2D473AEE4EAA77528353079765891883,13371,18,23,5,41,47,2097
23600,23600,53D8E731DA65650E5B825C52CF592433,40271,0,1,1,35,49,1799
23601,23601,53D8E731DA65650E5B825C52CF592433,10221,1,3,2,34,49,1749
23602,23602,53D8E731DA65650E5B825C52CF592433,11201,4,17,13,35,49,1799
23603,23603,53D8E731DA65650E5B825C52CF592433,11261,17,19,2,36,46,1846
23604,23604,53D8E731DA65650E5B825C52CF592433,10221,21,22,1,34,49,1749
23608,23608,E1D9DCC26BD9E70C84DC1D28D9FFAAE6,43644,4,7,3,14,38,738
23609,23609,E1D9DCC26BD9E70C84DC1D28D9FFAAE6,19114,12,14,2,7,43,393
23610,23610,E1D9DCC26BD9E70C84DC1D28D9FFAAE6,19904,15,17,2,9,44,494
23611,23611,E1D9DCC26BD9E70C84DC1D28D9FFAAE6,12641,22,23,1,10,43,543
23612,23612,2C430033E0EEB35867ADB0DAA2579608,11074,0,16,16,37,47,1897
23613,23613,2C430033E0EEB35867ADB0DAA2579608,42221,16,18,2,38,48,1948
23614,23614,2C430033E0EEB35867ADB0DAA2579608,11061,20,21,1,29,48,1498
23618,23618,8A92452E997F09EB2CFCCF0BB6941D92,10295,1,7,6,30,47,1547
23619,23619,8A92452E997F09EB2CFCCF0BB6941D92,11805,11,12,1,41,48,2098
23620,23620,8A92452E997F09EB2CFCCF0BB6941D92,43361,12,19,7,38,48,1948
23621,23621,8A92452E997F09EB2CFCCF0BB6941D92,10295,20,23,3,30,47,1547
23622,23622,B008950D13439AAF34B6D4BE3B059216,13651,0,13,13,30,47,1547
23623,23623,B008950D13439AAF34B6D4BE3B059216,42523,13,17,4,31,47,1597
23624,23624,B008950D13439AAF34B6D4BE3B059216,42541,18,19,1,25,47,1297
23625,23625,15AF53FBA0C13FBD61024895398ED2FD,11471,1,2,1,12,48,648
23626,23626,15AF53FBA0C13FBD61024895398ED2FD,19441,5,15,10,8,46,446
23627,23627,15AF53FBA0C13FBD61024895398ED2FD,42041,17,19,2,10,47,547
23631,23631,6AD981E757B177FB5B64F1D1D2EAA27F,42961,0,1,1,35,49,1799
23632,23632,6AD981E757B177FB5B64F1D1D2EAA27F,12651,2,8,6,43,47,2197
23633,23633,6AD981E757B177FB5B64F1D1D2EAA27F,10221,10,11,1,34,49,1749
23634,23634,6AD981E757B177FB5B64F1D1D2EAA27F,10901,12,15,3,35,48,1798
23635,23635,6AD981E757B177FB5B64F1D1D2EAA27F,10221,17,18,1,34,49,1749
23636,23636,6AD981E757B177FB5B64F1D1D2EAA27F,40271,18,23,5,35,49,1799
23641,23641,DC15358175A492C6F21AAEFAD4CD0BB7,42161,0,15,15,36,47,1847
23642,23642,DC15358175A492C6F21AAEFAD4CD0BB7,42521,16,19,3,31,47,1597
23643,23643,DC15358175A492C6F21AAEFAD4CD0BB7,42401,19,23,4,36,47,1847
23648,23648,43857F135F7541B4685E34097E43A46E,12921,0,10,10,9,41,491
23649,23649,43857F135F7541B4685E34097E43A46E,19021,12,19,7,10,45,545
23650,23650,43857F135F7541B4685E34097E43A46E,12641,20,21,1,10,43,543
23658,23658,5934F23DBC87E0A312C26B502942AF2F,13911,0,1,1,39,46,1996
23659,23659,5934F23DBC87E0A312C26B502942AF2F,42151,3,5,2,35,45,1795
23660,23660,5934F23DBC87E0A312C26B502942AF2F,42351,6,7,1,38,45,1945
23661,23661,5934F23DBC87E0A312C26B502942AF2F,42231,8,9,1,37,46,1896
23662,23662,5934F23DBC87E0A312C26B502942AF2F,42351,11,12,1,38,45,1945
23663,23663,5934F23DBC87E0A312C26B502942AF2F,13911,17,18,1,39,46,1996
23664,23664,5934F23DBC87E0A312C26B502942AF2F,42151,19,20,1,35,45,1795
23665,23665,5934F23DBC87E0A312C26B502942AF2F,42231,21,22,1,37,46,1896
23670,23670,8167EF05D15F996A6B93D96BD3E78468,10521,0,9,9,41,47,2097
23671,23671,8167EF05D15F996A6B93D96BD3E78468,42271,12,14,2,40,47,2047
23672,23672,8167EF05D15F996A6B93D96BD3E78468,15261,18,22,4,39,13,1963
23673,23673,CEB63AF3249F9F759AAF501C4D1F5357,11801,0,3,3,42,48,2148
23674,23674,CEB63AF3249F9F759AAF501C4D1F5357,42583,3,8,5,40,48,2048
23675,23675,CEB63AF3249F9F759AAF501C4D1F5357,12401,12,14,2,39,49,1999
23676,23676,CEB63AF3249F9F759AAF501C4D1F5357,12083,14,17,3,36,49,1849
23677,23677,CEB63AF3249F9F759AAF501C4D1F5357,42583,18,19,1,40,48,2048
23678,23678,CEB63AF3249F9F759AAF501C4D1F5357,10921,21,23,2,43,48,2198
23689,23689,163E800C7BD251C95DA23F7D9DD25383,12651,0,11,11,43,47,2197
23690,23690,163E800C7BD251C95DA23F7D9DD25383,11641,14,16,2,22,49,1149
23691,23691,163E800C7BD251C95DA23F7D9DD25383,12651,17,23,6,43,47,2197
23692,23692,055C3E79B75860F7D403E67AC462CB1B,11061,1,4,3,29,48,1498
23693,23693,055C3E79B75860F7D403E67AC462CB1B,11231,9,16,7,37,49,1899
23694,23694,055C3E79B75860F7D403E67AC462CB1B,10681,20,22,2,30,48,1548
23695,23695,3FD0940CB0B916F3B6E83D4E2AE88A76,43761,0,7,7,32,47,1647
23696,23696,3FD0940CB0B916F3B6E83D4E2AE88A76,42523,9,11,2,31,47,1597
23697,23697,3FD0940CB0B916F3B6E83D4E2AE88A76,40341,16,17,1,23,49,1199
23698,23698,3FD0940CB0B916F3B6E83D4E2AE88A76,43761,20,23,3,32,47,1647
23699,23699,34C2C19E72E3A8BD954F8F220235C379,43751,0,3,3,19,48,998
23700,23700,34C2C19E72E3A8BD954F8F220235C379,11104,4,6,2,17,47,897
23701,23701,34C2C19E72E3A8BD954F8F220235C379,43751,6,7,1,19,48,998
23702,23702,34C2C19E72E3A8BD954F8F220235C379,10211,12,15,3,16,49,849
23703,23703,34C2C19E72E3A8BD954F8F220235C379,10811,18,20,2,38,46,1946
23704,23704,34C2C19E72E3A8BD954F8F220235C379,42511,21,23,2,37,47,1897
23705,23705,0FB5FA6E5FD19BCDFACF335C2D092AC6,11324,1,8,7,31,46,1596
23706,23706,0FB5FA6E5FD19BCDFACF335C2D092AC6,10785,9,18,9,35,47,1797
23707,23707,0FB5FA6E5FD19BCDFACF335C2D092AC6,13101,21,22,1,40,47,2047
23712,23712,58B59FD7AA0814C0C6E50CF40955E7AA,10634,0,3,3,27,45,1395
23713,23713,58B59FD7AA0814C0C6E50CF40955E7AA,13771,6,10,4,21,45,1095
23714,23714,58B59FD7AA0814C0C6E50CF40955E7AA,12601,12,13,1,25,47,1297
23715,23715,58B59FD7AA0814C0C6E50CF40955E7AA,10634,14,21,7,27,45,1395
23725,23725,D1B681929BD44A1A7918A0268A3E43F0,43021,6,11,5,16,43,843
23726,23726,D1B681929BD44A1A7918A0268A3E43F0,19261,16,17,1,6,37,337
23727,23727,D1B681929BD44A1A7918A0268A3E43F0,12641,21,22,1,10,43,543
23737,23737,B84457A74A0D9026A24466C3F8A7B15D,19061,10,11,1,3,43,193
23738,23738,B84457A74A0D9026A24466C3F8A7B15D,12641,13,15,2,10,43,543
23739,23739,B84457A74A0D9026A24466C3F8A7B15D,19441,17,19,2,8,46,446
23740,23740,DFD3B5582AF8F95253BC66BB65B82218,19741,0,7,7,5,44,294
23741,23741,DFD3B5582AF8F95253BC66BB65B82218,19111,9,11,2,9,45,495
23742,23742,DFD3B5582AF8F95253BC66BB65B82218,12921,15,17,2,9,41,491
23743,23743,DFD3B5582AF8F95253BC66BB65B82218,19741,18,22,4,5,44,294
23750,23750,20806559F9E602745DBC97D78FDA70A0,10841,0,10,10,37,47,1897
23751,23751,20806559F9E602745DBC97D78FDA70A0,10421,10,12,2,41,48,2098
23752,23752,20806559F9E602745DBC97D78FDA70A0,10841,13,16,3,37,47,1897
23753,23753,20806559F9E602745DBC97D78FDA70A0,12341,20,21,1,26,38,1338
23754,23754,64F7708569C57ADADD849C5521367AD5,40302,0,8,8,40,49,2049
23755,23755,64F7708569C57ADADD849C5521367AD5,13511,9,11,2,34,48,1748
23756,23756,64F7708569C57ADADD849C5521367AD5,13651,13,17,4,30,47,1547
23757,23757,64F7708569C57ADADD849C5521367AD5,40302,21,23,2,40,49,2049
23761,23761,93E2DE921E47D3798DC5D4DD35FE7A3F,12651,2,5,3,43,47,2197
23762,23762,93E2DE921E47D3798DC5D4DD35FE7A3F,43621,8,9,1,46,48,2348
23763,23763,93E2DE921E47D3798DC5D4DD35FE7A3F,13371,13,19,6,41,47,2097
23764,23764,93E2DE921E47D3798DC5D4DD35FE7A3F,42031,20,21,1,40,46,2046
23765,23765,93E2DE921E47D3798DC5D4DD35FE7A3F,13941,22,23,1,41,47,2097
23769,23769,8D188B1328CA03E5FCB5F80DC745FFDD,42523,0,14,14,31,47,1597
23770,23770,8D188B1328CA03E5FCB5F80DC745FFDD,10107,15,18,3,38,49,1949
23771,23771,8D188B1328CA03E5FCB5F80DC745FFDD,10721,19,21,2,31,48,1598
23772,23772,8D188B1328CA03E5FCB5F80DC745FFDD,42523,22,23,1,31,47,1597
23773,23773,0C653DC860B823A0FBD73915967D7A74,10751,3,5,2,47,43,2393
23774,23774,0C653DC860B823A0FBD73915967D7A74,12221,7,8,1,43,44,2194
23775,23775,0C653DC860B823A0FBD73915967D7A74,42631,8,9,1,43,45,2195
23776,23776,0C653DC860B823A0FBD73915967D7A74,13341,12,13,1,44,45,2245
23777,23777,0C653DC860B823A0FBD73915967D7A74,12221,13,17,4,43,44,2194
23778,23778,0C653DC860B823A0FBD73915967D7A74,43051,20,21,1,46,45,2345
23779,23779,F66EBAC9EE1CB5E174070796CFB61D9B,12491,1,13,12,36,43,1843
23780,23780,F66EBAC9EE1CB5E174070796CFB61D9B,11834,18,19,1,32,45,1645
23781,23781,F66EBAC9EE1CB5E174070796CFB61D9B,12491,22,23,1,36,43,1843
23782,23782,26CB7197E081F66AA0D7DD9E572720E4,11741,7,8,1,42,49,2149
23783,23783,26CB7197E081F66AA0D7DD9E572720E4,11291,11,13,2,40,49,2049
23784,23784,26CB7197E081F66AA0D7DD9E572720E4,42623,16,18,2,22,49,1149
23785,23785,26CB7197E081F66AA0D7DD9E572720E4,10107,20,21,1,38,49,1949
23786,23786,4A7DB4C98C495CBE39929E4AF5856114,11521,0,5,5,41,48,2098
23787,23787,4A7DB4C98C495CBE39929E4AF5856114,40302,7,14,7,40,49,2049
23788,23788,4A7DB4C98C495CBE39929E4AF5856114,11271,16,18,2,37,48,1898
23789,23789,4A7DB4C98C495CBE39929E4AF5856114,11531,18,22,4,34,49,1749
23790,23790,5E8BB1A9FDE1AFD08848003FB8A60E0E,10411,0,8,8,36,48,1848
23791,23791,5E8BB1A9FDE1AFD08848003FB8A60E0E,43731,8,10,2,34,47,1747
23792,23792,5E8BB1A9FDE1AFD08848003FB8A60E0E,10971,10,12,2,35,47,1797
23793,23793,5E8BB1A9FDE1AFD08848003FB8A60E0E,43731,14,17,3,34,47,1747
23794,23794,5E8BB1A9FDE1AFD08848003FB8A60E0E,40673,19,23,4,36,48,1848
23798,23798,DE2A7336F28277C76BFE77D331615896,42461,10,11,1,45,47,2297
23799,23799,DE2A7336F28277C76BFE77D331615896,11701,14,18,4,43,48,2198
23800,23800,DE2A7336F28277C76BFE77D331615896,13911,18,19,1,39,46,1996
23804,23804,B2DF801CFC07B11589C001C790C72D58,11741,0,9,9,42,49,2149
23805,23805,B2DF801CFC07B11589C001C790C72D58,11291,11,13,2,40,49,2049
23806,23806,B2DF801CFC07B11589C001C790C72D58,40341,15,18,3,23,49,1199
23807,23807,B2DF801CFC07B11589C001C790C72D58,12514,18,20,2,38,47,1947
23808,23808,B2DF801CFC07B11589C001C790C72D58,10107,20,21,1,38,49,1949
23812,23812,2511B7B2BAC460D0F1BE6D7299BB9C0A,42511,0,2,2,37,47,1897
23813,23813,2511B7B2BAC460D0F1BE6D7299BB9C0A,43241,3,6,3,36,46,1846
23814,23814,2511B7B2BAC460D0F1BE6D7299BB9C0A,40341,9,11,2,23,49,1199
23815,23815,2511B7B2BAC460D0F1BE6D7299BB9C0A,10491,12,13,1,33,48,1698
23816,23816,2511B7B2BAC460D0F1BE6D7299BB9C0A,43241,15,23,8,36,46,1846
23817,23817,7BD5666208D4C4EF90CAAD8A97E6ED7C,13671,0,5,5,27,43,1393
23818,23818,7BD5666208D4C4EF90CAAD8A97E6ED7C,42151,9,12,3,35,45,1795
23819,23819,7BD5666208D4C4EF90CAAD8A97E6ED7C,12661,13,16,3,32,45,1645
23820,23820,7BD5666208D4C4EF90CAAD8A97E6ED7C,42151,18,23,5,35,45,1795
23821,23821,7779D5C4E5073D864A9050EB76A5AC64,42351,0,1,1,38,45,1945
23822,23822,7779D5C4E5073D864A9050EB76A5AC64,12211,4,6,2,41,44,2094
23823,23823,7779D5C4E5073D864A9050EB76A5AC64,11261,8,17,9,36,46,1846
23824,23824,7779D5C4E5073D864A9050EB76A5AC64,43341,19,20,1,41,46,2096
23825,23825,7779D5C4E5073D864A9050EB76A5AC64,11261,21,22,1,36,46,1846
23826,23826,0A569E697F931E157A9E2031150DE597,15114,1,6,5,22,16,1116
23827,23827,0A569E697F931E157A9E2031150DE597,16441,9,10,1,15,17,767
23828,23828,0A569E697F931E157A9E2031150DE597,15114,12,13,1,22,16,1116
23829,23829,0A569E697F931E157A9E2031150DE597,16441,15,16,1,15,17,767
23830,23830,0A569E697F931E157A9E2031150DE597,16231,20,22,2,11,15,565
23834,23834,3E92B936E30464D11A87159A7D122C74,10691,0,9,9,33,48,1698
23835,23835,3E92B936E30464D11A87159A7D122C74,42511,14,15,1,37,47,1897
23836,23836,3E92B936E30464D11A87159A7D122C74,10691,17,23,6,33,48,1698
23837,23837,ED63CD6A523ED82BABC0C283513656AA,42041,0,1,1,10,47,547
23838,23838,ED63CD6A523ED82BABC0C283513656AA,19441,5,7,2,8,46,446
23839,23839,ED63CD6A523ED82BABC0C283513656AA,42041,10,11,1,10,47,547
23840,23840,ED63CD6A523ED82BABC0C283513656AA,19441,13,17,4,8,46,446
23841,23841,ED63CD6A523ED82BABC0C283513656AA,42041,17,19,2,10,47,547
23846,23846,0163EDF601EA69BE8043EC76AB8DF5D1,10331,0,12,12,39,46,1996
23847,23847,0163EDF601EA69BE8043EC76AB8DF5D1,10841,12,13,1,37,47,1897
23848,23848,0163EDF601EA69BE8043EC76AB8DF5D1,40341,14,20,6,23,49,1199
23849,23849,0163EDF601EA69BE8043EC76AB8DF5D1,10331,21,23,2,39,46,1996
23850,23850,4FB7544A1E67AE742452DB3735E5F7CF,10771,0,1,1,41,46,2096
23851,23851,4FB7544A1E67AE742452DB3735E5F7CF,13111,1,3,2,42,46,2146
23852,23852,4FB7544A1E67AE742452DB3735E5F7CF,10771,3,5,2,41,46,2096
23853,23853,4FB7544A1E67AE742452DB3735E5F7CF,43951,8,9,1,49,41,2491
23854,23854,4FB7544A1E67AE742452DB3735E5F7CF,12561,10,11,1,45,43,2293
23855,23855,4FB7544A1E67AE742452DB3735E5F7CF,43951,13,18,5,49,41,2491
23856,23856,4FB7544A1E67AE742452DB3735E5F7CF,13111,18,20,2,42,46,2146
23857,23857,4FB7544A1E67AE742452DB3735E5F7CF,10771,21,23,2,41,46,2096
23858,23858,445A90121514A82FCCD431DD3088A581,43731,0,5,5,34,47,1747
23859,23859,445A90121514A82FCCD431DD3088A581,11381,7,11,4,30,47,1547
23860,23860,445A90121514A82FCCD431DD3088A581,11861,11,13,2,32,47,1647
23861,23861,445A90121514A82FCCD431DD3088A581,11381,14,18,4,30,47,1547
23862,23862,445A90121514A82FCCD431DD3088A581,11861,18,20,2,32,47,1647
23866,23866,3F0ADCAA0DAC5A451C6A2275297480C8,19901,0,6,6,7,44,394
23867,23867,3F0ADCAA0DAC5A451C6A2275297480C8,12641,7,8,1,10,43,543
23868,23868,3F0ADCAA0DAC5A451C6A2275297480C8,19114,9,10,1,7,43,393
23869,23869,3F0ADCAA0DAC5A451C6A2275297480C8,42971,13,23,10,43,49,2199
23883,23883,BB18F06A13016E09393A61EDC4B2B216,11461,1,8,7,37,49,1899
23884,23884,BB18F06A13016E09393A61EDC4B2B216,11954,8,10,2,32,49,1649
23885,23885,BB18F06A13016E09393A61EDC4B2B216,11261,11,13,2,36,46,1846
23886,23886,BB18F06A13016E09393A61EDC4B2B216,10531,14,15,1,34,46,1746
23887,23887,BB18F06A13016E09393A61EDC4B2B216,11801,19,22,3,42,48,2148
23891,23891,CEA501FA7BDE5D84B551C94F16C00DA1,11021,0,7,7,36,49,1849
23892,23892,CEA501FA7BDE5D84B551C94F16C00DA1,13561,8,9,1,37,49,1899
23893,23893,CEA501FA7BDE5D84B551C94F16C00DA1,11591,12,13,1,36,49,1849
23894,23894,CEA501FA7BDE5D84B551C94F16C00DA1,13101,15,16,1,40,47,2047
23895,23895,CEA501FA7BDE5D84B551C94F16C00DA1,10651,17,23,6,36,49,1849
23899,23899,7300FFB733BFFEA187DB110E4D4DC3D2,19181,0,6,6,8,40,440
23900,23900,7300FFB733BFFEA187DB110E4D4DC3D2,12641,9,10,1,10,43,543
23901,23901,7300FFB733BFFEA187DB110E4D4DC3D2,49201,12,13,1,7,41,391
23902,23902,7300FFB733BFFEA187DB110E4D4DC3D2,12921,15,18,3,9,41,491
23903,23903,7300FFB733BFFEA187DB110E4D4DC3D2,19181,21,23,2,8,40,440
23911,23911,919F84499249296B0D7A3B8F969B6B66,43041,0,6,6,41,46,2096
23912,23912,919F84499249296B0D7A3B8F969B6B66,42633,8,13,5,42,46,2146
23913,23913,919F84499249296B0D7A3B8F969B6B66,10271,15,16,1,37,46,1896
23914,23914,919F84499249296B0D7A3B8F969B6B66,42633,17,18,1,42,46,2146
23915,23915,919F84499249296B0D7A3B8F969B6B66,40691,20,21,1,42,48,2148
23920,23920,823BB637426A4B64F4A56D087D45C241,49201,0,6,6,7,41,391
23921,23921,823BB637426A4B64F4A56D087D45C241,12921,7,11,4,9,41,491
23922,23922,823BB637426A4B64F4A56D087D45C241,49201,12,13,1,7,41,391
23923,23923,823BB637426A4B64F4A56D087D45C241,19744,19,20,1,6,43,343
23924,23924,823BB637426A4B64F4A56D087D45C241,12641,22,23,1,10,43,543
23928,23928,760E5496C7CBF2B23EC48D1163A2AA2C,43081,2,3,1,27,28,1378
23929,23929,760E5496C7CBF2B23EC48D1163A2AA2C,12791,4,6,2,31,29,1579
23930,23930,760E5496C7CBF2B23EC48D1163A2AA2C,43081,6,8,2,27,28,1378
23931,23931,760E5496C7CBF2B23EC48D1163A2AA2C,15321,12,19,7,29,26,1476
23932,23932,5070C1A380F75CAF6835A3D83240A24D,19024,0,6,6,9,45,495
23933,23933,5070C1A380F75CAF6835A3D83240A24D,10451,9,10,1,25,48,1298
23934,23934,5070C1A380F75CAF6835A3D83240A24D,19441,13,18,5,8,46,446
23935,23935,5070C1A380F75CAF6835A3D83240A24D,19021,20,23,3,10,45,545
23936,23936,CE155B610E3EDB8ECA1DCB73ED422C8D,12571,0,8,8,48,39,2439
23937,23937,CE155B610E3EDB8ECA1DCB73ED422C8D,43101,8,11,3,46,40,2340
23938,23938,CE155B610E3EDB8ECA1DCB73ED422C8D,12571,12,15,3,48,39,2439
23939,23939,CE155B610E3EDB8ECA1DCB73ED422C8D,43101,16,17,1,46,40,2340
23940,23940,CE155B610E3EDB8ECA1DCB73ED422C8D,12571,19,22,3,48,39,2439
23944,23944,A4FB037706170157DA9B94939FEE9474,11001,1,7,6,42,47,2147
23945,23945,A4FB037706170157DA9B94939FEE9474,11351,11,14,3,36,48,1848
23946,23946,A4FB037706170157DA9B94939FEE9474,10841,15,19,4,37,47,1897
23947,23947,A4FB037706170157DA9B94939FEE9474,13941,22,23,1,41,47,2097
23948,23948,ACB971F1F5FC2426FE94D1AF3C5A3F58,42091,0,8,8,43,46,2196
23949,23949,ACB971F1F5FC2426FE94D1AF3C5A3F58,13771,9,12,3,21,45,1095
23950,23950,ACB971F1F5FC2426FE94D1AF3C5A3F58,11031,14,16,2,42,49,2149
23951,23951,ACB971F1F5FC2426FE94D1AF3C5A3F58,42091,17,23,6,43,46,2196
23952,23952,16D740AE27D92BE968DE244652195181,13671,5,9,4,27,43,1393
23953,23953,16D740AE27D92BE968DE244652195181,12731,11,12,1,22,40,1140
23954,23954,16D740AE27D92BE968DE244652195181,13671,13,23,10,27,43,1393
23961,23961,DC9866094212A637CCAC17CF01FE4B5F,42861,0,5,5,37,44,1894
23962,23962,DC9866094212A637CCAC17CF01FE4B5F,11261,9,12,3,36,46,1846
23963,23963,DC9866094212A637CCAC17CF01FE4B5F,42351,12,13,1,38,45,1945
23964,23964,DC9866094212A637CCAC17CF01FE4B5F,11261,16,19,3,36,46,1846
23965,23965,DC9866094212A637CCAC17CF01FE4B5F,42861,20,23,3,37,44,1894
23966,23966,71EC48DD21126B9B6A22DDC82F149351,19031,1,6,5,1,42,92
23967,23967,71EC48DD21126B9B6A22DDC82F149351,12921,9,11,2,9,41,491
23968,23968,71EC48DD21126B9B6A22DDC82F149351,19114,11,16,5,7,43,393
23969,23969,71EC48DD21126B9B6A22DDC82F149351,12921,20,21,1,9,41,491
23970,23970,690ED6B90D0AD4087D3ADF8FC3C1CDF1,10107,0,1,1,38,49,1949
23971,23971,690ED6B90D0AD4087D3ADF8FC3C1CDF1,10271,2,9,7,37,46,1896
23972,23972,690ED6B90D0AD4087D3ADF8FC3C1CDF1,11481,11,15,4,41,48,2098
23973,23973,690ED6B90D0AD4087D3ADF8FC3C1CDF1,10271,17,18,1,37,46,1896
23974,23974,690ED6B90D0AD4087D3ADF8FC3C1CDF1,11491,19,20,1,36,47,1847
23975,23975,024AB2D90319DF57F94996854D076E3D,40833,0,12,12,41,47,2097
23976,23976,024AB2D90319DF57F94996854D076E3D,42961,12,14,2,35,49,1799
23977,23977,024AB2D90319DF57F94996854D076E3D,13101,18,20,2,40,47,2047
23978,23978,024AB2D90319DF57F94996854D076E3D,11021,21,23,2,36,49,1849
23983,23983,6C020C892F288D31D45E761066653E6E,13711,0,15,15,38,46,1946
23984,23984,6C020C892F288D31D45E761066653E6E,40691,19,20,1,42,48,2148
23985,23985,6C020C892F288D31D45E761066653E6E,13711,21,23,2,38,46,1946
23986,23986,39A12A7E8C423731CE90191A15A5C3F4,43021,1,5,4,16,43,843
23987,23987,39A12A7E8C423731CE90191A15A5C3F4,12921,6,18,12,9,41,491
23988,23988,39A12A7E8C423731CE90191A15A5C3F4,43021,21,23,2,16,43,843
23989,23989,42450E4607B078BD3F39C67BF93F8737,11111,7,9,2,26,48,1348
23990,23990,42450E4607B078BD3F39C67BF93F8737,10451,9,12,3,25,48,1298
23991,23991,42450E4607B078BD3F39C67BF93F8737,10431,12,14,2,33,49,1699
23992,23992,42450E4607B078BD3F39C67BF93F8737,10451,14,19,5,25,48,1298
23996,23996,59A0A66272AD58C53CB4B05B1CFA927F,15404,0,5,5,40,24,2024
23997,23997,59A0A66272AD58C53CB4B05B1CFA927F,13551,7,9,2,45,38,2288
23998,23998,59A0A66272AD58C53CB4B05B1CFA927F,13071,11,17,6,41,41,2091
23999,23999,59A0A66272AD58C53CB4B05B1CFA927F,15404,18,23,5,40,24,2024
24003,24003,64EA873D359181A561255128009EB239,42581,2,8,6,38,48,1948
24004,24004,64EA873D359181A561255128009EB239,11914,8,11,3,37,48,1898
24005,24005,64EA873D359181A561255128009EB239,42581,11,16,5,38,48,1948
24006,24006,64EA873D359181A561255128009EB239,11914,16,18,2,37,48,1898
24007,24007,64EA873D359181A561255128009EB239,42581,19,20,1,38,48,1948
24008,24008,1C11E829C965E98C9AACE0FB801A921E,42921,0,9,9,33,47,1697
24009,24009,1C11E829C965E98C9AACE0FB801A921E,10107,10,13,3,38,49,1949
24010,24010,1C11E829C965E98C9AACE0FB801A921E,42921,14,20,6,33,47,1697
24020,24020,0FF23BFDB55A76F1FEA2FEA8A42CA80D,11381,0,2,2,30,47,1547
24021,24021,0FF23BFDB55A76F1FEA2FEA8A42CA80D,11061,3,4,1,29,48,1498
24022,24022,0FF23BFDB55A76F1FEA2FEA8A42CA80D,11381,4,6,2,30,47,1547
24023,24023,0FF23BFDB55A76F1FEA2FEA8A42CA80D,11061,7,8,1,29,48,1498
24024,24024,0FF23BFDB55A76F1FEA2FEA8A42CA80D,11381,12,23,11,30,47,1547
24025,24025,DC202B6E6FEBB44F8F053C76074DEC47,10471,1,13,12,37,48,1898
24026,24026,DC202B6E6FEBB44F8F053C76074DEC47,40637,14,15,1,36,47,1847
24027,24027,DC202B6E6FEBB44F8F053C76074DEC47,10721,17,23,6,31,48,1598
24028,24028,5A39E82B4B89A7E32F8694D4D3BC7774,43761,0,8,8,32,47,1647
24029,24029,5A39E82B4B89A7E32F8694D4D3BC7774,10341,9,17,8,31,47,1597
24030,24030,5A39E82B4B89A7E32F8694D4D3BC7774,40171,19,20,1,38,48,1948
24031,24031,23F5F0E674C3F48F47326D1970DAF3ED,40341,10,11,1,23,49,1199
24032,24032,23F5F0E674C3F48F47326D1970DAF3ED,43751,13,16,3,19,48,998
24033,24033,23F5F0E674C3F48F47326D1970DAF3ED,40341,19,21,2,23,49,1199
24034,24034,00ED2280FB2BEC22D8FB36F8A7AFB1A5,42151,0,8,8,35,45,1795
24035,24035,00ED2280FB2BEC22D8FB36F8A7AFB1A5,13121,8,10,2,38,46,1946
24036,24036,00ED2280FB2BEC22D8FB36F8A7AFB1A5,10271,12,15,3,37,46,1896
24037,24037,00ED2280FB2BEC22D8FB36F8A7AFB1A5,13121,15,18,3,38,46,1946
24038,24038,00ED2280FB2BEC22D8FB36F8A7AFB1A5,42791,19,23,4,35,45,1795
24055,24055,A98EFFE1F83A80D81FB02056DDB7FB66,13711,0,11,11,38,46,1946
24056,24056,A98EFFE1F83A80D81FB02056DDB7FB66,42511,12,13,1,37,47,1897
24057,24057,A98EFFE1F83A80D81FB02056DDB7FB66,13711,14,15,1,38,46,1946
24058,24058,A98EFFE1F83A80D81FB02056DDB7FB66,42471,17,22,5,35,49,1799
24059,24059,31CDF80C6F6D99CDF02165EC65D6A959,42041,0,1,1,10,47,547
24060,24060,31CDF80C6F6D99CDF02165EC65D6A959,19441,3,5,2,8,46,446
24061,24061,31CDF80C6F6D99CDF02165EC65D6A959,42041,7,8,1,10,47,547
24062,24062,31CDF80C6F6D99CDF02165EC65D6A959,19441,10,15,5,8,46,446
24063,24063,31CDF80C6F6D99CDF02165EC65D6A959,42041,16,17,1,10,47,547
24064,24064,31CDF80C6F6D99CDF02165EC65D6A959,19441,18,21,3,8,46,446
24065,24065,9C17C707743AE50FBFFE4446783207FB,40571,2,11,9,35,48,1798
24066,24066,9C17C707743AE50FBFFE4446783207FB,10221,11,13,2,34,49,1749
24067,24067,9C17C707743AE50FBFFE4446783207FB,43471,13,22,9,31,49,1599
24068,24068,9646DACA260879D32095F9107B2CAA8C,16451,0,2,2,5,5,255
24069,24069,9646DACA260879D32095F9107B2CAA8C,16181,2,10,8,4,2,202
24070,24070,9646DACA260879D32095F9107B2CAA8C,42523,15,16,1,31,47,1597
24071,24071,9646DACA260879D32095F9107B2CAA8C,43311,17,20,3,31,48,1598
24072,24072,BEE853049D28B67DAA1CF8A47B438594,12921,0,8,8,9,41,491
24073,24073,BEE853049D28B67DAA1CF8A47B438594,43644,9,11,2,14,38,738
24074,24074,BEE853049D28B67DAA1CF8A47B438594,12641,12,13,1,10,43,543
24075,24075,BEE853049D28B67DAA1CF8A47B438594,12921,15,20,5,9,41,491
24076,24076,1DBDA5FD1FD3F9451B3FDDD68A3C5716,42071,5,6,1,31,49,1599
24077,24077,1DBDA5FD1FD3F9451B3FDDD68A3C5716,42081,11,13,2,24,49,1249
24078,24078,1DBDA5FD1FD3F9451B3FDDD68A3C5716,42071,13,18,5,31,49,1599
24079,24079,D7349708A10855AEF98FEB8D22C33E59,10601,0,7,7,39,47,1997
24080,24080,D7349708A10855AEF98FEB8D22C33E59,11231,8,11,3,37,49,1899
24081,24081,D7349708A10855AEF98FEB8D22C33E59,10901,12,14,2,35,48,1798
24082,24082,D7349708A10855AEF98FEB8D22C33E59,11231,14,18,4,37,49,1899
24083,24083,D7349708A10855AEF98FEB8D22C33E59,10601,20,23,3,39,47,1997
24087,24087,87DA57462D476367AB276D1A619F26E5,11151,0,6,6,30,48,1548
24088,24088,87DA57462D476367AB276D1A619F26E5,43391,9,10,1,29,48,1498
24089,24089,87DA57462D476367AB276D1A619F26E5,11151,11,16,5,30,48,1548
24090,24090,87DA57462D476367AB276D1A619F26E5,10381,17,18,1,31,49,1599
24091,24091,87DA57462D476367AB276D1A619F26E5,43391,19,21,2,29,48,1498
24092,24092,232A65D7E72D31ED563D0041FCDF23A8,12491,5,15,10,36,43,1843
24093,24093,232A65D7E72D31ED563D0041FCDF23A8,43011,19,21,2,40,42,2042
24094,24094,232A65D7E72D31ED563D0041FCDF23A8,12491,21,23,2,36,43,1843
24095,24095,13593D379347B080E00A2547E2225557,43971,0,7,7,30,48,1548
24096,24096,13593D379347B080E00A2547E2225557,41591,8,12,4,34,49,1749
24097,24097,13593D379347B080E00A2547E2225557,11231,16,18,2,37,49,1899
24098,24098,13593D379347B080E00A2547E2225557,43971,20,23,3,30,48,1548
24108,24108,92E1BAA88B052422B820ED36A9E8F107,41392,0,6,6,43,48,2198
24109,24109,92E1BAA88B052422B820ED36A9E8F107,11271,8,10,2,37,48,1898
24110,24110,92E1BAA88B052422B820ED36A9E8F107,11701,11,23,12,43,48,2198
24115,24115,ACD04627348D28EB014FAB46490D4B92,10351,3,8,5,28,45,1445
24116,24116,ACD04627348D28EB014FAB46490D4B92,12601,10,12,2,25,47,1297
24117,24117,ACD04627348D28EB014FAB46490D4B92,13771,13,18,5,21,45,1095
24118,24118,ACD04627348D28EB014FAB46490D4B92,12601,18,19,1,25,47,1297
24119,24119,ACD04627348D28EB014FAB46490D4B92,13771,20,23,3,21,45,1095
24124,24124,89F7D51E6C75AB339293B38AD06EB378,40833,0,11,11,41,47,2097
24125,24125,89F7D51E6C75AB339293B38AD06EB378,10841,13,15,2,37,47,1897
24126,24126,89F7D51E6C75AB339293B38AD06EB378,40833,16,21,5,41,47,2097
24127,24127,89F7D51E6C75AB339293B38AD06EB378,40611,22,23,1,35,47,1797
24132,24132,0C2E73493B95B864220B3E14F6C11E84,13314,0,10,10,31,39,1589
24133,24133,0C2E73493B95B864220B3E14F6C11E84,12521,12,14,2,35,41,1791
24134,24134,0C2E73493B95B864220B3E14F6C11E84,13314,14,23,9,31,39,1589
24135,24135,558A6887C0D5899B43E75BBD844A7C64,42461,0,5,5,45,47,2297
24136,24136,558A6887C0D5899B43E75BBD844A7C64,42321,6,8,2,43,47,2197
24137,24137,558A6887C0D5899B43E75BBD844A7C64,42461,9,10,1,45,47,2297
24138,24138,558A6887C0D5899B43E75BBD844A7C64,42321,15,16,1,43,47,2197
24139,24139,558A6887C0D5899B43E75BBD844A7C64,42461,18,19,1,45,47,2297
24140,24140,3D2BDD74577C3FC02D2B34FCE9FAFF7E,12581,0,6,6,24,48,1248
24141,24141,3D2BDD74577C3FC02D2B34FCE9FAFF7E,12051,7,11,4,20,47,1047
24142,24142,3D2BDD74577C3FC02D2B34FCE9FAFF7E,10061,13,16,3,20,46,1046
24143,24143,3D2BDD74577C3FC02D2B34FCE9FAFF7E,12601,16,20,4,25,47,1297
24144,24144,3D2BDD74577C3FC02D2B34FCE9FAFF7E,10061,20,23,3,20,46,1046
24151,24151,56E206F1CDD0789AFDBC5B3F197C6FFD,43731,0,9,9,34,47,1747
24152,24152,56E206F1CDD0789AFDBC5B3F197C6FFD,13371,12,13,1,41,47,2097
24153,24153,56E206F1CDD0789AFDBC5B3F197C6FFD,43731,14,17,3,34,47,1747
24154,24154,56E206F1CDD0789AFDBC5B3F197C6FFD,11201,18,20,2,35,49,1799
24158,24158,D017405831E17178DF3ABF4227AE23F0,19901,0,4,4,7,44,394
24159,24159,D017405831E17178DF3ABF4227AE23F0,12921,7,9,2,9,41,491
24160,24160,D017405831E17178DF3ABF4227AE23F0,19111,9,11,2,9,45,495
24161,24161,D017405831E17178DF3ABF4227AE23F0,19901,11,12,1,7,44,394
24162,24162,D017405831E17178DF3ABF4227AE23F0,19111,14,18,4,9,45,495
24163,24163,D017405831E17178DF3ABF4227AE23F0,19114,22,23,1,7,43,393
24164,24164,F004825C5EEC7F8B7A184D4985895C55,13341,0,8,8,44,45,2245
24165,24165,F004825C5EEC7F8B7A184D4985895C55,42631,8,19,11,43,45,2195
24166,24166,F004825C5EEC7F8B7A184D4985895C55,40691,21,22,1,42,48,2148
24167,24167,8436FA510D59B3814E50B7F18BD1D92C,19571,0,4,4,1,36,86
24168,24168,8436FA510D59B3814E50B7F18BD1D92C,12641,7,11,4,10,43,543
24169,24169,8436FA510D59B3814E50B7F18BD1D92C,19571,12,13,1,1,36,86
24170,24170,8436FA510D59B3814E50B7F18BD1D92C,12641,14,18,4,10,43,543
24171,24171,4CDC8B55805F54C701951AA286ACE261,13651,1,5,4,30,47,1547
24172,24172,4CDC8B55805F54C701951AA286ACE261,42521,5,8,3,31,47,1597
24173,24173,4CDC8B55805F54C701951AA286ACE261,11201,13,15,2,35,49,1799
24174,24174,4CDC8B55805F54C701951AA286ACE261,42521,18,19,1,31,47,1597
24175,24175,4CDC8B55805F54C701951AA286ACE261,11751,20,21,1,35,48,1798
24182,24182,9FE70E4B6B2CB4BF68BC98D789DF7939,43311,0,13,13,31,48,1598
24183,24183,9FE70E4B6B2CB4BF68BC98D789DF7939,12401,14,15,1,39,49,1999
24184,24184,9FE70E4B6B2CB4BF68BC98D789DF7939,43311,18,23,5,31,48,1598
24185,24185,7E0551263B729B84FDA4D97FDAFF30C7,13711,0,7,7,38,46,1946
24186,24186,7E0551263B729B84FDA4D97FDAFF30C7,11061,10,11,1,29,48,1498
24187,24187,7E0551263B729B84FDA4D97FDAFF30C7,13711,12,23,11,38,46,1946
24188,24188,9B2D7E8F6087A89B0049A7B811F66E0C,43021,0,5,5,16,43,843
24189,24189,9B2D7E8F6087A89B0049A7B811F66E0C,12921,6,10,4,9,41,491
24190,24190,9B2D7E8F6087A89B0049A7B811F66E0C,43021,14,19,5,16,43,843
24191,24191,376DDDFE24216F652E9CDE9E324BF6F4,10544,0,16,16,28,48,1448
24192,24192,376DDDFE24216F652E9CDE9E324BF6F4,11781,17,19,2,38,49,1949
24193,24193,376DDDFE24216F652E9CDE9E324BF6F4,10544,20,22,2,28,48,1448
24194,24194,4F051F680532A6EEDFEDC3C17681E856,10331,0,12,12,39,46,1996
24195,24195,4F051F680532A6EEDFEDC3C17681E856,10841,12,13,1,37,47,1897
24196,24196,4F051F680532A6EEDFEDC3C17681E856,40341,14,20,6,23,49,1199
24197,24197,4F051F680532A6EEDFEDC3C17681E856,10331,21,23,2,39,46,1996
24201,24201,E8F5F4A78C0DE5C1EE8D56EB7226C7B2,10491,3,12,9,33,48,1698
24202,24202,E8F5F4A78C0DE5C1EE8D56EB7226C7B2,42501,14,15,1,28,47,1447
24203,24203,E8F5F4A78C0DE5C1EE8D56EB7226C7B2,10881,16,19,3,34,48,1748
24204,24204,E8F5F4A78C0DE5C1EE8D56EB7226C7B2,10281,20,23,3,33,48,1698
24205,24205,1556F2F689A33FDB51E57BDF7D017FA3,11541,0,1,1,35,49,1799
24206,24206,1556F2F689A33FDB51E57BDF7D017FA3,11061,2,13,11,29,48,1498
24207,24207,1556F2F689A33FDB51E57BDF7D017FA3,11151,13,15,2,30,48,1548
24208,24208,1556F2F689A33FDB51E57BDF7D017FA3,11061,18,21,3,29,48,1498
24212,24212,3D50CF8DA80A4761FAF974D4CBB0A177,43751,0,13,13,19,48,998
24213,24213,3D50CF8DA80A4761FAF974D4CBB0A177,10634,15,16,1,27,45,1395
24214,24214,3D50CF8DA80A4761FAF974D4CBB0A177,10351,17,18,1,28,45,1445
24215,24215,3D50CF8DA80A4761FAF974D4CBB0A177,43751,18,23,5,19,48,998
24224,24224,5DCDEE86AFA2D68FD07F31A3CA76F70F,42801,0,8,8,40,49,2049
24225,24225,5DCDEE86AFA2D68FD07F31A3CA76F70F,10401,12,13,1,33,49,1699
24226,24226,5DCDEE86AFA2D68FD07F31A3CA76F70F,13741,16,18,2,37,49,1899
24227,24227,A6EF3AA52D2C883DD4C8A6E9BED0EE14,19901,2,6,4,7,44,394
24228,24228,A6EF3AA52D2C883DD4C8A6E9BED0EE14,12921,7,13,6,9,41,491
24229,24229,A6EF3AA52D2C883DD4C8A6E9BED0EE14,49201,15,16,1,7,41,391
24230,24230,A6EF3AA52D2C883DD4C8A6E9BED0EE14,12921,16,20,4,9,41,491
24231,24231,A6EF3AA52D2C883DD4C8A6E9BED0EE14,19901,21,23,2,7,44,394
24235,24235,1C0548F40841AD0870DAD8EC7BECCBC6,13314,0,6,6,31,39,1589
24236,24236,1C0548F40841AD0870DAD8EC7BECCBC6,12521,7,11,4,35,41,1791
24237,24237,1C0548F40841AD0870DAD8EC7BECCBC6,13314,11,13,2,31,39,1589
24238,24238,1C0548F40841AD0870DAD8EC7BECCBC6,12521,14,18,4,35,41,1791
24239,24239,1C0548F40841AD0870DAD8EC7BECCBC6,13314,20,23,3,31,39,1589
24240,24240,26B9AAC369331C3B7CCBFCA623526739,43011,3,12,9,40,42,2042
24241,24241,26B9AAC369331C3B7CCBFCA623526739,10811,13,14,1,38,46,1946
24242,24242,26B9AAC369331C3B7CCBFCA623526739,42621,16,18,2,24,49,1249
24243,24243,26B9AAC369331C3B7CCBFCA623526739,10811,21,23,2,38,46,1946
24247,24247,E648A6F090A3BE85617E0ED54A73B4F0,12601,0,3,3,25,47,1297
24248,24248,E648A6F090A3BE85617E0ED54A73B4F0,12671,5,7,2,21,43,1093
24249,24249,E648A6F090A3BE85617E0ED54A73B4F0,12601,10,14,4,25,47,1297
24250,24250,E648A6F090A3BE85617E0ED54A73B4F0,12671,15,17,2,21,43,1093
24251,24251,E648A6F090A3BE85617E0ED54A73B4F0,12601,17,22,5,25,47,1297
24252,24252,50E219786E13E52AF19BF54D7BDB1D54,10751,10,13,3,47,43,2393
24253,24253,50E219786E13E52AF19BF54D7BDB1D54,12221,13,14,1,43,44,2194
24254,24254,50E219786E13E52AF19BF54D7BDB1D54,10107,16,18,2,38,49,1949
24255,24255,5507477CAE0F7F600E796239C20F4FA2,42501,1,9,8,28,47,1447
24256,24256,5507477CAE0F7F600E796239C20F4FA2,42381,13,15,2,39,41,1991
24257,24257,5507477CAE0F7F600E796239C20F4FA2,40341,18,19,1,23,49,1199
24258,24258,5507477CAE0F7F600E796239C20F4FA2,11541,20,22,2,35,49,1799
24259,24259,3C07D1557002BF4F1AA6A6D7A8949EF2,42523,3,4,1,31,47,1597
24260,24260,3C07D1557002BF4F1AA6A6D7A8949EF2,43761,8,9,1,32,47,1647
24261,24261,3C07D1557002BF4F1AA6A6D7A8949EF2,40463,12,17,5,38,49,1949
24262,24262,3C07D1557002BF4F1AA6A6D7A8949EF2,12131,18,20,2,32,47,1647
24263,24263,CC9D620B2FF16DD30482A39311FA03E8,42141,1,14,13,32,47,1647
24264,24264,CC9D620B2FF16DD30482A39311FA03E8,11161,15,16,1,32,48,1648
24265,24265,CC9D620B2FF16DD30482A39311FA03E8,42021,18,19,1,33,47,1697
24266,24266,CC9D620B2FF16DD30482A39311FA03E8,11231,22,23,1,37,49,1899
24267,24267,3C8A45B2A39299B87D30CF6AF1740216,13341,0,8,8,44,45,2245
24268,24268,3C8A45B2A39299B87D30CF6AF1740216,42461,10,11,1,45,47,2297
24269,24269,3C8A45B2A39299B87D30CF6AF1740216,13341,12,13,1,44,45,2245
24270,24270,3C8A45B2A39299B87D30CF6AF1740216,42461,15,17,2,45,47,2297
24271,24271,3C8A45B2A39299B87D30CF6AF1740216,10901,18,20,2,35,48,1798
24272,24272,3C8A45B2A39299B87D30CF6AF1740216,13341,20,23,3,44,45,2245
24283,24283,0F3B9D51ABEBD568D2353EE492F4DCAE,40171,1,2,1,38,48,1948
24284,24284,0F3B9D51ABEBD568D2353EE492F4DCAE,10471,3,6,3,37,48,1898
24285,24285,0F3B9D51ABEBD568D2353EE492F4DCAE,42581,9,12,3,38,48,1948
24286,24286,0F3B9D51ABEBD568D2353EE492F4DCAE,10471,12,13,1,37,48,1898
24287,24287,0F3B9D51ABEBD568D2353EE492F4DCAE,42581,14,18,4,38,48,1948
24288,24288,0F3B9D51ABEBD568D2353EE492F4DCAE,10471,20,23,3,37,48,1898
24292,24292,D9419B851F8839F5D675C951F631DB8E,10921,0,7,7,43,48,2198
24293,24293,D9419B851F8839F5D675C951F631DB8E,43101,8,16,8,46,40,2340
24294,24294,D9419B851F8839F5D675C951F631DB8E,10921,20,23,3,43,48,2198
24295,24295,B15DB8F603CFB397A54409016D7EC648,13101,0,9,9,40,47,2047
24296,24296,B15DB8F603CFB397A54409016D7EC648,13271,11,12,1,41,47,2097
24297,24297,B15DB8F603CFB397A54409016D7EC648,13101,12,14,2,40,47,2047
24298,24298,B15DB8F603CFB397A54409016D7EC648,40833,18,20,2,41,47,2097
24299,24299,B15DB8F603CFB397A54409016D7EC648,11481,21,23,2,41,48,2098
24303,24303,660D0729A871FB18966DF6415A58AEF7,11381,7,9,2,30,47,1547
24304,24304,660D0729A871FB18966DF6415A58AEF7,11061,9,11,2,29,48,1498
24305,24305,660D0729A871FB18966DF6415A58AEF7,11381,12,14,2,30,47,1547
24306,24306,660D0729A871FB18966DF6415A58AEF7,11061,16,18,2,29,48,1498
24307,24307,660D0729A871FB18966DF6415A58AEF7,11381,19,21,2,30,47,1547
24311,24311,C7C431E83C90A041B3FA2A63798CE4F8,12921,1,3,2,9,41,491
24312,24312,C7C431E83C90A041B3FA2A63798CE4F8,43644,4,7,3,14,38,738
24313,24313,C7C431E83C90A041B3FA2A63798CE4F8,43021,8,10,2,16,43,843
24314,24314,C7C431E83C90A041B3FA2A63798CE4F8,43644,14,19,5,14,38,738
24315,24315,C7C431E83C90A041B3FA2A63798CE4F8,43021,21,23,2,16,43,843
24319,24319,C3385B266A5088A7FA48BCC62DFDD003,42583,0,6,6,40,48,2048
24320,24320,C3385B266A5088A7FA48BCC62DFDD003,10471,6,10,4,37,48,1898
24321,24321,C3385B266A5088A7FA48BCC62DFDD003,42583,11,13,2,40,48,2048
24322,24322,C3385B266A5088A7FA48BCC62DFDD003,40171,13,16,3,38,48,1948
24323,24323,C3385B266A5088A7FA48BCC62DFDD003,42583,17,23,6,40,48,2048
24327,24327,9C853A4D5C7B5210EB733E5032A36376,11021,0,16,16,36,49,1849
24328,24328,9C853A4D5C7B5210EB733E5032A36376,10951,17,18,1,29,48,1498
24329,24329,9C853A4D5C7B5210EB733E5032A36376,11021,20,23,3,36,49,1849
24334,24334,C9C417CC20215FC88C29BB0FCAEAC56C,12581,0,8,8,24,48,1248
24335,24335,C9C417CC20215FC88C29BB0FCAEAC56C,12601,8,10,2,25,47,1297
24336,24336,C9C417CC20215FC88C29BB0FCAEAC56C,12581,12,14,2,24,48,1248
24337,24337,C9C417CC20215FC88C29BB0FCAEAC56C,12601,20,21,1,25,47,1297
24338,24338,C9C417CC20215FC88C29BB0FCAEAC56C,12581,22,23,1,24,48,1248
24346,24346,05C3A7EB5EF4E026B421540B8AC90475,12491,3,5,2,36,43,1843
24347,24347,05C3A7EB5EF4E026B421540B8AC90475,12311,6,10,4,30,44,1544
24348,24348,05C3A7EB5EF4E026B421540B8AC90475,42151,14,15,1,35,45,1795
24349,24349,05C3A7EB5EF4E026B421540B8AC90475,12311,16,18,2,30,44,1544
24350,24350,05C3A7EB5EF4E026B421540B8AC90475,42531,18,19,1,31,45,1595
24351,24351,13CC40471AC83D6354BC2D2A78721A9B,10721,0,8,8,31,48,1598
24352,24352,13CC40471AC83D6354BC2D2A78721A9B,42381,10,11,1,39,41,1991
24353,24353,13CC40471AC83D6354BC2D2A78721A9B,12401,13,14,1,39,49,1999
24354,24354,13CC40471AC83D6354BC2D2A78721A9B,10721,17,23,6,31,48,1598
24366,24366,A796809FFC26797F0B17A0B66E102B15,12521,7,9,2,35,41,1791
24367,24367,A796809FFC26797F0B17A0B66E102B15,13314,9,13,4,31,39,1589
24368,24368,A796809FFC26797F0B17A0B66E102B15,12521,13,18,5,35,41,1791
24369,24369,A796809FFC26797F0B17A0B66E102B15,13314,18,23,5,31,39,1589
24370,24370,065FDA0F1F1B82F5694B5A49131A7248,11431,0,11,11,29,47,1497
24371,24371,065FDA0F1F1B82F5694B5A49131A7248,11751,12,14,2,35,48,1798
24372,24372,065FDA0F1F1B82F5694B5A49131A7248,11431,16,18,2,29,47,1497
24373,24373,065FDA0F1F1B82F5694B5A49131A7248,40341,18,21,3,23,49,1199
24374,24374,065FDA0F1F1B82F5694B5A49131A7248,11431,21,23,2,29,47,1497
24375,24375,649CA0B4C9C73F10630BCAC6C100E533,12311,8,11,3,30,44,1544
24376,24376,649CA0B4C9C73F10630BCAC6C100E533,13231,12,13,1,39,46,1996
24377,24377,649CA0B4C9C73F10630BCAC6C100E533,12311,14,16,2,30,44,1544
24378,24378,649CA0B4C9C73F10630BCAC6C100E533,42531,17,18,1,31,45,1595
24379,24379,649CA0B4C9C73F10630BCAC6C100E533,42151,18,20,2,35,45,1795
24380,24380,6992B0D983B3C0A0A6CEEC9FA2251636,11101,1,16,15,18,48,948
24381,24381,6992B0D983B3C0A0A6CEEC9FA2251636,11104,17,18,1,17,47,897
24382,24382,6992B0D983B3C0A0A6CEEC9FA2251636,19441,21,23,2,8,46,446
24383,24383,91355BCE8BF14503E6439D9F3978B302,10151,0,9,9,34,47,1747
24384,24384,91355BCE8BF14503E6439D9F3978B302,10371,10,11,1,37,49,1899
24385,24385,91355BCE8BF14503E6439D9F3978B302,10151,16,23,7,34,47,1747
24386,24386,0BF9081B921E7C1EC68F2248D31F0D32,16281,7,8,1,11,4,554
24387,24387,0BF9081B921E7C1EC68F2248D31F0D32,15051,8,10,2,19,4,954
24388,24388,0BF9081B921E7C1EC68F2248D31F0D32,16281,13,22,9,11,4,554
24393,24393,AE1C8427E7309FB9A5C5DCEDFECA6BB0,13841,0,14,14,40,46,2046
24394,24394,AE1C8427E7309FB9A5C5DCEDFECA6BB0,40341,16,18,2,23,49,1199
24395,24395,AE1C8427E7309FB9A5C5DCEDFECA6BB0,13841,21,22,1,40,46,2046
24396,24396,D9B08428B230A26F9D8108567961B570,13671,0,6,6,27,43,1393
24397,24397,D9B08428B230A26F9D8108567961B570,11281,6,8,2,27,40,1390
24398,24398,D9B08428B230A26F9D8108567961B570,13671,8,11,3,27,43,1393
24399,24399,D9B08428B230A26F9D8108567961B570,11281,12,14,2,27,40,1390
24400,24400,D9B08428B230A26F9D8108567961B570,13671,17,19,2,27,43,1393
24407,24407,DDC57C2D8A8E33AD36EDC6A60160F725,11061,0,9,9,29,48,1498
24408,24408,DDC57C2D8A8E33AD36EDC6A60160F725,40341,10,11,1,23,49,1199
24409,24409,DDC57C2D8A8E33AD36EDC6A60160F725,11061,12,16,4,29,48,1498
24410,24410,DDC57C2D8A8E33AD36EDC6A60160F725,11151,17,19,2,30,48,1548
24411,24411,0DD51EE42A065AE9C7264B2B66A89D4A,19021,1,5,4,10,45,545
24412,24412,0DD51EE42A065AE9C7264B2B66A89D4A,12641,6,8,2,10,43,543
24413,24413,0DD51EE42A065AE9C7264B2B66A89D4A,19021,8,11,3,10,45,545
24414,24414,0DD51EE42A065AE9C7264B2B66A89D4A,12921,12,16,4,9,41,491
24415,24415,0DD51EE42A065AE9C7264B2B66A89D4A,19021,19,23,4,10,45,545
24416,24416,D5AEB0275C07F9A43E4282B7A52A66F5,11061,0,9,9,29,48,1498
24417,24417,D5AEB0275C07F9A43E4282B7A52A66F5,11211,11,12,1,34,49,1749
24418,24418,D5AEB0275C07F9A43E4282B7A52A66F5,13651,13,15,2,30,47,1547
24419,24419,D5AEB0275C07F9A43E4282B7A52A66F5,11061,19,23,4,29,48,1498
24420,24420,134926827D5E1ECC09C8575A1E6D9537,43051,1,14,13,46,45,2345
24421,24421,134926827D5E1ECC09C8575A1E6D9537,13951,16,17,1,47,45,2395
24422,24422,134926827D5E1ECC09C8575A1E6D9537,11791,20,22,2,38,49,1949
24423,24423,BDB33BB3C62B6611996C6835012F1B9F,11161,10,11,1,32,48,1648
24424,24424,BDB33BB3C62B6611996C6835012F1B9F,11151,13,15,2,30,48,1548
24425,24425,BDB33BB3C62B6611996C6835012F1B9F,40341,17,19,2,23,49,1199
24430,24430,4E334C505EDB00240ED52CD3D4C5C194,11641,0,13,13,22,49,1149
24431,24431,4E334C505EDB00240ED52CD3D4C5C194,11061,14,16,2,29,48,1498
24432,24432,4E334C505EDB00240ED52CD3D4C5C194,42481,19,23,4,22,49,1149
24439,24439,6FD561F01C19F901ECB84425772743A9,10821,0,5,5,40,47,2047
24440,24440,6FD561F01C19F901ECB84425772743A9,12561,6,8,2,45,43,2293
24441,24441,6FD561F01C19F901ECB84425772743A9,10821,10,22,12,40,47,2047
24442,24442,729777A53962E1F3578D2133C8CB379B,42633,0,7,7,42,46,2146
24443,24443,729777A53962E1F3578D2133C8CB379B,43041,8,9,1,41,46,2096
24444,24444,729777A53962E1F3578D2133C8CB379B,42633,11,13,2,42,46,2146
24445,24445,729777A53962E1F3578D2133C8CB379B,10271,15,16,1,37,46,1896
24446,24446,729777A53962E1F3578D2133C8CB379B,40691,20,21,1,42,48,2148
24447,24447,729777A53962E1F3578D2133C8CB379B,43041,22,23,1,41,46,2096
24448,24448,35852744F5904ADD083AEA3223D423A2,11061,0,9,9,29,48,1498
24449,24449,35852744F5904ADD083AEA3223D423A2,11531,13,16,3,34,49,1749
24450,24450,35852744F5904ADD083AEA3223D423A2,11061,17,18,1,29,48,1498
24451,24451,35852744F5904ADD083AEA3223D423A2,40341,18,20,2,23,49,1199
24452,24452,FF7F9E5CE2FAD8B6B285E27EA40F3632,10431,3,5,2,33,49,1699
24453,24453,FF7F9E5CE2FAD8B6B285E27EA40F3632,11954,7,18,11,32,49,1649
24454,24454,FF7F9E5CE2FAD8B6B285E27EA40F3632,42941,22,23,1,37,47,1897
24455,24455,331C93B6083F5634586EEDFC958D0A76,42351,0,6,6,38,45,1945
24456,24456,331C93B6083F5634586EEDFC958D0A76,12971,9,11,2,32,48,1648
24457,24457,331C93B6083F5634586EEDFC958D0A76,42231,12,13,1,37,46,1896
24458,24458,331C93B6083F5634586EEDFC958D0A76,12083,19,21,2,36,49,1849
24462,24462,C06A2B736F0C9DE7AE001761CE315949,15061,1,2,1,41,25,2075
24463,24463,C06A2B736F0C9DE7AE001761CE315949,12611,3,5,2,41,29,2079
24464,24464,C06A2B736F0C9DE7AE001761CE315949,12792,6,7,1,34,30,1730
24465,24465,C06A2B736F0C9DE7AE001761CE315949,15191,8,12,4,36,27,1827
24466,24466,C06A2B736F0C9DE7AE001761CE315949,12611,14,18,4,41,29,2079
24467,24467,68A1105E45875228253ACCFACF581238,15143,1,11,10,18,7,907
24468,24468,68A1105E45875228253ACCFACF581238,16281,14,16,2,11,4,554
24469,24469,68A1105E45875228253ACCFACF581238,15143,18,19,1,18,7,907
24470,24470,445C282EC1EF2D9CD074B953D3F4BD6F,11324,6,7,1,31,46,1596
24471,24471,445C282EC1EF2D9CD074B953D3F4BD6F,11151,8,13,5,30,48,1548
24472,24472,445C282EC1EF2D9CD074B953D3F4BD6F,42521,14,16,2,31,47,1597
24473,24473,445C282EC1EF2D9CD074B953D3F4BD6F,11061,16,17,1,29,48,1498
24474,24474,445C282EC1EF2D9CD074B953D3F4BD6F,42071,18,19,1,31,49,1599
24475,24475,A5073B9DCBD2B9DEFCC0B1F2FD0DC5E6,11381,4,12,8,30,47,1547
24476,24476,A5073B9DCBD2B9DEFCC0B1F2FD0DC5E6,40341,16,17,1,23,49,1199
24477,24477,A5073B9DCBD2B9DEFCC0B1F2FD0DC5E6,11381,19,23,4,30,47,1547
24478,24478,D7CBAE7AC7C39367F62B440CC08BDE7B,11231,0,2,2,37,49,1899
24479,24479,D7CBAE7AC7C39367F62B440CC08BDE7B,40171,3,4,1,38,48,1948
24480,24480,D7CBAE7AC7C39367F62B440CC08BDE7B,12971,6,21,15,32,48,1648
24481,24481,083E6F45CD758E55D59CE683A8831561,43011,1,3,2,40,42,2042
24482,24482,083E6F45CD758E55D59CE683A8831561,42381,4,6,2,39,41,1991
24483,24483,083E6F45CD758E55D59CE683A8831561,13951,7,18,11,47,45,2395
24484,24484,083E6F45CD758E55D59CE683A8831561,13121,21,22,1,38,46,1946
24489,24489,EC97F302F2783EE855C5A027BCDF9B5E,11171,2,17,15,33,48,1698
24490,24490,EC97F302F2783EE855C5A027BCDF9B5E,42351,18,21,3,38,45,1945
24491,24491,EC97F302F2783EE855C5A027BCDF9B5E,13121,22,23,1,38,46,1946
24505,24505,9AA09FAFA3A0B94587220E28842ADF00,11541,0,6,6,35,49,1799
24506,24506,9AA09FAFA3A0B94587220E28842ADF00,42801,7,8,1,40,49,2049
24507,24507,9AA09FAFA3A0B94587220E28842ADF00,10191,19,20,1,40,48,2048
24508,24508,7875A34DC3B1C1A6D18480769685A825,13911,0,5,5,39,46,1996
24509,24509,7875A34DC3B1C1A6D18480769685A825,42351,7,9,2,38,45,1945
24510,24510,7875A34DC3B1C1A6D18480769685A825,42151,11,12,1,35,45,1795
24511,24511,7875A34DC3B1C1A6D18480769685A825,42231,20,21,1,37,46,1896
24512,24512,7875A34DC3B1C1A6D18480769685A825,13911,21,22,1,39,46,1996
24513,24513,E8CCA599726B2AC03A00C0B1B8E9DC3A,12121,0,1,1,29,47,1497
24514,24514,E8CCA599726B2AC03A00C0B1B8E9DC3A,11381,2,3,1,30,47,1547
24515,24515,E8CCA599726B2AC03A00C0B1B8E9DC3A,12121,3,6,3,29,47,1497
24516,24516,E8CCA599726B2AC03A00C0B1B8E9DC3A,11381,7,9,2,30,47,1547
24517,24517,E8CCA599726B2AC03A00C0B1B8E9DC3A,12121,9,11,2,29,47,1497
24518,24518,E8CCA599726B2AC03A00C0B1B8E9DC3A,11381,14,17,3,30,47,1547
24519,24519,E8CCA599726B2AC03A00C0B1B8E9DC3A,12121,17,23,6,29,47,1497
24520,24520,39E9477CFB7A739ED25E5621F7D2A965,10821,1,13,12,40,47,2047
24521,24521,39E9477CFB7A739ED25E5621F7D2A965,42301,14,18,4,36,47,1847
24522,24522,39E9477CFB7A739ED25E5621F7D2A965,13551,19,22,3,45,38,2288
24530,24530,5DC716E0280A6C6B4246E93F2BE1607B,42921,0,7,7,33,47,1697
24531,24531,5DC716E0280A6C6B4246E93F2BE1607B,11201,9,11,2,35,49,1799
24532,24532,5DC716E0280A6C6B4246E93F2BE1607B,43761,13,15,2,32,47,1647
24533,24533,5DC716E0280A6C6B4246E93F2BE1607B,42021,20,21,1,33,47,1697
24534,24534,5DC716E0280A6C6B4246E93F2BE1607B,43761,21,23,2,32,47,1647
24535,24535,2D9F8EEE0946858BEC66856CB73B8335,43021,0,5,5,16,43,843
24536,24536,2D9F8EEE0946858BEC66856CB73B8335,12921,7,17,10,9,41,491
24537,24537,2D9F8EEE0946858BEC66856CB73B8335,43021,19,22,3,16,43,843
24538,24538,4EBB382643C7FAC868385593D235FA2B,12601,0,2,2,25,47,1297
24539,24539,4EBB382643C7FAC868385593D235FA2B,12671,5,7,2,21,43,1093
24540,24540,4EBB382643C7FAC868385593D235FA2B,12601,11,13,2,25,47,1297
24541,24541,4EBB382643C7FAC868385593D235FA2B,13091,14,15,1,20,42,1042
24542,24542,4EBB382643C7FAC868385593D235FA2B,12671,16,17,1,21,43,1093
24543,24543,4EBB382643C7FAC868385593D235FA2B,12601,19,21,2,25,47,1297
24551,24551,35DAC6756C7F4B57C2B1C6F65896CD31,10351,0,4,4,28,45,1445
24552,24552,35DAC6756C7F4B57C2B1C6F65896CD31,10634,5,11,6,27,45,1395
24553,24553,35DAC6756C7F4B57C2B1C6F65896CD31,10351,11,18,7,28,45,1445
24554,24554,35DAC6756C7F4B57C2B1C6F65896CD31,12601,19,23,4,25,47,1297
24561,24561,739AB5AD2D990A7DEFF33B710292BAED,11951,0,14,14,31,49,1599
24562,24562,739AB5AD2D990A7DEFF33B710292BAED,12021,17,19,2,37,49,1899
24563,24563,739AB5AD2D990A7DEFF33B710292BAED,11951,21,23,2,31,49,1599
24571,24571,F0D3FEBF4CC350A5851C8C36AA32D49C,11301,0,8,8,41,49,2099
24572,24572,F0D3FEBF4CC350A5851C8C36AA32D49C,40673,12,13,1,36,48,1848
24573,24573,F0D3FEBF4CC350A5851C8C36AA32D49C,11331,14,16,2,37,48,1898
24574,24574,F0D3FEBF4CC350A5851C8C36AA32D49C,42161,17,19,2,36,47,1847
24575,24575,F0D3FEBF4CC350A5851C8C36AA32D49C,11331,21,22,1,37,48,1898
24576,24576,4D7F9A766459E315716EA1D053BCDCF8,13771,1,7,6,21,45,1095
24577,24577,4D7F9A766459E315716EA1D053BCDCF8,13671,12,13,1,27,43,1393
24578,24578,4D7F9A766459E315716EA1D053BCDCF8,12521,14,15,1,35,41,1791
24579,24579,4D7F9A766459E315716EA1D053BCDCF8,13671,16,20,4,27,43,1393
24580,24580,4D7F9A766459E315716EA1D053BCDCF8,11281,22,23,1,27,40,1390
24581,24581,78B0E510C8AC1F29BEBD74E6A2E2C73D,10191,0,7,7,40,48,2048
24582,24582,78B0E510C8AC1F29BEBD74E6A2E2C73D,11161,8,17,9,32,48,1648
24583,24583,78B0E510C8AC1F29BEBD74E6A2E2C73D,10231,18,19,1,39,49,1999
24584,24584,78B0E510C8AC1F29BEBD74E6A2E2C73D,11753,21,23,2,35,48,1798
24585,24585,D1348B896638AC7A64C13B19AE981466,42141,0,8,8,32,47,1647
24586,24586,D1348B896638AC7A64C13B19AE981466,43451,12,14,2,37,40,1890
24587,24587,D1348B896638AC7A64C13B19AE981466,11861,16,23,7,32,47,1647
24588,24588,F6C54C668FECD237DA87E4FC2243153A,40171,0,1,1,38,48,1948
24589,24589,F6C54C668FECD237DA87E4FC2243153A,42321,1,7,6,43,47,2197
24590,24590,F6C54C668FECD237DA87E4FC2243153A,10691,11,15,4,33,48,1698
24591,24591,F6C54C668FECD237DA87E4FC2243153A,42321,21,23,2,43,47,2197
24596,24596,64C13D813011DB3ADB5144285311D4C8,10111,0,8,8,37,47,1897
24597,24597,64C13D813011DB3ADB5144285311D4C8,11201,9,11,2,35,49,1799
24598,24598,64C13D813011DB3ADB5144285311D4C8,10111,11,17,6,37,47,1897
24599,24599,64C13D813011DB3ADB5144285311D4C8,40341,19,21,2,23,49,1199
24600,24600,64C13D813011DB3ADB5144285311D4C8,10111,21,23,2,37,47,1897
24601,24601,8E806E086707540047E31CC3CA95A286,11834,0,8,8,32,45,1645
24602,24602,8E806E086707540047E31CC3CA95A286,42541,9,10,1,25,47,1297
24603,24603,8E806E086707540047E31CC3CA95A286,10716,13,17,4,30,46,1546
24604,24604,8E806E086707540047E31CC3CA95A286,12601,20,22,2,25,47,1297
24605,24605,60268F7A02ED65A28DFDDFCBD631880E,11751,0,1,1,35,48,1798
24606,24606,60268F7A02ED65A28DFDDFCBD631880E,42351,2,18,16,38,45,1945
24607,24607,60268F7A02ED65A28DFDDFCBD631880E,11751,20,21,1,35,48,1798
24611,24611,94092014F9DD3213271810B8D19555BE,49201,0,5,5,7,41,391
24612,24612,94092014F9DD3213271810B8D19555BE,12641,7,8,1,10,43,543
24613,24613,94092014F9DD3213271810B8D19555BE,19021,10,17,7,10,45,545
24614,24614,94092014F9DD3213271810B8D19555BE,49201,21,23,2,7,41,391
24619,24619,EEB3CBC85DF19031E292162C06516E43,10471,7,12,5,37,48,1898
24620,24620,EEB3CBC85DF19031E292162C06516E43,11381,14,19,5,30,47,1547
24621,24621,EEB3CBC85DF19031E292162C06516E43,40077,19,22,3,37,49,1899
24622,24622,EEB3CBC85DF19031E292162C06516E43,11381,22,23,1,30,47,1547
24626,24626,5BDD3929AF6E8091BBAE0A926D4F3F11,11061,0,8,8,29,48,1498
24627,24627,5BDD3929AF6E8091BBAE0A926D4F3F11,43761,12,13,1,32,47,1647
24628,24628,5BDD3929AF6E8091BBAE0A926D4F3F11,13601,14,15,1,34,47,1747
24629,24629,5BDD3929AF6E8091BBAE0A926D4F3F11,43761,16,21,5,32,47,1647
24630,24630,DE5F96E34E99D2F6A2C0DEB645C43B1D,42221,0,13,13,38,48,1948
24631,24631,DE5F96E34E99D2F6A2C0DEB645C43B1D,42271,14,15,1,40,47,2047
24632,24632,DE5F96E34E99D2F6A2C0DEB645C43B1D,40341,16,19,3,23,49,1199
24633,24633,DE5F96E34E99D2F6A2C0DEB645C43B1D,42271,20,22,2,40,47,2047
24642,24642,D29579433637905809D9DF6839E94DB4,11901,0,10,10,42,49,2149
24643,24643,D29579433637905809D9DF6839E94DB4,40341,12,19,7,23,49,1199
24644,24644,D29579433637905809D9DF6839E94DB4,11901,20,23,3,42,49,2149
24648,24648,21CAF4F5B17C418623F51F25C8C984C0,11731,2,12,10,36,48,1848
24649,24649,21CAF4F5B17C418623F51F25C8C984C0,11781,13,15,2,38,49,1949
24650,24650,21CAF4F5B17C418623F51F25C8C984C0,40341,18,21,3,23,49,1199
24654,24654,1D0327B2EE7BCEE22992382E18B29BCD,10801,0,2,2,42,47,2147
24655,24655,1D0327B2EE7BCEE22992382E18B29BCD,12651,4,5,1,43,47,2197
24656,24656,1D0327B2EE7BCEE22992382E18B29BCD,10801,5,8,3,42,47,2147
24657,24657,1D0327B2EE7BCEE22992382E18B29BCD,12651,9,10,1,43,47,2197
24658,24658,1D0327B2EE7BCEE22992382E18B29BCD,10801,13,21,8,42,47,2147
24668,24668,6FB9FC116D1D3B27DB4C5F481BA3C696,42401,0,11,11,36,47,1847
24669,24669,6FB9FC116D1D3B27DB4C5F481BA3C696,11771,13,14,1,39,49,1999
24670,24670,6FB9FC116D1D3B27DB4C5F481BA3C696,42401,16,18,2,36,47,1847
24671,24671,6FB9FC116D1D3B27DB4C5F481BA3C696,10111,18,20,2,37,47,1897
24672,24672,D6932FB45D03368B8FD3FCD5E6F4054F,13271,0,6,6,41,47,2097
24673,24673,D6932FB45D03368B8FD3FCD5E6F4054F,11261,8,10,2,36,46,1846
24674,24674,D6932FB45D03368B8FD3FCD5E6F4054F,11481,11,19,8,41,48,2098
24675,24675,D6932FB45D03368B8FD3FCD5E6F4054F,10381,20,21,1,31,49,1599
24679,24679,656752102BA99654C7060CE5B2133D72,19114,0,5,5,7,43,393
24680,24680,656752102BA99654C7060CE5B2133D72,12921,6,8,2,9,41,491
24681,24681,656752102BA99654C7060CE5B2133D72,12641,8,10,2,10,43,543
24682,24682,656752102BA99654C7060CE5B2133D72,19114,11,13,2,7,43,393
24683,24683,656752102BA99654C7060CE5B2133D72,12641,15,16,1,10,43,543
24684,24684,656752102BA99654C7060CE5B2133D72,12921,16,18,2,9,41,491
24685,24685,656752102BA99654C7060CE5B2133D72,19114,21,23,2,7,43,393
24686,24686,E3F6BEAC53881C33A9632EFCBC166461,13511,0,9,9,34,48,1748
24687,24687,E3F6BEAC53881C33A9632EFCBC166461,10801,11,12,1,42,47,2147
24688,24688,E3F6BEAC53881C33A9632EFCBC166461,13561,16,17,1,37,49,1899
24689,24689,E3F6BEAC53881C33A9632EFCBC166461,10801,18,21,3,42,47,2147
24693,24693,6FE087EF982BDB2568A12CCC091731A0,13321,0,6,6,41,37,2087
24694,24694,6FE087EF982BDB2568A12CCC091731A0,43841,8,9,1,40,37,2037
24695,24695,6FE087EF982BDB2568A12CCC091731A0,13071,9,13,4,41,41,2091
24696,24696,6FE087EF982BDB2568A12CCC091731A0,43451,16,20,4,37,40,1890
24700,24700,DEA13AE4E25C1F5535D501BC3C7ECF55,19111,0,8,8,9,45,495
24701,24701,DEA13AE4E25C1F5535D501BC3C7ECF55,10061,12,13,1,20,46,1046
24702,24702,DEA13AE4E25C1F5535D501BC3C7ECF55,42711,15,18,3,26,48,1348
24703,24703,DEA13AE4E25C1F5535D501BC3C7ECF55,10721,20,23,3,31,48,1598
24704,24704,2E7CC4EF44F5328D020B21B2138E3C1D,11061,0,2,2,29,48,1498
24705,24705,2E7CC4EF44F5328D020B21B2138E3C1D,12381,2,5,3,32,48,1648
24706,24706,2E7CC4EF44F5328D020B21B2138E3C1D,11061,5,17,12,29,48,1498
24707,24707,2E7CC4EF44F5328D020B21B2138E3C1D,10721,18,19,1,31,48,1598
24708,24708,2E7CC4EF44F5328D020B21B2138E3C1D,11061,20,22,2,29,48,1498
24709,24709,BA9C422AA929CA6E986445CAE4D37AFA,13371,3,10,7,41,47,2097
24710,24710,BA9C422AA929CA6E986445CAE4D37AFA,10411,12,14,2,36,48,1848
24711,24711,BA9C422AA929CA6E986445CAE4D37AFA,13371,14,23,9,41,47,2097
24712,24712,C1CF59B64EE7642E956AF0C2EBE03CC9,42921,0,16,16,33,47,1697
24713,24713,C1CF59B64EE7642E956AF0C2EBE03CC9,11781,17,19,2,38,49,1949
24714,24714,C1CF59B64EE7642E956AF0C2EBE03CC9,42921,20,23,3,33,47,1697
24719,24719,3CF7B0916CDE9473EE3871FE908999F3,19901,0,9,9,7,44,394
24720,24720,3CF7B0916CDE9473EE3871FE908999F3,12921,13,18,5,9,41,491
24721,24721,3CF7B0916CDE9473EE3871FE908999F3,19901,20,22,2,7,44,394
24722,24722,2F8CA12038D8BFDAC42D43FF94213821,43011,4,5,1,40,42,2042
24723,24723,2F8CA12038D8BFDAC42D43FF94213821,43451,6,9,3,37,40,1890
24724,24724,2F8CA12038D8BFDAC42D43FF94213821,42381,11,13,2,39,41,1991
24725,24725,2F8CA12038D8BFDAC42D43FF94213821,43451,14,18,4,37,40,1890
24726,24726,2F8CA12038D8BFDAC42D43FF94213821,42381,19,23,4,39,41,1991
24734,24734,055660D96102C90837257CF6FD6D548A,13911,0,3,3,39,46,1996
24735,24735,055660D96102C90837257CF6FD6D548A,11261,6,7,1,36,46,1846
24736,24736,055660D96102C90837257CF6FD6D548A,11331,9,13,4,37,48,1898
24737,24737,055660D96102C90837257CF6FD6D548A,11261,18,19,1,36,46,1846
24738,24738,055660D96102C90837257CF6FD6D548A,13341,19,20,1,44,45,2245
24739,24739,015977F21CA69DACA3E876A5F028B2A4,43051,0,5,5,46,45,2345
24740,24740,015977F21CA69DACA3E876A5F028B2A4,11701,6,7,1,43,48,2198
24741,24741,015977F21CA69DACA3E876A5F028B2A4,13351,11,12,1,48,48,2448
24742,24742,015977F21CA69DACA3E876A5F028B2A4,13951,12,15,3,47,45,2395
24743,24743,015977F21CA69DACA3E876A5F028B2A4,13351,15,20,5,48,48,2448
24744,24744,015977F21CA69DACA3E876A5F028B2A4,43051,21,23,2,46,45,2345
24748,24748,AC38F90B82E2DAAA768172BDE9BA8C19,13121,0,8,8,38,46,1946
24749,24749,AC38F90B82E2DAAA768172BDE9BA8C19,41601,12,13,1,39,49,1999
24750,24750,AC38F90B82E2DAAA768172BDE9BA8C19,11901,19,23,4,42,49,2149
24754,24754,C77F23D19DAEA5BB8ADE1BB3D3C261B4,13091,2,6,4,20,42,1042
24755,24755,C77F23D19DAEA5BB8ADE1BB3D3C261B4,13911,8,17,9,39,46,1996
24756,24756,C77F23D19DAEA5BB8ADE1BB3D3C261B4,13671,21,23,2,27,43,1393
24760,24760,E574F3730FD0D113C2FFCDB43DA8AFC3,10901,0,1,1,35,48,1798
24761,24761,E574F3730FD0D113C2FFCDB43DA8AFC3,10951,1,9,8,29,48,1498
24762,24762,E574F3730FD0D113C2FFCDB43DA8AFC3,42623,17,21,4,22,49,1149
24763,24763,42AA729D47E6C965205277DCB12E4F32,19741,1,5,4,5,44,294
24764,24764,42AA729D47E6C965205277DCB12E4F32,19031,5,7,2,1,42,92
24765,24765,42AA729D47E6C965205277DCB12E4F32,19741,11,14,3,5,44,294
24766,24766,42AA729D47E6C965205277DCB12E4F32,19181,15,16,1,8,40,440
24767,24767,42AA729D47E6C965205277DCB12E4F32,19741,20,23,3,5,44,294
24778,24778,5D94F7B8938FA1F85996B52812F07179,12581,7,8,1,24,48,1248
24779,24779,5D94F7B8938FA1F85996B52812F07179,10061,12,14,2,20,46,1046
24780,24780,5D94F7B8938FA1F85996B52812F07179,43731,18,20,2,34,47,1747
24781,24781,5D94F7B8938FA1F85996B52812F07179,10841,21,23,2,37,47,1897
24782,24782,32D84303772218703F84881EDD02368C,11301,0,15,15,41,49,2099
24783,24783,32D84303772218703F84881EDD02368C,11914,15,17,2,37,48,1898
24784,24784,32D84303772218703F84881EDD02368C,10251,19,23,4,35,47,1797
24794,24794,CD52B23153B32DF9098DFA2E090DCA75,12381,0,6,6,32,48,1648
24795,24795,CD52B23153B32DF9098DFA2E090DCA75,42864,8,11,3,38,44,1944
24796,24796,CD52B23153B32DF9098DFA2E090DCA75,10341,12,13,1,31,47,1597
24797,24797,CD52B23153B32DF9098DFA2E090DCA75,12381,16,22,6,32,48,1648
24798,24798,AFC682DA7B2C15A5BBB72506964CC56C,11001,0,6,6,42,47,2147
24799,24799,AFC682DA7B2C15A5BBB72506964CC56C,13941,6,9,3,41,47,2097
24800,24800,AFC682DA7B2C15A5BBB72506964CC56C,11001,14,15,1,42,47,2147
24801,24801,AFC682DA7B2C15A5BBB72506964CC56C,13941,15,18,3,41,47,2097
24802,24802,AFC682DA7B2C15A5BBB72506964CC56C,11001,18,22,4,42,47,2147
24809,24809,0CA94BF547334FA1B643CF26B9CBE337,13411,0,14,14,49,42,2492
24810,24810,0CA94BF547334FA1B643CF26B9CBE337,43951,16,17,1,49,41,2491
24811,24811,0CA94BF547334FA1B643CF26B9CBE337,43101,18,19,1,46,40,2340
24812,24812,0CA94BF547334FA1B643CF26B9CBE337,13411,20,22,2,49,42,2492
24817,24817,748B2DC185C417D09ADADEB5E78F0054,11771,0,6,6,39,49,1999
24818,24818,748B2DC185C417D09ADADEB5E78F0054,42523,10,14,4,31,47,1597
24819,24819,748B2DC185C417D09ADADEB5E78F0054,11791,17,18,1,38,49,1949
24820,24820,748B2DC185C417D09ADADEB5E78F0054,11771,19,23,4,39,49,1999
24824,24824,8A6733FDC0C9C057F881E617DF5C5C85,12131,0,11,11,32,47,1647
24825,24825,8A6733FDC0C9C057F881E617DF5C5C85,42941,13,17,4,37,47,1897
24826,24826,8A6733FDC0C9C057F881E617DF5C5C85,12131,18,23,5,32,47,1647
24830,24830,D73AC4E1047F9CA440E1B319E99C168F,10801,0,9,9,42,47,2147
24831,24831,D73AC4E1047F9CA440E1B319E99C168F,42641,10,12,2,33,49,1699
24832,24832,D73AC4E1047F9CA440E1B319E99C168F,10801,14,23,9,42,47,2147
24836,24836,D7F8F71ED9B8159734D8CFCB18871A01,13111,0,8,8,42,46,2146
24837,24837,D7F8F71ED9B8159734D8CFCB18871A01,11301,9,10,1,41,49,2099
24838,24838,D7F8F71ED9B8159734D8CFCB18871A01,11531,11,12,1,34,49,1749
24839,24839,D7F8F71ED9B8159734D8CFCB18871A01,13111,13,15,2,42,46,2146
24840,24840,D7F8F71ED9B8159734D8CFCB18871A01,43981,15,19,4,36,49,1849
24841,24841,D7F8F71ED9B8159734D8CFCB18871A01,13111,20,23,3,42,46,2146
24842,24842,330D560471771E22FA863AE2E7078EE3,42141,3,8,5,32,47,1647
24843,24843,330D560471771E22FA863AE2E7078EE3,10107,9,11,2,38,49,1949
24844,24844,330D560471771E22FA863AE2E7078EE3,43761,18,23,5,32,47,1647
24845,24845,4C8E92DBB85921608C1C92929A7A8C92,42521,0,6,6,31,47,1597
24846,24846,4C8E92DBB85921608C1C92929A7A8C92,13651,7,11,4,30,47,1547
24847,24847,4C8E92DBB85921608C1C92929A7A8C92,42521,12,13,1,31,47,1597
24848,24848,4C8E92DBB85921608C1C92929A7A8C92,13651,16,17,1,30,47,1547
24849,24849,4C8E92DBB85921608C1C92929A7A8C92,42521,22,23,1,31,47,1597
24850,24850,8FB1F6A24CA6533AD31173991C41B1F1,10151,0,11,11,34,47,1747
24851,24851,8FB1F6A24CA6533AD31173991C41B1F1,42351,11,12,1,38,45,1945
24852,24852,8FB1F6A24CA6533AD31173991C41B1F1,10781,15,17,2,35,47,1797
24853,24853,8FB1F6A24CA6533AD31173991C41B1F1,10151,18,21,3,34,47,1747
24854,24854,8FB1F6A24CA6533AD31173991C41B1F1,11231,22,23,1,37,49,1899
24858,24858,F7A05B3FECD253C9C578617425D22E9D,40302,7,11,4,40,49,2049
24859,24859,F7A05B3FECD253C9C578617425D22E9D,40365,13,15,2,42,48,2148
24860,24860,F7A05B3FECD253C9C578617425D22E9D,13351,17,20,3,48,48,2448
24861,24861,F7A05B3FECD253C9C578617425D22E9D,11481,21,22,1,41,48,2098
24862,24862,9BD9C3D4B6E110FE7FD8E3DDE3DF409B,12651,1,16,15,43,47,2197
24863,24863,9BD9C3D4B6E110FE7FD8E3DDE3DF409B,40341,17,19,2,23,49,1199
24864,24864,9BD9C3D4B6E110FE7FD8E3DDE3DF409B,12651,20,23,3,43,47,2197
24872,24872,0102436000D6EFDA91A3939751E37135,13351,9,13,4,48,48,2448
24873,24873,0102436000D6EFDA91A3939751E37135,42631,14,16,2,43,45,2195
24874,24874,0102436000D6EFDA91A3939751E37135,43061,19,20,1,43,46,2196
24875,24875,0102436000D6EFDA91A3939751E37135,42631,21,22,1,43,45,2195
24882,24882,83F2640D21345A35D8A8F80AAF4553B1,13111,0,7,7,42,46,2146
24883,24883,83F2640D21345A35D8A8F80AAF4553B1,19111,9,15,6,9,45,495
24884,24884,83F2640D21345A35D8A8F80AAF4553B1,11131,18,19,1,33,48,1698
24885,24885,83F2640D21345A35D8A8F80AAF4553B1,11201,19,22,3,35,49,1799
24886,24886,36440883919C51C9292EBA2E2CEBC5B3,10401,0,3,3,33,49,1699
24887,24887,36440883919C51C9292EBA2E2CEBC5B3,10221,8,15,7,34,49,1749
24888,24888,36440883919C51C9292EBA2E2CEBC5B3,40341,17,20,3,23,49,1199
24889,24889,7B34C273E34CE1CA5EC462EE747405EC,42031,0,7,7,40,46,2046
24890,24890,7B34C273E34CE1CA5EC462EE747405EC,12921,9,10,1,9,41,491
24891,24891,7B34C273E34CE1CA5EC462EE747405EC,43644,11,12,1,14,38,738
24892,24892,7B34C273E34CE1CA5EC462EE747405EC,12921,12,16,4,9,41,491
24893,24893,7B34C273E34CE1CA5EC462EE747405EC,10191,18,19,1,40,48,2048
24901,24901,43FDBDEDEEB9A933C806C05A34BCE296,10881,1,2,1,34,48,1748
24902,24902,43FDBDEDEEB9A933C806C05A34BCE296,43581,3,6,3,33,48,1698
24903,24903,43FDBDEDEEB9A933C806C05A34BCE296,10221,6,7,1,34,49,1749
24904,24904,43FDBDEDEEB9A933C806C05A34BCE296,15411,12,17,5,44,27,2227
24905,24905,43FDBDEDEEB9A933C806C05A34BCE296,13251,21,22,1,48,28,2428
24906,24906,43FDBDEDEEB9A933C806C05A34BCE296,15411,22,23,1,44,27,2227
24907,24907,BEEB427083CD1CDCE4F998989E7EA664,43021,0,1,1,16,43,843
24908,24908,BEEB427083CD1CDCE4F998989E7EA664,19021,2,14,12,10,45,545
24909,24909,BEEB427083CD1CDCE4F998989E7EA664,43021,15,17,2,16,43,843
24910,24910,BEEB427083CD1CDCE4F998989E7EA664,19021,20,23,3,10,45,545
24911,24911,D8FB972AAAC5DB0F06EEBA221E7E96BB,13951,0,7,7,47,45,2395
24912,24912,D8FB972AAAC5DB0F06EEBA221E7E96BB,12971,8,18,10,32,48,1648
24913,24913,D8FB972AAAC5DB0F06EEBA221E7E96BB,42231,18,19,1,37,46,1896
24914,24914,D8FB972AAAC5DB0F06EEBA221E7E96BB,13951,20,22,2,47,45,2395
24915,24915,4EC8D8BFDD4FC00C53BDA72AE182E742,42511,0,10,10,37,47,1897
24916,24916,4EC8D8BFDD4FC00C53BDA72AE182E742,12514,11,14,3,38,47,1947
24917,24917,4EC8D8BFDD4FC00C53BDA72AE182E742,10841,15,17,2,37,47,1897
24918,24918,4EC8D8BFDD4FC00C53BDA72AE182E742,10107,18,20,2,38,49,1949
24919,24919,4EC8D8BFDD4FC00C53BDA72AE182E742,42511,21,23,2,37,47,1897
24923,24923,1078436CC9F31DFE63B8B6F9AEB69E32,42151,5,15,10,35,45,1795
24924,24924,1078436CC9F31DFE63B8B6F9AEB69E32,11861,15,17,2,32,47,1647
24925,24925,1078436CC9F31DFE63B8B6F9AEB69E32,42151,17,18,1,35,45,1795
24926,24926,1078436CC9F31DFE63B8B6F9AEB69E32,11231,22,23,1,37,49,1899
24931,24931,50673603A4E10F5F55E83AA75E1A8A25,10691,0,7,7,33,48,1698
24932,24932,50673603A4E10F5F55E83AA75E1A8A25,13561,8,9,1,37,49,1899
24933,24933,50673603A4E10F5F55E83AA75E1A8A25,11021,10,18,8,36,49,1849
24934,24934,50673603A4E10F5F55E83AA75E1A8A25,10691,19,23,4,33,48,1698
24935,24935,D256AE34DD31744D7365602849D9C40A,10341,0,6,6,31,47,1597
24936,24936,D256AE34DD31744D7365602849D9C40A,42491,7,8,1,32,46,1646
24937,24937,D256AE34DD31744D7365602849D9C40A,12601,9,17,8,25,47,1297
24938,24938,D256AE34DD31744D7365602849D9C40A,42491,18,23,5,32,46,1646
24939,24939,04E25EABAF57B3731144C024B2F68618,13341,10,13,3,44,45,2245
24940,24940,04E25EABAF57B3731144C024B2F68618,42631,13,16,3,43,45,2195
24941,24941,04E25EABAF57B3731144C024B2F68618,13341,17,18,1,44,45,2245
24942,24942,04E25EABAF57B3731144C024B2F68618,42631,19,20,1,43,45,2195
24943,24943,04E25EABAF57B3731144C024B2F68618,13341,22,23,1,44,45,2245
24944,24944,AD054AE8A7B4E85DE142512CC2E7941D,10611,0,11,11,32,48,1648
24945,24945,AD054AE8A7B4E85DE142512CC2E7941D,42511,12,13,1,37,47,1897
24946,24946,AD054AE8A7B4E85DE142512CC2E7941D,10611,16,23,7,32,48,1648
24947,24947,53DE27C3988F5D22526FCC360F8F3A99,11324,0,5,5,31,46,1596
24948,24948,53DE27C3988F5D22526FCC360F8F3A99,10716,6,8,2,30,46,1546
24949,24949,53DE27C3988F5D22526FCC360F8F3A99,42523,10,15,5,31,47,1597
24950,24950,53DE27C3988F5D22526FCC360F8F3A99,10611,16,17,1,32,48,1648
24951,24951,53DE27C3988F5D22526FCC360F8F3A99,11321,21,23,2,31,46,1596
24952,24952,911E50F7AD4241B03D32542D259763EC,10351,0,5,5,28,45,1445
24953,24953,911E50F7AD4241B03D32542D259763EC,12671,6,7,1,21,43,1093
24954,24954,911E50F7AD4241B03D32542D259763EC,10351,8,16,8,28,45,1445
24955,24955,911E50F7AD4241B03D32542D259763EC,10634,21,23,2,27,45,1395
24956,24956,9D3AFAB836497D9B20982A4423B1B10D,11381,0,11,11,30,47,1547
24957,24957,9D3AFAB836497D9B20982A4423B1B10D,11201,12,14,2,35,49,1799
24958,24958,9D3AFAB836497D9B20982A4423B1B10D,11381,17,22,5,30,47,1547
24959,24959,09C172BA90724F27CBA36161F7F58B96,13651,0,13,13,30,47,1547
24960,24960,09C172BA90724F27CBA36161F7F58B96,40341,14,16,2,23,49,1199
24961,24961,09C172BA90724F27CBA36161F7F58B96,13651,17,22,5,30,47,1547
24962,24962,22A645825402D53B3D607F73188DD428,42941,1,7,6,37,47,1897
24963,24963,22A645825402D53B3D607F73188DD428,43181,8,9,1,39,48,1998
24964,24964,22A645825402D53B3D607F73188DD428,43021,12,14,2,16,43,843
24965,24965,22A645825402D53B3D607F73188DD428,42581,16,17,1,38,48,1948
24966,24966,22A645825402D53B3D607F73188DD428,40203,19,21,2,33,49,1699
24967,24967,22A645825402D53B3D607F73188DD428,42301,22,23,1,36,47,1847
24968,24968,E2F2F4143F844EB76521711717E3F1F1,43644,0,6,6,14,38,738
24969,24969,E2F2F4143F844EB76521711717E3F1F1,12641,9,10,1,10,43,543
24970,24970,E2F2F4143F844EB76521711717E3F1F1,12921,13,15,2,9,41,491
24971,24971,E2F2F4143F844EB76521711717E3F1F1,12641,15,19,4,10,43,543
24972,24972,E2F2F4143F844EB76521711717E3F1F1,19261,21,23,2,6,37,337
24973,24973,CD5F8D7604C7020A19DDE3C48998E9F5,13314,0,5,5,31,39,1589
24974,24974,CD5F8D7604C7020A19DDE3C48998E9F5,12521,6,18,12,35,41,1791
24975,24975,CD5F8D7604C7020A19DDE3C48998E9F5,13314,22,23,1,31,39,1589
24996,24996,58FF60972C1637520443DC5766A2AB67,13411,1,5,4,49,42,2492
24997,24997,58FF60972C1637520443DC5766A2AB67,43951,6,10,4,49,41,2491
24998,24998,58FF60972C1637520443DC5766A2AB67,13411,11,13,2,49,42,2492
24999,24999,58FF60972C1637520443DC5766A2AB67,43951,13,18,5,49,41,2491
25000,25000,58FF60972C1637520443DC5766A2AB67,13411,19,23,4,49,42,2492
25001,25001,D3F6CC79419CB8E677F2F17C3DF072CD,13121,0,5,5,38,46,1946
25002,25002,D3F6CC79419CB8E677F2F17C3DF072CD,13331,6,8,2,38,47,1947
25003,25003,D3F6CC79419CB8E677F2F17C3DF072CD,13711,10,13,3,38,46,1946
25004,25004,D3F6CC79419CB8E677F2F17C3DF072CD,13331,13,18,5,38,47,1947
25005,25005,D3F6CC79419CB8E677F2F17C3DF072CD,13121,20,23,3,38,46,1946
25022,25022,AC63A44AAFE297AD4CD776B1B1348D18,12401,0,10,10,39,49,1999
25023,25023,AC63A44AAFE297AD4CD776B1B1348D18,12601,14,16,2,25,47,1297
25024,25024,AC63A44AAFE297AD4CD776B1B1348D18,10491,19,20,1,33,48,1698
25035,25035,ED7978CEB7842F8AEDFD4F63C4901DD7,10301,0,7,7,31,45,1595
25036,25036,ED7978CEB7842F8AEDFD4F63C4901DD7,12601,10,13,3,25,47,1297
25037,25037,ED7978CEB7842F8AEDFD4F63C4901DD7,11324,14,22,8,31,46,1596
25041,25041,DC38A48F0665D559EEBE1B125DB4DDCA,13651,7,12,5,30,47,1547
25042,25042,DC38A48F0665D559EEBE1B125DB4DDCA,10331,13,16,3,39,46,1996
25043,25043,DC38A48F0665D559EEBE1B125DB4DDCA,40341,18,20,2,23,49,1199
25044,25044,DC38A48F0665D559EEBE1B125DB4DDCA,10331,22,23,1,39,46,1996
25049,25049,CF045BB51AB834592F0FA9268C200D5E,11491,0,10,10,36,47,1847
25050,25050,CF045BB51AB834592F0FA9268C200D5E,10161,13,14,1,35,49,1799
25051,25051,CF045BB51AB834592F0FA9268C200D5E,10107,14,17,3,38,49,1949
25052,25052,CF045BB51AB834592F0FA9268C200D5E,11541,18,21,3,35,49,1799
25053,25053,CF045BB51AB834592F0FA9268C200D5E,11491,22,23,1,36,47,1847
25057,25057,73C431267E9D15126DD630F092950C8C,42461,10,12,2,45,47,2297
25058,25058,73C431267E9D15126DD630F092950C8C,11771,13,15,2,39,49,1999
25059,25059,73C431267E9D15126DD630F092950C8C,11201,18,19,1,35,49,1799
25063,25063,23A21A73FEBD9CCFAF6CD9924910EBC0,10901,0,14,14,35,48,1798
25064,25064,23A21A73FEBD9CCFAF6CD9924910EBC0,11804,14,18,4,41,48,2098
25065,25065,23A21A73FEBD9CCFAF6CD9924910EBC0,42161,20,22,2,36,47,1847
25073,25073,A5BFF32240AF511BF31ADB547FFA4DAD,11491,0,7,7,36,47,1847
25074,25074,A5BFF32240AF511BF31ADB547FFA4DAD,10721,8,12,4,31,48,1598
25075,25075,A5BFF32240AF511BF31ADB547FFA4DAD,12381,14,21,7,32,48,1648
25076,25076,A5219D131E78CB02D96F02B95ED0AA34,10271,8,10,2,37,46,1896
25077,25077,A5219D131E78CB02D96F02B95ED0AA34,10111,13,16,3,37,47,1897
25078,25078,A5219D131E78CB02D96F02B95ED0AA34,11301,18,20,2,41,49,2099
25079,25079,802D06E8811CDC65FDAB61E1A1D233B3,12601,0,3,3,25,47,1297
25080,25080,802D06E8811CDC65FDAB61E1A1D233B3,10501,3,6,3,22,46,1146
25081,25081,802D06E8811CDC65FDAB61E1A1D233B3,12601,7,8,1,25,47,1297
25082,25082,802D06E8811CDC65FDAB61E1A1D233B3,10691,9,18,9,33,48,1698
25083,25083,802D06E8811CDC65FDAB61E1A1D233B3,12601,19,21,2,25,47,1297
25084,25084,29EECA43EEFE59ADAFABFF01A5C4E8B8,19441,0,6,6,8,46,446
25085,25085,29EECA43EEFE59ADAFABFF01A5C4E8B8,11571,8,9,1,13,46,696
25086,25086,29EECA43EEFE59ADAFABFF01A5C4E8B8,42041,13,14,1,10,47,547
25087,25087,29EECA43EEFE59ADAFABFF01A5C4E8B8,19901,17,18,1,7,44,394
25088,25088,29EECA43EEFE59ADAFABFF01A5C4E8B8,19024,21,22,1,9,45,495
25089,25089,7EA63201A47B68AA085BD7B8AF1F7767,10721,0,7,7,31,48,1598
25090,25090,7EA63201A47B68AA085BD7B8AF1F7767,10121,11,12,1,36,49,1849
25091,25091,7EA63201A47B68AA085BD7B8AF1F7767,11231,14,17,3,37,49,1899
25092,25092,7EA63201A47B68AA085BD7B8AF1F7767,10721,18,22,4,31,48,1598
25096,25096,03D1DC160CBADBB0DE0023DCA3409F5F,11741,0,5,5,42,49,2149
25097,25097,03D1DC160CBADBB0DE0023DCA3409F5F,10107,8,9,1,38,49,1949
25098,25098,03D1DC160CBADBB0DE0023DCA3409F5F,10611,13,15,2,32,48,1648
25099,25099,03D1DC160CBADBB0DE0023DCA3409F5F,11794,16,20,4,38,49,1949
25100,25100,A6F4E0A14DDF72AB1602B3834CD2AC43,11914,0,4,4,37,48,1898
25101,25101,A6F4E0A14DDF72AB1602B3834CD2AC43,43361,7,9,2,38,48,1948
25102,25102,A6F4E0A14DDF72AB1602B3834CD2AC43,11914,12,13,1,37,48,1898
25103,25103,A6F4E0A14DDF72AB1602B3834CD2AC43,43361,15,19,4,38,48,1948
25104,25104,A6F4E0A14DDF72AB1602B3834CD2AC43,11914,19,22,3,37,48,1898
25105,25105,E0F3A68E2935541E84AD4E1526A976E8,42281,1,9,8,40,48,2048
25106,25106,E0F3A68E2935541E84AD4E1526A976E8,13381,12,13,1,39,47,1997
25107,25107,E0F3A68E2935541E84AD4E1526A976E8,42281,14,16,2,40,48,2048
25108,25108,E0F3A68E2935541E84AD4E1526A976E8,13951,19,20,1,47,45,2395
25109,25109,B95248A393261A4557DDFBDFBDBBE5C4,40101,3,8,5,34,49,1749
25110,25110,B95248A393261A4557DDFBDFBDBBE5C4,42523,10,17,7,31,47,1597
25111,25111,B95248A393261A4557DDFBDFBDBBE5C4,10221,17,20,3,34,49,1749
25112,25112,24517D61FB768E2EEA9476C907365BA4,11801,0,14,14,42,48,2148
25113,25113,24517D61FB768E2EEA9476C907365BA4,11753,14,16,2,35,48,1798
25114,25114,24517D61FB768E2EEA9476C907365BA4,11801,16,21,5,42,48,2148
25115,25115,2B393DCEE96CA0B48803BDF9B1BBDE4E,10151,0,8,8,34,47,1747
25116,25116,2B393DCEE96CA0B48803BDF9B1BBDE4E,11481,10,14,4,41,48,2098
25117,25117,2B393DCEE96CA0B48803BDF9B1BBDE4E,13101,16,17,1,40,47,2047
25118,25118,2B393DCEE96CA0B48803BDF9B1BBDE4E,10151,18,23,5,34,47,1747
25119,25119,21B656E93C25F88D6CD1C23ADB7656C7,11011,0,6,6,39,49,1999
25120,25120,21B656E93C25F88D6CD1C23ADB7656C7,10341,8,9,1,31,47,1597
25121,25121,21B656E93C25F88D6CD1C23ADB7656C7,11301,13,14,1,41,49,2099
25122,25122,21B656E93C25F88D6CD1C23ADB7656C7,42491,16,18,2,32,46,1646
25127,25127,C54B7E894D1C5CD6E84B2182058F9208,42151,2,5,3,35,45,1795
25128,25128,C54B7E894D1C5CD6E84B2182058F9208,42864,9,10,1,38,44,1944
25129,25129,C54B7E894D1C5CD6E84B2182058F9208,43451,12,18,6,37,40,1890
25130,25130,C54B7E894D1C5CD6E84B2182058F9208,12491,19,21,2,36,43,1843
25131,25131,550035E235750077DB6B90A64CB04939,43671,0,3,3,35,48,1798
25132,25132,550035E235750077DB6B90A64CB04939,11771,4,6,2,39,49,1999
25133,25133,550035E235750077DB6B90A64CB04939,42321,8,10,2,43,47,2197
25134,25134,550035E235750077DB6B90A64CB04939,42221,12,18,6,38,48,1948
25135,25135,8894FD870225ED0E76C0B591E05E89EC,10881,0,13,13,34,48,1748
25136,25136,8894FD870225ED0E76C0B591E05E89EC,40073,14,16,2,37,48,1898
25137,25137,8894FD870225ED0E76C0B591E05E89EC,11061,18,19,1,29,48,1498
25138,25138,8894FD870225ED0E76C0B591E05E89EC,42623,20,22,2,22,49,1149
25139,25139,C33EE4F14EB8BA67F0E171B61D56D6DC,10881,0,11,11,34,48,1748
25140,25140,C33EE4F14EB8BA67F0E171B61D56D6DC,40341,11,14,3,23,49,1199
25141,25141,C33EE4F14EB8BA67F0E171B61D56D6DC,10881,19,22,3,34,48,1748
25163,25163,790457C5143568F0FC168A94781493E9,19114,0,6,6,7,43,393
25164,25164,790457C5143568F0FC168A94781493E9,12921,6,8,2,9,41,491
25165,25165,790457C5143568F0FC168A94781493E9,19114,9,11,2,7,43,393
25166,25166,790457C5143568F0FC168A94781493E9,12641,13,14,1,10,43,543
25167,25167,790457C5143568F0FC168A94781493E9,19114,18,23,5,7,43,393
25168,25168,3468A2FD78688C5AC65F3A70DF65F8EB,42221,0,3,3,38,48,1948
25169,25169,3468A2FD78688C5AC65F3A70DF65F8EB,11806,5,6,1,41,48,2098
25170,25170,3468A2FD78688C5AC65F3A70DF65F8EB,42281,7,8,1,40,48,2048
25171,25171,3468A2FD78688C5AC65F3A70DF65F8EB,11806,8,11,3,41,48,2098
25172,25172,3468A2FD78688C5AC65F3A70DF65F8EB,42281,12,14,2,40,48,2048
25173,25173,3468A2FD78688C5AC65F3A70DF65F8EB,40341,15,18,3,23,49,1199
25177,25177,B98653E9EDCEAF1657009E8D24A418C9,11861,0,8,8,32,47,1647
25178,25178,B98653E9EDCEAF1657009E8D24A418C9,40463,11,12,1,38,49,1949
25179,25179,B98653E9EDCEAF1657009E8D24A418C9,11521,13,19,6,41,48,2098
25180,25180,B98653E9EDCEAF1657009E8D24A418C9,11861,21,23,2,32,47,1647
25184,25184,6AEFFB19C6FA868D7C1D8F380ACB643A,10811,1,6,5,38,46,1946
25185,25185,6AEFFB19C6FA868D7C1D8F380ACB643A,42231,6,10,4,37,46,1896
25186,25186,6AEFFB19C6FA868D7C1D8F380ACB643A,10811,12,13,1,38,46,1946
25187,25187,6AEFFB19C6FA868D7C1D8F380ACB643A,13911,15,19,4,39,46,1996
25188,25188,6AEFFB19C6FA868D7C1D8F380ACB643A,10811,20,21,1,38,46,1946
25189,25189,CA376C13A61D259A65D593BAF6522A66,42371,3,5,2,34,46,1746
25190,25190,CA376C13A61D259A65D593BAF6522A66,13671,7,8,1,27,43,1393
25191,25191,CA376C13A61D259A65D593BAF6522A66,11834,10,11,1,32,45,1645
25192,25192,CA376C13A61D259A65D593BAF6522A66,13671,13,14,1,27,43,1393
25193,25193,CA376C13A61D259A65D593BAF6522A66,42623,16,18,2,22,49,1149
25194,25194,CA376C13A61D259A65D593BAF6522A66,11834,19,20,1,32,45,1645
25195,25195,5286A29EF2DEDE42572B77FE3AFBCCAE,10491,0,10,10,33,48,1698
25196,25196,5286A29EF2DEDE42572B77FE3AFBCCAE,40691,12,13,1,42,48,2148
25197,25197,5286A29EF2DEDE42572B77FE3AFBCCAE,11381,16,18,2,30,47,1547
25198,25198,5286A29EF2DEDE42572B77FE3AFBCCAE,11201,19,20,1,35,49,1799
25202,25202,EA1FD587726044750D83B82036123867,10191,0,9,9,40,48,2048
25203,25203,EA1FD587726044750D83B82036123867,11954,10,11,1,32,49,1649
25204,25204,EA1FD587726044750D83B82036123867,13331,14,16,2,38,47,1947
25205,25205,EA1FD587726044750D83B82036123867,43361,20,21,1,38,48,1948
25206,25206,8991A35048D1B40CA988AB47E787C0BD,42921,1,3,2,33,47,1697
25207,25207,8991A35048D1B40CA988AB47E787C0BD,13601,5,12,7,34,47,1747
25208,25208,8991A35048D1B40CA988AB47E787C0BD,10731,13,19,6,33,47,1697
25209,25209,8991A35048D1B40CA988AB47E787C0BD,40341,20,21,1,23,49,1199
25210,25210,8991A35048D1B40CA988AB47E787C0BD,10731,22,23,1,33,47,1697
25221,25221,B1BB83A089E286F1DF65CE3237F43765,11701,1,2,1,43,48,2198
25222,25222,B1BB83A089E286F1DF65CE3237F43765,42111,3,4,1,44,46,2246
25223,25223,B1BB83A089E286F1DF65CE3237F43765,11701,4,6,2,43,48,2198
25224,25224,B1BB83A089E286F1DF65CE3237F43765,42111,6,9,3,44,46,2246
25225,25225,B1BB83A089E286F1DF65CE3237F43765,11701,22,23,1,43,48,2198
25226,25226,344A3CF0E215A1C44A25A9F391805F64,11011,0,10,10,39,49,1999
25227,25227,344A3CF0E215A1C44A25A9F391805F64,12921,13,15,2,9,41,491
25228,25228,344A3CF0E215A1C44A25A9F391805F64,43644,18,19,1,14,38,738
25229,25229,B0CA59461CE535DA6C80DC6682EBEAFB,42271,0,7,7,40,47,2047
25230,25230,B0CA59461CE535DA6C80DC6682EBEAFB,11291,8,14,6,40,49,2049
25231,25231,B0CA59461CE535DA6C80DC6682EBEAFB,42271,15,16,1,40,47,2047
25232,25232,B0CA59461CE535DA6C80DC6682EBEAFB,11806,17,20,3,41,48,2098
25233,25233,B0CA59461CE535DA6C80DC6682EBEAFB,42271,20,22,2,40,47,2047
25234,25234,9F569681847AE1CB91DC5B95636EE88A,11851,0,1,1,13,47,697
25235,25235,9F569681847AE1CB91DC5B95636EE88A,19021,2,3,1,10,45,545
25236,25236,9F569681847AE1CB91DC5B95636EE88A,43021,5,13,8,16,43,843
25237,25237,9F569681847AE1CB91DC5B95636EE88A,19021,13,18,5,10,45,545
25238,25238,9F569681847AE1CB91DC5B95636EE88A,42041,18,19,1,10,47,547
25239,25239,FE289D23B7E617AD349A76499E85C77F,42021,0,2,2,33,47,1697
25240,25240,FE289D23B7E617AD349A76499E85C77F,13601,2,11,9,34,47,1747
25241,25241,FE289D23B7E617AD349A76499E85C77F,42021,11,14,3,33,47,1697
25242,25242,FE289D23B7E617AD349A76499E85C77F,10431,15,19,4,33,49,1699
25243,25243,FE289D23B7E617AD349A76499E85C77F,42021,19,23,4,33,47,1697
25250,25250,C01D7F4C525517694A04D5EAA5AD2420,10611,0,7,7,32,48,1648
25251,25251,C01D7F4C525517694A04D5EAA5AD2420,42351,8,11,3,38,45,1945
25252,25252,C01D7F4C525517694A04D5EAA5AD2420,13911,13,17,4,39,46,1996
25253,25253,C01D7F4C525517694A04D5EAA5AD2420,10611,22,23,1,32,48,1648
25254,25254,7F73EEE1198B300F5190B9A740E251E3,13911,0,2,2,39,46,1996
25255,25255,7F73EEE1198B300F5190B9A740E251E3,12491,3,6,3,36,43,1843
25256,25256,7F73EEE1198B300F5190B9A740E251E3,11261,8,10,2,36,46,1846
25257,25257,7F73EEE1198B300F5190B9A740E251E3,12491,11,13,2,36,43,1843
25258,25258,7F73EEE1198B300F5190B9A740E251E3,11261,17,18,1,36,46,1846
25266,25266,E6C0B95DF19745278BB8C4C83FE2A959,12401,0,7,7,39,49,1999
25267,25267,E6C0B95DF19745278BB8C4C83FE2A959,10221,7,11,4,34,49,1749
25268,25268,E6C0B95DF19745278BB8C4C83FE2A959,12401,12,16,4,39,49,1999
25269,25269,E6C0B95DF19745278BB8C4C83FE2A959,13651,19,20,1,30,47,1547
25270,25270,AA541C733BB5F99408992FE5EC11F72D,13461,9,10,1,39,44,1994
25271,25271,AA541C733BB5F99408992FE5EC11F72D,42351,13,15,2,38,45,1945
25272,25272,AA541C733BB5F99408992FE5EC11F72D,11261,19,20,1,36,46,1846
25273,25273,8AF37DA25939521E578C4AC1FCA90CB7,42221,1,3,2,38,48,1948
25274,25274,8AF37DA25939521E578C4AC1FCA90CB7,43481,4,6,2,39,48,1998
25275,25275,8AF37DA25939521E578C4AC1FCA90CB7,42581,9,11,2,38,48,1948
25276,25276,8AF37DA25939521E578C4AC1FCA90CB7,42981,18,21,3,36,49,1849
25277,25277,8AF37DA25939521E578C4AC1FCA90CB7,40101,21,23,2,34,49,1749
25278,25278,7F73A642AA11134206C46BA15C785E40,42491,0,7,7,32,46,1646
25279,25279,7F73A642AA11134206C46BA15C785E40,13651,7,13,6,30,47,1547
25280,25280,7F73A642AA11134206C46BA15C785E40,42521,13,15,2,31,47,1597
25281,25281,7F73A642AA11134206C46BA15C785E40,42491,16,19,3,32,46,1646
25282,25282,7F73A642AA11134206C46BA15C785E40,42521,22,23,1,31,47,1597
25283,25283,753369D691B504B9F7186B2CDF290F06,15391,0,2,2,35,26,1776
25284,25284,753369D691B504B9F7186B2CDF290F06,12792,2,6,4,34,30,1730
25285,25285,753369D691B504B9F7186B2CDF290F06,43121,7,10,3,25,27,1277
25286,25286,753369D691B504B9F7186B2CDF290F06,12791,12,18,6,31,29,1579
25297,25297,482231B264A5075F3CFE0C87BAE05ED6,10881,0,6,6,34,48,1748
25298,25298,482231B264A5075F3CFE0C87BAE05ED6,10491,7,9,2,33,48,1698
25299,25299,482231B264A5075F3CFE0C87BAE05ED6,40341,11,14,3,23,49,1199
25300,25300,482231B264A5075F3CFE0C87BAE05ED6,10491,20,21,1,33,48,1698
25301,25301,482231B264A5075F3CFE0C87BAE05ED6,10881,21,23,2,34,48,1748
25306,25306,3ACC8BF8C4DFF8F069BDD805025DF41D,12921,1,7,6,9,41,491
25307,25307,3ACC8BF8C4DFF8F069BDD805025DF41D,43021,7,9,2,16,43,843
25308,25308,3ACC8BF8C4DFF8F069BDD805025DF41D,12921,11,12,1,9,41,491
25309,25309,3ACC8BF8C4DFF8F069BDD805025DF41D,40341,17,19,2,23,49,1199
25310,25310,3ACC8BF8C4DFF8F069BDD805025DF41D,43021,21,23,2,16,43,843
25315,25315,122ABEFAD7532B3FE6A42311AE2305F5,10634,0,6,6,27,45,1395
25316,25316,122ABEFAD7532B3FE6A42311AE2305F5,42461,7,8,1,45,47,2297
25317,25317,122ABEFAD7532B3FE6A42311AE2305F5,10634,12,23,11,27,45,1395
25322,25322,8AB561279CAFD673B81CFFF6F25401C3,12221,1,5,4,43,44,2194
25323,25323,8AB561279CAFD673B81CFFF6F25401C3,43011,5,6,1,40,42,2042
25324,25324,8AB561279CAFD673B81CFFF6F25401C3,12221,7,9,2,43,44,2194
25325,25325,8AB561279CAFD673B81CFFF6F25401C3,43011,13,22,9,40,42,2042
25338,25338,CC51C12359BD55A1C639751513C599CA,40891,0,8,8,37,47,1897
25339,25339,CC51C12359BD55A1C639751513C599CA,10351,11,12,1,28,45,1445
25340,25340,CC51C12359BD55A1C639751513C599CA,40891,13,14,1,37,47,1897
25341,25341,CC51C12359BD55A1C639751513C599CA,10271,16,18,2,37,46,1896
25342,25342,CC51C12359BD55A1C639751513C599CA,13121,18,19,1,38,46,1946
25343,25343,42B28AE3CCE12BA9A899758E7A189C34,11806,0,8,8,41,48,2098
25344,25344,42B28AE3CCE12BA9A899758E7A189C34,11021,8,9,1,36,49,1849
25345,25345,42B28AE3CCE12BA9A899758E7A189C34,11806,12,13,1,41,48,2098
25346,25346,42B28AE3CCE12BA9A899758E7A189C34,42271,16,18,2,40,47,2047
25347,25347,42B28AE3CCE12BA9A899758E7A189C34,11806,18,21,3,41,48,2098
25348,25348,0F3E717B216F88179E3DB48E54FF2CA8,13711,0,1,1,38,46,1946
25349,25349,0F3E717B216F88179E3DB48E54FF2CA8,42411,2,11,9,40,49,2049
25350,25350,0F3E717B216F88179E3DB48E54FF2CA8,11081,15,18,3,35,46,1796
25351,25351,0F3E717B216F88179E3DB48E54FF2CA8,10931,19,23,4,41,48,2098
25352,25352,BC71A128CC1D1FD204F1FA3A371EA53A,43021,0,6,6,16,43,843
25353,25353,BC71A128CC1D1FD204F1FA3A371EA53A,12921,10,15,5,9,41,491
25354,25354,BC71A128CC1D1FD204F1FA3A371EA53A,43021,19,22,3,16,43,843
25355,25355,6941274ECF6E92A836FCC8AB273E4B50,11811,0,1,1,38,49,1949
25356,25356,6941274ECF6E92A836FCC8AB273E4B50,42521,2,4,2,31,47,1597
25357,25357,6941274ECF6E92A836FCC8AB273E4B50,10295,8,9,1,30,47,1547
25358,25358,6941274ECF6E92A836FCC8AB273E4B50,42523,11,15,4,31,47,1597
25359,25359,6941274ECF6E92A836FCC8AB273E4B50,40341,17,18,1,23,49,1199
25360,25360,6941274ECF6E92A836FCC8AB273E4B50,42523,18,20,2,31,47,1597
25364,25364,4754C3C44078DED403868682E26D1D5A,10491,0,6,6,33,48,1698
25365,25365,4754C3C44078DED403868682E26D1D5A,42941,7,9,2,37,47,1897
25366,25366,4754C3C44078DED403868682E26D1D5A,10431,11,13,2,33,49,1699
25367,25367,4754C3C44078DED403868682E26D1D5A,42941,14,15,1,37,47,1897
25368,25368,4754C3C44078DED403868682E26D1D5A,10491,19,22,3,33,48,1698
25369,25369,977E379842802F5F2EA6CD5CE3D29B80,12621,1,4,3,10,48,548
25370,25370,977E379842802F5F2EA6CD5CE3D29B80,19441,6,16,10,8,46,446
25371,25371,977E379842802F5F2EA6CD5CE3D29B80,11171,19,21,2,33,48,1698
25372,25372,EBA7165C555CC8E7F5C07D37A066F01A,40271,0,3,3,35,49,1799
25373,25373,EBA7165C555CC8E7F5C07D37A066F01A,11481,4,19,15,41,48,2098
25374,25374,EBA7165C555CC8E7F5C07D37A066F01A,41591,21,23,2,34,49,1749
25379,25379,382F73C796C98C44F5BB402C8CDCC061,42623,0,3,3,22,49,1149
25380,25380,382F73C796C98C44F5BB402C8CDCC061,42121,9,11,2,26,49,1349
25381,25381,382F73C796C98C44F5BB402C8CDCC061,42071,13,17,4,31,49,1599
25382,25382,382F73C796C98C44F5BB402C8CDCC061,11061,17,18,1,29,48,1498
25383,25383,2E8172F150A9CB734EA29311F057551D,10911,1,8,7,39,46,1996
25384,25384,2E8172F150A9CB734EA29311F057551D,10781,12,17,5,35,47,1797
25385,25385,2E8172F150A9CB734EA29311F057551D,43761,18,20,2,32,47,1647
25386,25386,E2E7904AF585940CD43CDDA5A90CDD82,10661,0,9,9,37,49,1899
25387,25387,E2E7904AF585940CD43CDDA5A90CDD82,42501,10,11,1,28,47,1447
25388,25388,E2E7904AF585940CD43CDDA5A90CDD82,13561,13,23,10,37,49,1899
25392,25392,28B8EF76314447DF77BE1FDB0E993B92,43581,0,7,7,33,48,1698
25393,25393,28B8EF76314447DF77BE1FDB0E993B92,12021,8,9,1,37,49,1899
25394,25394,28B8EF76314447DF77BE1FDB0E993B92,40697,12,13,1,43,48,2198
25395,25395,28B8EF76314447DF77BE1FDB0E993B92,43581,14,17,3,33,48,1698
25396,25396,28B8EF76314447DF77BE1FDB0E993B92,11531,18,20,2,34,49,1749
25397,25397,28B8EF76314447DF77BE1FDB0E993B92,42961,21,23,2,35,49,1799
25401,25401,C5FAF90C34968999A63CFDAD0562DDBD,10841,0,8,8,37,47,1897
25402,25402,C5FAF90C34968999A63CFDAD0562DDBD,12514,11,12,1,38,47,1947
25403,25403,C5FAF90C34968999A63CFDAD0562DDBD,40341,14,18,4,23,49,1199
25404,25404,C5FAF90C34968999A63CFDAD0562DDBD,10841,21,23,2,37,47,1897
25408,25408,075D6798652C490159667E0379AA18B5,42221,0,15,15,38,48,1948
25409,25409,075D6798652C490159667E0379AA18B5,10801,16,17,1,42,47,2147
25410,25410,075D6798652C490159667E0379AA18B5,13121,19,20,1,38,46,1946
25411,25411,075D6798652C490159667E0379AA18B5,42221,21,23,2,38,48,1948
25412,25412,6B48C0097B63B145B026C5EB7BA9FA60,11301,1,12,11,41,49,2099
25413,25413,6B48C0097B63B145B026C5EB7BA9FA60,10221,15,16,1,34,49,1749
25414,25414,6B48C0097B63B145B026C5EB7BA9FA60,40951,18,22,4,36,49,1849
25415,25415,C50F95F31F14C0EC9A55706C3B181C1C,15391,0,2,2,35,26,1776
25416,25416,C50F95F31F14C0EC9A55706C3B181C1C,12791,2,4,2,31,29,1579
25417,25417,C50F95F31F14C0EC9A55706C3B181C1C,15391,4,20,16,35,26,1776
25421,25421,DD7B8197066D2FDE311E6AE8E9360BB8,43971,0,1,1,30,48,1548
25422,25422,DD7B8197066D2FDE311E6AE8E9360BB8,11381,3,13,10,30,47,1547
25423,25423,DD7B8197066D2FDE311E6AE8E9360BB8,10951,16,17,1,29,48,1498
25424,25424,DD7B8197066D2FDE311E6AE8E9360BB8,11381,18,19,1,30,47,1547
25425,25425,DD7B8197066D2FDE311E6AE8E9360BB8,43971,21,23,2,30,48,1548
25426,25426,9896291F16C58B606909A81D72948C90,11541,0,3,3,35,49,1799
25427,25427,9896291F16C58B606909A81D72948C90,11021,3,6,3,36,49,1849
25428,25428,9896291F16C58B606909A81D72948C90,11541,7,8,1,35,49,1799
25429,25429,9896291F16C58B606909A81D72948C90,12381,12,14,2,32,48,1648
25430,25430,9896291F16C58B606909A81D72948C90,11541,14,19,5,35,49,1799
25437,25437,A27203DC664657DF4BBDCCF4AC9D93B1,49201,0,4,4,7,41,391
25438,25438,A27203DC664657DF4BBDCCF4AC9D93B1,12641,8,9,1,10,43,543
25439,25439,A27203DC664657DF4BBDCCF4AC9D93B1,12921,9,20,11,9,41,491
25450,25450,2FCC231DE348255A3F9CDA8D77EEA7DC,12051,5,8,3,20,47,1047
25451,25451,2FCC231DE348255A3F9CDA8D77EEA7DC,12581,8,10,2,24,48,1248
25452,25452,2FCC231DE348255A3F9CDA8D77EEA7DC,12051,10,14,4,20,47,1047
25453,25453,2FCC231DE348255A3F9CDA8D77EEA7DC,12581,16,23,7,24,48,1248
25454,25454,282E509775A1C97CDE05704E96553D55,10611,1,9,8,32,48,1648
25455,25455,282E509775A1C97CDE05704E96553D55,40302,9,12,3,40,49,2049
25456,25456,282E509775A1C97CDE05704E96553D55,40261,17,18,1,35,49,1799
25457,25457,282E509775A1C97CDE05704E96553D55,11021,19,22,3,36,49,1849
25458,25458,282E509775A1C97CDE05704E96553D55,40302,22,23,1,40,49,2049
25462,25462,351FCB0A4AACE684CC670F9CE5B19E09,42371,0,8,8,34,46,1746
25463,25463,351FCB0A4AACE684CC670F9CE5B19E09,40341,16,17,1,23,49,1199
25464,25464,351FCB0A4AACE684CC670F9CE5B19E09,11941,19,20,1,37,46,1896
25465,25465,351FCB0A4AACE684CC670F9CE5B19E09,42371,22,23,1,34,46,1746
25466,25466,87B1169D5A9BB025C6A10231CEED2118,19621,1,9,8,5,46,296
25467,25467,87B1169D5A9BB025C6A10231CEED2118,11861,12,13,1,32,47,1647
25468,25468,87B1169D5A9BB025C6A10231CEED2118,11651,14,15,1,33,47,1697
25469,25469,87B1169D5A9BB025C6A10231CEED2118,11861,17,22,5,32,47,1647
25470,25470,505FF343C6E446E7F99CFC0B5C13724B,42631,0,8,8,43,45,2195
25471,25471,505FF343C6E446E7F99CFC0B5C13724B,42031,9,10,1,40,46,2046
25472,25472,505FF343C6E446E7F99CFC0B5C13724B,42631,11,18,7,43,45,2195
25473,25473,505FF343C6E446E7F99CFC0B5C13724B,11701,20,21,1,43,48,2198
25474,25474,505FF343C6E446E7F99CFC0B5C13724B,42631,22,23,1,43,45,2195
25478,25478,5F3681CA154176D9C587280037CBB99D,13561,0,9,9,37,49,1899
25479,25479,5F3681CA154176D9C587280037CBB99D,13091,14,16,2,20,42,1042
25480,25480,5F3681CA154176D9C587280037CBB99D,13221,18,19,1,40,47,2047
25481,25481,5F3681CA154176D9C587280037CBB99D,40691,21,23,2,42,48,2148
25485,25485,1034E32537CD89A54195B02D13F8F6C7,42581,0,1,1,38,48,1948
25486,25486,1034E32537CD89A54195B02D13F8F6C7,11914,4,5,1,37,48,1898
25487,25487,1034E32537CD89A54195B02D13F8F6C7,42581,7,9,2,38,48,1948
25488,25488,1034E32537CD89A54195B02D13F8F6C7,11914,10,11,1,37,48,1898
25489,25489,1034E32537CD89A54195B02D13F8F6C7,42581,16,17,1,38,48,1948
25490,25490,1034E32537CD89A54195B02D13F8F6C7,11914,19,21,2,37,48,1898
25491,25491,1658E318B68367B87E9D322B1062FD51,11021,0,8,8,36,49,1849
25492,25492,1658E318B68367B87E9D322B1062FD51,10611,10,12,2,32,48,1648
25493,25493,1658E318B68367B87E9D322B1062FD51,42623,14,16,2,22,49,1149
25494,25494,1658E318B68367B87E9D322B1062FD51,11021,18,23,5,36,49,1849
25495,25495,A553D674E6ADCEEE9DF6E0981719FE7C,43341,0,15,15,41,46,2096
25496,25496,A553D674E6ADCEEE9DF6E0981719FE7C,11861,17,19,2,32,47,1647
25497,25497,A553D674E6ADCEEE9DF6E0981719FE7C,43341,21,23,2,41,46,2096
25498,25498,227CF90E190A804F43263E2E6F09CFEC,10681,0,7,7,30,48,1548
25499,25499,227CF90E190A804F43263E2E6F09CFEC,11061,10,12,2,29,48,1498
25500,25500,227CF90E190A804F43263E2E6F09CFEC,10681,12,15,3,30,48,1548
25501,25501,227CF90E190A804F43263E2E6F09CFEC,11061,15,17,2,29,48,1498
25502,25502,227CF90E190A804F43263E2E6F09CFEC,10681,19,23,4,30,48,1548
25503,25503,4E7276D3EE2346A4632416D72E435C73,11561,0,17,17,32,49,1649
25504,25504,4E7276D3EE2346A4632416D72E435C73,10471,17,20,3,37,48,1898
25505,25505,4E7276D3EE2346A4632416D72E435C73,42401,21,23,2,36,47,1847
25506,25506,B75BCB143B608EA57EF37455962D78CA,42121,10,11,1,26,49,1349
25507,25507,B75BCB143B608EA57EF37455962D78CA,42261,13,14,1,25,49,1299
25508,25508,B75BCB143B608EA57EF37455962D78CA,42121,15,16,1,26,49,1349
25509,25509,B75BCB143B608EA57EF37455962D78CA,10381,16,19,3,31,49,1599
25510,25510,A606595816A6CC186BFAE47D246F3A97,42801,0,9,9,40,49,2049
25511,25511,A606595816A6CC186BFAE47D246F3A97,10901,12,13,1,35,48,1798
25512,25512,A606595816A6CC186BFAE47D246F3A97,19441,17,23,6,8,46,446
25513,25513,6343BF60CCF3D70B5AB02F8245B426EB,13121,5,6,1,38,46,1946
25514,25514,6343BF60CCF3D70B5AB02F8245B426EB,40112,8,12,4,32,48,1648
25515,25515,6343BF60CCF3D70B5AB02F8245B426EB,13121,13,23,10,38,46,1946
25516,25516,51591F8EA07D8177C3E0ABFE6A0BF706,42623,2,6,4,22,49,1149
25517,25517,51591F8EA07D8177C3E0ABFE6A0BF706,13731,16,17,1,33,49,1699
25518,25518,51591F8EA07D8177C3E0ABFE6A0BF706,42623,21,22,1,22,49,1149
25519,25519,B48EF153016A0804647A4FDBEF6E3D64,12491,0,3,3,36,43,1843
25520,25520,B48EF153016A0804647A4FDBEF6E3D64,42151,5,7,2,35,45,1795
25521,25521,B48EF153016A0804647A4FDBEF6E3D64,13671,8,9,1,27,43,1393
25522,25522,B48EF153016A0804647A4FDBEF6E3D64,42861,15,16,1,37,44,1894
25523,25523,B48EF153016A0804647A4FDBEF6E3D64,42151,21,23,2,35,45,1795
25527,25527,135EF939D99CED11694D71795A5772B0,19031,0,6,6,1,42,92
25528,25528,135EF939D99CED11694D71795A5772B0,19021,9,11,2,10,45,545
25529,25529,135EF939D99CED11694D71795A5772B0,19031,13,16,3,1,42,92
25530,25530,135EF939D99CED11694D71795A5772B0,12641,16,18,2,10,43,543
25531,25531,135EF939D99CED11694D71795A5772B0,19031,20,23,3,1,42,92
25532,25532,67BCB76F611F63115F44CBB7619B7D68,42161,0,7,7,36,47,1847
25533,25533,67BCB76F611F63115F44CBB7619B7D68,42623,10,13,3,22,49,1149
25534,25534,67BCB76F611F63115F44CBB7619B7D68,43161,18,23,5,35,47,1797
25535,25535,996E78B516B54BE4ADEF09770F316D9D,13341,0,5,5,44,45,2245
25536,25536,996E78B516B54BE4ADEF09770F316D9D,43161,7,20,13,35,47,1797
25537,25537,996E78B516B54BE4ADEF09770F316D9D,13341,21,23,2,44,45,2245
25538,25538,30C49EE7A31FEEE7EEC894E81C72E143,42581,0,5,5,38,48,1948
25539,25539,30C49EE7A31FEEE7EEC894E81C72E143,11914,7,9,2,37,48,1898
25540,25540,30C49EE7A31FEEE7EEC894E81C72E143,42581,11,12,1,38,48,1948
25541,25541,30C49EE7A31FEEE7EEC894E81C72E143,11914,16,18,2,37,48,1898
25542,25542,30C49EE7A31FEEE7EEC894E81C72E143,40171,20,22,2,38,48,1948
25546,25546,0EC1D2502267B7D6F36C8EA9D8EC3DDA,10171,0,7,7,26,47,1347
25547,25547,0EC1D2502267B7D6F36C8EA9D8EC3DDA,10801,8,18,10,42,47,2147
25548,25548,0EC1D2502267B7D6F36C8EA9D8EC3DDA,10171,20,23,3,26,47,1347
25552,25552,FC69FF2B8F3FFBA821A97ACC70374733,11161,2,10,8,32,48,1648
25553,25553,FC69FF2B8F3FFBA821A97ACC70374733,40951,13,15,2,36,49,1849
25554,25554,FC69FF2B8F3FFBA821A97ACC70374733,43761,17,19,2,32,47,1647
25555,25555,14A26121D61284733518359391469C97,49201,0,1,1,7,41,391
25556,25556,14A26121D61284733518359391469C97,43644,4,6,2,14,38,738
25557,25557,14A26121D61284733518359391469C97,19571,9,11,2,1,36,86
25558,25558,14A26121D61284733518359391469C97,43644,15,16,1,14,38,738
25559,25559,14A26121D61284733518359391469C97,19571,20,22,2,1,36,86
25564,25564,4CA1188698B5DD1E66E2EDCA80216CDE,13071,2,5,3,41,41,2091
25565,25565,4CA1188698B5DD1E66E2EDCA80216CDE,43101,6,14,8,46,40,2340
25566,25566,4CA1188698B5DD1E66E2EDCA80216CDE,13071,15,17,2,41,41,2091
25567,25567,4CA1188698B5DD1E66E2EDCA80216CDE,12571,20,21,1,48,39,2439
25568,25568,4CA1188698B5DD1E66E2EDCA80216CDE,13071,21,23,2,41,41,2091
25572,25572,8879DF6A5F82577E1752858832950F5C,10731,9,10,1,33,47,1697
25573,25573,8879DF6A5F82577E1752858832950F5C,13601,14,16,2,34,47,1747
25574,25574,8879DF6A5F82577E1752858832950F5C,11781,20,21,1,38,49,1949
25575,25575,586F3AD64B483C4FDBF6963F85B66D9A,13271,0,6,6,41,47,2097
25576,25576,586F3AD64B483C4FDBF6963F85B66D9A,42201,10,14,4,43,46,2196
25577,25577,586F3AD64B483C4FDBF6963F85B66D9A,13271,15,16,1,41,47,2097
25578,25578,586F3AD64B483C4FDBF6963F85B66D9A,43001,19,21,2,47,47,2397
25579,25579,617ECF6138D40F55B7DF7178FE479643,10331,0,12,12,39,46,1996
25580,25580,617ECF6138D40F55B7DF7178FE479643,10841,12,13,1,37,47,1897
25581,25581,617ECF6138D40F55B7DF7178FE479643,40341,14,20,6,23,49,1199
25582,25582,617ECF6138D40F55B7DF7178FE479643,10331,21,23,2,39,46,1996
25583,25583,D96201B04F49DA8FE5B344343C2EC845,10061,0,4,4,20,46,1046
25584,25584,D96201B04F49DA8FE5B344343C2EC845,11861,5,15,10,32,47,1647
25585,25585,D96201B04F49DA8FE5B344343C2EC845,10061,17,18,1,20,46,1046
25586,25586,D96201B04F49DA8FE5B344343C2EC845,43761,20,22,2,32,47,1647
25595,25595,9397083C419903E30A62F5C06D299D5C,42381,0,6,6,39,41,1991
25596,25596,9397083C419903E30A62F5C06D299D5C,43451,9,11,2,37,40,1890
25597,25597,9397083C419903E30A62F5C06D299D5C,42381,11,13,2,39,41,1991
25598,25598,9397083C419903E30A62F5C06D299D5C,43451,15,16,1,37,40,1890
25599,25599,9397083C419903E30A62F5C06D299D5C,42381,20,22,2,39,41,1991
25600,25600,DDD1F27BCECA262AB12F44C73C77209E,10381,0,4,4,31,49,1599
25601,25601,DDD1F27BCECA262AB12F44C73C77209E,10681,4,5,1,30,48,1548
25602,25602,DDD1F27BCECA262AB12F44C73C77209E,10381,7,8,1,31,49,1599
25603,25603,DDD1F27BCECA262AB12F44C73C77209E,10681,10,11,1,30,48,1548
25604,25604,DDD1F27BCECA262AB12F44C73C77209E,10381,16,23,7,31,49,1599
25608,25608,4BEB96C1A6F8B99181CDADEF48D75275,42501,0,6,6,28,47,1447
25609,25609,4BEB96C1A6F8B99181CDADEF48D75275,42081,8,19,11,24,49,1249
25610,25610,4BEB96C1A6F8B99181CDADEF48D75275,42501,20,23,3,28,47,1447
25611,25611,C4DA25473510C59AF311C46DB13EDB15,10251,0,6,6,35,47,1797
25612,25612,C4DA25473510C59AF311C46DB13EDB15,40341,9,10,1,23,49,1199
25613,25613,C4DA25473510C59AF311C46DB13EDB15,13511,13,16,3,34,48,1748
25614,25614,C4DA25473510C59AF311C46DB13EDB15,11081,18,20,2,35,46,1796
25615,25615,C4DA25473510C59AF311C46DB13EDB15,10251,22,23,1,35,47,1797
25616,25616,25FFDC221DF5C09B531F864D963D911D,19021,3,4,1,10,45,545
25617,25617,25FFDC221DF5C09B531F864D963D911D,12641,8,17,9,10,43,543
25618,25618,25FFDC221DF5C09B531F864D963D911D,12921,19,20,1,9,41,491
25619,25619,C5C275AB5B07ACB792C4C80064B7A71E,40833,0,8,8,41,47,2097
25620,25620,C5C275AB5B07ACB792C4C80064B7A71E,10681,10,20,10,30,48,1548
25621,25621,C5C275AB5B07ACB792C4C80064B7A71E,40833,20,23,3,41,47,2097
25622,25622,0DC30FA0CCDAD859C724130675369152,12211,0,12,12,41,44,2094
25623,25623,0DC30FA0CCDAD859C724130675369152,42351,12,13,1,38,45,1945
25624,25624,0DC30FA0CCDAD859C724130675369152,11261,15,21,6,36,46,1846
25625,25625,A53DAA006542212C0F792E33874BF547,10231,1,14,13,39,49,1999
25626,25626,A53DAA006542212C0F792E33874BF547,10781,14,19,5,35,47,1797
25627,25627,A53DAA006542212C0F792E33874BF547,11661,19,22,3,40,49,2049
25631,25631,4568F4CB3839A063AA85BE5AD656F1DE,10221,0,2,2,34,49,1749
25632,25632,4568F4CB3839A063AA85BE5AD656F1DE,10661,2,4,2,37,49,1899
25633,25633,4568F4CB3839A063AA85BE5AD656F1DE,12161,10,17,7,32,46,1646
25634,25634,4568F4CB3839A063AA85BE5AD656F1DE,10221,19,23,4,34,49,1749
25642,25642,94FCE322B506FDEE0451D08A78C73ADD,12641,0,4,4,10,43,543
25643,25643,94FCE322B506FDEE0451D08A78C73ADD,19114,5,10,5,7,43,393
25644,25644,94FCE322B506FDEE0451D08A78C73ADD,12641,12,14,2,10,43,543
25645,25645,94FCE322B506FDEE0451D08A78C73ADD,19114,14,18,4,7,43,393
25646,25646,94FCE322B506FDEE0451D08A78C73ADD,12641,20,23,3,10,43,543
25647,25647,46624C7A7A05E81084BABC40FE8F937C,12521,8,9,1,35,41,1791
25648,25648,46624C7A7A05E81084BABC40FE8F937C,13314,9,11,2,31,39,1589
25649,25649,46624C7A7A05E81084BABC40FE8F937C,12521,13,14,1,35,41,1791
25650,25650,46624C7A7A05E81084BABC40FE8F937C,13314,14,23,9,31,39,1589
25651,25651,EAE31D5D50FF711EC1318FDE4AC6A497,12051,0,6,6,20,47,1047
25652,25652,EAE31D5D50FF711EC1318FDE4AC6A497,12581,6,10,4,24,48,1248
25653,25653,EAE31D5D50FF711EC1318FDE4AC6A497,12051,11,16,5,20,47,1047
25654,25654,EAE31D5D50FF711EC1318FDE4AC6A497,11361,18,19,1,22,48,1148
25655,25655,EAE31D5D50FF711EC1318FDE4AC6A497,11101,20,22,2,18,48,948
25656,25656,B6E06BECFD200E305BD11D4E181199C8,11951,0,8,8,31,49,1599
25657,25657,B6E06BECFD200E305BD11D4E181199C8,10401,9,11,2,33,49,1699
25658,25658,B6E06BECFD200E305BD11D4E181199C8,43191,13,14,1,40,49,2049
25659,25659,B6E06BECFD200E305BD11D4E181199C8,10221,16,19,3,34,49,1749
25660,25660,B6E06BECFD200E305BD11D4E181199C8,11951,19,23,4,31,49,1599
25661,25661,1B6F3845CF9B33669E95093F20B19BF3,15661,0,7,7,36,26,1826
25662,25662,1B6F3845CF9B33669E95093F20B19BF3,42931,8,10,2,41,49,2099
25663,25663,1B6F3845CF9B33669E95093F20B19BF3,15191,13,23,10,36,27,1827
25667,25667,7F0F7E01EE512C1A933F7133254355CA,43021,0,5,5,16,43,843
25668,25668,7F0F7E01EE512C1A933F7133254355CA,12921,7,15,8,9,41,491
25669,25669,7F0F7E01EE512C1A933F7133254355CA,43021,16,19,3,16,43,843
25670,25670,3B5439A9FD7060E7BC8644A0232D8663,11011,0,9,9,39,49,1999
25671,25671,3B5439A9FD7060E7BC8644A0232D8663,10921,12,14,2,43,48,2198
25672,25672,3B5439A9FD7060E7BC8644A0232D8663,12651,14,16,2,43,47,2197
25673,25673,3B5439A9FD7060E7BC8644A0232D8663,11954,18,21,3,32,49,1649
25674,25674,906075D6233195F1F9099F6FBB81286D,42523,0,8,8,31,47,1597
25675,25675,906075D6233195F1F9099F6FBB81286D,10295,9,11,2,30,47,1547
25676,25676,906075D6233195F1F9099F6FBB81286D,12021,12,14,2,37,49,1899
25677,25677,906075D6233195F1F9099F6FBB81286D,11381,18,20,2,30,47,1547
25681,25681,DA0EA0C5CA927FE9EEF137F63BEF30B0,43161,0,11,11,35,47,1797
25682,25682,DA0EA0C5CA927FE9EEF137F63BEF30B0,43001,17,20,3,47,47,2397
25683,25683,DA0EA0C5CA927FE9EEF137F63BEF30B0,10781,20,23,3,35,47,1797
25687,25687,1399CACEE1844E6F7F6C19DFA3C85CF0,42461,0,7,7,45,47,2297
25688,25688,1399CACEE1844E6F7F6C19DFA3C85CF0,42231,8,10,2,37,46,1896
25689,25689,1399CACEE1844E6F7F6C19DFA3C85CF0,10771,12,13,1,41,46,2096
25690,25690,1399CACEE1844E6F7F6C19DFA3C85CF0,42461,13,20,7,45,47,2297
25691,25691,4DA57F9F33C37E2CA21407DE781C18AF,13911,0,2,2,39,46,1996
25692,25692,4DA57F9F33C37E2CA21407DE781C18AF,12211,3,4,1,41,44,2094
25693,25693,4DA57F9F33C37E2CA21407DE781C18AF,42351,4,13,9,38,45,1945
25694,25694,4DA57F9F33C37E2CA21407DE781C18AF,11261,18,19,1,36,46,1846
25695,25695,4DA57F9F33C37E2CA21407DE781C18AF,13911,20,23,3,39,46,1996
25696,25696,E95553899844CEC511B8CCA79AFCA80F,11291,2,13,11,40,49,2049
25697,25697,E95553899844CEC511B8CCA79AFCA80F,11011,13,14,1,39,49,1999
25698,25698,E95553899844CEC511B8CCA79AFCA80F,40341,15,18,3,23,49,1199
25699,25699,E95553899844CEC511B8CCA79AFCA80F,11331,18,20,2,37,48,1898
25707,25707,F1249E9F0C0E4CFC8DF3A999C283E2E8,42791,0,7,7,35,45,1795
25708,25708,F1249E9F0C0E4CFC8DF3A999C283E2E8,10351,11,19,8,28,45,1445
25709,25709,F1249E9F0C0E4CFC8DF3A999C283E2E8,11074,21,23,2,37,47,1897
25710,25710,2522D6E38ECAB5C3B8D9E645448C4F62,11081,0,11,11,35,46,1796
25711,25711,2522D6E38ECAB5C3B8D9E645448C4F62,12921,12,13,1,9,41,491
25712,25712,2522D6E38ECAB5C3B8D9E645448C4F62,11081,16,18,2,35,46,1796
25713,25713,2522D6E38ECAB5C3B8D9E645448C4F62,41591,18,20,2,34,49,1749
25714,25714,2522D6E38ECAB5C3B8D9E645448C4F62,11081,21,23,2,35,46,1796
25718,25718,DA45C385079CB215948D5C65FC8DC814,40637,0,9,9,36,47,1847
25719,25719,DA45C385079CB215948D5C65FC8DC814,11011,10,14,4,39,49,1999
25720,25720,DA45C385079CB215948D5C65FC8DC814,15271,17,23,6,14,20,720
25721,25721,C7B2C2AE2DF954A69981F5A4F94159CA,13671,1,7,6,27,43,1393
25722,25722,C7B2C2AE2DF954A69981F5A4F94159CA,10781,12,14,2,35,47,1797
25723,25723,C7B2C2AE2DF954A69981F5A4F94159CA,13671,15,17,2,27,43,1393
25724,25724,C7B2C2AE2DF954A69981F5A4F94159CA,43341,17,18,1,41,46,2096
25725,25725,C7B2C2AE2DF954A69981F5A4F94159CA,11261,19,20,1,36,46,1846
25730,25730,C5265646F81D46CAFC774C63090EB008,11331,2,10,8,37,48,1898
25731,25731,C5265646F81D46CAFC774C63090EB008,42864,13,14,1,38,44,1944
25732,25732,C5265646F81D46CAFC774C63090EB008,11331,14,19,5,37,48,1898
25736,25736,181802B57A29F4FAE1E7EF60B334A9D5,11261,9,12,3,36,46,1846
25737,25737,181802B57A29F4FAE1E7EF60B334A9D5,10811,13,14,1,38,46,1946
25738,25738,181802B57A29F4FAE1E7EF60B334A9D5,42864,18,19,1,38,44,1944
25739,25739,181802B57A29F4FAE1E7EF60B334A9D5,11261,20,22,2,36,46,1846
25740,25740,181802B57A29F4FAE1E7EF60B334A9D5,42864,22,23,1,38,44,1944
25741,25741,8EC6592A5302140A9CA2CC55F2BCF8B9,42201,0,9,9,43,46,2196
25742,25742,8EC6592A5302140A9CA2CC55F2BCF8B9,10971,13,14,1,35,47,1797
25743,25743,8EC6592A5302140A9CA2CC55F2BCF8B9,11794,16,17,1,38,49,1949
25744,25744,8EC6592A5302140A9CA2CC55F2BCF8B9,42201,22,23,1,43,46,2196
25752,25752,D66BAA76A3803C0CC5E6A3EBCF732844,10491,0,5,5,33,48,1698
25753,25753,D66BAA76A3803C0CC5E6A3EBCF732844,12311,6,16,10,30,44,1544
25754,25754,D66BAA76A3803C0CC5E6A3EBCF732844,42531,16,18,2,31,45,1595
25755,25755,D66BAA76A3803C0CC5E6A3EBCF732844,11171,20,23,3,33,48,1698
25756,25756,129783A5284CC0BD9ADECE19EA951EBA,11301,0,8,8,41,49,2099
25757,25757,129783A5284CC0BD9ADECE19EA951EBA,40302,12,13,1,40,49,2049
25758,25758,129783A5284CC0BD9ADECE19EA951EBA,11901,14,15,1,42,49,2149
25759,25759,129783A5284CC0BD9ADECE19EA951EBA,10231,17,18,1,39,49,1999
25760,25760,129783A5284CC0BD9ADECE19EA951EBA,10951,18,22,4,29,48,1498
25761,25761,3D0E1B656C5536FA930B97A859157563,41612,0,7,7,36,47,1847
25762,25762,3D0E1B656C5536FA930B97A859157563,12514,9,11,2,38,47,1947
25763,25763,3D0E1B656C5536FA930B97A859157563,11201,16,17,1,35,49,1799
25764,25764,3D0E1B656C5536FA930B97A859157563,10661,17,20,3,37,49,1899
25765,25765,3D0E1B656C5536FA930B97A859157563,40637,20,22,2,36,47,1847
25766,25766,393F5524259520584332C02612814AC9,11431,0,12,12,29,47,1497
25767,25767,393F5524259520584332C02612814AC9,12561,15,17,2,45,43,2293
25768,25768,393F5524259520584332C02612814AC9,12121,20,23,3,29,47,1497
25769,25769,19DD9EA3315ECB699A68A051C9281E6B,10251,0,8,8,35,47,1797
25770,25770,19DD9EA3315ECB699A68A051C9281E6B,13511,8,10,2,34,48,1748
25771,25771,19DD9EA3315ECB699A68A051C9281E6B,10107,13,15,2,38,49,1949
25772,25772,19DD9EA3315ECB699A68A051C9281E6B,13791,18,19,1,42,47,2147
25773,25773,19DD9EA3315ECB699A68A051C9281E6B,10471,21,23,2,37,48,1898
25774,25774,FC1F790D10F2FBEDB4496227B56CC766,11261,0,9,9,36,46,1846
25775,25775,FC1F790D10F2FBEDB4496227B56CC766,42864,9,11,2,38,44,1944
25776,25776,FC1F790D10F2FBEDB4496227B56CC766,10771,12,17,5,41,46,2096
25777,25777,FC1F790D10F2FBEDB4496227B56CC766,11261,19,22,3,36,46,1846
25778,25778,DB3C92167D7C02EAB46060E4569D1D1B,42351,0,7,7,38,45,1945
25779,25779,DB3C92167D7C02EAB46060E4569D1D1B,11231,9,10,1,37,49,1899
25780,25780,DB3C92167D7C02EAB46060E4569D1D1B,10121,14,16,2,36,49,1849
25781,25781,DB3C92167D7C02EAB46060E4569D1D1B,42351,19,20,1,38,45,1945
25782,25782,DAF070E37522449552E837969D087804,10491,0,6,6,33,48,1698
25783,25783,DAF070E37522449552E837969D087804,40171,6,10,4,38,48,1948
25784,25784,DAF070E37522449552E837969D087804,10491,12,14,2,33,48,1698
25785,25785,DAF070E37522449552E837969D087804,10471,17,18,1,37,48,1898
25786,25786,DAF070E37522449552E837969D087804,10491,19,23,4,33,48,1698
25796,25796,838B72DE45501DC6F234B6EC878B4411,12921,8,10,2,9,41,491
25797,25797,838B72DE45501DC6F234B6EC878B4411,19181,10,16,6,8,40,440
25798,25798,838B72DE45501DC6F234B6EC878B4411,11151,18,19,1,30,48,1548
25802,25802,280A825D237E9CE7CB403628403E758B,11261,0,5,5,36,46,1846
25803,25803,280A825D237E9CE7CB403628403E758B,42351,6,7,1,38,45,1945
25804,25804,280A825D237E9CE7CB403628403E758B,11261,8,9,1,36,46,1846
25805,25805,280A825D237E9CE7CB403628403E758B,42351,10,11,1,38,45,1945
25806,25806,280A825D237E9CE7CB403628403E758B,13911,14,18,4,39,46,1996
25807,25807,280A825D237E9CE7CB403628403E758B,40341,19,21,2,23,49,1199
25808,25808,B8DB030E6F574F75DC469AA0B11A44D5,10531,0,7,7,34,46,1746
25809,25809,B8DB030E6F574F75DC469AA0B11A44D5,43731,8,10,2,34,47,1747
25810,25810,B8DB030E6F574F75DC469AA0B11A44D5,42921,10,11,1,33,47,1697
25811,25811,B8DB030E6F574F75DC469AA0B11A44D5,43731,13,14,1,34,47,1747
25812,25812,B8DB030E6F574F75DC469AA0B11A44D5,10531,19,22,3,34,46,1746
25813,25813,92E340B82C56A45F91D53CD2B709557E,11914,7,17,10,37,48,1898
25814,25814,92E340B82C56A45F91D53CD2B709557E,12131,18,19,1,32,47,1647
25815,25815,92E340B82C56A45F91D53CD2B709557E,42581,21,22,1,38,48,1948
25816,25816,58BEE0373BA3BBE6F00589D7DAF11B0C,11381,0,18,18,30,47,1547
25817,25817,58BEE0373BA3BBE6F00589D7DAF11B0C,40341,18,19,1,23,49,1199
25818,25818,58BEE0373BA3BBE6F00589D7DAF11B0C,11381,20,23,3,30,47,1547
25822,25822,A6FED4E386822DEAD939F8507075DAA9,11151,3,13,10,30,48,1548
25823,25823,A6FED4E386822DEAD939F8507075DAA9,40951,14,16,2,36,49,1849
25824,25824,A6FED4E386822DEAD939F8507075DAA9,11061,17,23,6,29,48,1498
25825,25825,CB569F11653BED8355DBB1B17AC5F222,40171,0,3,3,38,48,1948
25826,25826,CB569F11653BED8355DBB1B17AC5F222,11914,4,5,1,37,48,1898
25827,25827,CB569F11653BED8355DBB1B17AC5F222,40171,6,7,1,38,48,1948
25828,25828,CB569F11653BED8355DBB1B17AC5F222,11914,8,21,13,37,48,1898
25829,25829,CB569F11653BED8355DBB1B17AC5F222,42191,22,23,1,38,49,1949
25830,25830,91C845F33B01C4DA71C1A0D3DEBCFC93,10601,2,7,5,39,47,1997
25831,25831,91C845F33B01C4DA71C1A0D3DEBCFC93,40171,9,17,8,38,48,1948
25832,25832,91C845F33B01C4DA71C1A0D3DEBCFC93,13511,21,23,2,34,48,1748
25833,25833,EF4100B4391F55DDFFFFBAE9F0BF0EC4,40491,0,1,1,39,49,1999
25834,25834,EF4100B4391F55DDFFFFBAE9F0BF0EC4,10621,2,13,11,41,49,2099
25835,25835,EF4100B4391F55DDFFFFBAE9F0BF0EC4,42301,14,17,3,36,47,1847
25836,25836,EF4100B4391F55DDFFFFBAE9F0BF0EC4,10621,18,20,2,41,49,2099
25837,25837,78F17C1607ADFF9D37A77DDA7B7296AA,12521,0,16,16,35,41,1791
25838,25838,78F17C1607ADFF9D37A77DDA7B7296AA,12514,18,20,2,38,47,1947
25839,25839,78F17C1607ADFF9D37A77DDA7B7296AA,12521,22,23,1,35,41,1791
25840,25840,6830C8B20B4917E4B1A9CDF5263B9347,11875,0,10,10,30,46,1546
25841,25841,6830C8B20B4917E4B1A9CDF5263B9347,10107,12,17,5,38,49,1949
25842,25842,6830C8B20B4917E4B1A9CDF5263B9347,42301,18,23,5,36,47,1847
25843,25843,2A9DB16F184F96C3E4BC11F155505740,13941,10,12,2,41,47,2097
25844,25844,2A9DB16F184F96C3E4BC11F155505740,13101,16,18,2,40,47,2047
25845,25845,2A9DB16F184F96C3E4BC11F155505740,10351,20,21,1,28,45,1445
25846,25846,2C3A1C890B30FB06A95DD4A9EF742265,19801,0,5,5,19,26,976
25847,25847,2C3A1C890B30FB06A95DD4A9EF742265,43121,6,13,7,25,27,1277
25848,25848,2C3A1C890B30FB06A95DD4A9EF742265,19801,13,15,2,19,26,976
25849,25849,2C3A1C890B30FB06A95DD4A9EF742265,43121,15,19,4,25,27,1277
25850,25850,3499DD22FCE3132229D1F644860FC753,10251,0,9,9,35,47,1797
25851,25851,3499DD22FCE3132229D1F644860FC753,13511,9,12,3,34,48,1748
25852,25852,3499DD22FCE3132229D1F644860FC753,10251,13,14,1,35,47,1797
25853,25853,3499DD22FCE3132229D1F644860FC753,13511,15,20,5,34,48,1748
25854,25854,3499DD22FCE3132229D1F644860FC753,42161,20,23,3,36,47,1847
25855,25855,C6869A64CA9EF97A25D7192A00726FC2,10111,0,16,16,37,47,1897
25856,25856,C6869A64CA9EF97A25D7192A00726FC2,40341,16,18,2,23,49,1199
25857,25857,C6869A64CA9EF97A25D7192A00726FC2,42161,18,20,2,36,47,1847
25858,25858,C6869A64CA9EF97A25D7192A00726FC2,40381,21,23,2,32,46,1646
25873,25873,A2EA2AB82A45207E1BCB502B97AEA982,10381,0,5,5,31,49,1599
25874,25874,A2EA2AB82A45207E1BCB502B97AEA982,10451,9,17,8,25,48,1298
25875,25875,A2EA2AB82A45207E1BCB502B97AEA982,10381,18,23,5,31,49,1599
25876,25876,13C87CF8006F864BF06A45E50A6792F9,11271,0,2,2,37,48,1898
25877,25877,13C87CF8006F864BF06A45E50A6792F9,11461,2,8,6,37,49,1899
25878,25878,13C87CF8006F864BF06A45E50A6792F9,43731,12,14,2,34,47,1747
25879,25879,13C87CF8006F864BF06A45E50A6792F9,11351,18,19,1,36,48,1848
25880,25880,13C87CF8006F864BF06A45E50A6792F9,40081,21,22,1,40,49,2049
25881,25881,04618E39CCC1E5047B065A0EFB16FDCC,43161,0,6,6,35,47,1797
25882,25882,04618E39CCC1E5047B065A0EFB16FDCC,41031,7,10,3,32,49,1649
25883,25883,04618E39CCC1E5047B065A0EFB16FDCC,10781,19,20,1,35,47,1797
25887,25887,50654F68D94497D10A1C2B9ADDEB1DF4,10771,0,1,1,41,46,2096
25888,25888,50654F68D94497D10A1C2B9ADDEB1DF4,11771,2,19,17,39,49,1999
25889,25889,50654F68D94497D10A1C2B9ADDEB1DF4,16261,22,23,1,3,3,153
25890,25890,3F835F4DFC0247538A31F4DD3E1B5EAC,19244,0,2,2,1,43,93
25891,25891,3F835F4DFC0247538A31F4DD3E1B5EAC,12921,3,9,6,9,41,491
25892,25892,3F835F4DFC0247538A31F4DD3E1B5EAC,19031,12,13,1,1,42,92
25893,25893,3F835F4DFC0247538A31F4DD3E1B5EAC,12921,13,23,10,9,41,491
25894,25894,E311A49FD79CE1E67702DBA9B7887B92,19021,0,1,1,10,45,545
25895,25895,E311A49FD79CE1E67702DBA9B7887B92,12921,1,3,2,9,41,491
25896,25896,E311A49FD79CE1E67702DBA9B7887B92,19021,7,11,4,10,45,545
25897,25897,E311A49FD79CE1E67702DBA9B7887B92,12641,13,16,3,10,43,543
25898,25898,E311A49FD79CE1E67702DBA9B7887B92,19021,16,17,1,10,45,545
25899,25899,E311A49FD79CE1E67702DBA9B7887B92,12641,17,20,3,10,43,543
25900,25900,E311A49FD79CE1E67702DBA9B7887B92,19021,20,21,1,10,45,545
25901,25901,E311A49FD79CE1E67702DBA9B7887B92,12641,21,23,2,10,43,543
25902,25902,5CE5B38C43463AB4DE2D4D106DC3D232,11171,0,8,8,33,48,1698
25903,25903,5CE5B38C43463AB4DE2D4D106DC3D232,10251,9,19,10,35,47,1797
25904,25904,5CE5B38C43463AB4DE2D4D106DC3D232,13791,20,22,2,42,47,2147
25911,25911,ED569151E6A8C0A86F789287FFBD4CE0,11861,0,6,6,32,47,1647
25912,25912,ED569151E6A8C0A86F789287FFBD4CE0,10921,6,17,11,43,48,2198
25913,25913,ED569151E6A8C0A86F789287FFBD4CE0,11861,18,23,5,32,47,1647
25914,25914,5AF26FD3EDD59D73F20E2AE7E3BEDAFF,49201,0,15,15,7,41,391
25915,25915,5AF26FD3EDD59D73F20E2AE7E3BEDAFF,12921,16,17,1,9,41,491
25916,25916,5AF26FD3EDD59D73F20E2AE7E3BEDAFF,10681,18,23,5,30,48,1548
25917,25917,4BE03AB7B88CA8091DBCEF6257C15779,42371,2,4,2,34,46,1746
25918,25918,4BE03AB7B88CA8091DBCEF6257C15779,42521,9,10,1,31,47,1597
25919,25919,4BE03AB7B88CA8091DBCEF6257C15779,43761,10,15,5,32,47,1647
25920,25920,4BE03AB7B88CA8091DBCEF6257C15779,11541,18,19,1,35,49,1799
25921,25921,4BE03AB7B88CA8091DBCEF6257C15779,42521,21,23,2,31,47,1597
25922,25922,93789CDBB122DA3904CEB9B349C66F76,16261,0,14,14,3,3,153
25923,25923,93789CDBB122DA3904CEB9B349C66F76,11781,17,20,3,38,49,1949
25924,25924,93789CDBB122DA3904CEB9B349C66F76,42491,21,23,2,32,46,1646
25932,25932,3144EE37E69A5ACD2E35E50AD4D13910,11914,0,7,7,37,48,1898
25933,25933,3144EE37E69A5ACD2E35E50AD4D13910,13941,8,10,2,41,47,2097
25934,25934,3144EE37E69A5ACD2E35E50AD4D13910,11211,12,13,1,34,49,1749
25935,25935,3144EE37E69A5ACD2E35E50AD4D13910,11271,15,16,1,37,48,1898
25936,25936,3144EE37E69A5ACD2E35E50AD4D13910,40951,17,19,2,36,49,1849
25937,25937,3144EE37E69A5ACD2E35E50AD4D13910,40673,21,22,1,36,48,1848
25941,25941,812932466C0F18458E2AE0D62145AC1E,11481,0,10,10,41,48,2098
25942,25942,812932466C0F18458E2AE0D62145AC1E,13101,12,16,4,40,47,2047
25943,25943,812932466C0F18458E2AE0D62145AC1E,42381,17,18,1,39,41,1991
25944,25944,812932466C0F18458E2AE0D62145AC1E,11481,21,22,1,41,48,2098
25959,25959,1B83FAC3F59813014CE45FBC6E21E9E8,10841,0,8,8,37,47,1897
25960,25960,1B83FAC3F59813014CE45FBC6E21E9E8,42281,9,10,1,40,48,2048
25961,25961,1B83FAC3F59813014CE45FBC6E21E9E8,11791,12,13,1,38,49,1949
25962,25962,1B83FAC3F59813014CE45FBC6E21E9E8,42221,14,17,3,38,48,1948
25963,25963,1B83FAC3F59813014CE45FBC6E21E9E8,12021,19,20,1,37,49,1899
25964,25964,1B83FAC3F59813014CE45FBC6E21E9E8,10841,21,23,2,37,47,1897
25971,25971,441E401293D6FFC8E080552D376784E1,42581,0,4,4,38,48,1948
25972,25972,441E401293D6FFC8E080552D376784E1,11914,7,11,4,37,48,1898
25973,25973,441E401293D6FFC8E080552D376784E1,40171,13,16,3,38,48,1948
25974,25974,441E401293D6FFC8E080552D376784E1,11914,16,18,2,37,48,1898
25975,25975,441E401293D6FFC8E080552D376784E1,42581,20,23,3,38,48,1948
25976,25976,1F9F1C83F1B526750C2575DE062BE373,42523,0,9,9,31,47,1597
25977,25977,1F9F1C83F1B526750C2575DE062BE373,11001,10,11,1,42,47,2147
25978,25978,1F9F1C83F1B526750C2575DE062BE373,43761,12,22,10,32,47,1647
25987,25987,B2E1A9593E19D988BDD0EE32D9CE9188,11281,0,8,8,27,40,1390
25988,25988,B2E1A9593E19D988BDD0EE32D9CE9188,12601,8,14,6,25,47,1297
25989,25989,B2E1A9593E19D988BDD0EE32D9CE9188,11281,17,19,2,27,40,1390
25990,25990,B2E1A9593E19D988BDD0EE32D9CE9188,13311,21,22,1,27,39,1389
25991,25991,1DD2675D978306D1003A0492DF17A6CF,43341,0,9,9,41,46,2096
25992,25992,1DD2675D978306D1003A0492DF17A6CF,11531,13,14,1,34,49,1749
25993,25993,1DD2675D978306D1003A0492DF17A6CF,10841,18,19,1,37,47,1897
25994,25994,1DD2675D978306D1003A0492DF17A6CF,43341,22,23,1,41,46,2096
25995,25995,FEB59A68C75F5BC8C8778D41EDBC2B0C,10841,0,6,6,37,47,1897
25996,25996,FEB59A68C75F5BC8C8778D41EDBC2B0C,40302,12,16,4,40,49,2049
25997,25997,FEB59A68C75F5BC8C8778D41EDBC2B0C,13711,18,23,5,38,46,1946
25998,25998,3CBA439439A818CE4E4FEBB6B36C949B,43161,0,6,6,35,47,1797
25999,25999,3CBA439439A818CE4E4FEBB6B36C949B,42161,8,9,1,36,47,1847
26000,26000,3CBA439439A818CE4E4FEBB6B36C949B,43161,12,16,4,35,47,1797
26001,26001,3CBA439439A818CE4E4FEBB6B36C949B,12521,18,19,1,35,41,1791
26010,26010,5529DD2214C36634346603006F6A0F3F,12521,0,6,6,35,41,1791
26011,26011,5529DD2214C36634346603006F6A0F3F,13314,7,8,1,31,39,1589
26012,26012,5529DD2214C36634346603006F6A0F3F,12521,8,14,6,35,41,1791
26013,26013,5529DD2214C36634346603006F6A0F3F,42381,14,17,3,39,41,1991
26014,26014,5529DD2214C36634346603006F6A0F3F,12521,17,23,6,35,41,1791
26018,26018,95F5650709CACF923AC8764BA8D78995,10351,2,3,1,28,45,1445
26019,26019,95F5650709CACF923AC8764BA8D78995,13671,4,6,2,27,43,1393
26020,26020,95F5650709CACF923AC8764BA8D78995,42531,9,12,3,31,45,1595
26021,26021,95F5650709CACF923AC8764BA8D78995,12311,13,14,1,30,44,1544
26022,26022,95F5650709CACF923AC8764BA8D78995,42531,15,16,1,31,45,1595
26023,26023,95F5650709CACF923AC8764BA8D78995,12311,16,17,1,30,44,1544
26024,26024,95F5650709CACF923AC8764BA8D78995,11081,18,19,1,35,46,1796
26025,26025,95F5650709CACF923AC8764BA8D78995,42531,20,22,2,31,45,1595
26032,26032,19CFADE53A4E618D30CBCE45D478F0C7,12641,0,6,6,10,43,543
26033,26033,19CFADE53A4E618D30CBCE45D478F0C7,19181,10,11,1,8,40,440
26034,26034,19CFADE53A4E618D30CBCE45D478F0C7,12921,12,16,4,9,41,491
26035,26035,19CFADE53A4E618D30CBCE45D478F0C7,19744,19,20,1,6,43,343
26036,26036,19CFADE53A4E618D30CBCE45D478F0C7,19114,21,22,1,7,43,393
26046,26046,1425A0F2912750FA0EF5B4ADBC6542C9,11541,0,14,14,35,49,1799
26047,26047,1425A0F2912750FA0EF5B4ADBC6542C9,11701,19,20,1,43,48,2198
26048,26048,1425A0F2912750FA0EF5B4ADBC6542C9,40271,21,23,2,35,49,1799
26049,26049,2D31A857958A9483557700A965EAE41B,10401,0,9,9,33,49,1699
26050,26050,2D31A857958A9483557700A965EAE41B,11201,13,15,2,35,49,1799
26051,26051,2D31A857958A9483557700A965EAE41B,12601,16,18,2,25,47,1297
26052,26052,2D31A857958A9483557700A965EAE41B,11211,20,21,1,34,49,1749
26060,26060,02DE3D555EE45525F249BB367D3089C8,12381,2,12,10,32,48,1648
26061,26061,02DE3D555EE45525F249BB367D3089C8,42381,14,15,1,39,41,1991
26062,26062,02DE3D555EE45525F249BB367D3089C8,40341,16,19,3,23,49,1199
26070,26070,EC861FE21AFD755213652562865FFBF9,43101,0,1,1,46,40,2340
26071,26071,EC861FE21AFD755213652562865FFBF9,13071,8,9,1,41,41,2091
26072,26072,EC861FE21AFD755213652562865FFBF9,43101,16,18,2,46,40,2340
26073,26073,EC861FE21AFD755213652562865FFBF9,13071,19,21,2,41,41,2091
26077,26077,E91D856AE77784A332A7B6F7D402953C,42501,0,9,9,28,47,1447
26078,26078,E91D856AE77784A332A7B6F7D402953C,43761,12,14,2,32,47,1647
26079,26079,E91D856AE77784A332A7B6F7D402953C,42523,14,15,1,31,47,1597
26080,26080,E91D856AE77784A332A7B6F7D402953C,42541,18,19,1,25,47,1297
26081,26081,E91D856AE77784A332A7B6F7D402953C,42501,19,23,4,28,47,1447
26082,26082,B969FE7CA88FA294C8201CFC44CC669E,12121,0,7,7,29,47,1497
26083,26083,B969FE7CA88FA294C8201CFC44CC669E,12601,8,13,5,25,47,1297
26084,26084,B969FE7CA88FA294C8201CFC44CC669E,11201,18,20,2,35,49,1799
26099,26099,1CD741282378ACECE229BFA3E57C9431,19441,0,6,6,8,46,446
26100,26100,1CD741282378ACECE229BFA3E57C9431,42041,8,12,4,10,47,547
26101,26101,1CD741282378ACECE229BFA3E57C9431,19441,12,13,1,8,46,446
26102,26102,1CD741282378ACECE229BFA3E57C9431,42041,15,17,2,10,47,547
26103,26103,1CD741282378ACECE229BFA3E57C9431,19441,18,19,1,8,46,446
26104,26104,1CD741282378ACECE229BFA3E57C9431,42041,20,21,1,10,47,547
26105,26105,1CD741282378ACECE229BFA3E57C9431,19441,21,22,1,8,46,446
26106,26106,A9FAA4B4C51A5D14416D1899F40B6E9A,19801,1,7,6,19,26,976
26107,26107,A9FAA4B4C51A5D14416D1899F40B6E9A,13481,8,9,1,26,31,1331
26108,26108,A9FAA4B4C51A5D14416D1899F40B6E9A,19801,12,13,1,19,26,976
26109,26109,A9FAA4B4C51A5D14416D1899F40B6E9A,13481,14,15,1,26,31,1331
26110,26110,A9FAA4B4C51A5D14416D1899F40B6E9A,19801,18,20,2,19,26,976
26111,26111,5C2B763013F3453FD43407A455CBD2B2,13651,0,4,4,30,47,1547
26112,26112,5C2B763013F3453FD43407A455CBD2B2,11111,8,17,9,26,48,1348
26113,26113,5C2B763013F3453FD43407A455CBD2B2,42523,19,21,2,31,47,1597
26114,26114,79AB37E4BA910BB73519FC84F2A35B1A,43021,0,1,1,16,43,843
26115,26115,79AB37E4BA910BB73519FC84F2A35B1A,12921,1,4,3,9,41,491
26116,26116,79AB37E4BA910BB73519FC84F2A35B1A,19021,6,7,1,10,45,545
26117,26117,79AB37E4BA910BB73519FC84F2A35B1A,43021,8,16,8,16,43,843
26118,26118,79AB37E4BA910BB73519FC84F2A35B1A,12641,16,18,2,10,43,543
26119,26119,79AB37E4BA910BB73519FC84F2A35B1A,12921,18,19,1,9,41,491
26120,26120,79AB37E4BA910BB73519FC84F2A35B1A,19181,21,23,2,8,40,440
26121,26121,FD400E5E5D48DD38D9BF2DF0674CF1A6,11281,0,4,4,27,40,1390
26122,26122,FD400E5E5D48DD38D9BF2DF0674CF1A6,12311,5,6,1,30,44,1544
26123,26123,FD400E5E5D48DD38D9BF2DF0674CF1A6,11281,9,22,13,27,40,1390
26127,26127,3E2728364EE0F8914C7020C6A1917CB0,42161,1,7,6,36,47,1847
26128,26128,3E2728364EE0F8914C7020C6A1917CB0,12601,9,11,2,25,47,1297
26129,26129,3E2728364EE0F8914C7020C6A1917CB0,10251,13,22,9,35,47,1797
26136,26136,8B6448FD7DB9F8E2F8F73AFDDD5BFD38,43021,0,5,5,16,43,843
26137,26137,8B6448FD7DB9F8E2F8F73AFDDD5BFD38,12641,5,19,14,10,43,543
26138,26138,8B6448FD7DB9F8E2F8F73AFDDD5BFD38,12921,20,21,1,9,41,491
26139,26139,BA02C3BCEE7A48A5C905C95BDC29D4FD,12792,6,11,5,34,30,1730
26140,26140,BA02C3BCEE7A48A5C905C95BDC29D4FD,15391,11,13,2,35,26,1776
26141,26141,BA02C3BCEE7A48A5C905C95BDC29D4FD,12792,15,18,3,34,30,1730
26142,26142,BA02C3BCEE7A48A5C905C95BDC29D4FD,15391,19,23,4,35,26,1776
26143,26143,8ACC50A8C55036CCB5F5CED9121C61C8,43081,1,2,1,27,28,1378
26144,26144,8ACC50A8C55036CCB5F5CED9121C61C8,15191,6,13,7,36,27,1827
26145,26145,8ACC50A8C55036CCB5F5CED9121C61C8,12791,15,17,2,31,29,1579
26146,26146,8ACC50A8C55036CCB5F5CED9121C61C8,15191,18,19,1,36,27,1827
26147,26147,27B6DDFE3A356062F221ABD7AD70BB14,11061,0,8,8,29,48,1498
26148,26148,27B6DDFE3A356062F221ABD7AD70BB14,10681,9,10,1,30,48,1548
26149,26149,27B6DDFE3A356062F221ABD7AD70BB14,11061,11,12,1,29,48,1498
26150,26150,27B6DDFE3A356062F221ABD7AD70BB14,10681,12,15,3,30,48,1548
26151,26151,27B6DDFE3A356062F221ABD7AD70BB14,11061,18,23,5,29,48,1498
26152,26152,BC53AC2AD605C4C7ADADBBDB96B20E92,12381,0,1,1,32,48,1648
26153,26153,BC53AC2AD605C4C7ADADBBDB96B20E92,10154,3,15,12,33,47,1697
26154,26154,BC53AC2AD605C4C7ADADBBDB96B20E92,40302,18,19,1,40,49,2049
26155,26155,BC53AC2AD605C4C7ADADBBDB96B20E92,13601,22,23,1,34,47,1747
26156,26156,A2DD7BA75FCE1B5306A377D198F94491,15391,0,4,4,35,26,1776
26157,26157,A2DD7BA75FCE1B5306A377D198F94491,12792,5,9,4,34,30,1730
26158,26158,A2DD7BA75FCE1B5306A377D198F94491,15391,13,23,10,35,26,1776
26159,26159,5777E91F6C21D7F929436C43E70423ED,11021,10,12,2,36,49,1849
26160,26160,5777E91F6C21D7F929436C43E70423ED,11201,12,14,2,35,49,1799
26161,26161,5777E91F6C21D7F929436C43E70423ED,10451,19,20,1,25,48,1298
26162,26162,E5C174D2FF195FD116006ADE577A953D,11381,0,2,2,30,47,1547
26163,26163,E5C174D2FF195FD116006ADE577A953D,11061,2,7,5,29,48,1498
26164,26164,E5C174D2FF195FD116006ADE577A953D,11151,10,11,1,30,48,1548
26165,26165,E5C174D2FF195FD116006ADE577A953D,11061,11,13,2,29,48,1498
26166,26166,E5C174D2FF195FD116006ADE577A953D,11151,14,17,3,30,48,1548
26167,26167,E5C174D2FF195FD116006ADE577A953D,11381,21,23,2,30,47,1547
26174,26174,7DC04918C676E47DDDC7D65DB04D24FD,13071,0,7,7,41,41,2091
26175,26175,7DC04918C676E47DDDC7D65DB04D24FD,43951,7,9,2,49,41,2491
26176,26176,7DC04918C676E47DDDC7D65DB04D24FD,13071,10,11,1,41,41,2091
26177,26177,7DC04918C676E47DDDC7D65DB04D24FD,43951,13,15,2,49,41,2491
26178,26178,7DC04918C676E47DDDC7D65DB04D24FD,13071,19,20,1,41,41,2091
26179,26179,329011D78CCD407A57D7741FD67F5153,10301,0,8,8,31,45,1595
26180,26180,329011D78CCD407A57D7741FD67F5153,10351,10,16,6,28,45,1445
26181,26181,329011D78CCD407A57D7741FD67F5153,10271,16,18,2,37,46,1896
26182,26182,A6BBFE7886A6BFC52F86E58BBD2C0899,12871,1,3,2,22,33,1133
26183,26183,A6BBFE7886A6BFC52F86E58BBD2C0899,19281,6,8,2,16,32,832
26184,26184,A6BBFE7886A6BFC52F86E58BBD2C0899,12871,11,15,4,22,33,1133
26185,26185,A6BBFE7886A6BFC52F86E58BBD2C0899,19281,19,23,4,16,32,832
26186,26186,BB6408B6449FE57F7E33631A828BC98E,13961,3,11,8,42,48,2148
26187,26187,BB6408B6449FE57F7E33631A828BC98E,12514,13,16,3,38,47,1947
26188,26188,BB6408B6449FE57F7E33631A828BC98E,11701,17,23,6,43,48,2198
26189,26189,694AE58BB8FA7D73732050F947690888,42151,1,5,4,35,45,1795
26190,26190,694AE58BB8FA7D73732050F947690888,11261,6,19,13,36,46,1846
26191,26191,694AE58BB8FA7D73732050F947690888,13461,22,23,1,39,44,1994
26192,26192,0C5285B3D9349DE5F23E13A6102C7D40,49201,4,5,1,7,41,391
26193,26193,0C5285B3D9349DE5F23E13A6102C7D40,12921,8,10,2,9,41,491
26194,26194,0C5285B3D9349DE5F23E13A6102C7D40,12641,11,12,1,10,43,543
26195,26195,0C5285B3D9349DE5F23E13A6102C7D40,49201,15,16,1,7,41,391
26196,26196,0C5285B3D9349DE5F23E13A6102C7D40,12641,17,19,2,10,43,543
26197,26197,0C5285B3D9349DE5F23E13A6102C7D40,49201,21,23,2,7,41,391
26198,26198,AE0FCD2E71074EC83400DA10B63EF737,42141,0,11,11,32,47,1647
26199,26199,AE0FCD2E71074EC83400DA10B63EF737,12381,12,13,1,32,48,1648
26200,26200,AE0FCD2E71074EC83400DA10B63EF737,40951,15,17,2,36,49,1849
26201,26201,AE0FCD2E71074EC83400DA10B63EF737,42141,18,21,3,32,47,1647
26202,26202,A2A76E9881459C38F2E7EA3180775566,42681,0,5,5,24,48,1248
26203,26203,A2A76E9881459C38F2E7EA3180775566,40343,7,10,3,24,49,1249
26204,26204,A2A76E9881459C38F2E7EA3180775566,42681,10,12,2,24,48,1248
26205,26205,A2A76E9881459C38F2E7EA3180775566,10881,17,19,2,34,48,1748
26206,26206,A2A76E9881459C38F2E7EA3180775566,42681,20,23,3,24,48,1248
26207,26207,9F589AB01E58B6B2CA9FB997F96CB7F3,13071,0,13,13,41,41,2091
26208,26208,9F589AB01E58B6B2CA9FB997F96CB7F3,43451,14,17,3,37,40,1890
26209,26209,9F589AB01E58B6B2CA9FB997F96CB7F3,13071,20,23,3,41,41,2091
26210,26210,C70CB9CA8304D22FD6E6BECF352D543D,10951,8,11,3,29,48,1498
26211,26211,C70CB9CA8304D22FD6E6BECF352D543D,12121,11,13,2,29,47,1497
26212,26212,C70CB9CA8304D22FD6E6BECF352D543D,10951,13,16,3,29,48,1498
26213,26213,C70CB9CA8304D22FD6E6BECF352D543D,40341,17,18,1,23,49,1199
26214,26214,C70CB9CA8304D22FD6E6BECF352D543D,12121,19,23,4,29,47,1497
26219,26219,F3B16B9F2FE5D66DD896BE8E61C1FA80,10351,0,8,8,28,45,1445
26220,26220,F3B16B9F2FE5D66DD896BE8E61C1FA80,10301,8,15,7,31,45,1595
26221,26221,F3B16B9F2FE5D66DD896BE8E61C1FA80,10151,19,20,1,34,47,1747
26222,26222,F3B16B9F2FE5D66DD896BE8E61C1FA80,10351,21,23,2,28,45,1445
26223,26223,CD8AE18614BA812CC3BAB9DC79A4337F,11571,0,1,1,13,46,696
26224,26224,CD8AE18614BA812CC3BAB9DC79A4337F,42041,1,5,4,10,47,547
26225,26225,CD8AE18614BA812CC3BAB9DC79A4337F,11571,9,11,2,13,46,696
26226,26226,CD8AE18614BA812CC3BAB9DC79A4337F,19441,15,17,2,8,46,446
26227,26227,CD8AE18614BA812CC3BAB9DC79A4337F,19901,19,22,3,7,44,394
26228,26228,7F39CFD81893EF00CED4C98A6CC13D33,13651,0,2,2,30,47,1547
26229,26229,7F39CFD81893EF00CED4C98A6CC13D33,43761,2,4,2,32,47,1647
26230,26230,7F39CFD81893EF00CED4C98A6CC13D33,12121,8,15,7,29,47,1497
26231,26231,7F39CFD81893EF00CED4C98A6CC13D33,43761,17,19,2,32,47,1647
26232,26232,7F39CFD81893EF00CED4C98A6CC13D33,12121,22,23,1,29,47,1497
26233,26233,494D14A3621985C0273BE75F8254C29B,11571,0,4,4,13,46,696
26234,26234,494D14A3621985C0273BE75F8254C29B,10501,6,10,4,22,46,1146
26235,26235,494D14A3621985C0273BE75F8254C29B,11571,12,23,11,13,46,696
26236,26236,E675A65705B47E64E764764AA7201F3F,15411,0,2,2,44,27,2227
26237,26237,E675A65705B47E64E764764AA7201F3F,15561,2,5,3,32,22,1622
26238,26238,E675A65705B47E64E764764AA7201F3F,15411,6,8,2,44,27,2227
26239,26239,E675A65705B47E64E764764AA7201F3F,12611,8,11,3,41,29,2079
26240,26240,E675A65705B47E64E764764AA7201F3F,15411,13,17,4,44,27,2227
26241,26241,E675A65705B47E64E764764AA7201F3F,15561,22,23,1,32,22,1622
26242,26242,BD318E9AF2E060A187A0EF37B2B8ED3A,12381,0,7,7,32,48,1648
26243,26243,BD318E9AF2E060A187A0EF37B2B8ED3A,10161,8,10,2,35,49,1799
26244,26244,BD318E9AF2E060A187A0EF37B2B8ED3A,42231,14,15,1,37,46,1896
26245,26245,BD318E9AF2E060A187A0EF37B2B8ED3A,10161,19,22,3,35,49,1799
26246,26246,745F3FA1354D98082AFF1C374357DA89,42291,0,9,9,29,48,1498
26247,26247,745F3FA1354D98082AFF1C374357DA89,11541,11,12,1,35,49,1799
26248,26248,745F3FA1354D98082AFF1C374357DA89,11381,13,23,10,30,47,1547
26252,26252,9ADEB31D1D7C8DC65FE4C9F42CC16DA8,13314,0,6,6,31,39,1589
26253,26253,9ADEB31D1D7C8DC65FE4C9F42CC16DA8,12521,7,17,10,35,41,1791
26254,26254,9ADEB31D1D7C8DC65FE4C9F42CC16DA8,13314,19,23,4,31,39,1589
26259,26259,D5C98D28246C767D0FFD7F7274CFF193,13314,0,7,7,31,39,1589
26260,26260,D5C98D28246C767D0FFD7F7274CFF193,12521,8,9,1,35,41,1791
26261,26261,D5C98D28246C767D0FFD7F7274CFF193,13314,12,13,1,31,39,1589
26262,26262,D5C98D28246C767D0FFD7F7274CFF193,12521,14,15,1,35,41,1791
26263,26263,D5C98D28246C767D0FFD7F7274CFF193,43451,15,16,1,37,40,1890
26264,26264,D5C98D28246C767D0FFD7F7274CFF193,12521,17,18,1,35,41,1791
26265,26265,D5C98D28246C767D0FFD7F7274CFF193,13314,18,23,5,31,39,1589
26273,26273,0BCAB1889195FC18223902BD6E09E761,12731,1,8,7,22,40,1140
26274,26274,0BCAB1889195FC18223902BD6E09E761,12521,9,11,2,35,41,1791
26275,26275,0BCAB1889195FC18223902BD6E09E761,13121,13,14,1,38,46,1946
26276,26276,0BCAB1889195FC18223902BD6E09E761,42381,15,16,1,39,41,1991
26277,26277,0BCAB1889195FC18223902BD6E09E761,12521,16,20,4,35,41,1791
26278,26278,0BCAB1889195FC18223902BD6E09E761,13314,21,23,2,31,39,1589
26279,26279,D049151AA3A3F2786A77273D813485C6,13101,0,4,4,40,47,2047
26280,26280,D049151AA3A3F2786A77273D813485C6,12121,7,9,2,29,47,1497
26281,26281,D049151AA3A3F2786A77273D813485C6,40833,11,12,1,41,47,2097
26282,26282,D049151AA3A3F2786A77273D813485C6,13101,12,14,2,40,47,2047
26283,26283,D049151AA3A3F2786A77273D813485C6,40833,15,16,1,41,47,2097
26284,26284,D049151AA3A3F2786A77273D813485C6,13101,17,20,3,40,47,2047
26288,26288,0E5F301237FBD4915F1042740E938ED6,10331,0,12,12,39,46,1996
26289,26289,0E5F301237FBD4915F1042740E938ED6,10841,12,13,1,37,47,1897
26290,26290,0E5F301237FBD4915F1042740E938ED6,40341,14,20,6,23,49,1199
26291,26291,0E5F301237FBD4915F1042740E938ED6,10331,21,23,2,39,46,1996
26300,26300,6688FC2285BC13A1BD6CD9A3CA8E16B7,11911,0,11,11,37,48,1898
26301,26301,6688FC2285BC13A1BD6CD9A3CA8E16B7,42351,15,16,1,38,45,1945
26302,26302,6688FC2285BC13A1BD6CD9A3CA8E16B7,11641,17,19,2,22,49,1149
26310,26310,C3CC4BAB2A8D98453859826AC768DF24,13651,0,8,8,30,47,1547
26311,26311,C3CC4BAB2A8D98453859826AC768DF24,11481,11,13,2,41,48,2098
26312,26312,C3CC4BAB2A8D98453859826AC768DF24,12021,14,15,1,37,49,1899
26313,26313,C3CC4BAB2A8D98453859826AC768DF24,40341,18,20,2,23,49,1199
26314,26314,C3CC4BAB2A8D98453859826AC768DF24,10151,21,23,2,34,47,1747
26315,26315,0450CE4A9EA5097186EEF727418CD364,42231,0,1,1,37,46,1896
26316,26316,0450CE4A9EA5097186EEF727418CD364,13711,4,5,1,38,46,1946
26317,26317,0450CE4A9EA5097186EEF727418CD364,11941,7,8,1,37,46,1896
26318,26318,0450CE4A9EA5097186EEF727418CD364,42151,11,18,7,35,45,1795
26319,26319,0450CE4A9EA5097186EEF727418CD364,42231,21,22,1,37,46,1896
26320,26320,27A0DD6A965A1FEA8EED4D0E73345414,19181,2,3,1,8,40,440
26321,26321,27A0DD6A965A1FEA8EED4D0E73345414,12921,6,14,8,9,41,491
26322,26322,27A0DD6A965A1FEA8EED4D0E73345414,12641,14,16,2,10,43,543
26323,26323,27A0DD6A965A1FEA8EED4D0E73345414,12921,16,19,3,9,41,491
26324,26324,27A0DD6A965A1FEA8EED4D0E73345414,19181,20,21,1,8,40,440
26325,26325,1BD58ED4C87C4E7FB266C3FDC7A25F87,10681,0,4,4,30,48,1548
26326,26326,1BD58ED4C87C4E7FB266C3FDC7A25F87,12381,5,6,1,32,48,1648
26327,26327,1BD58ED4C87C4E7FB266C3FDC7A25F87,10681,11,12,1,30,48,1548
26328,26328,1BD58ED4C87C4E7FB266C3FDC7A25F87,12971,13,17,4,32,48,1648
26329,26329,1BD58ED4C87C4E7FB266C3FDC7A25F87,10681,21,23,2,30,48,1548
26342,26342,A35071276CF6040BBB9F2CC0B19C39D4,43751,0,3,3,19,48,998
26343,26343,A35071276CF6040BBB9F2CC0B19C39D4,42691,6,7,1,24,48,1248
26344,26344,A35071276CF6040BBB9F2CC0B19C39D4,11641,10,12,2,22,49,1149
26345,26345,A35071276CF6040BBB9F2CC0B19C39D4,42691,13,20,7,24,48,1248
26349,26349,E090AE745FE0157CE235544725EE3E3A,42281,1,3,2,40,48,2048
26350,26350,E090AE745FE0157CE235544725EE3E3A,42221,8,9,1,38,48,1948
26351,26351,E090AE745FE0157CE235544725EE3E3A,11074,13,14,1,37,47,1897
26352,26352,E090AE745FE0157CE235544725EE3E3A,42221,16,17,1,38,48,1948
26353,26353,E090AE745FE0157CE235544725EE3E3A,12511,20,22,2,39,47,1997
26354,26354,E090AE745FE0157CE235544725EE3E3A,12514,22,23,1,38,47,1947
26355,26355,68130B44ECEB142BC69A4DBE5DDD3715,12661,0,12,12,32,45,1645
26356,26356,68130B44ECEB142BC69A4DBE5DDD3715,43101,15,16,1,46,40,2340
26357,26357,68130B44ECEB142BC69A4DBE5DDD3715,12661,17,23,6,32,45,1645
26358,26358,C14EE605AF47234DE280A3E7EB161B28,10301,3,17,14,31,45,1595
26359,26359,C14EE605AF47234DE280A3E7EB161B28,12021,19,20,1,37,49,1899
26360,26360,C14EE605AF47234DE280A3E7EB161B28,12083,20,23,3,36,49,1849
26361,26361,7977837C561DAF2BE63B159C5447A829,42371,0,6,6,34,46,1746
26362,26362,7977837C561DAF2BE63B159C5447A829,13671,7,12,5,27,43,1393
26363,26363,7977837C561DAF2BE63B159C5447A829,13314,15,16,1,31,39,1589
26364,26364,7977837C561DAF2BE63B159C5447A829,42371,18,23,5,34,46,1746
26365,26365,2D868D5BE3CEB8F6D73B9B7117AF4556,11541,0,9,9,35,49,1799
26366,26366,2D868D5BE3CEB8F6D73B9B7117AF4556,43641,13,14,1,16,38,838
26367,26367,2D868D5BE3CEB8F6D73B9B7117AF4556,10221,17,18,1,34,49,1749
26368,26368,2D868D5BE3CEB8F6D73B9B7117AF4556,10251,21,22,1,35,47,1797
26372,26372,9FE2A6FCC5EEC778A427CFD9C2DB10C5,11911,0,7,7,37,48,1898
26373,26373,9FE2A6FCC5EEC778A427CFD9C2DB10C5,40343,9,12,3,24,49,1249
26374,26374,9FE2A6FCC5EEC778A427CFD9C2DB10C5,40673,15,18,3,36,48,1848
26375,26375,9FE2A6FCC5EEC778A427CFD9C2DB10C5,43171,21,22,1,39,49,1999
26379,26379,7555BE56ECBD7A21A433BB338C4AD042,11091,3,6,3,29,47,1497
26380,26380,7555BE56ECBD7A21A433BB338C4AD042,19114,9,12,3,7,43,393
26381,26381,7555BE56ECBD7A21A433BB338C4AD042,12641,12,18,6,10,43,543
26385,26385,97A72775944BA1B8C6B7775217FDFDCA,12514,0,5,5,38,47,1947
26386,26386,97A72775944BA1B8C6B7775217FDFDCA,12511,6,8,2,39,47,1997
26387,26387,97A72775944BA1B8C6B7775217FDFDCA,12514,9,12,3,38,47,1947
26388,26388,97A72775944BA1B8C6B7775217FDFDCA,42221,12,19,7,38,48,1948
26389,26389,97A72775944BA1B8C6B7775217FDFDCA,12514,21,23,2,38,47,1947
26390,26390,665D84DE00719CFBCFE85E60D38EDE84,10841,1,2,1,37,47,1897
26391,26391,665D84DE00719CFBCFE85E60D38EDE84,12514,3,4,1,38,47,1947
26392,26392,665D84DE00719CFBCFE85E60D38EDE84,12511,4,9,5,39,47,1997
26393,26393,665D84DE00719CFBCFE85E60D38EDE84,12514,9,11,2,38,47,1947
26394,26394,665D84DE00719CFBCFE85E60D38EDE84,12511,15,17,2,39,47,1997
26395,26395,665D84DE00719CFBCFE85E60D38EDE84,12514,18,23,5,38,47,1947
26396,26396,BBCB9918D42B41DEDF16DD7F5A9BE26F,11861,0,11,11,32,47,1647
26397,26397,BBCB9918D42B41DEDF16DD7F5A9BE26F,11331,12,16,4,37,48,1898
26398,26398,BBCB9918D42B41DEDF16DD7F5A9BE26F,11861,17,23,6,32,47,1647
26399,26399,9ED79486E96228E58F4205FAB52E5573,11021,0,6,6,36,49,1849
26400,26400,9ED79486E96228E58F4205FAB52E5573,42081,9,10,1,24,49,1249
26401,26401,9ED79486E96228E58F4205FAB52E5573,41591,12,14,2,34,49,1749
26402,26402,9ED79486E96228E58F4205FAB52E5573,11021,21,22,1,36,49,1849
26406,26406,18CC8E24CC8440426B1B91C3FCBC17A9,40112,0,8,8,32,48,1648
26407,26407,18CC8E24CC8440426B1B91C3FCBC17A9,11231,12,13,1,37,49,1899
26408,26408,18CC8E24CC8440426B1B91C3FCBC17A9,40171,20,22,2,38,48,1948
26412,26412,C6E2FE724EC40E59A83AB356B4604856,11331,0,6,6,37,48,1898
26413,26413,C6E2FE724EC40E59A83AB356B4604856,13731,7,10,3,33,49,1699
26414,26414,C6E2FE724EC40E59A83AB356B4604856,42081,11,12,1,24,49,1249
26415,26415,C6E2FE724EC40E59A83AB356B4604856,13731,13,15,2,33,49,1699
26416,26416,C6E2FE724EC40E59A83AB356B4604856,42081,17,18,1,24,49,1249
26417,26417,C6E2FE724EC40E59A83AB356B4604856,11331,20,22,2,37,48,1898
26418,26418,35CAA8E33B432720CDD3C14AE49DEBFD,43751,2,3,1,19,48,998
26419,26419,35CAA8E33B432720CDD3C14AE49DEBFD,12581,4,10,6,24,48,1248
26420,26420,35CAA8E33B432720CDD3C14AE49DEBFD,43751,12,23,11,19,48,998
26421,26421,38B4DBFFD58FD8FF57AA781F974B31D4,11231,0,7,7,37,49,1899
26422,26422,38B4DBFFD58FD8FF57AA781F974B31D4,43471,8,17,9,31,49,1599
26423,26423,38B4DBFFD58FD8FF57AA781F974B31D4,11231,18,23,5,37,49,1899
26424,26424,E429D5687CEEDF3C035534BDDBC8B9F3,13271,0,6,6,41,47,2097
26425,26425,E429D5687CEEDF3C035534BDDBC8B9F3,13101,7,10,3,40,47,2047
26426,26426,E429D5687CEEDF3C035534BDDBC8B9F3,13271,12,13,1,41,47,2097
26427,26427,E429D5687CEEDF3C035534BDDBC8B9F3,13101,14,18,4,40,47,2047
26428,26428,E429D5687CEEDF3C035534BDDBC8B9F3,13271,20,22,2,41,47,2097
26433,26433,809D30997DBB6653E10DF33CB05A97F7,13771,0,10,10,21,45,1095
26434,26434,809D30997DBB6653E10DF33CB05A97F7,12601,14,15,1,25,47,1297
26435,26435,809D30997DBB6653E10DF33CB05A97F7,13771,17,22,5,21,45,1095
26436,26436,8126820B7626A5221D3CB924C6CED31F,15651,0,8,8,39,25,1975
26437,26437,8126820B7626A5221D3CB924C6CED31F,13091,9,10,1,20,42,1042
26438,26438,8126820B7626A5221D3CB924C6CED31F,12511,13,14,1,39,47,1997
26439,26439,8126820B7626A5221D3CB924C6CED31F,42381,15,17,2,39,41,1991
26440,26440,8126820B7626A5221D3CB924C6CED31F,15651,20,22,2,39,25,1975
26448,26448,CABDD8B2A8DF9C3C6F2F674E6DD5C884,11061,0,7,7,29,48,1498
26449,26449,CABDD8B2A8DF9C3C6F2F674E6DD5C884,11381,10,13,3,30,47,1547
26450,26450,CABDD8B2A8DF9C3C6F2F674E6DD5C884,11061,16,17,1,29,48,1498
26451,26451,CABDD8B2A8DF9C3C6F2F674E6DD5C884,40445,17,20,3,30,48,1548
26452,26452,CABDD8B2A8DF9C3C6F2F674E6DD5C884,11061,20,22,2,29,48,1498
26453,26453,30165500CA5F6A8CB10812947A58AC25,10251,0,12,12,35,47,1797
26454,26454,30165500CA5F6A8CB10812947A58AC25,42491,12,17,5,32,46,1646
26455,26455,30165500CA5F6A8CB10812947A58AC25,10061,17,18,1,20,46,1046
26456,26456,30165500CA5F6A8CB10812947A58AC25,42491,19,23,4,32,46,1646
26464,26464,5B005239AD91B224060A740123F8C94E,13231,0,5,5,39,46,1996
26465,26465,5B005239AD91B224060A740123F8C94E,11381,8,9,1,30,47,1547
26466,26466,5B005239AD91B224060A740123F8C94E,13231,13,23,10,39,46,1996
26467,26467,A6B86C51D1E851C8306B13F3333CE4AD,11491,0,6,6,36,47,1847
26468,26468,A6B86C51D1E851C8306B13F3333CE4AD,10331,9,10,1,39,46,1996
26469,26469,A6B86C51D1E851C8306B13F3333CE4AD,42301,12,15,3,36,47,1847
26470,26470,A6B86C51D1E851C8306B13F3333CE4AD,11074,18,19,1,37,47,1897
26471,26471,A6B86C51D1E851C8306B13F3333CE4AD,42401,19,23,4,36,47,1847
26472,26472,8C0C518F021D811498F3154379387908,16121,0,7,7,3,0,150
26473,26473,8C0C518F021D811498F3154379387908,11461,15,16,1,37,49,1899
26474,26474,8C0C518F021D811498F3154379387908,11061,16,20,4,29,48,1498
26475,26475,8C0C518F021D811498F3154379387908,40341,22,23,1,23,49,1199
26485,26485,B51B8C74A49BD6867CCC9145F07F78FF,43644,3,5,2,14,38,738
26486,26486,B51B8C74A49BD6867CCC9145F07F78FF,43021,6,7,1,16,43,843
26487,26487,B51B8C74A49BD6867CCC9145F07F78FF,13091,8,9,1,20,42,1042
26488,26488,B51B8C74A49BD6867CCC9145F07F78FF,43021,14,19,5,16,43,843
26489,26489,DC96A3C0146AAA7F0BD0C89076B7AB4C,10107,0,9,9,38,49,1949
26490,26490,DC96A3C0146AAA7F0BD0C89076B7AB4C,40341,11,12,1,23,49,1199
26491,26491,DC96A3C0146AAA7F0BD0C89076B7AB4C,10107,14,23,9,38,49,1949
26492,26492,9407F1B8A05452EFE7898A22F58EEDF4,43061,0,5,5,43,46,2196
26493,26493,9407F1B8A05452EFE7898A22F58EEDF4,13071,7,8,1,41,41,2091
26494,26494,9407F1B8A05452EFE7898A22F58EEDF4,42381,9,10,1,39,41,1991
26495,26495,9407F1B8A05452EFE7898A22F58EEDF4,43451,11,13,2,37,40,1890
26496,26496,9407F1B8A05452EFE7898A22F58EEDF4,42381,14,16,2,39,41,1991
26497,26497,9407F1B8A05452EFE7898A22F58EEDF4,43061,19,23,4,43,46,2196
26501,26501,BA7C0D0905AD7B2A4C37AC9B433E8493,10921,0,1,1,43,48,2198
26502,26502,BA7C0D0905AD7B2A4C37AC9B433E8493,42301,18,19,1,36,47,1847
26503,26503,BA7C0D0905AD7B2A4C37AC9B433E8493,11781,21,23,2,38,49,1949
26511,26511,B3A048E5F00FC8ADF3315998C0BC00F9,43121,0,1,1,25,27,1277
26512,26512,B3A048E5F00FC8ADF3315998C0BC00F9,15181,4,6,2,26,24,1324
26513,26513,B3A048E5F00FC8ADF3315998C0BC00F9,15184,6,7,1,29,22,1472
26514,26514,B3A048E5F00FC8ADF3315998C0BC00F9,43121,8,9,1,25,27,1277
26515,26515,B3A048E5F00FC8ADF3315998C0BC00F9,15321,11,16,5,29,26,1476
26516,26516,B3A048E5F00FC8ADF3315998C0BC00F9,15184,17,19,2,29,22,1472
26517,26517,B3A048E5F00FC8ADF3315998C0BC00F9,15321,21,23,2,29,26,1476
26518,26518,EFDA2C5B5C74A84C4F53E182DEEAC908,11571,0,5,5,13,46,696
26519,26519,EFDA2C5B5C74A84C4F53E182DEEAC908,19441,9,10,1,8,46,446
26520,26520,EFDA2C5B5C74A84C4F53E182DEEAC908,11571,12,15,3,13,46,696
26521,26521,EFDA2C5B5C74A84C4F53E182DEEAC908,19441,17,23,6,8,46,446
26530,26530,98BA7F3F4273010D1D66E32FADA4A17B,43751,0,6,6,19,48,998
26531,26531,98BA7F3F4273010D1D66E32FADA4A17B,12581,6,8,2,24,48,1248
26532,26532,98BA7F3F4273010D1D66E32FADA4A17B,43751,8,23,15,19,48,998
26533,26533,FDF3A555382668B3FCFD730AFF8664D2,10411,0,8,8,36,48,1848
26534,26534,FDF3A555382668B3FCFD730AFF8664D2,11231,8,11,3,37,49,1899
26535,26535,FDF3A555382668B3FCFD730AFF8664D2,10411,12,14,2,36,48,1848
26536,26536,FDF3A555382668B3FCFD730AFF8664D2,11231,15,18,3,37,49,1899
26537,26537,FDF3A555382668B3FCFD730AFF8664D2,10411,18,23,5,36,48,1848
26538,26538,EAAB672210C677BA2879CCE67BDB7DF5,11151,0,5,5,30,48,1548
26539,26539,EAAB672210C677BA2879CCE67BDB7DF5,42831,6,8,2,27,48,1398
26540,26540,EAAB672210C677BA2879CCE67BDB7DF5,11151,10,13,3,30,48,1548
26541,26541,EAAB672210C677BA2879CCE67BDB7DF5,11061,15,17,2,29,48,1498
26542,26542,EAAB672210C677BA2879CCE67BDB7DF5,11151,18,22,4,30,48,1548
26543,26543,960FD8FAF04E1E447A1CA2BDB9A16E8A,11861,0,14,14,32,47,1647
26544,26544,960FD8FAF04E1E447A1CA2BDB9A16E8A,11541,14,19,5,35,49,1799
26545,26545,960FD8FAF04E1E447A1CA2BDB9A16E8A,11861,20,23,3,32,47,1647
26546,26546,A52680CFF3255B80F2E899094DC1E938,13951,0,5,5,47,45,2395
26547,26547,A52680CFF3255B80F2E899094DC1E938,43951,7,17,10,49,41,2491
26548,26548,A52680CFF3255B80F2E899094DC1E938,13411,18,19,1,49,42,2492
26549,26549,A52680CFF3255B80F2E899094DC1E938,13951,19,23,4,47,45,2395
26550,26550,A545182A2F00A2DA09CC5229677054C0,40341,8,11,3,23,49,1199
26551,26551,A545182A2F00A2DA09CC5229677054C0,11021,14,17,3,36,49,1849
26552,26552,A545182A2F00A2DA09CC5229677054C0,10841,17,20,3,37,47,1897
26553,26553,A545182A2F00A2DA09CC5229677054C0,11301,22,23,1,41,49,2099
26554,26554,220A83B4C0760D0CE7D499DE7174338C,11324,0,7,7,31,46,1596
26555,26555,220A83B4C0760D0CE7D499DE7174338C,10111,11,12,1,37,47,1897
26556,26556,220A83B4C0760D0CE7D499DE7174338C,11331,12,14,2,37,48,1898
26557,26557,220A83B4C0760D0CE7D499DE7174338C,10111,14,16,2,37,47,1897
26558,26558,220A83B4C0760D0CE7D499DE7174338C,10491,17,20,3,33,48,1698
26559,26559,220A83B4C0760D0CE7D499DE7174338C,11324,21,23,2,31,46,1596
26560,26560,FCB1B20DDDD51219843B425B77436520,10721,0,9,9,31,48,1598
26561,26561,FCB1B20DDDD51219843B425B77436520,12381,14,16,2,32,48,1648
26562,26562,FCB1B20DDDD51219843B425B77436520,11541,17,20,3,35,49,1799
26563,26563,FCB1B20DDDD51219843B425B77436520,12381,20,23,3,32,48,1648
26564,26564,DB7C258B86D471A06BBEC47D2709D566,19061,0,7,7,3,43,193
26565,26565,DB7C258B86D471A06BBEC47D2709D566,11061,9,10,1,29,48,1498
26566,26566,DB7C258B86D471A06BBEC47D2709D566,10381,14,18,4,31,49,1599
26570,26570,F1C03493C93CA25BBABF2DBA1FB3A09C,19441,0,8,8,8,46,446
26571,26571,F1C03493C93CA25BBABF2DBA1FB3A09C,11571,11,12,1,13,46,696
26572,26572,F1C03493C93CA25BBABF2DBA1FB3A09C,19441,13,23,10,8,46,446
26583,26583,9F22CEAACF5F9765BA896D571A934437,12921,10,13,3,9,41,491
26584,26584,9F22CEAACF5F9765BA896D571A934437,43021,15,17,2,16,43,843
26585,26585,9F22CEAACF5F9765BA896D571A934437,12921,18,20,2,9,41,491
26596,26596,FD926C96A4F9758B0E89829758CD18F3,11074,1,2,1,37,47,1897
26597,26597,FD926C96A4F9758B0E89829758CD18F3,10531,2,9,7,34,46,1746
26598,26598,FD926C96A4F9758B0E89829758CD18F3,10151,11,19,8,34,47,1747
26599,26599,FD926C96A4F9758B0E89829758CD18F3,12131,19,21,2,32,47,1647
26600,26600,FD926C96A4F9758B0E89829758CD18F3,10531,22,23,1,34,46,1746
26601,26601,0B48A85C2E63306F2732FBA1CEDC76FB,43361,0,1,1,38,48,1948
26602,26602,0B48A85C2E63306F2732FBA1CEDC76FB,11021,2,10,8,36,49,1849
26603,26603,0B48A85C2E63306F2732FBA1CEDC76FB,11331,13,16,3,37,48,1898
26604,26604,0B48A85C2E63306F2732FBA1CEDC76FB,11021,18,20,2,36,49,1849
26605,26605,0B48A85C2E63306F2732FBA1CEDC76FB,11231,21,22,1,37,49,1899
26606,26606,FF6FF9B0197A91C0352AF48B73895F85,42201,0,7,7,43,46,2196
26607,26607,FF6FF9B0197A91C0352AF48B73895F85,13341,7,9,2,44,45,2245
26608,26608,FF6FF9B0197A91C0352AF48B73895F85,42201,11,14,3,43,46,2196
26609,26609,FF6FF9B0197A91C0352AF48B73895F85,13341,14,16,2,44,45,2245
26610,26610,FF6FF9B0197A91C0352AF48B73895F85,42201,16,19,3,43,46,2196
26614,26614,7308A861032DD6CDA204025A180927B9,42151,0,1,1,35,45,1795
26615,26615,7308A861032DD6CDA204025A180927B9,42371,3,5,2,34,46,1746
26616,26616,7308A861032DD6CDA204025A180927B9,12311,9,10,1,30,44,1544
26617,26617,7308A861032DD6CDA204025A180927B9,42531,14,18,4,31,45,1595
26618,26618,7308A861032DD6CDA204025A180927B9,42151,18,20,2,35,45,1795
26619,26619,41DD0A6027648481BFEC7812042262C9,42351,0,1,1,38,45,1945
26620,26620,41DD0A6027648481BFEC7812042262C9,13911,1,4,3,39,46,1996
26621,26621,41DD0A6027648481BFEC7812042262C9,11231,7,21,14,37,49,1899
26625,26625,DE7BE47E05724D2B7B84051451E0119E,12491,1,8,7,36,43,1843
26626,26626,DE7BE47E05724D2B7B84051451E0119E,10111,11,20,9,37,47,1897
26627,26627,DE7BE47E05724D2B7B84051451E0119E,42161,20,23,3,36,47,1847
26628,26628,27FD8A6CDE751A5F2BC12F75826C7985,43021,0,5,5,16,43,843
26629,26629,27FD8A6CDE751A5F2BC12F75826C7985,12641,7,15,8,10,43,543
26630,26630,27FD8A6CDE751A5F2BC12F75826C7985,12921,15,18,3,9,41,491
26641,26641,362CF58B32D978DCF17B65B310F5E090,15311,0,6,6,43,25,2175
26642,26642,362CF58B32D978DCF17B65B310F5E090,10841,8,11,3,37,47,1897
26643,26643,362CF58B32D978DCF17B65B310F5E090,12151,12,13,1,41,33,2083
26644,26644,362CF58B32D978DCF17B65B310F5E090,15091,13,15,2,35,26,1776
26645,26645,362CF58B32D978DCF17B65B310F5E090,10161,17,23,6,35,49,1799
26646,26646,845099180B2D20E8B353EF994AE250AC,10811,0,9,9,38,46,1946
26647,26647,845099180B2D20E8B353EF994AE250AC,10151,12,13,1,34,47,1747
26648,26648,845099180B2D20E8B353EF994AE250AC,10811,13,23,10,38,46,1946
26653,26653,8EDC20F0B510B8C789B21A1A5BF0D26C,10471,0,7,7,37,48,1898
26654,26654,8EDC20F0B510B8C789B21A1A5BF0D26C,40341,9,11,2,23,49,1199
26655,26655,8EDC20F0B510B8C789B21A1A5BF0D26C,10471,13,23,10,37,48,1898
26656,26656,0D04AEE5D0D9747786113FB147421EF2,12921,0,7,7,9,41,491
26657,26657,0D04AEE5D0D9747786113FB147421EF2,19181,9,10,1,8,40,440
26658,26658,0D04AEE5D0D9747786113FB147421EF2,43724,12,16,4,35,33,1783
26659,26659,0D04AEE5D0D9747786113FB147421EF2,43631,20,21,1,19,43,993
26660,26660,1F6BCFEB56D245CBF5160F742055C8A2,11011,0,1,1,39,49,1999
26661,26661,1F6BCFEB56D245CBF5160F742055C8A2,11151,2,7,5,30,48,1548
26662,26662,1F6BCFEB56D245CBF5160F742055C8A2,11061,9,11,2,29,48,1498
26663,26663,1F6BCFEB56D245CBF5160F742055C8A2,11151,12,15,3,30,48,1548
26664,26664,1F6BCFEB56D245CBF5160F742055C8A2,11061,18,21,3,29,48,1498
26668,26668,C5F7FAD968A638302B2F661E0B67EEF8,10121,1,9,8,36,49,1849
26669,26669,C5F7FAD968A638302B2F661E0B67EEF8,42231,13,14,1,37,46,1896
26670,26670,C5F7FAD968A638302B2F661E0B67EEF8,12083,18,20,2,36,49,1849
26671,26671,C5F7FAD968A638302B2F661E0B67EEF8,42071,21,23,2,31,49,1599
26672,26672,A8C0E319CF806B3860CE270F9D93D0BD,11531,0,15,15,34,49,1749
26673,26673,A8C0E319CF806B3860CE270F9D93D0BD,11031,18,20,2,42,49,2149
26674,26674,A8C0E319CF806B3860CE270F9D93D0BD,11531,21,22,1,34,49,1749
26678,26678,86361714860BCCB10D7011DFBDCC92C9,40872,0,12,12,30,49,1549
26679,26679,86361714860BCCB10D7011DFBDCC92C9,42201,12,14,2,43,46,2196
26680,26680,86361714860BCCB10D7011DFBDCC92C9,42071,17,18,1,31,49,1599
26684,26684,CB51EA3DFBAD71C46F446085843381F3,15391,2,4,2,35,26,1776
26685,26685,CB51EA3DFBAD71C46F446085843381F3,12792,5,6,1,34,30,1730
26686,26686,CB51EA3DFBAD71C46F446085843381F3,43121,7,8,1,25,27,1277
26687,26687,CB51EA3DFBAD71C46F446085843381F3,15361,13,14,1,33,25,1675
26688,26688,CB51EA3DFBAD71C46F446085843381F3,15091,17,18,1,35,26,1776
26689,26689,CB51EA3DFBAD71C46F446085843381F3,43121,21,23,2,25,27,1277
26690,26690,2AC46CC4CE6B06A054D67C3525A8F6E5,10271,0,7,7,37,46,1896
26691,26691,2AC46CC4CE6B06A054D67C3525A8F6E5,42511,11,12,1,37,47,1897
26692,26692,2AC46CC4CE6B06A054D67C3525A8F6E5,10271,12,14,2,37,46,1896
26693,26693,2AC46CC4CE6B06A054D67C3525A8F6E5,11801,15,20,5,42,48,2148
26694,26694,138FF279D92615D61A668B43E45A706D,42221,0,7,7,38,48,1948
26695,26695,138FF279D92615D61A668B43E45A706D,10111,8,10,2,37,47,1897
26696,26696,138FF279D92615D61A668B43E45A706D,42221,12,14,2,38,48,1948
26697,26697,138FF279D92615D61A668B43E45A706D,43731,15,16,1,34,47,1747
26698,26698,138FF279D92615D61A668B43E45A706D,42221,18,20,2,38,48,1948
26703,26703,2CEF816D129AEB4E6BE9C8FD1F28C0F0,10951,0,11,11,29,48,1498
26704,26704,2CEF816D129AEB4E6BE9C8FD1F28C0F0,13651,17,18,1,30,47,1547
26705,26705,2CEF816D129AEB4E6BE9C8FD1F28C0F0,11781,19,21,2,38,49,1949
26713,26713,BA7F8D1245DF2BA170F396020DC5A58C,13671,0,4,4,27,43,1393
26714,26714,BA7F8D1245DF2BA170F396020DC5A58C,12761,5,7,2,25,40,1290
26715,26715,BA7F8D1245DF2BA170F396020DC5A58C,13671,9,23,14,27,43,1393
26719,26719,E04ABF1D82E3C5AAD1AD57EFBADD9580,10221,0,11,11,34,49,1749
26720,26720,E04ABF1D82E3C5AAD1AD57EFBADD9580,12311,15,17,2,30,44,1544
26721,26721,E04ABF1D82E3C5AAD1AD57EFBADD9580,10161,19,23,4,35,49,1799
26722,26722,8ED16B3798A5CB46EE51754BD24AEA76,42491,0,9,9,32,46,1646
26723,26723,8ED16B3798A5CB46EE51754BD24AEA76,10491,11,14,3,33,48,1698
26724,26724,8ED16B3798A5CB46EE51754BD24AEA76,42381,16,18,2,39,41,1991
26725,26725,EC8D784C19C185B8F2C30A9ECA831652,12211,0,5,5,41,44,2094
26726,26726,EC8D784C19C185B8F2C30A9ECA831652,11261,10,16,6,36,46,1846
26727,26727,EC8D784C19C185B8F2C30A9ECA831652,13911,16,18,2,39,46,1996
26728,26728,345D4029BCC33DBFE6D7841DB885E7B2,42491,0,6,6,32,46,1646
26729,26729,345D4029BCC33DBFE6D7841DB885E7B2,19031,8,9,1,1,42,92
26730,26730,345D4029BCC33DBFE6D7841DB885E7B2,10401,9,11,2,33,49,1699
26731,26731,345D4029BCC33DBFE6D7841DB885E7B2,12131,12,18,6,32,47,1647
26732,26732,345D4029BCC33DBFE6D7841DB885E7B2,11061,19,20,1,29,48,1498
26733,26733,6587B781598530C86F6C53CA6F1512D2,10431,0,8,8,33,49,1699
26734,26734,6587B781598530C86F6C53CA6F1512D2,10351,10,11,1,28,45,1445
26735,26735,6587B781598530C86F6C53CA6F1512D2,10431,13,15,2,33,49,1699
26736,26736,6587B781598530C86F6C53CA6F1512D2,11875,16,20,4,30,46,1546
26737,26737,6587B781598530C86F6C53CA6F1512D2,10431,21,23,2,33,49,1699
26742,26742,04FC279D8763FD0D52EBF8F599CB8F45,11021,0,8,8,36,49,1849
26743,26743,04FC279D8763FD0D52EBF8F599CB8F45,42301,8,10,2,36,47,1847
26744,26744,04FC279D8763FD0D52EBF8F599CB8F45,42511,10,19,9,37,47,1897
26745,26745,04FC279D8763FD0D52EBF8F599CB8F45,11521,21,23,2,41,48,2098
26756,26756,30F83A4510E5DF83A42211E8DF223D6F,10544,1,13,12,28,48,1448
26757,26757,30F83A4510E5DF83A42211E8DF223D6F,10921,14,15,1,43,48,2198
26758,26758,30F83A4510E5DF83A42211E8DF223D6F,40361,15,23,8,42,48,2148
26762,26762,38EAD9C71E0631172BE43F523D61F0B8,42971,0,6,6,43,49,2199
26763,26763,38EAD9C71E0631172BE43F523D61F0B8,11381,7,10,3,30,47,1547
26764,26764,38EAD9C71E0631172BE43F523D61F0B8,42971,13,23,10,43,49,2199
26773,26773,1030D8F4FE8CF10A7F5B83AE8CE6624F,42401,0,4,4,36,47,1847
26774,26774,1030D8F4FE8CF10A7F5B83AE8CE6624F,11331,4,6,2,37,48,1898
26775,26775,1030D8F4FE8CF10A7F5B83AE8CE6624F,42401,6,12,6,36,47,1847
26776,26776,1030D8F4FE8CF10A7F5B83AE8CE6624F,11331,12,15,3,37,48,1898
26777,26777,1030D8F4FE8CF10A7F5B83AE8CE6624F,42401,19,23,4,36,47,1847
26778,26778,09CB64EB85C69B9B3A6A8C4860776015,42623,0,6,6,22,49,1149
26779,26779,09CB64EB85C69B9B3A6A8C4860776015,11151,12,13,1,30,48,1548
26780,26780,09CB64EB85C69B9B3A6A8C4860776015,11951,21,23,2,31,49,1599
26781,26781,B532F93B6517A3D30211D466DC2FD209,11806,0,1,1,41,48,2098
26782,26782,B532F93B6517A3D30211D466DC2FD209,42281,2,5,3,40,48,2048
26783,26783,B532F93B6517A3D30211D466DC2FD209,11331,5,6,1,37,48,1898
26784,26784,B532F93B6517A3D30211D466DC2FD209,13381,13,15,2,39,47,1997
26785,26785,B532F93B6517A3D30211D466DC2FD209,42281,18,19,1,40,48,2048
26786,26786,B532F93B6517A3D30211D466DC2FD209,13381,20,22,2,39,47,1997
26787,26787,320F0142A6A8D98142B47BD5D35CD593,43761,1,7,6,32,47,1647
26788,26788,320F0142A6A8D98142B47BD5D35CD593,10411,10,12,2,36,48,1848
26789,26789,320F0142A6A8D98142B47BD5D35CD593,11861,15,21,6,32,47,1647
26790,26790,5F14E1A15EFA1C13F8B10CBC543F107C,12581,0,9,9,24,48,1248
26791,26791,5F14E1A15EFA1C13F8B10CBC543F107C,12641,10,12,2,10,43,543
26792,26792,5F14E1A15EFA1C13F8B10CBC543F107C,12581,13,22,9,24,48,1248
26796,26796,8D7EE0631BD03316D79002116B2659A2,13651,0,7,7,30,47,1547
26797,26797,8D7EE0631BD03316D79002116B2659A2,11541,9,10,1,35,49,1799
26798,26798,8D7EE0631BD03316D79002116B2659A2,13651,12,23,11,30,47,1547
26799,26799,38BAD20AF3F1C2D76FC5AB52738907B1,10341,0,6,6,31,47,1597
26800,26800,38BAD20AF3F1C2D76FC5AB52738907B1,10281,6,10,4,33,48,1698
26801,26801,38BAD20AF3F1C2D76FC5AB52738907B1,10341,11,13,2,31,47,1597
26802,26802,38BAD20AF3F1C2D76FC5AB52738907B1,10281,15,17,2,33,48,1698
26803,26803,38BAD20AF3F1C2D76FC5AB52738907B1,10341,18,21,3,31,47,1597
26804,26804,7C975D0C88EA67D672EB56E3A3056887,12761,0,14,14,25,40,1290
26805,26805,7C975D0C88EA67D672EB56E3A3056887,13671,14,16,2,27,43,1393
26806,26806,7C975D0C88EA67D672EB56E3A3056887,12761,17,22,5,25,40,1290
26810,26810,8CA45383A1E75C702FC2AAC829B85137,42801,0,9,9,40,49,2049
26811,26811,8CA45383A1E75C702FC2AAC829B85137,10221,13,14,1,34,49,1749
26812,26812,8CA45383A1E75C702FC2AAC829B85137,10107,17,20,3,38,49,1949
26813,26813,8CA45383A1E75C702FC2AAC829B85137,40302,21,23,2,40,49,2049
26818,26818,D1AF8C61ECDF34C409E73DFAA488C368,11231,0,9,9,37,49,1899
26819,26819,D1AF8C61ECDF34C409E73DFAA488C368,12391,12,15,3,36,49,1849
26820,26820,D1AF8C61ECDF34C409E73DFAA488C368,40341,16,20,4,23,49,1199
26821,26821,D1AF8C61ECDF34C409E73DFAA488C368,12083,21,23,2,36,49,1849
26825,26825,C5CEA5CBE70F0BCBF75A48F426F2F5F5,12561,0,4,4,45,43,2293
26826,26826,C5CEA5CBE70F0BCBF75A48F426F2F5F5,13341,5,7,2,44,45,2245
26827,26827,C5CEA5CBE70F0BCBF75A48F426F2F5F5,43011,11,12,1,40,42,2042
26828,26828,C5CEA5CBE70F0BCBF75A48F426F2F5F5,12561,13,23,10,45,43,2293
26829,26829,3922FD238DD5D48F7D9D1E9687F957C1,43161,1,6,5,35,47,1797
26830,26830,3922FD238DD5D48F7D9D1E9687F957C1,40691,9,17,8,42,48,2148
26831,26831,3922FD238DD5D48F7D9D1E9687F957C1,43161,19,21,2,35,47,1797
26832,26832,50322D78F9B960D06360104B350D78DB,42051,1,2,1,42,48,2148
26833,26833,50322D78F9B960D06360104B350D78DB,11271,6,9,3,37,48,1898
26834,26834,50322D78F9B960D06360104B350D78DB,42401,11,20,9,36,47,1847
26835,26835,F8C1432856D9260FBF1DC6D3982A96BB,10111,0,5,5,37,47,1897
26836,26836,F8C1432856D9260FBF1DC6D3982A96BB,12481,8,10,2,37,49,1899
26837,26837,F8C1432856D9260FBF1DC6D3982A96BB,10111,13,17,4,37,47,1897
26838,26838,F8C1432856D9260FBF1DC6D3982A96BB,42771,19,20,1,36,47,1847
26839,26839,F8C1432856D9260FBF1DC6D3982A96BB,10111,22,23,1,37,47,1897
26847,26847,8BD468643E2BCBB6BFE1267973163585,43361,0,7,7,38,48,1948
26848,26848,8BD468643E2BCBB6BFE1267973163585,10471,8,11,3,37,48,1898
26849,26849,8BD468643E2BCBB6BFE1267973163585,43361,12,14,2,38,48,1948
26850,26850,8BD468643E2BCBB6BFE1267973163585,10471,14,18,4,37,48,1898
26851,26851,8BD468643E2BCBB6BFE1267973163585,43361,19,23,4,38,48,1948
26852,26852,C38DC7FA552CFDFAC217A41A4700D6AF,42161,0,10,10,36,47,1847
26853,26853,C38DC7FA552CFDFAC217A41A4700D6AF,40341,11,14,3,23,49,1199
26854,26854,C38DC7FA552CFDFAC217A41A4700D6AF,42161,15,23,8,36,47,1847
26855,26855,AE10DC7E84F01B8503F9A575F42C6A41,43171,0,14,14,39,49,1999
26856,26856,AE10DC7E84F01B8503F9A575F42C6A41,12021,15,16,1,37,49,1899
26857,26857,AE10DC7E84F01B8503F9A575F42C6A41,40341,16,19,3,23,49,1199
26858,26858,AE10DC7E84F01B8503F9A575F42C6A41,43171,20,23,3,39,49,1999
26865,26865,4BF8F7FEF1D7444C0B1A7447A2F81EE8,42631,0,7,7,43,45,2195
26866,26866,4BF8F7FEF1D7444C0B1A7447A2F81EE8,42231,9,15,6,37,46,1896
26867,26867,4BF8F7FEF1D7444C0B1A7447A2F81EE8,10811,15,17,2,38,46,1946
26868,26868,4BF8F7FEF1D7444C0B1A7447A2F81EE8,42631,18,23,5,43,45,2195
26869,26869,82EFEE8C48953CCFABA92D42A14AA9D9,15191,2,3,1,36,27,1827
26870,26870,82EFEE8C48953CCFABA92D42A14AA9D9,15391,3,7,4,35,26,1776
26871,26871,82EFEE8C48953CCFABA92D42A14AA9D9,15411,8,17,9,44,27,2227
26872,26872,82EFEE8C48953CCFABA92D42A14AA9D9,15391,19,21,2,35,26,1776
26876,26876,23B993E372590302320AD46630AF2C76,15411,0,16,16,44,27,2227
26877,26877,23B993E372590302320AD46630AF2C76,12792,18,20,2,34,30,1730
26878,26878,23B993E372590302320AD46630AF2C76,13251,22,23,1,48,28,2428
26879,26879,4B71B639F21E2494C5369E9744AC687B,43751,0,16,16,19,48,998
26880,26880,4B71B639F21E2494C5369E9744AC687B,40341,19,21,2,23,49,1199
26881,26881,4B71B639F21E2494C5369E9744AC687B,43751,22,23,1,19,48,998
26882,26882,17ED77CF962040F64A4D9684CDA4E8D9,10251,0,9,9,35,47,1797
26883,26883,17ED77CF962040F64A4D9684CDA4E8D9,43011,12,14,2,40,42,2042
26884,26884,17ED77CF962040F64A4D9684CDA4E8D9,10251,19,23,4,35,47,1797
26885,26885,D5A1F589AD5A8A456E0D23A90489837D,43761,0,7,7,32,47,1647
26886,26886,D5A1F589AD5A8A456E0D23A90489837D,11231,10,18,8,37,49,1899
26887,26887,D5A1F589AD5A8A456E0D23A90489837D,43761,18,21,3,32,47,1647
26888,26888,E6FF42AEECF0CDA6C42BDBDEFD456416,13951,0,6,6,47,45,2395
26889,26889,E6FF42AEECF0CDA6C42BDBDEFD456416,43951,10,18,8,49,41,2491
26890,26890,E6FF42AEECF0CDA6C42BDBDEFD456416,13951,20,23,3,47,45,2395
26891,26891,13A17911F453E4AAF4D9A615FF8D2F12,42111,1,8,7,44,46,2246
26892,26892,13A17911F453E4AAF4D9A615FF8D2F12,15201,11,12,1,42,16,2116
26893,26893,13A17911F453E4AAF4D9A615FF8D2F12,13481,15,18,3,26,31,1331
26904,26904,A33710B1F53807B293E564AA3801F46F,15281,0,4,4,25,3,1253
26905,26905,A33710B1F53807B293E564AA3801F46F,15221,4,7,3,31,4,1554
26906,26906,A33710B1F53807B293E564AA3801F46F,15331,8,13,5,38,24,1924
26907,26907,A33710B1F53807B293E564AA3801F46F,15401,14,15,1,39,25,1975
26908,26908,A33710B1F53807B293E564AA3801F46F,15221,21,23,2,31,4,1554
26912,26912,BDD53902F29DF314B446CF4D23137A5B,10292,8,9,1,30,47,1547
26913,26913,BDD53902F29DF314B446CF4D23137A5B,11751,12,13,1,35,48,1798
26914,26914,BDD53902F29DF314B446CF4D23137A5B,40951,14,20,6,36,49,1849
26915,26915,BDD53902F29DF314B446CF4D23137A5B,10292,22,23,1,30,47,1547
26916,26916,6D411464E8569334C6217011CDDAB47B,10281,0,6,6,33,48,1698
26917,26917,6D411464E8569334C6217011CDDAB47B,12641,8,18,10,10,43,543
26918,26918,6D411464E8569334C6217011CDDAB47B,10281,20,23,3,33,48,1698
26923,26923,7061E3ED80661FEE4EB8EEA7837E523F,10781,0,14,14,35,47,1797
26924,26924,7061E3ED80661FEE4EB8EEA7837E523F,43451,15,16,1,37,40,1890
26925,26925,7061E3ED80661FEE4EB8EEA7837E523F,10781,17,23,6,35,47,1797
26929,26929,3DA0BCC83518894F0CE5D638362ECC1B,43731,0,8,8,34,47,1747
26930,26930,3DA0BCC83518894F0CE5D638362ECC1B,10971,8,12,4,35,47,1797
26931,26931,3DA0BCC83518894F0CE5D638362ECC1B,43731,12,14,2,34,47,1747
26932,26932,3DA0BCC83518894F0CE5D638362ECC1B,10971,14,17,3,35,47,1797
26933,26933,3DA0BCC83518894F0CE5D638362ECC1B,43731,17,18,1,34,47,1747
26934,26934,15BA009B68D87958E0A9656ADB01E7D6,42371,0,9,9,34,46,1746
26935,26935,15BA009B68D87958E0A9656ADB01E7D6,10511,13,18,5,35,46,1796
26936,26936,15BA009B68D87958E0A9656ADB01E7D6,43001,20,21,1,47,47,2397
26937,26937,FCA1EAEE7E44DEF112E09E949BE6A553,19531,0,5,5,17,30,880
26938,26938,FCA1EAEE7E44DEF112E09E949BE6A553,13481,6,9,3,26,31,1331
26939,26939,FCA1EAEE7E44DEF112E09E949BE6A553,19801,11,21,10,19,26,976
26940,26940,FCA1EAEE7E44DEF112E09E949BE6A553,13481,22,23,1,26,31,1331
26945,26945,487A62E76A99728DF0C08197456F9487,41721,0,9,9,39,48,1998
26946,26946,487A62E76A99728DF0C08197456F9487,13481,12,17,5,26,31,1331
26947,26947,487A62E76A99728DF0C08197456F9487,40171,20,23,3,38,48,1948
26948,26948,53B252291F2CAD2164BB97EE14FF9349,13071,1,5,4,41,41,2091
26949,26949,53B252291F2CAD2164BB97EE14FF9349,12561,9,10,1,45,43,2293
26950,26950,53B252291F2CAD2164BB97EE14FF9349,43101,15,16,1,46,40,2340
26951,26951,53B252291F2CAD2164BB97EE14FF9349,13071,18,20,2,41,41,2091
26952,26952,53B252291F2CAD2164BB97EE14FF9349,43101,21,23,2,46,40,2340
26973,26973,D75859C5199E26E4E069299921FEC112,42921,0,6,6,33,47,1697
26974,26974,D75859C5199E26E4E069299921FEC112,43761,7,13,6,32,47,1647
26975,26975,D75859C5199E26E4E069299921FEC112,42921,14,16,2,33,47,1697
26976,26976,D75859C5199E26E4E069299921FEC112,43761,16,18,2,32,47,1647
26977,26977,D75859C5199E26E4E069299921FEC112,42021,18,20,2,33,47,1697
26978,26978,D75859C5199E26E4E069299921FEC112,43761,20,23,3,32,47,1647
26989,26989,A67F948B05FC7E2F067AD14E85A0E030,42011,1,8,7,36,46,1846
26990,26990,A67F948B05FC7E2F067AD14E85A0E030,12521,9,16,7,35,41,1791
26991,26991,A67F948B05FC7E2F067AD14E85A0E030,43241,18,19,1,36,46,1846
26992,26992,A67F948B05FC7E2F067AD14E85A0E030,10251,20,21,1,35,47,1797
26993,26993,A326B4A4D866C138E41D960539966F6C,43041,0,15,15,41,46,2096
26994,26994,A326B4A4D866C138E41D960539966F6C,11381,16,17,1,30,47,1547
26995,26995,A326B4A4D866C138E41D960539966F6C,43041,18,23,5,41,46,2096
27000,27000,C783F573219BE815B78681C436E8AC03,11871,0,7,7,29,46,1496
27001,27001,C783F573219BE815B78681C436E8AC03,12601,8,10,2,25,47,1297
27002,27002,C783F573219BE815B78681C436E8AC03,11871,12,13,1,29,46,1496
27003,27003,C783F573219BE815B78681C436E8AC03,41591,16,17,1,34,49,1749
27004,27004,C783F573219BE815B78681C436E8AC03,11751,18,20,2,35,48,1798
27005,27005,3809DF865AE1A6DDD760F4685D4EB08C,11631,0,6,6,12,49,649
27006,27006,3809DF865AE1A6DDD760F4685D4EB08C,12641,9,19,10,10,43,543
27007,27007,3809DF865AE1A6DDD760F4685D4EB08C,11631,20,21,1,12,49,649
27012,27012,6C0E943C8B3CE3071E466B3888DE833C,42531,6,9,3,31,45,1595
27013,27013,6C0E943C8B3CE3071E466B3888DE833C,12311,13,18,5,30,44,1544
27014,27014,6C0E943C8B3CE3071E466B3888DE833C,19744,19,20,1,6,43,343
27015,27015,793DC4BC4E2928DCDBFB7B36F78CD36B,40637,3,8,5,36,47,1847
27016,27016,793DC4BC4E2928DCDBFB7B36F78CD36B,10231,10,16,6,39,49,1999
27017,27017,793DC4BC4E2928DCDBFB7B36F78CD36B,42161,18,23,5,36,47,1847
27021,27021,EDBEDCDD3729803D79956D4495DD48D8,11261,3,12,9,36,46,1846
27022,27022,EDBEDCDD3729803D79956D4495DD48D8,42864,14,15,1,38,44,1944
27023,27023,EDBEDCDD3729803D79956D4495DD48D8,11261,15,16,1,36,46,1846
27024,27024,EDBEDCDD3729803D79956D4495DD48D8,42864,17,18,1,38,44,1944
27025,27025,EDBEDCDD3729803D79956D4495DD48D8,11261,19,20,1,36,46,1846
27026,27026,9732AAAE01C1D221A25A4D45059565D7,10924,1,12,11,43,49,2199
27027,27027,9732AAAE01C1D221A25A4D45059565D7,13911,12,14,2,39,46,1996
27028,27028,9732AAAE01C1D221A25A4D45059565D7,10924,14,23,9,43,49,2199
27029,27029,946768BFA72752D5660750415178C67F,11131,0,5,5,33,48,1698
27030,27030,946768BFA72752D5660750415178C67F,10251,7,8,1,35,47,1797
27031,27031,946768BFA72752D5660750415178C67F,43731,9,14,5,34,47,1747
27032,27032,946768BFA72752D5660750415178C67F,42161,14,16,2,36,47,1847
27033,27033,946768BFA72752D5660750415178C67F,13601,20,22,2,34,47,1747
27034,27034,6B301C33659FC7DDF1FEBEFD22E1FEA8,42931,0,8,8,41,49,2099
27035,27035,6B301C33659FC7DDF1FEBEFD22E1FEA8,43761,9,11,2,32,47,1647
27036,27036,6B301C33659FC7DDF1FEBEFD22E1FEA8,42931,11,16,5,41,49,2099
27037,27037,6B301C33659FC7DDF1FEBEFD22E1FEA8,43761,17,21,4,32,47,1647
27038,27038,03D6FFA8E0742D0181BD0480CCE1246D,42511,0,7,7,37,47,1897
27039,27039,03D6FFA8E0742D0181BD0480CCE1246D,11271,12,13,1,37,48,1898
27040,27040,03D6FFA8E0742D0181BD0480CCE1246D,11021,14,16,2,36,49,1849
27041,27041,03D6FFA8E0742D0181BD0480CCE1246D,12514,18,19,1,38,47,1947
27042,27042,03D6FFA8E0742D0181BD0480CCE1246D,42511,21,23,2,37,47,1897
27043,27043,3821B66A00758CF4502F36B7CE2D17D9,42381,5,6,1,39,41,1991
27044,27044,3821B66A00758CF4502F36B7CE2D17D9,12491,6,8,2,36,43,1843
27045,27045,3821B66A00758CF4502F36B7CE2D17D9,43451,12,13,1,37,40,1890
27046,27046,3821B66A00758CF4502F36B7CE2D17D9,12491,15,22,7,36,43,1843
27047,27047,3E43826B2F3C90E1974FF5F797EBAA40,42581,1,4,3,38,48,1948
27048,27048,3E43826B2F3C90E1974FF5F797EBAA40,13731,10,11,1,33,49,1699
27049,27049,3E43826B2F3C90E1974FF5F797EBAA40,11914,19,21,2,37,48,1898
27050,27050,3E43826B2F3C90E1974FF5F797EBAA40,42581,22,23,1,38,48,1948
27051,27051,D0E6E806A8EF2CDA9D15AA685B083DE4,42851,0,8,8,35,41,1791
27052,27052,D0E6E806A8EF2CDA9D15AA685B083DE4,13331,12,14,2,38,47,1947
27053,27053,D0E6E806A8EF2CDA9D15AA685B083DE4,43041,15,23,8,41,46,2096
27054,27054,74EBB90FA1C414F58477B49370E7F73F,11861,0,7,7,32,47,1647
27055,27055,74EBB90FA1C414F58477B49370E7F73F,12311,8,17,9,30,44,1544
27056,27056,74EBB90FA1C414F58477B49370E7F73F,11861,18,23,5,32,47,1647
27066,27066,F294DDD245042E94D549E953AEE33CE4,19111,0,6,6,9,45,495
27067,27067,F294DDD245042E94D549E953AEE33CE4,12921,6,11,5,9,41,491
27068,27068,F294DDD245042E94D549E953AEE33CE4,19111,12,13,1,9,45,495
27069,27069,F294DDD245042E94D549E953AEE33CE4,12641,16,18,2,10,43,543
27070,27070,F294DDD245042E94D549E953AEE33CE4,19111,19,23,4,9,45,495
27075,27075,B24D31253C9949139956CC39FFE7E756,40673,0,5,5,36,48,1848
27076,27076,B24D31253C9949139956CC39FFE7E756,11914,5,7,2,37,48,1898
27077,27077,B24D31253C9949139956CC39FFE7E756,11231,8,10,2,37,49,1899
27078,27078,B24D31253C9949139956CC39FFE7E756,11731,15,17,2,36,48,1848
27079,27079,B24D31253C9949139956CC39FFE7E756,11231,18,19,1,37,49,1899
27080,27080,39179060954ADF536A44D5CDC3D7ADA4,11261,3,8,5,36,46,1846
27081,27081,39179060954ADF536A44D5CDC3D7ADA4,13911,8,10,2,39,46,1996
27082,27082,39179060954ADF536A44D5CDC3D7ADA4,11261,10,17,7,36,46,1846
27083,27083,39179060954ADF536A44D5CDC3D7ADA4,10921,21,22,1,43,48,2198
27084,27084,91128F0B7E1DD854B9F41D220D1F9DDF,10901,0,2,2,35,48,1798
27085,27085,91128F0B7E1DD854B9F41D220D1F9DDF,13101,2,13,11,40,47,2047
27086,27086,91128F0B7E1DD854B9F41D220D1F9DDF,11481,14,15,1,41,48,2098
27087,27087,91128F0B7E1DD854B9F41D220D1F9DDF,11781,16,18,2,38,49,1949
27088,27088,91128F0B7E1DD854B9F41D220D1F9DDF,11481,18,23,5,41,48,2098
27089,27089,2AAF43D3E248BC96758C66C2CEB202CD,42531,0,14,14,31,45,1595
27090,27090,2AAF43D3E248BC96758C66C2CEB202CD,40341,15,18,3,23,49,1199
27091,27091,2AAF43D3E248BC96758C66C2CEB202CD,42531,22,23,1,31,45,1595
27092,27092,BA6D45213D52989026A398B5D7995374,43021,1,5,4,16,43,843
27093,27093,BA6D45213D52989026A398B5D7995374,19181,6,7,1,8,40,440
27094,27094,BA6D45213D52989026A398B5D7995374,43644,8,14,6,14,38,738
27095,27095,BA6D45213D52989026A398B5D7995374,19181,15,19,4,8,40,440
27096,27096,BA6D45213D52989026A398B5D7995374,43644,21,23,2,14,38,738
27097,27097,F7EADACA8DDEE0CC3CC7BEFD55463830,11954,0,13,13,32,49,1649
27098,27098,F7EADACA8DDEE0CC3CC7BEFD55463830,11211,13,16,3,34,49,1749
27099,27099,F7EADACA8DDEE0CC3CC7BEFD55463830,42161,17,23,6,36,47,1847
27100,27100,639EA486291B8A87A84D90343A87732A,10451,0,7,7,25,48,1298
27101,27101,639EA486291B8A87A84D90343A87732A,42021,7,9,2,33,47,1697
27102,27102,639EA486291B8A87A84D90343A87732A,13091,12,13,1,20,42,1042
27103,27103,639EA486291B8A87A84D90343A87732A,42523,15,16,1,31,47,1597
27104,27104,639EA486291B8A87A84D90343A87732A,10451,18,20,2,25,48,1298
27105,27105,639EA486291B8A87A84D90343A87732A,11111,22,23,1,26,48,1348
27106,27106,CFB5B91AB0CD7543884ADBE535AD19D6,43021,0,13,13,16,43,843
27107,27107,CFB5B91AB0CD7543884ADBE535AD19D6,12641,14,15,1,10,43,543
27108,27108,CFB5B91AB0CD7543884ADBE535AD19D6,43021,19,20,1,16,43,843
27119,27119,6DFBF28C4BB1FC2BFED5E053C4C14307,43581,0,6,6,33,48,1698
27120,27120,6DFBF28C4BB1FC2BFED5E053C4C14307,11631,7,8,1,12,49,649
27121,27121,6DFBF28C4BB1FC2BFED5E053C4C14307,19441,8,11,3,8,46,446
27122,27122,6DFBF28C4BB1FC2BFED5E053C4C14307,19021,12,13,1,10,45,545
27123,27123,6DFBF28C4BB1FC2BFED5E053C4C14307,10781,16,18,2,35,47,1797
27124,27124,6DFBF28C4BB1FC2BFED5E053C4C14307,43581,19,23,4,33,48,1698
27125,27125,FB5A872D0FAE7AA0035523EB5DBD36C2,11324,0,9,9,31,46,1596
27126,27126,FB5A872D0FAE7AA0035523EB5DBD36C2,43761,10,13,3,32,47,1647
27127,27127,FB5A872D0FAE7AA0035523EB5DBD36C2,11324,14,15,1,31,46,1596
27128,27128,FB5A872D0FAE7AA0035523EB5DBD36C2,43761,15,16,1,32,47,1647
27129,27129,FB5A872D0FAE7AA0035523EB5DBD36C2,11324,17,23,6,31,46,1596
27130,27130,F2091902BA005B733C221C2A68412BCF,43751,3,12,9,19,48,998
27131,27131,F2091902BA005B733C221C2A68412BCF,42691,17,18,1,24,48,1248
27132,27132,F2091902BA005B733C221C2A68412BCF,43751,22,23,1,19,48,998
27133,27133,1B79EB886A5576DB94A20A87F2358771,43751,0,6,6,19,48,998
27134,27134,1B79EB886A5576DB94A20A87F2358771,12581,9,10,1,24,48,1248
27135,27135,1B79EB886A5576DB94A20A87F2358771,43751,11,13,2,19,48,998
27136,27136,1B79EB886A5576DB94A20A87F2358771,42681,18,19,1,24,48,1248
27137,27137,1B79EB886A5576DB94A20A87F2358771,43751,20,23,3,19,48,998
27149,27149,6CA81E446D8D06A02BF3A70A33D72BFD,10691,0,6,6,33,48,1698
27150,27150,6CA81E446D8D06A02BF3A70A33D72BFD,11861,8,10,2,32,47,1647
27151,27151,6CA81E446D8D06A02BF3A70A33D72BFD,42021,13,14,1,33,47,1697
27152,27152,6CA81E446D8D06A02BF3A70A33D72BFD,42491,14,15,1,32,46,1646
27153,27153,6CA81E446D8D06A02BF3A70A33D72BFD,42021,16,18,2,33,47,1697
27154,27154,6CA81E446D8D06A02BF3A70A33D72BFD,10691,19,22,3,33,48,1698
27171,27171,4E22CAE8774A9F064D48507CF8FECB20,11901,0,14,14,42,49,2149
27172,27172,4E22CAE8774A9F064D48507CF8FECB20,11021,17,18,1,36,49,1849
27173,27173,4E22CAE8774A9F064D48507CF8FECB20,11901,21,23,2,42,49,2149
27174,27174,C8E1F9FF4BDCF5DC404825DE8B951E8C,10341,0,6,6,31,47,1597
27175,27175,C8E1F9FF4BDCF5DC404825DE8B951E8C,12521,10,13,3,35,41,1791
27176,27176,C8E1F9FF4BDCF5DC404825DE8B951E8C,42381,14,15,1,39,41,1991
27177,27177,C8E1F9FF4BDCF5DC404825DE8B951E8C,43761,16,17,1,32,47,1647
27178,27178,C8E1F9FF4BDCF5DC404825DE8B951E8C,10107,18,19,1,38,49,1949
27179,27179,2FB9B4671D70EAA841884AE3AD828EC1,13341,0,6,6,44,45,2245
27180,27180,2FB9B4671D70EAA841884AE3AD828EC1,43951,6,8,2,49,41,2491
27181,27181,2FB9B4671D70EAA841884AE3AD828EC1,13341,11,23,12,44,45,2245
27182,27182,98029F333AC5519D4BA1B7A7F8079304,10191,0,6,6,40,48,2048
27183,27183,98029F333AC5519D4BA1B7A7F8079304,19031,7,8,1,1,42,92
27184,27184,98029F333AC5519D4BA1B7A7F8079304,41721,14,23,9,39,48,1998
27185,27185,C6A8E88AF4FAB8E3B900B709C1644500,10411,0,14,14,36,48,1848
27186,27186,C6A8E88AF4FAB8E3B900B709C1644500,42461,15,16,1,45,47,2297
27187,27187,C6A8E88AF4FAB8E3B900B709C1644500,11201,17,23,6,35,49,1799
27203,27203,BCF92C7DFDA1549BE35A1FFC34391226,13111,0,8,8,42,46,2146
27204,27204,BCF92C7DFDA1549BE35A1FFC34391226,13711,10,11,1,38,46,1946
27205,27205,BCF92C7DFDA1549BE35A1FFC34391226,41401,13,14,1,37,46,1896
27206,27206,BCF92C7DFDA1549BE35A1FFC34391226,43041,18,23,5,41,46,2096
27207,27207,3BA5FA710EA7575C057415E520D57C01,40101,0,2,2,34,49,1749
27208,27208,3BA5FA710EA7575C057415E520D57C01,10111,3,8,5,37,47,1897
27209,27209,3BA5FA710EA7575C057415E520D57C01,42161,10,11,1,36,47,1847
27210,27210,3BA5FA710EA7575C057415E520D57C01,10111,11,19,8,37,47,1897
27211,27211,3BA5FA710EA7575C057415E520D57C01,43751,20,23,3,19,48,998
27215,27215,5B38B567B1C7BA8CD66BEFDF9C575D7A,12083,2,13,11,36,49,1849
27216,27216,5B38B567B1C7BA8CD66BEFDF9C575D7A,11231,14,15,1,37,49,1899
27217,27217,5B38B567B1C7BA8CD66BEFDF9C575D7A,11151,16,22,6,30,48,1548
27218,27218,A691A72C2F2583B864130D33125CED6E,10681,0,6,6,30,48,1548
27219,27219,A691A72C2F2583B864130D33125CED6E,11061,7,8,1,29,48,1498
27220,27220,A691A72C2F2583B864130D33125CED6E,10681,8,12,4,30,48,1548
27221,27221,A691A72C2F2583B864130D33125CED6E,11061,13,14,1,29,48,1498
27222,27222,A691A72C2F2583B864130D33125CED6E,10681,17,18,1,30,48,1548
27223,27223,A691A72C2F2583B864130D33125CED6E,11061,21,23,2,29,48,1498
27224,27224,963D3FC841F63E14E513E0B8C4C21628,13121,0,5,5,38,46,1946
27225,27225,963D3FC841F63E14E513E0B8C4C21628,12521,8,10,2,35,41,1791
27226,27226,963D3FC841F63E14E513E0B8C4C21628,12491,12,17,5,36,43,1843
27227,27227,963D3FC841F63E14E513E0B8C4C21628,13121,21,23,2,38,46,1946
27231,27231,8420BC80E057341A3D646D0572754A34,11074,0,6,6,37,47,1897
27232,27232,8420BC80E057341A3D646D0572754A34,42521,10,11,1,31,47,1597
27233,27233,8420BC80E057341A3D646D0572754A34,12921,15,17,2,9,41,491
27234,27234,8420BC80E057341A3D646D0572754A34,49201,18,20,2,7,41,391
27245,27245,E348AAFE4A29289B071092F6D1793503,10371,0,17,17,37,49,1899
27246,27246,E348AAFE4A29289B071092F6D1793503,40341,17,18,1,23,49,1199
27247,27247,E348AAFE4A29289B071092F6D1793503,10371,20,23,3,37,49,1899
27252,27252,C480B777251B620ACAA88D390354CC87,42301,0,15,15,36,47,1847
27253,27253,C480B777251B620ACAA88D390354CC87,10111,15,17,2,37,47,1897
27254,27254,C480B777251B620ACAA88D390354CC87,40341,18,19,1,23,49,1199
27255,27255,C480B777251B620ACAA88D390354CC87,42301,20,21,1,36,47,1847
27256,27256,C480B777251B620ACAA88D390354CC87,10111,22,23,1,37,47,1897
27260,27260,71C7D3BEB879651EE771977BC4EF34E5,10341,0,6,6,31,47,1597
27261,27261,71C7D3BEB879651EE771977BC4EF34E5,12311,6,14,8,30,44,1544
27262,27262,71C7D3BEB879651EE771977BC4EF34E5,10631,15,16,1,28,46,1446
27263,27263,71C7D3BEB879651EE771977BC4EF34E5,10634,16,17,1,27,45,1395
27264,27264,71C7D3BEB879651EE771977BC4EF34E5,10341,20,23,3,31,47,1597
27265,27265,A655C67D52402CE056E16AFA14815F89,13271,0,1,1,41,47,2097
27266,27266,A655C67D52402CE056E16AFA14815F89,11481,3,9,6,41,48,2098
27267,27267,A655C67D52402CE056E16AFA14815F89,13101,10,11,1,40,47,2047
27268,27268,A655C67D52402CE056E16AFA14815F89,11481,12,13,1,41,48,2098
27269,27269,A655C67D52402CE056E16AFA14815F89,13271,13,22,9,41,47,2097
27270,27270,F48E7510533C0694298CD0FB1DB458E2,11324,1,13,12,31,46,1596
27271,27271,F48E7510533C0694298CD0FB1DB458E2,40341,15,18,3,23,49,1199
27272,27272,F48E7510533C0694298CD0FB1DB458E2,11324,19,23,4,31,46,1596
27277,27277,0E0FDED13F5B84BC92F50855B792F158,42221,0,13,13,38,48,1948
27278,27278,0E0FDED13F5B84BC92F50855B792F158,42621,16,17,1,24,49,1249
27279,27279,0E0FDED13F5B84BC92F50855B792F158,42221,21,23,2,38,48,1948
27283,27283,84BFDA5775B1A36CF113618F1669E73C,42521,0,6,6,31,47,1597
27284,27284,84BFDA5775B1A36CF113618F1669E73C,13651,6,8,2,30,47,1547
27285,27285,84BFDA5775B1A36CF113618F1669E73C,42521,11,14,3,31,47,1597
27286,27286,84BFDA5775B1A36CF113618F1669E73C,11381,15,18,3,30,47,1547
27287,27287,84BFDA5775B1A36CF113618F1669E73C,42521,19,23,4,31,47,1597
27292,27292,0EA80F49CAFA9BFC58CF0D20F7967BFF,42871,0,6,6,30,45,1545
27293,27293,0EA80F49CAFA9BFC58CF0D20F7967BFF,12311,7,10,3,30,44,1544
27294,27294,0EA80F49CAFA9BFC58CF0D20F7967BFF,42871,11,13,2,30,45,1545
27295,27295,0EA80F49CAFA9BFC58CF0D20F7967BFF,11381,14,17,3,30,47,1547
27296,27296,0EA80F49CAFA9BFC58CF0D20F7967BFF,42871,18,23,5,30,45,1545
27297,27297,B9FCA1257B3D2CA4CAA3A4B3B2D1FCEB,43581,0,7,7,33,48,1698
27298,27298,B9FCA1257B3D2CA4CAA3A4B3B2D1FCEB,11531,16,17,1,34,49,1749
27299,27299,B9FCA1257B3D2CA4CAA3A4B3B2D1FCEB,42201,18,19,1,43,46,2196
27300,27300,B9FCA1257B3D2CA4CAA3A4B3B2D1FCEB,10221,22,23,1,34,49,1749
27304,27304,C0EC240E36490D1263D83D45770C29BF,42321,0,10,10,43,47,2197
27305,27305,C0EC240E36490D1263D83D45770C29BF,42091,11,13,2,43,46,2196
27306,27306,C0EC240E36490D1263D83D45770C29BF,13941,14,17,3,41,47,2097
27307,27307,C0EC240E36490D1263D83D45770C29BF,42091,18,21,3,43,46,2196
27308,27308,C0EC240E36490D1263D83D45770C29BF,42321,21,23,2,43,47,2197
27309,27309,17DAF69888CAF0D2E4EC5B9B5C6A7A7D,13271,0,1,1,41,47,2097
27310,27310,17DAF69888CAF0D2E4EC5B9B5C6A7A7D,11801,2,8,6,42,48,2148
27311,27311,17DAF69888CAF0D2E4EC5B9B5C6A7A7D,40341,11,12,1,23,49,1199
27312,27312,17DAF69888CAF0D2E4EC5B9B5C6A7A7D,13101,14,15,1,40,47,2047
27313,27313,17DAF69888CAF0D2E4EC5B9B5C6A7A7D,13271,15,18,3,41,47,2097
27314,27314,17DAF69888CAF0D2E4EC5B9B5C6A7A7D,11481,20,21,1,41,48,2098
27318,27318,6DFA48F81EF42083077B44FC80706865,10251,0,9,9,35,47,1797
27319,27319,6DFA48F81EF42083077B44FC80706865,43731,11,14,3,34,47,1747
27320,27320,6DFA48F81EF42083077B44FC80706865,43161,14,16,2,35,47,1797
27321,27321,6DFA48F81EF42083077B44FC80706865,43731,16,17,1,34,47,1747
27322,27322,6DFA48F81EF42083077B44FC80706865,42161,17,19,2,36,47,1847
27323,27323,6DFA48F81EF42083077B44FC80706865,43161,21,23,2,35,47,1797
27324,27324,ECBC886277109C0582E65AB313F27C1C,13314,0,6,6,31,39,1589
27325,27325,ECBC886277109C0582E65AB313F27C1C,42151,10,17,7,35,45,1795
27326,27326,ECBC886277109C0582E65AB313F27C1C,13314,18,22,4,31,39,1589
27327,27327,7EF8399B7744B26431FFE3070C9BD313,19181,2,4,2,8,40,440
27328,27328,7EF8399B7744B26431FFE3070C9BD313,12921,4,8,4,9,41,491
27329,27329,7EF8399B7744B26431FFE3070C9BD313,42041,10,11,1,10,47,547
27330,27330,7EF8399B7744B26431FFE3070C9BD313,19441,12,16,4,8,46,446
27331,27331,7EF8399B7744B26431FFE3070C9BD313,12641,19,20,1,10,43,543
27332,27332,4791E7F4B92A12C67F79536AAA93BED3,10471,0,9,9,37,48,1898
27333,27333,4791E7F4B92A12C67F79536AAA93BED3,43061,9,11,2,43,46,2196
27334,27334,4791E7F4B92A12C67F79536AAA93BED3,10471,13,18,5,37,48,1898
27335,27335,4791E7F4B92A12C67F79536AAA93BED3,10661,18,19,1,37,49,1899
27336,27336,4791E7F4B92A12C67F79536AAA93BED3,10471,20,22,2,37,48,1898
27337,27337,D8DCFF78BA67097F4D9471927F4813FD,43751,0,5,5,19,48,998
27338,27338,D8DCFF78BA67097F4D9471927F4813FD,12581,6,17,11,24,48,1248
27339,27339,D8DCFF78BA67097F4D9471927F4813FD,43751,20,22,2,19,48,998
27340,27340,2F3FBE39EE4E3AB748593134D6A2A772,42231,0,8,8,37,46,1896
27341,27341,2F3FBE39EE4E3AB748593134D6A2A772,42351,10,11,1,38,45,1945
27342,27342,2F3FBE39EE4E3AB748593134D6A2A772,42231,12,14,2,37,46,1896
27343,27343,2F3FBE39EE4E3AB748593134D6A2A772,42351,15,16,1,38,45,1945
27344,27344,2F3FBE39EE4E3AB748593134D6A2A772,42231,21,22,1,37,46,1896
27345,27345,58DD29620A36856900D278AA525EEA23,16281,0,3,3,11,4,554
27346,27346,58DD29620A36856900D278AA525EEA23,15143,5,7,2,18,7,907
27347,27347,58DD29620A36856900D278AA525EEA23,16281,7,14,7,11,4,554
27348,27348,58DD29620A36856900D278AA525EEA23,15143,18,19,1,18,7,907
27349,27349,58DD29620A36856900D278AA525EEA23,16281,20,23,3,11,4,554
27350,27350,3C1FE3D867D28EEDD89D2AE77037BF3E,11211,1,3,2,34,49,1749
27351,27351,3C1FE3D867D28EEDD89D2AE77037BF3E,43581,5,6,1,33,48,1698
27352,27352,3C1FE3D867D28EEDD89D2AE77037BF3E,42351,10,11,1,38,45,1945
27353,27353,3C1FE3D867D28EEDD89D2AE77037BF3E,10161,12,18,6,35,49,1799
27361,27361,2BEF2F1DF9F53E26FBA10E115C641BD7,42151,0,6,6,35,45,1795
27362,27362,2BEF2F1DF9F53E26FBA10E115C641BD7,12661,10,11,1,32,45,1645
27363,27363,2BEF2F1DF9F53E26FBA10E115C641BD7,42151,12,14,2,35,45,1795
27364,27364,2BEF2F1DF9F53E26FBA10E115C641BD7,12661,14,16,2,32,45,1645
27365,27365,2BEF2F1DF9F53E26FBA10E115C641BD7,12311,17,18,1,30,44,1544
27366,27366,119196C18578341D0084AF6B48A62632,11631,0,1,1,12,49,649
27367,27367,119196C18578341D0084AF6B48A62632,43021,5,7,2,16,43,843
27368,27368,119196C18578341D0084AF6B48A62632,19021,7,8,1,10,45,545
27369,27369,119196C18578341D0084AF6B48A62632,11631,11,18,7,12,49,649
27370,27370,119196C18578341D0084AF6B48A62632,42551,19,20,1,14,48,748
27371,27371,119196C18578341D0084AF6B48A62632,11631,22,23,1,12,49,649
27375,27375,05BD882F25219A49EB57A8F905CE344B,43281,0,10,10,37,48,1898
27376,27376,05BD882F25219A49EB57A8F905CE344B,13271,11,12,1,41,47,2097
27377,27377,05BD882F25219A49EB57A8F905CE344B,13481,15,17,2,26,31,1331
27378,27378,05BD882F25219A49EB57A8F905CE344B,13101,18,20,2,40,47,2047
27379,27379,05BD882F25219A49EB57A8F905CE344B,43281,22,23,1,37,48,1898
27383,27383,8022990AE31C9584DEB8AC231685A64C,10341,3,8,5,31,47,1597
27384,27384,8022990AE31C9584DEB8AC231685A64C,42491,12,13,1,32,46,1646
27385,27385,8022990AE31C9584DEB8AC231685A64C,10341,14,16,2,31,47,1597
27386,27386,8022990AE31C9584DEB8AC231685A64C,10292,17,19,2,30,47,1547
27387,27387,8022990AE31C9584DEB8AC231685A64C,10341,21,23,2,31,47,1597
27394,27394,220BB9CC5F3F3413B665192BBE457CBF,10781,0,14,14,35,47,1797
27395,27395,220BB9CC5F3F3413B665192BBE457CBF,42981,15,17,2,36,49,1849
27396,27396,220BB9CC5F3F3413B665192BBE457CBF,11874,18,22,4,29,46,1496
27397,27397,59BD966FE7595E6B73F7A7CC1B56DA5C,19114,0,2,2,7,43,393
27398,27398,59BD966FE7595E6B73F7A7CC1B56DA5C,12514,3,16,13,38,47,1947
27399,27399,59BD966FE7595E6B73F7A7CC1B56DA5C,42041,18,19,1,10,47,547
27400,27400,59BD966FE7595E6B73F7A7CC1B56DA5C,12514,19,23,4,38,47,1947
27401,27401,F4A5CE128B0276BA64A57CF9F5D60F74,42831,0,14,14,27,48,1398
27402,27402,F4A5CE128B0276BA64A57CF9F5D60F74,11021,17,18,1,36,49,1849
27403,27403,F4A5CE128B0276BA64A57CF9F5D60F74,42831,21,23,2,27,48,1398
27404,27404,D5E9BDC8FA219234703CDBDA1084CD0E,43581,0,6,6,33,48,1698
27405,27405,D5E9BDC8FA219234703CDBDA1084CD0E,42941,9,12,3,37,47,1897
27406,27406,D5E9BDC8FA219234703CDBDA1084CD0E,43731,15,16,1,34,47,1747
27407,27407,D5E9BDC8FA219234703CDBDA1084CD0E,12031,19,23,4,33,48,1698
27414,27414,A7B47D86EDC54D750D3985FD16D6CF0C,43951,1,6,5,49,41,2491
27415,27415,A7B47D86EDC54D750D3985FD16D6CF0C,43101,9,10,1,46,40,2340
27416,27416,A7B47D86EDC54D750D3985FD16D6CF0C,12311,14,15,1,30,44,1544
27417,27417,A7B47D86EDC54D750D3985FD16D6CF0C,43951,17,18,1,49,41,2491
27418,27418,09B258FCC1A04CEAAFFB93000EF42A6F,10811,0,6,6,38,46,1946
27419,27419,09B258FCC1A04CEAAFFB93000EF42A6F,11074,7,8,1,37,47,1897
27420,27420,09B258FCC1A04CEAAFFB93000EF42A6F,10811,11,13,2,38,46,1946
27421,27421,09B258FCC1A04CEAAFFB93000EF42A6F,10601,13,18,5,39,47,1997
27422,27422,09B258FCC1A04CEAAFFB93000EF42A6F,13231,22,23,1,39,46,1996
27423,27423,C5ED324891B8B95E257970408E8D4150,12491,0,6,6,36,43,1843
27424,27424,C5ED324891B8B95E257970408E8D4150,13911,8,9,1,39,46,1996
27425,27425,C5ED324891B8B95E257970408E8D4150,11261,9,15,6,36,46,1846
27426,27426,C5ED324891B8B95E257970408E8D4150,12211,15,16,1,41,44,2094
27427,27427,C5ED324891B8B95E257970408E8D4150,11261,17,19,2,36,46,1846
27432,27432,F681B79833B44C7DE260E9A55ED030A3,19741,0,6,6,5,44,294
27433,27433,F681B79833B44C7DE260E9A55ED030A3,19111,7,8,1,9,45,495
27434,27434,F681B79833B44C7DE260E9A55ED030A3,12921,9,11,2,9,41,491
27435,27435,F681B79833B44C7DE260E9A55ED030A3,19741,12,13,1,5,44,294
27436,27436,F681B79833B44C7DE260E9A55ED030A3,12921,14,15,1,9,41,491
27437,27437,F681B79833B44C7DE260E9A55ED030A3,19111,16,17,1,9,45,495
27438,27438,F681B79833B44C7DE260E9A55ED030A3,12921,17,19,2,9,41,491
27439,27439,F681B79833B44C7DE260E9A55ED030A3,19741,20,23,3,5,44,294
27443,27443,7D40FDA16D9F775EEBE4F7D8E79E845C,42521,1,9,8,31,47,1597
27444,27444,7D40FDA16D9F775EEBE4F7D8E79E845C,43761,13,15,2,32,47,1647
27445,27445,7D40FDA16D9F775EEBE4F7D8E79E845C,10511,19,20,1,35,46,1796
27446,27446,7D40FDA16D9F775EEBE4F7D8E79E845C,10251,21,23,2,35,47,1797
27450,27450,4560AA6E9FF5488D13E472C26129D09F,42511,1,6,5,37,47,1897
27451,27451,4560AA6E9FF5488D13E472C26129D09F,40123,9,10,1,38,47,1947
27452,27452,4560AA6E9FF5488D13E472C26129D09F,10841,11,13,2,37,47,1897
27453,27453,4560AA6E9FF5488D13E472C26129D09F,12514,13,15,2,38,47,1947
27454,27454,4560AA6E9FF5488D13E472C26129D09F,12511,17,18,1,39,47,1997
27455,27455,4560AA6E9FF5488D13E472C26129D09F,42511,19,21,2,37,47,1897
27456,27456,4560AA6E9FF5488D13E472C26129D09F,42301,22,23,1,36,47,1847
27466,27466,80D714670E3DCDC08BB414C5D3B58641,11641,0,7,7,22,49,1149
27467,27467,80D714670E3DCDC08BB414C5D3B58641,42081,11,12,1,24,49,1249
27468,27468,80D714670E3DCDC08BB414C5D3B58641,11641,12,13,1,22,49,1149
27469,27469,80D714670E3DCDC08BB414C5D3B58641,12381,14,23,9,32,48,1648
27470,27470,CF7D34E0CAAC53341408143F5EE5A475,10841,0,5,5,37,47,1897
27471,27471,CF7D34E0CAAC53341408143F5EE5A475,11381,7,8,1,30,47,1547
27472,27472,CF7D34E0CAAC53341408143F5EE5A475,10951,10,23,13,29,48,1498
27477,27477,9D5FAD2D946916458AB09D98B7F6CB85,11641,0,2,2,22,49,1149
27478,27478,9D5FAD2D946916458AB09D98B7F6CB85,42621,2,3,1,24,49,1249
27479,27479,9D5FAD2D946916458AB09D98B7F6CB85,11641,3,4,1,22,49,1149
27480,27480,9D5FAD2D946916458AB09D98B7F6CB85,42081,4,5,1,24,49,1249
27481,27481,9D5FAD2D946916458AB09D98B7F6CB85,11641,5,6,1,22,49,1149
27482,27482,9D5FAD2D946916458AB09D98B7F6CB85,42621,12,14,2,24,49,1249
27483,27483,9D5FAD2D946916458AB09D98B7F6CB85,11641,14,22,8,22,49,1149
27488,27488,3754E5DEC750B3FDF263838F0A83F5E2,42623,0,4,4,22,49,1149
27489,27489,3754E5DEC750B3FDF263838F0A83F5E2,42081,4,14,10,24,49,1249
27490,27490,3754E5DEC750B3FDF263838F0A83F5E2,42021,18,21,3,33,47,1697
27499,27499,8AEC3F43D5D83F5BD682D6C5D7D41196,42331,0,11,11,39,46,1996
27500,27500,8AEC3F43D5D83F5BD682D6C5D7D41196,13941,11,12,1,41,47,2097
27501,27501,8AEC3F43D5D83F5BD682D6C5D7D41196,40951,14,16,2,36,49,1849
27502,27502,8AEC3F43D5D83F5BD682D6C5D7D41196,11541,18,20,2,35,49,1799
27503,27503,8AEC3F43D5D83F5BD682D6C5D7D41196,40401,21,23,2,40,46,2046
27504,27504,B671273BF5D0429E749B3B0F044C7639,43751,0,7,7,19,48,998
27505,27505,B671273BF5D0429E749B3B0F044C7639,42681,7,8,1,24,48,1248
27506,27506,B671273BF5D0429E749B3B0F044C7639,43751,11,23,12,19,48,998
27510,27510,46BBCC9273D590273033A9E7C369AF84,11104,0,5,5,17,47,897
27511,27511,46BBCC9273D590273033A9E7C369AF84,12311,7,10,3,30,44,1544
27512,27512,46BBCC9273D590273033A9E7C369AF84,11104,10,23,13,17,47,897
27513,27513,6B614428F8D95ECFDE2207017437E97D,12871,10,14,4,22,33,1133
27514,27514,6B614428F8D95ECFDE2207017437E97D,19281,14,16,2,16,32,832
27515,27515,6B614428F8D95ECFDE2207017437E97D,12871,19,21,2,22,33,1133
27516,27516,6B614428F8D95ECFDE2207017437E97D,19281,21,23,2,16,32,832
27517,27517,2D07E09A52A0E5B59EF4ED787502C02A,11806,5,6,1,41,48,2098
27518,27518,2D07E09A52A0E5B59EF4ED787502C02A,42271,9,11,2,40,47,2047
27519,27519,2D07E09A52A0E5B59EF4ED787502C02A,10651,13,15,2,36,49,1849
27520,27520,2D07E09A52A0E5B59EF4ED787502C02A,42021,19,21,2,33,47,1697
27521,27521,2873DE93703B028193B7B9719DCFE691,12521,0,6,6,35,41,1791
27522,27522,2873DE93703B028193B7B9719DCFE691,43451,9,10,1,37,40,1890
27523,27523,2873DE93703B028193B7B9719DCFE691,12521,11,13,2,35,41,1791
27524,27524,2873DE93703B028193B7B9719DCFE691,43451,14,16,2,37,40,1890
27525,27525,2873DE93703B028193B7B9719DCFE691,12521,18,23,5,35,41,1791
27536,27536,0513D4A0850C5AAFBF193D222DECEC20,12311,0,5,5,30,44,1544
27537,27537,0513D4A0850C5AAFBF193D222DECEC20,11381,9,10,1,30,47,1547
27538,27538,0513D4A0850C5AAFBF193D222DECEC20,13671,12,14,2,27,43,1393
27539,27539,0513D4A0850C5AAFBF193D222DECEC20,10711,20,21,1,29,46,1496
27540,27540,0513D4A0850C5AAFBF193D222DECEC20,12311,22,23,1,30,44,1544
27545,27545,F3045CC1C5922EA9E51F158FC63C4145,11941,0,13,13,37,46,1896
27546,27546,F3045CC1C5922EA9E51F158FC63C4145,42523,15,17,2,31,47,1597
27547,27547,F3045CC1C5922EA9E51F158FC63C4145,40636,21,23,2,35,48,1798
27552,27552,48F425EFC007ADE1D852387A656C298E,10151,0,12,12,34,47,1747
27553,27553,48F425EFC007ADE1D852387A656C298E,42864,14,15,1,38,44,1944
27554,27554,48F425EFC007ADE1D852387A656C298E,10841,18,20,2,37,47,1897
27555,27555,15AF53FBA0C13FBD61024895398ED2FD,11471,0,1,1,12,48,648
27556,27556,15AF53FBA0C13FBD61024895398ED2FD,19441,2,14,12,8,46,446
27557,27557,15AF53FBA0C13FBD61024895398ED2FD,42041,14,15,1,10,47,547
27558,27558,15AF53FBA0C13FBD61024895398ED2FD,19441,17,21,4,8,46,446
27562,27562,804B7737707030C63DF2E4BD94DF220F,42971,0,9,9,43,49,2199
27563,27563,804B7737707030C63DF2E4BD94DF220F,42271,10,11,1,40,47,2047
27564,27564,804B7737707030C63DF2E4BD94DF220F,11806,15,22,7,41,48,2098
27568,27568,6AD981E757B177FB5B64F1D1D2EAA27F,42961,0,3,3,35,49,1799
27569,27569,6AD981E757B177FB5B64F1D1D2EAA27F,12651,4,8,4,43,47,2197
27570,27570,6AD981E757B177FB5B64F1D1D2EAA27F,10901,18,20,2,35,48,1798
27577,27577,AB3BB6994E8D7661CC3917FB33952C7D,42491,0,2,2,32,46,1646
27578,27578,AB3BB6994E8D7661CC3917FB33952C7D,10292,3,4,1,30,47,1547
27579,27579,AB3BB6994E8D7661CC3917FB33952C7D,42523,5,11,6,31,47,1597
27580,27580,AB3BB6994E8D7661CC3917FB33952C7D,15304,15,16,1,39,17,1967
27581,27581,AB3BB6994E8D7661CC3917FB33952C7D,15571,19,22,3,37,19,1869
27588,27588,DC15358175A492C6F21AAEFAD4CD0BB7,42401,0,10,10,36,47,1847
27589,27589,DC15358175A492C6F21AAEFAD4CD0BB7,42521,10,17,7,31,47,1597
27590,27590,DC15358175A492C6F21AAEFAD4CD0BB7,42161,18,22,4,36,47,1847
27601,27601,7D71FD39BDECB664B66339BA30BE7454,11381,0,13,13,30,47,1547
27602,27602,7D71FD39BDECB664B66339BA30BE7454,40341,14,17,3,23,49,1199
27603,27603,7D71FD39BDECB664B66339BA30BE7454,11381,17,23,6,30,47,1547
27604,27604,662B4DE10B5E46302328673CD9C61795,10111,0,7,7,37,47,1897
27605,27605,662B4DE10B5E46302328673CD9C61795,11491,8,11,3,36,47,1847
27606,27606,662B4DE10B5E46302328673CD9C61795,10841,12,13,1,37,47,1897
27607,27607,662B4DE10B5E46302328673CD9C61795,11491,13,18,5,36,47,1847
27608,27608,662B4DE10B5E46302328673CD9C61795,10841,19,23,4,37,47,1897
27609,27609,C247820FF94535A6E7B0AE8ABDC5672D,13341,2,3,1,44,45,2245
27610,27610,C247820FF94535A6E7B0AE8ABDC5672D,12221,5,11,6,43,44,2194
27611,27611,C247820FF94535A6E7B0AE8ABDC5672D,11001,15,17,2,42,47,2147
27612,27612,C247820FF94535A6E7B0AE8ABDC5672D,13371,21,23,2,41,47,2097
27617,27617,CB5B6B98973636834396900860590D74,42921,0,6,6,33,47,1697
27618,27618,CB5B6B98973636834396900860590D74,42461,8,10,2,45,47,2297
27619,27619,CB5B6B98973636834396900860590D74,42091,10,11,1,43,46,2196
27620,27620,CB5B6B98973636834396900860590D74,42921,14,23,9,33,47,1697
27621,27621,AF57FD742700B6DD506E3D60F4DB6DD5,13471,0,8,8,47,49,2399
27622,27622,AF57FD742700B6DD506E3D60F4DB6DD5,13101,8,11,3,40,47,2047
27623,27623,AF57FD742700B6DD506E3D60F4DB6DD5,13471,12,14,2,47,49,2399
27624,27624,AF57FD742700B6DD506E3D60F4DB6DD5,11481,14,16,2,41,48,2098
27625,27625,AF57FD742700B6DD506E3D60F4DB6DD5,10801,18,20,2,42,47,2147
27634,27634,BB35601A464DE0CE8B68A3DB3D94C0D5,10331,0,9,9,39,46,1996
27635,27635,BB35601A464DE0CE8B68A3DB3D94C0D5,11381,10,15,5,30,47,1547
27636,27636,BB35601A464DE0CE8B68A3DB3D94C0D5,12021,20,21,1,37,49,1899
27661,27661,64F7708569C57ADADD849C5521367AD5,40302,0,8,8,40,49,2049
27662,27662,64F7708569C57ADADD849C5521367AD5,13511,9,13,4,34,48,1748
27663,27663,64F7708569C57ADADD849C5521367AD5,10292,16,17,1,30,47,1547
27664,27664,64F7708569C57ADADD849C5521367AD5,40302,19,23,4,40,49,2049
27665,27665,6F712976E0E790786B4CAFA7504F8275,19281,9,10,1,16,32,832
27666,27666,6F712976E0E790786B4CAFA7504F8275,13371,15,17,2,41,47,2097
27667,27667,6F712976E0E790786B4CAFA7504F8275,19281,21,22,1,16,32,832
27668,27668,71CDB42BF8ABF4C8B89BDC81F92C39B7,10634,0,6,6,27,45,1395
27669,27669,71CDB42BF8ABF4C8B89BDC81F92C39B7,12601,6,11,5,25,47,1297
27670,27670,71CDB42BF8ABF4C8B89BDC81F92C39B7,10634,12,13,1,27,45,1395
27671,27671,71CDB42BF8ABF4C8B89BDC81F92C39B7,12601,14,15,1,25,47,1297
27672,27672,71CDB42BF8ABF4C8B89BDC81F92C39B7,10634,20,23,3,27,45,1395
27673,27673,F9BB7DF37B85A58B4DA3F92DEFB1BE52,10721,0,7,7,31,48,1598
27674,27674,F9BB7DF37B85A58B4DA3F92DEFB1BE52,12021,8,10,2,37,49,1899
27675,27675,F9BB7DF37B85A58B4DA3F92DEFB1BE52,10721,12,14,2,31,48,1598
27676,27676,F9BB7DF37B85A58B4DA3F92DEFB1BE52,11551,18,22,4,39,49,1999
27677,27677,4798658570B4C475A1526DA6007BD6A8,41392,0,2,2,43,48,2198
27678,27678,4798658570B4C475A1526DA6007BD6A8,42633,3,8,5,42,46,2146
27679,27679,4798658570B4C475A1526DA6007BD6A8,11074,11,16,5,37,47,1897
27680,27680,4798658570B4C475A1526DA6007BD6A8,10921,21,23,2,43,48,2198
27684,27684,5E8BB1A9FDE1AFD08848003FB8A60E0E,40673,0,8,8,36,48,1848
27685,27685,5E8BB1A9FDE1AFD08848003FB8A60E0E,43731,9,11,2,34,47,1747
27686,27686,5E8BB1A9FDE1AFD08848003FB8A60E0E,40673,12,13,1,36,48,1848
27687,27687,5E8BB1A9FDE1AFD08848003FB8A60E0E,43731,14,19,5,34,47,1747
27688,27688,5E8BB1A9FDE1AFD08848003FB8A60E0E,40673,20,23,3,36,48,1848
27689,27689,2648C45FE5CC239A366DE45F7AAB1FCB,11261,1,2,1,36,46,1846
27690,27690,2648C45FE5CC239A366DE45F7AAB1FCB,13911,3,4,1,39,46,1996
27691,27691,2648C45FE5CC239A366DE45F7AAB1FCB,11261,8,9,1,36,46,1846
27692,27692,2648C45FE5CC239A366DE45F7AAB1FCB,42864,12,13,1,38,44,1944
27693,27693,2648C45FE5CC239A366DE45F7AAB1FCB,13911,17,19,2,39,46,1996
27694,27694,2648C45FE5CC239A366DE45F7AAB1FCB,42351,21,22,1,38,45,1945
27695,27695,047FBC3C7DA02121732A5E848C316210,42971,0,8,8,43,49,2199
27696,27696,047FBC3C7DA02121732A5E848C316210,12514,12,13,1,38,47,1947
27697,27697,047FBC3C7DA02121732A5E848C316210,11031,16,18,2,42,49,2149
27701,27701,DE2A7336F28277C76BFE77D331615896,13911,0,7,7,39,46,1996
27702,27702,DE2A7336F28277C76BFE77D331615896,42461,9,10,1,45,47,2297
27703,27703,DE2A7336F28277C76BFE77D331615896,42091,10,11,1,43,46,2196
27704,27704,DE2A7336F28277C76BFE77D331615896,42461,15,18,3,45,47,2297
27705,27705,DE2A7336F28277C76BFE77D331615896,13911,19,23,4,39,46,1996
27709,27709,1A71FA18AA428C4DDAD1FCB8BD6DCCEA,13511,0,1,1,34,48,1748
27710,27710,1A71FA18AA428C4DDAD1FCB8BD6DCCEA,11806,2,5,3,41,48,2098
27711,27711,1A71FA18AA428C4DDAD1FCB8BD6DCCEA,42281,8,23,15,40,48,2048
27712,27712,01885FDCC1DF913B6C947811B80025B1,12671,0,6,6,21,43,1093
27713,27713,01885FDCC1DF913B6C947811B80025B1,12581,7,12,5,24,48,1248
27714,27714,01885FDCC1DF913B6C947811B80025B1,12641,14,16,2,10,43,543
27715,27715,01885FDCC1DF913B6C947811B80025B1,10061,20,21,1,20,46,1046
27716,27716,6AD802B611D26308C5A2EA16422CE33C,13314,0,16,16,31,39,1589
27717,27717,6AD802B611D26308C5A2EA16422CE33C,12521,16,17,1,35,41,1791
27718,27718,6AD802B611D26308C5A2EA16422CE33C,40341,19,22,3,23,49,1199
27719,27719,7BD5666208D4C4EF90CAAD8A97E6ED7C,12491,4,7,3,36,43,1843
27720,27720,7BD5666208D4C4EF90CAAD8A97E6ED7C,42151,8,10,2,35,45,1795
27721,27721,7BD5666208D4C4EF90CAAD8A97E6ED7C,12491,12,14,2,36,43,1843
27722,27722,7BD5666208D4C4EF90CAAD8A97E6ED7C,42151,15,17,2,35,45,1795
27723,27723,7BD5666208D4C4EF90CAAD8A97E6ED7C,11834,21,23,2,32,45,1645
27724,27724,50897C798DD981F790935635A0EC3137,12601,0,6,6,25,47,1297
27725,27725,50897C798DD981F790935635A0EC3137,10501,10,11,1,22,46,1146
27726,27726,50897C798DD981F790935635A0EC3137,12601,14,16,2,25,47,1297
27727,27727,50897C798DD981F790935635A0EC3137,10501,16,17,1,22,46,1146
27728,27728,50897C798DD981F790935635A0EC3137,12601,19,22,3,25,47,1297
27733,27733,3E92B936E30464D11A87159A7D122C74,10691,0,8,8,33,48,1698
27734,27734,3E92B936E30464D11A87159A7D122C74,10841,8,9,1,37,47,1897
27735,27735,3E92B936E30464D11A87159A7D122C74,10691,12,23,11,33,48,1698
27736,27736,4FB7544A1E67AE742452DB3735E5F7CF,10771,0,6,6,41,46,2096
27737,27737,4FB7544A1E67AE742452DB3735E5F7CF,12221,7,8,1,43,44,2194
27738,27738,4FB7544A1E67AE742452DB3735E5F7CF,12561,10,11,1,45,43,2293
27739,27739,4FB7544A1E67AE742452DB3735E5F7CF,43011,14,16,2,40,42,2042
27740,27740,4FB7544A1E67AE742452DB3735E5F7CF,10771,18,23,5,41,46,2096
27741,27741,D3E10CE72D4AD84FD9BC70DA697D3C48,19441,1,9,8,8,46,446
27742,27742,D3E10CE72D4AD84FD9BC70DA697D3C48,43021,12,14,2,16,43,843
27743,27743,D3E10CE72D4AD84FD9BC70DA697D3C48,19021,14,22,8,10,45,545
27751,27751,F79F71E4EFD3DF9759F759D2C27E499D,10681,0,15,15,30,48,1548
27752,27752,F79F71E4EFD3DF9759F759D2C27E499D,40341,15,17,2,23,49,1199
27753,27753,F79F71E4EFD3DF9759F759D2C27E499D,10681,18,21,3,30,48,1548
27754,27754,44CFFC276A65F95BE03A7F0CD0EA65D0,43761,1,7,6,32,47,1647
27755,27755,44CFFC276A65F95BE03A7F0CD0EA65D0,10371,8,20,12,37,49,1899
27756,27756,44CFFC276A65F95BE03A7F0CD0EA65D0,42141,21,23,2,32,47,1647
27757,27757,0FCC9992AE8D71AAE404BB0E597A281E,11861,0,5,5,32,47,1647
27758,27758,0FCC9992AE8D71AAE404BB0E597A281E,11201,6,12,6,35,49,1799
27759,27759,0FCC9992AE8D71AAE404BB0E597A281E,10221,13,18,5,34,49,1749
27760,27760,0FCC9992AE8D71AAE404BB0E597A281E,11861,19,23,4,32,47,1647
27765,27765,8C93E9687A717AEFB87364B357E16B82,13511,0,1,1,34,48,1748
27766,27766,8C93E9687A717AEFB87364B357E16B82,10601,3,8,5,39,47,1997
27767,27767,8C93E9687A717AEFB87364B357E16B82,43341,9,10,1,41,46,2096
27768,27768,8C93E9687A717AEFB87364B357E16B82,13371,12,23,11,41,47,2097
27769,27769,DAD4C4CCB9D717CA848AB20853599079,42523,1,7,6,31,47,1597
27770,27770,DAD4C4CCB9D717CA848AB20853599079,11151,8,11,3,30,48,1548
27771,27771,DAD4C4CCB9D717CA848AB20853599079,10295,12,14,2,30,47,1547
27772,27772,DAD4C4CCB9D717CA848AB20853599079,12051,16,18,2,20,47,1047
27773,27773,DAD4C4CCB9D717CA848AB20853599079,42521,21,23,2,31,47,1597
27774,27774,B1399D45A878B64B2B5DD9137A4D2E43,13911,0,7,7,39,46,1996
27775,27775,B1399D45A878B64B2B5DD9137A4D2E43,10841,8,10,2,37,47,1897
27776,27776,B1399D45A878B64B2B5DD9137A4D2E43,12161,10,12,2,32,46,1646
27777,27777,B1399D45A878B64B2B5DD9137A4D2E43,10221,12,14,2,34,49,1749
27778,27778,B1399D45A878B64B2B5DD9137A4D2E43,12161,14,17,3,32,46,1646
27779,27779,B1399D45A878B64B2B5DD9137A4D2E43,13911,17,23,6,39,46,1996
27787,27787,5FF9CE460A753808614E5114D88F66EB,40801,0,7,7,43,46,2196
27788,27788,5FF9CE460A753808614E5114D88F66EB,10841,8,11,3,37,47,1897
27789,27789,5FF9CE460A753808614E5114D88F66EB,40801,11,23,12,43,46,2196
27794,27794,D0432960E92A76D460F2119582FA4286,13711,0,1,1,38,46,1946
27795,27795,D0432960E92A76D460F2119582FA4286,11731,2,11,9,36,48,1848
27796,27796,D0432960E92A76D460F2119582FA4286,10107,12,13,1,38,49,1949
27797,27797,D0432960E92A76D460F2119582FA4286,40691,17,18,1,42,48,2148
27806,27806,AB35C432DC3D59E7929F031635A675AA,12601,3,14,11,25,47,1297
27807,27807,AB35C432DC3D59E7929F031635A675AA,10061,14,16,2,20,46,1046
27808,27808,AB35C432DC3D59E7929F031635A675AA,12601,19,20,1,25,47,1297
27820,27820,F8320AC02FAC6F4A311CBF8892D02227,13251,0,9,9,48,28,2428
27821,27821,F8320AC02FAC6F4A311CBF8892D02227,15411,11,13,2,44,27,2227
27822,27822,F8320AC02FAC6F4A311CBF8892D02227,13251,17,20,3,48,28,2428
27836,27836,A4FB037706170157DA9B94939FEE9474,11001,0,9,9,42,47,2147
27837,27837,A4FB037706170157DA9B94939FEE9474,10841,10,12,2,37,47,1897
27838,27838,A4FB037706170157DA9B94939FEE9474,12514,13,20,7,38,47,1947
27839,27839,A4FB037706170157DA9B94939FEE9474,13941,22,23,1,41,47,2097
27843,27843,129F81D7C5B1F26EBD43236D3A3893F5,11741,1,9,8,42,49,2149
27844,27844,129F81D7C5B1F26EBD43236D3A3893F5,12601,13,15,2,25,47,1297
27845,27845,129F81D7C5B1F26EBD43236D3A3893F5,10061,15,17,2,20,46,1046
27846,27846,129F81D7C5B1F26EBD43236D3A3893F5,10731,18,19,1,33,47,1697
27847,27847,129F81D7C5B1F26EBD43236D3A3893F5,10621,20,22,2,41,49,2099
27848,27848,DC9866094212A637CCAC17CF01FE4B5F,42861,0,6,6,37,44,1894
27849,27849,DC9866094212A637CCAC17CF01FE4B5F,11261,6,11,5,36,46,1846
27850,27850,DC9866094212A637CCAC17CF01FE4B5F,13911,11,13,2,39,46,1996
27851,27851,DC9866094212A637CCAC17CF01FE4B5F,11261,15,17,2,36,46,1846
27852,27852,DC9866094212A637CCAC17CF01FE4B5F,42861,19,23,4,37,44,1894
27860,27860,ADA4A0694EC851291BBE6D1AE8EAB630,42201,0,6,6,43,46,2196
27861,27861,ADA4A0694EC851291BBE6D1AE8EAB630,19111,10,20,10,9,45,495
27862,27862,ADA4A0694EC851291BBE6D1AE8EAB630,42201,21,22,1,43,46,2196
27863,27863,024AB2D90319DF57F94996854D076E3D,42471,0,1,1,35,49,1799
27864,27864,024AB2D90319DF57F94996854D076E3D,13271,2,10,8,41,47,2097
27865,27865,024AB2D90319DF57F94996854D076E3D,42501,13,14,1,28,47,1447
27866,27866,024AB2D90319DF57F94996854D076E3D,42864,16,17,1,38,44,1944
27867,27867,024AB2D90319DF57F94996854D076E3D,42501,19,21,2,28,47,1447
27868,27868,024AB2D90319DF57F94996854D076E3D,40833,22,23,1,41,47,2097
27880,27880,A01E473EBE490C9947593A3FF8F54760,11021,0,10,10,36,49,1849
27881,27881,A01E473EBE490C9947593A3FF8F54760,42381,11,13,2,39,41,1991
27882,27882,A01E473EBE490C9947593A3FF8F54760,11021,21,23,2,36,49,1849
27896,27896,0FF23BFDB55A76F1FEA2FEA8A42CA80D,11381,0,5,5,30,47,1547
27897,27897,0FF23BFDB55A76F1FEA2FEA8A42CA80D,11061,6,8,2,29,48,1498
27898,27898,0FF23BFDB55A76F1FEA2FEA8A42CA80D,11381,12,13,1,30,47,1547
27899,27899,0FF23BFDB55A76F1FEA2FEA8A42CA80D,11061,14,21,7,29,48,1498
27900,27900,0FF23BFDB55A76F1FEA2FEA8A42CA80D,11381,22,23,1,30,47,1547
27904,27904,4A1E2DF13E9399DEAE7966E1EFE6FC6B,13271,0,4,4,41,47,2097
27905,27905,4A1E2DF13E9399DEAE7966E1EFE6FC6B,11091,5,10,5,29,47,1497
27906,27906,4A1E2DF13E9399DEAE7966E1EFE6FC6B,42151,11,20,9,35,45,1795
27907,27907,4A1E2DF13E9399DEAE7966E1EFE6FC6B,11481,20,21,1,41,48,2098
27908,27908,82B9DE1C452C89862B559CE0DF4F04BF,16281,0,1,1,11,4,554
27909,27909,82B9DE1C452C89862B559CE0DF4F04BF,15051,6,21,15,19,4,954
27910,27910,82B9DE1C452C89862B559CE0DF4F04BF,16281,22,23,1,11,4,554
27911,27911,8CC8B8C8F8D80276B3550F8C8D5ED9D3,12021,0,15,15,37,49,1899
27912,27912,8CC8B8C8F8D80276B3550F8C8D5ED9D3,40341,15,20,5,23,49,1199
27913,27913,8CC8B8C8F8D80276B3550F8C8D5ED9D3,12481,21,23,2,37,49,1899
27914,27914,66A1757BF5A4116BA4BCC483D90F56EF,42231,0,7,7,37,46,1896
27915,27915,66A1757BF5A4116BA4BCC483D90F56EF,42351,10,11,1,38,45,1945
27916,27916,66A1757BF5A4116BA4BCC483D90F56EF,42231,11,13,2,37,46,1896
27917,27917,66A1757BF5A4116BA4BCC483D90F56EF,13911,14,15,1,39,46,1996
27918,27918,66A1757BF5A4116BA4BCC483D90F56EF,40341,19,20,1,23,49,1199
27922,27922,6C496D77B29C0E07DD8CA6E71E452ED0,10681,0,16,16,30,48,1548
27923,27923,6C496D77B29C0E07DD8CA6E71E452ED0,40341,17,18,1,23,49,1199
27924,27924,6C496D77B29C0E07DD8CA6E71E452ED0,10681,20,23,3,30,48,1548
27925,27925,EBE74CAA370851CCC599E73574A1082B,42221,3,4,1,38,48,1948
27926,27926,EBE74CAA370851CCC599E73574A1082B,11074,5,7,2,37,47,1897
27927,27927,EBE74CAA370851CCC599E73574A1082B,42221,7,10,3,38,48,1948
27928,27928,EBE74CAA370851CCC599E73574A1082B,11074,11,12,1,37,47,1897
27929,27929,EBE74CAA370851CCC599E73574A1082B,42221,12,16,4,38,48,1948
27930,27930,EBE74CAA370851CCC599E73574A1082B,11074,16,22,6,37,47,1897
27931,27931,00ED2280FB2BEC22D8FB36F8A7AFB1A5,42791,0,8,8,35,45,1795
27932,27932,00ED2280FB2BEC22D8FB36F8A7AFB1A5,13121,9,12,3,38,46,1946
27933,27933,00ED2280FB2BEC22D8FB36F8A7AFB1A5,10271,13,15,2,37,46,1896
27934,27934,00ED2280FB2BEC22D8FB36F8A7AFB1A5,13121,15,17,2,38,46,1946
27935,27935,00ED2280FB2BEC22D8FB36F8A7AFB1A5,42791,19,20,1,35,45,1795
27936,27936,00ED2280FB2BEC22D8FB36F8A7AFB1A5,10841,21,23,2,37,47,1897
27940,27940,F9B50F8C0BC548F341BD45D3142A9731,11461,0,4,4,37,49,1899
27941,27941,F9B50F8C0BC548F341BD45D3142A9731,13041,8,9,1,30,37,1537
27942,27942,F9B50F8C0BC548F341BD45D3142A9731,10901,12,14,2,35,48,1798
27943,27943,F9B50F8C0BC548F341BD45D3142A9731,11951,14,20,6,31,49,1599
27944,27944,F9B50F8C0BC548F341BD45D3142A9731,12971,21,23,2,32,48,1648
27954,27954,2075B4FB25DAADC66CD593580F270747,10421,0,14,14,41,48,2098
27955,27955,2075B4FB25DAADC66CD593580F270747,11751,17,19,2,35,48,1798
27956,27956,2075B4FB25DAADC66CD593580F270747,43161,20,22,2,35,47,1797
27957,27957,9C17C707743AE50FBFFE4446783207FB,10381,0,12,12,31,49,1599
27958,27958,9C17C707743AE50FBFFE4446783207FB,10107,13,14,1,38,49,1949
27959,27959,9C17C707743AE50FBFFE4446783207FB,12021,15,17,2,37,49,1899
27960,27960,9C17C707743AE50FBFFE4446783207FB,10221,18,20,2,34,49,1749
27961,27961,9C17C707743AE50FBFFE4446783207FB,10381,21,23,2,31,49,1599
27962,27962,863093DB11F1063670E11FFAF49890AF,43061,0,8,8,43,46,2196
27963,27963,863093DB11F1063670E11FFAF49890AF,13341,12,13,1,44,45,2245
27964,27964,863093DB11F1063670E11FFAF49890AF,43061,14,18,4,43,46,2196
27965,27965,863093DB11F1063670E11FFAF49890AF,13341,18,20,2,44,45,2245
27966,27966,863093DB11F1063670E11FFAF49890AF,43061,20,21,1,43,46,2196
27967,27967,50581210A7BCE9A02646A253A88D47F6,13561,2,5,3,37,49,1899
27968,27968,50581210A7BCE9A02646A253A88D47F6,11021,7,9,2,36,49,1849
27969,27969,50581210A7BCE9A02646A253A88D47F6,10251,11,13,2,35,47,1797
27970,27970,50581210A7BCE9A02646A253A88D47F6,13561,14,15,1,37,49,1899
27971,27971,50581210A7BCE9A02646A253A88D47F6,11021,18,20,2,36,49,1849
27975,27975,6A72A6369674993FC322A428033222FA,42321,0,6,6,43,47,2197
27976,27976,6A72A6369674993FC322A428033222FA,13121,9,16,7,38,46,1946
27977,27977,6A72A6369674993FC322A428033222FA,42321,21,23,2,43,47,2197
27981,27981,ED54D9A6448FF51B585DC3225EB6058D,43644,0,8,8,14,38,738
27982,27982,ED54D9A6448FF51B585DC3225EB6058D,19181,12,13,1,8,40,440
27983,27983,ED54D9A6448FF51B585DC3225EB6058D,43644,16,17,1,14,38,738
27984,27984,ED54D9A6448FF51B585DC3225EB6058D,19181,21,22,1,8,40,440
27985,27985,EA84EDCB7C9475F6273168934FDD6476,19441,0,14,14,8,46,446
27986,27986,EA84EDCB7C9475F6273168934FDD6476,11571,16,18,2,13,46,696
27987,27987,EA84EDCB7C9475F6273168934FDD6476,19901,21,23,2,7,44,394
27992,27992,9ED250E6220018B9A0811A3F419C20A5,11901,0,10,10,42,49,2149
27993,27993,9ED250E6220018B9A0811A3F419C20A5,11021,11,13,2,36,49,1849
27994,27994,9ED250E6220018B9A0811A3F419C20A5,11201,13,18,5,35,49,1799
27995,27995,9ED250E6220018B9A0811A3F419C20A5,10731,18,19,1,33,47,1697
27996,27996,87DA57462D476367AB276D1A619F26E5,11151,0,7,7,30,48,1548
27997,27997,87DA57462D476367AB276D1A619F26E5,11211,10,11,1,34,49,1749
27998,27998,87DA57462D476367AB276D1A619F26E5,11151,14,17,3,30,48,1548
27999,27999,87DA57462D476367AB276D1A619F26E5,43391,18,19,1,29,48,1498
28000,28000,957B13B978E49C7D5F0C344341485CC0,19744,0,14,14,6,43,343
28001,28001,957B13B978E49C7D5F0C344341485CC0,11781,17,19,2,38,49,1949
28002,28002,957B13B978E49C7D5F0C344341485CC0,10651,19,23,4,36,49,1849
28003,28003,B4CEF71A1930B17ECA0A64AF6A41A163,19114,0,9,9,7,43,393
28004,28004,B4CEF71A1930B17ECA0A64AF6A41A163,40341,13,16,3,23,49,1199
28005,28005,B4CEF71A1930B17ECA0A64AF6A41A163,11171,18,23,5,33,48,1698
28006,28006,6E393276634E5B0B2A68B7AC0F0F48CF,10491,0,6,6,33,48,1698
28007,28007,6E393276634E5B0B2A68B7AC0F0F48CF,11861,10,11,1,32,47,1647
28008,28008,6E393276634E5B0B2A68B7AC0F0F48CF,10491,12,15,3,33,48,1698
28009,28009,6E393276634E5B0B2A68B7AC0F0F48CF,11861,17,19,2,32,47,1647
28010,28010,6E393276634E5B0B2A68B7AC0F0F48CF,10491,19,23,4,33,48,1698
28011,28011,9D7E28E179E5F5D009F8D277D0F434A8,11861,0,6,6,32,47,1647
28012,28012,9D7E28E179E5F5D009F8D277D0F434A8,42581,6,7,1,38,48,1948
28013,28013,9D7E28E179E5F5D009F8D277D0F434A8,10591,8,9,1,39,48,1998
28014,28014,9D7E28E179E5F5D009F8D277D0F434A8,42581,9,10,1,38,48,1948
28015,28015,9D7E28E179E5F5D009F8D277D0F434A8,11861,12,23,11,32,47,1647
28016,28016,711A729D73D390B3128E8E166ADEC6D6,11541,0,1,1,35,49,1799
28017,28017,711A729D73D390B3128E8E166ADEC6D6,10191,2,9,7,40,48,2048
28018,28018,711A729D73D390B3128E8E166ADEC6D6,42231,14,16,2,37,46,1896
28019,28019,711A729D73D390B3128E8E166ADEC6D6,11481,17,19,2,41,48,2098
28020,28020,711A729D73D390B3128E8E166ADEC6D6,13711,20,23,3,38,46,1946
28024,28024,0910F80498ECB893DE64FE27C977BF87,10531,0,2,2,34,46,1746
28025,28025,0910F80498ECB893DE64FE27C977BF87,10661,2,8,6,37,49,1899
28026,28026,0910F80498ECB893DE64FE27C977BF87,40073,10,16,6,37,48,1898
28027,28027,0910F80498ECB893DE64FE27C977BF87,11061,17,18,1,29,48,1498
28032,28032,F17FA2BD0CF3F60546423A323C9B3C80,43751,0,5,5,19,48,998
28033,28033,F17FA2BD0CF3F60546423A323C9B3C80,10451,9,10,1,25,48,1298
28034,28034,F17FA2BD0CF3F60546423A323C9B3C80,43751,12,20,8,19,48,998
28035,28035,618D9F41DE4EC96FBA6A3C4386221825,10221,0,10,10,34,49,1749
28036,28036,618D9F41DE4EC96FBA6A3C4386221825,13351,12,13,1,48,48,2448
28037,28037,618D9F41DE4EC96FBA6A3C4386221825,19111,15,17,2,9,45,495
28038,28038,618D9F41DE4EC96FBA6A3C4386221825,19741,17,19,2,5,44,294
28039,28039,618D9F41DE4EC96FBA6A3C4386221825,11461,22,23,1,37,49,1899
28040,28040,0C2E73493B95B864220B3E14F6C11E84,13314,0,7,7,31,39,1589
28041,28041,0C2E73493B95B864220B3E14F6C11E84,12521,8,17,9,35,41,1791
28042,28042,0C2E73493B95B864220B3E14F6C11E84,13314,17,23,6,31,39,1589
28043,28043,3B13223DDDE569265499AF6495E8952A,40891,0,9,9,37,47,1897
28044,28044,3B13223DDDE569265499AF6495E8952A,12521,13,16,3,35,41,1791
28045,28045,3B13223DDDE569265499AF6495E8952A,43731,18,20,2,34,47,1747
28046,28046,F87C006906FC5F5270405EDAA1B0E6A3,12514,6,7,1,38,47,1947
28047,28047,F87C006906FC5F5270405EDAA1B0E6A3,11781,8,10,2,38,49,1949
28048,28048,F87C006906FC5F5270405EDAA1B0E6A3,40271,14,16,2,35,49,1799
28049,28049,F87C006906FC5F5270405EDAA1B0E6A3,12514,18,20,2,38,47,1947
28050,28050,F87C006906FC5F5270405EDAA1B0E6A3,10841,20,22,2,37,47,1897
28051,28051,34F0C519B6FDD2F794A275DCB1DAFC02,10921,0,8,8,43,48,2198
28052,28052,34F0C519B6FDD2F794A275DCB1DAFC02,13091,10,12,2,20,42,1042
28053,28053,34F0C519B6FDD2F794A275DCB1DAFC02,10921,15,23,8,43,48,2198
28054,28054,FB55907415A7C0538398712A9BE0B78E,12661,1,7,6,32,45,1645
28055,28055,FB55907415A7C0538398712A9BE0B78E,42151,8,11,3,35,45,1795
28056,28056,FB55907415A7C0538398712A9BE0B78E,12661,11,14,3,32,45,1645
28057,28057,FB55907415A7C0538398712A9BE0B78E,42151,17,18,1,35,45,1795
28058,28058,FB55907415A7C0538398712A9BE0B78E,12661,18,20,2,32,45,1645
28062,28062,D8B46FFCD15B641FB93B8219A29A7205,42161,4,6,2,36,47,1847
28063,28063,D8B46FFCD15B641FB93B8219A29A7205,40673,7,8,1,36,48,1848
28064,28064,D8B46FFCD15B641FB93B8219A29A7205,10251,8,13,5,35,47,1797
28065,28065,D8B46FFCD15B641FB93B8219A29A7205,42161,13,15,2,36,47,1847
28066,28066,D8B46FFCD15B641FB93B8219A29A7205,10251,19,22,3,35,47,1797
28067,28067,24749D787EBC84F706A029C12F99F051,11021,0,7,7,36,49,1849
28068,28068,24749D787EBC84F706A029C12F99F051,42461,7,8,1,45,47,2297
28069,28069,24749D787EBC84F706A029C12F99F051,43361,10,20,10,38,48,1948
28073,28073,4E9D6148560142FFC3549F2650187D86,10691,2,6,4,33,48,1698
28074,28074,4E9D6148560142FFC3549F2650187D86,11861,8,11,3,32,47,1647
28075,28075,4E9D6148560142FFC3549F2650187D86,40112,11,12,1,32,48,1648
28076,28076,4E9D6148560142FFC3549F2650187D86,42021,12,15,3,33,47,1697
28077,28077,4E9D6148560142FFC3549F2650187D86,10691,20,21,1,33,48,1698
28078,28078,947EE86E96DF76B9619AD7271E46BF1E,42623,10,11,1,22,49,1149
28079,28079,947EE86E96DF76B9619AD7271E46BF1E,15191,13,18,5,36,27,1827
28080,28080,947EE86E96DF76B9619AD7271E46BF1E,12792,19,21,2,34,30,1730
28081,28081,947EE86E96DF76B9619AD7271E46BF1E,15191,21,23,2,36,27,1827
28089,28089,8436FA510D59B3814E50B7F18BD1D92C,19571,0,1,1,1,36,86
28090,28090,8436FA510D59B3814E50B7F18BD1D92C,43644,5,6,1,14,38,738
28091,28091,8436FA510D59B3814E50B7F18BD1D92C,19031,9,10,1,1,42,92
28092,28092,8436FA510D59B3814E50B7F18BD1D92C,19571,11,13,2,1,36,86
28093,28093,8436FA510D59B3814E50B7F18BD1D92C,19031,15,16,1,1,42,92
28094,28094,8436FA510D59B3814E50B7F18BD1D92C,12641,16,17,1,10,43,543
28095,28095,8436FA510D59B3814E50B7F18BD1D92C,19571,21,23,2,1,36,86
28096,28096,A0248BFF2ED2A835235C86968F1768A2,13231,1,2,1,39,46,1996
28097,28097,A0248BFF2ED2A835235C86968F1768A2,43041,2,3,1,41,46,2096
28098,28098,A0248BFF2ED2A835235C86968F1768A2,13231,4,7,3,39,46,1996
28099,28099,A0248BFF2ED2A835235C86968F1768A2,11261,9,11,2,36,46,1846
28100,28100,A0248BFF2ED2A835235C86968F1768A2,42351,12,13,1,38,45,1945
28101,28101,A0248BFF2ED2A835235C86968F1768A2,11261,15,17,2,36,46,1846
28102,28102,A0248BFF2ED2A835235C86968F1768A2,13231,18,20,2,39,46,1996
28106,28106,C26F1BFC29B75732B01C2749BCC04DE8,11791,0,2,2,38,49,1949
28107,28107,C26F1BFC29B75732B01C2749BCC04DE8,43361,3,10,7,38,48,1948
28108,28108,C26F1BFC29B75732B01C2749BCC04DE8,11791,11,13,2,38,49,1949
28109,28109,C26F1BFC29B75732B01C2749BCC04DE8,11541,16,17,1,35,49,1799
28110,28110,C26F1BFC29B75732B01C2749BCC04DE8,42641,18,20,2,33,49,1699
28111,28111,C26F1BFC29B75732B01C2749BCC04DE8,11531,20,21,1,34,49,1749
28112,28112,0C2B805EE888E91F034AB21F925F07C4,19901,1,8,7,7,44,394
28113,28113,0C2B805EE888E91F034AB21F925F07C4,19114,8,11,3,7,43,393
28114,28114,0C2B805EE888E91F034AB21F925F07C4,19901,13,14,1,7,44,394
28115,28115,0C2B805EE888E91F034AB21F925F07C4,12641,15,17,2,10,43,543
28116,28116,0C2B805EE888E91F034AB21F925F07C4,19901,20,22,2,7,44,394
28117,28117,BF5EFB3BDBF5437ACD467C87E9038A8B,43021,2,9,7,16,43,843
28118,28118,BF5EFB3BDBF5437ACD467C87E9038A8B,12921,10,13,3,9,41,491
28119,28119,BF5EFB3BDBF5437ACD467C87E9038A8B,43021,14,16,2,16,43,843
28120,28120,BF5EFB3BDBF5437ACD467C87E9038A8B,43644,19,20,1,14,38,738
28121,28121,BF5EFB3BDBF5437ACD467C87E9038A8B,43021,20,23,3,16,43,843
28122,28122,DC039387A628B91E0244A44A27B6D2A1,42623,0,9,9,22,49,1149
28123,28123,DC039387A628B91E0244A44A27B6D2A1,43761,16,17,1,32,47,1647
28124,28124,DC039387A628B91E0244A44A27B6D2A1,11061,18,20,2,29,48,1498
28125,28125,DC039387A628B91E0244A44A27B6D2A1,11641,21,23,2,22,49,1149
28130,28130,DFD67893B33D33FDAA92DC71D5732DAF,40833,0,8,8,41,47,2097
28131,28131,DFD67893B33D33FDAA92DC71D5732DAF,42161,8,14,6,36,47,1847
28132,28132,DFD67893B33D33FDAA92DC71D5732DAF,10111,14,20,6,37,47,1897
28133,28133,DFD67893B33D33FDAA92DC71D5732DAF,42161,21,22,1,36,47,1847
28137,28137,F49EE04071D0B4FCCD4263F4C2BBEA7A,10681,0,7,7,30,48,1548
28138,28138,F49EE04071D0B4FCCD4263F4C2BBEA7A,11161,11,12,1,32,48,1648
28139,28139,F49EE04071D0B4FCCD4263F4C2BBEA7A,11061,12,15,3,29,48,1498
28140,28140,F49EE04071D0B4FCCD4263F4C2BBEA7A,12121,15,17,2,29,47,1497
28141,28141,F49EE04071D0B4FCCD4263F4C2BBEA7A,11161,18,19,1,32,48,1648
28142,28142,F49EE04071D0B4FCCD4263F4C2BBEA7A,11061,19,21,2,29,48,1498
28143,28143,F49EE04071D0B4FCCD4263F4C2BBEA7A,10681,21,23,2,30,48,1548
28144,28144,BE1BBD5C0848E8672C9646D8F78DADAC,11331,0,3,3,37,48,1898
28145,28145,BE1BBD5C0848E8672C9646D8F78DADAC,42031,4,14,10,40,46,2046
28146,28146,BE1BBD5C0848E8672C9646D8F78DADAC,42961,16,17,1,35,49,1799
28147,28147,BE1BBD5C0848E8672C9646D8F78DADAC,11751,18,20,2,35,48,1798
28148,28148,BE1BBD5C0848E8672C9646D8F78DADAC,11074,20,22,2,37,47,1897
28153,28153,A6EF3AA52D2C883DD4C8A6E9BED0EE14,19901,0,5,5,7,44,394
28154,28154,A6EF3AA52D2C883DD4C8A6E9BED0EE14,12921,6,14,8,9,41,491
28155,28155,A6EF3AA52D2C883DD4C8A6E9BED0EE14,42551,17,21,4,14,48,748
28156,28156,1C0548F40841AD0870DAD8EC7BECCBC6,13314,0,13,13,31,39,1589
28157,28157,1C0548F40841AD0870DAD8EC7BECCBC6,12521,17,18,1,35,41,1791
28158,28158,1C0548F40841AD0870DAD8EC7BECCBC6,13314,19,23,4,31,39,1589
28159,28159,FD112B5156FECF6460254CADD94A5EF4,12731,0,2,2,22,40,1140
28160,28160,FD112B5156FECF6460254CADD94A5EF4,12641,3,4,1,10,43,543
28161,28161,FD112B5156FECF6460254CADD94A5EF4,19031,6,11,5,1,42,92
28162,28162,FD112B5156FECF6460254CADD94A5EF4,12641,13,18,5,10,43,543
28163,28163,FD112B5156FECF6460254CADD94A5EF4,19031,19,20,1,1,42,92
28164,28164,FD112B5156FECF6460254CADD94A5EF4,12641,21,23,2,10,43,543
28165,28165,26B9AAC369331C3B7CCBFCA623526739,10811,0,1,1,38,46,1946
28166,28166,26B9AAC369331C3B7CCBFCA623526739,43011,2,9,7,40,42,2042
28167,28167,26B9AAC369331C3B7CCBFCA623526739,13101,10,13,3,40,47,2047
28168,28168,26B9AAC369331C3B7CCBFCA623526739,10601,14,16,2,39,47,1997
28169,28169,26B9AAC369331C3B7CCBFCA623526739,13101,20,22,2,40,47,2047
28173,28173,3B8FB8720B738954F0287E8A91FB9A89,43751,0,14,14,19,48,998
28174,28174,3B8FB8720B738954F0287E8A91FB9A89,42691,16,20,4,24,48,1248
28175,28175,3B8FB8720B738954F0287E8A91FB9A89,43751,20,22,2,19,48,998
28179,28179,4B127C7EA26458E507C53C5C29F3B661,10281,0,18,18,33,48,1698
28180,28180,4B127C7EA26458E507C53C5C29F3B661,12021,19,21,2,37,49,1899
28181,28181,4B127C7EA26458E507C53C5C29F3B661,10281,21,23,2,33,48,1698
28182,28182,2E9DA8BFC00288392B827149BB3FB265,43021,0,6,6,16,43,843
28183,28183,2E9DA8BFC00288392B827149BB3FB265,12641,8,14,6,10,43,543
28184,28184,2E9DA8BFC00288392B827149BB3FB265,12921,14,20,6,9,41,491
28185,28185,364CFB7A1685ACB31A7518A83542E08A,11806,0,6,6,41,48,2098
28186,28186,364CFB7A1685ACB31A7518A83542E08A,40302,10,11,1,40,49,2049
28187,28187,364CFB7A1685ACB31A7518A83542E08A,42271,14,17,3,40,47,2047
28188,28188,364CFB7A1685ACB31A7518A83542E08A,11806,17,18,1,41,48,2098
28189,28189,364CFB7A1685ACB31A7518A83542E08A,42271,21,23,2,40,47,2047
28193,28193,0EE0313B12B9F1B71F01783385794A53,42341,0,8,8,43,49,2199
28194,28194,0EE0313B12B9F1B71F01783385794A53,42601,11,13,2,44,48,2248
28195,28195,0EE0313B12B9F1B71F01783385794A53,11801,13,14,1,42,48,2148
28196,28196,0EE0313B12B9F1B71F01783385794A53,42601,15,19,4,44,48,2248
28197,28197,0EE0313B12B9F1B71F01783385794A53,42341,19,21,2,43,49,2199
28198,28198,0EE0313B12B9F1B71F01783385794A53,42601,22,23,1,44,48,2248
28202,28202,6D5AD065D152866F8B3D587D0B5B6031,42271,0,6,6,40,47,2047
28203,28203,6D5AD065D152866F8B3D587D0B5B6031,11806,9,10,1,41,48,2098
28204,28204,6D5AD065D152866F8B3D587D0B5B6031,11201,13,16,3,35,49,1799
28205,28205,6D5AD065D152866F8B3D587D0B5B6031,12521,17,18,1,35,41,1791
28209,28209,A397CA34DC305144BBC47B61A59BF2DD,42401,0,8,8,36,47,1847
28210,28210,A397CA34DC305144BBC47B61A59BF2DD,12561,10,12,2,45,43,2293
28211,28211,A397CA34DC305144BBC47B61A59BF2DD,12221,15,16,1,43,44,2194
28212,28212,A397CA34DC305144BBC47B61A59BF2DD,42301,19,23,4,36,47,1847
28213,28213,EEAD4C1A5C3C3CA3E08C3BA4BC80CCB9,12921,0,3,3,9,41,491
28214,28214,EEAD4C1A5C3C3CA3E08C3BA4BC80CCB9,19021,5,7,2,10,45,545
28215,28215,EEAD4C1A5C3C3CA3E08C3BA4BC80CCB9,12921,9,18,9,9,41,491
28216,28216,EEAD4C1A5C3C3CA3E08C3BA4BC80CCB9,49201,20,23,3,7,41,391
28217,28217,2F66AC01887397A198C9CCA6611EA97B,12521,0,16,16,35,41,1791
28218,28218,2F66AC01887397A198C9CCA6611EA97B,13314,16,17,1,31,39,1589
28219,28219,2F66AC01887397A198C9CCA6611EA97B,12521,18,23,5,35,41,1791
28220,28220,6873293A7011427730E4398465E19659,12641,1,2,1,10,43,543
28221,28221,6873293A7011427730E4398465E19659,12921,6,11,5,9,41,491
28222,28222,6873293A7011427730E4398465E19659,12641,12,13,1,10,43,543
28223,28223,6873293A7011427730E4398465E19659,12921,14,17,3,9,41,491
28224,28224,6873293A7011427730E4398465E19659,12641,18,20,2,10,43,543
28225,28225,99A24879ECB2B435F68696FC7F63DBB9,11021,0,12,12,36,49,1849
28226,28226,99A24879ECB2B435F68696FC7F63DBB9,10107,13,14,1,38,49,1949
28227,28227,99A24879ECB2B435F68696FC7F63DBB9,11875,16,18,2,30,46,1546
28236,28236,10174C5AAAC6DE7A0575D462AC2C511D,10471,0,7,7,37,48,1898
28237,28237,10174C5AAAC6DE7A0575D462AC2C511D,42031,8,9,1,40,46,2046
28238,28238,10174C5AAAC6DE7A0575D462AC2C511D,10471,10,17,7,37,48,1898
28239,28239,10174C5AAAC6DE7A0575D462AC2C511D,40171,18,20,2,38,48,1948
28240,28240,10174C5AAAC6DE7A0575D462AC2C511D,10151,20,23,3,34,47,1747
28241,28241,B77682EADE198F59AF75ED4446059C81,42623,5,6,1,22,49,1149
28242,28242,B77682EADE198F59AF75ED4446059C81,42071,8,16,8,31,49,1599
28243,28243,B77682EADE198F59AF75ED4446059C81,42081,16,18,2,24,49,1249
28244,28244,B77682EADE198F59AF75ED4446059C81,42071,18,19,1,31,49,1599
28245,28245,29B536EE93C2E266619D50C15F53EE29,42531,0,6,6,31,45,1595
28246,28246,29B536EE93C2E266619D50C15F53EE29,12311,6,8,2,30,44,1544
28247,28247,29B536EE93C2E266619D50C15F53EE29,42531,8,11,3,31,45,1595
28248,28248,29B536EE93C2E266619D50C15F53EE29,12311,16,18,2,30,44,1544
28249,28249,29B536EE93C2E266619D50C15F53EE29,42531,19,22,3,31,45,1595
28253,28253,C9CAC2C6335B37B2CDE3F43D7A7F9A91,42071,6,11,5,31,49,1599
28254,28254,C9CAC2C6335B37B2CDE3F43D7A7F9A91,42081,12,13,1,24,49,1249
28255,28255,C9CAC2C6335B37B2CDE3F43D7A7F9A91,42071,14,20,6,31,49,1599
28256,28256,88BD866547E35D038437E393C4A29F25,12491,0,4,4,36,43,1843
28257,28257,88BD866547E35D038437E393C4A29F25,13314,4,6,2,31,39,1589
28258,28258,88BD866547E35D038437E393C4A29F25,11261,6,19,13,36,46,1846
28259,28259,478EBB14CD85A09C42BEE36934A1ECB1,42623,2,9,7,22,49,1149
28260,28260,478EBB14CD85A09C42BEE36934A1ECB1,42071,10,15,5,31,49,1599
28261,28261,478EBB14CD85A09C42BEE36934A1ECB1,42623,16,20,4,22,49,1149
28262,28262,13CC40471AC83D6354BC2D2A78721A9B,10721,0,9,9,31,48,1598
28263,28263,13CC40471AC83D6354BC2D2A78721A9B,10921,13,18,5,43,48,2198
28264,28264,13CC40471AC83D6354BC2D2A78721A9B,10721,19,21,2,31,48,1598
28269,28269,5DC656AE1F755A21D4CE0049D29039D4,12521,3,4,1,35,41,1791
28270,28270,5DC656AE1F755A21D4CE0049D29039D4,12491,5,7,2,36,43,1843
28271,28271,5DC656AE1F755A21D4CE0049D29039D4,40073,11,13,2,37,48,1898
28272,28272,5DC656AE1F755A21D4CE0049D29039D4,11261,15,17,2,36,46,1846
28273,28273,5DC656AE1F755A21D4CE0049D29039D4,12491,18,20,2,36,43,1843
28274,28274,151AF07FE1353F98EA8933566E4D900D,12921,0,13,13,9,41,491
28275,28275,151AF07FE1353F98EA8933566E4D900D,43021,13,14,1,16,43,843
28276,28276,151AF07FE1353F98EA8933566E4D900D,12921,15,23,8,9,41,491
28277,28277,946D60A1107ED022BBF209ADA80BE0A7,11781,0,7,7,38,49,1949
28278,28278,946D60A1107ED022BBF209ADA80BE0A7,11701,9,10,1,43,48,2198
28279,28279,946D60A1107ED022BBF209ADA80BE0A7,40341,15,17,2,23,49,1199
28280,28280,946D60A1107ED022BBF209ADA80BE0A7,11781,21,23,2,38,49,1949
28288,28288,3E053959024199C33329BDA98E776BD4,10951,0,8,8,29,48,1498
28289,28289,3E053959024199C33329BDA98E776BD4,11481,8,10,2,41,48,2098
28290,28290,3E053959024199C33329BDA98E776BD4,11381,11,17,6,30,47,1547
28291,28291,3E053959024199C33329BDA98E776BD4,10381,19,20,1,31,49,1599
28292,28292,3E053959024199C33329BDA98E776BD4,11381,20,23,3,30,47,1547
28297,28297,A796809FFC26797F0B17A0B66E102B15,13314,0,3,3,31,39,1589
28298,28298,A796809FFC26797F0B17A0B66E102B15,12521,8,9,1,35,41,1791
28299,28299,A796809FFC26797F0B17A0B66E102B15,13314,12,13,1,31,39,1589
28300,28300,A796809FFC26797F0B17A0B66E102B15,12521,14,18,4,35,41,1791
28301,28301,A796809FFC26797F0B17A0B66E102B15,13314,19,23,4,31,39,1589
28305,28305,634DBD789AFAD1E24FFCA10A088F0AE1,13341,0,7,7,44,45,2245
28306,28306,634DBD789AFAD1E24FFCA10A088F0AE1,11261,10,11,1,36,46,1846
28307,28307,634DBD789AFAD1E24FFCA10A088F0AE1,42351,15,17,2,38,45,1945
28308,28308,634DBD789AFAD1E24FFCA10A088F0AE1,13341,19,21,2,44,45,2245
28309,28309,85E9AA20A2655C92CBF1FCB9F1F420CF,11551,10,11,1,39,49,1999
28310,28310,85E9AA20A2655C92CBF1FCB9F1F420CF,13941,17,18,1,41,47,2097
28311,28311,85E9AA20A2655C92CBF1FCB9F1F420CF,42461,19,20,1,45,47,2297
28315,28315,51F784C888CDC439364E57C73AA7020C,11161,0,6,6,32,48,1648
28316,28316,51F784C888CDC439364E57C73AA7020C,42541,7,9,2,25,47,1297
28317,28317,51F784C888CDC439364E57C73AA7020C,42141,9,23,14,32,47,1647
28318,28318,806A9140D4F11D37CD665345EE97E730,12921,2,3,1,9,41,491
28319,28319,806A9140D4F11D37CD665345EE97E730,12641,7,15,8,10,43,543
28320,28320,806A9140D4F11D37CD665345EE97E730,12921,17,18,1,9,41,491
28321,28321,806A9140D4F11D37CD665345EE97E730,12641,19,20,1,10,43,543
28322,28322,806A9140D4F11D37CD665345EE97E730,12921,21,23,2,9,41,491
28323,28323,DE69FEBC50432F9871EF62D07F7A5C1A,19181,0,12,12,8,40,440
28324,28324,DE69FEBC50432F9871EF62D07F7A5C1A,43644,13,14,1,14,38,738
28325,28325,DE69FEBC50432F9871EF62D07F7A5C1A,19181,16,20,4,8,40,440
28326,28326,1DAFF76ACB610741A4BE36A701B9B8ED,11791,0,6,6,38,49,1949
28327,28327,1DAFF76ACB610741A4BE36A701B9B8ED,13731,17,18,1,33,49,1699
28328,28328,1DAFF76ACB610741A4BE36A701B9B8ED,11791,21,23,2,38,49,1949
28329,28329,BA2AC3617D6B7C3A5B1FFF7BEC1D44D4,13671,0,9,9,27,43,1393
28330,28330,BA2AC3617D6B7C3A5B1FFF7BEC1D44D4,12021,13,15,2,37,49,1899
28331,28331,BA2AC3617D6B7C3A5B1FFF7BEC1D44D4,13671,16,18,2,27,43,1393
28332,28332,BA2AC3617D6B7C3A5B1FFF7BEC1D44D4,13094,18,19,1,21,42,1092
28333,28333,BA2AC3617D6B7C3A5B1FFF7BEC1D44D4,13671,21,22,1,27,43,1393
28340,28340,7B654C3798CB89CF9AFEC7720C14AC66,41393,0,7,7,43,49,2199
28341,28341,7B654C3798CB89CF9AFEC7720C14AC66,43051,10,11,1,46,45,2345
28342,28342,7B654C3798CB89CF9AFEC7720C14AC66,42461,14,16,2,45,47,2297
28343,28343,7B654C3798CB89CF9AFEC7720C14AC66,43051,16,20,4,46,45,2345
28353,28353,178C77A35FD44B11E87CB7B618A8D58F,10171,0,8,8,26,47,1347
28354,28354,178C77A35FD44B11E87CB7B618A8D58F,42523,10,12,2,31,47,1597
28355,28355,178C77A35FD44B11E87CB7B618A8D58F,15301,17,18,1,35,16,1766
28356,28356,178C77A35FD44B11E87CB7B618A8D58F,15571,19,21,2,37,19,1869
28357,28357,1F2EEABE111E8F6AD1CE439041F72B5B,13911,1,5,4,39,46,1996
28358,28358,1F2EEABE111E8F6AD1CE439041F72B5B,42231,7,8,1,37,46,1896
28359,28359,1F2EEABE111E8F6AD1CE439041F72B5B,13911,11,14,3,39,46,1996
28360,28360,1F2EEABE111E8F6AD1CE439041F72B5B,42351,15,17,2,38,45,1945
28361,28361,1F2EEABE111E8F6AD1CE439041F72B5B,42231,17,18,1,37,46,1896
28362,28362,AE9DABC8C76DE8782FA56379E8CBF939,10544,0,11,11,28,48,1448
28363,28363,AE9DABC8C76DE8782FA56379E8CBF939,11211,11,13,2,34,49,1749
28364,28364,AE9DABC8C76DE8782FA56379E8CBF939,11954,15,17,2,32,49,1649
28365,28365,AE9DABC8C76DE8782FA56379E8CBF939,10544,17,19,2,28,48,1448
28366,28366,AE9DABC8C76DE8782FA56379E8CBF939,43501,21,23,2,27,48,1398
28379,28379,68A1105E45875228253ACCFACF581238,15143,4,8,4,18,7,907
28380,28380,68A1105E45875228253ACCFACF581238,15051,9,10,1,19,4,954
28381,28381,68A1105E45875228253ACCFACF581238,16211,10,12,2,4,3,203
28382,28382,68A1105E45875228253ACCFACF581238,16261,13,17,4,3,3,153
28383,28383,68A1105E45875228253ACCFACF581238,15051,18,19,1,19,4,954
28384,28384,68A1105E45875228253ACCFACF581238,15143,21,23,2,18,7,907
28385,28385,6A457FC295BEABB4E7455CBB04B50835,12641,3,4,1,10,43,543
28386,28386,6A457FC295BEABB4E7455CBB04B50835,12921,5,7,2,9,41,491
28387,28387,6A457FC295BEABB4E7455CBB04B50835,43021,7,8,1,16,43,843
28388,28388,6A457FC295BEABB4E7455CBB04B50835,12921,8,10,2,9,41,491
28389,28389,6A457FC295BEABB4E7455CBB04B50835,43644,14,18,4,14,38,738
28390,28390,16A0589A145EA4C47047324378E38CE2,42633,0,7,7,42,46,2146
28391,28391,16A0589A145EA4C47047324378E38CE2,43061,14,15,1,43,46,2196
28392,28392,16A0589A145EA4C47047324378E38CE2,11731,17,19,2,36,48,1848
28393,28393,16A0589A145EA4C47047324378E38CE2,42091,20,22,2,43,46,2196
28394,28394,9BC47FA5C2F284E30455980EAAB09B9D,42031,0,6,6,40,46,2046
28395,28395,9BC47FA5C2F284E30455980EAAB09B9D,12391,10,13,3,36,49,1849
28396,28396,9BC47FA5C2F284E30455980EAAB09B9D,11074,14,15,1,37,47,1897
28397,28397,9BC47FA5C2F284E30455980EAAB09B9D,11021,17,23,6,36,49,1849
28398,28398,253A422C6572FACDA35B610A2E4ABDE3,15171,0,5,5,42,21,2121
28399,28399,253A422C6572FACDA35B610A2E4ABDE3,15441,9,17,8,44,20,2220
28400,28400,253A422C6572FACDA35B610A2E4ABDE3,43041,21,22,1,41,46,2096
28404,28404,19544F9BC0BE20E6141BDD062D6E05AC,43451,3,5,2,37,40,1890
28405,28405,19544F9BC0BE20E6141BDD062D6E05AC,13071,7,10,3,41,41,2091
28406,28406,19544F9BC0BE20E6141BDD062D6E05AC,43451,12,16,4,37,40,1890
28407,28407,19544F9BC0BE20E6141BDD062D6E05AC,13071,18,19,1,41,41,2091
28408,28408,5AF7B491379174D1EAB9243D9B74745C,42541,0,13,13,25,47,1297
28409,28409,5AF7B491379174D1EAB9243D9B74745C,12051,16,18,2,20,47,1047
28410,28410,5AF7B491379174D1EAB9243D9B74745C,42541,19,22,3,25,47,1297
28414,28414,9526CA84048ECDF651C5107129654F39,15145,1,13,12,22,9,1109
28415,28415,9526CA84048ECDF651C5107129654F39,16321,13,15,2,8,7,407
28416,28416,9526CA84048ECDF651C5107129654F39,15145,17,20,3,22,9,1109
28417,28417,CEAC6C818D7651ADBA37DD2B6097C732,42301,0,7,7,36,47,1847
28418,28418,CEAC6C818D7651ADBA37DD2B6097C732,42231,9,10,1,37,46,1896
28419,28419,CEAC6C818D7651ADBA37DD2B6097C732,42351,10,12,2,38,45,1945
28420,28420,CEAC6C818D7651ADBA37DD2B6097C732,42231,15,19,4,37,46,1896
28421,28421,CEAC6C818D7651ADBA37DD2B6097C732,13911,19,21,2,39,46,1996
28422,28422,2FF9DDF73D42A9CA6C9A2099916DB72C,40673,1,10,9,36,48,1848
28423,28423,2FF9DDF73D42A9CA6C9A2099916DB72C,42261,12,17,5,25,49,1299
28424,28424,2FF9DDF73D42A9CA6C9A2099916DB72C,42623,18,20,2,22,49,1149
28425,28425,2FF9DDF73D42A9CA6C9A2099916DB72C,41591,21,23,2,34,49,1749
28426,28426,359FE9C81191B336C3006B985BEC71B7,10281,0,9,9,33,48,1698
28427,28427,359FE9C81191B336C3006B985BEC71B7,43761,11,12,1,32,47,1647
28428,28428,359FE9C81191B336C3006B985BEC71B7,10281,12,15,3,33,48,1698
28429,28429,359FE9C81191B336C3006B985BEC71B7,40341,16,18,2,23,49,1199
28430,28430,359FE9C81191B336C3006B985BEC71B7,10491,18,19,1,33,48,1698
28444,28444,422DDC348F4AAA002A648FA0F6118A74,42161,0,2,2,36,47,1847
28445,28445,422DDC348F4AAA002A648FA0F6118A74,43761,3,17,14,32,47,1647
28446,28446,422DDC348F4AAA002A648FA0F6118A74,11161,19,22,3,32,48,1648
28447,28447,FCA3C665B5BF337F331669EDB597A6AC,42791,4,7,3,35,45,1795
28448,28448,FCA3C665B5BF337F331669EDB597A6AC,10271,8,9,1,37,46,1896
28449,28449,FCA3C665B5BF337F331669EDB597A6AC,13121,9,15,6,38,46,1946
28450,28450,FCA3C665B5BF337F331669EDB597A6AC,42791,19,21,2,35,45,1795
28451,28451,FCA3C665B5BF337F331669EDB597A6AC,10841,21,22,1,37,47,1897
28452,28452,8D8161B5F370B32EB1F94AA1C515485F,10161,1,11,10,35,49,1799
28453,28453,8D8161B5F370B32EB1F94AA1C515485F,12401,12,13,1,39,49,1999
28454,28454,8D8161B5F370B32EB1F94AA1C515485F,10161,15,17,2,35,49,1799
28455,28455,8D8161B5F370B32EB1F94AA1C515485F,11861,17,22,5,32,47,1647
28456,28456,2D9F8EEE0946858BEC66856CB73B8335,43021,0,5,5,16,43,843
28457,28457,2D9F8EEE0946858BEC66856CB73B8335,12921,6,19,13,9,41,491
28458,28458,2D9F8EEE0946858BEC66856CB73B8335,43021,19,22,3,16,43,843
28459,28459,323D4177D0D22193C91552166ADC43E4,10341,0,6,6,31,47,1597
28460,28460,323D4177D0D22193C91552166ADC43E4,42471,8,13,5,35,49,1799
28461,28461,323D4177D0D22193C91552166ADC43E4,42521,14,23,9,31,47,1597
28462,28462,7F22F6803A0EF06EA97B48DC039DF4A6,10121,0,8,8,36,49,1849
28463,28463,7F22F6803A0EF06EA97B48DC039DF4A6,43011,15,17,2,40,42,2042
28464,28464,7F22F6803A0EF06EA97B48DC039DF4A6,10121,17,23,6,36,49,1849
28465,28465,35DAC6756C7F4B57C2B1C6F65896CD31,10351,6,9,3,28,45,1445
28466,28466,35DAC6756C7F4B57C2B1C6F65896CD31,12601,9,13,4,25,47,1297
28467,28467,35DAC6756C7F4B57C2B1C6F65896CD31,10351,14,23,9,28,45,1445
28468,28468,170A0AC014DC9BA930EAA0E56A2C9D03,42321,0,7,7,43,47,2197
28469,28469,170A0AC014DC9BA930EAA0E56A2C9D03,42461,10,14,4,45,47,2297
28470,28470,170A0AC014DC9BA930EAA0E56A2C9D03,42091,15,17,2,43,46,2196
28471,28471,170A0AC014DC9BA930EAA0E56A2C9D03,11701,17,20,3,43,48,2198
28472,28472,170A0AC014DC9BA930EAA0E56A2C9D03,11001,21,23,2,42,47,2147
28473,28473,8FFDEB2573593D2EBFD07303D94AB87F,42321,0,9,9,43,47,2197
28474,28474,8FFDEB2573593D2EBFD07303D94AB87F,13271,11,13,2,41,47,2097
28475,28475,8FFDEB2573593D2EBFD07303D94AB87F,10781,15,18,3,35,47,1797
28476,28476,8FFDEB2573593D2EBFD07303D94AB87F,42321,20,23,3,43,47,2197
28477,28477,6D7E7D83809F09E3C9AFF977E8089BFE,42633,0,15,15,42,46,2146
28478,28478,6D7E7D83809F09E3C9AFF977E8089BFE,43041,18,21,3,41,46,2096
28479,28479,6D7E7D83809F09E3C9AFF977E8089BFE,10781,21,23,2,35,47,1797
28480,28480,6E9349B8A3D65DDCD99336144FE8839B,13371,0,7,7,41,47,2097
28481,28481,6E9349B8A3D65DDCD99336144FE8839B,13481,9,14,5,26,31,1331
28482,28482,6E9349B8A3D65DDCD99336144FE8839B,10821,15,18,3,40,47,2047
28483,28483,6E9349B8A3D65DDCD99336144FE8839B,11771,20,21,1,39,49,1999
28484,28484,9ECA5557B94DDF8D494B58216329A377,11261,0,1,1,36,46,1846
28485,28485,9ECA5557B94DDF8D494B58216329A377,42864,2,5,3,38,44,1944
28486,28486,9ECA5557B94DDF8D494B58216329A377,11261,9,14,5,36,46,1846
28487,28487,9ECA5557B94DDF8D494B58216329A377,42864,14,17,3,38,44,1944
28488,28488,9ECA5557B94DDF8D494B58216329A377,11261,20,21,1,36,46,1846
28489,28489,78B0E510C8AC1F29BEBD74E6A2E2C73D,10191,0,9,9,40,48,2048
28490,28490,78B0E510C8AC1F29BEBD74E6A2E2C73D,12381,10,12,2,32,48,1648
28491,28491,78B0E510C8AC1F29BEBD74E6A2E2C73D,11751,12,13,1,35,48,1798
28492,28492,78B0E510C8AC1F29BEBD74E6A2E2C73D,11161,13,15,2,32,48,1648
28493,28493,78B0E510C8AC1F29BEBD74E6A2E2C73D,10191,16,20,4,40,48,2048
28497,28497,4DB38339991D812959DD5185E09987C4,12511,0,7,7,39,47,1997
28498,28498,4DB38339991D812959DD5185E09987C4,10171,11,13,2,26,47,1347
28499,28499,4DB38339991D812959DD5185E09987C4,10841,14,16,2,37,47,1897
28500,28500,4DB38339991D812959DD5185E09987C4,12511,21,22,1,39,47,1997
28501,28501,369C4B9E6415952E1C4158CF467B54B7,43971,0,13,13,30,48,1548
28502,28502,369C4B9E6415952E1C4158CF467B54B7,40341,14,16,2,23,49,1199
28503,28503,369C4B9E6415952E1C4158CF467B54B7,11381,17,20,3,30,47,1547
28504,28504,369C4B9E6415952E1C4158CF467B54B7,43971,22,23,1,30,48,1548
28505,28505,F0E73403448DB83F822D52BA48555EF6,42351,0,2,2,38,45,1945
28506,28506,F0E73403448DB83F822D52BA48555EF6,13911,6,8,2,39,46,1996
28507,28507,F0E73403448DB83F822D52BA48555EF6,11261,9,10,1,36,46,1846
28508,28508,F0E73403448DB83F822D52BA48555EF6,13911,12,17,5,39,46,1996
28509,28509,F0E73403448DB83F822D52BA48555EF6,42231,18,20,2,37,46,1896
28510,28510,F0E73403448DB83F822D52BA48555EF6,13911,20,22,2,39,46,1996
28514,28514,08B22EEE6E957330DAD27E7217103ACF,42381,0,5,5,39,41,1991
28515,28515,08B22EEE6E957330DAD27E7217103ACF,43011,9,17,8,40,42,2042
28516,28516,08B22EEE6E957330DAD27E7217103ACF,11331,20,23,3,37,48,1898
28517,28517,F2E0A788EC41736380A7AB3495E7AB34,42161,0,7,7,36,47,1847
28518,28518,F2E0A788EC41736380A7AB3495E7AB34,42691,8,16,8,24,48,1248
28519,28519,F2E0A788EC41736380A7AB3495E7AB34,12051,16,18,2,20,47,1047
28520,28520,F2E0A788EC41736380A7AB3495E7AB34,42161,19,23,4,36,47,1847
28525,28525,0FC68E48E696814F86B32F35581B75FC,10107,0,15,15,38,49,1949
28526,28526,0FC68E48E696814F86B32F35581B75FC,40341,16,18,2,23,49,1199
28527,28527,0FC68E48E696814F86B32F35581B75FC,11811,20,23,3,38,49,1949
28528,28528,8DE4D252DA36E1365B15A8E9C0F92CC0,11151,0,8,8,30,48,1548
28529,28529,8DE4D252DA36E1365B15A8E9C0F92CC0,10544,9,10,1,28,48,1448
28530,28530,8DE4D252DA36E1365B15A8E9C0F92CC0,41591,13,16,3,34,49,1749
28531,28531,8DE4D252DA36E1365B15A8E9C0F92CC0,11151,20,22,2,30,48,1548
28532,28532,F54ED9AF3F4912FB803CEE4DE140399D,12841,0,9,9,37,47,1897
28533,28533,F54ED9AF3F4912FB803CEE4DE140399D,10281,9,10,1,33,48,1698
28534,28534,F54ED9AF3F4912FB803CEE4DE140399D,12841,12,13,1,37,47,1897
28535,28535,F54ED9AF3F4912FB803CEE4DE140399D,11331,17,23,6,37,48,1898
28536,28536,23A496F5772D8BF78DF525393F93F8DB,42623,1,3,2,22,49,1149
28537,28537,23A496F5772D8BF78DF525393F93F8DB,42071,3,8,5,31,49,1599
28538,28538,23A496F5772D8BF78DF525393F93F8DB,42623,9,14,5,22,49,1149
28539,28539,23A496F5772D8BF78DF525393F93F8DB,42261,17,18,1,25,49,1299
28540,28540,23A496F5772D8BF78DF525393F93F8DB,10951,19,21,2,29,48,1498
28545,28545,9F0B4B6E77BE60EAA5CB4882CAB55218,13511,1,10,9,34,48,1748
28546,28546,9F0B4B6E77BE60EAA5CB4882CAB55218,42471,12,13,1,35,49,1799
28547,28547,9F0B4B6E77BE60EAA5CB4882CAB55218,10107,13,17,4,38,49,1949
28548,28548,9F0B4B6E77BE60EAA5CB4882CAB55218,43161,18,20,2,35,47,1797
28549,28549,9F0B4B6E77BE60EAA5CB4882CAB55218,10107,22,23,1,38,49,1949
28550,28550,2D6BB08D0028E1950DC24BE69D8E3BA3,42711,0,7,7,26,48,1348
28551,28551,2D6BB08D0028E1950DC24BE69D8E3BA3,42623,8,10,2,22,49,1149
28552,28552,2D6BB08D0028E1950DC24BE69D8E3BA3,10451,11,18,7,25,48,1298
28553,28553,2D6BB08D0028E1950DC24BE69D8E3BA3,10811,19,20,1,38,46,1946
28563,28563,221907A0B5FBDE67A1B2826B991290F1,11381,3,4,1,30,47,1547
28564,28564,221907A0B5FBDE67A1B2826B991290F1,11061,7,10,3,29,48,1498
28565,28565,221907A0B5FBDE67A1B2826B991290F1,11381,14,15,1,30,47,1547
28566,28566,221907A0B5FBDE67A1B2826B991290F1,12121,16,19,3,29,47,1497
28567,28567,221907A0B5FBDE67A1B2826B991290F1,11061,20,23,3,29,48,1498
28572,28572,19783D60B70DD47851602F72E0868D88,12381,0,13,13,32,48,1648
28573,28573,19783D60B70DD47851602F72E0868D88,11331,14,15,1,37,48,1898
28574,28574,19783D60B70DD47851602F72E0868D88,43311,16,23,7,31,48,1598
28578,28578,EB558A84961E1C47AC33D341B18F2B6E,13671,1,11,10,27,43,1393
28579,28579,EB558A84961E1C47AC33D341B18F2B6E,13314,12,13,1,31,39,1589
28580,28580,EB558A84961E1C47AC33D341B18F2B6E,13671,13,23,10,27,43,1393
28581,28581,1DFC063262F02B96AF96AED120E22A58,10411,0,8,8,36,48,1848
28582,28582,1DFC063262F02B96AF96AED120E22A58,11231,11,13,2,37,49,1899
28583,28583,1DFC063262F02B96AF96AED120E22A58,11591,13,14,1,36,49,1849
28584,28584,1DFC063262F02B96AF96AED120E22A58,11231,14,17,3,37,49,1899
28585,28585,1DFC063262F02B96AF96AED120E22A58,10411,18,23,5,36,48,1848
28586,28586,21D029E4FB71F3A5DA880019FDFB9BC1,12491,0,6,6,36,43,1843
28587,28587,21D029E4FB71F3A5DA880019FDFB9BC1,42151,8,9,1,35,45,1795
28588,28588,21D029E4FB71F3A5DA880019FDFB9BC1,12491,12,13,1,36,43,1843
28589,28589,21D029E4FB71F3A5DA880019FDFB9BC1,42151,16,19,3,35,45,1795
28590,28590,21D029E4FB71F3A5DA880019FDFB9BC1,12491,21,22,1,36,43,1843
28591,28591,9C2C2A9A5923C3E8476FE17BB2B155DD,19114,0,4,4,7,43,393
28592,28592,9C2C2A9A5923C3E8476FE17BB2B155DD,19021,4,5,1,10,45,545
28593,28593,9C2C2A9A5923C3E8476FE17BB2B155DD,12641,7,9,2,10,43,543
28594,28594,9C2C2A9A5923C3E8476FE17BB2B155DD,19114,11,23,12,7,43,393
28595,28595,705DFE0F0CF99753368D655C68C21E78,43011,4,6,2,40,42,2042
28596,28596,705DFE0F0CF99753368D655C68C21E78,12211,11,12,1,41,44,2094
28597,28597,705DFE0F0CF99753368D655C68C21E78,12221,12,22,10,43,44,2194
28598,28598,2F1F755AD0C3D64033AC7CD812D0FE51,10421,0,15,15,41,48,2098
28599,28599,2F1F755AD0C3D64033AC7CD812D0FE51,43161,16,18,2,35,47,1797
28600,28600,2F1F755AD0C3D64033AC7CD812D0FE51,11901,20,23,3,42,49,2149
28604,28604,B2DC586D2D86C625F826CC8D52546835,13951,1,6,5,47,45,2395
28605,28605,B2DC586D2D86C625F826CC8D52546835,13821,6,10,4,49,45,2495
28606,28606,B2DC586D2D86C625F826CC8D52546835,13951,11,12,1,47,45,2395
28607,28607,B2DC586D2D86C625F826CC8D52546835,11531,16,17,1,34,49,1749
28608,28608,B2DC586D2D86C625F826CC8D52546835,10111,18,22,4,37,47,1897
28615,28615,612F18F83615AD18C521C0260D4FB623,11914,0,6,6,37,48,1898
28616,28616,612F18F83615AD18C521C0260D4FB623,42581,7,10,3,38,48,1948
28617,28617,612F18F83615AD18C521C0260D4FB623,11914,11,13,2,37,48,1898
28618,28618,612F18F83615AD18C521C0260D4FB623,42581,14,15,1,38,48,1948
28619,28619,612F18F83615AD18C521C0260D4FB623,11914,18,23,5,37,48,1898
28626,28626,6A9C7C9C66DF263397058A158A48D198,12381,0,11,11,32,48,1648
28627,28627,6A9C7C9C66DF263397058A158A48D198,40341,14,17,3,23,49,1199
28628,28628,6A9C7C9C66DF263397058A158A48D198,10431,18,23,5,33,49,1699
28629,28629,62A2F5272230052AEB85DFD96BD0E354,42541,0,10,10,25,47,1297
28630,28630,62A2F5272230052AEB85DFD96BD0E354,10251,11,12,1,35,47,1797
28631,28631,62A2F5272230052AEB85DFD96BD0E354,10411,13,17,4,36,48,1848
28632,28632,62A2F5272230052AEB85DFD96BD0E354,10251,18,21,3,35,47,1797
28633,28633,3CF7B0916CDE9473EE3871FE908999F3,19901,0,8,8,7,44,394
28634,28634,3CF7B0916CDE9473EE3871FE908999F3,12921,10,17,7,9,41,491
28635,28635,3CF7B0916CDE9473EE3871FE908999F3,19901,20,23,3,7,44,394
28640,28640,015977F21CA69DACA3E876A5F028B2A4,43051,0,5,5,46,45,2345
28641,28641,015977F21CA69DACA3E876A5F028B2A4,13351,5,11,6,48,48,2448
28642,28642,015977F21CA69DACA3E876A5F028B2A4,43051,12,14,2,46,45,2345
28643,28643,015977F21CA69DACA3E876A5F028B2A4,13351,18,20,2,48,48,2448
28644,28644,015977F21CA69DACA3E876A5F028B2A4,43051,21,23,2,46,45,2345
28652,28652,E1B4D34F30518B1001C1CE57EBC5ED84,16233,0,8,8,5,15,265
28653,28653,E1B4D34F30518B1001C1CE57EBC5ED84,19844,10,11,1,8,20,420
28654,28654,E1B4D34F30518B1001C1CE57EBC5ED84,16233,12,16,4,5,15,265
28655,28655,E1B4D34F30518B1001C1CE57EBC5ED84,19351,20,21,1,2,18,118
28663,28663,478F01BCCD8ECC2639B5EA3CD060CD5E,11201,0,16,16,35,49,1799
28664,28664,478F01BCCD8ECC2639B5EA3CD060CD5E,11381,17,20,3,30,47,1547
28665,28665,478F01BCCD8ECC2639B5EA3CD060CD5E,43671,20,23,3,35,48,1798
28673,28673,30935E32EDAA8B6FE38680027A6AC16D,12641,0,2,2,10,43,543
28674,28674,30935E32EDAA8B6FE38680027A6AC16D,12921,2,4,2,9,41,491
28675,28675,30935E32EDAA8B6FE38680027A6AC16D,19181,5,8,3,8,40,440
28676,28676,30935E32EDAA8B6FE38680027A6AC16D,12921,10,12,2,9,41,491
28677,28677,30935E32EDAA8B6FE38680027A6AC16D,12641,16,18,2,10,43,543
28678,28678,30935E32EDAA8B6FE38680027A6AC16D,12921,20,21,1,9,41,491
28682,28682,890E28003097AE1252F2C7F02F9B8CC8,42531,1,11,10,31,45,1595
28683,28683,890E28003097AE1252F2C7F02F9B8CC8,12311,13,15,2,30,44,1544
28684,28684,890E28003097AE1252F2C7F02F9B8CC8,13911,19,21,2,39,46,1996
28685,28685,851B0DC09818756606A4B6B5AFE731B9,11914,0,2,2,37,48,1898
28686,28686,851B0DC09818756606A4B6B5AFE731B9,42221,2,4,2,38,48,1948
28687,28687,851B0DC09818756606A4B6B5AFE731B9,11914,4,12,8,37,48,1898
28688,28688,851B0DC09818756606A4B6B5AFE731B9,11201,15,18,3,35,49,1799
28689,28689,851B0DC09818756606A4B6B5AFE731B9,11074,20,21,1,37,47,1897
28690,28690,FB4682846D7AC5546629522DAEB65BE4,11851,0,7,7,13,47,697
28691,28691,FB4682846D7AC5546629522DAEB65BE4,19021,9,17,8,10,45,545
28692,28692,FB4682846D7AC5546629522DAEB65BE4,11571,19,22,3,13,46,696
28693,28693,62F6BE848412C7FADEB816AFD62C431F,15141,2,6,4,26,11,1311
28694,28694,62F6BE848412C7FADEB816AFD62C431F,16151,7,20,13,13,11,661
28695,28695,62F6BE848412C7FADEB816AFD62C431F,15114,21,23,2,22,16,1116
28703,28703,7B4E6126570CADEFC5C95EC455FF20E3,11914,0,4,4,37,48,1898
28704,28704,7B4E6126570CADEFC5C95EC455FF20E3,43361,8,9,1,38,48,1948
28705,28705,7B4E6126570CADEFC5C95EC455FF20E3,11914,10,15,5,37,48,1898
28706,28706,7B4E6126570CADEFC5C95EC455FF20E3,11921,16,17,1,38,48,1948
28707,28707,7B4E6126570CADEFC5C95EC455FF20E3,11914,18,23,5,37,48,1898
28717,28717,D92D00150BC27A9BD4FD19E6AAF05E52,11806,0,5,5,41,48,2098
28718,28718,D92D00150BC27A9BD4FD19E6AAF05E52,42271,6,15,9,40,47,2047
28719,28719,D92D00150BC27A9BD4FD19E6AAF05E52,11541,18,21,3,35,49,1799
28720,28720,D92D00150BC27A9BD4FD19E6AAF05E52,42271,22,23,1,40,47,2047
28721,28721,487C415045C076F1BAA7DB25A908AF05,13371,0,1,1,41,47,2097
28722,28722,487C415045C076F1BAA7DB25A908AF05,10107,12,13,1,38,49,1949
28723,28723,487C415045C076F1BAA7DB25A908AF05,40341,15,16,1,23,49,1199
28724,28724,487C415045C076F1BAA7DB25A908AF05,13941,17,21,4,41,47,2097
28725,28725,16B2F0D78BEB849442A93B3F29FB7F4E,42271,2,4,2,40,47,2047
28726,28726,16B2F0D78BEB849442A93B3F29FB7F4E,11806,9,10,1,41,48,2098
28727,28727,16B2F0D78BEB849442A93B3F29FB7F4E,12021,11,15,4,37,49,1899
28728,28728,16B2F0D78BEB849442A93B3F29FB7F4E,40171,16,17,1,38,48,1948
28729,28729,16B2F0D78BEB849442A93B3F29FB7F4E,11806,17,23,6,41,48,2098
28734,28734,D7F8F71ED9B8159734D8CFCB18871A01,13111,0,8,8,42,46,2146
28735,28735,D7F8F71ED9B8159734D8CFCB18871A01,43281,11,13,2,37,48,1898
28736,28736,D7F8F71ED9B8159734D8CFCB18871A01,13111,13,20,7,42,46,2146
28737,28737,D7F8F71ED9B8159734D8CFCB18871A01,12401,22,23,1,39,49,1999
28738,28738,4C8E92DBB85921608C1C92929A7A8C92,42521,0,6,6,31,47,1597
28739,28739,4C8E92DBB85921608C1C92929A7A8C92,10295,7,8,1,30,47,1547
28740,28740,4C8E92DBB85921608C1C92929A7A8C92,42521,11,16,5,31,47,1597
28741,28741,4C8E92DBB85921608C1C92929A7A8C92,11381,16,19,3,30,47,1547
28742,28742,4C8E92DBB85921608C1C92929A7A8C92,42521,21,23,2,31,47,1597
28743,28743,F7A05B3FECD253C9C578617425D22E9D,13351,0,6,6,48,48,2448
28744,28744,F7A05B3FECD253C9C578617425D22E9D,40302,8,10,2,40,49,2049
28745,28745,F7A05B3FECD253C9C578617425D22E9D,11701,11,12,1,43,48,2198
28746,28746,F7A05B3FECD253C9C578617425D22E9D,42601,12,14,2,44,48,2248
28747,28747,F7A05B3FECD253C9C578617425D22E9D,19114,16,17,1,7,43,393
28748,28748,F7A05B3FECD253C9C578617425D22E9D,13351,20,23,3,48,48,2448
28749,28749,F4795F76C84E6097830D18EC01423C7D,10901,0,7,7,35,48,1798
28750,28750,F4795F76C84E6097830D18EC01423C7D,11351,8,9,1,36,48,1848
28751,28751,F4795F76C84E6097830D18EC01423C7D,42921,9,18,9,33,47,1697
28752,28752,F4795F76C84E6097830D18EC01423C7D,10281,19,20,1,33,48,1698
28753,28753,F4795F76C84E6097830D18EC01423C7D,11481,22,23,1,41,48,2098
28754,28754,4DA21EF09DE00955AFF28F16D2698178,12792,0,6,6,34,30,1730
28755,28755,4DA21EF09DE00955AFF28F16D2698178,15391,6,7,1,35,26,1776
28756,28756,4DA21EF09DE00955AFF28F16D2698178,12792,9,14,5,34,30,1730
28757,28757,4DA21EF09DE00955AFF28F16D2698178,15184,15,17,2,29,22,1472
28758,28758,4DA21EF09DE00955AFF28F16D2698178,15391,18,23,5,35,26,1776
28762,28762,05A20A77E064FB17D426DE75FE90D3D6,13791,1,11,10,42,47,2147
28763,28763,05A20A77E064FB17D426DE75FE90D3D6,42971,12,18,6,43,49,2199
28764,28764,05A20A77E064FB17D426DE75FE90D3D6,11091,19,21,2,29,47,1497
28765,28765,05A20A77E064FB17D426DE75FE90D3D6,42971,22,23,1,43,49,2199
28770,28770,B4BA824D03B689E71343C29B23089A47,43451,1,2,1,37,40,1890
28771,28771,B4BA824D03B689E71343C29B23089A47,13461,2,3,1,39,44,1994
28772,28772,B4BA824D03B689E71343C29B23089A47,43451,8,11,3,37,40,1890
28773,28773,B4BA824D03B689E71343C29B23089A47,43011,12,14,2,40,42,2042
28774,28774,B4BA824D03B689E71343C29B23089A47,42864,19,21,2,38,44,1944
28775,28775,B4BA824D03B689E71343C29B23089A47,43011,21,23,2,40,42,2042
28780,28780,D8F61CF3289E3928FCE68B7F3A3EF9A7,43041,0,7,7,41,46,2096
28781,28781,D8F61CF3289E3928FCE68B7F3A3EF9A7,11074,7,18,11,37,47,1897
28782,28782,D8F61CF3289E3928FCE68B7F3A3EF9A7,43041,21,23,2,41,46,2096
28783,28783,691D67A032E65E82F40137DDC8A198BA,11481,0,6,6,41,48,2098
28784,28784,691D67A032E65E82F40137DDC8A198BA,11074,7,11,4,37,47,1897
28785,28785,691D67A032E65E82F40137DDC8A198BA,42631,13,15,2,43,45,2195
28786,28786,691D67A032E65E82F40137DDC8A198BA,12221,15,16,1,43,44,2194
28787,28787,691D67A032E65E82F40137DDC8A198BA,11805,20,23,3,41,48,2098
28788,28788,69A2BE2C8E8C7C266144086560BD5BC9,15321,0,7,7,29,26,1476
28789,28789,69A2BE2C8E8C7C266144086560BD5BC9,43121,7,17,10,25,27,1277
28790,28790,69A2BE2C8E8C7C266144086560BD5BC9,15321,18,23,5,29,26,1476
28791,28791,E645E5BB1A62A5A30FBD4EDD94F205D6,42371,0,7,7,34,46,1746
28792,28792,E645E5BB1A62A5A30FBD4EDD94F205D6,42121,8,9,1,26,49,1349
28793,28793,E645E5BB1A62A5A30FBD4EDD94F205D6,12401,12,13,1,39,49,1999
28794,28794,E645E5BB1A62A5A30FBD4EDD94F205D6,10511,14,15,1,35,46,1796
28795,28795,E645E5BB1A62A5A30FBD4EDD94F205D6,42371,17,23,6,34,46,1746
28804,28804,43FDBDEDEEB9A933C806C05A34BCE296,15411,0,2,2,44,27,2227
28805,28805,43FDBDEDEEB9A933C806C05A34BCE296,13251,2,5,3,48,28,2428
28806,28806,43FDBDEDEEB9A933C806C05A34BCE296,15411,9,10,1,44,27,2227
28807,28807,43FDBDEDEEB9A933C806C05A34BCE296,13251,12,14,2,48,28,2428
28808,28808,43FDBDEDEEB9A933C806C05A34BCE296,15411,15,23,8,44,27,2227
28809,28809,B289C6428E0D98B8D720F0FA5499A67A,15114,0,6,6,22,16,1116
28810,28810,B289C6428E0D98B8D720F0FA5499A67A,15271,7,15,8,14,20,720
28811,28811,B289C6428E0D98B8D720F0FA5499A67A,16231,16,17,1,11,15,565
28812,28812,B289C6428E0D98B8D720F0FA5499A67A,15271,19,23,4,14,20,720
28813,28813,D8FB972AAAC5DB0F06EEBA221E7E96BB,43051,0,6,6,46,45,2345
28814,28814,D8FB972AAAC5DB0F06EEBA221E7E96BB,12971,8,17,9,32,48,1648
28815,28815,D8FB972AAAC5DB0F06EEBA221E7E96BB,13951,21,23,2,47,45,2395
28819,28819,1078436CC9F31DFE63B8B6F9AEB69E32,11231,0,1,1,37,49,1899
28820,28820,1078436CC9F31DFE63B8B6F9AEB69E32,42151,3,8,5,35,45,1795
28821,28821,1078436CC9F31DFE63B8B6F9AEB69E32,42871,8,10,2,30,45,1545
28822,28822,1078436CC9F31DFE63B8B6F9AEB69E32,42151,15,18,3,35,45,1795
28823,28823,1078436CC9F31DFE63B8B6F9AEB69E32,40341,21,22,1,23,49,1199
28824,28824,53DE27C3988F5D22526FCC360F8F3A99,11321,0,6,6,31,46,1596
28825,28825,53DE27C3988F5D22526FCC360F8F3A99,10716,8,9,1,30,46,1546
28826,28826,53DE27C3988F5D22526FCC360F8F3A99,11321,13,14,1,31,46,1596
28827,28827,53DE27C3988F5D22526FCC360F8F3A99,42523,15,17,2,31,47,1597
28828,28828,53DE27C3988F5D22526FCC360F8F3A99,11324,17,23,6,31,46,1596
28829,28829,04E25EABAF57B3731144C024B2F68618,13341,2,3,1,44,45,2245
28830,28830,04E25EABAF57B3731144C024B2F68618,42631,4,10,6,43,45,2195
28831,28831,04E25EABAF57B3731144C024B2F68618,13341,15,16,1,44,45,2245
28832,28832,04E25EABAF57B3731144C024B2F68618,42631,17,19,2,43,45,2195
28833,28833,04E25EABAF57B3731144C024B2F68618,13341,19,21,2,44,45,2245
28834,28834,04E25EABAF57B3731144C024B2F68618,42631,21,22,1,43,45,2195
28835,28835,4A8B6D4A591CC4F1D4132A3A7DF0E4D7,42141,0,4,4,32,47,1647
28836,28836,4A8B6D4A591CC4F1D4132A3A7DF0E4D7,10634,8,13,5,27,45,1395
28837,28837,4A8B6D4A591CC4F1D4132A3A7DF0E4D7,43761,15,16,1,32,47,1647
28838,28838,4A8B6D4A591CC4F1D4132A3A7DF0E4D7,42521,19,20,1,31,47,1597
28842,28842,09757EDFE7795D1E67DCE5C4439A4727,12521,0,13,13,35,41,1791
28843,28843,09757EDFE7795D1E67DCE5C4439A4727,13041,14,16,2,30,37,1537
28844,28844,09757EDFE7795D1E67DCE5C4439A4727,12521,16,23,7,35,41,1791
28845,28845,865F5C790EEA2B073A2DFB218885D09A,10161,0,18,18,35,49,1799
28846,28846,865F5C790EEA2B073A2DFB218885D09A,42501,19,21,2,28,47,1447
28847,28847,865F5C790EEA2B073A2DFB218885D09A,10161,22,23,1,35,49,1799
28872,28872,83020B0F42F086D077C7C591731949A4,10724,0,9,9,32,48,1648
28873,28873,83020B0F42F086D077C7C591731949A4,11531,10,11,1,34,49,1749
28874,28874,83020B0F42F086D077C7C591731949A4,12601,13,14,1,25,47,1297
28875,28875,83020B0F42F086D077C7C591731949A4,11531,21,22,1,34,49,1749
28879,28879,998B80F631E2139F748EA594E6602CEA,12141,0,13,13,42,45,2145
28880,28880,998B80F631E2139F748EA594E6602CEA,12511,14,16,2,39,47,1997
28881,28881,998B80F631E2139F748EA594E6602CEA,10651,19,21,2,36,49,1849
28882,28882,5513A4EBEB51AF5647B29C75D8B8CC2C,10281,0,9,9,33,48,1698
28883,28883,5513A4EBEB51AF5647B29C75D8B8CC2C,13314,17,18,1,31,39,1589
28884,28884,5513A4EBEB51AF5647B29C75D8B8CC2C,12521,21,22,1,35,41,1791
28895,28895,C587B8BBA49D2BF4E222CE1A0182D385,42583,0,8,8,40,48,2048
28896,28896,C587B8BBA49D2BF4E222CE1A0182D385,15411,14,15,1,44,27,2227
28897,28897,C587B8BBA49D2BF4E222CE1A0182D385,11781,16,20,4,38,49,1949
28898,28898,C587B8BBA49D2BF4E222CE1A0182D385,40691,22,23,1,42,48,2148
28899,28899,F371094BE40ABC55A2290DBE1D2E2B40,11001,0,12,12,42,47,2147
28900,28900,F371094BE40ABC55A2290DBE1D2E2B40,40211,15,17,2,36,49,1849
28901,28901,F371094BE40ABC55A2290DBE1D2E2B40,11001,18,23,5,42,47,2147
28905,28905,23A21A73FEBD9CCFAF6CD9924910EBC0,10901,0,8,8,35,48,1798
28906,28906,23A21A73FEBD9CCFAF6CD9924910EBC0,10921,12,14,2,43,48,2198
28907,28907,23A21A73FEBD9CCFAF6CD9924910EBC0,42161,21,22,1,36,47,1847
28908,28908,A5BFF32240AF511BF31ADB547FFA4DAD,11491,0,7,7,36,47,1847
28909,28909,A5BFF32240AF511BF31ADB547FFA4DAD,12381,8,13,5,32,48,1648
28910,28910,A5BFF32240AF511BF31ADB547FFA4DAD,11491,13,23,10,36,47,1847
28914,28914,F4F868B9360D29EF169CCB1C386B42DC,10351,9,11,2,28,45,1445
28915,28915,F4F868B9360D29EF169CCB1C386B42DC,12601,13,14,1,25,47,1297
28916,28916,F4F868B9360D29EF169CCB1C386B42DC,10351,15,17,2,28,45,1445
28917,28917,F4F868B9360D29EF169CCB1C386B42DC,11201,18,19,1,35,49,1799
28918,28918,4FA7E2AF35091649A8D61648BF92F5C0,42581,0,7,7,38,48,1948
28919,28919,4FA7E2AF35091649A8D61648BF92F5C0,10471,7,9,2,37,48,1898
28920,28920,4FA7E2AF35091649A8D61648BF92F5C0,42581,12,14,2,38,48,1948
28921,28921,4FA7E2AF35091649A8D61648BF92F5C0,10471,14,18,4,37,48,1898
28922,28922,4FA7E2AF35091649A8D61648BF92F5C0,10381,21,22,1,31,49,1599
28936,28936,3A3E30929F956029CA3F3618BEC4878A,12641,0,6,6,10,43,543
28937,28937,3A3E30929F956029CA3F3618BEC4878A,19111,8,9,1,9,45,495
28938,28938,3A3E30929F956029CA3F3618BEC4878A,12641,11,13,2,10,43,543
28939,28939,3A3E30929F956029CA3F3618BEC4878A,12731,15,17,2,22,40,1140
28940,28940,3A3E30929F956029CA3F3618BEC4878A,12641,20,22,2,10,43,543
28944,28944,E0F3A68E2935541E84AD4E1526A976E8,42281,5,9,4,40,48,2048
28945,28945,E0F3A68E2935541E84AD4E1526A976E8,13381,10,14,4,39,47,1997
28946,28946,E0F3A68E2935541E84AD4E1526A976E8,11631,18,19,1,12,49,649
28950,28950,2B393DCEE96CA0B48803BDF9B1BBDE4E,10151,0,8,8,34,47,1747
28951,28951,2B393DCEE96CA0B48803BDF9B1BBDE4E,11481,12,16,4,41,48,2098
28952,28952,2B393DCEE96CA0B48803BDF9B1BBDE4E,10151,18,23,5,34,47,1747
28953,28953,21B656E93C25F88D6CD1C23ADB7656C7,11011,1,8,7,39,49,1999
28954,28954,21B656E93C25F88D6CD1C23ADB7656C7,42491,10,14,4,32,46,1646
28955,28955,21B656E93C25F88D6CD1C23ADB7656C7,16261,18,23,5,3,3,153
28962,28962,BC7E26CA9C636872D72F8E2051181A1A,42231,0,6,6,37,46,1896
28963,28963,BC7E26CA9C636872D72F8E2051181A1A,13951,7,9,2,47,45,2395
28964,28964,BC7E26CA9C636872D72F8E2051181A1A,42231,12,13,1,37,46,1896
28965,28965,BC7E26CA9C636872D72F8E2051181A1A,43101,15,17,2,46,40,2340
28966,28966,BC7E26CA9C636872D72F8E2051181A1A,42231,19,23,4,37,46,1896
28967,28967,2CB194F5C88F15739C3E83AF93DF02DF,10281,0,8,8,33,48,1698
28968,28968,2CB194F5C88F15739C3E83AF93DF02DF,11541,9,11,2,35,49,1799
28969,28969,2CB194F5C88F15739C3E83AF93DF02DF,10721,11,13,2,31,48,1598
28970,28970,2CB194F5C88F15739C3E83AF93DF02DF,12561,14,15,1,45,43,2293
28971,28971,2CB194F5C88F15739C3E83AF93DF02DF,11161,19,21,2,32,48,1648
28972,28972,92C01AF584EB3A0D72BDA461E00D5EAF,13041,8,12,4,30,37,1537
28973,28973,92C01AF584EB3A0D72BDA461E00D5EAF,11151,14,15,1,30,48,1548
28974,28974,92C01AF584EB3A0D72BDA461E00D5EAF,11061,18,19,1,29,48,1498
28982,28982,6C085935D99355C13FA9E34597239F44,13911,0,7,7,39,46,1996
28983,28983,6C085935D99355C13FA9E34597239F44,42151,8,20,12,35,45,1795
28984,28984,6C085935D99355C13FA9E34597239F44,13911,21,23,2,39,46,1996
28985,28985,AF3BB2EB266D8BDC31553ED7C05B56FE,12731,6,7,1,22,40,1140
28986,28986,AF3BB2EB266D8BDC31553ED7C05B56FE,42371,8,9,1,34,46,1746
28987,28987,AF3BB2EB266D8BDC31553ED7C05B56FE,12731,10,11,1,22,40,1140
28988,28988,AF3BB2EB266D8BDC31553ED7C05B56FE,13671,14,22,8,27,43,1393
28992,28992,790457C5143568F0FC168A94781493E9,19114,0,6,6,7,43,393
28993,28993,790457C5143568F0FC168A94781493E9,12921,7,8,1,9,41,491
28994,28994,790457C5143568F0FC168A94781493E9,12641,9,10,1,10,43,543
28995,28995,790457C5143568F0FC168A94781493E9,12921,12,17,5,9,41,491
28996,28996,790457C5143568F0FC168A94781493E9,19114,19,23,4,7,43,393
28997,28997,4E48DD9D727793AAE5242285C8B10E39,11061,0,10,10,29,48,1498
28998,28998,4E48DD9D727793AAE5242285C8B10E39,11201,15,16,1,35,49,1799
28999,28999,4E48DD9D727793AAE5242285C8B10E39,11061,21,23,2,29,48,1498
29000,29000,A178FA23835F7340CB9C26A1AEC90741,43501,1,9,8,27,48,1398
29001,29001,A178FA23835F7340CB9C26A1AEC90741,10221,12,13,1,34,49,1749
29002,29002,A178FA23835F7340CB9C26A1AEC90741,42521,13,23,10,31,47,1597
29003,29003,4EE541C2C77ED64C3476846B8EC5E510,19801,0,1,1,19,26,976
29004,29004,4EE541C2C77ED64C3476846B8EC5E510,43081,4,5,1,27,28,1378
29005,29005,4EE541C2C77ED64C3476846B8EC5E510,43121,7,8,1,25,27,1277
29006,29006,4EE541C2C77ED64C3476846B8EC5E510,19801,8,10,2,19,26,976
29007,29007,4EE541C2C77ED64C3476846B8EC5E510,19431,15,20,5,8,29,429
29008,29008,4EE541C2C77ED64C3476846B8EC5E510,43081,21,22,1,27,28,1378
29009,29009,5286A29EF2DEDE42572B77FE3AFBCCAE,12121,0,8,8,29,47,1497
29010,29010,5286A29EF2DEDE42572B77FE3AFBCCAE,11381,11,12,1,30,47,1547
29011,29011,5286A29EF2DEDE42572B77FE3AFBCCAE,12121,13,16,3,29,47,1497
29012,29012,5286A29EF2DEDE42572B77FE3AFBCCAE,10221,18,20,2,34,49,1749
29026,29026,9F569681847AE1CB91DC5B95636EE88A,19021,2,3,1,10,45,545
29027,29027,9F569681847AE1CB91DC5B95636EE88A,43021,5,15,10,16,43,843
29028,29028,9F569681847AE1CB91DC5B95636EE88A,19021,16,17,1,10,45,545
29029,29029,9F569681847AE1CB91DC5B95636EE88A,11471,19,23,4,12,48,648
29039,29039,BDE131E3985277A452A63ED13E5958AD,11381,0,5,5,30,47,1547
29040,29040,BDE131E3985277A452A63ED13E5958AD,43761,7,8,1,32,47,1647
29041,29041,BDE131E3985277A452A63ED13E5958AD,43971,12,13,1,30,48,1548
29042,29042,BDE131E3985277A452A63ED13E5958AD,43311,16,17,1,31,48,1598
29043,29043,BDE131E3985277A452A63ED13E5958AD,11381,20,23,3,30,47,1547
29044,29044,4B5119258FB3482B746B53277561992F,10061,0,4,4,20,46,1046
29045,29045,4B5119258FB3482B746B53277561992F,12051,5,7,2,20,47,1047
29046,29046,4B5119258FB3482B746B53277561992F,12581,9,11,2,24,48,1248
29047,29047,4B5119258FB3482B746B53277561992F,12601,12,13,1,25,47,1297
29048,29048,4B5119258FB3482B746B53277561992F,12581,17,18,1,24,48,1248
29049,29049,4B5119258FB3482B746B53277561992F,12601,20,21,1,25,47,1297
29057,29057,C01D7F4C525517694A04D5EAA5AD2420,10611,0,6,6,32,48,1648
29058,29058,C01D7F4C525517694A04D5EAA5AD2420,13911,8,12,4,39,46,1996
29059,29059,C01D7F4C525517694A04D5EAA5AD2420,10611,13,23,10,32,48,1648
29060,29060,7F73EEE1198B300F5190B9A740E251E3,12491,0,5,5,36,43,1843
29061,29061,7F73EEE1198B300F5190B9A740E251E3,11261,6,20,14,36,46,1846
29062,29062,7F73EEE1198B300F5190B9A740E251E3,13911,21,23,2,39,46,1996
29063,29063,E6C0B95DF19745278BB8C4C83FE2A959,12401,0,12,12,39,49,1999
29064,29064,E6C0B95DF19745278BB8C4C83FE2A959,11531,15,16,1,34,49,1749
29065,29065,E6C0B95DF19745278BB8C4C83FE2A959,13651,18,21,3,30,47,1547
29070,29070,9977264E5988BFD7801E2DD236EF4D59,12514,0,3,3,38,47,1947
29071,29071,9977264E5988BFD7801E2DD236EF4D59,42511,4,9,5,37,47,1897
29072,29072,9977264E5988BFD7801E2DD236EF4D59,12514,9,17,8,38,47,1947
29073,29073,9977264E5988BFD7801E2DD236EF4D59,10841,18,20,2,37,47,1897
29074,29074,9977264E5988BFD7801E2DD236EF4D59,12514,20,23,3,38,47,1947
29075,29075,0A8F7479198CE1702D41784AD33AF3BC,13121,0,8,8,38,46,1946
29076,29076,0A8F7479198CE1702D41784AD33AF3BC,40302,9,11,2,40,49,2049
29077,29077,0A8F7479198CE1702D41784AD33AF3BC,13121,13,23,10,38,46,1946
29099,29099,2D0988A9AAF5B7E7801809924C7B16D4,11911,0,16,16,37,48,1898
29100,29100,2D0988A9AAF5B7E7801809924C7B16D4,10531,17,18,1,34,46,1746
29101,29101,2D0988A9AAF5B7E7801809924C7B16D4,11271,20,23,3,37,48,1898
29115,29115,C2EED89F322B08EE68257E7620F2CAA6,13841,0,8,8,40,46,2046
29116,29116,C2EED89F322B08EE68257E7620F2CAA6,42381,9,11,2,39,41,1991
29117,29117,C2EED89F322B08EE68257E7620F2CAA6,13841,20,23,3,40,46,2046
29124,29124,073EBE93660DAEAA6A02C36811E4AA2E,12381,0,13,13,32,48,1648
29125,29125,073EBE93660DAEAA6A02C36811E4AA2E,42191,13,15,2,38,49,1949
29126,29126,073EBE93660DAEAA6A02C36811E4AA2E,10471,16,17,1,37,48,1898
29127,29127,073EBE93660DAEAA6A02C36811E4AA2E,12381,21,23,2,32,48,1648
29139,29139,883C2BBA1D154EE36C01769727615287,42623,1,13,12,22,49,1149
29140,29140,883C2BBA1D154EE36C01769727615287,43761,16,17,1,32,47,1647
29141,29141,883C2BBA1D154EE36C01769727615287,42623,21,23,2,22,49,1149
29142,29142,3D39BFF619D555933510C63A4C03CAF1,13121,0,7,7,38,46,1946
29143,29143,3D39BFF619D555933510C63A4C03CAF1,13101,9,10,1,40,47,2047
29144,29144,3D39BFF619D555933510C63A4C03CAF1,42161,14,15,1,36,47,1847
29145,29145,3D39BFF619D555933510C63A4C03CAF1,11201,16,18,2,35,49,1799
29146,29146,3A1B49B490CA109FD4D5251F0C86C9CB,43581,0,14,14,33,48,1698
29147,29147,3A1B49B490CA109FD4D5251F0C86C9CB,12601,15,17,2,25,47,1297
29148,29148,3A1B49B490CA109FD4D5251F0C86C9CB,43581,18,23,5,33,48,1698
29149,29149,7B7808F449A709BA37633BF3E740E9A3,43051,0,5,5,46,45,2345
29150,29150,7B7808F449A709BA37633BF3E740E9A3,12211,7,20,13,41,44,2094
29151,29151,7B7808F449A709BA37633BF3E740E9A3,43051,22,23,1,46,45,2345
29152,29152,BC71A128CC1D1FD204F1FA3A371EA53A,43021,0,6,6,16,43,843
29153,29153,BC71A128CC1D1FD204F1FA3A371EA53A,12921,7,17,10,9,41,491
29154,29154,BC71A128CC1D1FD204F1FA3A371EA53A,43021,18,23,5,16,43,843
29161,29161,2ED0EAEC5E72F7DC65DFDFB4B66840DD,42864,1,7,6,38,44,1944
29162,29162,2ED0EAEC5E72F7DC65DFDFB4B66840DD,11261,8,11,3,36,46,1846
29163,29163,2ED0EAEC5E72F7DC65DFDFB4B66840DD,42321,12,18,6,43,47,2197
29168,29168,9DEEF19394CBDCCB625461D4CDDE2CD3,42941,0,7,7,37,47,1897
29169,29169,9DEEF19394CBDCCB625461D4CDDE2CD3,42201,9,11,2,43,46,2196
29170,29170,9DEEF19394CBDCCB625461D4CDDE2CD3,13341,15,17,2,44,45,2245
29171,29171,9DEEF19394CBDCCB625461D4CDDE2CD3,42941,19,23,4,37,47,1897
29172,29172,612F300BEBAF004C161982E666E74C49,42031,0,13,13,40,46,2046
29173,29173,612F300BEBAF004C161982E666E74C49,10251,14,16,2,35,47,1797
29174,29174,612F300BEBAF004C161982E666E74C49,11481,21,23,2,41,48,2098
29179,29179,85113926FD58DF2481DE297BC312E23D,10161,0,4,4,35,49,1799
29180,29180,85113926FD58DF2481DE297BC312E23D,10221,5,6,1,34,49,1749
29181,29181,85113926FD58DF2481DE297BC312E23D,10161,7,13,6,35,49,1799
29182,29182,85113926FD58DF2481DE297BC312E23D,15404,16,18,2,40,24,2024
29183,29183,85113926FD58DF2481DE297BC312E23D,15661,18,19,1,36,26,1826
29184,29184,85113926FD58DF2481DE297BC312E23D,10161,21,22,1,35,49,1799
29185,29185,286A389F0D464801789628A432DEF43F,42523,9,12,3,31,47,1597
29186,29186,286A389F0D464801789628A432DEF43F,15304,14,16,2,39,17,1967
29187,29187,286A389F0D464801789628A432DEF43F,15571,20,22,2,37,19,1869
29191,29191,9E8650B76E9047B63AD694EBC9D1BFBC,42321,0,1,1,43,47,2197
29192,29192,9E8650B76E9047B63AD694EBC9D1BFBC,11381,5,16,11,30,47,1547
29193,29193,9E8650B76E9047B63AD694EBC9D1BFBC,12311,17,19,2,30,44,1544
29194,29194,53493041487B5321836147FAAD536213,10661,0,2,2,37,49,1899
29195,29195,53493041487B5321836147FAAD536213,11074,3,8,5,37,47,1897
29196,29196,53493041487B5321836147FAAD536213,13101,13,19,6,40,47,2047
29200,29200,5AF7A250F769DD424B6F153B49B360AA,10901,0,7,7,35,48,1798
29201,29201,5AF7A250F769DD424B6F153B49B360AA,10501,9,11,2,22,46,1146
29202,29202,5AF7A250F769DD424B6F153B49B360AA,12601,11,16,5,25,47,1297
29203,29203,5AF7A250F769DD424B6F153B49B360AA,10901,17,22,5,35,48,1798
29204,29204,B304D2AD98C7DE24CAE6DD0DA65095F0,10431,0,6,6,33,49,1699
29205,29205,B304D2AD98C7DE24CAE6DD0DA65095F0,43581,7,9,2,33,48,1698
29206,29206,B304D2AD98C7DE24CAE6DD0DA65095F0,42491,9,10,1,32,46,1646
29207,29207,B304D2AD98C7DE24CAE6DD0DA65095F0,43581,11,17,6,33,48,1698
29208,29208,B304D2AD98C7DE24CAE6DD0DA65095F0,10431,18,23,5,33,49,1699
29209,29209,4D5F3AD35DC755EFFA8D428280AF81F0,12514,0,2,2,38,47,1947
29210,29210,4D5F3AD35DC755EFFA8D428280AF81F0,42491,3,4,1,32,46,1646
29211,29211,4D5F3AD35DC755EFFA8D428280AF81F0,12131,5,6,1,32,47,1647
29212,29212,4D5F3AD35DC755EFFA8D428280AF81F0,10107,8,14,6,38,49,1949
29213,29213,4D5F3AD35DC755EFFA8D428280AF81F0,11074,16,22,6,37,47,1897
29214,29214,34FB5BF239A7B5016E3CA81F47968839,42161,3,6,3,36,47,1847
29215,29215,34FB5BF239A7B5016E3CA81F47968839,43161,6,8,2,35,47,1797
29216,29216,34FB5BF239A7B5016E3CA81F47968839,43731,10,11,1,34,47,1747
29217,29217,34FB5BF239A7B5016E3CA81F47968839,42161,11,12,1,36,47,1847
29218,29218,34FB5BF239A7B5016E3CA81F47968839,40961,15,19,4,35,47,1797
29219,29219,34FB5BF239A7B5016E3CA81F47968839,42161,21,22,1,36,47,1847
29224,29224,F64DBF6F397EABD21E62990EB1C5953F,11281,1,3,2,27,40,1390
29225,29225,F64DBF6F397EABD21E62990EB1C5953F,12731,3,7,4,22,40,1140
29226,29226,F64DBF6F397EABD21E62990EB1C5953F,12521,9,23,14,35,41,1791
29227,29227,F5CAB8F803ECE6BB91E5E9B3677179B2,42401,0,7,7,36,47,1847
29228,29228,F5CAB8F803ECE6BB91E5E9B3677179B2,11481,10,11,1,41,48,2098
29229,29229,F5CAB8F803ECE6BB91E5E9B3677179B2,11491,12,13,1,36,47,1847
29230,29230,F5CAB8F803ECE6BB91E5E9B3677179B2,42921,13,18,5,33,47,1697
29231,29231,F5CAB8F803ECE6BB91E5E9B3677179B2,10111,19,23,4,37,47,1897
29235,29235,99A92AD24D04D2EBCBD0E2108B572F74,11061,0,2,2,29,48,1498
29236,29236,99A92AD24D04D2EBCBD0E2108B572F74,10721,3,6,3,31,48,1598
29237,29237,99A92AD24D04D2EBCBD0E2108B572F74,11061,11,14,3,29,48,1498
29238,29238,99A92AD24D04D2EBCBD0E2108B572F74,11151,16,18,2,30,48,1548
29239,29239,99A92AD24D04D2EBCBD0E2108B572F74,11061,18,23,5,29,48,1498
29240,29240,0A252836FA6DFCFDFC50B5267919BF05,43021,0,5,5,16,43,843
29241,29241,0A252836FA6DFCFDFC50B5267919BF05,12921,6,7,1,9,41,491
29242,29242,0A252836FA6DFCFDFC50B5267919BF05,43021,10,23,13,16,43,843
29243,29243,D5D027DEC2E15CD439B6E37A42DFD8C1,43021,0,6,6,16,43,843
29244,29244,D5D027DEC2E15CD439B6E37A42DFD8C1,12921,8,9,1,9,41,491
29245,29245,D5D027DEC2E15CD439B6E37A42DFD8C1,43021,13,17,4,16,43,843
29246,29246,D5D027DEC2E15CD439B6E37A42DFD8C1,12921,17,22,5,9,41,491
29247,29247,439D8CB010A4086802C0243322BA6C31,11061,0,7,7,29,48,1498
29248,29248,439D8CB010A4086802C0243322BA6C31,40343,12,15,3,24,49,1249
29249,29249,439D8CB010A4086802C0243322BA6C31,11061,18,23,5,29,48,1498
29250,29250,3473FA09F0017B3BD24476C962AE1520,13314,0,6,6,31,39,1589
29251,29251,3473FA09F0017B3BD24476C962AE1520,12521,8,18,10,35,41,1791
29252,29252,3473FA09F0017B3BD24476C962AE1520,43451,18,19,1,37,40,1890
29253,29253,3473FA09F0017B3BD24476C962AE1520,13314,21,22,1,31,39,1589
29258,29258,EC89DE3B46364353FB59FBDB06C949AD,10107,0,1,1,38,49,1949
29259,29259,EC89DE3B46364353FB59FBDB06C949AD,13411,12,13,1,49,42,2492
29260,29260,EC89DE3B46364353FB59FBDB06C949AD,10107,14,18,4,38,49,1949
29274,29274,9F08D51AB5A713D9DA81349F9F08E5F1,42461,0,15,15,45,47,2297
29275,29275,9F08D51AB5A713D9DA81349F9F08E5F1,10781,16,17,1,35,47,1797
29276,29276,9F08D51AB5A713D9DA81349F9F08E5F1,41007,18,19,1,37,47,1897
29277,29277,2FCC231DE348255A3F9CDA8D77EEA7DC,12581,0,5,5,24,48,1248
29278,29278,2FCC231DE348255A3F9CDA8D77EEA7DC,12051,5,10,5,20,47,1047
29279,29279,2FCC231DE348255A3F9CDA8D77EEA7DC,12581,10,23,13,24,48,1248
29280,29280,B628586ACCA037821F9C53B9BF884987,11151,0,8,8,30,48,1548
29281,29281,B628586ACCA037821F9C53B9BF884987,40341,18,19,1,23,49,1199
29282,29282,B628586ACCA037821F9C53B9BF884987,11151,21,23,2,30,48,1548
29283,29283,CAAAD4CB5A4D253C42859C8EEFB3CB6E,42051,0,7,7,42,48,2148
29284,29284,CAAAD4CB5A4D253C42859C8EEFB3CB6E,10491,9,10,1,33,48,1698
29285,29285,CAAAD4CB5A4D253C42859C8EEFB3CB6E,11381,12,13,1,30,47,1547
29286,29286,CAAAD4CB5A4D253C42859C8EEFB3CB6E,43761,15,16,1,32,47,1647
29287,29287,CAAAD4CB5A4D253C42859C8EEFB3CB6E,10281,16,18,2,33,48,1698
29288,29288,CAAAD4CB5A4D253C42859C8EEFB3CB6E,42051,20,23,3,42,48,2148
29289,29289,87B1169D5A9BB025C6A10231CEED2118,19621,0,4,4,5,46,296
29290,29290,87B1169D5A9BB025C6A10231CEED2118,11631,6,7,1,12,49,649
29291,29291,87B1169D5A9BB025C6A10231CEED2118,19621,9,16,7,5,46,296
29292,29292,87B1169D5A9BB025C6A10231CEED2118,11861,17,23,6,32,47,1647
29297,29297,B4055019E788AD750EC06C6167DF7EAA,40673,2,9,7,36,48,1848
29298,29298,B4055019E788AD750EC06C6167DF7EAA,42501,10,13,3,28,47,1447
29299,29299,B4055019E788AD750EC06C6167DF7EAA,11231,14,18,4,37,49,1899
29300,29300,B4055019E788AD750EC06C6167DF7EAA,10411,21,22,1,36,48,1848
29301,29301,F8584A5277683398A2423E9367C858A2,11521,0,6,6,41,48,2098
29302,29302,F8584A5277683398A2423E9367C858A2,11781,15,16,1,38,49,1949
29303,29303,F8584A5277683398A2423E9367C858A2,10621,17,19,2,41,49,2099
29304,29304,F8584A5277683398A2423E9367C858A2,10411,20,22,2,36,48,1848
29305,29305,F4C8F856DD638BBA75F52C720E10C05D,12921,0,7,7,9,41,491
29306,29306,F4C8F856DD638BBA75F52C720E10C05D,43644,8,9,1,14,38,738
29307,29307,F4C8F856DD638BBA75F52C720E10C05D,12921,11,13,2,9,41,491
29308,29308,F4C8F856DD638BBA75F52C720E10C05D,43644,16,17,1,14,38,738
29309,29309,F4C8F856DD638BBA75F52C720E10C05D,12641,18,19,1,10,43,543
29310,29310,F4C8F856DD638BBA75F52C720E10C05D,12921,21,23,2,9,41,491
29311,29311,189940572A21819E762822485B53A141,10271,0,16,16,37,46,1896
29312,29312,189940572A21819E762822485B53A141,11061,17,19,2,29,48,1498
29313,29313,189940572A21819E762822485B53A141,43971,20,21,1,30,48,1548
29314,29314,145E734E186950C5FCF9FF61BBA7968A,11321,0,1,1,31,46,1596
29315,29315,145E734E186950C5FCF9FF61BBA7968A,42371,5,6,1,34,46,1746
29316,29316,145E734E186950C5FCF9FF61BBA7968A,42161,9,20,11,36,47,1847
29321,29321,70BC072844C7CA9E90555B310CFF3C22,10511,0,1,1,35,46,1796
29322,29322,70BC072844C7CA9E90555B310CFF3C22,13601,4,11,7,34,47,1747
29323,29323,70BC072844C7CA9E90555B310CFF3C22,11081,12,14,2,35,46,1796
29324,29324,70BC072844C7CA9E90555B310CFF3C22,43731,15,17,2,34,47,1747
29325,29325,70BC072844C7CA9E90555B310CFF3C22,11081,18,22,4,35,46,1796
29326,29326,70BC072844C7CA9E90555B310CFF3C22,43731,22,23,1,34,47,1747
29327,29327,F7F6E311089E545E2ADE21E1CFF4D206,40636,0,1,1,35,48,1798
29328,29328,F7F6E311089E545E2ADE21E1CFF4D206,11861,1,7,6,32,47,1647
29329,29329,F7F6E311089E545E2ADE21E1CFF4D206,42921,7,9,2,33,47,1697
29330,29330,F7F6E311089E545E2ADE21E1CFF4D206,43761,18,19,1,32,47,1647
29331,29331,F7F6E311089E545E2ADE21E1CFF4D206,40636,21,22,1,35,48,1798
29332,29332,11C5ACA60B0246DE7069023057E8285F,11381,0,2,2,30,47,1547
29333,29333,11C5ACA60B0246DE7069023057E8285F,11061,2,3,1,29,48,1498
29334,29334,11C5ACA60B0246DE7069023057E8285F,11381,7,9,2,30,47,1547
29335,29335,11C5ACA60B0246DE7069023057E8285F,11061,14,15,1,29,48,1498
29336,29336,11C5ACA60B0246DE7069023057E8285F,11381,16,22,6,30,47,1547
29340,29340,1A4239438BAE2C7F83F71D8DE65545B2,11331,0,10,10,37,48,1898
29341,29341,1A4239438BAE2C7F83F71D8DE65545B2,16181,14,18,4,4,2,202
29342,29342,1A4239438BAE2C7F83F71D8DE65545B2,12841,20,22,2,37,47,1897
29353,29353,A553D674E6ADCEEE9DF6E0981719FE7C,43341,0,9,9,41,46,2096
29354,29354,A553D674E6ADCEEE9DF6E0981719FE7C,10601,10,12,2,39,47,1997
29355,29355,A553D674E6ADCEEE9DF6E0981719FE7C,42031,13,14,1,40,46,2046
29356,29356,A553D674E6ADCEEE9DF6E0981719FE7C,43341,14,17,3,41,46,2096
29357,29357,A553D674E6ADCEEE9DF6E0981719FE7C,10251,18,22,4,35,47,1797
29361,29361,0DFD98C5BF618352145AEF64606DF221,10251,1,3,2,35,47,1797
29362,29362,0DFD98C5BF618352145AEF64606DF221,40637,6,7,1,36,47,1847
29363,29363,0DFD98C5BF618352145AEF64606DF221,10251,7,11,4,35,47,1797
29364,29364,0DFD98C5BF618352145AEF64606DF221,42161,12,16,4,36,47,1847
29365,29365,0DFD98C5BF618352145AEF64606DF221,10251,17,23,6,35,47,1797
29366,29366,1A5DEB007188BBCFFE665C75C024CDE9,42531,0,7,7,31,45,1595
29367,29367,1A5DEB007188BBCFFE665C75C024CDE9,12311,9,11,2,30,44,1544
29368,29368,1A5DEB007188BBCFFE665C75C024CDE9,42531,12,13,1,31,45,1595
29369,29369,1A5DEB007188BBCFFE665C75C024CDE9,13711,16,22,6,38,46,1946
29370,29370,135EF939D99CED11694D71795A5772B0,19031,0,9,9,1,42,92
29371,29371,135EF939D99CED11694D71795A5772B0,12641,10,11,1,10,43,543
29372,29372,135EF939D99CED11694D71795A5772B0,19031,11,13,2,1,42,92
29373,29373,135EF939D99CED11694D71795A5772B0,12641,14,19,5,10,43,543
29374,29374,135EF939D99CED11694D71795A5772B0,19031,20,23,3,1,42,92
29379,29379,DF5678A2D82F170D018446CB4502486B,11231,0,10,10,37,49,1899
29380,29380,DF5678A2D82F170D018446CB4502486B,12083,13,15,2,36,49,1849
29381,29381,DF5678A2D82F170D018446CB4502486B,12671,16,20,4,21,43,1093
29386,29386,10ECE1681B9A18CCFFA5F5EE024AF126,13711,0,9,9,38,46,1946
29387,29387,10ECE1681B9A18CCFFA5F5EE024AF126,11074,11,12,1,37,47,1897
29388,29388,10ECE1681B9A18CCFFA5F5EE024AF126,13121,13,15,2,38,46,1946
29389,29389,10ECE1681B9A18CCFFA5F5EE024AF126,11011,17,20,3,39,49,1999
29390,29390,10ECE1681B9A18CCFFA5F5EE024AF126,13711,21,22,1,38,46,1946
29394,29394,63A511A46BA2337EF20E8ECBD866F8A2,12921,6,8,2,9,41,491
29395,29395,63A511A46BA2337EF20E8ECBD866F8A2,43644,13,14,1,14,38,738
29396,29396,63A511A46BA2337EF20E8ECBD866F8A2,43641,19,20,1,16,38,838
29397,29397,14A26121D61284733518359391469C97,19571,1,5,4,1,36,86
29398,29398,14A26121D61284733518359391469C97,43644,6,19,13,14,38,738
29399,29399,14A26121D61284733518359391469C97,19571,20,23,3,1,36,86
29400,29400,0324B4BC4AC52B5FF38CABDD51C922F7,42141,0,5,5,32,47,1647
29401,29401,0324B4BC4AC52B5FF38CABDD51C922F7,13341,7,11,4,44,45,2245
29402,29402,0324B4BC4AC52B5FF38CABDD51C922F7,12561,16,17,1,45,43,2293
29403,29403,0324B4BC4AC52B5FF38CABDD51C922F7,42141,19,23,4,32,47,1647
29407,29407,586F3AD64B483C4FDBF6963F85B66D9A,11481,0,10,10,41,48,2098
29408,29408,586F3AD64B483C4FDBF6963F85B66D9A,42201,10,12,2,43,46,2196
29409,29409,586F3AD64B483C4FDBF6963F85B66D9A,11481,13,14,1,41,48,2098
29410,29410,586F3AD64B483C4FDBF6963F85B66D9A,11491,15,16,1,36,47,1847
29411,29411,586F3AD64B483C4FDBF6963F85B66D9A,42201,16,18,2,43,46,2196
29412,29412,586F3AD64B483C4FDBF6963F85B66D9A,13271,22,23,1,41,47,2097
29416,29416,D96201B04F49DA8FE5B344343C2EC845,11861,0,9,9,32,47,1647
29417,29417,D96201B04F49DA8FE5B344343C2EC845,10061,10,15,5,20,46,1046
29418,29418,D96201B04F49DA8FE5B344343C2EC845,42151,18,20,2,35,45,1795
29419,29419,5AAEE0960A0C6A42F1E879CAC8362FAE,10601,0,6,6,39,47,1997
29420,29420,5AAEE0960A0C6A42F1E879CAC8362FAE,12481,7,8,1,37,49,1899
29421,29421,5AAEE0960A0C6A42F1E879CAC8362FAE,13691,12,17,5,47,30,2380
29422,29422,5AAEE0960A0C6A42F1E879CAC8362FAE,10601,21,22,1,39,47,1997
29423,29423,3C97F95D3E300B5D6FAF61C6893E701A,10271,0,14,14,37,46,1896
29424,29424,3C97F95D3E300B5D6FAF61C6893E701A,40341,17,20,3,23,49,1199
29425,29425,3C97F95D3E300B5D6FAF61C6893E701A,10271,21,23,2,37,46,1896
29432,29432,CC641F0BEEAF913DA1AE8ACC2C85589D,11753,0,9,9,35,48,1798
29433,29433,CC641F0BEEAF913DA1AE8ACC2C85589D,11771,11,13,2,39,49,1999
29434,29434,CC641F0BEEAF913DA1AE8ACC2C85589D,13951,21,23,2,47,45,2395
29438,29438,9397083C419903E30A62F5C06D299D5C,43011,1,3,2,40,42,2042
29439,29439,9397083C419903E30A62F5C06D299D5C,42381,4,6,2,39,41,1991
29440,29440,9397083C419903E30A62F5C06D299D5C,43451,8,11,3,37,40,1890
29441,29441,9397083C419903E30A62F5C06D299D5C,42381,11,23,12,39,41,1991
29442,29442,5416C4EE8A73D7FAF4E34F0113CD8F14,13071,1,5,4,41,41,2091
29443,29443,5416C4EE8A73D7FAF4E34F0113CD8F14,43101,6,8,2,46,40,2340
29444,29444,5416C4EE8A73D7FAF4E34F0113CD8F14,13071,8,14,6,41,41,2091
29445,29445,5416C4EE8A73D7FAF4E34F0113CD8F14,43011,20,21,1,40,42,2042
29446,29446,5416C4EE8A73D7FAF4E34F0113CD8F14,13071,22,23,1,41,41,2091
29447,29447,F776CF5BFCBAFE40EFE079BFD8CF34A4,19901,0,4,4,7,44,394
29448,29448,F776CF5BFCBAFE40EFE079BFD8CF34A4,19111,7,11,4,9,45,495
29449,29449,F776CF5BFCBAFE40EFE079BFD8CF34A4,19901,11,13,2,7,44,394
29450,29450,F776CF5BFCBAFE40EFE079BFD8CF34A4,19111,15,18,3,9,45,495
29451,29451,F776CF5BFCBAFE40EFE079BFD8CF34A4,12641,21,22,1,10,43,543
29461,29461,4B70CDECC69BFFC3ED2138AE842AE025,11111,8,10,2,26,48,1348
29462,29462,4B70CDECC69BFFC3ED2138AE842AE025,12581,12,13,1,24,48,1248
29463,29463,4B70CDECC69BFFC3ED2138AE842AE025,42371,17,23,6,34,46,1746
29470,29470,4BEB96C1A6F8B99181CDADEF48D75275,42501,0,6,6,28,47,1447
29471,29471,4BEB96C1A6F8B99181CDADEF48D75275,42081,8,18,10,24,49,1249
29472,29472,4BEB96C1A6F8B99181CDADEF48D75275,42501,19,23,4,28,47,1447
29473,29473,DE7A331A2ADB65AF4D6289538234B91E,11491,0,9,9,36,47,1847
29474,29474,DE7A331A2ADB65AF4D6289538234B91E,13341,9,12,3,44,45,2245
29475,29475,DE7A331A2ADB65AF4D6289538234B91E,13371,13,14,1,41,47,2097
29476,29476,DE7A331A2ADB65AF4D6289538234B91E,42201,17,21,4,43,46,2196
29477,29477,DE7A331A2ADB65AF4D6289538234B91E,12511,21,23,2,39,47,1997
29478,29478,A61D0F5D6E4730E77483BB5A83F54B2C,13841,0,11,11,40,46,2046
29479,29479,A61D0F5D6E4730E77483BB5A83F54B2C,10191,13,14,1,40,48,2048
29480,29480,A61D0F5D6E4730E77483BB5A83F54B2C,10251,15,20,5,35,47,1797
29481,29481,0DC30FA0CCDAD859C724130675369152,12211,1,12,11,41,44,2094
29482,29482,0DC30FA0CCDAD859C724130675369152,13481,14,16,2,26,31,1331
29483,29483,0DC30FA0CCDAD859C724130675369152,42351,19,20,1,38,45,1945
29490,29490,B5D372B83A800D0F8993F9701E49A955,13271,0,13,13,41,47,2097
29491,29491,B5D372B83A800D0F8993F9701E49A955,11461,14,17,3,37,49,1899
29492,29492,B5D372B83A800D0F8993F9701E49A955,13271,21,22,1,41,47,2097
29493,29493,23EA4F8B5D0ABEDDC9284DC80F701F9F,42461,6,7,1,45,47,2297
29494,29494,23EA4F8B5D0ABEDDC9284DC80F701F9F,42031,10,11,1,40,46,2046
29495,29495,23EA4F8B5D0ABEDDC9284DC80F701F9F,42091,11,13,2,43,46,2196
29496,29496,23EA4F8B5D0ABEDDC9284DC80F701F9F,42461,14,15,1,45,47,2297
29497,29497,23EA4F8B5D0ABEDDC9284DC80F701F9F,42091,19,21,2,43,46,2196
29498,29498,406EDA02B30F2BAE6E77943EDDABB841,42461,0,5,5,45,47,2297
29499,29499,406EDA02B30F2BAE6E77943EDDABB841,42801,7,8,1,40,49,2049
29500,29500,406EDA02B30F2BAE6E77943EDDABB841,13941,9,10,1,41,47,2097
29501,29501,406EDA02B30F2BAE6E77943EDDABB841,42801,15,16,1,40,49,2049
29502,29502,406EDA02B30F2BAE6E77943EDDABB841,43061,17,22,5,43,46,2196
29503,29503,4A5EF93BB858500EB5E990B25A969531,13094,1,2,1,21,42,1092
29504,29504,4A5EF93BB858500EB5E990B25A969531,43751,3,4,1,19,48,998
29505,29505,4A5EF93BB858500EB5E990B25A969531,12581,6,8,2,24,48,1248
29506,29506,4A5EF93BB858500EB5E990B25A969531,10271,18,20,2,37,46,1896
29507,29507,5DACA86958CD1100E6CA86CA11D6DB13,11741,0,11,11,42,49,2149
29508,29508,5DACA86958CD1100E6CA86CA11D6DB13,10921,11,13,2,43,48,2198
29509,29509,5DACA86958CD1100E6CA86CA11D6DB13,11061,15,18,3,29,48,1498
29510,29510,5DACA86958CD1100E6CA86CA11D6DB13,10921,19,20,1,43,48,2198
29511,29511,2F1F7798F5E8889B4080CA59D71F0274,10271,4,11,7,37,46,1896
29512,29512,2F1F7798F5E8889B4080CA59D71F0274,11861,13,15,2,32,47,1647
29513,29513,2F1F7798F5E8889B4080CA59D71F0274,13711,16,18,2,38,46,1946
29514,29514,2F1F7798F5E8889B4080CA59D71F0274,10271,19,22,3,37,46,1896
29519,29519,906075D6233195F1F9099F6FBB81286D,43761,3,6,3,32,47,1647
29520,29520,906075D6233195F1F9099F6FBB81286D,42121,9,10,1,26,49,1349
29521,29521,906075D6233195F1F9099F6FBB81286D,43761,11,13,2,32,47,1647
29522,29522,906075D6233195F1F9099F6FBB81286D,42161,18,19,1,36,47,1847
29523,29523,906075D6233195F1F9099F6FBB81286D,42523,21,22,1,31,47,1597
29524,29524,B4CF5575585A81D8047EC86B2FC8CF53,42861,0,6,6,37,44,1894
29525,29525,B4CF5575585A81D8047EC86B2FC8CF53,13461,7,8,1,39,44,1994
29526,29526,B4CF5575585A81D8047EC86B2FC8CF53,42861,11,13,2,37,44,1894
29527,29527,B4CF5575585A81D8047EC86B2FC8CF53,11261,14,18,4,36,46,1846
29528,29528,B4CF5575585A81D8047EC86B2FC8CF53,42861,19,20,1,37,44,1894
29529,29529,B4CF5575585A81D8047EC86B2FC8CF53,10811,22,23,1,38,46,1946
29530,29530,3683BCD5E2A83D301E5101A2DD111033,10107,0,12,12,38,49,1949
29531,29531,3683BCD5E2A83D301E5101A2DD111033,43481,12,15,3,39,48,1998
29532,29532,3683BCD5E2A83D301E5101A2DD111033,12381,15,17,2,32,48,1648
29533,29533,3683BCD5E2A83D301E5101A2DD111033,11541,19,20,1,35,49,1799
29541,29541,AF115A3AF51A8C5F1F530DF91945369C,10881,3,9,6,34,48,1748
29542,29542,AF115A3AF51A8C5F1F530DF91945369C,42401,10,11,1,36,47,1847
29543,29543,AF115A3AF51A8C5F1F530DF91945369C,10881,12,17,5,34,48,1748
29544,29544,AF115A3AF51A8C5F1F530DF91945369C,42401,18,20,2,36,47,1847
29545,29545,AF115A3AF51A8C5F1F530DF91945369C,10881,20,23,3,34,48,1748
29549,29549,DCCA3E687E0809C76288FEF723D82C98,43751,0,11,11,19,48,998
29550,29550,DCCA3E687E0809C76288FEF723D82C98,11741,13,15,2,42,49,2149
29551,29551,DCCA3E687E0809C76288FEF723D82C98,40341,16,17,1,23,49,1199
29552,29552,DCCA3E687E0809C76288FEF723D82C98,42621,18,19,1,24,49,1249
29553,29553,DCCA3E687E0809C76288FEF723D82C98,43751,21,23,2,19,48,998
29554,29554,5ABC7476B829907717164C7F4D7F76B4,11381,0,1,1,30,47,1547
29555,29555,5ABC7476B829907717164C7F4D7F76B4,10681,2,8,6,30,48,1548
29556,29556,5ABC7476B829907717164C7F4D7F76B4,11061,10,11,1,29,48,1498
29557,29557,5ABC7476B829907717164C7F4D7F76B4,11381,15,17,2,30,47,1547
29558,29558,5ABC7476B829907717164C7F4D7F76B4,10951,20,21,1,29,48,1498
29562,29562,4A13D317408FAA25E5E85E9637D26642,10811,0,6,6,38,46,1946
29563,29563,4A13D317408FAA25E5E85E9637D26642,42461,7,8,1,45,47,2297
29564,29564,4A13D317408FAA25E5E85E9637D26642,10811,13,23,10,38,46,1946
29565,29565,7E6F1057729DFB8EE8B59466F9245966,42231,0,5,5,37,46,1896
29566,29566,7E6F1057729DFB8EE8B59466F9245966,13911,6,8,2,39,46,1996
29567,29567,7E6F1057729DFB8EE8B59466F9245966,11074,10,12,2,37,47,1897
29568,29568,7E6F1057729DFB8EE8B59466F9245966,42231,14,19,5,37,46,1896
29569,29569,7E6F1057729DFB8EE8B59466F9245966,13911,21,23,2,39,46,1996
29570,29570,69601DFFFCF880DD8BF9BB911205AC6A,13651,0,3,3,30,47,1547
29571,29571,69601DFFFCF880DD8BF9BB911205AC6A,10281,3,11,8,33,48,1698
29572,29572,69601DFFFCF880DD8BF9BB911205AC6A,13651,15,21,6,30,47,1547
29573,29573,69601DFFFCF880DD8BF9BB911205AC6A,12391,21,22,1,36,49,1849
29577,29577,F1249E9F0C0E4CFC8DF3A999C283E2E8,42791,0,7,7,35,45,1795
29578,29578,F1249E9F0C0E4CFC8DF3A999C283E2E8,10351,9,15,6,28,45,1445
29579,29579,F1249E9F0C0E4CFC8DF3A999C283E2E8,42791,19,20,1,35,45,1795
29580,29580,0903FF09B8DBD20BBBE7AE6E70D516AE,40302,0,1,1,40,49,2049
29581,29581,0903FF09B8DBD20BBBE7AE6E70D516AE,10341,1,6,5,31,47,1597
29582,29582,0903FF09B8DBD20BBBE7AE6E70D516AE,40302,10,12,2,40,49,2049
29583,29583,0903FF09B8DBD20BBBE7AE6E70D516AE,42523,20,23,3,31,47,1597
29584,29584,5C72B0A7D2D9BEA9D0832F659C47AFA7,42471,1,4,3,35,49,1799
29585,29585,5C72B0A7D2D9BEA9D0832F659C47AFA7,11591,7,9,2,36,49,1849
29586,29586,5C72B0A7D2D9BEA9D0832F659C47AFA7,11331,11,12,1,37,48,1898
29587,29587,5C72B0A7D2D9BEA9D0832F659C47AFA7,11021,13,15,2,36,49,1849
29588,29588,5C72B0A7D2D9BEA9D0832F659C47AFA7,42471,17,18,1,35,49,1799
29589,29589,718F9C02C6A67F792D4A34A4E958BCFE,10221,0,1,1,34,49,1749
29590,29590,718F9C02C6A67F792D4A34A4E958BCFE,11351,2,3,1,36,48,1848
29591,29591,718F9C02C6A67F792D4A34A4E958BCFE,13011,4,19,15,39,47,1997
29592,29592,718F9C02C6A67F792D4A34A4E958BCFE,11074,21,22,1,37,47,1897
29600,29600,04DEDD36B373B01A1756B199C3BB2782,16233,1,15,14,5,15,265
29601,29601,04DEDD36B373B01A1756B199C3BB2782,19356,17,18,1,7,19,369
29602,29602,04DEDD36B373B01A1756B199C3BB2782,16233,19,23,4,5,15,265
29603,29603,8EC6592A5302140A9CA2CC55F2BCF8B9,42201,0,9,9,43,46,2196
29604,29604,8EC6592A5302140A9CA2CC55F2BCF8B9,10971,10,12,2,35,47,1797
29605,29605,8EC6592A5302140A9CA2CC55F2BCF8B9,11753,14,16,2,35,48,1798
29606,29606,8EC6592A5302140A9CA2CC55F2BCF8B9,11201,16,18,2,35,49,1799
29607,29607,8EC6592A5302140A9CA2CC55F2BCF8B9,42201,20,23,3,43,46,2196
29608,29608,69EAF8E4E5F831CE44362C43E1F3AA99,12221,1,4,3,43,44,2194
29609,29609,69EAF8E4E5F831CE44362C43E1F3AA99,43051,13,16,3,46,45,2345
29610,29610,69EAF8E4E5F831CE44362C43E1F3AA99,12561,17,20,3,45,43,2293
29611,29611,69EAF8E4E5F831CE44362C43E1F3AA99,10751,21,22,1,47,43,2393
29615,29615,2CBA54B2F1C25B10208FDF74997E0D60,11074,0,8,8,37,47,1897
29616,29616,2CBA54B2F1C25B10208FDF74997E0D60,42231,11,12,1,37,46,1896
29617,29617,2CBA54B2F1C25B10208FDF74997E0D60,11074,12,15,3,37,47,1897
29618,29618,2CBA54B2F1C25B10208FDF74997E0D60,42231,17,18,1,37,46,1896
29619,29619,2CBA54B2F1C25B10208FDF74997E0D60,11074,19,22,3,37,47,1897
29623,29623,D33073253CB693323CC0CB90DBBADEB8,40101,0,2,2,34,49,1749
29624,29624,D33073253CB693323CC0CB90DBBADEB8,10811,4,9,5,38,46,1946
29625,29625,D33073253CB693323CC0CB90DBBADEB8,42231,9,12,3,37,46,1896
29626,29626,D33073253CB693323CC0CB90DBBADEB8,12381,16,17,1,32,48,1648
29627,29627,D33073253CB693323CC0CB90DBBADEB8,42161,22,23,1,36,47,1847
29634,29634,F238E4BCD894635E3C09F75844D0698F,42231,0,6,6,37,46,1896
29635,29635,F238E4BCD894635E3C09F75844D0698F,42351,10,11,1,38,45,1945
29636,29636,F238E4BCD894635E3C09F75844D0698F,42231,13,18,5,37,46,1896
29637,29637,F238E4BCD894635E3C09F75844D0698F,42021,19,20,1,33,47,1697
29638,29638,F238E4BCD894635E3C09F75844D0698F,13711,21,23,2,38,46,1946
29643,29643,FC386E5EE84DD966E138539871A3312A,42221,1,8,7,38,48,1948
29644,29644,FC386E5EE84DD966E138539871A3312A,11074,10,11,1,37,47,1897
29645,29645,FC386E5EE84DD966E138539871A3312A,43361,12,13,1,38,48,1948
29646,29646,FC386E5EE84DD966E138539871A3312A,10531,19,21,2,34,46,1746
29647,29647,FC386E5EE84DD966E138539871A3312A,11074,22,23,1,37,47,1897
29648,29648,DAF070E37522449552E837969D087804,10491,0,6,6,33,48,1698
29649,29649,DAF070E37522449552E837969D087804,10471,6,9,3,37,48,1898
29650,29650,DAF070E37522449552E837969D087804,10491,11,13,2,33,48,1698
29651,29651,DAF070E37522449552E837969D087804,11324,14,18,4,31,46,1596
29652,29652,DAF070E37522449552E837969D087804,11171,18,23,5,33,48,1698
29656,29656,48988F9738D846417A4FDCB0B8D562D9,13371,4,9,5,41,47,2097
29657,29657,48988F9738D846417A4FDCB0B8D562D9,40341,11,13,2,23,49,1199
29658,29658,48988F9738D846417A4FDCB0B8D562D9,13371,16,21,5,41,47,2097
29662,29662,892134ADC1B7E9D78731B48CCE14A5DD,42271,0,11,11,40,47,2047
29663,29663,892134ADC1B7E9D78731B48CCE14A5DD,13381,12,17,5,39,47,1997
29664,29664,892134ADC1B7E9D78731B48CCE14A5DD,43081,20,21,1,27,28,1378
29665,29665,B8DB030E6F574F75DC469AA0B11A44D5,10531,0,7,7,34,46,1746
29666,29666,B8DB030E6F574F75DC469AA0B11A44D5,42921,8,9,1,33,47,1697
29667,29667,B8DB030E6F574F75DC469AA0B11A44D5,43731,9,13,4,34,47,1747
29668,29668,B8DB030E6F574F75DC469AA0B11A44D5,42921,14,18,4,33,47,1697
29669,29669,B8DB030E6F574F75DC469AA0B11A44D5,10531,19,23,4,34,46,1746
29670,29670,280A825D237E9CE7CB403628403E758B,42351,1,11,10,38,45,1945
29671,29671,280A825D237E9CE7CB403628403E758B,13911,15,18,3,39,46,1996
29672,29672,280A825D237E9CE7CB403628403E758B,40341,19,20,1,23,49,1199
29673,29673,280A825D237E9CE7CB403628403E758B,13911,21,22,1,39,46,1996
29674,29674,57634625D4FE2F74F8D328FA58FAE9E8,12031,0,7,7,33,48,1698
29675,29675,57634625D4FE2F74F8D328FA58FAE9E8,12311,9,12,3,30,44,1544
29676,29676,57634625D4FE2F74F8D328FA58FAE9E8,12031,12,23,11,33,48,1698
29683,29683,7649F52C89D1670662DA3962910D6645,13011,0,6,6,39,47,1997
29684,29684,7649F52C89D1670662DA3962910D6645,42531,7,12,5,31,45,1595
29685,29685,7649F52C89D1670662DA3962910D6645,12311,14,18,4,30,44,1544
29686,29686,7649F52C89D1670662DA3962910D6645,13011,20,23,3,39,47,1997
29687,29687,B586EAB297E83D0A90DD54A60924E8FC,10111,0,9,9,37,47,1897
29688,29688,B586EAB297E83D0A90DD54A60924E8FC,12871,12,13,1,22,33,1133
29689,29689,B586EAB297E83D0A90DD54A60924E8FC,42161,15,23,8,36,47,1847
29694,29694,4EDC5FBF42EB21EC06A8CD8083C0B04D,10471,0,9,9,37,48,1898
29695,29695,4EDC5FBF42EB21EC06A8CD8083C0B04D,10611,11,13,2,32,48,1648
29696,29696,4EDC5FBF42EB21EC06A8CD8083C0B04D,11834,17,18,1,32,45,1645
29701,29701,DE562E077213566DA78895C5D4449486,10411,0,8,8,36,48,1848
29702,29702,DE562E077213566DA78895C5D4449486,12921,11,14,3,9,41,491
29703,29703,DE562E077213566DA78895C5D4449486,10411,15,23,8,36,48,1848
29708,29708,02E0F712E80A642B0486CBB8817B053B,40124,0,6,6,38,47,1947
29709,29709,02E0F712E80A642B0486CBB8817B053B,42301,6,7,1,36,47,1847
29710,29710,02E0F712E80A642B0486CBB8817B053B,13331,11,12,1,38,47,1947
29711,29711,02E0F712E80A642B0486CBB8817B053B,42301,13,14,1,36,47,1847
29712,29712,02E0F712E80A642B0486CBB8817B053B,40124,18,23,5,38,47,1947
29713,29713,E03B05F0FB01917EEB19D58711FDBCBD,13071,0,8,8,41,41,2091
29714,29714,E03B05F0FB01917EEB19D58711FDBCBD,43101,8,18,10,46,40,2340
29715,29715,E03B05F0FB01917EEB19D58711FDBCBD,13071,19,22,3,41,41,2091
29725,29725,B0A41D60A2339C9B19D1BAAEC9E2E557,11324,0,5,5,31,46,1596
29726,29726,B0A41D60A2339C9B19D1BAAEC9E2E557,19181,7,15,8,8,40,440
29727,29727,B0A41D60A2339C9B19D1BAAEC9E2E557,42071,18,20,2,31,49,1599
29731,29731,92C298774EE2079F8846BCF9DC40CF98,10691,0,6,6,33,48,1698
29732,29732,92C298774EE2079F8846BCF9DC40CF98,42491,9,10,1,32,46,1646
29733,29733,92C298774EE2079F8846BCF9DC40CF98,10691,11,13,2,33,48,1698
29734,29734,92C298774EE2079F8846BCF9DC40CF98,42491,14,15,1,32,46,1646
29735,29735,92C298774EE2079F8846BCF9DC40CF98,10691,18,22,4,33,48,1698
29742,29742,160D07DE00D03BDA78F3AB41DCF3D29D,10921,0,7,7,43,48,2198
29743,29743,160D07DE00D03BDA78F3AB41DCF3D29D,13094,10,11,1,21,42,1092
29744,29744,160D07DE00D03BDA78F3AB41DCF3D29D,10921,16,23,7,43,48,2198
29751,29751,21FCC6B6C6A0998CC9336AAD4AF0C4E3,42941,1,2,1,37,47,1897
29752,29752,21FCC6B6C6A0998CC9336AAD4AF0C4E3,42011,3,8,5,36,46,1846
29753,29753,21FCC6B6C6A0998CC9336AAD4AF0C4E3,42941,10,11,1,37,47,1897
29754,29754,21FCC6B6C6A0998CC9336AAD4AF0C4E3,42011,12,13,1,36,46,1846
29755,29755,21FCC6B6C6A0998CC9336AAD4AF0C4E3,40431,13,15,2,36,47,1847
29756,29756,21FCC6B6C6A0998CC9336AAD4AF0C4E3,10271,16,18,2,37,46,1896
29757,29757,21FCC6B6C6A0998CC9336AAD4AF0C4E3,42941,18,20,2,37,47,1897
29758,29758,21FCC6B6C6A0998CC9336AAD4AF0C4E3,10271,22,23,1,37,46,1896
29759,29759,DBE56CF804EFF98F06EBBF480586FC01,43021,1,2,1,16,43,843
29760,29760,DBE56CF804EFF98F06EBBF480586FC01,12921,7,9,2,9,41,491
29761,29761,DBE56CF804EFF98F06EBBF480586FC01,43021,10,18,8,16,43,843
29762,29762,DBE56CF804EFF98F06EBBF480586FC01,12921,18,20,2,9,41,491
29763,29763,DBE56CF804EFF98F06EBBF480586FC01,43021,20,21,1,16,43,843
29764,29764,EAE287F5D6EFBC2D9301FCA476FADCD5,42531,3,6,3,31,45,1595
29765,29765,EAE287F5D6EFBC2D9301FCA476FADCD5,11875,7,8,1,30,46,1546
29766,29766,EAE287F5D6EFBC2D9301FCA476FADCD5,42531,9,12,3,31,45,1595
29767,29767,EAE287F5D6EFBC2D9301FCA476FADCD5,10351,14,16,2,28,45,1445
29768,29768,EAE287F5D6EFBC2D9301FCA476FADCD5,42531,19,20,1,31,45,1595
29769,29769,E1C859FD8CC74565ED07635B54DBAB6A,43761,0,7,7,32,47,1647
29770,29770,E1C859FD8CC74565ED07635B54DBAB6A,11061,7,11,4,29,48,1498
29771,29771,E1C859FD8CC74565ED07635B54DBAB6A,42471,12,14,2,35,49,1799
29772,29772,E1C859FD8CC74565ED07635B54DBAB6A,11061,14,18,4,29,48,1498
29773,29773,E1C859FD8CC74565ED07635B54DBAB6A,42141,19,20,1,32,47,1647
29774,29774,6504F1F0C122D0816D84E7F4E32ECF8A,11271,0,1,1,37,48,1898
29775,29775,6504F1F0C122D0816D84E7F4E32ECF8A,13651,2,8,6,30,47,1547
29776,29776,6504F1F0C122D0816D84E7F4E32ECF8A,42523,17,22,5,31,47,1597
29777,29777,5CE5B38C43463AB4DE2D4D106DC3D232,11231,0,1,1,37,49,1899
29778,29778,5CE5B38C43463AB4DE2D4D106DC3D232,10251,1,12,11,35,47,1797
29779,29779,5CE5B38C43463AB4DE2D4D106DC3D232,13791,17,20,3,42,47,2147
29783,29783,9936C0BC7C8E5C695B3A454E94E542C6,42471,0,2,2,35,49,1799
29784,29784,9936C0BC7C8E5C695B3A454E94E542C6,11591,2,6,4,36,49,1849
29785,29785,9936C0BC7C8E5C695B3A454E94E542C6,42471,6,8,2,35,49,1799
29786,29786,9936C0BC7C8E5C695B3A454E94E542C6,11021,16,18,2,36,49,1849
29787,29787,9936C0BC7C8E5C695B3A454E94E542C6,11201,18,19,1,35,49,1799
29788,29788,9936C0BC7C8E5C695B3A454E94E542C6,11591,21,22,1,36,49,1849
29789,29789,E8D9E959F97C7FD7CC901C0701D97F78,10221,0,12,12,34,49,1749
29790,29790,E8D9E959F97C7FD7CC901C0701D97F78,42511,13,15,2,37,47,1897
29791,29791,E8D9E959F97C7FD7CC901C0701D97F78,12131,15,16,1,32,47,1647
29792,29792,E8D9E959F97C7FD7CC901C0701D97F78,11201,19,23,4,35,49,1799
29813,29813,9CAF9D4766C52431BBA0063BD723C357,13101,1,18,17,40,47,2047
29814,29814,9CAF9D4766C52431BBA0063BD723C357,11381,18,20,2,30,47,1547
29815,29815,9CAF9D4766C52431BBA0063BD723C357,13101,21,23,2,40,47,2047
29820,29820,1439D71C3B1C0FF45CC1AED4C666D5BA,13071,1,14,13,41,41,2091
29821,29821,1439D71C3B1C0FF45CC1AED4C666D5BA,43101,14,16,2,46,40,2340
29822,29822,1439D71C3B1C0FF45CC1AED4C666D5BA,13071,16,17,1,41,41,2091
29823,29823,1439D71C3B1C0FF45CC1AED4C666D5BA,10911,19,20,1,39,46,1996
29824,29824,1439D71C3B1C0FF45CC1AED4C666D5BA,13711,21,22,1,38,46,1946
29840,29840,5408DC5B0AFBD23C3FA2E4CCFD3A9C81,42633,0,5,5,42,46,2146
29841,29841,5408DC5B0AFBD23C3FA2E4CCFD3A9C81,11261,7,8,1,36,46,1846
29842,29842,5408DC5B0AFBD23C3FA2E4CCFD3A9C81,42633,11,14,3,42,46,2146
29843,29843,5408DC5B0AFBD23C3FA2E4CCFD3A9C81,11261,14,17,3,36,46,1846
29844,29844,5408DC5B0AFBD23C3FA2E4CCFD3A9C81,42861,17,19,2,37,44,1894
29845,29845,5408DC5B0AFBD23C3FA2E4CCFD3A9C81,42633,21,23,2,42,46,2146
29846,29846,03FE0D0BD52A528C1B4DF1F3C44F085B,11941,2,9,7,37,46,1896
29847,29847,03FE0D0BD52A528C1B4DF1F3C44F085B,40697,12,13,1,43,48,2198
29848,29848,03FE0D0BD52A528C1B4DF1F3C44F085B,43241,14,18,4,36,46,1846
29852,29852,769F9473A8B39D9A96BE9614F46C9EF0,11331,0,10,10,37,48,1898
29853,29853,769F9473A8B39D9A96BE9614F46C9EF0,19571,12,14,2,1,36,86
29854,29854,769F9473A8B39D9A96BE9614F46C9EF0,11331,21,23,2,37,48,1898
29864,29864,CA7675D4504FF649E5D3C79C1D770D57,10901,0,6,6,35,48,1798
29865,29865,CA7675D4504FF649E5D3C79C1D770D57,42831,7,9,2,27,48,1398
29866,29866,CA7675D4504FF649E5D3C79C1D770D57,10901,10,14,4,35,48,1798
29867,29867,CA7675D4504FF649E5D3C79C1D770D57,42831,14,16,2,27,48,1398
29868,29868,CA7675D4504FF649E5D3C79C1D770D57,10901,18,23,5,35,48,1798
29869,29869,AE08A1E713DAA4F0C24DA0563595B4F9,11471,0,2,2,12,48,648
29870,29870,AE08A1E713DAA4F0C24DA0563595B4F9,19441,4,17,13,8,46,446
29871,29871,AE08A1E713DAA4F0C24DA0563595B4F9,11471,22,23,1,12,48,648
29875,29875,2B742D33ECA5D739DE9809C030EAA6E5,42351,0,3,3,38,45,1945
29876,29876,2B742D33ECA5D739DE9809C030EAA6E5,11261,4,5,1,36,46,1846
29877,29877,2B742D33ECA5D739DE9809C030EAA6E5,13911,5,7,2,39,46,1996
29878,29878,2B742D33ECA5D739DE9809C030EAA6E5,42351,8,9,1,38,45,1945
29879,29879,2B742D33ECA5D739DE9809C030EAA6E5,11261,11,23,12,36,46,1846
29890,29890,9C33045C9DAA538B403A4845044E2124,11541,0,10,10,35,49,1799
29891,29891,9C33045C9DAA538B403A4845044E2124,10591,14,15,1,39,48,1998
29892,29892,9C33045C9DAA538B403A4845044E2124,11541,18,23,5,35,49,1799
29896,29896,CFF4943452741BA085C68AD1AAC66347,10331,0,5,5,39,46,1996
29897,29897,CFF4943452741BA085C68AD1AAC66347,19031,7,10,3,1,42,92
29898,29898,CFF4943452741BA085C68AD1AAC66347,11481,12,17,5,41,48,2098
29899,29899,CFF4943452741BA085C68AD1AAC66347,10331,19,22,3,39,46,1996
29900,29900,9DFDF456583EF8ED513F44E92BD3969E,19024,0,8,8,9,45,495
29901,29901,9DFDF456583EF8ED513F44E92BD3969E,11301,11,13,2,41,49,2099
29902,29902,9DFDF456583EF8ED513F44E92BD3969E,19024,15,23,8,9,45,495
29910,29910,8E1B59B1D093F12DCE92DD7FCED5EC72,42511,1,7,6,37,47,1897
29911,29911,8E1B59B1D093F12DCE92DD7FCED5EC72,13331,7,8,1,38,47,1947
29912,29912,8E1B59B1D093F12DCE92DD7FCED5EC72,42511,9,10,1,37,47,1897
29913,29913,8E1B59B1D093F12DCE92DD7FCED5EC72,13331,10,12,2,38,47,1947
29914,29914,8E1B59B1D093F12DCE92DD7FCED5EC72,42511,14,15,1,37,47,1897
29915,29915,8E1B59B1D093F12DCE92DD7FCED5EC72,13331,17,19,2,38,47,1947
29923,29923,8255A2F4BC245ABC1F6126838351DBA2,10411,1,7,6,36,48,1848
29924,29924,8255A2F4BC245ABC1F6126838351DBA2,12311,10,13,3,30,44,1544
29925,29925,8255A2F4BC245ABC1F6126838351DBA2,40637,17,19,2,36,47,1847
29926,29926,8255A2F4BC245ABC1F6126838351DBA2,43161,20,22,2,35,47,1797
29927,29927,5C2B763013F3453FD43407A455CBD2B2,13651,1,3,2,30,47,1547
29928,29928,5C2B763013F3453FD43407A455CBD2B2,11111,6,14,8,26,48,1348
29929,29929,5C2B763013F3453FD43407A455CBD2B2,13651,19,20,1,30,47,1547
29930,29930,79AB37E4BA910BB73519FC84F2A35B1A,19181,0,2,2,8,40,440
29931,29931,79AB37E4BA910BB73519FC84F2A35B1A,43021,2,10,8,16,43,843
29932,29932,79AB37E4BA910BB73519FC84F2A35B1A,12641,13,15,2,10,43,543
29933,29933,79AB37E4BA910BB73519FC84F2A35B1A,43021,15,17,2,16,43,843
29934,29934,79AB37E4BA910BB73519FC84F2A35B1A,12921,19,23,4,9,41,491
29942,29942,3E2728364EE0F8914C7020C6A1917CB0,10251,0,7,7,35,47,1797
29943,29943,3E2728364EE0F8914C7020C6A1917CB0,10501,9,11,2,22,46,1146
29944,29944,3E2728364EE0F8914C7020C6A1917CB0,42161,13,16,3,36,47,1847
29945,29945,3E2728364EE0F8914C7020C6A1917CB0,10971,20,23,3,35,47,1797
29949,29949,494D4CE05480984DBEB3A2073E0D7F93,42411,0,12,12,40,49,2049
29950,29950,494D4CE05480984DBEB3A2073E0D7F93,11021,12,18,6,36,49,1849
29951,29951,494D4CE05480984DBEB3A2073E0D7F93,12381,20,21,1,32,48,1648
29952,29952,A907F1FD9C6E827C729A4F36D915F4F7,11701,0,10,10,43,48,2198
29953,29953,A907F1FD9C6E827C729A4F36D915F4F7,40691,12,13,1,42,48,2148
29954,29954,A907F1FD9C6E827C729A4F36D915F4F7,11701,14,16,2,43,48,2198
29955,29955,A907F1FD9C6E827C729A4F36D915F4F7,11151,17,18,1,30,48,1548
29956,29956,A907F1FD9C6E827C729A4F36D915F4F7,40691,22,23,1,42,48,2148
29957,29957,A69D0E675DF53C65958A5EB6BCEDF77C,10841,2,3,1,37,47,1897
29958,29958,A69D0E675DF53C65958A5EB6BCEDF77C,11331,4,13,9,37,48,1898
29959,29959,A69D0E675DF53C65958A5EB6BCEDF77C,10061,14,16,2,20,46,1046
29960,29960,A69D0E675DF53C65958A5EB6BCEDF77C,11074,18,23,5,37,47,1897
29961,29961,F41F2183915AF409B9D08A678FE56B27,43061,0,11,11,43,46,2196
29962,29962,F41F2183915AF409B9D08A678FE56B27,40341,16,19,3,23,49,1199
29963,29963,F41F2183915AF409B9D08A678FE56B27,12021,20,21,1,37,49,1899
29964,29964,E1C94ADF7C5F9FDFC23FBE30C6F5D01A,10651,0,6,6,36,49,1849
29965,29965,E1C94ADF7C5F9FDFC23FBE30C6F5D01A,10381,12,14,2,31,49,1599
29966,29966,E1C94ADF7C5F9FDFC23FBE30C6F5D01A,11021,15,23,8,36,49,1849
29967,29967,8B6448FD7DB9F8E2F8F73AFDDD5BFD38,43021,1,5,4,16,43,843
29968,29968,8B6448FD7DB9F8E2F8F73AFDDD5BFD38,12641,6,10,4,10,43,543
29969,29969,8B6448FD7DB9F8E2F8F73AFDDD5BFD38,43021,12,13,1,16,43,843
29970,29970,8B6448FD7DB9F8E2F8F73AFDDD5BFD38,12921,15,16,1,9,41,491
29971,29971,8B6448FD7DB9F8E2F8F73AFDDD5BFD38,12641,17,19,2,10,43,543
29975,29975,BA02C3BCEE7A48A5C905C95BDC29D4FD,15391,1,3,2,35,26,1776
29976,29976,BA02C3BCEE7A48A5C905C95BDC29D4FD,12792,4,5,1,34,30,1730
29977,29977,BA02C3BCEE7A48A5C905C95BDC29D4FD,15391,6,11,5,35,26,1776
29978,29978,BA02C3BCEE7A48A5C905C95BDC29D4FD,12792,11,12,1,34,30,1730
29979,29979,BA02C3BCEE7A48A5C905C95BDC29D4FD,15391,12,14,2,35,26,1776
29980,29980,BA02C3BCEE7A48A5C905C95BDC29D4FD,12792,14,17,3,34,30,1730
29981,29981,BA02C3BCEE7A48A5C905C95BDC29D4FD,15391,19,23,4,35,26,1776
29982,29982,B4ECB7BEB340F225BCAE990B1C8CD533,13371,0,16,16,41,47,2097
29983,29983,B4ECB7BEB340F225BCAE990B1C8CD533,40341,17,19,2,23,49,1199
29984,29984,B4ECB7BEB340F225BCAE990B1C8CD533,10111,19,21,2,37,47,1897
29985,29985,B4ECB7BEB340F225BCAE990B1C8CD533,13941,21,22,1,41,47,2097
29989,29989,A2DD7BA75FCE1B5306A377D198F94491,15391,0,4,4,35,26,1776
29990,29990,A2DD7BA75FCE1B5306A377D198F94491,12792,5,8,3,34,30,1730
29991,29991,A2DD7BA75FCE1B5306A377D198F94491,15391,8,9,1,35,26,1776
29992,29992,A2DD7BA75FCE1B5306A377D198F94491,12792,12,21,9,34,30,1730
29993,29993,A2DD7BA75FCE1B5306A377D198F94491,15391,22,23,1,35,26,1776
29994,29994,5777E91F6C21D7F929436C43E70423ED,13041,10,12,2,30,37,1537
29995,29995,5777E91F6C21D7F929436C43E70423ED,11061,14,19,5,29,48,1498
29996,29996,5777E91F6C21D7F929436C43E70423ED,11021,20,21,1,36,49,1849
29997,29997,97EED02186157B67ACCA35C5CC13851D,43731,0,7,7,34,47,1747
29998,29998,97EED02186157B67ACCA35C5CC13851D,12083,8,9,1,36,49,1849
29999,29999,97EED02186157B67ACCA35C5CC13851D,42161,11,12,1,36,47,1847
30000,30000,97EED02186157B67ACCA35C5CC13851D,10251,15,17,2,35,47,1797
30001,30001,97EED02186157B67ACCA35C5CC13851D,11271,18,20,2,37,48,1898
30002,30002,85D5644108183A9856ABEFE509080D3A,19621,0,6,6,5,46,296
30003,30003,85D5644108183A9856ABEFE509080D3A,12621,7,9,2,10,48,548
30004,30004,85D5644108183A9856ABEFE509080D3A,19901,12,17,5,7,44,394
30005,30005,85D5644108183A9856ABEFE509080D3A,12621,20,22,2,10,48,548
30006,30006,83823305B701824CEA13C3092045A23D,19441,0,5,5,8,46,446
30007,30007,83823305B701824CEA13C3092045A23D,19821,9,10,1,4,46,246
30008,30008,83823305B701824CEA13C3092045A23D,19441,11,14,3,8,46,446
30009,30009,83823305B701824CEA13C3092045A23D,12621,16,17,1,10,48,548
30010,30010,83823305B701824CEA13C3092045A23D,19441,18,20,2,8,46,446
30011,30011,E5C174D2FF195FD116006ADE577A953D,11381,0,4,4,30,47,1547
30012,30012,E5C174D2FF195FD116006ADE577A953D,11061,5,6,1,29,48,1498
30013,30013,E5C174D2FF195FD116006ADE577A953D,11151,7,10,3,30,48,1548
30014,30014,E5C174D2FF195FD116006ADE577A953D,11061,14,17,3,29,48,1498
30015,30015,E5C174D2FF195FD116006ADE577A953D,11151,19,20,1,30,48,1548
30016,30016,40A3F567657A043546A2ED7A5DC91A85,12792,0,5,5,34,30,1730
30017,30017,40A3F567657A043546A2ED7A5DC91A85,15401,5,11,6,39,25,1975
30018,30018,40A3F567657A043546A2ED7A5DC91A85,12792,12,13,1,34,30,1730
30019,30019,40A3F567657A043546A2ED7A5DC91A85,15401,15,17,2,39,25,1975
30020,30020,40A3F567657A043546A2ED7A5DC91A85,12792,18,23,5,34,30,1730
30021,30021,F075803A6C36A9D2864358E78F8DF986,15051,5,8,3,19,4,954
30022,30022,F075803A6C36A9D2864358E78F8DF986,16281,10,13,3,11,4,554
30023,30023,F075803A6C36A9D2864358E78F8DF986,42091,17,22,5,43,46,2196
30028,30028,78A4AA9407E763ED8D1652A4AFF74DAE,12641,0,3,3,10,43,543
30029,30029,78A4AA9407E763ED8D1652A4AFF74DAE,12921,4,7,3,9,41,491
30030,30030,78A4AA9407E763ED8D1652A4AFF74DAE,12641,8,14,6,10,43,543
30031,30031,78A4AA9407E763ED8D1652A4AFF74DAE,19114,14,17,3,7,43,393
30032,30032,78A4AA9407E763ED8D1652A4AFF74DAE,12641,19,20,1,10,43,543
30033,30033,78A4AA9407E763ED8D1652A4AFF74DAE,19114,20,22,2,7,43,393
30034,30034,EC1722613FE796BEC32CA3A55D02E02D,13941,1,10,9,41,47,2097
30035,30035,EC1722613FE796BEC32CA3A55D02E02D,11701,11,12,1,43,48,2198
30036,30036,EC1722613FE796BEC32CA3A55D02E02D,42971,13,14,1,43,49,2199
30037,30037,EC1722613FE796BEC32CA3A55D02E02D,13381,15,16,1,39,47,1997
30038,30038,EC1722613FE796BEC32CA3A55D02E02D,13941,21,23,2,41,47,2097
30039,30039,A6BBFE7886A6BFC52F86E58BBD2C0899,12871,0,1,1,22,33,1133
30040,30040,A6BBFE7886A6BFC52F86E58BBD2C0899,19281,6,12,6,16,32,832
30041,30041,A6BBFE7886A6BFC52F86E58BBD2C0899,12871,16,18,2,22,33,1133
30045,30045,BD95023CA3EF86943AE8599382EF55E0,12401,0,10,10,39,49,1999
30046,30046,BD95023CA3EF86943AE8599382EF55E0,42491,12,14,2,32,46,1646
30047,30047,BD95023CA3EF86943AE8599382EF55E0,42523,15,17,2,31,47,1597
30048,30048,BD95023CA3EF86943AE8599382EF55E0,42491,17,23,6,32,46,1646
30052,30052,8B7C73BA6B2D95910FBCFDF137038C2A,19114,0,7,7,7,43,393
30053,30053,8B7C73BA6B2D95910FBCFDF137038C2A,12641,9,10,1,10,43,543
30054,30054,8B7C73BA6B2D95910FBCFDF137038C2A,19021,14,15,1,10,45,545
30055,30055,8B7C73BA6B2D95910FBCFDF137038C2A,19114,17,23,6,7,43,393
30056,30056,47CD03C948687C96861434761EE3E932,10621,0,7,7,41,49,2099
30057,30057,47CD03C948687C96861434761EE3E932,19024,9,18,9,9,45,495
30058,30058,47CD03C948687C96861434761EE3E932,10621,20,23,3,41,49,2099
30059,30059,AB57CFBC7FBBD1B4F46C04046F726522,12881,1,3,2,47,22,2372
30060,30060,AB57CFBC7FBBD1B4F46C04046F726522,15021,7,16,9,46,18,2318
30061,30061,AB57CFBC7FBBD1B4F46C04046F726522,12881,19,20,1,47,22,2372
30062,30062,409A27121CD9E6BC90762C45B277F54C,43281,9,10,1,37,48,1898
30063,30063,409A27121CD9E6BC90762C45B277F54C,11461,14,15,1,37,49,1899
30064,30064,409A27121CD9E6BC90762C45B277F54C,43281,16,17,1,37,48,1898
30065,30065,409A27121CD9E6BC90762C45B277F54C,11861,18,23,5,32,47,1647
30066,30066,7CDAB588EA65BCF95FE0652A61C14CC7,12581,0,1,1,24,48,1248
30067,30067,7CDAB588EA65BCF95FE0652A61C14CC7,43751,3,8,5,19,48,998
30068,30068,7CDAB588EA65BCF95FE0652A61C14CC7,12581,13,15,2,24,48,1248
30069,30069,7CDAB588EA65BCF95FE0652A61C14CC7,43751,17,18,1,19,48,998
30070,30070,7CDAB588EA65BCF95FE0652A61C14CC7,12581,18,20,2,24,48,1248
30074,30074,9F589AB01E58B6B2CA9FB997F96CB7F3,13071,0,5,5,41,41,2091
30075,30075,9F589AB01E58B6B2CA9FB997F96CB7F3,43451,7,11,4,37,40,1890
30076,30076,9F589AB01E58B6B2CA9FB997F96CB7F3,13071,11,12,1,41,41,2091
30077,30077,9F589AB01E58B6B2CA9FB997F96CB7F3,43451,16,17,1,37,40,1890
30078,30078,9F589AB01E58B6B2CA9FB997F96CB7F3,13071,20,23,3,41,41,2091
30085,30085,AC10638FE06D5B3AFAFC879A4024709C,13011,0,8,8,39,47,1997
30086,30086,AC10638FE06D5B3AFAFC879A4024709C,40951,12,16,4,36,49,1849
30087,30087,AC10638FE06D5B3AFAFC879A4024709C,43161,20,22,2,35,47,1797
30088,30088,284B31D992ED8D2F40E0148E7C3CBF26,12971,0,9,9,32,48,1648
30089,30089,284B31D992ED8D2F40E0148E7C3CBF26,10251,10,18,8,35,47,1797
30090,30090,284B31D992ED8D2F40E0148E7C3CBF26,10811,20,21,1,38,46,1946
30091,30091,F3B16B9F2FE5D66DD896BE8E61C1FA80,19621,7,12,5,5,46,296
30092,30092,F3B16B9F2FE5D66DD896BE8E61C1FA80,10351,14,17,3,28,45,1445
30093,30093,F3B16B9F2FE5D66DD896BE8E61C1FA80,10301,18,21,3,31,45,1595
30094,30094,2C9F9127F2AECFBA8069624790D23C60,10471,6,9,3,37,48,1898
30095,30095,2C9F9127F2AECFBA8069624790D23C60,11161,10,11,1,32,48,1648
30096,30096,2C9F9127F2AECFBA8069624790D23C60,12121,12,13,1,29,47,1497
30097,30097,2C9F9127F2AECFBA8069624790D23C60,10471,14,19,5,37,48,1898
30098,30098,2C9F9127F2AECFBA8069624790D23C60,12401,20,21,1,39,49,1999
30099,30099,2C9F9127F2AECFBA8069624790D23C60,10471,21,22,1,37,48,1898
30100,30100,36E4D456967ADF7C503C23EAE8460AAD,42523,9,10,1,31,47,1597
30101,30101,36E4D456967ADF7C503C23EAE8460AAD,13651,13,15,2,30,47,1547
30102,30102,36E4D456967ADF7C503C23EAE8460AAD,42523,15,17,2,31,47,1597
30103,30103,36E4D456967ADF7C503C23EAE8460AAD,40951,19,20,1,36,49,1849
30104,30104,36E4D456967ADF7C503C23EAE8460AAD,42523,21,23,2,31,47,1597
30105,30105,6D9B191036D25EF15FC371A87A4278C4,11741,0,7,7,42,49,2149
30106,30106,6D9B191036D25EF15FC371A87A4278C4,13711,8,11,3,38,46,1946
30107,30107,6D9B191036D25EF15FC371A87A4278C4,42231,14,16,2,37,46,1896
30108,30108,6D9B191036D25EF15FC371A87A4278C4,42341,21,23,2,43,49,2199
30113,30113,59644621240D60A0095CD2C9DBFE93CE,12871,8,10,2,22,33,1133
30114,30114,59644621240D60A0095CD2C9DBFE93CE,43121,12,14,2,25,27,1277
30115,30115,59644621240D60A0095CD2C9DBFE93CE,19801,15,18,3,19,26,976
30116,30116,59644621240D60A0095CD2C9DBFE93CE,43121,21,23,2,25,27,1277
30126,30126,90AC20E6CC0B4ABA3A4EAC5C3086C030,10511,1,2,1,35,46,1796
30127,30127,90AC20E6CC0B4ABA3A4EAC5C3086C030,13561,3,15,12,37,49,1899
30128,30128,90AC20E6CC0B4ABA3A4EAC5C3086C030,11841,18,19,1,33,46,1696
30129,30129,90AC20E6CC0B4ABA3A4EAC5C3086C030,10511,20,22,2,35,46,1796
30133,30133,05285A1552C297CAB9E2CA0C1588A769,16233,0,1,1,5,15,265
30134,30134,05285A1552C297CAB9E2CA0C1588A769,16231,1,8,7,11,15,565
30135,30135,05285A1552C297CAB9E2CA0C1588A769,15271,9,15,6,14,20,720
30136,30136,05285A1552C297CAB9E2CA0C1588A769,16231,15,18,3,11,15,565
30137,30137,88FE361D84BF34DD1AB79F3DA14ADA96,43281,0,7,7,37,48,1898
30138,30138,88FE361D84BF34DD1AB79F3DA14ADA96,11461,9,12,3,37,49,1899
30139,30139,88FE361D84BF34DD1AB79F3DA14ADA96,43281,12,13,1,37,48,1898
30140,30140,88FE361D84BF34DD1AB79F3DA14ADA96,11461,14,15,1,37,49,1899
30141,30141,88FE361D84BF34DD1AB79F3DA14ADA96,43281,15,18,3,37,48,1898
30142,30142,88FE361D84BF34DD1AB79F3DA14ADA96,40463,19,21,2,38,49,1949
30143,30143,502BBB8F4B3FEB461DC0CC11B2A61072,42501,0,6,6,28,47,1447
30144,30144,502BBB8F4B3FEB461DC0CC11B2A61072,10381,7,10,3,31,49,1599
30145,30145,502BBB8F4B3FEB461DC0CC11B2A61072,42831,13,15,2,27,48,1398
30146,30146,502BBB8F4B3FEB461DC0CC11B2A61072,42121,16,17,1,26,49,1349
30147,30147,502BBB8F4B3FEB461DC0CC11B2A61072,42501,21,22,1,28,47,1447
30151,30151,8D7C0B857F663DDD976EFDB13B0F0F1F,11331,0,8,8,37,48,1898
30152,30152,8D7C0B857F663DDD976EFDB13B0F0F1F,11384,12,14,2,30,47,1547
30153,30153,8D7C0B857F663DDD976EFDB13B0F0F1F,10161,15,17,2,35,49,1799
30154,30154,8D7C0B857F663DDD976EFDB13B0F0F1F,43001,20,21,1,47,47,2397
30159,30159,4EE5C60035D807126AEE0DC0CD563832,11074,8,10,2,37,47,1897
30160,30160,4EE5C60035D807126AEE0DC0CD563832,11914,11,13,2,37,48,1898
30161,30161,4EE5C60035D807126AEE0DC0CD563832,42581,14,16,2,38,48,1948
30162,30162,4EE5C60035D807126AEE0DC0CD563832,11914,19,21,2,37,48,1898
30163,30163,4EE5C60035D807126AEE0DC0CD563832,42581,21,22,1,38,48,1948
30168,30168,24576DC2C63BF30A46BA06C33A71F868,13911,3,4,1,39,46,1996
30169,30169,24576DC2C63BF30A46BA06C33A71F868,11261,5,9,4,36,46,1846
30170,30170,24576DC2C63BF30A46BA06C33A71F868,12491,11,12,1,36,43,1843
30171,30171,24576DC2C63BF30A46BA06C33A71F868,11261,14,19,5,36,46,1846
30178,30178,B45D59A19F6B61302F993D2909F39450,12031,0,8,8,33,48,1698
30179,30179,B45D59A19F6B61302F993D2909F39450,11061,9,11,2,29,48,1498
30180,30180,B45D59A19F6B61302F993D2909F39450,12031,11,14,3,33,48,1698
30181,30181,B45D59A19F6B61302F993D2909F39450,40445,15,18,3,30,48,1548
30182,30182,B45D59A19F6B61302F993D2909F39450,12031,21,22,1,33,48,1698
30183,30183,6CD008CBF5332727B7FB0E79DB4BAD66,12021,1,2,1,37,49,1899
30184,30184,6CD008CBF5332727B7FB0E79DB4BAD66,43761,3,13,10,32,47,1647
30185,30185,6CD008CBF5332727B7FB0E79DB4BAD66,10901,15,18,3,35,48,1798
30186,30186,6CD008CBF5332727B7FB0E79DB4BAD66,43281,21,23,2,37,48,1898
30187,30187,49EBFFED818B81ED7AB867F150330C08,10411,7,8,1,36,48,1848
30188,30188,49EBFFED818B81ED7AB867F150330C08,12921,9,14,5,9,41,491
30189,30189,49EBFFED818B81ED7AB867F150330C08,10411,16,23,7,36,48,1848
30193,30193,C14EE605AF47234DE280A3E7EB161B28,10301,1,8,7,31,45,1595
30194,30194,C14EE605AF47234DE280A3E7EB161B28,10351,10,11,1,28,45,1445
30195,30195,C14EE605AF47234DE280A3E7EB161B28,10251,12,14,2,35,47,1797
30196,30196,C14EE605AF47234DE280A3E7EB161B28,10351,16,17,1,28,45,1445
30197,30197,C14EE605AF47234DE280A3E7EB161B28,10301,17,18,1,31,45,1595
30198,30198,7977837C561DAF2BE63B159C5447A829,42371,0,6,6,34,46,1746
30199,30199,7977837C561DAF2BE63B159C5447A829,13314,7,8,1,31,39,1589
30200,30200,7977837C561DAF2BE63B159C5447A829,12521,8,9,1,35,41,1791
30201,30201,7977837C561DAF2BE63B159C5447A829,13671,11,18,7,27,43,1393
30202,30202,7977837C561DAF2BE63B159C5447A829,42371,19,23,4,34,46,1746
30203,30203,820ABE912FAA3AA9AC28C360DC47C671,43181,1,5,4,39,48,1998
30204,30204,820ABE912FAA3AA9AC28C360DC47C671,11914,5,12,7,37,48,1898
30205,30205,820ABE912FAA3AA9AC28C360DC47C671,10491,14,21,7,33,48,1698
30206,30206,F5063032BD81D66235C251CB6864E6CB,11231,0,1,1,37,49,1899
30207,30207,F5063032BD81D66235C251CB6864E6CB,12083,2,8,6,36,49,1849
30208,30208,F5063032BD81D66235C251CB6864E6CB,10381,20,22,2,31,49,1599
30209,30209,2D868D5BE3CEB8F6D73B9B7117AF4556,41591,0,8,8,34,49,1749
30210,30210,2D868D5BE3CEB8F6D73B9B7117AF4556,13121,12,13,1,38,46,1946
30211,30211,2D868D5BE3CEB8F6D73B9B7117AF4556,43581,16,17,1,33,48,1698
30212,30212,2D868D5BE3CEB8F6D73B9B7117AF4556,10221,21,23,2,34,49,1749
30219,30219,658EA9AD37668CF7382B10ACD38D61EB,43101,0,3,3,46,40,2340
30220,30220,658EA9AD37668CF7382B10ACD38D61EB,43011,4,6,2,40,42,2042
30221,30221,658EA9AD37668CF7382B10ACD38D61EB,12831,7,13,6,34,38,1738
30222,30222,658EA9AD37668CF7382B10ACD38D61EB,13071,16,20,4,41,41,2091
30223,30223,658EA9AD37668CF7382B10ACD38D61EB,10601,21,23,2,39,47,1997
30224,30224,BBCB9918D42B41DEDF16DD7F5A9BE26F,11861,0,9,9,32,47,1647
30225,30225,BBCB9918D42B41DEDF16DD7F5A9BE26F,42161,10,12,2,36,47,1847
30226,30226,BBCB9918D42B41DEDF16DD7F5A9BE26F,11911,13,16,3,37,48,1898
30227,30227,BBCB9918D42B41DEDF16DD7F5A9BE26F,11861,17,23,6,32,47,1647
30228,30228,8CE4E978A47DAD9E19885D6399031494,42261,6,8,2,25,49,1299
30229,30229,8CE4E978A47DAD9E19885D6399031494,42071,12,13,1,31,49,1599
30230,30230,8CE4E978A47DAD9E19885D6399031494,42261,15,17,2,25,49,1299
30231,30231,8CE4E978A47DAD9E19885D6399031494,10381,17,19,2,31,49,1599
30232,30232,CD89ECEA39067471BB8877232E517EB8,19114,0,9,9,7,43,393
30233,30233,CD89ECEA39067471BB8877232E517EB8,40341,10,13,3,23,49,1199
30234,30234,CD89ECEA39067471BB8877232E517EB8,19114,16,20,4,7,43,393
30245,30245,4865E61AE7876A808DD0EADEBFFF6E2B,10171,0,7,7,26,47,1347
30246,30246,4865E61AE7876A808DD0EADEBFFF6E2B,40951,10,11,1,36,49,1849
30247,30247,4865E61AE7876A808DD0EADEBFFF6E2B,11211,15,18,3,34,49,1749
30248,30248,81565F9704E60766FEFBB47B416D00DF,12581,0,2,2,24,48,1248
30249,30249,81565F9704E60766FEFBB47B416D00DF,12051,4,8,4,20,47,1047
30250,30250,81565F9704E60766FEFBB47B416D00DF,42691,8,13,5,24,48,1248
30251,30251,81565F9704E60766FEFBB47B416D00DF,12051,14,15,1,20,47,1047
30252,30252,81565F9704E60766FEFBB47B416D00DF,12581,18,23,5,24,48,1248
30257,30257,AD235EE6A83CA7956AB86E8BC887D3C7,11541,0,6,6,35,49,1799
30258,30258,AD235EE6A83CA7956AB86E8BC887D3C7,11021,7,11,4,36,49,1849
30259,30259,AD235EE6A83CA7956AB86E8BC887D3C7,13561,14,16,2,37,49,1899
30260,30260,AD235EE6A83CA7956AB86E8BC887D3C7,11021,16,18,2,36,49,1849
30261,30261,AD235EE6A83CA7956AB86E8BC887D3C7,11541,19,23,4,35,49,1799
30262,30262,809D30997DBB6653E10DF33CB05A97F7,13771,0,14,14,21,45,1095
30263,30263,809D30997DBB6653E10DF33CB05A97F7,12601,14,16,2,25,47,1297
30264,30264,809D30997DBB6653E10DF33CB05A97F7,13771,17,23,6,21,45,1095
30269,30269,EE943A825C03A473E1B9EEBEEDFC68AA,42301,3,6,3,36,47,1847
30270,30270,EE943A825C03A473E1B9EEBEEDFC68AA,10111,9,11,2,37,47,1897
30271,30271,EE943A825C03A473E1B9EEBEEDFC68AA,11231,11,13,2,37,49,1899
30272,30272,EE943A825C03A473E1B9EEBEEDFC68AA,42301,13,15,2,36,47,1847
30273,30273,EE943A825C03A473E1B9EEBEEDFC68AA,10111,15,18,3,37,47,1897
30274,30274,EE943A825C03A473E1B9EEBEEDFC68AA,10251,20,21,1,35,47,1797
30275,30275,5B005239AD91B224060A740123F8C94E,13231,0,15,15,39,46,1996
30276,30276,5B005239AD91B224060A740123F8C94E,42231,15,17,2,37,46,1896
30277,30277,5B005239AD91B224060A740123F8C94E,13911,17,18,1,39,46,1996
30278,30278,5B005239AD91B224060A740123F8C94E,42231,19,22,3,37,46,1896
30279,30279,5B005239AD91B224060A740123F8C94E,13231,22,23,1,39,46,1996
30286,30286,132BAF41704DD845C2F70543C3732C4E,13711,1,2,1,38,46,1946
30287,30287,132BAF41704DD845C2F70543C3732C4E,42231,3,7,4,37,46,1896
30288,30288,132BAF41704DD845C2F70543C3732C4E,13711,8,12,4,38,46,1946
30289,30289,132BAF41704DD845C2F70543C3732C4E,42231,14,16,2,37,46,1896
30290,30290,132BAF41704DD845C2F70543C3732C4E,13711,17,19,2,38,46,1946
30291,30291,132BAF41704DD845C2F70543C3732C4E,42231,21,22,1,37,46,1896
30302,30302,F2812FE3AA21CE45A5EFD1D980E36D0B,10721,0,5,5,31,48,1598
30303,30303,F2812FE3AA21CE45A5EFD1D980E36D0B,13041,7,9,2,30,37,1537
30304,30304,F2812FE3AA21CE45A5EFD1D980E36D0B,10721,14,17,3,31,48,1598
30305,30305,F2812FE3AA21CE45A5EFD1D980E36D0B,11531,18,19,1,34,49,1749
30306,30306,F2812FE3AA21CE45A5EFD1D980E36D0B,11231,20,23,3,37,49,1899
30310,30310,E1BB7B2CDA075A402737990C0757A672,40632,0,14,14,35,48,1798
30311,30311,E1BB7B2CDA075A402737990C0757A672,11771,14,18,4,39,49,1999
30312,30312,E1BB7B2CDA075A402737990C0757A672,40632,19,23,4,35,48,1798
30313,30313,74B1AFCB5F944E1DAC044B57BB362A2A,13111,0,9,9,42,46,2146
30314,30314,74B1AFCB5F944E1DAC044B57BB362A2A,13791,13,15,2,42,47,2147
30315,30315,74B1AFCB5F944E1DAC044B57BB362A2A,10841,18,20,2,37,47,1897
30326,30326,58F88D24C8D34253C1CFFF1E39E8BF81,10681,0,11,11,30,48,1548
30327,30327,58F88D24C8D34253C1CFFF1E39E8BF81,11521,12,14,2,41,48,2098
30328,30328,58F88D24C8D34253C1CFFF1E39E8BF81,10681,15,17,2,30,48,1548
30329,30329,58F88D24C8D34253C1CFFF1E39E8BF81,10491,18,20,2,33,48,1698
30330,30330,58F88D24C8D34253C1CFFF1E39E8BF81,40341,20,22,2,23,49,1199
30331,30331,58F88D24C8D34253C1CFFF1E39E8BF81,11061,22,23,1,29,48,1498
30338,30338,A52680CFF3255B80F2E899094DC1E938,13951,0,7,7,47,45,2395
30339,30339,A52680CFF3255B80F2E899094DC1E938,43951,7,11,4,49,41,2491
30340,30340,A52680CFF3255B80F2E899094DC1E938,13951,12,13,1,47,45,2395
30341,30341,A52680CFF3255B80F2E899094DC1E938,43951,14,18,4,49,41,2491
30342,30342,A52680CFF3255B80F2E899094DC1E938,13951,19,23,4,47,45,2395
30347,30347,60E47AB33736AC41E2674A67294A03D4,10601,0,6,6,39,47,1997
30348,30348,60E47AB33736AC41E2674A67294A03D4,11261,9,11,2,36,46,1846
30349,30349,60E47AB33736AC41E2674A67294A03D4,13711,11,13,2,38,46,1946
30350,30350,60E47AB33736AC41E2674A67294A03D4,11261,14,19,5,36,46,1846
30351,30351,60E47AB33736AC41E2674A67294A03D4,12491,20,21,1,36,43,1843
30352,30352,8A669FA8576C037D512EF1FA192DA19A,15091,2,7,5,35,26,1776
30353,30353,8A669FA8576C037D512EF1FA192DA19A,43121,8,13,5,25,27,1277
30354,30354,8A669FA8576C037D512EF1FA192DA19A,15361,16,17,1,33,25,1675
30355,30355,8A669FA8576C037D512EF1FA192DA19A,15091,19,23,4,35,26,1776
30362,30362,E7A499EFF2705CCA8F4C4AD8B684EDF4,11201,0,5,5,35,49,1799
30363,30363,E7A499EFF2705CCA8F4C4AD8B684EDF4,12311,8,14,6,30,44,1544
30364,30364,E7A499EFF2705CCA8F4C4AD8B684EDF4,11951,16,18,2,31,49,1599
30365,30365,E7A499EFF2705CCA8F4C4AD8B684EDF4,10221,19,23,4,34,49,1749
30366,30366,BCBA00BEAEB6DE0B9A71959AB040ABB5,11481,0,6,6,41,48,2098
30367,30367,BCBA00BEAEB6DE0B9A71959AB040ABB5,12141,8,9,1,42,45,2145
30368,30368,BCBA00BEAEB6DE0B9A71959AB040ABB5,12221,14,16,2,43,44,2194
30369,30369,BCBA00BEAEB6DE0B9A71959AB040ABB5,11481,19,22,3,41,48,2098
30373,30373,9D09DCE1A4275410381A48D19E0BBD30,10801,0,12,12,42,47,2147
30374,30374,9D09DCE1A4275410381A48D19E0BBD30,42511,15,17,2,37,47,1897
30375,30375,9D09DCE1A4275410381A48D19E0BBD30,10801,21,23,2,42,47,2147
30376,30376,F36A9C530F88290C9D611D428C0B8F3A,11021,0,14,14,36,49,1849
30377,30377,F36A9C530F88290C9D611D428C0B8F3A,12521,16,17,1,35,41,1791
30378,30378,F36A9C530F88290C9D611D428C0B8F3A,10221,19,20,1,34,49,1749
30379,30379,F36A9C530F88290C9D611D428C0B8F3A,40261,20,22,2,35,49,1799
30383,30383,9E74C4204DF0368A301BB287E42AE5CC,13371,0,8,8,41,47,2097
30384,30384,9E74C4204DF0368A301BB287E42AE5CC,10771,8,9,1,41,46,2096
30385,30385,9E74C4204DF0368A301BB287E42AE5CC,43241,10,12,2,36,46,1846
30386,30386,9E74C4204DF0368A301BB287E42AE5CC,13371,19,21,2,41,47,2097
30390,30390,D366589B3E90DFE9BB97263FFFDAB40D,10811,1,3,2,38,46,1946
30391,30391,D366589B3E90DFE9BB97263FFFDAB40D,13911,4,5,1,39,46,1996
30392,30392,D366589B3E90DFE9BB97263FFFDAB40D,42231,8,9,1,37,46,1896
30393,30393,D366589B3E90DFE9BB97263FFFDAB40D,13911,10,14,4,39,46,1996
30394,30394,D366589B3E90DFE9BB97263FFFDAB40D,42231,15,16,1,37,46,1896
30395,30395,D366589B3E90DFE9BB97263FFFDAB40D,13911,18,23,5,39,46,1996
30396,30396,E5547D3185F38B5D86673D95E45685DB,10841,1,9,8,37,47,1897
30397,30397,E5547D3185F38B5D86673D95E45685DB,42381,12,13,1,39,41,1991
30398,30398,E5547D3185F38B5D86673D95E45685DB,12521,13,16,3,35,41,1791
30399,30399,E5547D3185F38B5D86673D95E45685DB,43361,18,19,1,38,48,1948
30400,30400,E5547D3185F38B5D86673D95E45685DB,10841,22,23,1,37,47,1897
30401,30401,8075DAAF176C5F9FC4052CCC9203B4B2,16281,0,1,1,11,4,554
30402,30402,8075DAAF176C5F9FC4052CCC9203B4B2,16321,2,4,2,8,7,407
30403,30403,8075DAAF176C5F9FC4052CCC9203B4B2,16281,7,23,16,11,4,554
30416,30416,F503E603617F2C8DE95DF3F33038AA90,11151,0,17,17,30,48,1548
30417,30417,F503E603617F2C8DE95DF3F33038AA90,40341,18,19,1,23,49,1199
30418,30418,F503E603617F2C8DE95DF3F33038AA90,11151,21,23,2,30,48,1548
30423,30423,A2AA07DF0DCA4A9D5EE9A81521A19C25,10351,0,1,1,28,45,1445
30424,30424,A2AA07DF0DCA4A9D5EE9A81521A19C25,13671,2,4,2,27,43,1393
30425,30425,A2AA07DF0DCA4A9D5EE9A81521A19C25,10301,4,6,2,31,45,1595
30426,30426,A2AA07DF0DCA4A9D5EE9A81521A19C25,13671,6,7,1,27,43,1393
30427,30427,A2AA07DF0DCA4A9D5EE9A81521A19C25,10301,15,16,1,31,45,1595
30428,30428,A2AA07DF0DCA4A9D5EE9A81521A19C25,10351,18,19,1,28,45,1445
30435,30435,CB51EA3DFBAD71C46F446085843381F3,15391,0,7,7,35,26,1776
30436,30436,CB51EA3DFBAD71C46F446085843381F3,43121,7,18,11,25,27,1277
30437,30437,CB51EA3DFBAD71C46F446085843381F3,15091,20,22,2,35,26,1776
30438,30438,138FF279D92615D61A668B43E45A706D,42221,0,9,9,38,48,1948
30439,30439,138FF279D92615D61A668B43E45A706D,42301,9,12,3,36,47,1847
30440,30440,138FF279D92615D61A668B43E45A706D,42321,16,17,1,43,47,2197
30441,30441,138FF279D92615D61A668B43E45A706D,42221,21,23,2,38,48,1948
30445,30445,DC066CD0495E31C3328CCF0DC4172A03,13314,0,6,6,31,39,1589
30446,30446,DC066CD0495E31C3328CCF0DC4172A03,12521,7,13,6,35,41,1791
30447,30447,DC066CD0495E31C3328CCF0DC4172A03,13314,13,23,10,31,39,1589
30448,30448,7A880FE847C48EF3051E04A866E8ED9A,42971,2,12,10,43,49,2199
30449,30449,7A880FE847C48EF3051E04A866E8ED9A,10151,13,14,1,34,47,1747
30450,30450,7A880FE847C48EF3051E04A866E8ED9A,10251,16,18,2,35,47,1797
30451,30451,7A880FE847C48EF3051E04A866E8ED9A,40636,21,23,2,35,48,1798
30459,30459,2ABF49253EA5397F3561D28BF0E75271,43161,0,14,14,35,47,1797
30460,30460,2ABF49253EA5397F3561D28BF0E75271,42623,17,18,1,22,49,1149
30461,30461,2ABF49253EA5397F3561D28BF0E75271,10971,21,23,2,35,47,1797
30462,30462,4F34225CDC596E63EE8F1BEB4ACA56CC,43011,0,7,7,40,42,2042
30463,30463,4F34225CDC596E63EE8F1BEB4ACA56CC,12521,7,16,9,35,41,1791
30464,30464,4F34225CDC596E63EE8F1BEB4ACA56CC,43011,19,21,2,40,42,2042
30471,30471,2446E8F15BFC2A49F5E456D12DC187B8,42071,0,5,5,31,49,1599
30472,30472,2446E8F15BFC2A49F5E456D12DC187B8,43391,9,12,3,29,48,1498
30473,30473,2446E8F15BFC2A49F5E456D12DC187B8,10381,13,14,1,31,49,1599
30474,30474,2446E8F15BFC2A49F5E456D12DC187B8,43391,15,16,1,29,48,1498
30475,30475,2446E8F15BFC2A49F5E456D12DC187B8,10381,17,23,6,31,49,1599
30476,30476,2A49789A9C87E826D89AA399A7E108C0,12083,0,9,9,36,49,1849
30477,30477,2A49789A9C87E826D89AA399A7E108C0,13471,12,14,2,47,49,2399
30478,30478,2A49789A9C87E826D89AA399A7E108C0,42141,17,19,2,32,47,1647
30479,30479,2A49789A9C87E826D89AA399A7E108C0,11231,19,23,4,37,49,1899
30480,30480,70BFB6853FABD538EB052DBA1C5DEBF3,10381,5,6,1,31,49,1599
30481,30481,70BFB6853FABD538EB052DBA1C5DEBF3,42121,11,14,3,26,49,1349
30482,30482,70BFB6853FABD538EB052DBA1C5DEBF3,42623,15,16,1,22,49,1149
30483,30483,70BFB6853FABD538EB052DBA1C5DEBF3,11061,16,19,3,29,48,1498
30491,30491,1C60CB0F57E29CF26D99169B6CE00B11,11381,0,10,10,30,47,1547
30492,30492,1C60CB0F57E29CF26D99169B6CE00B11,11541,11,12,1,35,49,1799
30493,30493,1C60CB0F57E29CF26D99169B6CE00B11,11381,13,18,5,30,47,1547
30494,30494,1C60CB0F57E29CF26D99169B6CE00B11,43361,21,22,1,38,48,1948
30498,30498,310495CED2B9A5474016E6C3A39FBC80,10821,0,14,14,40,47,2047
30499,30499,310495CED2B9A5474016E6C3A39FBC80,12514,14,16,2,38,47,1947
30500,30500,310495CED2B9A5474016E6C3A39FBC80,40951,17,19,2,36,49,1849
30501,30501,310495CED2B9A5474016E6C3A39FBC80,10821,21,23,2,40,47,2047
30502,30502,72CBF9D6A57AAF950CC7AA6E4324A7E7,10281,0,7,7,33,48,1698
30503,30503,72CBF9D6A57AAF950CC7AA6E4324A7E7,42141,9,13,4,32,47,1647
30504,30504,72CBF9D6A57AAF950CC7AA6E4324A7E7,40341,14,17,3,23,49,1199
30505,30505,72CBF9D6A57AAF950CC7AA6E4324A7E7,10281,18,20,2,33,48,1698
30506,30506,72CBF9D6A57AAF950CC7AA6E4324A7E7,11331,22,23,1,37,48,1898
30507,30507,592FA83EBA85B354FFC07C3670A06E56,19031,0,6,6,1,42,92
30508,30508,592FA83EBA85B354FFC07C3670A06E56,43644,8,9,1,14,38,738
30509,30509,592FA83EBA85B354FFC07C3670A06E56,19181,12,13,1,8,40,440
30510,30510,592FA83EBA85B354FFC07C3670A06E56,19061,19,21,2,3,43,193
30511,30511,592FA83EBA85B354FFC07C3670A06E56,19031,21,23,2,1,42,92
30512,30512,93DD2C863C5AA53C83002ED6F1D5AEBB,19031,1,5,4,1,42,92
30513,30513,93DD2C863C5AA53C83002ED6F1D5AEBB,19181,6,7,1,8,40,440
30514,30514,93DD2C863C5AA53C83002ED6F1D5AEBB,49201,8,9,1,7,41,391
30515,30515,93DD2C863C5AA53C83002ED6F1D5AEBB,12641,13,17,4,10,43,543
30516,30516,93DD2C863C5AA53C83002ED6F1D5AEBB,49201,17,19,2,7,41,391
30520,30520,BBA244405FCBF580331CF1C7DC28986A,13314,1,3,2,31,39,1589
30521,30521,BBA244405FCBF580331CF1C7DC28986A,13671,5,8,3,27,43,1393
30522,30522,BBA244405FCBF580331CF1C7DC28986A,13314,8,15,7,31,39,1589
30523,30523,BBA244405FCBF580331CF1C7DC28986A,11091,17,19,2,29,47,1497
30524,30524,BBA244405FCBF580331CF1C7DC28986A,13671,19,22,3,27,43,1393
30531,30531,1550936E77AB3F9D5F52AE840621A4EE,10431,0,13,13,33,49,1699
30532,30532,1550936E77AB3F9D5F52AE840621A4EE,42941,16,17,1,37,47,1897
30533,30533,1550936E77AB3F9D5F52AE840621A4EE,10431,18,22,4,33,49,1699
30534,30534,2FF2D0C944A977F1DECFD15718F5B816,42231,3,8,5,37,46,1896
30535,30535,2FF2D0C944A977F1DECFD15718F5B816,13711,11,12,1,38,46,1946
30536,30536,2FF2D0C944A977F1DECFD15718F5B816,42471,17,19,2,35,49,1799
30537,30537,DEF2119ECB90D4385AD1A45A0B2C7A35,43761,3,5,2,32,47,1647
30538,30538,DEF2119ECB90D4385AD1A45A0B2C7A35,42523,7,8,1,31,47,1597
30539,30539,DEF2119ECB90D4385AD1A45A0B2C7A35,43761,10,12,2,32,47,1647
30540,30540,DEF2119ECB90D4385AD1A45A0B2C7A35,42491,14,16,2,32,46,1646
30541,30541,DEF2119ECB90D4385AD1A45A0B2C7A35,43761,20,21,1,32,47,1647
30542,30542,B885E78265DACA8F21D2357388930CCE,13331,5,13,8,38,47,1947
30543,30543,B885E78265DACA8F21D2357388930CCE,11541,15,16,1,35,49,1799
30544,30544,B885E78265DACA8F21D2357388930CCE,12511,17,18,1,39,47,1997
30545,30545,B885E78265DACA8F21D2357388930CCE,12514,20,23,3,38,47,1947
30546,30546,C8853D20D98FBDC677FE97E63FEF8305,12083,2,13,11,36,49,1849
30547,30547,C8853D20D98FBDC677FE97E63FEF8305,10107,15,17,2,38,49,1949
30548,30548,C8853D20D98FBDC677FE97E63FEF8305,42481,19,20,1,22,49,1149
30558,30558,1F739BDB545C56FBC617A916604523EE,42231,0,6,6,37,46,1896
30559,30559,1F739BDB545C56FBC617A916604523EE,10211,8,9,1,16,49,849
30560,30560,1F739BDB545C56FBC617A916604523EE,12581,10,14,4,24,48,1248
30561,30561,1F739BDB545C56FBC617A916604523EE,43751,15,17,2,19,48,998
30562,30562,1F739BDB545C56FBC617A916604523EE,12581,17,19,2,24,48,1248
30563,30563,1F739BDB545C56FBC617A916604523EE,42231,20,23,3,37,46,1896
30564,30564,82EFEE8C48953CCFABA92D42A14AA9D9,15191,0,7,7,36,27,1827
30565,30565,82EFEE8C48953CCFABA92D42A14AA9D9,15411,9,16,7,44,27,2227
30566,30566,82EFEE8C48953CCFABA92D42A14AA9D9,15391,18,21,3,35,26,1776
30573,30573,CBCBC4EFD4DD5AB68824D0A95962A2BF,15411,0,7,7,44,27,2227
30574,30574,CBCBC4EFD4DD5AB68824D0A95962A2BF,43724,8,9,1,35,33,1783
30575,30575,CBCBC4EFD4DD5AB68824D0A95962A2BF,15411,11,23,12,44,27,2227
30586,30586,4464BD039B35CE3EE5B2A5EA08665552,16261,10,16,6,3,3,153
30587,30587,4464BD039B35CE3EE5B2A5EA08665552,11201,19,20,1,35,49,1799
30588,30588,4464BD039B35CE3EE5B2A5EA08665552,43171,21,22,1,39,49,1999
30589,30589,8E7E1D3BA1392AF853A6068E181E9940,12971,1,11,10,32,48,1648
30590,30590,8E7E1D3BA1392AF853A6068E181E9940,11741,14,15,1,42,49,2149
30591,30591,8E7E1D3BA1392AF853A6068E181E9940,10191,15,18,3,40,48,2048
30599,30599,A0B07DBD7CFEABE1E4A0E9444C496CF6,42271,0,1,1,40,47,2047
30600,30600,A0B07DBD7CFEABE1E4A0E9444C496CF6,13381,1,7,6,39,47,1997
30601,30601,A0B07DBD7CFEABE1E4A0E9444C496CF6,42271,8,11,3,40,47,2047
30602,30602,A0B07DBD7CFEABE1E4A0E9444C496CF6,13381,12,13,1,39,47,1997
30603,30603,A0B07DBD7CFEABE1E4A0E9444C496CF6,42271,13,16,3,40,47,2047
30604,30604,A0B07DBD7CFEABE1E4A0E9444C496CF6,13381,18,21,3,39,47,1997
30605,30605,A0B07DBD7CFEABE1E4A0E9444C496CF6,42271,21,23,2,40,47,2047
30616,30616,E6FF42AEECF0CDA6C42BDBDEFD456416,13951,0,7,7,47,45,2395
30617,30617,E6FF42AEECF0CDA6C42BDBDEFD456416,43951,9,11,2,49,41,2491
30618,30618,E6FF42AEECF0CDA6C42BDBDEFD456416,13951,12,13,1,47,45,2395
30619,30619,E6FF42AEECF0CDA6C42BDBDEFD456416,43951,14,16,2,49,41,2491
30620,30620,E6FF42AEECF0CDA6C42BDBDEFD456416,13951,18,23,5,47,45,2395
30625,30625,E5BB92AE788D676EF5421215D9B4CAD1,11861,0,8,8,32,47,1647
30626,30626,E5BB92AE788D676EF5421215D9B4CAD1,13091,10,14,4,20,42,1042
30627,30627,E5BB92AE788D676EF5421215D9B4CAD1,11861,16,22,6,32,47,1647
30628,30628,2089CCBC2F855C8416A68A67F03D7345,41031,0,7,7,32,49,1649
30629,30629,2089CCBC2F855C8416A68A67F03D7345,10161,8,12,4,35,49,1799
30630,30630,2089CCBC2F855C8416A68A67F03D7345,10841,12,14,2,37,47,1897
30631,30631,2089CCBC2F855C8416A68A67F03D7345,42981,14,16,2,36,49,1849
30632,30632,2089CCBC2F855C8416A68A67F03D7345,10161,17,18,1,35,49,1799
30653,30653,0367A1F13F7EBCABCF28C4AB3138B113,10171,8,10,2,26,47,1347
30654,30654,0367A1F13F7EBCABCF28C4AB3138B113,13911,13,14,1,39,46,1996
30655,30655,0367A1F13F7EBCABCF28C4AB3138B113,11261,15,23,8,36,46,1846
30660,30660,1E80787B69718C7476B2A0E1C06850FD,42401,0,13,13,36,47,1847
30661,30661,1E80787B69718C7476B2A0E1C06850FD,11381,14,16,2,30,47,1547
30662,30662,1E80787B69718C7476B2A0E1C06850FD,42301,19,21,2,36,47,1847
30663,30663,1E80787B69718C7476B2A0E1C06850FD,10111,21,23,2,37,47,1897
30664,30664,AB652B14D0006620935B2EA1FDED8C25,11753,4,7,3,35,48,1798
30665,30665,AB652B14D0006620935B2EA1FDED8C25,10971,9,10,1,35,47,1797
30666,30666,AB652B14D0006620935B2EA1FDED8C25,10511,12,18,6,35,46,1796
30667,30667,AB652B14D0006620935B2EA1FDED8C25,13121,18,21,3,38,46,1946
30668,30668,AB652B14D0006620935B2EA1FDED8C25,11231,21,23,2,37,49,1899
30669,30669,14DAF335F4CBCDBE4E07381277F389B6,43751,0,6,6,19,48,998
30670,30670,14DAF335F4CBCDBE4E07381277F389B6,12581,10,20,10,24,48,1248
30671,30671,14DAF335F4CBCDBE4E07381277F389B6,43751,20,22,2,19,48,998
30689,30689,2096D605E761270CADC602C6FACD079B,42491,0,8,8,32,46,1646
30690,30690,2096D605E761270CADC602C6FACD079B,43971,8,11,3,30,48,1548
30691,30691,2096D605E761270CADC602C6FACD079B,11061,12,19,7,29,48,1498
30692,30692,5832F798017EC944959971DE10E6C76B,13911,2,6,4,39,46,1996
30693,30693,5832F798017EC944959971DE10E6C76B,11261,8,9,1,36,46,1846
30694,30694,5832F798017EC944959971DE10E6C76B,12211,13,15,2,41,44,2094
30695,30695,5832F798017EC944959971DE10E6C76B,42351,15,16,1,38,45,1945
30696,30696,5832F798017EC944959971DE10E6C76B,13911,20,21,1,39,46,1996
30697,30697,E748F2254AC2A75A1317C0ED54387A7E,42831,2,6,4,27,48,1398
30698,30698,E748F2254AC2A75A1317C0ED54387A7E,10381,9,12,3,31,49,1599
30699,30699,E748F2254AC2A75A1317C0ED54387A7E,42831,12,23,11,27,48,1398
30700,30700,D70B599B2DC6AADF34C273ACBD3A4312,42401,0,15,15,36,47,1847
30701,30701,D70B599B2DC6AADF34C273ACBD3A4312,10381,16,17,1,31,49,1599
30702,30702,D70B599B2DC6AADF34C273ACBD3A4312,42401,18,23,5,36,47,1847
30706,30706,3FCAEF7F5639836756473C829C683B1D,42401,1,6,5,36,47,1847
30707,30707,3FCAEF7F5639836756473C829C683B1D,11111,7,17,10,26,48,1348
30708,30708,3FCAEF7F5639836756473C829C683B1D,10111,18,23,5,37,47,1897
30709,30709,86F83A4789830DBB7C5E8BC1D0F8B089,13091,1,5,4,20,42,1042
30710,30710,86F83A4789830DBB7C5E8BC1D0F8B089,12921,6,7,1,9,41,491
30711,30711,86F83A4789830DBB7C5E8BC1D0F8B089,43021,9,11,2,16,43,843
30712,30712,86F83A4789830DBB7C5E8BC1D0F8B089,43751,18,21,3,19,48,998
30713,30713,86F83A4789830DBB7C5E8BC1D0F8B089,11101,21,23,2,18,48,948
30717,30717,017A725FE9C4C50AD6E7804B9E2EC1C6,42011,0,8,8,36,46,1846
30718,30718,017A725FE9C4C50AD6E7804B9E2EC1C6,42381,10,12,2,39,41,1991
30719,30719,017A725FE9C4C50AD6E7804B9E2EC1C6,42011,13,20,7,36,46,1846
30734,30734,6C0E943C8B3CE3071E466B3888DE833C,12311,6,9,3,30,44,1544
30735,30735,6C0E943C8B3CE3071E466B3888DE833C,42531,9,11,2,31,45,1595
30736,30736,6C0E943C8B3CE3071E466B3888DE833C,12311,12,14,2,30,44,1544
30737,30737,6C0E943C8B3CE3071E466B3888DE833C,42531,14,17,3,31,45,1595
30738,30738,6C0E943C8B3CE3071E466B3888DE833C,19744,19,22,3,6,43,343
30739,30739,C20496C873E4D6CBDAA003A1B830833C,11011,0,7,7,39,49,1999
30740,30740,C20496C873E4D6CBDAA003A1B830833C,11074,13,15,2,37,47,1897
30741,30741,C20496C873E4D6CBDAA003A1B830833C,11875,16,17,1,30,46,1546
30742,30742,C20496C873E4D6CBDAA003A1B830833C,11011,21,23,2,39,49,1999
30743,30743,DC736499F15CC90E33F3F344F148EB89,40833,2,10,8,41,47,2097
30744,30744,DC736499F15CC90E33F3F344F148EB89,11461,20,21,1,37,49,1899
30745,30745,DC736499F15CC90E33F3F344F148EB89,13271,21,23,2,41,47,2097
30746,30746,1C4286795932E5315147C67BA60ADCE3,15191,0,8,8,36,27,1827
30747,30747,1C4286795932E5315147C67BA60ADCE3,43081,9,10,1,27,28,1378
30748,30748,1C4286795932E5315147C67BA60ADCE3,15191,12,13,1,36,27,1827
30749,30749,1C4286795932E5315147C67BA60ADCE3,12792,18,19,1,34,30,1730
30754,30754,793DC4BC4E2928DCDBFB7B36F78CD36B,10251,0,1,1,35,47,1797
30755,30755,793DC4BC4E2928DCDBFB7B36F78CD36B,42401,3,6,3,36,47,1847
30756,30756,793DC4BC4E2928DCDBFB7B36F78CD36B,10111,7,11,4,37,47,1897
30757,30757,793DC4BC4E2928DCDBFB7B36F78CD36B,40637,12,19,7,36,47,1847
30758,30758,793DC4BC4E2928DCDBFB7B36F78CD36B,10471,20,21,1,37,48,1898
30759,30759,793DC4BC4E2928DCDBFB7B36F78CD36B,42401,21,23,2,36,47,1847
30764,30764,645D5AB3176764CF68EB0DF289246158,43761,0,14,14,32,47,1647
30765,30765,645D5AB3176764CF68EB0DF289246158,40341,15,17,2,23,49,1199
30766,30766,645D5AB3176764CF68EB0DF289246158,43761,20,22,2,32,47,1647
30767,30767,46D10B971C10D2856504DC61068F66E7,12381,0,2,2,32,48,1648
30768,30768,46D10B971C10D2856504DC61068F66E7,12491,3,7,4,36,43,1843
30769,30769,46D10B971C10D2856504DC61068F66E7,19111,9,23,14,9,45,495
30773,30773,39179060954ADF536A44D5CDC3D7ADA4,10921,0,4,4,43,48,2198
30774,30774,39179060954ADF536A44D5CDC3D7ADA4,11261,6,10,4,36,46,1846
30775,30775,39179060954ADF536A44D5CDC3D7ADA4,13911,12,16,4,39,46,1996
30776,30776,39179060954ADF536A44D5CDC3D7ADA4,11261,16,23,7,36,46,1846
30780,30780,59C9891991D18AB42F5CA2A676EAFEE0,42501,0,7,7,28,47,1447
30781,30781,59C9891991D18AB42F5CA2A676EAFEE0,13731,12,17,5,33,49,1699
30782,30782,59C9891991D18AB42F5CA2A676EAFEE0,42501,19,23,4,28,47,1447
30783,30783,BA6D45213D52989026A398B5D7995374,43644,0,6,6,14,38,738
30784,30784,BA6D45213D52989026A398B5D7995374,19181,6,19,13,8,40,440
30785,30785,BA6D45213D52989026A398B5D7995374,43644,21,23,2,14,38,738
30786,30786,0025E620ECBCE3FCC81B4262138E77D1,12401,0,1,1,39,49,1999
30787,30787,0025E620ECBCE3FCC81B4262138E77D1,40361,2,6,4,42,48,2148
30788,30788,0025E620ECBCE3FCC81B4262138E77D1,11481,6,7,1,41,48,2098
30789,30789,0025E620ECBCE3FCC81B4262138E77D1,11801,8,21,13,42,48,2148
30790,30790,0025E620ECBCE3FCC81B4262138E77D1,13101,22,23,1,40,47,2047
30791,30791,141A87FA0005158A87D02A7AC0237629,13561,0,2,2,37,49,1899
30792,30792,141A87FA0005158A87D02A7AC0237629,11751,18,20,2,35,48,1798
30793,30793,141A87FA0005158A87D02A7AC0237629,11701,22,23,1,43,48,2198
30797,30797,FE2BCF9C3956859FCE3A08C6A6AB0960,11741,0,8,8,42,49,2149
30798,30798,FE2BCF9C3956859FCE3A08C6A6AB0960,13471,8,10,2,47,49,2399
30799,30799,FE2BCF9C3956859FCE3A08C6A6AB0960,42601,16,17,1,44,48,2248
30800,30800,FE2BCF9C3956859FCE3A08C6A6AB0960,11741,18,23,5,42,49,2149
30807,30807,58DF107986367FA88C1D627635A20D98,42011,1,6,5,36,46,1846
30808,30808,58DF107986367FA88C1D627635A20D98,42521,8,10,2,31,47,1597
30809,30809,58DF107986367FA88C1D627635A20D98,11861,11,13,2,32,47,1647
30810,30810,58DF107986367FA88C1D627635A20D98,11461,14,16,2,37,49,1899
30811,30811,58DF107986367FA88C1D627635A20D98,11861,18,19,1,32,47,1647
30812,30812,58DF107986367FA88C1D627635A20D98,42011,20,23,3,36,46,1846
30813,30813,A5A342C5B79B8AEE00BA80AE678B8EC5,10331,0,8,8,39,46,1996
30814,30814,A5A342C5B79B8AEE00BA80AE678B8EC5,11151,8,11,3,30,48,1548
30815,30815,A5A342C5B79B8AEE00BA80AE678B8EC5,10331,12,14,2,39,46,1996
30816,30816,A5A342C5B79B8AEE00BA80AE678B8EC5,11151,15,17,2,30,48,1548
30817,30817,A5A342C5B79B8AEE00BA80AE678B8EC5,10331,20,23,3,39,46,1996
30818,30818,2AB1E00AE324EB01DB00242758B61F8A,11001,0,7,7,42,47,2147
30819,30819,2AB1E00AE324EB01DB00242758B61F8A,11531,12,16,4,34,49,1749
30820,30820,2AB1E00AE324EB01DB00242758B61F8A,11001,18,23,5,42,47,2147
30825,30825,F95E8C48F26FEDEBE2F61D5B3778D40A,43281,0,9,9,37,48,1898
30826,30826,F95E8C48F26FEDEBE2F61D5B3778D40A,10731,10,13,3,33,47,1697
30827,30827,F95E8C48F26FEDEBE2F61D5B3778D40A,10661,13,15,2,37,49,1899
30828,30828,F95E8C48F26FEDEBE2F61D5B3778D40A,19111,16,17,1,9,45,495
30829,30829,F95E8C48F26FEDEBE2F61D5B3778D40A,43281,19,23,4,37,48,1898
30833,30833,1A6A180FC1652CDA8F079E8572A81E38,42501,0,7,7,28,47,1447
30834,30834,1A6A180FC1652CDA8F079E8572A81E38,12391,9,12,3,36,49,1849
30835,30835,1A6A180FC1652CDA8F079E8572A81E38,11231,12,17,5,37,49,1899
30836,30836,1A6A180FC1652CDA8F079E8572A81E38,42501,18,23,5,28,47,1447
30837,30837,698E1A34C01E7972A66B3ED2C9BEE544,40637,0,12,12,36,47,1847
30838,30838,698E1A34C01E7972A66B3ED2C9BEE544,12311,13,15,2,30,44,1544
30839,30839,698E1A34C01E7972A66B3ED2C9BEE544,10251,19,23,4,35,47,1797
30843,30843,622CAD2A1CBEEB3E7C37B415C8550447,13561,0,7,7,37,49,1899
30844,30844,622CAD2A1CBEEB3E7C37B415C8550447,11021,7,9,2,36,49,1849
30845,30845,622CAD2A1CBEEB3E7C37B415C8550447,10251,12,15,3,35,47,1797
30846,30846,622CAD2A1CBEEB3E7C37B415C8550447,42321,19,21,2,43,47,2197
30856,30856,3ADF1F40A3E7D2F77A54CBF8A723358F,42523,0,2,2,31,47,1597
30857,30857,3ADF1F40A3E7D2F77A54CBF8A723358F,10292,2,9,7,30,47,1547
30858,30858,3ADF1F40A3E7D2F77A54CBF8A723358F,12381,11,13,2,32,48,1648
30859,30859,3ADF1F40A3E7D2F77A54CBF8A723358F,10292,14,16,2,30,47,1547
30860,30860,3ADF1F40A3E7D2F77A54CBF8A723358F,11171,18,21,3,33,48,1698
30861,30861,A910A64B88EF93AE4B4F67D39EA167CE,40171,0,2,2,38,48,1948
30862,30862,A910A64B88EF93AE4B4F67D39EA167CE,11811,4,6,2,38,49,1949
30863,30863,A910A64B88EF93AE4B4F67D39EA167CE,10471,6,8,2,37,48,1898
30864,30864,A910A64B88EF93AE4B4F67D39EA167CE,42581,8,16,8,38,48,1948
30865,30865,A910A64B88EF93AE4B4F67D39EA167CE,10471,17,22,5,37,48,1898
30866,30866,5B1C0BC031C302008BE737E10A20E45F,11481,0,7,7,41,48,2098
30867,30867,5B1C0BC031C302008BE737E10A20E45F,11131,9,11,2,33,48,1698
30868,30868,5B1C0BC031C302008BE737E10A20E45F,11801,12,19,7,42,48,2148
30869,30869,5B1C0BC031C302008BE737E10A20E45F,11481,20,23,3,41,48,2098
30870,30870,F209A399D7060EB5C592C672B5567F86,19901,8,9,1,7,44,394
30871,30871,F209A399D7060EB5C592C672B5567F86,12921,11,14,3,9,41,491
30872,30872,F209A399D7060EB5C592C672B5567F86,12641,14,20,6,10,43,543
30873,30873,FB55B20B748C0A1CF26B4BE2B509424A,12731,0,5,5,22,40,1140
30874,30874,FB55B20B748C0A1CF26B4BE2B509424A,13671,6,10,4,27,43,1393
30875,30875,FB55B20B748C0A1CF26B4BE2B509424A,12761,11,13,2,25,40,1290
30876,30876,FB55B20B748C0A1CF26B4BE2B509424A,13671,14,18,4,27,43,1393
30883,30883,440A5BC995406F5A39B97937FE6675EC,12641,0,4,4,10,43,543
30884,30884,440A5BC995406F5A39B97937FE6675EC,43644,7,17,10,14,38,738
30885,30885,440A5BC995406F5A39B97937FE6675EC,12641,20,22,2,10,43,543
30886,30886,AA71E9A6AEA764D2564D532D0321512B,42041,0,5,5,10,47,547
30887,30887,AA71E9A6AEA764D2564D532D0321512B,11471,6,8,2,12,48,648
30888,30888,AA71E9A6AEA764D2564D532D0321512B,42041,11,13,2,10,47,547
30889,30889,AA71E9A6AEA764D2564D532D0321512B,19441,15,18,3,8,46,446
30890,30890,AA71E9A6AEA764D2564D532D0321512B,11571,20,22,2,13,46,696
30894,30894,963D3FC841F63E14E513E0B8C4C21628,13121,0,3,3,38,46,1946
30895,30895,963D3FC841F63E14E513E0B8C4C21628,12521,5,8,3,35,41,1791
30896,30896,963D3FC841F63E14E513E0B8C4C21628,12491,12,14,2,36,43,1843
30897,30897,963D3FC841F63E14E513E0B8C4C21628,42151,14,15,1,35,45,1795
30898,30898,963D3FC841F63E14E513E0B8C4C21628,13121,21,23,2,38,46,1946
30899,30899,B9E927B8C825AF1AC2891B310330CB7E,42011,0,7,7,36,46,1846
30900,30900,B9E927B8C825AF1AC2891B310330CB7E,10221,11,13,2,34,49,1749
30901,30901,B9E927B8C825AF1AC2891B310330CB7E,42011,14,19,5,36,46,1846
30902,30902,B9E927B8C825AF1AC2891B310330CB7E,13511,20,21,1,34,48,1748
30906,30906,CC542EA3A72441C176DD8B2A582775E3,40637,0,9,9,36,47,1847
30907,30907,CC542EA3A72441C176DD8B2A582775E3,11001,11,12,1,42,47,2147
30908,30908,CC542EA3A72441C176DD8B2A582775E3,11231,15,17,2,37,49,1899
30909,30909,CC542EA3A72441C176DD8B2A582775E3,10731,18,21,3,33,47,1697
30910,30910,CC542EA3A72441C176DD8B2A582775E3,10251,21,23,2,35,47,1797
30917,30917,71C7D3BEB879651EE771977BC4EF34E5,10341,0,6,6,31,47,1597
30918,30918,71C7D3BEB879651EE771977BC4EF34E5,10351,7,11,4,28,45,1445
30919,30919,71C7D3BEB879651EE771977BC4EF34E5,12661,12,14,2,32,45,1645
30920,30920,71C7D3BEB879651EE771977BC4EF34E5,10351,14,17,3,28,45,1445
30921,30921,71C7D3BEB879651EE771977BC4EF34E5,10341,21,23,2,31,47,1597
30925,30925,A8491B4932A74BB29E61F0906E6D23DE,42461,0,16,16,45,47,2297
30926,30926,A8491B4932A74BB29E61F0906E6D23DE,11074,17,19,2,37,47,1897
30927,30927,A8491B4932A74BB29E61F0906E6D23DE,42201,20,23,3,43,46,2196
30928,30928,A3BFED7EBC8273A150663075EB9361B2,11271,3,4,1,37,48,1898
30929,30929,A3BFED7EBC8273A150663075EB9361B2,11021,5,8,3,36,49,1849
30930,30930,A3BFED7EBC8273A150663075EB9361B2,40181,9,10,1,37,49,1899
30931,30931,A3BFED7EBC8273A150663075EB9361B2,12391,19,21,2,36,49,1849
30932,30932,A3BFED7EBC8273A150663075EB9361B2,11271,22,23,1,37,48,1898
30933,30933,ED387BC9729A0D8CA1364378D6AA6E43,10634,1,13,12,27,45,1395
30934,30934,ED387BC9729A0D8CA1364378D6AA6E43,11841,14,15,1,33,46,1696
30935,30935,ED387BC9729A0D8CA1364378D6AA6E43,10634,18,22,4,27,45,1395
30936,30936,9B628FEA6BCA8EB97BB3F7B5F63CD306,13911,0,7,7,39,46,1996
30937,30937,9B628FEA6BCA8EB97BB3F7B5F63CD306,12671,8,9,1,21,43,1093
30938,30938,9B628FEA6BCA8EB97BB3F7B5F63CD306,10351,12,14,2,28,45,1445
30939,30939,9B628FEA6BCA8EB97BB3F7B5F63CD306,13911,18,23,5,39,46,1996
30940,30940,F3355C7CE640AE85292C2A8D8E7E2415,40833,0,7,7,41,47,2097
30941,30941,F3355C7CE640AE85292C2A8D8E7E2415,10161,12,17,5,35,49,1799
30942,30942,F3355C7CE640AE85292C2A8D8E7E2415,13271,21,23,2,41,47,2097
30952,30952,FA11FB85FFA438962CC9C2E7C90144A5,42711,0,7,7,26,48,1348
30953,30953,FA11FB85FFA438962CC9C2E7C90144A5,13121,11,14,3,38,46,1946
30954,30954,FA11FB85FFA438962CC9C2E7C90144A5,42121,17,19,2,26,49,1349
30955,30955,FA11FB85FFA438962CC9C2E7C90144A5,42711,20,23,3,26,48,1348
30956,30956,D7FF370101A79BFE566DB4075F09B40E,42801,0,9,9,40,49,2049
30957,30957,D7FF370101A79BFE566DB4075F09B40E,40341,12,16,4,23,49,1199
30958,30958,D7FF370101A79BFE566DB4075F09B40E,42801,19,20,1,40,49,2049
30963,30963,EFD3CD287097CC7EB227645070325EE5,13341,0,7,7,44,45,2245
30964,30964,EFD3CD287097CC7EB227645070325EE5,42523,8,10,2,31,47,1597
30965,30965,EFD3CD287097CC7EB227645070325EE5,11871,13,14,1,29,46,1496
30966,30966,EFD3CD287097CC7EB227645070325EE5,12131,15,17,2,32,47,1647
30967,30967,EFD3CD287097CC7EB227645070325EE5,11291,17,23,6,40,49,2049
30968,30968,69F41107244EDDE97DD1AAB2D554177A,19281,0,13,13,16,32,832
30969,30969,69F41107244EDDE97DD1AAB2D554177A,12871,16,18,2,22,33,1133
30970,30970,69F41107244EDDE97DD1AAB2D554177A,19281,21,23,2,16,32,832
30971,30971,C0EC240E36490D1263D83D45770C29BF,42321,0,6,6,43,47,2197
30972,30972,C0EC240E36490D1263D83D45770C29BF,42091,7,14,7,43,46,2196
30973,30973,C0EC240E36490D1263D83D45770C29BF,42321,14,16,2,43,47,2197
30974,30974,C0EC240E36490D1263D83D45770C29BF,42091,17,19,2,43,46,2196
30975,30975,C0EC240E36490D1263D83D45770C29BF,42321,21,23,2,43,47,2197
30979,30979,4791E7F4B92A12C67F79536AAA93BED3,10471,0,12,12,37,48,1898
30980,30980,4791E7F4B92A12C67F79536AAA93BED3,11074,13,14,1,37,47,1897
30981,30981,4791E7F4B92A12C67F79536AAA93BED3,11331,15,18,3,37,48,1898
30982,30982,4791E7F4B92A12C67F79536AAA93BED3,11074,19,20,1,37,47,1897
30983,30983,4791E7F4B92A12C67F79536AAA93BED3,11331,21,23,2,37,48,1898
30984,30984,C493E8EAD829832CA31397E82BE4990B,43021,0,5,5,16,43,843
30985,30985,C493E8EAD829832CA31397E82BE4990B,12921,6,9,3,9,41,491
30986,30986,C493E8EAD829832CA31397E82BE4990B,43021,11,13,2,16,43,843
30987,30987,C493E8EAD829832CA31397E82BE4990B,12921,13,18,5,9,41,491
30988,30988,C493E8EAD829832CA31397E82BE4990B,43021,20,23,3,16,43,843
30989,30989,83E1267DBFF562AC3705563E6446EE0A,10951,1,9,8,29,48,1498
30990,30990,83E1267DBFF562AC3705563E6446EE0A,43731,17,18,1,34,47,1747
30991,30991,83E1267DBFF562AC3705563E6446EE0A,10251,19,21,2,35,47,1797
30992,30992,83E1267DBFF562AC3705563E6446EE0A,11381,21,23,2,30,47,1547
30993,30993,6324E038DED9EC12CD06DF2BDBC3BEAA,43644,1,2,1,14,38,738
30994,30994,6324E038DED9EC12CD06DF2BDBC3BEAA,19181,3,6,3,8,40,440
30995,30995,6324E038DED9EC12CD06DF2BDBC3BEAA,12921,9,10,1,9,41,491
30996,30996,6324E038DED9EC12CD06DF2BDBC3BEAA,19181,15,22,7,8,40,440
30997,30997,2F3FBE39EE4E3AB748593134D6A2A772,42231,0,6,6,37,46,1896
30998,30998,2F3FBE39EE4E3AB748593134D6A2A772,42351,8,11,3,38,45,1945
30999,30999,2F3FBE39EE4E3AB748593134D6A2A772,42231,11,16,5,37,46,1896
31000,31000,2F3FBE39EE4E3AB748593134D6A2A772,42351,16,17,1,38,45,1945
31001,31001,2F3FBE39EE4E3AB748593134D6A2A772,42231,17,22,5,37,46,1896
31005,31005,7DFCA2932B390D69ABC0E415A2260097,12311,0,10,10,30,44,1544
31006,31006,7DFCA2932B390D69ABC0E415A2260097,11211,12,13,1,34,49,1749
31007,31007,7DFCA2932B390D69ABC0E415A2260097,42531,18,23,5,31,45,1595
31014,31014,BC3DA9BAF9B0A0C935A79D91ECBDA067,19441,0,7,7,8,46,446
31015,31015,BC3DA9BAF9B0A0C935A79D91ECBDA067,42041,10,11,1,10,47,547
31016,31016,BC3DA9BAF9B0A0C935A79D91ECBDA067,19441,12,15,3,8,46,446
31017,31017,BC3DA9BAF9B0A0C935A79D91ECBDA067,42041,18,19,1,10,47,547
31018,31018,BC3DA9BAF9B0A0C935A79D91ECBDA067,19901,20,23,3,7,44,394
31019,31019,D9AF0A0BEFAFF72D2F6D04084706EE69,43051,0,7,7,46,45,2345
31020,31020,D9AF0A0BEFAFF72D2F6D04084706EE69,43391,8,9,1,29,48,1498
31021,31021,D9AF0A0BEFAFF72D2F6D04084706EE69,10381,12,18,6,31,49,1599
31022,31022,D9AF0A0BEFAFF72D2F6D04084706EE69,43051,19,23,4,46,45,2345
31023,31023,F7752CA1B73DF28C3ED02C34596B4599,10451,0,9,9,25,48,1298
31024,31024,F7752CA1B73DF28C3ED02C34596B4599,42631,12,13,1,43,45,2195
31025,31025,F7752CA1B73DF28C3ED02C34596B4599,10451,15,23,8,25,48,1298
31029,31029,C187943D20D187183526E0228C45660E,11021,0,7,7,36,49,1849
31030,31030,C187943D20D187183526E0228C45660E,12381,12,14,2,32,48,1648
31031,31031,C187943D20D187183526E0228C45660E,11021,16,23,7,36,49,1849
31032,31032,D1DF8B8CF696B3934AD219B19DE51DE4,11811,0,1,1,38,49,1949
31033,31033,D1DF8B8CF696B3934AD219B19DE51DE4,10251,3,14,11,35,47,1797
31034,31034,D1DF8B8CF696B3934AD219B19DE51DE4,11811,15,21,6,38,49,1949
31035,31035,D1DF8B8CF696B3934AD219B19DE51DE4,40171,21,22,1,38,48,1948
31036,31036,668B25EA27DB62433F6B97341A2F29D6,10251,0,8,8,35,47,1797
31037,31037,668B25EA27DB62433F6B97341A2F29D6,42021,8,9,1,33,47,1697
31038,31038,668B25EA27DB62433F6B97341A2F29D6,11875,10,11,1,30,46,1546
31039,31039,668B25EA27DB62433F6B97341A2F29D6,43731,12,14,2,34,47,1747
31040,31040,668B25EA27DB62433F6B97341A2F29D6,11875,16,18,2,30,46,1546
31041,31041,668B25EA27DB62433F6B97341A2F29D6,10251,21,23,2,35,47,1797
31045,31045,8B4A696968381C2907415C3905232868,15391,0,6,6,35,26,1776
31046,31046,8B4A696968381C2907415C3905232868,15661,9,10,1,36,26,1826
31047,31047,8B4A696968381C2907415C3905232868,10821,13,15,2,40,47,2047
31048,31048,8B4A696968381C2907415C3905232868,11151,18,20,2,30,48,1548
31049,31049,8B4A696968381C2907415C3905232868,11631,22,23,1,12,49,649
31057,31057,BBB180103068E98D503C4D3D2B6186F0,40302,0,7,7,40,49,2049
31058,31058,BBB180103068E98D503C4D3D2B6186F0,11301,10,11,1,41,49,2099
31059,31059,BBB180103068E98D503C4D3D2B6186F0,11291,12,19,7,40,49,2049
31060,31060,BBB180103068E98D503C4D3D2B6186F0,43161,21,22,1,35,47,1797
31064,31064,5B1B6E4E01E99B967E0FFD2590D939B1,12511,0,6,6,39,47,1997
31065,31065,5B1B6E4E01E99B967E0FFD2590D939B1,42321,7,9,2,43,47,2197
31066,31066,5B1B6E4E01E99B967E0FFD2590D939B1,42601,13,15,2,44,48,2248
31067,31067,5B1B6E4E01E99B967E0FFD2590D939B1,11701,15,17,2,43,48,2198
31068,31068,5B1B6E4E01E99B967E0FFD2590D939B1,10601,19,23,4,39,47,1997
31069,31069,C5ED324891B8B95E257970408E8D4150,12491,0,7,7,36,43,1843
31070,31070,C5ED324891B8B95E257970408E8D4150,13911,7,13,6,39,46,1996
31071,31071,C5ED324891B8B95E257970408E8D4150,11261,13,15,2,36,46,1846
31072,31072,C5ED324891B8B95E257970408E8D4150,13911,16,22,6,39,46,1996
31073,31073,A2939A88D49E89644FEBA8B1C0E8B435,10251,0,9,9,35,47,1797
31074,31074,A2939A88D49E89644FEBA8B1C0E8B435,42161,10,14,4,36,47,1847
31075,31075,A2939A88D49E89644FEBA8B1C0E8B435,10111,14,16,2,37,47,1897
31076,31076,A2939A88D49E89644FEBA8B1C0E8B435,41612,16,18,2,36,47,1847
31077,31077,A2939A88D49E89644FEBA8B1C0E8B435,10251,20,23,3,35,47,1797
31085,31085,055392723CC93B49A610878855A95D5B,19441,1,7,6,8,46,446
31086,31086,055392723CC93B49A610878855A95D5B,10107,12,13,1,38,49,1949
31087,31087,055392723CC93B49A610878855A95D5B,19441,15,22,7,8,46,446
31091,31091,3F2FE95AB24E5E71D935604E5158C97B,41392,0,9,9,43,48,2198
31092,31092,3F2FE95AB24E5E71D935604E5158C97B,11941,10,11,1,37,46,1896
31093,31093,3F2FE95AB24E5E71D935604E5158C97B,42511,12,14,2,37,47,1897
31094,31094,3F2FE95AB24E5E71D935604E5158C97B,11301,19,20,1,41,49,2099
31095,31095,3F2FE95AB24E5E71D935604E5158C97B,41392,20,23,3,43,48,2198
31103,31103,06DA10A5127707E5C949D4A6A9073869,10301,1,2,1,31,45,1595
31104,31104,06DA10A5127707E5C949D4A6A9073869,12311,2,4,2,30,44,1544
31105,31105,06DA10A5127707E5C949D4A6A9073869,10301,4,5,1,31,45,1595
31106,31106,06DA10A5127707E5C949D4A6A9073869,12311,14,15,1,30,44,1544
31107,31107,06DA10A5127707E5C949D4A6A9073869,42531,19,23,4,31,45,1595
31115,31115,37B4372D6FD69424B506A40FED2F08A1,11324,5,6,1,31,46,1596
31116,31116,37B4372D6FD69424B506A40FED2F08A1,42861,7,8,1,37,44,1894
31117,31117,37B4372D6FD69424B506A40FED2F08A1,42151,12,13,1,35,45,1795
31118,31118,37B4372D6FD69424B506A40FED2F08A1,10351,17,18,1,28,45,1445
31122,31122,7131B3E60850983536AB13215C852D24,11831,0,9,9,32,45,1645
31123,31123,7131B3E60850983536AB13215C852D24,11231,12,13,1,37,49,1899
31124,31124,7131B3E60850983536AB13215C852D24,10841,16,18,2,37,47,1897
31125,31125,7131B3E60850983536AB13215C852D24,11831,20,23,3,32,45,1645
31126,31126,37FD993175423D4A4F3973BD90B3E646,40401,0,7,7,40,46,2046
31127,31127,37FD993175423D4A4F3973BD90B3E646,10107,7,18,11,38,49,1949
31128,31128,37FD993175423D4A4F3973BD90B3E646,11061,19,21,2,29,48,1498
31129,31129,7DD9E91F4EBA77140FFEB3FB0235C15D,41591,0,1,1,34,49,1749
31130,31130,7DD9E91F4EBA77140FFEB3FB0235C15D,42491,3,9,6,32,46,1646
31131,31131,7DD9E91F4EBA77140FFEB3FB0235C15D,42523,9,11,2,31,47,1597
31132,31132,7DD9E91F4EBA77140FFEB3FB0235C15D,10151,13,14,1,34,47,1747
31133,31133,7DD9E91F4EBA77140FFEB3FB0235C15D,41591,17,18,1,34,49,1749
31134,31134,7DD9E91F4EBA77140FFEB3FB0235C15D,40341,20,22,2,23,49,1199
31135,31135,CA13573EC489EC297A1DB55BF08926BD,42231,0,6,6,37,46,1896
31136,31136,CA13573EC489EC297A1DB55BF08926BD,11481,10,12,2,41,48,2098
31137,31137,CA13573EC489EC297A1DB55BF08926BD,42231,12,14,2,37,46,1896
31138,31138,CA13573EC489EC297A1DB55BF08926BD,11481,15,19,4,41,48,2098
31139,31139,CA13573EC489EC297A1DB55BF08926BD,42231,20,23,3,37,46,1896
31140,31140,1B66B8211BF40C70A6501E442DA10ECB,11261,9,15,6,36,46,1846
31141,31141,1B66B8211BF40C70A6501E442DA10ECB,43451,18,19,1,37,40,1890
31142,31142,1B66B8211BF40C70A6501E442DA10ECB,43011,21,22,1,40,42,2042
31143,31143,6AD981E757B177FB5B64F1D1D2EAA27F,13711,1,3,2,38,46,1946
31144,31144,6AD981E757B177FB5B64F1D1D2EAA27F,12651,4,8,4,43,47,2197
31145,31145,6AD981E757B177FB5B64F1D1D2EAA27F,10921,12,13,1,43,48,2198
31146,31146,6AD981E757B177FB5B64F1D1D2EAA27F,10901,14,22,8,35,48,1798
31153,31153,DE6709015B79F307E57CED7DDDF807DA,12491,0,12,12,36,43,1843
31154,31154,DE6709015B79F307E57CED7DDDF807DA,42151,12,13,1,35,45,1795
31155,31155,DE6709015B79F307E57CED7DDDF807DA,12491,14,16,2,36,43,1843
31156,31156,DE6709015B79F307E57CED7DDDF807DA,42151,17,18,1,35,45,1795
31157,31157,DE6709015B79F307E57CED7DDDF807DA,12491,20,22,2,36,43,1843
31158,31158,4F6A6D6BDB1CA40A8AF45B87F3BE9E9C,10431,0,15,15,33,49,1699
31159,31159,4F6A6D6BDB1CA40A8AF45B87F3BE9E9C,10721,16,19,3,31,48,1598
31160,31160,4F6A6D6BDB1CA40A8AF45B87F3BE9E9C,11491,20,21,1,36,47,1847
31161,31161,1CDF6C6970CBC7D24D606B7FD41E9D6C,43021,4,6,2,16,43,843
31162,31162,1CDF6C6970CBC7D24D606B7FD41E9D6C,12921,6,15,9,9,41,491
31163,31163,1CDF6C6970CBC7D24D606B7FD41E9D6C,12641,17,18,1,10,43,543
31167,31167,34C2C19E72E3A8BD954F8F220235C379,10211,0,7,7,16,49,849
31168,31168,34C2C19E72E3A8BD954F8F220235C379,43751,12,16,4,19,48,998
31169,31169,34C2C19E72E3A8BD954F8F220235C379,40637,18,20,2,36,47,1847
31170,31170,34C2C19E72E3A8BD954F8F220235C379,10211,22,23,1,16,49,849
31174,31174,E83626203AACCB897F7BD46A246F7D90,11551,0,7,7,39,49,1999
31175,31175,E83626203AACCB897F7BD46A246F7D90,10401,8,12,4,33,49,1699
31176,31176,E83626203AACCB897F7BD46A246F7D90,11074,13,15,2,37,47,1897
31177,31177,E83626203AACCB897F7BD46A246F7D90,11551,18,20,2,39,49,1999
31178,31178,E83626203AACCB897F7BD46A246F7D90,40951,21,23,2,36,49,1849
31179,31179,31CBC77871B7612C90BD0F8F8FF24A20,42321,6,7,1,43,47,2197
31180,31180,31CBC77871B7612C90BD0F8F8FF24A20,10801,7,9,2,42,47,2147
31181,31181,31CBC77871B7612C90BD0F8F8FF24A20,42321,10,13,3,43,47,2197
31182,31182,31CBC77871B7612C90BD0F8F8FF24A20,10801,14,16,2,42,47,2147
31183,31183,31CBC77871B7612C90BD0F8F8FF24A20,42321,20,22,2,43,47,2197
31184,31184,F364E0EEFD1054C9EFD28F93C1BE30E0,10061,0,6,6,20,46,1046
31185,31185,F364E0EEFD1054C9EFD28F93C1BE30E0,13771,7,18,11,21,45,1095
31186,31186,F364E0EEFD1054C9EFD28F93C1BE30E0,10351,19,21,2,28,45,1445
31187,31187,F364E0EEFD1054C9EFD28F93C1BE30E0,10634,21,23,2,27,45,1395
31198,31198,821AF5EB52A2D1F024AF220A9E4C3FF0,42351,1,2,1,38,45,1945
31199,31199,821AF5EB52A2D1F024AF220A9E4C3FF0,10841,2,6,4,37,47,1897
31200,31200,821AF5EB52A2D1F024AF220A9E4C3FF0,12381,12,14,2,32,48,1648
31201,31201,821AF5EB52A2D1F024AF220A9E4C3FF0,42301,19,21,2,36,47,1847
31205,31205,0C4501C4FEA302439851DF066C24E4EE,12584,3,7,4,24,48,1248
31206,31206,0C4501C4FEA302439851DF066C24E4EE,11291,11,16,5,40,49,2049
31207,31207,0C4501C4FEA302439851DF066C24E4EE,42691,21,22,1,24,48,1248
31208,31208,5E8BB1A9FDE1AFD08848003FB8A60E0E,40673,0,8,8,36,48,1848
31209,31209,5E8BB1A9FDE1AFD08848003FB8A60E0E,43731,10,11,1,34,47,1747
31210,31210,5E8BB1A9FDE1AFD08848003FB8A60E0E,40673,12,14,2,36,48,1848
31211,31211,5E8BB1A9FDE1AFD08848003FB8A60E0E,10971,17,20,3,35,47,1797
31212,31212,5E8BB1A9FDE1AFD08848003FB8A60E0E,40673,21,23,2,36,48,1848
31236,31236,3297B4A1C1241EB727A6D528B291051B,42801,0,8,8,40,49,2049
31237,31237,3297B4A1C1241EB727A6D528B291051B,11551,9,10,1,39,49,1999
31238,31238,3297B4A1C1241EB727A6D528B291051B,40341,13,15,2,23,49,1199
31239,31239,3297B4A1C1241EB727A6D528B291051B,11351,18,19,1,36,48,1848
31240,31240,3297B4A1C1241EB727A6D528B291051B,11551,21,23,2,39,49,1999
31245,31245,44CFFC276A65F95BE03A7F0CD0EA65D0,43761,0,7,7,32,47,1647
31246,31246,44CFFC276A65F95BE03A7F0CD0EA65D0,10371,8,18,10,37,49,1899
31247,31247,44CFFC276A65F95BE03A7F0CD0EA65D0,10491,19,20,1,33,48,1698
31248,31248,44CFFC276A65F95BE03A7F0CD0EA65D0,42141,20,21,1,32,47,1647
31249,31249,F1D52E271AD2CA60B9DB39C5E4BE77A4,12921,1,3,2,9,41,491
31250,31250,F1D52E271AD2CA60B9DB39C5E4BE77A4,19021,6,17,11,10,45,545
31251,31251,F1D52E271AD2CA60B9DB39C5E4BE77A4,12641,20,23,3,10,43,543
31279,31279,AB35C432DC3D59E7929F031635A675AA,12601,0,14,14,25,47,1297
31280,31280,AB35C432DC3D59E7929F031635A675AA,11381,16,17,1,30,47,1547
31281,31281,AB35C432DC3D59E7929F031635A675AA,12601,19,22,3,25,47,1297
31285,31285,73701CC9434D9172C828A8DD1EB9C8FD,19114,0,6,6,7,43,393
31286,31286,73701CC9434D9172C828A8DD1EB9C8FD,49201,7,11,4,7,41,391
31287,31287,73701CC9434D9172C828A8DD1EB9C8FD,19114,12,13,1,7,43,393
31288,31288,73701CC9434D9172C828A8DD1EB9C8FD,49201,14,15,1,7,41,391
31289,31289,73701CC9434D9172C828A8DD1EB9C8FD,12921,17,18,1,9,41,491
31290,31290,73701CC9434D9172C828A8DD1EB9C8FD,19114,19,21,2,7,43,393
31291,31291,E131C5415CA4464B2E2B8BBC4B15D17C,42521,0,8,8,31,47,1597
31292,31292,E131C5415CA4464B2E2B8BBC4B15D17C,10221,11,14,3,34,49,1749
31293,31293,E131C5415CA4464B2E2B8BBC4B15D17C,43761,18,19,1,32,47,1647
31301,31301,E046CA1FB3D88E64409E287DB5C3F414,11701,0,5,5,43,48,2198
31302,31302,E046CA1FB3D88E64409E287DB5C3F414,13951,5,7,2,47,45,2395
31303,31303,E046CA1FB3D88E64409E287DB5C3F414,42581,7,9,2,38,48,1948
31304,31304,E046CA1FB3D88E64409E287DB5C3F414,42321,13,20,7,43,47,2197
31305,31305,E22B1C54A0FAFCF3D8C5712FD60B6323,11521,0,7,7,41,48,2098
31306,31306,E22B1C54A0FAFCF3D8C5712FD60B6323,42281,9,10,1,40,48,2048
31307,31307,E22B1C54A0FAFCF3D8C5712FD60B6323,10161,10,17,7,35,49,1799
31308,31308,E22B1C54A0FAFCF3D8C5712FD60B6323,10221,18,21,3,34,49,1749
31309,31309,E22B1C54A0FAFCF3D8C5712FD60B6323,42351,22,23,1,38,45,1945
31310,31310,4DF3C091EB814BBFB3CE5DF6F2B4BD49,12641,8,9,1,10,43,543
31311,31311,4DF3C091EB814BBFB3CE5DF6F2B4BD49,19114,11,12,1,7,43,393
31312,31312,4DF3C091EB814BBFB3CE5DF6F2B4BD49,12641,15,16,1,10,43,543
31313,31313,4DF3C091EB814BBFB3CE5DF6F2B4BD49,19114,17,19,2,7,43,393
31314,31314,4DF3C091EB814BBFB3CE5DF6F2B4BD49,12641,19,21,2,10,43,543
31324,31324,506260504ADDFFEBDF6F921DD8023DFE,11381,0,9,9,30,47,1547
31325,31325,506260504ADDFFEBDF6F921DD8023DFE,12121,13,15,2,29,47,1497
31326,31326,506260504ADDFFEBDF6F921DD8023DFE,11231,18,19,1,37,49,1899
31330,31330,446AC7E279C6659F3E40FC9C0B9B7F45,13341,0,2,2,44,45,2245
31331,31331,446AC7E279C6659F3E40FC9C0B9B7F45,43061,3,4,1,43,46,2196
31332,31332,446AC7E279C6659F3E40FC9C0B9B7F45,13341,8,18,10,44,45,2245
31333,31333,446AC7E279C6659F3E40FC9C0B9B7F45,42631,20,21,1,43,45,2195
31334,31334,446AC7E279C6659F3E40FC9C0B9B7F45,13341,21,22,1,44,45,2245
31338,31338,88107E927A20EAF8FA358D8FC5D83337,12521,0,9,9,35,41,1791
31339,31339,88107E927A20EAF8FA358D8FC5D83337,10471,10,15,5,37,48,1898
31340,31340,88107E927A20EAF8FA358D8FC5D83337,41031,18,20,2,32,49,1649
31341,31341,88107E927A20EAF8FA358D8FC5D83337,11651,21,23,2,33,47,1697
31352,31352,9E98312735BD1183ADA629DF4376E225,42511,0,1,1,37,47,1897
31353,31353,9E98312735BD1183ADA629DF4376E225,11521,10,11,1,41,48,2098
31354,31354,9E98312735BD1183ADA629DF4376E225,11531,18,19,1,34,49,1749
31355,31355,9E98312735BD1183ADA629DF4376E225,11491,19,20,1,36,47,1847
31356,31356,9E98312735BD1183ADA629DF4376E225,13511,22,23,1,34,48,1748
31360,31360,0E8C761E49461045C15875EF50ECD335,13371,0,9,9,41,47,2097
31361,31361,0E8C761E49461045C15875EF50ECD335,11806,12,13,1,41,48,2098
31362,31362,0E8C761E49461045C15875EF50ECD335,42321,13,15,2,43,47,2197
31363,31363,0E8C761E49461045C15875EF50ECD335,13371,16,20,4,41,47,2097
31364,31364,0E8C761E49461045C15875EF50ECD335,43481,20,22,2,39,48,1998
31371,31371,6B33C993B739D337E981CD19E6D27BBE,42091,0,15,15,43,46,2196
31372,31372,6B33C993B739D337E981CD19E6D27BBE,42461,16,17,1,45,47,2297
31373,31373,6B33C993B739D337E981CD19E6D27BBE,13951,18,19,1,47,45,2395
31374,31374,6B33C993B739D337E981CD19E6D27BBE,13791,20,23,3,42,47,2147
31388,31388,CFD715D5150B825EF7BF61CC0E30B03B,10471,7,9,2,37,48,1898
31389,31389,CFD715D5150B825EF7BF61CC0E30B03B,43181,12,13,1,39,48,1998
31390,31390,CFD715D5150B825EF7BF61CC0E30B03B,40171,14,15,1,38,48,1948
31391,31391,CFD715D5150B825EF7BF61CC0E30B03B,11914,18,20,2,37,48,1898
31392,31392,CFD715D5150B825EF7BF61CC0E30B03B,43181,22,23,1,39,48,1998
31399,31399,2075B4FB25DAADC66CD593580F270747,10421,0,7,7,41,48,2098
31400,31400,2075B4FB25DAADC66CD593580F270747,10621,7,9,2,41,49,2099
31401,31401,2075B4FB25DAADC66CD593580F270747,11801,11,14,3,42,48,2148
31402,31402,2075B4FB25DAADC66CD593580F270747,43191,15,17,2,40,49,2049
31403,31403,2075B4FB25DAADC66CD593580F270747,42641,21,23,2,33,49,1699
31413,31413,1C27B3723865DD51848A2743C866805D,43051,0,13,13,46,45,2345
31414,31414,1C27B3723865DD51848A2743C866805D,12211,13,15,2,41,44,2094
31415,31415,1C27B3723865DD51848A2743C866805D,13341,16,17,1,44,45,2245
31416,31416,1C27B3723865DD51848A2743C866805D,43051,19,23,4,46,45,2345
31423,31423,525655B30753832E11A6455806FEB5D9,40094,0,7,7,29,48,1498
31424,31424,525655B30753832E11A6455806FEB5D9,11941,11,15,4,37,46,1896
31425,31425,525655B30753832E11A6455806FEB5D9,11541,19,20,1,35,49,1799
31426,31426,525655B30753832E11A6455806FEB5D9,40094,21,23,2,29,48,1498
31427,31427,13593D379347B080E00A2547E2225557,10901,0,1,1,35,48,1798
31428,31428,13593D379347B080E00A2547E2225557,43971,2,8,6,30,48,1548
31429,31429,13593D379347B080E00A2547E2225557,11541,8,11,3,35,49,1799
31430,31430,13593D379347B080E00A2547E2225557,40673,12,14,2,36,48,1848
31431,31431,13593D379347B080E00A2547E2225557,13121,15,17,2,38,46,1946
31432,31432,13593D379347B080E00A2547E2225557,43971,20,23,3,30,48,1548
31433,31433,3D4D278B3D58167073B4ACCB11432DB2,13091,2,3,1,20,42,1042
31434,31434,3D4D278B3D58167073B4ACCB11432DB2,43631,3,7,4,19,43,993
31435,31435,3D4D278B3D58167073B4ACCB11432DB2,13091,7,12,5,20,42,1042
31436,31436,3D4D278B3D58167073B4ACCB11432DB2,13094,14,16,2,21,42,1092
31437,31437,3D4D278B3D58167073B4ACCB11432DB2,13671,17,18,1,27,43,1393
31438,31438,3D4D278B3D58167073B4ACCB11432DB2,13091,19,20,1,20,42,1042
31439,31439,3D4D278B3D58167073B4ACCB11432DB2,12671,21,22,1,21,43,1093
31447,31447,92E1BAA88B052422B820ED36A9E8F107,11271,8,10,2,37,48,1898
31448,31448,92E1BAA88B052422B820ED36A9E8F107,41392,10,14,4,43,48,2198
31449,31449,92E1BAA88B052422B820ED36A9E8F107,11271,15,16,1,37,48,1898
31450,31450,92E1BAA88B052422B820ED36A9E8F107,11701,20,22,2,43,48,2198
31457,31457,ACD04627348D28EB014FAB46490D4B92,10351,0,14,14,28,45,1445
31458,31458,ACD04627348D28EB014FAB46490D4B92,13771,15,16,1,21,45,1095
31459,31459,ACD04627348D28EB014FAB46490D4B92,12601,18,23,5,25,47,1297
31464,31464,C13E66C78C66072C9185A5D9323CAB19,42021,0,15,15,33,47,1697
31465,31465,C13E66C78C66072C9185A5D9323CAB19,40341,15,16,1,23,49,1199
31466,31466,C13E66C78C66072C9185A5D9323CAB19,42021,19,23,4,33,47,1697
31467,31467,3044AD5F90932CCE405DE87EFA97D7EF,19021,2,5,3,10,45,545
31468,31468,3044AD5F90932CCE405DE87EFA97D7EF,43021,6,8,2,16,43,843
31469,31469,3044AD5F90932CCE405DE87EFA97D7EF,19021,9,18,9,10,45,545
31470,31470,0C2E73493B95B864220B3E14F6C11E84,13314,0,7,7,31,39,1589
31471,31471,0C2E73493B95B864220B3E14F6C11E84,12521,9,11,2,35,41,1791
31472,31472,0C2E73493B95B864220B3E14F6C11E84,13314,16,17,1,31,39,1589
31473,31473,0C2E73493B95B864220B3E14F6C11E84,12521,17,19,2,35,41,1791
31474,31474,0C2E73493B95B864220B3E14F6C11E84,13314,19,23,4,31,39,1589
31475,31475,E45B0EC44E00842EDD865C65A561543D,11791,0,8,8,38,49,1949
31476,31476,E45B0EC44E00842EDD865C65A561543D,11231,8,12,4,37,49,1899
31477,31477,E45B0EC44E00842EDD865C65A561543D,10471,14,17,3,37,48,1898
31478,31478,E45B0EC44E00842EDD865C65A561543D,42261,19,20,1,25,49,1299
31479,31479,0262D446D971791F20E3BB61298CD2A6,11074,0,9,9,37,47,1897
31480,31480,0262D446D971791F20E3BB61298CD2A6,43391,12,13,1,29,48,1498
31481,31481,0262D446D971791F20E3BB61298CD2A6,10221,15,16,1,34,49,1749
31482,31482,0262D446D971791F20E3BB61298CD2A6,40341,18,19,1,23,49,1199
31483,31483,0262D446D971791F20E3BB61298CD2A6,11074,21,23,2,37,47,1897
31484,31484,D8B46FFCD15B641FB93B8219A29A7205,10251,0,5,5,35,47,1797
31485,31485,D8B46FFCD15B641FB93B8219A29A7205,40673,5,7,2,36,48,1848
31486,31486,D8B46FFCD15B641FB93B8219A29A7205,10251,9,11,2,35,47,1797
31487,31487,D8B46FFCD15B641FB93B8219A29A7205,11811,11,14,3,38,49,1949
31488,31488,D8B46FFCD15B641FB93B8219A29A7205,10251,17,23,6,35,47,1797
31493,31493,E962C3D0A8FC163364DD770DFBF0ADE9,11381,0,3,3,30,47,1547
31494,31494,E962C3D0A8FC163364DD770DFBF0ADE9,43761,4,5,1,32,47,1647
31495,31495,E962C3D0A8FC163364DD770DFBF0ADE9,11381,5,7,2,30,47,1547
31496,31496,E962C3D0A8FC163364DD770DFBF0ADE9,11541,9,22,13,35,49,1799
31497,31497,E962C3D0A8FC163364DD770DFBF0ADE9,11381,22,23,1,30,47,1547
31501,31501,3C9FCF8526E7E52C206BF1E3F8AE8299,43581,0,6,6,33,48,1698
31502,31502,3C9FCF8526E7E52C206BF1E3F8AE8299,42941,7,15,8,37,47,1897
31503,31503,3C9FCF8526E7E52C206BF1E3F8AE8299,43581,19,23,4,33,48,1698
31504,31504,722F93E6CE54FADD6A9BE8EB60306018,43161,0,9,9,35,47,1797
31505,31505,722F93E6CE54FADD6A9BE8EB60306018,42501,19,20,1,28,47,1447
31506,31506,722F93E6CE54FADD6A9BE8EB60306018,10971,21,23,2,35,47,1797
31511,31511,8436FA510D59B3814E50B7F18BD1D92C,19571,0,5,5,1,36,86
31512,31512,8436FA510D59B3814E50B7F18BD1D92C,12641,6,8,2,10,43,543
31513,31513,8436FA510D59B3814E50B7F18BD1D92C,43644,12,13,1,14,38,738
31514,31514,8436FA510D59B3814E50B7F18BD1D92C,12641,14,15,1,10,43,543
31515,31515,8436FA510D59B3814E50B7F18BD1D92C,43644,19,21,2,14,38,738
31526,31526,90CAE68E57E6D6254F2E8F80F351FD91,11491,0,6,6,36,47,1847
31527,31527,90CAE68E57E6D6254F2E8F80F351FD91,11151,7,8,1,30,48,1548
31528,31528,90CAE68E57E6D6254F2E8F80F351FD91,43391,9,10,1,29,48,1498
31529,31529,90CAE68E57E6D6254F2E8F80F351FD91,11151,11,12,1,30,48,1548
31530,31530,90CAE68E57E6D6254F2E8F80F351FD91,43471,13,15,2,31,49,1599
31531,31531,90CAE68E57E6D6254F2E8F80F351FD91,42121,19,22,3,26,49,1349
31532,31532,90CAE68E57E6D6254F2E8F80F351FD91,43471,22,23,1,31,49,1599
31533,31533,9080DF503ACF0ABF3EAE58FF37C4563F,10681,0,1,1,30,48,1548
31534,31534,9080DF503ACF0ABF3EAE58FF37C4563F,11061,3,10,7,29,48,1498
31535,31535,9080DF503ACF0ABF3EAE58FF37C4563F,10681,12,14,2,30,48,1548
31536,31536,9080DF503ACF0ABF3EAE58FF37C4563F,11061,15,16,1,29,48,1498
31537,31537,9080DF503ACF0ABF3EAE58FF37C4563F,10681,19,20,1,30,48,1548
31538,31538,3D50CF8DA80A4761FAF974D4CBB0A177,43751,1,13,12,19,48,998
31539,31539,3D50CF8DA80A4761FAF974D4CBB0A177,12601,14,18,4,25,47,1297
31540,31540,3D50CF8DA80A4761FAF974D4CBB0A177,43751,19,21,2,19,48,998
31548,31548,F49EE04071D0B4FCCD4263F4C2BBEA7A,10681,0,6,6,30,48,1548
31549,31549,F49EE04071D0B4FCCD4263F4C2BBEA7A,11061,6,8,2,29,48,1498
31550,31550,F49EE04071D0B4FCCD4263F4C2BBEA7A,10221,9,17,8,34,49,1749
31551,31551,F49EE04071D0B4FCCD4263F4C2BBEA7A,11061,20,23,3,29,48,1498
31559,31559,2E529D3231B9931142907BBC57A6A51B,42381,0,1,1,39,41,1991
31560,31560,2E529D3231B9931142907BBC57A6A51B,13071,1,3,2,41,41,2091
31561,31561,2E529D3231B9931142907BBC57A6A51B,42381,6,7,1,39,41,1991
31562,31562,2E529D3231B9931142907BBC57A6A51B,13071,8,10,2,41,41,2091
31563,31563,2E529D3231B9931142907BBC57A6A51B,43451,11,12,1,37,40,1890
31564,31564,2E529D3231B9931142907BBC57A6A51B,13071,12,14,2,41,41,2091
31565,31565,2E529D3231B9931142907BBC57A6A51B,43451,14,17,3,37,40,1890
31566,31566,2E529D3231B9931142907BBC57A6A51B,42381,17,18,1,39,41,1991
31567,31567,2E529D3231B9931142907BBC57A6A51B,13071,21,23,2,41,41,2091
31568,31568,5DA850223ED57F7C6946AC72AE1F8742,10731,0,15,15,33,47,1697
31569,31569,5DA850223ED57F7C6946AC72AE1F8742,40341,15,17,2,23,49,1199
31570,31570,5DA850223ED57F7C6946AC72AE1F8742,10731,21,23,2,33,47,1697
31574,31574,4C479F308A99C28A9312A97B8F351EC7,11201,0,14,14,35,49,1799
31575,31575,4C479F308A99C28A9312A97B8F351EC7,16151,18,19,1,13,11,661
31576,31576,4C479F308A99C28A9312A97B8F351EC7,12971,21,23,2,32,48,1648
31577,31577,E648A6F090A3BE85617E0ED54A73B4F0,12601,0,4,4,25,47,1297
31578,31578,E648A6F090A3BE85617E0ED54A73B4F0,12671,4,8,4,21,43,1093
31579,31579,E648A6F090A3BE85617E0ED54A73B4F0,12601,8,23,15,25,47,1297
31580,31580,E174906C34757317002B4085C5149929,43751,0,8,8,19,48,998
31581,31581,E174906C34757317002B4085C5149929,40341,9,14,5,23,49,1199
31582,31582,E174906C34757317002B4085C5149929,43751,15,23,8,19,48,998
31586,31586,77FA051C7FE484BBBC94A458F9402E14,42261,5,7,2,25,49,1299
31587,31587,77FA051C7FE484BBBC94A458F9402E14,42071,11,15,4,31,49,1599
31588,31588,77FA051C7FE484BBBC94A458F9402E14,11061,17,18,1,29,48,1498
31589,31589,77FA051C7FE484BBBC94A458F9402E14,42121,21,22,1,26,49,1349
31594,31594,A534FD7E51A551BE3196665029DD0400,19931,0,6,6,7,43,393
31595,31595,A534FD7E51A551BE3196665029DD0400,19031,8,16,8,1,42,92
31596,31596,A534FD7E51A551BE3196665029DD0400,19931,18,20,2,7,43,393
31600,31600,3AB35E62E3464B5074E82DE69E9DD0D9,42501,0,7,7,28,47,1447
31601,31601,3AB35E62E3464B5074E82DE69E9DD0D9,19441,8,9,1,8,46,446
31602,31602,3AB35E62E3464B5074E82DE69E9DD0D9,13731,13,17,4,33,49,1699
31603,31603,3AB35E62E3464B5074E82DE69E9DD0D9,42501,20,22,2,28,47,1447
31604,31604,437C208E6A22D99C9B03C303E18C2636,42151,0,9,9,35,45,1795
31605,31605,437C208E6A22D99C9B03C303E18C2636,40341,12,16,4,23,49,1199
31606,31606,437C208E6A22D99C9B03C303E18C2636,42151,19,22,3,35,45,1795
31610,31610,C3385B266A5088A7FA48BCC62DFDD003,42583,0,6,6,40,48,2048
31611,31611,C3385B266A5088A7FA48BCC62DFDD003,43181,7,9,2,39,48,1998
31612,31612,C3385B266A5088A7FA48BCC62DFDD003,11914,11,13,2,37,48,1898
31613,31613,C3385B266A5088A7FA48BCC62DFDD003,43181,13,15,2,39,48,1998
31614,31614,C3385B266A5088A7FA48BCC62DFDD003,40171,20,21,1,38,48,1948
31618,31618,4C277ABE9AAFFACC84B539B0700C1F48,10221,1,9,8,34,49,1749
31619,31619,4C277ABE9AAFFACC84B539B0700C1F48,40691,12,18,6,42,48,2148
31620,31620,4C277ABE9AAFFACC84B539B0700C1F48,10221,22,23,1,34,49,1749
31621,31621,9641FF809BC99375A7EB0913A38DD4C9,43391,0,13,13,29,48,1498
31622,31622,9641FF809BC99375A7EB0913A38DD4C9,10401,16,17,1,33,49,1699
31623,31623,9641FF809BC99375A7EB0913A38DD4C9,43391,18,22,4,29,48,1498
31628,31628,9BBBC00C93BA6A3176E2B008E6F8A88E,13911,0,7,7,39,46,1996
31629,31629,9BBBC00C93BA6A3176E2B008E6F8A88E,11261,7,10,3,36,46,1846
31630,31630,9BBBC00C93BA6A3176E2B008E6F8A88E,13911,11,13,2,39,46,1996
31631,31631,9BBBC00C93BA6A3176E2B008E6F8A88E,11261,14,19,5,36,46,1846
31632,31632,9BBBC00C93BA6A3176E2B008E6F8A88E,12211,21,22,1,41,44,2094
31633,31633,A336F8D086418A70D6F2B0EA33768B6C,10811,0,14,14,38,46,1946
31634,31634,A336F8D086418A70D6F2B0EA33768B6C,40341,18,20,2,23,49,1199
31635,31635,A336F8D086418A70D6F2B0EA33768B6C,10811,21,23,2,38,46,1946
31646,31646,8A524E85431660319A09E8D071AC107B,42321,0,13,13,43,47,2197
31647,31647,8A524E85431660319A09E8D071AC107B,12601,16,18,2,25,47,1297
31648,31648,8A524E85431660319A09E8D071AC107B,42321,19,23,4,43,47,2197
31649,31649,449E7811DCD6E8CD500501049B5A906E,13911,1,2,1,39,46,1996
31650,31650,449E7811DCD6E8CD500501049B5A906E,11261,6,7,1,36,46,1846
31651,31651,449E7811DCD6E8CD500501049B5A906E,13911,8,11,3,39,46,1996
31652,31652,449E7811DCD6E8CD500501049B5A906E,11261,14,15,1,36,46,1846
31653,31653,449E7811DCD6E8CD500501049B5A906E,13911,20,21,1,39,46,1996
31657,31657,649CA0B4C9C73F10630BCAC6C100E533,42151,1,13,12,35,45,1795
31658,31658,649CA0B4C9C73F10630BCAC6C100E533,12311,16,17,1,30,44,1544
31659,31659,649CA0B4C9C73F10630BCAC6C100E533,42151,18,20,2,35,45,1795
31667,31667,234DD051611DC4B33CE971644BD11A2E,11861,2,14,12,32,47,1647
31668,31668,234DD051611DC4B33CE971644BD11A2E,10381,15,20,5,31,49,1599
31669,31669,234DD051611DC4B33CE971644BD11A2E,11201,20,21,1,35,49,1799
31670,31670,89CA2603AB460CC5371CFF262CF45064,42161,0,8,8,36,47,1847
31671,31671,89CA2603AB460CC5371CFF262CF45064,12581,12,13,1,24,48,1248
31672,31672,89CA2603AB460CC5371CFF262CF45064,42161,14,23,9,36,47,1847
31677,31677,DE69FEBC50432F9871EF62D07F7A5C1A,12641,0,3,3,10,43,543
31678,31678,DE69FEBC50432F9871EF62D07F7A5C1A,19181,3,8,5,8,40,440
31679,31679,DE69FEBC50432F9871EF62D07F7A5C1A,43644,8,10,2,14,38,738
31680,31680,DE69FEBC50432F9871EF62D07F7A5C1A,19181,15,23,8,8,40,440
31681,31681,043894B99640B00230745CDDE4761C32,12083,0,9,9,36,49,1849
31682,31682,043894B99640B00230745CDDE4761C32,43501,9,11,2,27,48,1398
31683,31683,043894B99640B00230745CDDE4761C32,13841,12,18,6,40,46,2046
31687,31687,68D66AC2F31097852E1113FCAC38B096,12311,0,5,5,30,44,1544
31688,31688,68D66AC2F31097852E1113FCAC38B096,42531,9,10,1,31,45,1595
31689,31689,68D66AC2F31097852E1113FCAC38B096,12311,11,13,2,30,44,1544
31690,31690,68D66AC2F31097852E1113FCAC38B096,42531,17,19,2,31,45,1595
31691,31691,68D66AC2F31097852E1113FCAC38B096,12311,20,22,2,30,44,1544
31692,31692,04D73C3CD00D40CB611F6BA5801F802C,13314,0,7,7,31,39,1589
31693,31693,04D73C3CD00D40CB611F6BA5801F802C,12521,7,10,3,35,41,1791
31694,31694,04D73C3CD00D40CB611F6BA5801F802C,13314,12,13,1,31,39,1589
31695,31695,04D73C3CD00D40CB611F6BA5801F802C,12521,13,15,2,35,41,1791
31696,31696,04D73C3CD00D40CB611F6BA5801F802C,13314,19,23,4,31,39,1589
31701,31701,5802ED48E0EAA71622E4381E7E15AD7A,13941,8,9,1,41,47,2097
31702,31702,5802ED48E0EAA71622E4381E7E15AD7A,11001,11,14,3,42,47,2147
31703,31703,5802ED48E0EAA71622E4381E7E15AD7A,10107,15,20,5,38,49,1949
31704,31704,5802ED48E0EAA71622E4381E7E15AD7A,11074,22,23,1,37,47,1897
31708,31708,D60640DE63138FE979CD83BAA9CD031E,13711,0,2,2,38,46,1946
31709,31709,D60640DE63138FE979CD83BAA9CD031E,43241,5,6,1,36,46,1846
31710,31710,D60640DE63138FE979CD83BAA9CD031E,13121,7,10,3,38,46,1946
31711,31711,D60640DE63138FE979CD83BAA9CD031E,43241,10,15,5,36,46,1846
31712,31712,D60640DE63138FE979CD83BAA9CD031E,13121,17,22,5,38,46,1946
31713,31713,52BF7F7431C896695CC0CC2998A1B620,10295,0,15,15,30,47,1547
31714,31714,52BF7F7431C896695CC0CC2998A1B620,42523,17,18,1,31,47,1597
31715,31715,52BF7F7431C896695CC0CC2998A1B620,40073,21,22,1,37,48,1898
31726,31726,6D0799AB0F55190F6E5F774F154A9036,13101,1,3,2,40,47,2047
31727,31727,6D0799AB0F55190F6E5F774F154A9036,11481,4,6,2,41,48,2098
31728,31728,6D0799AB0F55190F6E5F774F154A9036,11801,8,11,3,42,48,2148
31729,31729,6D0799AB0F55190F6E5F774F154A9036,11481,12,13,1,41,48,2098
31730,31730,6D0799AB0F55190F6E5F774F154A9036,11801,14,20,6,42,48,2148
31731,31731,F97A7158978C8B50C2AA96D4A3644D4B,43171,1,9,8,39,49,1999
31732,31732,F97A7158978C8B50C2AA96D4A3644D4B,42231,11,16,5,37,46,1896
31733,31733,F97A7158978C8B50C2AA96D4A3644D4B,11074,20,21,1,37,47,1897
31734,31734,F97A7158978C8B50C2AA96D4A3644D4B,40341,22,23,1,23,49,1199
31735,31735,9526CA84048ECDF651C5107129654F39,15145,0,1,1,22,9,1109
31736,31736,9526CA84048ECDF651C5107129654F39,16321,5,12,7,8,7,407
31737,31737,9526CA84048ECDF651C5107129654F39,16151,13,15,2,13,11,661
31738,31738,9526CA84048ECDF651C5107129654F39,15145,15,16,1,22,9,1109
31739,31739,9526CA84048ECDF651C5107129654F39,16151,19,21,2,13,11,661
31740,31740,9526CA84048ECDF651C5107129654F39,15145,21,23,2,22,9,1109
31748,31748,775CA947FF37432092AA3395F5AA137B,10971,0,7,7,35,47,1797
31749,31749,775CA947FF37432092AA3395F5AA137B,43731,8,10,2,34,47,1747
31750,31750,775CA947FF37432092AA3395F5AA137B,10971,10,14,4,35,47,1797
31751,31751,775CA947FF37432092AA3395F5AA137B,43731,14,16,2,34,47,1747
31752,31752,775CA947FF37432092AA3395F5AA137B,10971,17,18,1,35,47,1797
31753,31753,775CA947FF37432092AA3395F5AA137B,10111,18,20,2,37,47,1897
31754,31754,775CA947FF37432092AA3395F5AA137B,42161,22,23,1,36,47,1847
31755,31755,E6F8B18996A93B41942201687916F106,11231,0,6,6,37,49,1899
31756,31756,E6F8B18996A93B41942201687916F106,10471,8,12,4,37,48,1898
31757,31757,E6F8B18996A93B41942201687916F106,11231,15,16,1,37,49,1899
31758,31758,E6F8B18996A93B41942201687916F106,10471,16,17,1,37,48,1898
31759,31759,E6F8B18996A93B41942201687916F106,11231,19,20,1,37,49,1899
31760,31760,E6F8B18996A93B41942201687916F106,10471,20,23,3,37,48,1898
31761,31761,FCA3C665B5BF337F331669EDB597A6AC,42151,0,7,7,35,45,1795
31762,31762,FCA3C665B5BF337F331669EDB597A6AC,13121,9,10,1,38,46,1946
31763,31763,FCA3C665B5BF337F331669EDB597A6AC,10271,10,15,5,37,46,1896
31764,31764,FCA3C665B5BF337F331669EDB597A6AC,13121,16,18,2,38,46,1946
31765,31765,FCA3C665B5BF337F331669EDB597A6AC,40951,21,23,2,36,49,1849
31770,31770,4784D97F3C276E4A1D7A7813E1000E1E,10811,0,6,6,38,46,1946
31771,31771,4784D97F3C276E4A1D7A7813E1000E1E,11021,9,16,7,36,49,1849
31772,31772,4784D97F3C276E4A1D7A7813E1000E1E,10811,21,23,2,38,46,1946
31787,31787,B866B15302F4F3C7BE854D6DBA30F31B,42711,0,7,7,26,48,1348
31788,31788,B866B15302F4F3C7BE854D6DBA30F31B,13121,11,16,5,38,46,1946
31789,31789,B866B15302F4F3C7BE854D6DBA30F31B,42711,18,20,2,26,48,1348
31790,31790,19B7F0CF3E3FD886B38254D17C1F93A2,12311,0,5,5,30,44,1544
31791,31791,19B7F0CF3E3FD886B38254D17C1F93A2,10351,6,7,1,28,45,1445
31792,31792,19B7F0CF3E3FD886B38254D17C1F93A2,10301,9,15,6,31,45,1595
31793,31793,19B7F0CF3E3FD886B38254D17C1F93A2,12311,16,17,1,30,44,1544
31794,31794,19B7F0CF3E3FD886B38254D17C1F93A2,10351,21,23,2,28,45,1445
31795,31795,D1348B896638AC7A64C13B19AE981466,10281,1,12,11,33,48,1698
31796,31796,D1348B896638AC7A64C13B19AE981466,43451,13,16,3,37,40,1890
31797,31797,D1348B896638AC7A64C13B19AE981466,42141,20,23,3,32,47,1647
31802,31802,F2E0A788EC41736380A7AB3495E7AB34,42161,0,7,7,36,47,1847
31803,31803,F2E0A788EC41736380A7AB3495E7AB34,12051,12,17,5,20,47,1047
31804,31804,F2E0A788EC41736380A7AB3495E7AB34,10251,19,23,4,35,47,1797
31805,31805,F6C54C668FECD237DA87E4FC2243153A,11171,1,8,7,33,48,1698
31806,31806,F6C54C668FECD237DA87E4FC2243153A,42321,9,17,8,43,47,2197
31807,31807,F6C54C668FECD237DA87E4FC2243153A,10491,18,22,4,33,48,1698
31808,31808,DE5BDD3B470489AE77EA550C66DF0B7A,13314,0,5,5,31,39,1589
31809,31809,DE5BDD3B470489AE77EA550C66DF0B7A,12521,6,9,3,35,41,1791
31810,31810,DE5BDD3B470489AE77EA550C66DF0B7A,13314,11,13,2,31,39,1589
31811,31811,DE5BDD3B470489AE77EA550C66DF0B7A,12521,14,15,1,35,41,1791
31812,31812,DE5BDD3B470489AE77EA550C66DF0B7A,13314,18,23,5,31,39,1589
31813,31813,94092014F9DD3213271810B8D19555BE,49201,0,5,5,7,41,391
31814,31814,94092014F9DD3213271810B8D19555BE,12641,6,7,1,10,43,543
31815,31815,94092014F9DD3213271810B8D19555BE,19021,8,9,1,10,45,545
31816,31816,94092014F9DD3213271810B8D19555BE,49201,12,19,7,7,41,391
31817,31817,27489D89F6903730F1EBE77F048FABDF,19024,0,10,10,9,45,495
31818,31818,27489D89F6903730F1EBE77F048FABDF,11794,15,17,2,38,49,1949
31819,31819,27489D89F6903730F1EBE77F048FABDF,40341,19,20,1,23,49,1199
31820,31820,360CAB205F052520FED1AC4C9779857A,11941,7,10,3,37,46,1896
31821,31821,360CAB205F052520FED1AC4C9779857A,13711,12,15,3,38,46,1946
31822,31822,360CAB205F052520FED1AC4C9779857A,11941,15,17,2,37,46,1896
31823,31823,360CAB205F052520FED1AC4C9779857A,13711,17,19,2,38,46,1946
31824,31824,360CAB205F052520FED1AC4C9779857A,11941,20,21,1,37,46,1896
31825,31825,360CAB205F052520FED1AC4C9779857A,13711,21,23,2,38,46,1946
31826,31826,5655612953640FEF8E6F10B722F330F6,10751,1,4,3,47,43,2393
31827,31827,5655612953640FEF8E6F10B722F330F6,12211,6,7,1,41,44,2094
31828,31828,5655612953640FEF8E6F10B722F330F6,10751,11,23,12,47,43,2393
31832,31832,11A1F6791BB139142B52DB3053B236D6,11861,0,8,8,32,47,1647
31833,31833,11A1F6791BB139142B52DB3053B236D6,40124,11,14,3,38,47,1947
31834,31834,11A1F6791BB139142B52DB3053B236D6,11861,18,23,5,32,47,1647
31838,31838,DA8EF7789DD15D64E4CB91A60A838933,12841,10,13,3,37,47,1897
31839,31839,DA8EF7789DD15D64E4CB91A60A838933,11161,14,17,3,32,48,1648
31840,31840,DA8EF7789DD15D64E4CB91A60A838933,43731,20,22,2,34,47,1747
31841,31841,9C2C2A9A5923C3E8476FE17BB2B155DD,19114,1,2,1,7,43,393
31842,31842,9C2C2A9A5923C3E8476FE17BB2B155DD,12641,6,8,2,10,43,543
31843,31843,9C2C2A9A5923C3E8476FE17BB2B155DD,19114,11,12,1,7,43,393
31844,31844,9C2C2A9A5923C3E8476FE17BB2B155DD,12641,14,16,2,10,43,543
31845,31845,9C2C2A9A5923C3E8476FE17BB2B155DD,43021,18,19,1,16,43,843
31846,31846,9C2C2A9A5923C3E8476FE17BB2B155DD,19114,22,23,1,7,43,393
31847,31847,B2012EE6BD195EC80673B0F2B5EC1C5E,12921,2,12,10,9,41,491
31848,31848,B2012EE6BD195EC80673B0F2B5EC1C5E,12641,13,15,2,10,43,543
31849,31849,B2012EE6BD195EC80673B0F2B5EC1C5E,19901,16,17,1,7,44,394
31850,31850,B2012EE6BD195EC80673B0F2B5EC1C5E,12641,20,21,1,10,43,543
31851,31851,B2012EE6BD195EC80673B0F2B5EC1C5E,12921,22,23,1,9,41,491
31852,31852,D6932FB45D03368B8FD3FCD5E6F4054F,42281,1,5,4,40,48,2048
31853,31853,D6932FB45D03368B8FD3FCD5E6F4054F,11481,6,7,1,41,48,2098
31854,31854,D6932FB45D03368B8FD3FCD5E6F4054F,13561,8,10,2,37,49,1899
31855,31855,D6932FB45D03368B8FD3FCD5E6F4054F,10161,12,13,1,35,49,1799
31856,31856,D6932FB45D03368B8FD3FCD5E6F4054F,13561,13,15,2,37,49,1899
31857,31857,D6932FB45D03368B8FD3FCD5E6F4054F,43041,18,19,1,41,46,2096
31858,31858,D6932FB45D03368B8FD3FCD5E6F4054F,11481,20,23,3,41,48,2098
31859,31859,705DFE0F0CF99753368D655C68C21E78,12221,0,9,9,43,44,2194
31860,31860,705DFE0F0CF99753368D655C68C21E78,43011,10,11,1,40,42,2042
31861,31861,705DFE0F0CF99753368D655C68C21E78,12221,14,18,4,43,44,2194
31862,31862,705DFE0F0CF99753368D655C68C21E78,43011,19,21,2,40,42,2042
31891,31891,2F8CA12038D8BFDAC42D43FF94213821,13071,0,3,3,41,41,2091
31892,31892,2F8CA12038D8BFDAC42D43FF94213821,42381,5,6,1,39,41,1991
31893,31893,2F8CA12038D8BFDAC42D43FF94213821,43451,6,16,10,37,40,1890
31894,31894,2F8CA12038D8BFDAC42D43FF94213821,42381,16,18,2,39,41,1991
31901,31901,015977F21CA69DACA3E876A5F028B2A4,43051,0,14,14,46,45,2345
31902,31902,015977F21CA69DACA3E876A5F028B2A4,13351,17,19,2,48,48,2448
31903,31903,015977F21CA69DACA3E876A5F028B2A4,43051,20,23,3,46,45,2345
31904,31904,96056246DD9856C2DDE7E703B0D16D68,10951,0,9,9,29,48,1498
31905,31905,96056246DD9856C2DDE7E703B0D16D68,11381,10,13,3,30,47,1547
31906,31906,96056246DD9856C2DDE7E703B0D16D68,42523,13,15,2,31,47,1597
31907,31907,96056246DD9856C2DDE7E703B0D16D68,11381,15,17,2,30,47,1547
31908,31908,96056246DD9856C2DDE7E703B0D16D68,10341,20,23,3,31,47,1597
31909,31909,F1AA6F3E940CBB9FB719C98F8431D25C,19901,0,5,5,7,44,394
31910,31910,F1AA6F3E940CBB9FB719C98F8431D25C,12641,6,11,5,10,43,543
31911,31911,F1AA6F3E940CBB9FB719C98F8431D25C,19901,12,14,2,7,44,394
31912,31912,F1AA6F3E940CBB9FB719C98F8431D25C,12641,16,17,1,10,43,543
31913,31913,F1AA6F3E940CBB9FB719C98F8431D25C,19114,20,21,1,7,43,393
31923,31923,475E382C47A6CA1AB6F806407098614F,40261,9,10,1,35,49,1799
31924,31924,475E382C47A6CA1AB6F806407098614F,11531,10,12,2,34,49,1749
31925,31925,475E382C47A6CA1AB6F806407098614F,13941,18,20,2,41,47,2097
31926,31926,475E382C47A6CA1AB6F806407098614F,11001,20,22,2,42,47,2147
31927,31927,475E382C47A6CA1AB6F806407098614F,13941,22,23,1,41,47,2097
31928,31928,D8A54F41892F1A7A5D59849AB6E88F58,10951,2,12,10,29,48,1498
31929,31929,D8A54F41892F1A7A5D59849AB6E88F58,43731,17,18,1,34,47,1747
31930,31930,D8A54F41892F1A7A5D59849AB6E88F58,10251,19,21,2,35,47,1797
31931,31931,D8A54F41892F1A7A5D59849AB6E88F58,11381,21,23,2,30,47,1547
31939,31939,0E54FDDDFEF0BF7075D3505985BA7000,43011,0,5,5,40,42,2042
31940,31940,0E54FDDDFEF0BF7075D3505985BA7000,43451,6,11,5,37,40,1890
31941,31941,0E54FDDDFEF0BF7075D3505985BA7000,42381,15,17,2,39,41,1991
31942,31942,0E54FDDDFEF0BF7075D3505985BA7000,13071,22,23,1,41,41,2091
31946,31946,33EAA7EC4927A769D83E7FFC99116427,12051,0,4,4,20,47,1047
31947,31947,33EAA7EC4927A769D83E7FFC99116427,42681,6,7,1,24,48,1248
31948,31948,33EAA7EC4927A769D83E7FFC99116427,12051,8,14,6,20,47,1047
31949,31949,33EAA7EC4927A769D83E7FFC99116427,12581,15,16,1,24,48,1248
31950,31950,33EAA7EC4927A769D83E7FFC99116427,12051,17,23,6,20,47,1047
31951,31951,FF222C3A48CBB9D140AAD47504FE867F,10801,0,9,9,42,47,2147
31952,31952,FF222C3A48CBB9D140AAD47504FE867F,40112,13,14,1,32,48,1648
31953,31953,FF222C3A48CBB9D140AAD47504FE867F,11171,14,16,2,33,48,1698
31954,31954,FF222C3A48CBB9D140AAD47504FE867F,12381,17,21,4,32,48,1648
31962,31962,D73AC4E1047F9CA440E1B319E99C168F,10801,0,9,9,42,47,2147
31963,31963,D73AC4E1047F9CA440E1B319E99C168F,40341,10,14,4,23,49,1199
31964,31964,D73AC4E1047F9CA440E1B319E99C168F,10801,15,23,8,42,47,2147
31972,31972,996BCE0DAB75A26D5C00E852EA1E0939,42201,0,8,8,43,46,2196
31973,31973,996BCE0DAB75A26D5C00E852EA1E0939,11301,13,15,2,41,49,2099
31974,31974,996BCE0DAB75A26D5C00E852EA1E0939,42201,17,19,2,43,46,2196
31995,31995,1311DE2B902FCAF1CBC790AD8F564F3C,13551,4,8,4,45,38,2288
31996,31996,1311DE2B902FCAF1CBC790AD8F564F3C,43011,9,12,3,40,42,2042
31997,31997,1311DE2B902FCAF1CBC790AD8F564F3C,13551,16,18,2,45,38,2288
31998,31998,0102436000D6EFDA91A3939751E37135,13341,3,4,1,44,45,2245
31999,31999,0102436000D6EFDA91A3939751E37135,13771,11,20,9,21,45,1095
32000,32000,0102436000D6EFDA91A3939751E37135,12221,21,22,1,43,44,2194
32001,32001,31EDFF51AFC077D20CD89D6C726D652F,12131,0,11,11,32,47,1647
32002,32002,31EDFF51AFC077D20CD89D6C726D652F,12601,12,13,1,25,47,1297
32003,32003,31EDFF51AFC077D20CD89D6C726D652F,10501,14,16,2,22,46,1146
32004,32004,31EDFF51AFC077D20CD89D6C726D652F,12131,18,23,5,32,47,1647
32005,32005,2E539AC6B5EE453A303FF282CE24EA33,19931,0,6,6,7,43,393
32006,32006,2E539AC6B5EE453A303FF282CE24EA33,12921,7,11,4,9,41,491
32007,32007,2E539AC6B5EE453A303FF282CE24EA33,19114,12,13,1,7,43,393
32008,32008,2E539AC6B5EE453A303FF282CE24EA33,12921,14,15,1,9,41,491
32009,32009,2E539AC6B5EE453A303FF282CE24EA33,19114,19,23,4,7,43,393
32010,32010,02510C166446D75090C66561AC0C7CC2,15653,0,8,8,40,25,2025
32011,32011,02510C166446D75090C66561AC0C7CC2,10841,12,13,1,37,47,1897
32012,32012,02510C166446D75090C66561AC0C7CC2,15653,18,23,5,40,25,2025
32017,32017,E428A2146487F7DA252A6BC2E421F512,11074,0,8,8,37,47,1897
32018,32018,E428A2146487F7DA252A6BC2E421F512,12514,11,12,1,38,47,1947
32019,32019,E428A2146487F7DA252A6BC2E421F512,11074,14,19,5,37,47,1897
32020,32020,E428A2146487F7DA252A6BC2E421F512,12514,19,20,1,38,47,1947
32021,32021,E428A2146487F7DA252A6BC2E421F512,11074,20,23,3,37,47,1897
32028,32028,3DD72547B5608222DA28A9B71FDAA734,10681,0,7,7,30,48,1548
32029,32029,3DD72547B5608222DA28A9B71FDAA734,11231,9,15,6,37,49,1899
32030,32030,3DD72547B5608222DA28A9B71FDAA734,40094,19,22,3,29,48,1498
32031,32031,8E574C373DACF2614DE8EE194FD45B5E,40401,0,6,6,40,46,2046
32032,32032,8E574C373DACF2614DE8EE194FD45B5E,12021,8,13,5,37,49,1899
32033,32033,8E574C373DACF2614DE8EE194FD45B5E,11021,13,15,2,36,49,1849
32034,32034,8E574C373DACF2614DE8EE194FD45B5E,10161,17,21,4,35,49,1799
32035,32035,D8FB972AAAC5DB0F06EEBA221E7E96BB,12971,8,11,3,32,48,1648
32036,32036,D8FB972AAAC5DB0F06EEBA221E7E96BB,13951,14,19,5,47,45,2395
32037,32037,D8FB972AAAC5DB0F06EEBA221E7E96BB,13911,21,22,1,39,46,1996
32044,32044,D256AE34DD31744D7365602849D9C40A,42491,0,8,8,32,46,1646
32045,32045,D256AE34DD31744D7365602849D9C40A,10351,8,9,1,28,45,1445
32046,32046,D256AE34DD31744D7365602849D9C40A,12601,13,14,1,25,47,1297
32047,32047,D256AE34DD31744D7365602849D9C40A,10351,14,16,2,28,45,1445
32048,32048,D256AE34DD31744D7365602849D9C40A,42491,19,23,4,32,46,1646
32060,32060,1DD07CF7FD5B3CCCB4E85025836774E4,12841,1,7,6,37,47,1897
32061,32061,1DD07CF7FD5B3CCCB4E85025836774E4,11231,7,17,10,37,49,1899
32062,32062,1DD07CF7FD5B3CCCB4E85025836774E4,11061,18,20,2,29,48,1498
32063,32063,1DD07CF7FD5B3CCCB4E85025836774E4,10221,21,22,1,34,49,1749
32064,32064,05286C4B5017A260B39768783F7D4555,42581,0,6,6,38,48,1948
32065,32065,05286C4B5017A260B39768783F7D4555,10471,6,9,3,37,48,1898
32066,32066,05286C4B5017A260B39768783F7D4555,42581,11,13,2,38,48,1948
32067,32067,05286C4B5017A260B39768783F7D4555,11914,16,18,2,37,48,1898
32068,32068,05286C4B5017A260B39768783F7D4555,42581,18,23,5,38,48,1948
32073,32073,0CED0A2998E753C043314DC59E2912AD,15114,0,1,1,22,16,1116
32074,32074,0CED0A2998E753C043314DC59E2912AD,15143,2,10,8,18,7,907
32075,32075,0CED0A2998E753C043314DC59E2912AD,16151,12,22,10,13,11,661
32085,32085,983364FA08EE78C75B91294E8BF61EB7,12611,0,11,11,41,29,2079
32086,32086,983364FA08EE78C75B91294E8BF61EB7,15411,12,14,2,44,27,2227
32087,32087,983364FA08EE78C75B91294E8BF61EB7,12611,18,19,1,41,29,2079
32094,32094,85030E5036770440209930B75F818AAB,11521,0,13,13,41,48,2098
32095,32095,85030E5036770440209930B75F818AAB,11531,14,16,2,34,49,1749
32096,32096,85030E5036770440209930B75F818AAB,11521,21,23,2,41,48,2098
32111,32111,F808ABC7A00624398DD0E1E1BEE09822,11021,0,8,8,36,49,1849
32112,32112,F808ABC7A00624398DD0E1E1BEE09822,10214,11,16,5,15,49,799
32113,32113,F808ABC7A00624398DD0E1E1BEE09822,12021,18,20,2,37,49,1899
32114,32114,F808ABC7A00624398DD0E1E1BEE09822,11021,20,23,3,36,49,1849
32121,32121,23A21A73FEBD9CCFAF6CD9924910EBC0,10901,0,7,7,35,48,1798
32122,32122,23A21A73FEBD9CCFAF6CD9924910EBC0,10251,7,12,5,35,47,1797
32123,32123,23A21A73FEBD9CCFAF6CD9924910EBC0,11151,15,17,2,30,48,1548
32124,32124,23A21A73FEBD9CCFAF6CD9924910EBC0,10901,18,21,3,35,48,1798
32133,32133,063B1354212200B78E10EABB4C36109F,11834,0,12,12,32,45,1645
32134,32134,063B1354212200B78E10EABB4C36109F,10351,12,13,1,28,45,1445
32135,32135,063B1354212200B78E10EABB4C36109F,12541,14,18,4,37,35,1885
32136,32136,7EA63201A47B68AA085BD7B8AF1F7767,10721,0,7,7,31,48,1598
32137,32137,7EA63201A47B68AA085BD7B8AF1F7767,11231,8,18,10,37,49,1899
32138,32138,7EA63201A47B68AA085BD7B8AF1F7767,10721,19,21,2,31,48,1598
32139,32139,7EA63201A47B68AA085BD7B8AF1F7767,11901,22,23,1,42,49,2149
32144,32144,F118442650FD85FBD1BC14112D7133A6,11061,0,8,8,29,48,1498
32145,32145,F118442650FD85FBD1BC14112D7133A6,42623,10,15,5,22,49,1149
32146,32146,F118442650FD85FBD1BC14112D7133A6,11061,18,23,5,29,48,1498
32151,32151,BC76CCD190FA1A5238AAD9129E2B96C9,40463,2,7,5,38,49,1949
32152,32152,BC76CCD190FA1A5238AAD9129E2B96C9,11231,9,12,3,37,49,1899
32153,32153,BC76CCD190FA1A5238AAD9129E2B96C9,10471,14,16,2,37,48,1898
32154,32154,BC76CCD190FA1A5238AAD9129E2B96C9,10107,18,20,2,38,49,1949
32155,32155,BC76CCD190FA1A5238AAD9129E2B96C9,11271,21,23,2,37,48,1898
32156,32156,980F11CF66A8689B80A1B01A146D2DB4,12491,0,7,7,36,43,1843
32157,32157,980F11CF66A8689B80A1B01A146D2DB4,11261,7,8,1,36,46,1846
32158,32158,980F11CF66A8689B80A1B01A146D2DB4,12491,12,15,3,36,43,1843
32159,32159,980F11CF66A8689B80A1B01A146D2DB4,11261,17,19,2,36,46,1846
32160,32160,980F11CF66A8689B80A1B01A146D2DB4,12491,22,23,1,36,43,1843
32170,32170,C75ACAB55033EB4726676DE416393EB2,11324,0,4,4,31,46,1596
32171,32171,C75ACAB55033EB4726676DE416393EB2,10292,5,7,2,30,47,1547
32172,32172,C75ACAB55033EB4726676DE416393EB2,11324,10,15,5,31,46,1596
32173,32173,C75ACAB55033EB4726676DE416393EB2,43241,17,19,2,36,46,1846
32174,32174,C75ACAB55033EB4726676DE416393EB2,10351,20,21,1,28,45,1445
32175,32175,C75ACAB55033EB4726676DE416393EB2,10634,22,23,1,27,45,1395
32176,32176,FCF6425DA3F542476DF1F93935C075D8,42581,0,9,9,38,48,1948
32177,32177,FCF6425DA3F542476DF1F93935C075D8,11914,9,11,2,37,48,1898
32178,32178,FCF6425DA3F542476DF1F93935C075D8,42581,11,13,2,38,48,1948
32179,32179,FCF6425DA3F542476DF1F93935C075D8,11914,16,17,1,37,48,1898
32180,32180,FCF6425DA3F542476DF1F93935C075D8,11811,18,21,3,38,49,1949
32181,32181,FCF6425DA3F542476DF1F93935C075D8,11914,22,23,1,37,48,1898
32182,32182,4EE541C2C77ED64C3476846B8EC5E510,43081,3,4,1,27,28,1378
32183,32183,4EE541C2C77ED64C3476846B8EC5E510,19801,6,8,2,19,26,976
32184,32184,4EE541C2C77ED64C3476846B8EC5E510,12871,8,9,1,22,33,1133
32185,32185,4EE541C2C77ED64C3476846B8EC5E510,19431,10,11,1,8,29,429
32186,32186,4EE541C2C77ED64C3476846B8EC5E510,12871,15,17,2,22,33,1133
32187,32187,4EE541C2C77ED64C3476846B8EC5E510,19431,19,22,3,8,29,429
32191,32191,5286A29EF2DEDE42572B77FE3AFBCCAE,10611,0,6,6,32,48,1648
32192,32192,5286A29EF2DEDE42572B77FE3AFBCCAE,10295,8,12,4,30,47,1547
32193,32193,5286A29EF2DEDE42572B77FE3AFBCCAE,10611,12,17,5,32,48,1648
32194,32194,5286A29EF2DEDE42572B77FE3AFBCCAE,11201,17,20,3,35,49,1799
32195,32195,5286A29EF2DEDE42572B77FE3AFBCCAE,10221,21,23,2,34,49,1749
32205,32205,E1694F36CFC557B0D454F938790C3817,11861,0,8,8,32,47,1647
32206,32206,E1694F36CFC557B0D454F938790C3817,11731,11,13,2,36,48,1848
32207,32207,E1694F36CFC557B0D454F938790C3817,11211,14,15,1,34,49,1749
32208,32208,E1694F36CFC557B0D454F938790C3817,11861,17,23,6,32,47,1647
32213,32213,684CD853F55EF2E4DB41FBB3886F182A,40094,0,10,10,29,48,1498
32214,32214,684CD853F55EF2E4DB41FBB3886F182A,11151,13,19,6,30,48,1548
32215,32215,684CD853F55EF2E4DB41FBB3886F182A,43241,19,20,1,36,46,1846
32216,32216,684CD853F55EF2E4DB41FBB3886F182A,43391,22,23,1,29,48,1498
32217,32217,6F979605D6AF357AC2A7D27325238248,13821,0,7,7,49,45,2495
32218,32218,6F979605D6AF357AC2A7D27325238248,11261,8,14,6,36,46,1846
32219,32219,6F979605D6AF357AC2A7D27325238248,13821,16,23,7,49,45,2495
32223,32223,8A38A371F8FE39150F4F4AA4BA565B6B,13371,0,7,7,41,47,2097
32224,32224,8A38A371F8FE39150F4F4AA4BA565B6B,10107,8,9,1,38,49,1949
32225,32225,8A38A371F8FE39150F4F4AA4BA565B6B,13371,13,16,3,41,47,2097
32226,32226,8A38A371F8FE39150F4F4AA4BA565B6B,11301,21,22,1,41,49,2099
32227,32227,B15051F34C1D709D49D7843A7D62729F,19441,6,7,1,8,46,446
32228,32228,B15051F34C1D709D49D7843A7D62729F,10061,12,14,2,20,46,1046
32229,32229,B15051F34C1D709D49D7843A7D62729F,19021,15,18,3,10,45,545
32234,32234,2A084843819E55359DC43CB345DC7E6B,42341,0,9,9,43,49,2199
32235,32235,2A084843819E55359DC43CB345DC7E6B,11861,12,19,7,32,47,1647
32236,32236,2A084843819E55359DC43CB345DC7E6B,42971,22,23,1,43,49,2199
32237,32237,E9B5EB38ABAD5346AF228CDEC81E2CE5,13791,0,5,5,42,47,2147
32238,32238,E9B5EB38ABAD5346AF228CDEC81E2CE5,11231,8,13,5,37,49,1899
32239,32239,E9B5EB38ABAD5346AF228CDEC81E2CE5,12601,15,16,1,25,47,1297
32240,32240,E9B5EB38ABAD5346AF228CDEC81E2CE5,11001,18,23,5,42,47,2147
32241,32241,33C1E114C3D832CC53C9AF80A4C6EA55,42091,0,6,6,43,46,2196
32242,32242,33C1E114C3D832CC53C9AF80A4C6EA55,40502,9,10,1,36,48,1848
32243,32243,33C1E114C3D832CC53C9AF80A4C6EA55,42091,13,15,2,43,46,2196
32244,32244,33C1E114C3D832CC53C9AF80A4C6EA55,40341,17,21,4,23,49,1199
32248,32248,7F73A642AA11134206C46BA15C785E40,42491,0,7,7,32,46,1646
32249,32249,7F73A642AA11134206C46BA15C785E40,42521,7,10,3,31,47,1597
32250,32250,7F73A642AA11134206C46BA15C785E40,13651,10,11,1,30,47,1547
32251,32251,7F73A642AA11134206C46BA15C785E40,42521,12,16,4,31,47,1597
32252,32252,7F73A642AA11134206C46BA15C785E40,42491,16,18,2,32,46,1646
32253,32253,7F73A642AA11134206C46BA15C785E40,13651,19,20,1,30,47,1547
32254,32254,7F73A642AA11134206C46BA15C785E40,42521,20,21,1,31,47,1597
32261,32261,753369D691B504B9F7186B2CDF290F06,15391,5,6,1,35,26,1776
32262,32262,753369D691B504B9F7186B2CDF290F06,12792,6,9,3,34,30,1730
32263,32263,753369D691B504B9F7186B2CDF290F06,15391,10,15,5,35,26,1776
32264,32264,753369D691B504B9F7186B2CDF290F06,12792,17,18,1,34,30,1730
32265,32265,753369D691B504B9F7186B2CDF290F06,15391,19,23,4,35,26,1776
32269,32269,3FDEC67AEAECF97FFF0C863D42676BE7,11551,0,10,10,39,49,1999
32270,32270,3FDEC67AEAECF97FFF0C863D42676BE7,40341,12,15,3,23,49,1199
32271,32271,3FDEC67AEAECF97FFF0C863D42676BE7,11351,18,21,3,36,48,1848
32272,32272,C4D6D6893D15A40EF6C21B7CBC7CED3E,11861,0,8,8,32,47,1647
32273,32273,C4D6D6893D15A40EF6C21B7CBC7CED3E,11541,8,18,10,35,49,1799
32274,32274,C4D6D6893D15A40EF6C21B7CBC7CED3E,11861,19,23,4,32,47,1647
32281,32281,343FDB4C0A32FC084A16DC2CB8DF6772,13371,0,7,7,41,47,2097
32282,32282,343FDB4C0A32FC084A16DC2CB8DF6772,42231,9,10,1,37,46,1896
32283,32283,343FDB4C0A32FC084A16DC2CB8DF6772,13941,11,23,12,41,47,2097
32291,32291,883C2BBA1D154EE36C01769727615287,42623,0,14,14,22,49,1149
32292,32292,883C2BBA1D154EE36C01769727615287,11061,18,19,1,29,48,1498
32293,32293,883C2BBA1D154EE36C01769727615287,42623,20,21,1,22,49,1149
32294,32294,42B28AE3CCE12BA9A899758E7A189C34,42271,0,7,7,40,47,2047
32295,32295,42B28AE3CCE12BA9A899758E7A189C34,11806,12,13,1,41,48,2098
32296,32296,42B28AE3CCE12BA9A899758E7A189C34,10121,14,17,3,36,49,1849
32297,32297,42B28AE3CCE12BA9A899758E7A189C34,11806,18,23,5,41,48,2098
32298,32298,3A1B49B490CA109FD4D5251F0C86C9CB,43581,0,14,14,33,48,1698
32299,32299,3A1B49B490CA109FD4D5251F0C86C9CB,12601,14,18,4,25,47,1297
32300,32300,3A1B49B490CA109FD4D5251F0C86C9CB,43581,19,23,4,33,48,1698
32301,32301,CED9AB11DC2F2428809A8D01B1B5BE5E,11381,0,8,8,30,47,1547
32302,32302,CED9AB11DC2F2428809A8D01B1B5BE5E,11751,11,12,1,35,48,1798
32303,32303,CED9AB11DC2F2428809A8D01B1B5BE5E,11061,17,19,2,29,48,1498
32304,32304,2ED0EAEC5E72F7DC65DFDFB4B66840DD,42864,0,7,7,38,44,1944
32305,32305,2ED0EAEC5E72F7DC65DFDFB4B66840DD,11261,8,9,1,36,46,1846
32306,32306,2ED0EAEC5E72F7DC65DFDFB4B66840DD,42864,12,13,1,38,44,1944
32307,32307,2ED0EAEC5E72F7DC65DFDFB4B66840DD,13461,13,14,1,39,44,1994
32308,32308,2ED0EAEC5E72F7DC65DFDFB4B66840DD,42864,15,17,2,38,44,1944
32309,32309,2ED0EAEC5E72F7DC65DFDFB4B66840DD,13821,18,20,2,49,45,2495
32310,32310,64026A4BCC6F790A96FE58191BA1BECE,11431,10,11,1,29,47,1497
32311,32311,64026A4BCC6F790A96FE58191BA1BECE,10751,14,17,3,47,43,2393
32312,32312,64026A4BCC6F790A96FE58191BA1BECE,43951,19,21,2,49,41,2491
32320,32320,4D5F3AD35DC755EFFA8D428280AF81F0,11074,0,3,3,37,47,1897
32321,32321,4D5F3AD35DC755EFFA8D428280AF81F0,12131,4,12,8,32,47,1647
32322,32322,4D5F3AD35DC755EFFA8D428280AF81F0,40463,16,21,5,38,49,1949
32323,32323,4D92520D1E60176F5F81838CD0F00070,10681,0,14,14,30,48,1548
32324,32324,4D92520D1E60176F5F81838CD0F00070,11231,14,17,3,37,49,1899
32325,32325,4D92520D1E60176F5F81838CD0F00070,11061,19,22,3,29,48,1498
32335,32335,33B427A287EC6223ED12DF4C96ADCB55,42523,0,7,7,31,47,1597
32336,32336,33B427A287EC6223ED12DF4C96ADCB55,42491,9,12,3,32,46,1646
32337,32337,33B427A287EC6223ED12DF4C96ADCB55,42523,15,16,1,31,47,1597
32338,32338,33B427A287EC6223ED12DF4C96ADCB55,42491,18,19,1,32,46,1646
32339,32339,33B427A287EC6223ED12DF4C96ADCB55,42523,19,21,2,31,47,1597
32343,32343,C50F95F31F14C0EC9A55706C3B181C1C,12791,2,4,2,31,29,1579
32344,32344,C50F95F31F14C0EC9A55706C3B181C1C,12792,8,13,5,34,30,1730
32345,32345,C50F95F31F14C0EC9A55706C3B181C1C,15391,16,19,3,35,26,1776
32346,32346,C50F95F31F14C0EC9A55706C3B181C1C,12792,21,23,2,34,30,1730
32347,32347,401DBF9291C70DB6E3FE8385830F996E,13791,0,7,7,42,47,2147
32348,32348,401DBF9291C70DB6E3FE8385830F996E,10221,8,12,4,34,49,1749
32349,32349,401DBF9291C70DB6E3FE8385830F996E,43981,12,13,1,36,49,1849
32350,32350,401DBF9291C70DB6E3FE8385830F996E,42521,18,20,2,31,47,1597
32351,32351,401DBF9291C70DB6E3FE8385830F996E,13791,21,23,2,42,47,2147
32356,32356,D5D027DEC2E15CD439B6E37A42DFD8C1,12921,2,3,1,9,41,491
32357,32357,D5D027DEC2E15CD439B6E37A42DFD8C1,43021,8,10,2,16,43,843
32358,32358,D5D027DEC2E15CD439B6E37A42DFD8C1,12921,12,13,1,9,41,491
32359,32359,D5D027DEC2E15CD439B6E37A42DFD8C1,43021,14,18,4,16,43,843
32360,32360,D5D027DEC2E15CD439B6E37A42DFD8C1,19114,18,19,1,7,43,393
32361,32361,3CEF40338CA143A6AA42514B303F8D1D,12311,0,10,10,30,44,1544
32362,32362,3CEF40338CA143A6AA42514B303F8D1D,12083,15,17,2,36,49,1849
32363,32363,3CEF40338CA143A6AA42514B303F8D1D,12311,19,20,1,30,44,1544
32364,32364,1E78C6812CC13AC596F7D7BD80A5DD70,11921,0,10,10,38,48,1948
32365,32365,1E78C6812CC13AC596F7D7BD80A5DD70,11074,10,12,2,37,47,1897
32366,32366,1E78C6812CC13AC596F7D7BD80A5DD70,42221,13,14,1,38,48,1948
32367,32367,1E78C6812CC13AC596F7D7BD80A5DD70,11331,19,20,1,37,48,1898
32368,32368,1E78C6812CC13AC596F7D7BD80A5DD70,11074,21,22,1,37,47,1897
32369,32369,A27203DC664657DF4BBDCCF4AC9D93B1,19181,0,6,6,8,40,440
32370,32370,A27203DC664657DF4BBDCCF4AC9D93B1,12921,6,7,1,9,41,491
32371,32371,A27203DC664657DF4BBDCCF4AC9D93B1,49201,9,17,8,7,41,391
32372,32372,A27203DC664657DF4BBDCCF4AC9D93B1,12921,19,20,1,9,41,491
32373,32373,A27203DC664657DF4BBDCCF4AC9D93B1,49201,21,23,2,7,41,391
32374,32374,39E8FB5C4AE9A0E0783441178F244CD5,10341,2,8,6,31,47,1597
32375,32375,39E8FB5C4AE9A0E0783441178F244CD5,11201,9,12,3,35,49,1799
32376,32376,39E8FB5C4AE9A0E0783441178F244CD5,10341,13,22,9,31,47,1597
32377,32377,497265379240209E8EE445497590FA7C,42221,0,6,6,38,48,1948
32378,32378,497265379240209E8EE445497590FA7C,10724,10,16,6,32,48,1648
32379,32379,497265379240209E8EE445497590FA7C,40094,18,19,1,29,48,1498
32380,32380,497265379240209E8EE445497590FA7C,42221,21,23,2,38,48,1948
32381,32381,2FCC231DE348255A3F9CDA8D77EEA7DC,12581,0,5,5,24,48,1248
32382,32382,2FCC231DE348255A3F9CDA8D77EEA7DC,12051,6,8,2,20,47,1047
32383,32383,2FCC231DE348255A3F9CDA8D77EEA7DC,12581,8,10,2,24,48,1248
32384,32384,2FCC231DE348255A3F9CDA8D77EEA7DC,42541,12,13,1,25,47,1297
32385,32385,2FCC231DE348255A3F9CDA8D77EEA7DC,12581,14,23,9,24,48,1248
32389,32389,38A33D46BA038506E3D6FF17537ACDD6,11911,0,7,7,37,48,1898
32390,32390,38A33D46BA038506E3D6FF17537ACDD6,11921,7,9,2,38,48,1948
32391,32391,38A33D46BA038506E3D6FF17537ACDD6,40951,10,12,2,36,49,1849
32392,32392,38A33D46BA038506E3D6FF17537ACDD6,11331,15,21,6,37,48,1898
32393,32393,38A33D46BA038506E3D6FF17537ACDD6,11921,21,23,2,38,48,1948
32394,32394,78835555A1F3DD1461EF560F0EA88840,12561,0,7,7,45,43,2293
32395,32395,78835555A1F3DD1461EF560F0EA88840,10121,8,12,4,36,49,1849
32396,32396,78835555A1F3DD1461EF560F0EA88840,43951,19,20,1,49,41,2491
32397,32397,87B1169D5A9BB025C6A10231CEED2118,11861,0,2,2,32,47,1647
32398,32398,87B1169D5A9BB025C6A10231CEED2118,19621,4,12,8,5,46,296
32399,32399,87B1169D5A9BB025C6A10231CEED2118,11861,13,15,2,32,47,1647
32400,32400,87B1169D5A9BB025C6A10231CEED2118,10301,15,17,2,31,45,1595
32401,32401,87B1169D5A9BB025C6A10231CEED2118,11861,18,21,3,32,47,1647
32405,32405,19ED78081AD29F14B10BEB26B76EAFDC,42401,0,8,8,36,47,1847
32406,32406,19ED78081AD29F14B10BEB26B76EAFDC,13271,11,12,1,41,47,2097
32407,32407,19ED78081AD29F14B10BEB26B76EAFDC,11001,12,14,2,42,47,2147
32408,32408,19ED78081AD29F14B10BEB26B76EAFDC,42401,19,23,4,36,47,1847
32409,32409,2D936AD1D5A2176A143EF0970EE2AEF0,43021,0,7,7,16,43,843
32410,32410,2D936AD1D5A2176A143EF0970EE2AEF0,19021,7,8,1,10,45,545
32411,32411,2D936AD1D5A2176A143EF0970EE2AEF0,43021,12,13,1,16,43,843
32412,32412,2D936AD1D5A2176A143EF0970EE2AEF0,19021,13,23,10,10,45,545
32416,32416,48D09EA1E123F030FD71CF37426D4799,43011,1,4,3,40,42,2042
32417,32417,48D09EA1E123F030FD71CF37426D4799,42151,5,7,2,35,45,1795
32418,32418,48D09EA1E123F030FD71CF37426D4799,43011,7,19,12,40,42,2042
32419,32419,48D09EA1E123F030FD71CF37426D4799,42151,20,22,2,35,45,1795
32427,32427,734912AAE07BFE6A8CDF7B2AFD01F8FC,10811,0,8,8,38,46,1946
32428,32428,734912AAE07BFE6A8CDF7B2AFD01F8FC,42351,8,9,1,38,45,1945
32429,32429,734912AAE07BFE6A8CDF7B2AFD01F8FC,13711,13,15,2,38,46,1946
32430,32430,734912AAE07BFE6A8CDF7B2AFD01F8FC,10841,18,21,3,37,47,1897
32431,32431,734912AAE07BFE6A8CDF7B2AFD01F8FC,42351,22,23,1,38,45,1945
32435,32435,135EF939D99CED11694D71795A5772B0,19031,0,6,6,1,42,92
32436,32436,135EF939D99CED11694D71795A5772B0,12641,6,10,4,10,43,543
32437,32437,135EF939D99CED11694D71795A5772B0,19031,11,14,3,1,42,92
32438,32438,135EF939D99CED11694D71795A5772B0,12641,14,19,5,10,43,543
32439,32439,0EC1D2502267B7D6F36C8EA9D8EC3DDA,10171,0,12,12,26,47,1347
32440,32440,0EC1D2502267B7D6F36C8EA9D8EC3DDA,10801,16,17,1,42,47,2147
32441,32441,0EC1D2502267B7D6F36C8EA9D8EC3DDA,10171,20,23,3,26,47,1347
32446,32446,14A26121D61284733518359391469C97,19571,0,1,1,1,36,86
32447,32447,14A26121D61284733518359391469C97,43644,1,2,1,14,38,738
32448,32448,14A26121D61284733518359391469C97,19571,2,5,3,1,36,86
32449,32449,14A26121D61284733518359391469C97,43644,6,22,16,14,38,738
32450,32450,0324B4BC4AC52B5FF38CABDD51C922F7,42141,0,5,5,32,47,1647
32451,32451,0324B4BC4AC52B5FF38CABDD51C922F7,43951,8,11,3,49,41,2491
32452,32452,0324B4BC4AC52B5FF38CABDD51C922F7,42631,13,15,2,43,45,2195
32453,32453,0324B4BC4AC52B5FF38CABDD51C922F7,42141,19,23,4,32,47,1647
32461,32461,D96201B04F49DA8FE5B344343C2EC845,10061,0,2,2,20,46,1046
32462,32462,D96201B04F49DA8FE5B344343C2EC845,12601,2,4,2,25,47,1297
32463,32463,D96201B04F49DA8FE5B344343C2EC845,11861,4,17,13,32,47,1647
32464,32464,D96201B04F49DA8FE5B344343C2EC845,42151,19,22,3,35,45,1795
32465,32465,21709F7FFA433548AE3C0AA8A76FE0E7,11151,0,8,8,30,48,1548
32466,32466,21709F7FFA433548AE3C0AA8A76FE0E7,42831,8,9,1,27,48,1398
32467,32467,21709F7FFA433548AE3C0AA8A76FE0E7,11151,11,14,3,30,48,1548
32468,32468,21709F7FFA433548AE3C0AA8A76FE0E7,42831,14,16,2,27,48,1398
32469,32469,21709F7FFA433548AE3C0AA8A76FE0E7,10381,16,18,2,31,49,1599
32470,32470,21709F7FFA433548AE3C0AA8A76FE0E7,11151,20,23,3,30,48,1548
32474,32474,99C7ECB8A04AED18341CF71575998F26,10811,0,7,7,38,46,1946
32475,32475,99C7ECB8A04AED18341CF71575998F26,42091,8,10,2,43,46,2196
32476,32476,99C7ECB8A04AED18341CF71575998F26,13231,12,17,5,39,46,1996
32477,32477,99C7ECB8A04AED18341CF71575998F26,11074,18,20,2,37,47,1897
32478,32478,99C7ECB8A04AED18341CF71575998F26,10811,21,22,1,38,46,1946
32479,32479,D1B198FBEC3C8F15FED9970CD6DFF591,43451,1,14,13,37,40,1890
32480,32480,D1B198FBEC3C8F15FED9970CD6DFF591,42151,15,17,2,35,45,1795
32481,32481,D1B198FBEC3C8F15FED9970CD6DFF591,43451,19,23,4,37,40,1890
32482,32482,5767DCB7927C2A22DA225038742C1BCE,13561,0,6,6,37,49,1899
32483,32483,5767DCB7927C2A22DA225038742C1BCE,11021,10,11,1,36,49,1849
32484,32484,5767DCB7927C2A22DA225038742C1BCE,13561,12,13,1,37,49,1899
32485,32485,5767DCB7927C2A22DA225038742C1BCE,11021,14,17,3,36,49,1849
32486,32486,5767DCB7927C2A22DA225038742C1BCE,13561,19,23,4,37,49,1899
32501,32501,5E28EAB5F2E807365535BF3233D32C9B,10621,0,7,7,41,49,2099
32502,32502,5E28EAB5F2E807365535BF3233D32C9B,40302,7,8,1,40,49,2049
32503,32503,5E28EAB5F2E807365535BF3233D32C9B,42301,13,15,2,36,47,1847
32504,32504,5E28EAB5F2E807365535BF3233D32C9B,11951,15,23,8,31,49,1599
32505,32505,4BEB96C1A6F8B99181CDADEF48D75275,42501,0,6,6,28,47,1447
32506,32506,4BEB96C1A6F8B99181CDADEF48D75275,40343,7,18,11,24,49,1249
32507,32507,4BEB96C1A6F8B99181CDADEF48D75275,42501,20,23,3,28,47,1447
32508,32508,DE7A331A2ADB65AF4D6289538234B91E,13341,0,12,12,44,45,2245
32509,32509,DE7A331A2ADB65AF4D6289538234B91E,42031,13,15,2,40,46,2046
32510,32510,DE7A331A2ADB65AF4D6289538234B91E,11091,16,17,1,29,47,1497
32511,32511,DE7A331A2ADB65AF4D6289538234B91E,13951,19,21,2,47,45,2395
32512,32512,29C5C7944A565741A7D5BD5CE10D2802,13911,1,3,2,39,46,1996
32513,32513,29C5C7944A565741A7D5BD5CE10D2802,11261,4,12,8,36,46,1846
32514,32514,29C5C7944A565741A7D5BD5CE10D2802,11381,15,18,3,30,47,1547
32515,32515,49DF4DE29112FAF4F15B34AA5B17E8E7,43751,8,10,2,19,48,998
32516,32516,49DF4DE29112FAF4F15B34AA5B17E8E7,42681,12,13,1,24,48,1248
32517,32517,49DF4DE29112FAF4F15B34AA5B17E8E7,11381,17,19,2,30,47,1547
32518,32518,49DF4DE29112FAF4F15B34AA5B17E8E7,42681,22,23,1,24,48,1248
32530,32530,4568F4CB3839A063AA85BE5AD656F1DE,11201,1,3,2,35,49,1799
32531,32531,4568F4CB3839A063AA85BE5AD656F1DE,12161,10,14,4,32,46,1646
32532,32532,4568F4CB3839A063AA85BE5AD656F1DE,11351,17,18,1,36,48,1848
32533,32533,46624C7A7A05E81084BABC40FE8F937C,13314,0,7,7,31,39,1589
32534,32534,46624C7A7A05E81084BABC40FE8F937C,12521,12,18,6,35,41,1791
32535,32535,46624C7A7A05E81084BABC40FE8F937C,13314,19,23,4,31,39,1589
32536,32536,23665784F161F2C3C8ECC1289ACB3078,42221,2,3,1,38,48,1948
32537,32537,23665784F161F2C3C8ECC1289ACB3078,11331,5,8,3,37,48,1898
32538,32538,23665784F161F2C3C8ECC1289ACB3078,11701,10,11,1,43,48,2198
32539,32539,23665784F161F2C3C8ECC1289ACB3078,40691,12,13,1,42,48,2148
32540,32540,23665784F161F2C3C8ECC1289ACB3078,11701,15,16,1,43,48,2198
32541,32541,23665784F161F2C3C8ECC1289ACB3078,11911,20,23,3,37,48,1898
32542,32542,7C7C7763ADA0CC64FB88CC4AF6EE7D4D,13791,0,7,7,42,47,2147
32543,32543,7C7C7763ADA0CC64FB88CC4AF6EE7D4D,11074,9,12,3,37,47,1897
32544,32544,7C7C7763ADA0CC64FB88CC4AF6EE7D4D,11921,13,14,1,38,48,1948
32545,32545,7C7C7763ADA0CC64FB88CC4AF6EE7D4D,11074,17,18,1,37,47,1897
32546,32546,7C7C7763ADA0CC64FB88CC4AF6EE7D4D,11921,19,21,2,38,48,1948
32547,32547,7C7C7763ADA0CC64FB88CC4AF6EE7D4D,11001,22,23,1,42,47,2147
32551,32551,7C46E639818D9018A7FC0F2856E8C040,11861,1,13,12,32,47,1647
32552,32552,7C46E639818D9018A7FC0F2856E8C040,42541,14,19,5,25,47,1297
32553,32553,7C46E639818D9018A7FC0F2856E8C040,42021,19,21,2,33,47,1697
32566,32566,95BE11D93617AD2F2EC61FB8A9C16407,13671,2,6,4,27,43,1393
32567,32567,95BE11D93617AD2F2EC61FB8A9C16407,12661,9,11,2,32,45,1645
32568,32568,95BE11D93617AD2F2EC61FB8A9C16407,43011,11,12,1,40,42,2042
32569,32569,95BE11D93617AD2F2EC61FB8A9C16407,12311,18,19,1,30,44,1544
32570,32570,95BE11D93617AD2F2EC61FB8A9C16407,12661,21,23,2,32,45,1645
32581,32581,F1249E9F0C0E4CFC8DF3A999C283E2E8,42791,0,7,7,35,45,1795
32582,32582,F1249E9F0C0E4CFC8DF3A999C283E2E8,10351,9,14,5,28,45,1445
32583,32583,F1249E9F0C0E4CFC8DF3A999C283E2E8,42791,18,21,3,35,45,1795
32584,32584,F1249E9F0C0E4CFC8DF3A999C283E2E8,13381,21,23,2,39,47,1997
32585,32585,A6D2F93D4A875B71BCE922FB59F6D67F,10191,0,13,13,40,48,2048
32586,32586,A6D2F93D4A875B71BCE922FB59F6D67F,10901,14,15,1,35,48,1798
32587,32587,A6D2F93D4A875B71BCE922FB59F6D67F,40341,17,20,3,23,49,1199
32588,32588,A6D2F93D4A875B71BCE922FB59F6D67F,11631,21,23,2,12,49,649
32589,32589,51E47FDE51716EB36BE96125516194AB,10651,0,11,11,36,49,1849
32590,32590,51E47FDE51716EB36BE96125516194AB,40073,12,13,1,37,48,1898
32591,32591,51E47FDE51716EB36BE96125516194AB,11021,14,17,3,36,49,1849
32592,32592,51E47FDE51716EB36BE96125516194AB,40073,18,21,3,37,48,1898
32593,32593,51E47FDE51716EB36BE96125516194AB,11021,21,23,2,36,49,1849
32594,32594,C7B2C2AE2DF954A69981F5A4F94159CA,12731,1,2,1,22,40,1140
32595,32595,C7B2C2AE2DF954A69981F5A4F94159CA,12491,4,8,4,36,43,1843
32596,32596,C7B2C2AE2DF954A69981F5A4F94159CA,11261,12,21,9,36,46,1846
32597,32597,9B49BEB65E16F10DE8E30D5D01D652E3,10811,0,8,8,38,46,1946
32598,32598,9B49BEB65E16F10DE8E30D5D01D652E3,12311,10,14,4,30,44,1544
32599,32599,9B49BEB65E16F10DE8E30D5D01D652E3,11261,19,20,1,36,46,1846
32600,32600,9B49BEB65E16F10DE8E30D5D01D652E3,42351,21,23,2,38,45,1945
32601,32601,D23F2700B8DAA7E39714DEA082BE0CF7,12083,0,2,2,36,49,1849
32602,32602,D23F2700B8DAA7E39714DEA082BE0CF7,13731,4,5,1,33,49,1699
32603,32603,D23F2700B8DAA7E39714DEA082BE0CF7,42261,6,8,2,25,49,1299
32604,32604,D23F2700B8DAA7E39714DEA082BE0CF7,13731,11,23,12,33,49,1699
32613,32613,33DCEB99733F5490EC3E4641096F98E9,11861,0,8,8,32,47,1647
32614,32614,33DCEB99733F5490EC3E4641096F98E9,42861,8,10,2,37,44,1894
32615,32615,33DCEB99733F5490EC3E4641096F98E9,42151,10,11,1,35,45,1795
32616,32616,33DCEB99733F5490EC3E4641096F98E9,42861,14,15,1,37,44,1894
32617,32617,33DCEB99733F5490EC3E4641096F98E9,11781,19,23,4,38,49,1949
32618,32618,86D79D690C2F1F8AD0DA3D3F5AF4C54F,10601,0,3,3,39,47,1997
32619,32619,86D79D690C2F1F8AD0DA3D3F5AF4C54F,10521,4,5,1,41,47,2097
32620,32620,86D79D690C2F1F8AD0DA3D3F5AF4C54F,12491,10,12,2,36,43,1843
32621,32621,86D79D690C2F1F8AD0DA3D3F5AF4C54F,13231,18,21,3,39,46,1996
32622,32622,86D79D690C2F1F8AD0DA3D3F5AF4C54F,10521,21,23,2,41,47,2097
32627,32627,78F90AA6A75AEF1689FC79D56BBC2594,42351,0,7,7,38,45,1945
32628,32628,78F90AA6A75AEF1689FC79D56BBC2594,13911,11,14,3,39,46,1996
32629,32629,78F90AA6A75AEF1689FC79D56BBC2594,42231,14,16,2,37,46,1896
32630,32630,78F90AA6A75AEF1689FC79D56BBC2594,13911,18,19,1,39,46,1996
32631,32631,78F90AA6A75AEF1689FC79D56BBC2594,42351,21,22,1,38,45,1945
32635,32635,53BED426E3030287F564655ACD249D2C,11324,0,10,10,31,46,1596
32636,32636,53BED426E3030287F564655ACD249D2C,43731,12,14,2,34,47,1747
32637,32637,53BED426E3030287F564655ACD249D2C,11324,16,18,2,31,46,1596
32638,32638,53BED426E3030287F564655ACD249D2C,40636,22,23,1,35,48,1798
32642,32642,062DB82DC0B3D584AB2529F1637FF6A0,40271,0,1,1,35,49,1799
32643,32643,062DB82DC0B3D584AB2529F1637FF6A0,41121,4,14,10,25,49,1299
32644,32644,062DB82DC0B3D584AB2529F1637FF6A0,10901,16,18,2,35,48,1798
32645,32645,DAF070E37522449552E837969D087804,11171,0,6,6,33,48,1698
32646,32646,DAF070E37522449552E837969D087804,10471,7,9,2,37,48,1898
32647,32647,DAF070E37522449552E837969D087804,13121,12,16,4,38,46,1946
32648,32648,DAF070E37522449552E837969D087804,10491,20,23,3,33,48,1698
32649,32649,A8D0833E2063BD4F8648FD1BA2D4CAED,10881,0,11,11,34,48,1748
32650,32650,A8D0833E2063BD4F8648FD1BA2D4CAED,40463,12,14,2,38,49,1949
32651,32651,A8D0833E2063BD4F8648FD1BA2D4CAED,11074,20,22,2,37,47,1897
32658,32658,F40AE549AB85A8B1B62FF352219F0DDA,11324,0,2,2,31,46,1596
32659,32659,F40AE549AB85A8B1B62FF352219F0DDA,13651,3,4,1,30,47,1547
32660,32660,F40AE549AB85A8B1B62FF352219F0DDA,10501,9,11,2,22,46,1146
32661,32661,F40AE549AB85A8B1B62FF352219F0DDA,13651,15,19,4,30,47,1547
32662,32662,F40AE549AB85A8B1B62FF352219F0DDA,11324,19,20,1,31,46,1596
32663,32663,F40AE549AB85A8B1B62FF352219F0DDA,13651,21,23,2,30,47,1547
32667,32667,280A825D237E9CE7CB403628403E758B,42351,1,13,12,38,45,1945
32668,32668,280A825D237E9CE7CB403628403E758B,13911,14,15,1,39,46,1996
32669,32669,280A825D237E9CE7CB403628403E758B,13951,19,20,1,47,45,2395
32670,32670,280A825D237E9CE7CB403628403E758B,40463,22,23,1,38,49,1949
32671,32671,7649F52C89D1670662DA3962910D6645,10601,0,6,6,39,47,1997
32672,32672,7649F52C89D1670662DA3962910D6645,12311,7,8,1,30,44,1544
32673,32673,7649F52C89D1670662DA3962910D6645,42531,8,18,10,31,45,1595
32674,32674,7649F52C89D1670662DA3962910D6645,13011,20,23,3,39,47,1997
32679,32679,E03B05F0FB01917EEB19D58711FDBCBD,13071,1,7,6,41,41,2091
32680,32680,E03B05F0FB01917EEB19D58711FDBCBD,43101,11,13,2,46,40,2340
32681,32681,E03B05F0FB01917EEB19D58711FDBCBD,13071,15,17,2,41,41,2091
32682,32682,E03B05F0FB01917EEB19D58711FDBCBD,43101,21,22,1,46,40,2340
32683,32683,64A2E9501F429B6DEC66E8EE627CCABA,11061,0,7,7,29,48,1498
32684,32684,64A2E9501F429B6DEC66E8EE627CCABA,10301,9,13,4,31,45,1595
32685,32685,64A2E9501F429B6DEC66E8EE627CCABA,42521,18,19,1,31,47,1597
32686,32686,F2229754FABF7F398D6839D6208AC86F,10544,0,7,7,28,48,1448
32687,32687,F2229754FABF7F398D6839D6208AC86F,10381,8,11,3,31,49,1599
32688,32688,F2229754FABF7F398D6839D6208AC86F,10544,13,14,1,28,48,1448
32689,32689,F2229754FABF7F398D6839D6208AC86F,10381,15,18,3,31,49,1599
32690,32690,F2229754FABF7F398D6839D6208AC86F,10544,18,23,5,28,48,1448
32698,32698,004D26DDA49F4E295E56D0D4EFA58427,12021,0,1,1,37,49,1899
32699,32699,004D26DDA49F4E295E56D0D4EFA58427,10901,2,4,2,35,48,1798
32700,32700,004D26DDA49F4E295E56D0D4EFA58427,16071,6,19,13,3,3,153
32714,32714,DBE56CF804EFF98F06EBBF480586FC01,43021,0,6,6,16,43,843
32715,32715,DBE56CF804EFF98F06EBBF480586FC01,12921,7,10,3,9,41,491
32716,32716,DBE56CF804EFF98F06EBBF480586FC01,43021,11,14,3,16,43,843
32717,32717,DBE56CF804EFF98F06EBBF480586FC01,12921,18,19,1,9,41,491
32718,32718,DBE56CF804EFF98F06EBBF480586FC01,43021,21,22,1,16,43,843
32722,32722,2D6FDB3C321FD7B096048D3D8304E7BC,42321,0,6,6,43,47,2197
32723,32723,2D6FDB3C321FD7B096048D3D8304E7BC,13941,7,8,1,41,47,2097
32724,32724,2D6FDB3C321FD7B096048D3D8304E7BC,42351,9,11,2,38,45,1945
32725,32725,2D6FDB3C321FD7B096048D3D8304E7BC,11001,11,14,3,42,47,2147
32726,32726,2D6FDB3C321FD7B096048D3D8304E7BC,13941,16,18,2,41,47,2097
32727,32727,2D6FDB3C321FD7B096048D3D8304E7BC,11001,18,20,2,42,47,2147
32728,32728,A5A090591E63A367211B3058D6F881BC,12921,0,7,7,9,41,491
32729,32729,A5A090591E63A367211B3058D6F881BC,43021,7,17,10,16,43,843
32730,32730,A5A090591E63A367211B3058D6F881BC,19114,18,21,3,7,43,393
32731,32731,A5A090591E63A367211B3058D6F881BC,12921,22,23,1,9,41,491
32735,32735,50654F68D94497D10A1C2B9ADDEB1DF4,11771,0,14,14,39,49,1999
32736,32736,50654F68D94497D10A1C2B9ADDEB1DF4,10881,17,18,1,34,48,1748
32737,32737,50654F68D94497D10A1C2B9ADDEB1DF4,11551,19,23,4,39,49,1999
32744,32744,7AB7808A497636952D0CCE900063C9AF,19031,0,2,2,1,42,92
32745,32745,7AB7808A497636952D0CCE900063C9AF,12641,2,3,1,10,43,543
32746,32746,7AB7808A497636952D0CCE900063C9AF,19024,5,22,17,9,45,495
32747,32747,9CAF9D4766C52431BBA0063BD723C357,13101,0,8,8,40,47,2047
32748,32748,9CAF9D4766C52431BBA0063BD723C357,10951,10,12,2,29,48,1498
32749,32749,9CAF9D4766C52431BBA0063BD723C357,13101,13,23,10,40,47,2047
32754,32754,999F2C76DEAF7D23C337AF7700A1D1B4,12641,10,16,6,10,43,543
32755,32755,999F2C76DEAF7D23C337AF7700A1D1B4,43641,17,18,1,16,38,838
32756,32756,999F2C76DEAF7D23C337AF7700A1D1B4,12641,19,21,2,10,43,543
32757,32757,1C04D8021AA3D6ACE9D6057D8C5BDA46,43011,0,5,5,40,42,2042
32758,32758,1C04D8021AA3D6ACE9D6057D8C5BDA46,12211,5,15,10,41,44,2094
32759,32759,1C04D8021AA3D6ACE9D6057D8C5BDA46,13341,16,17,1,44,45,2245
32760,32760,1C04D8021AA3D6ACE9D6057D8C5BDA46,43011,19,21,2,40,42,2042
32761,32761,6C7DE4B4696563CBDA9D3C6E4FCAB652,43761,2,6,4,32,47,1647
32762,32762,6C7DE4B4696563CBDA9D3C6E4FCAB652,42523,6,7,1,31,47,1597
32763,32763,6C7DE4B4696563CBDA9D3C6E4FCAB652,10292,8,9,1,30,47,1547
32764,32764,6C7DE4B4696563CBDA9D3C6E4FCAB652,11751,12,13,1,35,48,1798
32765,32765,6C7DE4B4696563CBDA9D3C6E4FCAB652,10292,16,19,3,30,47,1547
32766,32766,6C7DE4B4696563CBDA9D3C6E4FCAB652,10341,20,22,2,31,47,1597
32770,32770,441E401293D6FFC8E080552D376784E1,42581,0,5,5,38,48,1948
32771,32771,441E401293D6FFC8E080552D376784E1,11914,5,9,4,37,48,1898
32772,32772,441E401293D6FFC8E080552D376784E1,42581,10,19,9,38,48,1948
32773,32773,441E401293D6FFC8E080552D376784E1,11914,19,20,1,37,48,1898
32774,32774,441E401293D6FFC8E080552D376784E1,42581,21,23,2,38,48,1948
32790,32790,E84132D1E9974974874A22AF07CA75D4,43751,0,6,6,19,48,998
32791,32791,E84132D1E9974974874A22AF07CA75D4,11381,6,8,2,30,47,1547
32792,32792,E84132D1E9974974874A22AF07CA75D4,43751,12,14,2,19,48,998
32793,32793,E84132D1E9974974874A22AF07CA75D4,11571,19,20,1,13,46,696
32794,32794,E84132D1E9974974874A22AF07CA75D4,43751,21,23,2,19,48,998
32798,32798,F841C6434AB81A3BFE74D7CA133D307B,11074,0,16,16,37,47,1897
32799,32799,F841C6434AB81A3BFE74D7CA133D307B,43001,18,19,1,47,47,2397
32800,32800,F841C6434AB81A3BFE74D7CA133D307B,11074,21,23,2,37,47,1897
32804,32804,1482B7A55B8E55DF5157551064F6B705,13471,0,6,6,47,49,2399
32805,32805,1482B7A55B8E55DF5157551064F6B705,12661,10,11,1,32,45,1645
32806,32806,1482B7A55B8E55DF5157551064F6B705,12311,11,13,2,30,44,1544
32807,32807,1482B7A55B8E55DF5157551064F6B705,13471,14,23,9,47,49,2399
32808,32808,6D44900B338261EB5103DD9A28DDA712,13941,0,7,7,41,47,2097
32809,32809,6D44900B338261EB5103DD9A28DDA712,11021,9,12,3,36,49,1849
32810,32810,6D44900B338261EB5103DD9A28DDA712,13941,13,14,1,41,47,2097
32811,32811,6D44900B338261EB5103DD9A28DDA712,11021,16,17,1,36,49,1849
32812,32812,6D44900B338261EB5103DD9A28DDA712,11481,18,19,1,41,48,2098
32813,32813,6D44900B338261EB5103DD9A28DDA712,13221,20,21,1,40,47,2047
32814,32814,6D44900B338261EB5103DD9A28DDA712,13941,22,23,1,41,47,2097
32827,32827,8653F490165C5E4408F801ED221A6191,10841,0,1,1,37,47,1897
32828,32828,8653F490165C5E4408F801ED221A6191,13551,2,4,2,45,38,2288
32829,32829,8653F490165C5E4408F801ED221A6191,43451,4,7,3,37,40,1890
32830,32830,8653F490165C5E4408F801ED221A6191,12521,12,20,8,35,41,1791
32831,32831,FCC19A67E55CE4004C874BCD935AF655,43761,7,9,2,32,47,1647
32832,32832,FCC19A67E55CE4004C874BCD935AF655,42523,9,11,2,31,47,1597
32833,32833,FCC19A67E55CE4004C874BCD935AF655,43761,11,13,2,32,47,1647
32834,32834,FCC19A67E55CE4004C874BCD935AF655,42523,13,16,3,31,47,1597
32835,32835,FCC19A67E55CE4004C874BCD935AF655,11301,20,22,2,41,49,2099
32836,32836,79180DDD86B22B2BAEB51E3552560D4E,11381,0,12,12,30,47,1547
32837,32837,79180DDD86B22B2BAEB51E3552560D4E,10341,13,15,2,31,47,1597
32838,32838,79180DDD86B22B2BAEB51E3552560D4E,11381,15,17,2,30,47,1547
32839,32839,79180DDD86B22B2BAEB51E3552560D4E,10381,17,19,2,31,49,1599
32840,32840,79180DDD86B22B2BAEB51E3552560D4E,10341,20,22,2,31,47,1597
32844,32844,3725094C67BAB476261802F12382A183,10251,6,9,3,35,47,1797
32845,32845,3725094C67BAB476261802F12382A183,43761,9,10,1,32,47,1647
32846,32846,3725094C67BAB476261802F12382A183,10251,11,13,2,35,47,1797
32847,32847,3725094C67BAB476261802F12382A183,12511,14,15,1,39,47,1997
32848,32848,3725094C67BAB476261802F12382A183,10251,16,19,3,35,47,1797
32849,32849,3725094C67BAB476261802F12382A183,11074,19,20,1,37,47,1897
32850,32850,716B09685D1959DF7A0BF10A089CC954,11351,0,1,1,36,48,1848
32851,32851,716B09685D1959DF7A0BF10A089CC954,11271,3,6,3,37,48,1898
32852,32852,716B09685D1959DF7A0BF10A089CC954,19441,8,13,5,8,46,446
32853,32853,716B09685D1959DF7A0BF10A089CC954,10161,17,21,4,35,49,1799
32854,32854,716B09685D1959DF7A0BF10A089CC954,11271,21,22,1,37,48,1898
32855,32855,25E2DC6B6F1A35C270D1506739EABFB0,43051,0,8,8,46,45,2345
32856,32856,25E2DC6B6F1A35C270D1506739EABFB0,13471,12,13,1,47,49,2399
32857,32857,25E2DC6B6F1A35C270D1506739EABFB0,43051,17,23,6,46,45,2345
32867,32867,FC6A327AF4D88F99F15C3F090B3C9103,13341,1,2,1,44,45,2245
32868,32868,FC6A327AF4D88F99F15C3F090B3C9103,43011,6,17,11,40,42,2042
32869,32869,FC6A327AF4D88F99F15C3F090B3C9103,43051,18,22,4,46,45,2345
32870,32870,88B9ED484BFC88A3E18D812526B753D0,10811,0,4,4,38,46,1946
32871,32871,88B9ED484BFC88A3E18D812526B753D0,42864,6,10,4,38,44,1944
32872,32872,88B9ED484BFC88A3E18D812526B753D0,11261,11,13,2,36,46,1846
32873,32873,88B9ED484BFC88A3E18D812526B753D0,42864,14,17,3,38,44,1944
32874,32874,88B9ED484BFC88A3E18D812526B753D0,11261,19,21,2,36,46,1846
32875,32875,494D4CE05480984DBEB3A2073E0D7F93,10191,0,9,9,40,48,2048
32876,32876,494D4CE05480984DBEB3A2073E0D7F93,10491,9,12,3,33,48,1698
32877,32877,494D4CE05480984DBEB3A2073E0D7F93,10191,12,14,2,40,48,2048
32878,32878,494D4CE05480984DBEB3A2073E0D7F93,10721,17,18,1,31,48,1598
32879,32879,494D4CE05480984DBEB3A2073E0D7F93,11781,21,23,2,38,49,1949
32880,32880,A0E1933ED6F7A553840E39014C4F2632,15184,0,6,6,29,22,1472
32881,32881,A0E1933ED6F7A553840E39014C4F2632,13481,8,20,12,26,31,1331
32882,32882,A0E1933ED6F7A553840E39014C4F2632,12871,21,22,1,22,33,1133
32883,32883,A907F1FD9C6E827C729A4F36D915F4F7,40691,0,1,1,42,48,2148
32884,32884,A907F1FD9C6E827C729A4F36D915F4F7,11701,2,5,3,43,48,2198
32885,32885,A907F1FD9C6E827C729A4F36D915F4F7,40691,5,7,2,42,48,2148
32886,32886,A907F1FD9C6E827C729A4F36D915F4F7,12083,8,11,3,36,49,1849
32887,32887,A907F1FD9C6E827C729A4F36D915F4F7,11231,12,14,2,37,49,1899
32888,32888,A907F1FD9C6E827C729A4F36D915F4F7,43281,15,16,1,37,48,1898
32889,32889,A907F1FD9C6E827C729A4F36D915F4F7,12083,20,21,1,36,49,1849
32890,32890,852A679DBA85E8EC93E7E59DB87D7BB9,10661,0,7,7,37,49,1899
32891,32891,852A679DBA85E8EC93E7E59DB87D7BB9,12971,8,9,1,32,48,1648
32892,32892,852A679DBA85E8EC93E7E59DB87D7BB9,10661,17,21,4,37,49,1899
32893,32893,852A679DBA85E8EC93E7E59DB87D7BB9,11531,21,23,2,34,49,1749
32897,32897,64C897065E9EDCA8A69F38A94EFB9055,10151,0,9,9,34,47,1747
32898,32898,64C897065E9EDCA8A69F38A94EFB9055,10651,9,11,2,36,49,1849
32899,32899,64C897065E9EDCA8A69F38A94EFB9055,10151,13,14,1,34,47,1747
32900,32900,64C897065E9EDCA8A69F38A94EFB9055,10651,14,16,2,36,49,1849
32901,32901,64C897065E9EDCA8A69F38A94EFB9055,43731,17,22,5,34,47,1747
32911,32911,3685D6C71438FECB08DB0F37510D88D0,12514,4,7,3,38,47,1947
32912,32912,3685D6C71438FECB08DB0F37510D88D0,42471,10,12,2,35,49,1799
32913,32913,3685D6C71438FECB08DB0F37510D88D0,12514,13,23,10,38,47,1947
32917,32917,97EED02186157B67ACCA35C5CC13851D,10531,0,8,8,34,46,1746
32918,32918,97EED02186157B67ACCA35C5CC13851D,12971,9,11,2,32,48,1648
32919,32919,97EED02186157B67ACCA35C5CC13851D,10531,12,14,2,34,46,1746
32920,32920,97EED02186157B67ACCA35C5CC13851D,12121,16,23,7,29,47,1497
32924,32924,506A4D1673DAADE6E640971E1A7E467C,42921,0,12,12,33,47,1697
32925,32925,506A4D1673DAADE6E640971E1A7E467C,40951,12,14,2,36,49,1849
32926,32926,506A4D1673DAADE6E640971E1A7E467C,11751,16,17,1,35,48,1798
32927,32927,506A4D1673DAADE6E640971E1A7E467C,42021,18,23,5,33,47,1697
32931,32931,CB6CE8B284764CB65EC4187E6FE5A3FF,43021,0,5,5,16,43,843
32932,32932,CB6CE8B284764CB65EC4187E6FE5A3FF,19021,6,19,13,10,45,545
32933,32933,CB6CE8B284764CB65EC4187E6FE5A3FF,43021,21,22,1,16,43,843
32934,32934,BB6408B6449FE57F7E33631A828BC98E,11701,0,1,1,43,48,2198
32935,32935,BB6408B6449FE57F7E33631A828BC98E,11521,3,8,5,41,48,2098
32936,32936,BB6408B6449FE57F7E33631A828BC98E,13961,8,12,4,42,48,2148
32937,32937,BB6408B6449FE57F7E33631A828BC98E,42201,16,17,1,43,46,2196
32938,32938,BB6408B6449FE57F7E33631A828BC98E,11701,18,20,2,43,48,2198
32939,32939,1DD1A250791E8DE9D0B949B1DAE230C8,10281,0,11,11,33,48,1698
32940,32940,1DD1A250791E8DE9D0B949B1DAE230C8,11861,11,13,2,32,47,1647
32941,32941,1DD1A250791E8DE9D0B949B1DAE230C8,10281,15,16,1,33,48,1698
32942,32942,1DD1A250791E8DE9D0B949B1DAE230C8,11861,18,20,2,32,47,1647
32943,32943,1DD1A250791E8DE9D0B949B1DAE230C8,10151,21,23,2,34,47,1747
32947,32947,0A15402BF50F336CD996C3C85D01B359,10471,0,9,9,37,48,1898
32948,32948,0A15402BF50F336CD996C3C85D01B359,11791,9,10,1,38,49,1949
32949,32949,0A15402BF50F336CD996C3C85D01B359,10471,11,15,4,37,48,1898
32950,32950,0A15402BF50F336CD996C3C85D01B359,11231,15,16,1,37,49,1899
32951,32951,0A15402BF50F336CD996C3C85D01B359,10471,16,23,7,37,48,1898
32952,32952,AB57CFBC7FBBD1B4F46C04046F726522,12881,0,4,4,47,22,2372
32953,32953,AB57CFBC7FBBD1B4F46C04046F726522,15021,7,8,1,46,18,2318
32954,32954,AB57CFBC7FBBD1B4F46C04046F726522,12881,8,10,2,47,22,2372
32955,32955,AB57CFBC7FBBD1B4F46C04046F726522,15441,10,11,1,44,20,2220
32956,32956,AB57CFBC7FBBD1B4F46C04046F726522,12881,11,13,2,47,22,2372
32957,32957,AB57CFBC7FBBD1B4F46C04046F726522,15171,18,23,5,42,21,2121
32958,32958,409A27121CD9E6BC90762C45B277F54C,11861,0,6,6,32,47,1647
32959,32959,409A27121CD9E6BC90762C45B277F54C,43281,7,11,4,37,48,1898
32960,32960,409A27121CD9E6BC90762C45B277F54C,11461,11,13,2,37,49,1899
32961,32961,409A27121CD9E6BC90762C45B277F54C,43281,14,16,2,37,48,1898
32962,32962,409A27121CD9E6BC90762C45B277F54C,11861,19,23,4,32,47,1647
32966,32966,4159D43B297F1C5059F36ACC8EB9CB14,12661,0,1,1,32,45,1645
32967,32967,4159D43B297F1C5059F36ACC8EB9CB14,42151,2,4,2,35,45,1795
32968,32968,4159D43B297F1C5059F36ACC8EB9CB14,12661,8,9,1,32,45,1645
32969,32969,4159D43B297F1C5059F36ACC8EB9CB14,43751,15,19,4,19,48,998
32970,32970,4159D43B297F1C5059F36ACC8EB9CB14,12661,20,22,2,32,45,1645
32974,32974,37F1D2311F2383134D9A7BD374E33133,12051,10,14,4,20,47,1047
32975,32975,37F1D2311F2383134D9A7BD374E33133,12121,16,18,2,29,47,1497
32976,32976,37F1D2311F2383134D9A7BD374E33133,10501,19,21,2,22,46,1146
32977,32977,9F589AB01E58B6B2CA9FB997F96CB7F3,13071,0,7,7,41,41,2091
32978,32978,9F589AB01E58B6B2CA9FB997F96CB7F3,43451,9,10,1,37,40,1890
32979,32979,9F589AB01E58B6B2CA9FB997F96CB7F3,42381,11,13,2,39,41,1991
32980,32980,9F589AB01E58B6B2CA9FB997F96CB7F3,43451,14,16,2,37,40,1890
32981,32981,9F589AB01E58B6B2CA9FB997F96CB7F3,13071,16,23,7,41,41,2091
32985,32985,54AF0735D887B9C0B8CEE7B0E8BAEF2D,19441,1,12,11,8,46,446
32986,32986,54AF0735D887B9C0B8CEE7B0E8BAEF2D,11571,16,18,2,13,46,696
32987,32987,54AF0735D887B9C0B8CEE7B0E8BAEF2D,19441,18,23,5,8,46,446
33001,33001,E675A65705B47E64E764764AA7201F3F,15411,6,9,3,44,27,2227
33002,33002,E675A65705B47E64E764764AA7201F3F,12611,10,12,2,41,29,2079
33003,33003,E675A65705B47E64E764764AA7201F3F,15411,13,21,8,44,27,2227
33004,33004,6D9B191036D25EF15FC371A87A4278C4,11741,0,6,6,42,49,2149
33005,33005,6D9B191036D25EF15FC371A87A4278C4,42231,10,17,7,37,46,1896
33006,33006,6D9B191036D25EF15FC371A87A4278C4,42341,19,23,4,43,49,2199
33007,33007,59644621240D60A0095CD2C9DBFE93CE,43081,0,3,3,27,28,1378
33008,33008,59644621240D60A0095CD2C9DBFE93CE,49181,4,6,2,21,31,1081
33009,33009,59644621240D60A0095CD2C9DBFE93CE,19801,6,8,2,19,26,976
33010,33010,59644621240D60A0095CD2C9DBFE93CE,43121,9,10,1,25,27,1277
33011,33011,59644621240D60A0095CD2C9DBFE93CE,12871,10,12,2,22,33,1133
33012,33012,59644621240D60A0095CD2C9DBFE93CE,19801,13,16,3,19,26,976
33013,33013,59644621240D60A0095CD2C9DBFE93CE,12871,17,18,1,22,33,1133
33014,33014,59644621240D60A0095CD2C9DBFE93CE,19801,18,20,2,19,26,976
33018,33018,84F67B4B3C17ACCABE2B7DC342CF0E8C,16151,2,15,13,13,11,661
33019,33019,84F67B4B3C17ACCABE2B7DC342CF0E8C,15114,16,18,2,22,16,1116
33020,33020,84F67B4B3C17ACCABE2B7DC342CF0E8C,16151,20,22,2,13,11,661
33024,33024,4D239E998445105BB1DB28C4CB8040D2,11914,0,1,1,37,48,1898
33025,33025,4D239E998445105BB1DB28C4CB8040D2,42581,2,7,5,38,48,1948
33026,33026,4D239E998445105BB1DB28C4CB8040D2,11914,11,12,1,37,48,1898
33027,33027,4D239E998445105BB1DB28C4CB8040D2,42581,13,19,6,38,48,1948
33028,33028,4D239E998445105BB1DB28C4CB8040D2,11914,19,20,1,37,48,1898
33032,33032,09803726F3C2A40BEF93389F75159E93,10281,0,7,7,33,48,1698
33033,33033,09803726F3C2A40BEF93389F75159E93,11161,8,10,2,32,48,1648
33034,33034,09803726F3C2A40BEF93389F75159E93,10281,11,13,2,33,48,1698
33035,33035,09803726F3C2A40BEF93389F75159E93,11861,15,19,4,32,47,1647
33036,33036,09803726F3C2A40BEF93389F75159E93,10281,19,23,4,33,48,1698
33037,33037,90AC20E6CC0B4ABA3A4EAC5C3086C030,13741,0,8,8,37,49,1899
33038,33038,90AC20E6CC0B4ABA3A4EAC5C3086C030,11841,8,11,3,33,46,1696
33039,33039,90AC20E6CC0B4ABA3A4EAC5C3086C030,10531,11,13,2,34,46,1746
33040,33040,90AC20E6CC0B4ABA3A4EAC5C3086C030,13561,14,17,3,37,49,1899
33041,33041,90AC20E6CC0B4ABA3A4EAC5C3086C030,13121,17,22,5,38,46,1946
33042,33042,44BA65919A80728667B0D62571A4968D,13121,0,1,1,38,46,1946
33043,33043,44BA65919A80728667B0D62571A4968D,10271,4,7,3,37,46,1896
33044,33044,44BA65919A80728667B0D62571A4968D,13121,12,13,1,38,46,1946
33045,33045,44BA65919A80728667B0D62571A4968D,10271,14,15,1,37,46,1896
33046,33046,44BA65919A80728667B0D62571A4968D,13121,16,19,3,38,46,1946
33054,33054,24576DC2C63BF30A46BA06C33A71F868,13911,0,4,4,39,46,1996
33055,33055,24576DC2C63BF30A46BA06C33A71F868,11261,5,21,16,36,46,1846
33056,33056,24576DC2C63BF30A46BA06C33A71F868,42151,22,23,1,35,45,1795
33061,33061,D2729AB4C70132F423F41A3669BBCC53,43761,0,6,6,32,47,1647
33062,33062,D2729AB4C70132F423F41A3669BBCC53,42521,6,7,1,31,47,1597
33063,33063,D2729AB4C70132F423F41A3669BBCC53,43761,11,12,1,32,47,1647
33064,33064,D2729AB4C70132F423F41A3669BBCC53,42521,13,14,1,31,47,1597
33065,33065,D2729AB4C70132F423F41A3669BBCC53,43761,15,23,8,32,47,1647
33069,33069,4ECB0AF0BC82340C9B2682E9A14AD42C,11151,0,8,8,30,48,1548
33070,33070,4ECB0AF0BC82340C9B2682E9A14AD42C,40343,13,16,3,24,49,1249
33071,33071,4ECB0AF0BC82340C9B2682E9A14AD42C,11151,19,23,4,30,48,1548
33076,33076,37F4973B3FFADD567DBFB2AD063B667B,11074,1,9,8,37,47,1897
33077,33077,37F4973B3FFADD567DBFB2AD063B667B,42301,10,12,2,36,47,1847
33078,33078,37F4973B3FFADD567DBFB2AD063B667B,11074,13,16,3,37,47,1897
33079,33079,37F4973B3FFADD567DBFB2AD063B667B,43021,19,23,4,16,43,843
33083,33083,1B914EA19E608B834149612681BFDCB4,43011,0,6,6,40,42,2042
33084,33084,1B914EA19E608B834149612681BFDCB4,12221,11,21,10,43,44,2194
33085,33085,1B914EA19E608B834149612681BFDCB4,43011,22,23,1,40,42,2042
33095,33095,09C2A5500F5ABAEEAC932C07F5628EC4,11021,0,8,8,36,49,1849
33096,33096,09C2A5500F5ABAEEAC932C07F5628EC4,43161,8,11,3,35,47,1797
33097,33097,09C2A5500F5ABAEEAC932C07F5628EC4,11021,12,14,2,36,49,1849
33098,33098,09C2A5500F5ABAEEAC932C07F5628EC4,10251,15,19,4,35,47,1797
33099,33099,09C2A5500F5ABAEEAC932C07F5628EC4,11021,19,20,1,36,49,1849
33100,33100,DF7C9F87F303AFFB64D67BB12FA23958,42321,0,5,5,43,47,2197
33101,33101,DF7C9F87F303AFFB64D67BB12FA23958,13121,7,11,4,38,46,1946
33102,33102,DF7C9F87F303AFFB64D67BB12FA23958,13221,22,23,1,40,47,2047
33107,33107,97A72775944BA1B8C6B7775217FDFDCA,42221,4,6,2,38,48,1948
33108,33108,97A72775944BA1B8C6B7775217FDFDCA,42623,9,10,1,22,49,1149
33109,33109,97A72775944BA1B8C6B7775217FDFDCA,42221,14,16,2,38,48,1948
33110,33110,97A72775944BA1B8C6B7775217FDFDCA,12514,18,23,5,38,47,1947
33111,33111,BBCB9918D42B41DEDF16DD7F5A9BE26F,11861,0,10,10,32,47,1647
33112,33112,BBCB9918D42B41DEDF16DD7F5A9BE26F,42161,10,14,4,36,47,1847
33113,33113,BBCB9918D42B41DEDF16DD7F5A9BE26F,11911,14,16,2,37,48,1898
33114,33114,BBCB9918D42B41DEDF16DD7F5A9BE26F,11861,17,23,6,32,47,1647
33130,33130,5A90C46B3DA1304065EF64B9AFC21F3D,43311,0,10,10,31,48,1598
33131,33131,5A90C46B3DA1304065EF64B9AFC21F3D,10801,15,16,1,42,47,2147
33132,33132,5A90C46B3DA1304065EF64B9AFC21F3D,12381,17,23,6,32,48,1648
33140,33140,A5267560F8241F40BFCB325C4ADBB18D,12601,0,5,5,25,47,1297
33141,33141,A5267560F8241F40BFCB325C4ADBB18D,10351,6,7,1,28,45,1445
33142,33142,A5267560F8241F40BFCB325C4ADBB18D,10634,8,10,2,27,45,1395
33143,33143,A5267560F8241F40BFCB325C4ADBB18D,10351,11,18,7,28,45,1445
33162,33162,4C6EBE1C4B2FAAFACD17B57BF7692986,10531,1,4,3,34,46,1746
33163,33163,4C6EBE1C4B2FAAFACD17B57BF7692986,43731,5,7,2,34,47,1747
33164,33164,4C6EBE1C4B2FAAFACD17B57BF7692986,42161,8,9,1,36,47,1847
33165,33165,4C6EBE1C4B2FAAFACD17B57BF7692986,43731,11,19,8,34,47,1747
33166,33166,4C6EBE1C4B2FAAFACD17B57BF7692986,10401,20,21,1,33,49,1699
33177,33177,10C025DE83AEC63388DB13DE6128ADC8,10951,0,7,7,29,48,1498
33178,33178,10C025DE83AEC63388DB13DE6128ADC8,11381,9,10,1,30,47,1547
33179,33179,10C025DE83AEC63388DB13DE6128ADC8,12121,12,13,1,29,47,1497
33180,33180,10C025DE83AEC63388DB13DE6128ADC8,11381,15,18,3,30,47,1547
33181,33181,10C025DE83AEC63388DB13DE6128ADC8,10951,19,23,4,29,48,1498
33182,33182,B914A132573D7D3BBB16CB089396ABAE,10381,9,11,2,31,49,1599
33183,33183,B914A132573D7D3BBB16CB089396ABAE,11061,11,14,3,29,48,1498
33184,33184,B914A132573D7D3BBB16CB089396ABAE,12021,18,19,1,37,49,1899
33198,33198,220A83B4C0760D0CE7D499DE7174338C,11324,0,7,7,31,46,1596
33199,33199,220A83B4C0760D0CE7D499DE7174338C,10111,8,13,5,37,47,1897
33200,33200,220A83B4C0760D0CE7D499DE7174338C,42401,14,16,2,36,47,1847
33201,33201,220A83B4C0760D0CE7D499DE7174338C,11324,19,23,4,31,46,1596
33205,33205,DD6C9DDEAEA1DF5C11D85E17AB24B977,11151,0,11,11,30,48,1548
33206,33206,DD6C9DDEAEA1DF5C11D85E17AB24B977,10107,13,14,1,38,49,1949
33207,33207,DD6C9DDEAEA1DF5C11D85E17AB24B977,40341,16,19,3,23,49,1199
33208,33208,DD6C9DDEAEA1DF5C11D85E17AB24B977,11151,20,23,3,30,48,1548
33209,33209,35507D733CAF04397C1F4C352260CF5D,42583,0,11,11,40,48,2048
33210,33210,35507D733CAF04397C1F4C352260CF5D,42521,14,17,3,31,47,1597
33211,33211,35507D733CAF04397C1F4C352260CF5D,10901,17,20,3,35,48,1798
33223,33223,27FD8A6CDE751A5F2BC12F75826C7985,43021,2,5,3,16,43,843
33224,33224,27FD8A6CDE751A5F2BC12F75826C7985,12921,5,7,2,9,41,491
33225,33225,27FD8A6CDE751A5F2BC12F75826C7985,43021,7,11,4,16,43,843
33226,33226,27FD8A6CDE751A5F2BC12F75826C7985,12921,14,18,4,9,41,491
33227,33227,27FD8A6CDE751A5F2BC12F75826C7985,43021,18,21,3,16,43,843
33231,33231,B33429D7A00DB66721EA07FF9AC9AB45,11861,0,8,8,32,47,1647
33232,33232,B33429D7A00DB66721EA07FF9AC9AB45,11461,10,22,12,37,49,1899
33233,33233,B33429D7A00DB66721EA07FF9AC9AB45,11861,22,23,1,32,47,1647
33234,33234,0A06E26D4B63B311703019BBFB7FEF42,42191,0,8,8,38,49,1949
33235,33235,0A06E26D4B63B311703019BBFB7FEF42,11021,9,12,3,36,49,1849
33236,33236,0A06E26D4B63B311703019BBFB7FEF42,42161,12,14,2,36,47,1847
33237,33237,0A06E26D4B63B311703019BBFB7FEF42,11591,15,17,2,36,49,1849
33238,33238,0A06E26D4B63B311703019BBFB7FEF42,10471,19,21,2,37,48,1898
33239,33239,0A06E26D4B63B311703019BBFB7FEF42,42471,22,23,1,35,49,1799
33240,33240,08B6161A63F0BFCCF67BFC0EA5B81E44,42621,0,6,6,24,49,1249
33241,33241,08B6161A63F0BFCCF67BFC0EA5B81E44,40341,6,10,4,23,49,1199
33242,33242,08B6161A63F0BFCCF67BFC0EA5B81E44,42621,10,13,3,24,49,1249
33243,33243,08B6161A63F0BFCCF67BFC0EA5B81E44,40341,19,21,2,23,49,1199
33244,33244,08B6161A63F0BFCCF67BFC0EA5B81E44,42621,22,23,1,24,49,1249
33251,33251,259F6E48951D41AE5936B8EB9EF0DFD3,42371,7,11,4,34,46,1746
33252,33252,259F6E48951D41AE5936B8EB9EF0DFD3,42151,12,20,8,35,45,1795
33253,33253,259F6E48951D41AE5936B8EB9EF0DFD3,12211,22,23,1,41,44,2094
33254,33254,A8C0E319CF806B3860CE270F9D93D0BD,10724,9,13,4,32,48,1648
33255,33255,A8C0E319CF806B3860CE270F9D93D0BD,11231,17,19,2,37,49,1899
33256,33256,A8C0E319CF806B3860CE270F9D93D0BD,11531,21,23,2,34,49,1749
33257,33257,558AEDA0354D38416F35BBE95686ABB4,11001,0,1,1,42,47,2147
33258,33258,558AEDA0354D38416F35BBE95686ABB4,13941,1,6,5,41,47,2097
33259,33259,558AEDA0354D38416F35BBE95686ABB4,10107,11,12,1,38,49,1949
33260,33260,558AEDA0354D38416F35BBE95686ABB4,11001,18,19,1,42,47,2147
33261,33261,558AEDA0354D38416F35BBE95686ABB4,13941,21,22,1,41,47,2097
33262,33262,CB51EA3DFBAD71C46F446085843381F3,43121,10,12,2,25,27,1277
33263,33263,CB51EA3DFBAD71C46F446085843381F3,15391,15,17,2,35,26,1776
33264,33264,CB51EA3DFBAD71C46F446085843381F3,43121,20,22,2,25,27,1277
33268,33268,D4CF3029D8323BAC4825498E0DB09BA7,11021,0,1,1,36,49,1849
33269,33269,D4CF3029D8323BAC4825498E0DB09BA7,10781,2,13,11,35,47,1797
33270,33270,D4CF3029D8323BAC4825498E0DB09BA7,10731,15,16,1,33,47,1697
33271,33271,D4CF3029D8323BAC4825498E0DB09BA7,10781,21,23,2,35,47,1797
33272,33272,6561265EB655B8B0AF69E03674D76359,11861,0,9,9,32,47,1647
33273,33273,6561265EB655B8B0AF69E03674D76359,19801,11,14,3,19,26,976
33274,33274,6561265EB655B8B0AF69E03674D76359,15181,16,18,2,26,24,1324
33275,33275,6561265EB655B8B0AF69E03674D76359,11861,21,23,2,32,47,1647
33276,33276,EC8D784C19C185B8F2C30A9ECA831652,13911,0,5,5,39,46,1996
33277,33277,EC8D784C19C185B8F2C30A9ECA831652,11261,6,8,2,36,46,1846
33278,33278,EC8D784C19C185B8F2C30A9ECA831652,13911,8,9,1,39,46,1996
33279,33279,EC8D784C19C185B8F2C30A9ECA831652,11261,10,12,2,36,46,1846
33280,33280,EC8D784C19C185B8F2C30A9ECA831652,13911,12,13,1,39,46,1996
33281,33281,EC8D784C19C185B8F2C30A9ECA831652,11261,14,15,1,36,46,1846
33282,33282,EC8D784C19C185B8F2C30A9ECA831652,13911,16,18,2,39,46,1996
33287,33287,1277ACA424D6A91D4C363B632562549C,10501,0,6,6,22,46,1146
33288,33288,1277ACA424D6A91D4C363B632562549C,10951,9,10,1,29,48,1498
33289,33289,1277ACA424D6A91D4C363B632562549C,10501,14,16,2,22,46,1146
33290,33290,1277ACA424D6A91D4C363B632562549C,12601,18,22,4,25,47,1297
33295,33295,35217EACD99DFE586FDD79C48317E8FE,13314,0,7,7,31,39,1589
33296,33296,35217EACD99DFE586FDD79C48317E8FE,12521,8,17,9,35,41,1791
33297,33297,35217EACD99DFE586FDD79C48317E8FE,13314,18,23,5,31,39,1589
33298,33298,ECC55A41DE7DF4FF6A356DE1634B0C55,19264,0,4,4,10,36,536
33299,33299,ECC55A41DE7DF4FF6A356DE1634B0C55,19261,4,6,2,6,37,337
33300,33300,ECC55A41DE7DF4FF6A356DE1634B0C55,19264,7,10,3,10,36,536
33301,33301,ECC55A41DE7DF4FF6A356DE1634B0C55,19261,14,15,1,6,37,337
33302,33302,ECC55A41DE7DF4FF6A356DE1634B0C55,19264,18,23,5,10,36,536
33303,33303,FA4F1B601227C71AFAB75D80108A9F0D,15381,0,10,10,19,21,971
33304,33304,FA4F1B601227C71AFAB75D80108A9F0D,43121,12,14,2,25,27,1277
33305,33305,FA4F1B601227C71AFAB75D80108A9F0D,15381,15,18,3,19,21,971
33306,33306,93DD2C863C5AA53C83002ED6F1D5AEBB,19031,0,1,1,1,42,92
33307,33307,93DD2C863C5AA53C83002ED6F1D5AEBB,12641,2,6,4,10,43,543
33308,33308,93DD2C863C5AA53C83002ED6F1D5AEBB,19181,7,23,16,8,40,440
33312,33312,1550936E77AB3F9D5F52AE840621A4EE,10431,0,13,13,33,49,1699
33313,33313,1550936E77AB3F9D5F52AE840621A4EE,42941,15,17,2,37,47,1897
33314,33314,1550936E77AB3F9D5F52AE840621A4EE,10691,19,21,2,33,48,1698
33315,33315,1550936E77AB3F9D5F52AE840621A4EE,10431,22,23,1,33,49,1699
33316,33316,414AA00EC00DAA3D830C87A4F3E4DD09,11861,0,10,10,32,47,1647
33317,33317,414AA00EC00DAA3D830C87A4F3E4DD09,13561,12,14,2,37,49,1899
33318,33318,414AA00EC00DAA3D830C87A4F3E4DD09,11861,19,20,1,32,47,1647
33319,33319,414AA00EC00DAA3D830C87A4F3E4DD09,10121,22,23,1,36,49,1849
33324,33324,DEF2119ECB90D4385AD1A45A0B2C7A35,43761,0,3,3,32,47,1647
33325,33325,DEF2119ECB90D4385AD1A45A0B2C7A35,42523,6,8,2,31,47,1597
33326,33326,DEF2119ECB90D4385AD1A45A0B2C7A35,43761,10,12,2,32,47,1647
33327,33327,DEF2119ECB90D4385AD1A45A0B2C7A35,42523,12,18,6,31,47,1597
33328,33328,DEF2119ECB90D4385AD1A45A0B2C7A35,43761,18,22,4,32,47,1647
33329,33329,B885E78265DACA8F21D2357388930CCE,13331,0,3,3,38,47,1947
33330,33330,B885E78265DACA8F21D2357388930CCE,42511,4,8,4,37,47,1897
33331,33331,B885E78265DACA8F21D2357388930CCE,12514,8,9,1,38,47,1947
33332,33332,B885E78265DACA8F21D2357388930CCE,11331,13,14,1,37,48,1898
33333,33333,B885E78265DACA8F21D2357388930CCE,11201,14,16,2,35,49,1799
33334,33334,B885E78265DACA8F21D2357388930CCE,41591,18,20,2,34,49,1749
33335,33335,5ADA9660158083BA681D3EABE7C6BBBF,42864,0,1,1,38,44,1944
33336,33336,5ADA9660158083BA681D3EABE7C6BBBF,11261,2,3,1,36,46,1846
33337,33337,5ADA9660158083BA681D3EABE7C6BBBF,42861,5,10,5,37,44,1894
33338,33338,5ADA9660158083BA681D3EABE7C6BBBF,11261,10,12,2,36,46,1846
33339,33339,5ADA9660158083BA681D3EABE7C6BBBF,42861,13,17,4,37,44,1894
33340,33340,5ADA9660158083BA681D3EABE7C6BBBF,11261,19,20,1,36,46,1846
33341,33341,5ADA9660158083BA681D3EABE7C6BBBF,42864,21,22,1,38,44,1944
33342,33342,0A501EA010779C8F9EB8C2F8834C3F4F,10351,0,5,5,28,45,1445
33343,33343,0A501EA010779C8F9EB8C2F8834C3F4F,10301,6,8,2,31,45,1595
33344,33344,0A501EA010779C8F9EB8C2F8834C3F4F,10634,8,9,1,27,45,1395
33345,33345,0A501EA010779C8F9EB8C2F8834C3F4F,10301,11,12,1,31,45,1595
33346,33346,0A501EA010779C8F9EB8C2F8834C3F4F,10351,14,21,7,28,45,1445
33360,33360,66F1F2D6193BB6F1096E3454F499C888,13111,0,13,13,42,46,2146
33361,33361,66F1F2D6193BB6F1096E3454F499C888,43731,15,17,2,34,47,1747
33362,33362,66F1F2D6193BB6F1096E3454F499C888,10251,18,20,2,35,47,1797
33366,33366,92AA74C025DCC8E1B6F69E40B85D2713,43971,0,7,7,30,48,1548
33367,33367,92AA74C025DCC8E1B6F69E40B85D2713,11074,9,19,10,37,47,1897
33368,33368,92AA74C025DCC8E1B6F69E40B85D2713,42521,19,21,2,31,47,1597
33369,33369,189C54EA37D8896B78DBF80EEA026F2F,19901,0,1,1,7,44,394
33370,33370,189C54EA37D8896B78DBF80EEA026F2F,12641,2,7,5,10,43,543
33371,33371,189C54EA37D8896B78DBF80EEA026F2F,43644,9,10,1,14,38,738
33372,33372,189C54EA37D8896B78DBF80EEA026F2F,19931,11,18,7,7,43,393
33373,33373,189C54EA37D8896B78DBF80EEA026F2F,19901,21,23,2,7,44,394
33374,33374,23B993E372590302320AD46630AF2C76,12792,0,3,3,34,30,1730
33375,33375,23B993E372590302320AD46630AF2C76,15411,8,16,8,44,27,2227
33376,33376,23B993E372590302320AD46630AF2C76,12792,19,23,4,34,30,1730
33377,33377,D5A1F589AD5A8A456E0D23A90489837D,43761,1,5,4,32,47,1647
33378,33378,D5A1F589AD5A8A456E0D23A90489837D,11231,8,16,8,37,49,1899
33379,33379,D5A1F589AD5A8A456E0D23A90489837D,43761,19,21,2,32,47,1647
33383,33383,891C63A7FCD795A9067DDBCBE0342E42,42351,0,8,8,38,45,1945
33384,33384,891C63A7FCD795A9067DDBCBE0342E42,43234,9,14,5,37,49,1899
33385,33385,891C63A7FCD795A9067DDBCBE0342E42,43731,19,20,1,34,47,1747
33394,33394,E6FF42AEECF0CDA6C42BDBDEFD456416,13951,0,7,7,47,45,2395
33395,33395,E6FF42AEECF0CDA6C42BDBDEFD456416,43951,8,17,9,49,41,2491
33396,33396,E6FF42AEECF0CDA6C42BDBDEFD456416,40171,22,23,1,38,48,1948
33397,33397,09DFCEC539690419D4B049069A90B969,13651,0,16,16,30,47,1547
33398,33398,09DFCEC539690419D4B049069A90B969,42621,17,18,1,24,49,1249
33399,33399,09DFCEC539690419D4B049069A90B969,13651,21,23,2,30,47,1547
33400,33400,AA2A20597DFD0E4B45B17F38082C4AFA,19031,0,5,5,1,42,92
33401,33401,AA2A20597DFD0E4B45B17F38082C4AFA,12921,9,10,1,9,41,491
33402,33402,AA2A20597DFD0E4B45B17F38082C4AFA,19244,15,16,1,1,43,93
33403,33403,AA2A20597DFD0E4B45B17F38082C4AFA,12641,17,19,2,10,43,543
33407,33407,D7833B9581E82789849A40F9D4093BF8,12121,7,12,5,29,47,1497
33408,33408,D7833B9581E82789849A40F9D4093BF8,11381,14,18,4,30,47,1547
33409,33409,D7833B9581E82789849A40F9D4093BF8,11631,21,22,1,12,49,649
33416,33416,2808B465D0CA5BE626B66BA705E41B68,13231,0,3,3,39,46,1996
33417,33417,2808B465D0CA5BE626B66BA705E41B68,42351,4,6,2,38,45,1945
33418,33418,2808B465D0CA5BE626B66BA705E41B68,42864,7,18,11,38,44,1944
33419,33419,2808B465D0CA5BE626B66BA705E41B68,42351,19,20,1,38,45,1945
33420,33420,2808B465D0CA5BE626B66BA705E41B68,11261,22,23,1,36,46,1846
33421,33421,60EA8BA3C68F73C05BC0A731CC76BB3C,43341,0,9,9,41,46,2096
33422,33422,60EA8BA3C68F73C05BC0A731CC76BB3C,12971,9,12,3,32,48,1648
33423,33423,60EA8BA3C68F73C05BC0A731CC76BB3C,11481,13,14,1,41,48,2098
33424,33424,60EA8BA3C68F73C05BC0A731CC76BB3C,40801,15,19,4,43,46,2196
33425,33425,60EA8BA3C68F73C05BC0A731CC76BB3C,13271,20,22,2,41,47,2097
33426,33426,325394BE7E2327589A3095D8D54DE233,13601,0,5,5,34,47,1747
33427,33427,325394BE7E2327589A3095D8D54DE233,42161,6,7,1,36,47,1847
33428,33428,325394BE7E2327589A3095D8D54DE233,10881,10,12,2,34,48,1748
33429,33429,325394BE7E2327589A3095D8D54DE233,10221,18,19,1,34,49,1749
33430,33430,325394BE7E2327589A3095D8D54DE233,40411,20,22,2,34,48,1748
33438,33438,C39D91BF2E280FFDBCE9EECBDA2DD536,11551,1,9,8,39,49,1999
33439,33439,C39D91BF2E280FFDBCE9EECBDA2DD536,42621,13,15,2,24,49,1249
33440,33440,C39D91BF2E280FFDBCE9EECBDA2DD536,40341,16,19,3,23,49,1199
33448,33448,D01B29B4F49282632E2D608AA5299A7E,42381,0,6,6,39,41,1991
33449,33449,D01B29B4F49282632E2D608AA5299A7E,42151,7,18,11,35,45,1795
33450,33450,D01B29B4F49282632E2D608AA5299A7E,42381,20,23,3,39,41,1991
33451,33451,3C5BF8354C7B22C00BFA5438C070BC0F,13711,0,7,7,38,46,1946
33452,33452,3C5BF8354C7B22C00BFA5438C070BC0F,43241,7,11,4,36,46,1846
33453,33453,3C5BF8354C7B22C00BFA5438C070BC0F,13711,12,14,2,38,46,1946
33454,33454,3C5BF8354C7B22C00BFA5438C070BC0F,43241,14,18,4,36,46,1846
33455,33455,3C5BF8354C7B22C00BFA5438C070BC0F,13711,19,22,3,38,46,1946
33456,33456,FF54487E0B5C80FA4088AB1638FB8194,43181,1,2,1,39,48,1998
33457,33457,FF54487E0B5C80FA4088AB1638FB8194,42581,5,10,5,38,48,1948
33458,33458,FF54487E0B5C80FA4088AB1638FB8194,11914,10,15,5,37,48,1898
33459,33459,FF54487E0B5C80FA4088AB1638FB8194,42581,15,16,1,38,48,1948
33460,33460,FF54487E0B5C80FA4088AB1638FB8194,11914,20,22,2,37,48,1898
33461,33461,EEBDA7E158BB4E61F70D4E677CB3B98B,12651,4,6,2,43,47,2197
33462,33462,EEBDA7E158BB4E61F70D4E677CB3B98B,43621,7,8,1,46,48,2348
33463,33463,EEBDA7E158BB4E61F70D4E677CB3B98B,12651,13,16,3,43,47,2197
33464,33464,EEBDA7E158BB4E61F70D4E677CB3B98B,40171,20,22,2,38,48,1948
33475,33475,77005C31B950B4D388791DB384438A22,10111,0,9,9,37,47,1897
33476,33476,77005C31B950B4D388791DB384438A22,42321,11,12,1,43,47,2197
33477,33477,77005C31B950B4D388791DB384438A22,42161,16,18,2,36,47,1847
33478,33478,77005C31B950B4D388791DB384438A22,10111,18,23,5,37,47,1897
33488,33488,EA7259828C59286A0C8476F89AAE54B8,11261,0,12,12,36,46,1846
33489,33489,EA7259828C59286A0C8476F89AAE54B8,12311,12,13,1,30,44,1544
33490,33490,EA7259828C59286A0C8476F89AAE54B8,11261,13,18,5,36,46,1846
33491,33491,0A4DEAAE87BBCD0C04DEB057F69A322D,11381,0,9,9,30,47,1547
33492,33492,0A4DEAAE87BBCD0C04DEB057F69A322D,10251,10,11,1,35,47,1797
33493,33493,0A4DEAAE87BBCD0C04DEB057F69A322D,11381,14,16,2,30,47,1547
33494,33494,0A4DEAAE87BBCD0C04DEB057F69A322D,42581,20,21,1,38,48,1948
33495,33495,0A4DEAAE87BBCD0C04DEB057F69A322D,11381,22,23,1,30,47,1547
33496,33496,6B301C33659FC7DDF1FEBEFD22E1FEA8,11901,0,10,10,42,49,2149
33497,33497,6B301C33659FC7DDF1FEBEFD22E1FEA8,43761,11,20,9,32,47,1647
33498,33498,6B301C33659FC7DDF1FEBEFD22E1FEA8,42931,22,23,1,41,49,2099
33499,33499,3E43826B2F3C90E1974FF5F797EBAA40,42581,0,6,6,38,48,1948
33500,33500,3E43826B2F3C90E1974FF5F797EBAA40,13731,10,16,6,33,49,1699
33501,33501,3E43826B2F3C90E1974FF5F797EBAA40,11914,19,21,2,37,48,1898
33502,33502,09111B635170EC4072310ADB48522169,11021,1,8,7,36,49,1849
33503,33503,09111B635170EC4072310ADB48522169,10221,12,13,1,34,49,1749
33504,33504,09111B635170EC4072310ADB48522169,11021,14,19,5,36,49,1849
33505,33505,09111B635170EC4072310ADB48522169,11861,20,22,2,32,47,1647
33512,33512,F294DDD245042E94D549E953AEE33CE4,19111,0,6,6,9,45,495
33513,33513,F294DDD245042E94D549E953AEE33CE4,12921,7,9,2,9,41,491
33514,33514,F294DDD245042E94D549E953AEE33CE4,19111,10,14,4,9,45,495
33515,33515,F294DDD245042E94D549E953AEE33CE4,19621,15,20,5,5,46,296
33531,33531,A5A342C5B79B8AEE00BA80AE678B8EC5,10331,0,8,8,39,46,1996
33532,33532,A5A342C5B79B8AEE00BA80AE678B8EC5,11151,8,11,3,30,48,1548
33533,33533,A5A342C5B79B8AEE00BA80AE678B8EC5,10331,13,14,1,39,46,1996
33534,33534,A5A342C5B79B8AEE00BA80AE678B8EC5,11151,16,18,2,30,48,1548
33535,33535,A5A342C5B79B8AEE00BA80AE678B8EC5,10331,19,23,4,39,46,1996
33536,33536,6DFBF28C4BB1FC2BFED5E053C4C14307,43581,0,6,6,33,48,1698
33537,33537,6DFBF28C4BB1FC2BFED5E053C4C14307,19441,7,9,2,8,46,446
33538,33538,6DFBF28C4BB1FC2BFED5E053C4C14307,43581,14,23,9,33,48,1698
33542,33542,1A6A180FC1652CDA8F079E8572A81E38,42501,0,6,6,28,47,1447
33543,33543,1A6A180FC1652CDA8F079E8572A81E38,11231,8,17,9,37,49,1899
33544,33544,1A6A180FC1652CDA8F079E8572A81E38,12121,19,23,4,29,47,1497
33551,33551,48BFDAC45FFDDC1EE0721263D1AD77D7,10841,0,6,6,37,47,1897
33552,33552,48BFDAC45FFDDC1EE0721263D1AD77D7,10251,10,11,1,35,47,1797
33553,33553,48BFDAC45FFDDC1EE0721263D1AD77D7,10841,11,14,3,37,47,1897
33554,33554,48BFDAC45FFDDC1EE0721263D1AD77D7,10251,14,17,3,35,47,1797
33555,33555,48BFDAC45FFDDC1EE0721263D1AD77D7,10841,19,22,3,37,47,1897
33565,33565,9467C00340FDB6745E40F052A8816117,13791,0,15,15,42,47,2147
33566,33566,9467C00340FDB6745E40F052A8816117,43341,16,18,2,41,46,2096
33567,33567,9467C00340FDB6745E40F052A8816117,12481,20,22,2,37,49,1899
33582,33582,FB55B20B748C0A1CF26B4BE2B509424A,12761,0,6,6,25,40,1290
33583,33583,FB55B20B748C0A1CF26B4BE2B509424A,13671,7,9,2,27,43,1393
33584,33584,FB55B20B748C0A1CF26B4BE2B509424A,12731,12,13,1,22,40,1140
33585,33585,FB55B20B748C0A1CF26B4BE2B509424A,13671,14,15,1,27,43,1393
33586,33586,FB55B20B748C0A1CF26B4BE2B509424A,12761,20,23,3,25,40,1290
33587,33587,755A1FA6C962DCA1F0C6C27EDC12A160,13371,0,13,13,41,47,2097
33588,33588,755A1FA6C962DCA1F0C6C27EDC12A160,11541,13,16,3,35,49,1799
33589,33589,755A1FA6C962DCA1F0C6C27EDC12A160,13371,17,18,1,41,47,2097
33590,33590,755A1FA6C962DCA1F0C6C27EDC12A160,40697,19,21,2,43,48,2198
33591,33591,755A1FA6C962DCA1F0C6C27EDC12A160,13371,21,23,2,41,47,2097
33592,33592,117FA329666C41D6B88EB4542F2C9FDD,42281,0,7,7,40,48,2048
33593,33593,117FA329666C41D6B88EB4542F2C9FDD,11021,11,17,6,36,49,1849
33594,33594,117FA329666C41D6B88EB4542F2C9FDD,42281,19,23,4,40,48,2048
33601,33601,3FBA130DE96D19DDB92B7C1710211CF0,10611,0,7,7,32,48,1648
33602,33602,3FBA130DE96D19DDB92B7C1710211CF0,10251,7,12,5,35,47,1797
33603,33603,3FBA130DE96D19DDB92B7C1710211CF0,10611,13,14,1,32,48,1648
33604,33604,3FBA130DE96D19DDB92B7C1710211CF0,10251,14,17,3,35,47,1797
33605,33605,3FBA130DE96D19DDB92B7C1710211CF0,43731,18,19,1,34,47,1747
33606,33606,3FBA130DE96D19DDB92B7C1710211CF0,10611,20,23,3,32,48,1648
33607,33607,429BCEDAA6EBE91D7B110F54D2914EBB,13371,0,15,15,41,47,2097
33608,33608,429BCEDAA6EBE91D7B110F54D2914EBB,11061,17,18,1,29,48,1498
33609,33609,429BCEDAA6EBE91D7B110F54D2914EBB,13371,19,21,2,41,47,2097
33610,33610,429BCEDAA6EBE91D7B110F54D2914EBB,42031,21,22,1,40,46,2046
33614,33614,5B38B567B1C7BA8CD66BEFDF9C575D7A,12083,1,16,15,36,49,1849
33615,33615,5B38B567B1C7BA8CD66BEFDF9C575D7A,11151,17,19,2,30,48,1548
33616,33616,5B38B567B1C7BA8CD66BEFDF9C575D7A,12083,20,23,3,36,49,1849
33634,33634,03A91EC93647A8BA652DF6ED44DA5BB9,11161,1,3,2,32,48,1648
33635,33635,03A91EC93647A8BA652DF6ED44DA5BB9,42141,3,8,5,32,47,1647
33636,33636,03A91EC93647A8BA652DF6ED44DA5BB9,10491,12,17,5,33,48,1698
33637,33637,03A91EC93647A8BA652DF6ED44DA5BB9,40341,18,19,1,23,49,1199
33638,33638,03A91EC93647A8BA652DF6ED44DA5BB9,42141,22,23,1,32,47,1647
33648,33648,9B628FEA6BCA8EB97BB3F7B5F63CD306,13911,0,6,6,39,46,1996
33649,33649,9B628FEA6BCA8EB97BB3F7B5F63CD306,12731,9,10,1,22,40,1140
33650,33650,9B628FEA6BCA8EB97BB3F7B5F63CD306,10351,12,13,1,28,45,1445
33651,33651,9B628FEA6BCA8EB97BB3F7B5F63CD306,13911,19,23,4,39,46,1996
33652,33652,D1D02DF9C1212407C948C37939001BC3,13671,0,5,5,27,43,1393
33653,33653,D1D02DF9C1212407C948C37939001BC3,42531,6,21,15,31,45,1595
33654,33654,D1D02DF9C1212407C948C37939001BC3,13671,21,22,1,27,43,1393
33655,33655,9FC853D14B199D9AE09B3905110E90BD,12514,0,8,8,38,47,1947
33656,33656,9FC853D14B199D9AE09B3905110E90BD,42221,8,10,2,38,48,1948
33657,33657,9FC853D14B199D9AE09B3905110E90BD,12514,11,13,2,38,47,1947
33658,33658,9FC853D14B199D9AE09B3905110E90BD,42221,13,17,4,38,48,1948
33659,33659,9FC853D14B199D9AE09B3905110E90BD,12514,21,22,1,38,47,1947
33660,33660,019BFAC27AFC4F2F208CAEF58F73A0A2,10471,0,8,8,37,48,1898
33661,33661,019BFAC27AFC4F2F208CAEF58F73A0A2,11231,10,16,6,37,49,1899
33662,33662,019BFAC27AFC4F2F208CAEF58F73A0A2,11631,20,23,3,12,49,649
33663,33663,5FB7FCDE8733B3DE0082FB61D42FC13D,13941,0,1,1,41,47,2097
33664,33664,5FB7FCDE8733B3DE0082FB61D42FC13D,11001,3,4,1,42,47,2147
33665,33665,5FB7FCDE8733B3DE0082FB61D42FC13D,42321,8,14,6,43,47,2197
33666,33666,5FB7FCDE8733B3DE0082FB61D42FC13D,13821,15,16,1,49,45,2495
33667,33667,5FB7FCDE8733B3DE0082FB61D42FC13D,42321,17,21,4,43,47,2197
33668,33668,5FB7FCDE8733B3DE0082FB61D42FC13D,13371,22,23,1,41,47,2097
33684,33684,0576900C4D0FA559C4C3ACF6E9F4048D,43341,0,8,8,41,46,2096
33685,33685,0576900C4D0FA559C4C3ACF6E9F4048D,11271,11,13,2,37,48,1898
33686,33686,0576900C4D0FA559C4C3ACF6E9F4048D,12381,14,15,1,32,48,1648
33687,33687,0576900C4D0FA559C4C3ACF6E9F4048D,40073,18,21,3,37,48,1898
33694,33694,ECBC886277109C0582E65AB313F27C1C,13314,0,6,6,31,39,1589
33695,33695,ECBC886277109C0582E65AB313F27C1C,12521,10,18,8,35,41,1791
33696,33696,ECBC886277109C0582E65AB313F27C1C,13314,22,23,1,31,39,1589
33707,33707,C493E8EAD829832CA31397E82BE4990B,43021,0,13,13,16,43,843
33708,33708,C493E8EAD829832CA31397E82BE4990B,12921,15,16,1,9,41,491
33709,33709,C493E8EAD829832CA31397E82BE4990B,12641,16,17,1,10,43,543
33710,33710,C493E8EAD829832CA31397E82BE4990B,43021,20,23,3,16,43,843
33714,33714,6164F469738A30A14CD373EB73D02471,11801,0,14,14,42,48,2148
33715,33715,6164F469738A30A14CD373EB73D02471,10401,17,20,3,33,49,1699
33716,33716,6164F469738A30A14CD373EB73D02471,11801,20,23,3,42,48,2148
33730,33730,5ECDAA2EB4652040809B2B1EAC7A3195,10251,0,6,6,35,47,1797
33731,33731,5ECDAA2EB4652040809B2B1EAC7A3195,11271,9,14,5,37,48,1898
33732,33732,5ECDAA2EB4652040809B2B1EAC7A3195,13331,15,16,1,38,47,1947
33733,33733,5ECDAA2EB4652040809B2B1EAC7A3195,40171,19,21,2,38,48,1948
33734,33734,5ECDAA2EB4652040809B2B1EAC7A3195,11811,22,23,1,38,49,1949
33735,33735,508DF001F529FBF83DF8D4A342350BFA,42861,3,4,1,37,44,1894
33736,33736,508DF001F529FBF83DF8D4A342350BFA,11261,8,10,2,36,46,1846
33737,33737,508DF001F529FBF83DF8D4A342350BFA,42861,12,13,1,37,44,1894
33738,33738,508DF001F529FBF83DF8D4A342350BFA,11261,17,19,2,36,46,1846
33739,33739,508DF001F529FBF83DF8D4A342350BFA,42861,19,20,1,37,44,1894
33740,33740,52ACC485A3B15823424685D0F282776F,10841,3,6,3,37,47,1897
33741,33741,52ACC485A3B15823424685D0F282776F,10781,11,18,7,35,47,1797
33742,33742,52ACC485A3B15823424685D0F282776F,42321,19,20,1,43,47,2197
33743,33743,52ACC485A3B15823424685D0F282776F,11231,21,23,2,37,49,1899
33747,33747,BC3DA9BAF9B0A0C935A79D91ECBDA067,19441,1,6,5,8,46,446
33748,33748,BC3DA9BAF9B0A0C935A79D91ECBDA067,42041,7,10,3,10,47,547
33749,33749,BC3DA9BAF9B0A0C935A79D91ECBDA067,19441,10,13,3,8,46,446
33750,33750,BC3DA9BAF9B0A0C935A79D91ECBDA067,42041,14,17,3,10,47,547
33751,33751,BC3DA9BAF9B0A0C935A79D91ECBDA067,19901,21,22,1,7,44,394
33756,33756,1DA79481C6B6D1D9223A378A0D81757A,10111,0,8,8,37,47,1897
33757,33757,1DA79481C6B6D1D9223A378A0D81757A,11211,9,17,8,34,49,1749
33758,33758,1DA79481C6B6D1D9223A378A0D81757A,10111,18,19,1,37,47,1897
33759,33759,1DA79481C6B6D1D9223A378A0D81757A,42401,22,23,1,36,47,1847
33775,33775,C5ED324891B8B95E257970408E8D4150,12491,0,6,6,36,43,1843
33776,33776,C5ED324891B8B95E257970408E8D4150,13911,6,7,1,39,46,1996
33777,33777,C5ED324891B8B95E257970408E8D4150,12491,8,10,2,36,43,1843
33778,33778,C5ED324891B8B95E257970408E8D4150,11261,13,21,8,36,46,1846
33779,33779,CAF83309DC5164BDCFC4AF3B395E1D5C,10841,0,9,9,37,47,1897
33780,33780,CAF83309DC5164BDCFC4AF3B395E1D5C,10161,11,14,3,35,49,1799
33781,33781,CAF83309DC5164BDCFC4AF3B395E1D5C,10841,15,16,1,37,47,1897
33782,33782,CAF83309DC5164BDCFC4AF3B395E1D5C,10161,19,21,2,35,49,1799
33783,33783,CAF83309DC5164BDCFC4AF3B395E1D5C,11861,21,22,1,32,47,1647
33784,33784,055392723CC93B49A610878855A95D5B,11471,4,5,1,12,48,648
33785,33785,055392723CC93B49A610878855A95D5B,19441,5,19,14,8,46,446
33786,33786,055392723CC93B49A610878855A95D5B,11471,21,23,2,12,48,648
33790,33790,50AD8ACDABF8BBC007C0D64420D91B51,11861,0,7,7,32,47,1647
33791,33791,50AD8ACDABF8BBC007C0D64420D91B51,12381,8,11,3,32,48,1648
33792,33792,50AD8ACDABF8BBC007C0D64420D91B51,11861,12,15,3,32,47,1647
33793,33793,50AD8ACDABF8BBC007C0D64420D91B51,12381,15,17,2,32,48,1648
33794,33794,50AD8ACDABF8BBC007C0D64420D91B51,11861,19,23,4,32,47,1647
33795,33795,3F2FE95AB24E5E71D935604E5158C97B,41392,0,8,8,43,48,2198
33796,33796,3F2FE95AB24E5E71D935604E5158C97B,42271,10,11,1,40,47,2047
33797,33797,3F2FE95AB24E5E71D935604E5158C97B,41392,12,15,3,43,48,2198
33798,33798,3F2FE95AB24E5E71D935604E5158C97B,11941,16,17,1,37,46,1896
33799,33799,3F2FE95AB24E5E71D935604E5158C97B,11301,18,19,1,41,49,2099
33800,33800,3F2FE95AB24E5E71D935604E5158C97B,42161,20,23,3,36,47,1847
33804,33804,D3E46B15B35DC3C198E6EE945D227259,11806,0,5,5,41,48,2098
33805,33805,D3E46B15B35DC3C198E6EE945D227259,43481,6,9,3,39,48,1998
33806,33806,D3E46B15B35DC3C198E6EE945D227259,13381,9,11,2,39,47,1997
33807,33807,D3E46B15B35DC3C198E6EE945D227259,11806,12,14,2,41,48,2098
33808,33808,D3E46B15B35DC3C198E6EE945D227259,11641,15,17,2,22,49,1149
33809,33809,D3E46B15B35DC3C198E6EE945D227259,42271,18,22,4,40,47,2047
33814,33814,BA285F01E6926591864F1F3184565800,42581,0,7,7,38,48,1948
33815,33815,BA285F01E6926591864F1F3184565800,11914,7,11,4,37,48,1898
33816,33816,BA285F01E6926591864F1F3184565800,42581,11,12,1,38,48,1948
33817,33817,BA285F01E6926591864F1F3184565800,40341,15,18,3,23,49,1199
33818,33818,BA285F01E6926591864F1F3184565800,42581,21,22,1,38,48,1948
33826,33826,70E50AA138C0538910E5623295B506D8,42351,2,7,5,38,45,1945
33827,33827,70E50AA138C0538910E5623295B506D8,13911,7,11,4,39,46,1996
33828,33828,70E50AA138C0538910E5623295B506D8,42351,12,14,2,38,45,1945
33829,33829,70E50AA138C0538910E5623295B506D8,11261,17,18,1,36,46,1846
33830,33830,70E50AA138C0538910E5623295B506D8,42351,18,20,2,38,45,1945
33831,33831,E51EE41655D386174398555E16D6604B,11171,0,7,7,33,48,1698
33832,33832,E51EE41655D386174398555E16D6604B,10661,12,17,5,37,49,1899
33833,33833,E51EE41655D386174398555E16D6604B,42541,20,21,1,25,47,1297
33834,33834,4FAD8B8BFEF35D4436F0EB07D5139D88,13371,0,9,9,41,47,2097
33835,33835,4FAD8B8BFEF35D4436F0EB07D5139D88,19401,11,12,1,7,30,380
33836,33836,4FAD8B8BFEF35D4436F0EB07D5139D88,13371,13,22,9,41,47,2097
33841,33841,C6DF57F9AD220FA45128DF32BD0D316B,10881,0,10,10,34,48,1748
33842,33842,C6DF57F9AD220FA45128DF32BD0D316B,11061,13,15,2,29,48,1498
33843,33843,C6DF57F9AD220FA45128DF32BD0D316B,10881,15,23,8,34,48,1748
33844,33844,8F0DB5319866C8E59D99F7AC9A3D3B2B,10661,0,8,8,37,49,1899
33845,33845,8F0DB5319866C8E59D99F7AC9A3D3B2B,11801,10,12,2,42,48,2148
33846,33846,8F0DB5319866C8E59D99F7AC9A3D3B2B,10661,17,23,6,37,49,1899
33847,33847,15AF53FBA0C13FBD61024895398ED2FD,11471,0,1,1,12,48,648
33848,33848,15AF53FBA0C13FBD61024895398ED2FD,42041,5,10,5,10,47,547
33849,33849,15AF53FBA0C13FBD61024895398ED2FD,19441,10,17,7,8,46,446
33850,33850,15AF53FBA0C13FBD61024895398ED2FD,42041,18,19,1,10,47,547
33851,33851,15AF53FBA0C13FBD61024895398ED2FD,19441,20,21,1,8,46,446
33864,33864,A8928928ADC91E39B694E056FF7A2E01,42271,0,8,8,40,47,2047
33865,33865,A8928928ADC91E39B694E056FF7A2E01,42941,10,11,1,37,47,1897
33866,33866,A8928928ADC91E39B694E056FF7A2E01,11331,12,13,1,37,48,1898
33867,33867,A8928928ADC91E39B694E056FF7A2E01,42941,14,19,5,37,47,1897
33868,33868,A8928928ADC91E39B694E056FF7A2E01,42271,22,23,1,40,47,2047
33873,33873,339C318AF31D2161E3FA2AD4986D9B89,10411,7,10,3,36,48,1848
33874,33874,339C318AF31D2161E3FA2AD4986D9B89,10221,15,17,2,34,49,1749
33875,33875,339C318AF31D2161E3FA2AD4986D9B89,40302,18,22,4,40,49,2049
33876,33876,5934F23DBC87E0A312C26B502942AF2F,11261,9,10,1,36,46,1846
33877,33877,5934F23DBC87E0A312C26B502942AF2F,42351,11,12,1,38,45,1945
33878,33878,5934F23DBC87E0A312C26B502942AF2F,11771,15,22,7,39,49,1999
33882,33882,A6FD529C3EA66C1845775EA07FC46A8F,12581,1,5,4,24,48,1248
33883,33883,A6FD529C3EA66C1845775EA07FC46A8F,12601,5,13,8,25,47,1297
33884,33884,A6FD529C3EA66C1845775EA07FC46A8F,12051,15,16,1,20,47,1047
33885,33885,A6FD529C3EA66C1845775EA07FC46A8F,12601,17,22,5,25,47,1297
33896,33896,9B8E3A84EF821A3E9564A6D6EAEA0FE5,11914,0,1,1,37,48,1898
33897,33897,9B8E3A84EF821A3E9564A6D6EAEA0FE5,42581,1,5,4,38,48,1948
33898,33898,9B8E3A84EF821A3E9564A6D6EAEA0FE5,11914,7,8,1,37,48,1898
33899,33899,9B8E3A84EF821A3E9564A6D6EAEA0FE5,42581,13,14,1,38,48,1948
33900,33900,9B8E3A84EF821A3E9564A6D6EAEA0FE5,11914,14,22,8,37,48,1898
33904,33904,5983009455C3652429C1D94097232D58,11074,1,5,4,37,47,1897
33905,33905,5983009455C3652429C1D94097232D58,43581,9,10,1,33,48,1698
33906,33906,5983009455C3652429C1D94097232D58,11074,12,22,10,37,47,1897
33910,33910,5B302590863E0C5DC94B2AFDBAD75C42,12131,0,12,12,32,47,1647
33911,33911,5B302590863E0C5DC94B2AFDBAD75C42,11271,14,16,2,37,48,1898
33912,33912,5B302590863E0C5DC94B2AFDBAD75C42,10221,20,21,1,34,49,1749
33913,33913,45D6DC753A70E5EDE4E9A4A90E8F23A4,43061,0,7,7,43,46,2196
33914,33914,45D6DC753A70E5EDE4E9A4A90E8F23A4,12391,9,11,2,36,49,1849
33915,33915,45D6DC753A70E5EDE4E9A4A90E8F23A4,43061,14,23,9,43,46,2196
33925,33925,32EC0F36441544FE0077B62E357B89B9,12921,0,3,3,9,41,491
33926,33926,32EC0F36441544FE0077B62E357B89B9,43021,4,5,1,16,43,843
33927,33927,32EC0F36441544FE0077B62E357B89B9,12921,6,23,17,9,41,491
33928,33928,2E18E8DF093288689E2805A1F3FB2A40,12921,2,6,4,9,41,491
33929,33929,2E18E8DF093288689E2805A1F3FB2A40,12641,6,14,8,10,43,543
33930,33930,2E18E8DF093288689E2805A1F3FB2A40,40341,15,17,2,23,49,1199
33931,33931,2E18E8DF093288689E2805A1F3FB2A40,10221,18,20,2,34,49,1749
33932,33932,2E18E8DF093288689E2805A1F3FB2A40,12921,21,23,2,9,41,491
33933,33933,71CDB42BF8ABF4C8B89BDC81F92C39B7,10634,0,5,5,27,45,1395
33934,33934,71CDB42BF8ABF4C8B89BDC81F92C39B7,12311,7,8,1,30,44,1544
33935,33935,71CDB42BF8ABF4C8B89BDC81F92C39B7,12601,9,10,1,25,47,1297
33936,33936,71CDB42BF8ABF4C8B89BDC81F92C39B7,10634,12,13,1,27,45,1395
33937,33937,71CDB42BF8ABF4C8B89BDC81F92C39B7,12601,15,16,1,25,47,1297
33938,33938,71CDB42BF8ABF4C8B89BDC81F92C39B7,10634,20,21,1,27,45,1395
33942,33942,F9BB7DF37B85A58B4DA3F92DEFB1BE52,10721,0,16,16,31,48,1598
33943,33943,F9BB7DF37B85A58B4DA3F92DEFB1BE52,40171,17,18,1,38,48,1948
33944,33944,F9BB7DF37B85A58B4DA3F92DEFB1BE52,11151,18,20,2,30,48,1548
33945,33945,F9BB7DF37B85A58B4DA3F92DEFB1BE52,40341,21,22,1,23,49,1199
33949,33949,5E8BB1A9FDE1AFD08848003FB8A60E0E,40673,0,8,8,36,48,1848
33950,33950,5E8BB1A9FDE1AFD08848003FB8A60E0E,10971,8,12,4,35,47,1797
33951,33951,5E8BB1A9FDE1AFD08848003FB8A60E0E,10411,13,14,1,36,48,1848
33952,33952,5E8BB1A9FDE1AFD08848003FB8A60E0E,10971,15,17,2,35,47,1797
33953,33953,5E8BB1A9FDE1AFD08848003FB8A60E0E,40673,19,23,4,36,48,1848
33957,33957,0004E9A02B9F97024FE46D8B36381EE9,10801,1,6,5,42,47,2147
33958,33958,0004E9A02B9F97024FE46D8B36381EE9,13951,7,9,2,47,45,2395
33959,33959,0004E9A02B9F97024FE46D8B36381EE9,13911,12,13,1,39,46,1996
33960,33960,0004E9A02B9F97024FE46D8B36381EE9,19021,15,18,3,10,45,545
33961,33961,0004E9A02B9F97024FE46D8B36381EE9,42521,19,20,1,31,47,1597
33962,33962,0004E9A02B9F97024FE46D8B36381EE9,43021,22,23,1,16,43,843
33966,33966,7BD5666208D4C4EF90CAAD8A97E6ED7C,42151,2,6,4,35,45,1795
33967,33967,7BD5666208D4C4EF90CAAD8A97E6ED7C,13671,8,17,9,27,43,1393
33968,33968,7BD5666208D4C4EF90CAAD8A97E6ED7C,12491,21,23,2,36,43,1843
33976,33976,4FB7544A1E67AE742452DB3735E5F7CF,10771,0,1,1,41,46,2096
33977,33977,4FB7544A1E67AE742452DB3735E5F7CF,11001,2,3,1,42,47,2147
33978,33978,4FB7544A1E67AE742452DB3735E5F7CF,12561,8,9,1,45,43,2293
33979,33979,4FB7544A1E67AE742452DB3735E5F7CF,11001,19,20,1,42,47,2147
33980,33980,4FB7544A1E67AE742452DB3735E5F7CF,13111,21,22,1,42,46,2146
33981,33981,445A90121514A82FCCD431DD3088A581,42021,2,4,2,33,47,1697
33982,33982,445A90121514A82FCCD431DD3088A581,43731,6,7,1,34,47,1747
33983,33983,445A90121514A82FCCD431DD3088A581,43161,8,9,1,35,47,1797
33984,33984,445A90121514A82FCCD431DD3088A581,11861,13,18,5,32,47,1647
33985,33985,445A90121514A82FCCD431DD3088A581,43731,21,22,1,34,47,1747
33986,33986,15B4B2807EF132F03A4FFF7B638F630B,11281,5,7,2,27,40,1390
33987,33987,15B4B2807EF132F03A4FFF7B638F630B,13091,11,12,1,20,42,1042
33988,33988,15B4B2807EF132F03A4FFF7B638F630B,12731,13,19,6,22,40,1140
34003,34003,44CFFC276A65F95BE03A7F0CD0EA65D0,43761,0,6,6,32,47,1647
34004,34004,44CFFC276A65F95BE03A7F0CD0EA65D0,10371,8,18,10,37,49,1899
34005,34005,44CFFC276A65F95BE03A7F0CD0EA65D0,43761,19,22,3,32,47,1647
34013,34013,2ACA8D6D72EC3C4F1023E70AD8A81BBE,10501,4,5,1,22,46,1146
34014,34014,2ACA8D6D72EC3C4F1023E70AD8A81BBE,10061,6,7,1,20,46,1046
34015,34015,2ACA8D6D72EC3C4F1023E70AD8A81BBE,10501,8,12,4,22,46,1146
34016,34016,2ACA8D6D72EC3C4F1023E70AD8A81BBE,12601,14,15,1,25,47,1297
34017,34017,2ACA8D6D72EC3C4F1023E70AD8A81BBE,10061,19,20,1,20,46,1046
34018,34018,2ACA8D6D72EC3C4F1023E70AD8A81BBE,10634,22,23,1,27,45,1395
34022,34022,02985C86D5E4F2BDA0171A63AF0B5416,13601,0,6,6,34,47,1747
34023,34023,02985C86D5E4F2BDA0171A63AF0B5416,11291,8,12,4,40,49,2049
34024,34024,02985C86D5E4F2BDA0171A63AF0B5416,42161,15,16,1,36,47,1847
34025,34025,02985C86D5E4F2BDA0171A63AF0B5416,40411,19,21,2,34,48,1748
34026,34026,EE011155820C4CF0BA812B7959F3205A,15401,0,7,7,39,25,1975
34027,34027,EE011155820C4CF0BA812B7959F3205A,12611,7,14,7,41,29,2079
34028,34028,EE011155820C4CF0BA812B7959F3205A,15671,17,18,1,37,26,1876
34029,34029,EE011155820C4CF0BA812B7959F3205A,12611,20,22,2,41,29,2079
34030,34030,11FECEE7865049CDA55CAB34FACD3089,42871,0,6,6,30,45,1545
34031,34031,11FECEE7865049CDA55CAB34FACD3089,11871,7,15,8,29,46,1496
34032,34032,11FECEE7865049CDA55CAB34FACD3089,11151,15,17,2,30,48,1548
34033,34033,11FECEE7865049CDA55CAB34FACD3089,11871,18,20,2,29,46,1496
34034,34034,11FECEE7865049CDA55CAB34FACD3089,11061,20,23,3,29,48,1498
34041,34041,C7C2B835B3989AD3964515AD81B4C955,10151,1,13,12,34,47,1747
34042,34042,C7C2B835B3989AD3964515AD81B4C955,10781,15,16,1,35,47,1797
34043,34043,C7C2B835B3989AD3964515AD81B4C955,10751,20,22,2,47,43,2393
34044,34044,F8320AC02FAC6F4A311CBF8892D02227,13251,1,2,1,48,28,2428
34045,34045,F8320AC02FAC6F4A311CBF8892D02227,15411,3,16,13,44,27,2227
34046,34046,F8320AC02FAC6F4A311CBF8892D02227,11381,19,22,3,30,47,1547
34047,34047,82D1CEDE24E0792F5B9EEC9BCF1BF69B,43951,2,4,2,49,41,2491
34048,34048,82D1CEDE24E0792F5B9EEC9BCF1BF69B,43101,6,8,2,46,40,2340
34049,34049,82D1CEDE24E0792F5B9EEC9BCF1BF69B,43951,10,11,1,49,41,2491
34050,34050,82D1CEDE24E0792F5B9EEC9BCF1BF69B,43101,14,16,2,46,40,2340
34051,34051,82D1CEDE24E0792F5B9EEC9BCF1BF69B,13951,18,21,3,47,45,2395
34052,34052,82D1CEDE24E0792F5B9EEC9BCF1BF69B,43951,22,23,1,49,41,2491
34053,34053,F7B0DEB7BA567C33456EA83CB86454BE,12971,0,17,17,32,48,1648
34054,34054,F7B0DEB7BA567C33456EA83CB86454BE,10251,17,20,3,35,47,1797
34055,34055,F7B0DEB7BA567C33456EA83CB86454BE,43181,21,23,2,39,48,1998
34067,34067,FF43E23AD6A11F262D2124DAFB9E2571,13511,0,11,11,34,48,1748
34068,34068,FF43E23AD6A11F262D2124DAFB9E2571,43731,11,13,2,34,47,1747
34069,34069,FF43E23AD6A11F262D2124DAFB9E2571,40341,14,17,3,23,49,1199
34070,34070,FF43E23AD6A11F262D2124DAFB9E2571,13511,19,21,2,34,48,1748
34071,34071,84D6BC0DD46DF9ED9EEE88BA266AB163,13651,1,6,5,30,47,1547
34072,34072,84D6BC0DD46DF9ED9EEE88BA266AB163,42531,6,8,2,31,45,1595
34073,34073,84D6BC0DD46DF9ED9EEE88BA266AB163,12601,15,16,1,25,47,1297
34074,34074,84D6BC0DD46DF9ED9EEE88BA266AB163,19114,21,23,2,7,43,393
34075,34075,919B6D6CA33899F0F2E7C2D48DA4283C,11061,0,8,8,29,48,1498
34076,34076,919B6D6CA33899F0F2E7C2D48DA4283C,10544,10,11,1,28,48,1448
34077,34077,919B6D6CA33899F0F2E7C2D48DA4283C,11061,13,16,3,29,48,1498
34078,34078,919B6D6CA33899F0F2E7C2D48DA4283C,13551,18,20,2,45,38,2288
34083,34083,16D740AE27D92BE968DE244652195181,13671,0,15,15,27,43,1393
34084,34084,16D740AE27D92BE968DE244652195181,12761,16,18,2,25,40,1290
34085,34085,16D740AE27D92BE968DE244652195181,13671,20,23,3,27,43,1393
34086,34086,624991DF545549832CE47D4FCA29334A,11091,1,7,6,29,47,1497
34087,34087,624991DF545549832CE47D4FCA29334A,43451,11,12,1,37,40,1890
34088,34088,624991DF545549832CE47D4FCA29334A,13091,12,14,2,20,42,1042
34089,34089,624991DF545549832CE47D4FCA29334A,13481,17,18,1,26,31,1331
34097,34097,9A05CC5DD26139C78DC854D097F8344B,43761,0,7,7,32,47,1647
34098,34098,9A05CC5DD26139C78DC854D097F8344B,11381,8,9,1,30,47,1547
34099,34099,9A05CC5DD26139C78DC854D097F8344B,12121,13,14,1,29,47,1497
34100,34100,9A05CC5DD26139C78DC854D097F8344B,10681,19,20,1,30,48,1548
34101,34101,9A05CC5DD26139C78DC854D097F8344B,11061,21,23,2,29,48,1498
34106,34106,CC9014FC196BC06D34CCADB91E1ECFC5,43391,0,10,10,29,48,1498
34107,34107,CC9014FC196BC06D34CCADB91E1ECFC5,40951,12,15,3,36,49,1849
34108,34108,CC9014FC196BC06D34CCADB91E1ECFC5,43391,19,22,3,29,48,1498
34113,34113,39A12A7E8C423731CE90191A15A5C3F4,43021,0,5,5,16,43,843
34114,34114,39A12A7E8C423731CE90191A15A5C3F4,12921,7,8,1,9,41,491
34115,34115,39A12A7E8C423731CE90191A15A5C3F4,43021,12,14,2,16,43,843
34116,34116,39A12A7E8C423731CE90191A15A5C3F4,12641,17,18,1,10,43,543
34117,34117,39A12A7E8C423731CE90191A15A5C3F4,12921,19,20,1,9,41,491
34118,34118,59A0A66272AD58C53CB4B05B1CFA927F,15404,0,6,6,40,24,2024
34119,34119,59A0A66272AD58C53CB4B05B1CFA927F,16281,7,10,3,11,4,554
34120,34120,59A0A66272AD58C53CB4B05B1CFA927F,15051,12,13,1,19,4,954
34121,34121,59A0A66272AD58C53CB4B05B1CFA927F,15481,13,15,2,24,5,1205
34122,34122,59A0A66272AD58C53CB4B05B1CFA927F,15404,19,23,4,40,24,2024
34123,34123,64EA873D359181A561255128009EB239,42581,0,3,3,38,48,1948
34124,34124,64EA873D359181A561255128009EB239,11914,6,10,4,37,48,1898
34125,34125,64EA873D359181A561255128009EB239,42581,11,13,2,38,48,1948
34126,34126,64EA873D359181A561255128009EB239,11914,13,17,4,37,48,1898
34127,34127,64EA873D359181A561255128009EB239,42581,19,21,2,38,48,1948
34128,34128,9B42EAB884E9A185F8907A30EF0D4816,11791,0,7,7,38,49,1949
34129,34129,9B42EAB884E9A185F8907A30EF0D4816,13101,7,16,9,40,47,2047
34130,34130,9B42EAB884E9A185F8907A30EF0D4816,13821,17,18,1,49,45,2495
34131,34131,7179E8D23C9EF0FE56A034B0F52DF3EB,42623,7,8,1,22,49,1149
34132,34132,7179E8D23C9EF0FE56A034B0F52DF3EB,11381,12,14,2,30,47,1547
34133,34133,7179E8D23C9EF0FE56A034B0F52DF3EB,42081,16,17,1,24,49,1249
34134,34134,7179E8D23C9EF0FE56A034B0F52DF3EB,42623,20,23,3,22,49,1149
34135,34135,292D7751F008D18B4FCCEEE4AB80D151,19441,0,4,4,8,46,446
34136,34136,292D7751F008D18B4FCCEEE4AB80D151,42041,8,11,3,10,47,547
34137,34137,292D7751F008D18B4FCCEEE4AB80D151,10211,13,17,4,16,49,849
34138,34138,292D7751F008D18B4FCCEEE4AB80D151,42041,19,21,2,10,47,547
34139,34139,292D7751F008D18B4FCCEEE4AB80D151,11631,22,23,1,12,49,649
34143,34143,CAD1FFF41FBB07303E4F900E7ED6962A,43391,0,6,6,29,48,1498
34144,34144,CAD1FFF41FBB07303E4F900E7ED6962A,40691,10,17,7,42,48,2148
34145,34145,CAD1FFF41FBB07303E4F900E7ED6962A,43391,20,23,3,29,48,1498
34156,34156,428B188218234958DE1D29D91C2ACBA1,12601,0,1,1,25,47,1297
34157,34157,428B188218234958DE1D29D91C2ACBA1,13094,3,7,4,21,42,1092
34158,34158,428B188218234958DE1D29D91C2ACBA1,12601,8,18,10,25,47,1297
34168,34168,F6D5F0720A4C82E72FD0C591B5570DDC,11951,0,8,8,31,49,1599
34169,34169,F6D5F0720A4C82E72FD0C591B5570DDC,10431,8,9,1,33,49,1699
34170,34170,F6D5F0720A4C82E72FD0C591B5570DDC,42971,13,14,1,43,49,2199
34171,34171,F6D5F0720A4C82E72FD0C591B5570DDC,40112,15,17,2,32,48,1648
34172,34172,F6D5F0720A4C82E72FD0C591B5570DDC,10381,21,23,2,31,49,1599
34173,34173,F808555B77D1C0F006490F1B42959132,10634,0,7,7,27,45,1395
34174,34174,F808555B77D1C0F006490F1B42959132,11871,8,10,2,29,46,1496
34175,34175,F808555B77D1C0F006490F1B42959132,10634,11,12,1,27,45,1395
34176,34176,F808555B77D1C0F006490F1B42959132,12311,14,15,1,30,44,1544
34177,34177,F808555B77D1C0F006490F1B42959132,11871,20,21,1,29,46,1496
34181,34181,8CD5156CF883DA15618BAFE58DDCF2A7,42581,0,7,7,38,48,1948
34182,34182,8CD5156CF883DA15618BAFE58DDCF2A7,10471,9,10,1,37,48,1898
34183,34183,8CD5156CF883DA15618BAFE58DDCF2A7,42581,11,13,2,38,48,1948
34184,34184,8CD5156CF883DA15618BAFE58DDCF2A7,11914,14,16,2,37,48,1898
34185,34185,8CD5156CF883DA15618BAFE58DDCF2A7,42581,21,22,1,38,48,1948
34186,34186,C79E0ABB02DE1A9FB5B4E2D7657A2B28,40271,0,7,7,35,49,1799
34187,34187,C79E0ABB02DE1A9FB5B4E2D7657A2B28,13341,10,11,1,44,45,2245
34188,34188,C79E0ABB02DE1A9FB5B4E2D7657A2B28,43061,11,13,2,43,46,2196
34189,34189,C79E0ABB02DE1A9FB5B4E2D7657A2B28,13221,14,16,2,40,47,2047
34190,34190,C79E0ABB02DE1A9FB5B4E2D7657A2B28,13341,17,18,1,44,45,2245
34191,34191,C79E0ABB02DE1A9FB5B4E2D7657A2B28,40271,21,23,2,35,49,1799
34192,34192,D7349708A10855AEF98FEB8D22C33E59,13271,0,7,7,41,47,2097
34193,34193,D7349708A10855AEF98FEB8D22C33E59,11231,9,16,7,37,49,1899
34194,34194,D7349708A10855AEF98FEB8D22C33E59,13271,19,23,4,41,47,2097
34195,34195,5AF85D9ED958D0E5348613692DAC5B4D,11171,0,2,2,33,48,1698
34196,34196,5AF85D9ED958D0E5348613692DAC5B4D,12083,3,9,6,36,49,1849
34197,34197,5AF85D9ED958D0E5348613692DAC5B4D,11201,10,18,8,35,49,1799
34198,34198,5AF85D9ED958D0E5348613692DAC5B4D,11921,19,21,2,38,48,1948
34199,34199,5AF85D9ED958D0E5348613692DAC5B4D,11231,22,23,1,37,49,1899
34200,34200,36FCC77221FD197391086B41E6ED8F8F,43731,0,5,5,34,47,1747
34201,34201,36FCC77221FD197391086B41E6ED8F8F,43161,6,7,1,35,47,1797
34202,34202,36FCC77221FD197391086B41E6ED8F8F,43731,9,11,2,34,47,1747
34203,34203,36FCC77221FD197391086B41E6ED8F8F,10971,14,16,2,35,47,1797
34204,34204,36FCC77221FD197391086B41E6ED8F8F,43731,21,23,2,34,47,1747
34222,34222,92E1BAA88B052422B820ED36A9E8F107,41392,4,6,2,43,48,2198
34223,34223,92E1BAA88B052422B820ED36A9E8F107,11921,7,9,2,38,48,1948
34224,34224,92E1BAA88B052422B820ED36A9E8F107,11914,9,10,1,37,48,1898
34225,34225,92E1BAA88B052422B820ED36A9E8F107,41392,12,23,11,43,48,2198
34226,34226,ACD04627348D28EB014FAB46490D4B92,12601,0,1,1,25,47,1297
34227,34227,ACD04627348D28EB014FAB46490D4B92,10351,1,8,7,28,45,1445
34228,34228,ACD04627348D28EB014FAB46490D4B92,12601,8,11,3,25,47,1297
34229,34229,ACD04627348D28EB014FAB46490D4B92,13771,12,15,3,21,45,1095
34230,34230,ACD04627348D28EB014FAB46490D4B92,12601,16,17,1,25,47,1297
34231,34231,ACD04627348D28EB014FAB46490D4B92,13771,19,23,4,21,45,1095
34235,34235,91FB7E11CCB9539E71578F3DFA4AFBA7,12921,0,6,6,9,41,491
34236,34236,91FB7E11CCB9539E71578F3DFA4AFBA7,19181,7,17,10,8,40,440
34237,34237,91FB7E11CCB9539E71578F3DFA4AFBA7,12921,18,19,1,9,41,491
34238,34238,91FB7E11CCB9539E71578F3DFA4AFBA7,19181,19,20,1,8,40,440
34239,34239,91FB7E11CCB9539E71578F3DFA4AFBA7,12921,21,22,1,9,41,491
34244,34244,F87C006906FC5F5270405EDAA1B0E6A3,12514,0,5,5,38,47,1947
34245,34245,F87C006906FC5F5270405EDAA1B0E6A3,10841,6,7,1,37,47,1897
34246,34246,F87C006906FC5F5270405EDAA1B0E6A3,42801,8,11,3,40,49,2049
34247,34247,F87C006906FC5F5270405EDAA1B0E6A3,12514,11,13,2,38,47,1947
34248,34248,F87C006906FC5F5270405EDAA1B0E6A3,11201,15,16,1,35,49,1799
34249,34249,F87C006906FC5F5270405EDAA1B0E6A3,42221,21,23,2,38,48,1948
34250,34250,E962C3D0A8FC163364DD770DFBF0ADE9,13651,3,4,1,30,47,1547
34251,34251,E962C3D0A8FC163364DD770DFBF0ADE9,41591,9,16,7,34,49,1749
34252,34252,E962C3D0A8FC163364DD770DFBF0ADE9,13651,19,23,4,30,47,1547
34253,34253,3C9FCF8526E7E52C206BF1E3F8AE8299,43581,0,6,6,33,48,1698
34254,34254,3C9FCF8526E7E52C206BF1E3F8AE8299,11561,8,10,2,32,49,1649
34255,34255,3C9FCF8526E7E52C206BF1E3F8AE8299,42941,13,15,2,37,47,1897
34256,34256,3C9FCF8526E7E52C206BF1E3F8AE8299,43581,19,22,3,33,48,1698
34260,34260,8436FA510D59B3814E50B7F18BD1D92C,19571,0,5,5,1,36,86
34261,34261,8436FA510D59B3814E50B7F18BD1D92C,19031,6,7,1,1,42,92
34262,34262,8436FA510D59B3814E50B7F18BD1D92C,12921,8,10,2,9,41,491
34263,34263,8436FA510D59B3814E50B7F18BD1D92C,19571,15,18,3,1,36,86
34264,34264,8436FA510D59B3814E50B7F18BD1D92C,43644,19,21,2,14,38,738
34271,34271,827BF5EA812D262D83B15CA76EB0A042,15401,0,9,9,39,25,1975
34272,34272,827BF5EA812D262D83B15CA76EB0A042,19051,12,17,5,16,23,823
34273,34273,827BF5EA812D262D83B15CA76EB0A042,15381,17,19,2,19,21,971
34277,34277,DFD67893B33D33FDAA92DC71D5732DAF,42161,0,6,6,36,47,1847
34278,34278,DFD67893B33D33FDAA92DC71D5732DAF,10111,6,7,1,37,47,1897
34279,34279,DFD67893B33D33FDAA92DC71D5732DAF,42161,10,11,1,36,47,1847
34280,34280,DFD67893B33D33FDAA92DC71D5732DAF,10111,11,15,4,37,47,1897
34281,34281,DFD67893B33D33FDAA92DC71D5732DAF,42161,15,19,4,36,47,1847
34282,34282,DFD67893B33D33FDAA92DC71D5732DAF,42941,21,23,2,37,47,1897
34286,34286,F49EE04071D0B4FCCD4263F4C2BBEA7A,11061,0,8,8,29,48,1498
34287,34287,F49EE04071D0B4FCCD4263F4C2BBEA7A,10221,10,16,6,34,49,1749
34288,34288,F49EE04071D0B4FCCD4263F4C2BBEA7A,11061,20,22,2,29,48,1498
34295,34295,3C07D1557002BF4F1AA6A6D7A8949EF2,42523,0,5,5,31,47,1597
34296,34296,3C07D1557002BF4F1AA6A6D7A8949EF2,12601,8,17,9,25,47,1297
34297,34297,3C07D1557002BF4F1AA6A6D7A8949EF2,12131,18,20,2,32,47,1647
34301,34301,E599FEB56FA765D8959145E7D77CF1E9,11301,0,7,7,41,49,2099
34302,34302,E599FEB56FA765D8959145E7D77CF1E9,10151,8,11,3,34,47,1747
34303,34303,E599FEB56FA765D8959145E7D77CF1E9,11301,12,18,6,41,49,2099
34304,34304,E599FEB56FA765D8959145E7D77CF1E9,43391,19,20,1,29,48,1498
34305,34305,0CD64602CFE1261D235445667371CC96,12311,0,9,9,30,44,1544
34306,34306,0CD64602CFE1261D235445667371CC96,11261,11,12,1,36,46,1846
34307,34307,0CD64602CFE1261D235445667371CC96,12311,13,17,4,30,44,1544
34308,34308,0CD64602CFE1261D235445667371CC96,40341,18,21,3,23,49,1199
34312,34312,2E32D5B3CE79B664F5081CE0C306539E,40124,0,10,10,38,47,1947
34313,34313,2E32D5B3CE79B664F5081CE0C306539E,42381,13,14,1,39,41,1991
34314,34314,2E32D5B3CE79B664F5081CE0C306539E,40341,17,18,1,23,49,1199
34315,34315,2E32D5B3CE79B664F5081CE0C306539E,10491,19,20,1,33,48,1698
34316,34316,2E32D5B3CE79B664F5081CE0C306539E,10841,21,23,2,37,47,1897
34317,34317,9F700CBC144BEA32CD8E0663B89B3CC6,42961,3,7,4,35,49,1799
34318,34318,9F700CBC144BEA32CD8E0663B89B3CC6,40062,10,12,2,32,49,1649
34319,34319,9F700CBC144BEA32CD8E0663B89B3CC6,11231,14,15,1,37,49,1899
34320,34320,9F700CBC144BEA32CD8E0663B89B3CC6,10121,15,17,2,36,49,1849
34321,34321,9F700CBC144BEA32CD8E0663B89B3CC6,11231,21,22,1,37,49,1899
34322,34322,7A155C9E4A54A3892757F457CD4D9BC1,43011,0,2,2,40,42,2042
34323,34323,7A155C9E4A54A3892757F457CD4D9BC1,12491,2,8,6,36,43,1843
34324,34324,7A155C9E4A54A3892757F457CD4D9BC1,42861,9,10,1,37,44,1894
34325,34325,7A155C9E4A54A3892757F457CD4D9BC1,12491,12,21,9,36,43,1843
34326,34326,7A155C9E4A54A3892757F457CD4D9BC1,42151,22,23,1,35,45,1795
34327,34327,1B3986DEE462AB0A28DAC3E4267A48E5,42031,0,9,9,40,46,2046
34328,34328,1B3986DEE462AB0A28DAC3E4267A48E5,42151,12,14,2,35,45,1795
34329,34329,1B3986DEE462AB0A28DAC3E4267A48E5,11111,15,16,1,26,48,1348
34330,34330,1B3986DEE462AB0A28DAC3E4267A48E5,40673,20,21,1,36,48,1848
34331,34331,1B3986DEE462AB0A28DAC3E4267A48E5,42031,22,23,1,40,46,2046
34335,34335,77FA051C7FE484BBBC94A458F9402E14,42121,3,8,5,26,49,1349
34336,34336,77FA051C7FE484BBBC94A458F9402E14,11151,9,10,1,30,48,1548
34337,34337,77FA051C7FE484BBBC94A458F9402E14,40094,10,15,5,29,48,1498
34338,34338,77FA051C7FE484BBBC94A458F9402E14,42121,20,23,3,26,49,1349
34339,34339,2F66AC01887397A198C9CCA6611EA97B,12521,0,8,8,35,41,1791
34340,34340,2F66AC01887397A198C9CCA6611EA97B,13314,8,10,2,31,39,1589
34341,34341,2F66AC01887397A198C9CCA6611EA97B,12521,11,23,12,35,41,1791
34342,34342,62A4DF59E8BCEC0DCF6C971E2D9209AC,13711,1,6,5,38,46,1946
34343,34343,62A4DF59E8BCEC0DCF6C971E2D9209AC,11021,8,16,8,36,49,1849
34344,34344,62A4DF59E8BCEC0DCF6C971E2D9209AC,10271,18,19,1,37,46,1896
34345,34345,290CF9B7E8E39B2A6D619522168B66C7,19621,0,7,7,5,46,296
34346,34346,290CF9B7E8E39B2A6D619522168B66C7,11941,8,9,1,37,46,1896
34347,34347,290CF9B7E8E39B2A6D619522168B66C7,10221,10,12,2,34,49,1749
34348,34348,290CF9B7E8E39B2A6D619522168B66C7,12584,14,15,1,24,48,1248
34349,34349,290CF9B7E8E39B2A6D619522168B66C7,10721,16,17,1,31,48,1598
34350,34350,290CF9B7E8E39B2A6D619522168B66C7,41591,18,19,1,34,49,1749
34351,34351,290CF9B7E8E39B2A6D619522168B66C7,19441,20,23,3,8,46,446
34352,34352,9A25B61D346E80AAD368234207486E9F,13381,2,9,7,39,47,1997
34353,34353,9A25B61D346E80AAD368234207486E9F,11381,12,19,7,30,47,1547
34354,34354,9A25B61D346E80AAD368234207486E9F,12121,19,22,3,29,47,1497
34359,34359,60DB2F1E5C63BE640D47B87EE3CFB05B,42461,0,6,6,45,47,2297
34360,34360,60DB2F1E5C63BE640D47B87EE3CFB05B,42321,6,13,7,43,47,2197
34361,34361,60DB2F1E5C63BE640D47B87EE3CFB05B,42201,13,14,1,43,46,2196
34362,34362,60DB2F1E5C63BE640D47B87EE3CFB05B,42321,15,16,1,43,47,2197
34363,34363,60DB2F1E5C63BE640D47B87EE3CFB05B,42461,18,23,5,45,47,2297
34364,34364,88BD866547E35D038437E393C4A29F25,42151,0,6,6,35,45,1795
34365,34365,88BD866547E35D038437E393C4A29F25,12491,10,15,5,36,43,1843
34366,34366,88BD866547E35D038437E393C4A29F25,13314,15,18,3,31,39,1589
34367,34367,88BD866547E35D038437E393C4A29F25,42151,21,22,1,35,45,1795
34368,34368,4AE93F20F703B65B87F8746D93A2B5AE,43061,0,12,12,43,46,2196
34369,34369,4AE93F20F703B65B87F8746D93A2B5AE,42461,12,14,2,45,47,2297
34370,34370,4AE93F20F703B65B87F8746D93A2B5AE,43061,15,16,1,43,46,2196
34371,34371,4AE93F20F703B65B87F8746D93A2B5AE,10841,18,19,1,37,47,1897
34372,34372,4AE93F20F703B65B87F8746D93A2B5AE,42204,22,23,1,43,46,2196
34373,34373,2D1B88BCBB8DC02CFE938728AF8C4C63,11591,4,6,2,36,49,1849
34374,34374,2D1B88BCBB8DC02CFE938728AF8C4C63,42261,14,17,3,25,49,1299
34375,34375,2D1B88BCBB8DC02CFE938728AF8C4C63,11021,20,22,2,36,49,1849
34380,34380,E7952D427A9DDD1AD4B0E14CEF0AF308,16281,0,7,7,11,4,554
34381,34381,E7952D427A9DDD1AD4B0E14CEF0AF308,42221,16,18,2,38,48,1948
34382,34382,E7952D427A9DDD1AD4B0E14CEF0AF308,11074,20,21,1,37,47,1897
34383,34383,DE69FEBC50432F9871EF62D07F7A5C1A,12641,0,5,5,10,43,543
34384,34384,DE69FEBC50432F9871EF62D07F7A5C1A,12921,6,7,1,9,41,491
34385,34385,DE69FEBC50432F9871EF62D07F7A5C1A,19181,8,20,12,8,40,440
34393,34393,0DD51EE42A065AE9C7264B2B66A89D4A,19021,0,3,3,10,45,545
34394,34394,0DD51EE42A065AE9C7264B2B66A89D4A,12921,4,6,2,9,41,491
34395,34395,0DD51EE42A065AE9C7264B2B66A89D4A,19021,11,19,8,10,45,545
34396,34396,0DD51EE42A065AE9C7264B2B66A89D4A,12921,22,23,1,9,41,491
34397,34397,FF16D1104349162E539969031BE39A02,12514,0,1,1,38,47,1947
34398,34398,FF16D1104349162E539969031BE39A02,43481,5,6,1,39,48,1998
34399,34399,FF16D1104349162E539969031BE39A02,12514,10,12,2,38,47,1947
34400,34400,FF16D1104349162E539969031BE39A02,12511,15,17,2,39,47,1997
34401,34401,FF16D1104349162E539969031BE39A02,43481,18,23,5,39,48,1998
34411,34411,6EA9E153B6DD6D2CE15CEF030053FF82,40636,0,10,10,35,48,1798
34412,34412,6EA9E153B6DD6D2CE15CEF030053FF82,13094,13,15,2,21,42,1092
34413,34413,6EA9E153B6DD6D2CE15CEF030053FF82,40636,16,22,6,35,48,1798
34417,34417,05B48753BF44A0652E2900B7B33078B5,13671,0,12,12,27,43,1393
34418,34418,05B48753BF44A0652E2900B7B33078B5,11871,13,15,2,29,46,1496
34419,34419,05B48753BF44A0652E2900B7B33078B5,10351,16,18,2,28,45,1445
34420,34420,05B48753BF44A0652E2900B7B33078B5,11871,18,21,3,29,46,1496
34424,34424,253A422C6572FACDA35B610A2E4ABDE3,15441,0,3,3,44,20,2220
34425,34425,253A422C6572FACDA35B610A2E4ABDE3,12881,7,8,1,47,22,2372
34426,34426,253A422C6572FACDA35B610A2E4ABDE3,15441,12,20,8,44,20,2220
34427,34427,253A422C6572FACDA35B610A2E4ABDE3,12881,21,22,1,47,22,2372
34428,34428,20816E69FB6F9D199E34B5C4EF146CB7,10634,1,6,5,27,45,1395
34429,34429,20816E69FB6F9D199E34B5C4EF146CB7,19441,9,16,7,8,46,446
34430,34430,20816E69FB6F9D199E34B5C4EF146CB7,10634,19,20,1,27,45,1395
34431,34431,85061C43999146706723F4E0700EE955,13911,0,3,3,39,46,1996
34432,34432,85061C43999146706723F4E0700EE955,42351,3,5,2,38,45,1945
34433,34433,85061C43999146706723F4E0700EE955,13911,5,15,10,39,46,1996
34434,34434,85061C43999146706723F4E0700EE955,11261,15,20,5,36,46,1846
34435,34435,85061C43999146706723F4E0700EE955,13911,21,23,2,39,46,1996
34440,34440,FCA3C665B5BF337F331669EDB597A6AC,42791,0,7,7,35,45,1795
34441,34441,FCA3C665B5BF337F331669EDB597A6AC,10271,8,10,2,37,46,1896
34442,34442,FCA3C665B5BF337F331669EDB597A6AC,13121,10,13,3,38,46,1946
34443,34443,FCA3C665B5BF337F331669EDB597A6AC,10271,14,17,3,37,46,1896
34444,34444,FCA3C665B5BF337F331669EDB597A6AC,10531,21,23,2,34,46,1746
34445,34445,2D9F8EEE0946858BEC66856CB73B8335,43021,0,5,5,16,43,843
34446,34446,2D9F8EEE0946858BEC66856CB73B8335,12921,5,8,3,9,41,491
34447,34447,2D9F8EEE0946858BEC66856CB73B8335,43021,11,12,1,16,43,843
34448,34448,2D9F8EEE0946858BEC66856CB73B8335,12921,13,17,4,9,41,491
34449,34449,2D9F8EEE0946858BEC66856CB73B8335,43021,20,23,3,16,43,843
34450,34450,4EBB382643C7FAC868385593D235FA2B,10351,0,1,1,28,45,1445
34451,34451,4EBB382643C7FAC868385593D235FA2B,13771,1,2,1,21,45,1095
34452,34452,4EBB382643C7FAC868385593D235FA2B,12671,4,6,2,21,43,1093
34453,34453,4EBB382643C7FAC868385593D235FA2B,13091,7,8,1,20,42,1042
34454,34454,4EBB382643C7FAC868385593D235FA2B,12671,13,14,1,21,43,1093
34455,34455,4EBB382643C7FAC868385593D235FA2B,12601,19,23,4,25,47,1297
34459,34459,35DAC6756C7F4B57C2B1C6F65896CD31,10351,0,2,2,28,45,1445
34460,34460,35DAC6756C7F4B57C2B1C6F65896CD31,10634,5,7,2,27,45,1395
34461,34461,35DAC6756C7F4B57C2B1C6F65896CD31,11091,8,10,2,29,47,1497
34462,34462,35DAC6756C7F4B57C2B1C6F65896CD31,10351,14,16,2,28,45,1445
34463,34463,35DAC6756C7F4B57C2B1C6F65896CD31,12601,20,23,3,25,47,1297
34464,34464,264D4B6C2E3DE9376B913B62B2448C2D,42351,0,1,1,38,45,1945
34465,34465,264D4B6C2E3DE9376B913B62B2448C2D,42151,2,4,2,35,45,1795
34466,34466,264D4B6C2E3DE9376B913B62B2448C2D,10271,5,6,1,37,46,1896
34467,34467,264D4B6C2E3DE9376B913B62B2448C2D,13711,6,12,6,38,46,1946
34468,34468,264D4B6C2E3DE9376B913B62B2448C2D,40463,13,14,1,38,49,1949
34469,34469,264D4B6C2E3DE9376B913B62B2448C2D,13711,17,21,4,38,46,1946
34470,34470,AC9A35D001464E087369411DD671E08D,42511,0,5,5,37,47,1897
34471,34471,AC9A35D001464E087369411DD671E08D,11301,6,7,1,41,49,2099
34472,34472,AC9A35D001464E087369411DD671E08D,10841,8,15,7,37,47,1897
34473,34473,AC9A35D001464E087369411DD671E08D,10901,15,16,1,35,48,1798
34474,34474,AC9A35D001464E087369411DD671E08D,11521,18,19,1,41,48,2098
34478,34478,EABEF7F279809019F175B54E78F96D19,13271,0,14,14,41,47,2097
34479,34479,EABEF7F279809019F175B54E78F96D19,43761,16,17,1,32,47,1647
34480,34480,EABEF7F279809019F175B54E78F96D19,13951,19,20,1,47,45,2395
34481,34481,EABEF7F279809019F175B54E78F96D19,12514,22,23,1,38,47,1947
34482,34482,19B7F0CF3E3FD886B38254D17C1F93A2,10351,1,2,1,28,45,1445
34483,34483,19B7F0CF3E3FD886B38254D17C1F93A2,11875,3,6,3,30,46,1546
34484,34484,19B7F0CF3E3FD886B38254D17C1F93A2,10351,7,8,1,28,45,1445
34485,34485,19B7F0CF3E3FD886B38254D17C1F93A2,12311,12,17,5,30,44,1544
34486,34486,19B7F0CF3E3FD886B38254D17C1F93A2,10301,20,22,2,31,45,1595
34487,34487,D1348B896638AC7A64C13B19AE981466,11861,0,8,8,32,47,1647
34488,34488,D1348B896638AC7A64C13B19AE981466,43451,8,15,7,37,40,1890
34489,34489,D1348B896638AC7A64C13B19AE981466,10281,20,23,3,33,48,1698
34490,34490,E78E0ABBE194ABEE97C2D7DD94378A1C,10121,0,8,8,36,49,1849
34491,34491,E78E0ABBE194ABEE97C2D7DD94378A1C,12971,9,10,1,32,48,1648
34492,34492,E78E0ABBE194ABEE97C2D7DD94378A1C,10121,12,13,1,36,49,1849
34493,34493,E78E0ABBE194ABEE97C2D7DD94378A1C,41101,14,16,2,32,48,1648
34494,34494,E78E0ABBE194ABEE97C2D7DD94378A1C,13561,19,23,4,37,49,1899
34495,34495,D3BB6434CFBF49B50777B86837D5C192,11331,0,11,11,37,48,1898
34496,34496,D3BB6434CFBF49B50777B86837D5C192,11061,12,14,2,29,48,1498
34497,34497,D3BB6434CFBF49B50777B86837D5C192,43971,15,19,4,30,48,1548
34501,34501,2770DAF26F856B8C604C0FF1601A7902,19031,0,6,6,1,42,92
34502,34502,2770DAF26F856B8C604C0FF1601A7902,19181,7,8,1,8,40,440
34503,34503,2770DAF26F856B8C604C0FF1601A7902,12921,13,23,10,9,41,491
34521,34521,D4FFD3DBF31169ED7795F657992DBA3A,10111,1,3,2,37,47,1897
34522,34522,D4FFD3DBF31169ED7795F657992DBA3A,10611,4,7,3,32,48,1648
34523,34523,D4FFD3DBF31169ED7795F657992DBA3A,10451,8,12,4,25,48,1298
34524,34524,D4FFD3DBF31169ED7795F657992DBA3A,11921,13,18,5,38,48,1948
34528,34528,09D4E4AC27B1C2BD71280354244F178D,11081,0,8,8,35,46,1796
34529,34529,09D4E4AC27B1C2BD71280354244F178D,43361,9,10,1,38,48,1948
34530,34530,09D4E4AC27B1C2BD71280354244F178D,11081,12,18,6,35,46,1796
34531,34531,09D4E4AC27B1C2BD71280354244F178D,10491,18,20,2,33,48,1698
34532,34532,09D4E4AC27B1C2BD71280354244F178D,11651,21,23,2,33,47,1697
34539,34539,594835BD749880E69EF137011FAE9C84,19744,0,14,14,6,43,343
34540,34540,594835BD749880E69EF137011FAE9C84,12641,14,15,1,10,43,543
34541,34541,594835BD749880E69EF137011FAE9C84,19931,15,16,1,7,43,393
34542,34542,594835BD749880E69EF137011FAE9C84,19741,18,20,2,5,44,294
34543,34543,594835BD749880E69EF137011FAE9C84,19744,21,23,2,6,43,343
34544,34544,9C2C2A9A5923C3E8476FE17BB2B155DD,19114,0,2,2,7,43,393
34545,34545,9C2C2A9A5923C3E8476FE17BB2B155DD,19021,4,5,1,10,45,545
34546,34546,9C2C2A9A5923C3E8476FE17BB2B155DD,12641,6,17,11,10,43,543
34547,34547,9C2C2A9A5923C3E8476FE17BB2B155DD,19114,17,18,1,7,43,393
34552,34552,89C5F5C036761FD2C32F64BC4CDE2E5B,19441,0,13,13,8,46,446
34553,34553,89C5F5C036761FD2C32F64BC4CDE2E5B,19621,14,18,4,5,46,296
34554,34554,89C5F5C036761FD2C32F64BC4CDE2E5B,11074,20,21,1,37,47,1897
34555,34555,9BB4D156915876EB02A7BFC0268C6AFA,10251,0,9,9,35,47,1797
34556,34556,9BB4D156915876EB02A7BFC0268C6AFA,11151,10,11,1,30,48,1548
34557,34557,9BB4D156915876EB02A7BFC0268C6AFA,10251,12,23,11,35,47,1797
34562,34562,04D3DE5FD9FDB4FD914E8F65E47E316F,19901,7,9,2,7,44,394
34563,34563,04D3DE5FD9FDB4FD914E8F65E47E316F,12641,12,14,2,10,43,543
34564,34564,04D3DE5FD9FDB4FD914E8F65E47E316F,12921,16,21,5,9,41,491
34565,34565,6ABCA112AF80119A11E9BA7816F26F03,19031,0,12,12,1,42,92
34566,34566,6ABCA112AF80119A11E9BA7816F26F03,19114,13,14,1,7,43,393
34567,34567,6ABCA112AF80119A11E9BA7816F26F03,19031,15,23,8,1,42,92
34572,34572,25E3861C45844C04BED1098CE2242715,13511,0,8,8,34,48,1748
34573,34573,25E3861C45844C04BED1098CE2242715,43731,11,13,2,34,47,1747
34574,34574,25E3861C45844C04BED1098CE2242715,40341,14,17,3,23,49,1199
34575,34575,25E3861C45844C04BED1098CE2242715,13511,17,21,4,34,48,1748
34579,34579,F0A1BB763F378032A1CC33E7783B3D13,10121,1,2,1,36,49,1849
34580,34580,F0A1BB763F378032A1CC33E7783B3D13,10661,3,4,1,37,49,1899
34581,34581,F0A1BB763F378032A1CC33E7783B3D13,11021,4,5,1,36,49,1849
34582,34582,F0A1BB763F378032A1CC33E7783B3D13,10661,5,8,3,37,49,1899
34583,34583,F0A1BB763F378032A1CC33E7783B3D13,10121,10,15,5,36,49,1849
34584,34584,F0A1BB763F378032A1CC33E7783B3D13,40341,17,19,2,23,49,1199
34585,34585,E978944605FAE9C6CFC8A2DA156237C6,11551,0,13,13,39,49,1999
34586,34586,E978944605FAE9C6CFC8A2DA156237C6,43731,15,19,4,34,47,1747
34587,34587,E978944605FAE9C6CFC8A2DA156237C6,11551,20,23,3,39,49,1999
34588,34588,20CD9E3A1B77E936B4A35B7A2F14CDE6,12514,5,8,3,38,47,1947
34589,34589,20CD9E3A1B77E936B4A35B7A2F14CDE6,11074,10,12,2,37,47,1897
34590,34590,20CD9E3A1B77E936B4A35B7A2F14CDE6,12514,13,16,3,38,47,1947
34591,34591,20CD9E3A1B77E936B4A35B7A2F14CDE6,11074,17,20,3,37,47,1897
34592,34592,20CD9E3A1B77E936B4A35B7A2F14CDE6,12514,20,22,2,38,47,1947
34593,34593,62A2F5272230052AEB85DFD96BD0E354,42541,0,8,8,25,47,1297
34594,34594,62A2F5272230052AEB85DFD96BD0E354,10251,10,18,8,35,47,1797
34595,34595,62A2F5272230052AEB85DFD96BD0E354,11861,19,20,1,32,47,1647
34596,34596,62A2F5272230052AEB85DFD96BD0E354,12601,21,22,1,25,47,1297
34603,34603,499426AABDFB3A48AD7C69EA8E2B51C2,19621,0,12,12,5,46,296
34604,34604,499426AABDFB3A48AD7C69EA8E2B51C2,10221,13,14,1,34,49,1749
34605,34605,499426AABDFB3A48AD7C69EA8E2B51C2,19621,16,23,7,5,46,296
34606,34606,DF27A3CF500C9336C7867AB47C4B8B4A,12131,1,16,15,32,47,1647
34607,34607,DF27A3CF500C9336C7867AB47C4B8B4A,40341,18,19,1,23,49,1199
34608,34608,DF27A3CF500C9336C7867AB47C4B8B4A,10731,21,22,1,33,47,1697
34623,34623,C0D3D746EE362DF9092390E1B22CCC4A,11061,6,7,1,29,48,1498
34624,34624,C0D3D746EE362DF9092390E1B22CCC4A,12311,8,18,10,30,44,1544
34625,34625,C0D3D746EE362DF9092390E1B22CCC4A,40445,20,22,2,30,48,1548
34626,34626,1F87CA1D778B027B6DE06AC8BD5FBD25,13314,0,7,7,31,39,1589
34627,34627,1F87CA1D778B027B6DE06AC8BD5FBD25,42851,9,10,1,35,41,1791
34628,34628,1F87CA1D778B027B6DE06AC8BD5FBD25,13314,15,19,4,31,39,1589
34632,34632,DD628D137A372FD9F2379158E8EE3966,12921,0,15,15,9,41,491
34633,34633,DD628D137A372FD9F2379158E8EE3966,43644,15,17,2,14,38,738
34634,34634,DD628D137A372FD9F2379158E8EE3966,12921,18,21,3,9,41,491
34639,34639,4EABE655BE26B3EDCCD7B6B2C89F187F,10221,0,1,1,34,49,1749
34640,34640,4EABE655BE26B3EDCCD7B6B2C89F187F,42981,2,4,2,36,49,1849
34641,34641,4EABE655BE26B3EDCCD7B6B2C89F187F,10161,4,16,12,35,49,1799
34642,34642,4EABE655BE26B3EDCCD7B6B2C89F187F,40341,19,22,3,23,49,1199
34650,34650,62F6BE848412C7FADEB816AFD62C431F,15521,2,3,1,27,14,1364
34651,34651,62F6BE848412C7FADEB816AFD62C431F,16151,6,11,5,13,11,661
34652,34652,62F6BE848412C7FADEB816AFD62C431F,15521,15,16,1,27,14,1364
34653,34653,62F6BE848412C7FADEB816AFD62C431F,16151,17,19,2,13,11,661
34662,34662,0E54FDDDFEF0BF7075D3505985BA7000,13071,0,6,6,41,41,2091
34663,34663,0E54FDDDFEF0BF7075D3505985BA7000,43451,11,12,1,37,40,1890
34664,34664,0E54FDDDFEF0BF7075D3505985BA7000,13071,12,14,2,41,41,2091
34665,34665,0E54FDDDFEF0BF7075D3505985BA7000,43451,14,21,7,37,40,1890
34669,34669,B046A650BE0C1BBB3512CD7DA14AD148,13941,0,7,7,41,47,2097
34670,34670,B046A650BE0C1BBB3512CD7DA14AD148,11531,11,12,1,34,49,1749
34671,34671,B046A650BE0C1BBB3512CD7DA14AD148,40833,19,23,4,41,47,2097
34672,34672,62FCB15297A7724012720DDE29CC0405,40691,0,2,2,42,48,2148
34673,34673,62FCB15297A7724012720DDE29CC0405,11701,2,8,6,43,48,2198
34674,34674,62FCB15297A7724012720DDE29CC0405,42541,11,12,1,25,47,1297
34675,34675,62FCB15297A7724012720DDE29CC0405,10107,13,14,1,38,49,1949
34676,34676,62FCB15297A7724012720DDE29CC0405,42541,15,21,6,25,47,1297
34684,34684,B20D4CCCBBF9B534BB9F26A35B371E4C,13911,0,1,1,39,46,1996
34685,34685,B20D4CCCBBF9B534BB9F26A35B371E4C,42351,1,9,8,38,45,1945
34686,34686,B20D4CCCBBF9B534BB9F26A35B371E4C,42231,10,11,1,37,46,1896
34687,34687,B20D4CCCBBF9B534BB9F26A35B371E4C,42351,11,16,5,38,45,1945
34688,34688,B20D4CCCBBF9B534BB9F26A35B371E4C,42231,21,23,2,37,46,1896
34692,34692,D799218F43FD3256AF73C1C62F09EA78,11751,0,6,6,35,48,1798
34693,34693,D799218F43FD3256AF73C1C62F09EA78,40341,8,9,1,23,49,1199
34694,34694,D799218F43FD3256AF73C1C62F09EA78,13091,13,15,2,20,42,1042
34695,34695,D799218F43FD3256AF73C1C62F09EA78,12021,16,21,5,37,49,1899
34696,34696,864A03B46C1B66C462A334A7049A7399,40636,0,1,1,35,48,1798
34697,34697,864A03B46C1B66C462A334A7049A7399,11861,2,11,9,32,47,1647
34698,34698,864A03B46C1B66C462A334A7049A7399,42523,11,13,2,31,47,1597
34699,34699,864A03B46C1B66C462A334A7049A7399,43761,13,17,4,32,47,1647
34700,34700,864A03B46C1B66C462A334A7049A7399,40636,20,23,3,35,48,1798
34701,34701,B4BA824D03B689E71343C29B23089A47,43451,1,4,3,37,40,1890
34702,34702,B4BA824D03B689E71343C29B23089A47,43011,5,7,2,40,42,2042
34703,34703,B4BA824D03B689E71343C29B23089A47,43451,9,15,6,37,40,1890
34704,34704,B4BA824D03B689E71343C29B23089A47,43011,18,19,1,40,42,2042
34705,34705,B4BA824D03B689E71343C29B23089A47,42864,19,20,1,38,44,1944
34721,34721,B289C6428E0D98B8D720F0FA5499A67A,15271,0,7,7,14,20,720
34722,34722,B289C6428E0D98B8D720F0FA5499A67A,15401,9,10,1,39,25,1975
34723,34723,B289C6428E0D98B8D720F0FA5499A67A,15371,11,12,1,15,22,772
34724,34724,B289C6428E0D98B8D720F0FA5499A67A,16441,13,14,1,15,17,767
34725,34725,B289C6428E0D98B8D720F0FA5499A67A,15271,17,23,6,14,20,720
34726,34726,5CD1F9F9A599BFBDCECB134735F43935,40322,0,1,1,38,46,1946
34727,34727,5CD1F9F9A599BFBDCECB134735F43935,43011,4,6,2,40,42,2042
34728,34728,5CD1F9F9A599BFBDCECB134735F43935,42151,7,16,9,35,45,1795
34729,34729,5CD1F9F9A599BFBDCECB134735F43935,40951,21,23,2,36,49,1849
34730,34730,D256AE34DD31744D7365602849D9C40A,42491,0,8,8,32,46,1646
34731,34731,D256AE34DD31744D7365602849D9C40A,12601,8,14,6,25,47,1297
34732,34732,D256AE34DD31744D7365602849D9C40A,12971,16,18,2,32,48,1648
34733,34733,D256AE34DD31744D7365602849D9C40A,42491,19,23,4,32,46,1646
34741,34741,D892D681F58BAE67117A47FF9D199CBC,11201,0,9,9,35,49,1799
34742,34742,D892D681F58BAE67117A47FF9D199CBC,10821,10,11,1,40,47,2047
34743,34743,D892D681F58BAE67117A47FF9D199CBC,11201,14,20,6,35,49,1799
34744,34744,1DD07CF7FD5B3CCCB4E85025836774E4,12841,0,7,7,37,47,1897
34745,34745,1DD07CF7FD5B3CCCB4E85025836774E4,11231,7,18,11,37,49,1899
34746,34746,1DD07CF7FD5B3CCCB4E85025836774E4,12381,21,23,2,32,48,1648
34753,34753,0CED0A2998E753C043314DC59E2912AD,16151,0,1,1,13,11,661
34754,34754,0CED0A2998E753C043314DC59E2912AD,15143,2,9,7,18,7,907
34755,34755,0CED0A2998E753C043314DC59E2912AD,16251,10,15,5,15,13,763
34756,34756,0CED0A2998E753C043314DC59E2912AD,16151,18,23,5,13,11,661
34757,34757,CD5F8D7604C7020A19DDE3C48998E9F5,13314,0,2,2,31,39,1589
34758,34758,CD5F8D7604C7020A19DDE3C48998E9F5,13041,2,6,4,30,37,1537
34759,34759,CD5F8D7604C7020A19DDE3C48998E9F5,12521,7,22,15,35,41,1791
34760,34760,6D63FF8A3FC1EAB372239FB0BF4A8ABC,41392,0,7,7,43,48,2198
34761,34761,6D63FF8A3FC1EAB372239FB0BF4A8ABC,11384,8,9,1,30,47,1547
34762,34762,6D63FF8A3FC1EAB372239FB0BF4A8ABC,11701,11,14,3,43,48,2198
34763,34763,6D63FF8A3FC1EAB372239FB0BF4A8ABC,11651,15,17,2,33,47,1697
34764,34764,6D63FF8A3FC1EAB372239FB0BF4A8ABC,41392,18,21,3,43,48,2198
34769,34769,F14E2078AC4B9DC25FBC5A32ED013426,40801,0,7,7,43,46,2196
34770,34770,F14E2078AC4B9DC25FBC5A32ED013426,11541,8,10,2,35,49,1799
34771,34771,F14E2078AC4B9DC25FBC5A32ED013426,41591,14,16,2,34,49,1749
34772,34772,F14E2078AC4B9DC25FBC5A32ED013426,40801,18,23,5,43,46,2196
34779,34779,E02F57B26F613B95B8A8C38410D07E2A,42681,2,6,4,24,48,1248
34780,34780,E02F57B26F613B95B8A8C38410D07E2A,42481,8,9,1,22,49,1149
34781,34781,E02F57B26F613B95B8A8C38410D07E2A,11111,9,10,1,26,48,1348
34782,34782,E02F57B26F613B95B8A8C38410D07E2A,12581,16,19,3,24,48,1248
34783,34783,E02F57B26F613B95B8A8C38410D07E2A,11361,20,21,1,22,48,1148
34791,34791,7011DE96B440B54BDA505351983BAF85,11551,0,1,1,39,49,1999
34792,34792,7011DE96B440B54BDA505351983BAF85,11021,2,14,12,36,49,1849
34793,34793,7011DE96B440B54BDA505351983BAF85,11751,14,16,2,35,48,1798
34794,34794,7011DE96B440B54BDA505351983BAF85,11021,16,18,2,36,49,1849
34795,34795,7011DE96B440B54BDA505351983BAF85,43161,22,23,1,35,47,1797
34796,34796,83B65A620AA8887006B94BCE755E769B,10351,0,6,6,28,45,1445
34797,34797,83B65A620AA8887006B94BCE755E769B,42871,7,8,1,30,45,1545
34798,34798,83B65A620AA8887006B94BCE755E769B,10351,10,11,1,28,45,1445
34799,34799,83B65A620AA8887006B94BCE755E769B,10634,15,17,2,27,45,1395
34800,34800,83B65A620AA8887006B94BCE755E769B,10351,18,19,1,28,45,1445
34801,34801,83B65A620AA8887006B94BCE755E769B,10634,21,23,2,27,45,1395
34802,34802,9EBD792C30B963491A648A1AF083878E,12641,0,1,1,10,43,543
34803,34803,9EBD792C30B963491A648A1AF083878E,19111,1,2,1,9,45,495
34804,34804,9EBD792C30B963491A648A1AF083878E,12641,3,4,1,10,43,543
34805,34805,9EBD792C30B963491A648A1AF083878E,19111,6,11,5,9,45,495
34806,34806,9EBD792C30B963491A648A1AF083878E,12641,12,21,9,10,43,543
34807,34807,914FCCE81925BD3B7C09A01C1E108BA6,42461,2,9,7,45,47,2297
34808,34808,914FCCE81925BD3B7C09A01C1E108BA6,41591,10,12,2,34,49,1749
34809,34809,914FCCE81925BD3B7C09A01C1E108BA6,42091,17,20,3,43,46,2196
34813,34813,0BDAF69C7AB80550E0362911AC25E517,12641,0,3,3,10,43,543
34814,34814,0BDAF69C7AB80550E0362911AC25E517,19031,4,16,12,1,42,92
34815,34815,0BDAF69C7AB80550E0362911AC25E517,12641,16,18,2,10,43,543
34816,34816,0BDAF69C7AB80550E0362911AC25E517,19931,18,19,1,7,43,393
34817,34817,0BDAF69C7AB80550E0362911AC25E517,12921,21,23,2,9,41,491
34821,34821,E478E2D9BCF7A4F7B498F875A46F0A1D,42461,1,7,6,45,47,2297
34822,34822,E478E2D9BCF7A4F7B498F875A46F0A1D,43061,7,9,2,43,46,2196
34823,34823,E478E2D9BCF7A4F7B498F875A46F0A1D,42461,11,14,3,45,47,2297
34824,34824,E478E2D9BCF7A4F7B498F875A46F0A1D,42091,19,20,1,43,46,2196
34825,34825,E478E2D9BCF7A4F7B498F875A46F0A1D,42461,21,22,1,45,47,2297
34826,34826,4F3F717E93BC5AFE00C4421DCBF0AA01,42301,0,8,8,36,47,1847
34827,34827,4F3F717E93BC5AFE00C4421DCBF0AA01,11261,11,15,4,36,46,1846
34828,34828,4F3F717E93BC5AFE00C4421DCBF0AA01,42864,17,18,1,38,44,1944
34829,34829,4F3F717E93BC5AFE00C4421DCBF0AA01,10841,20,23,3,37,47,1897
34830,34830,C68BD884038901FC3E44D28FCEB3DA1A,12311,0,3,3,30,44,1544
34831,34831,C68BD884038901FC3E44D28FCEB3DA1A,10301,3,4,1,31,45,1595
34832,34832,C68BD884038901FC3E44D28FCEB3DA1A,10211,7,9,2,16,49,849
34833,34833,C68BD884038901FC3E44D28FCEB3DA1A,11074,19,21,2,37,47,1897
34834,34834,C68BD884038901FC3E44D28FCEB3DA1A,12311,22,23,1,30,44,1544
34841,34841,A0C13743AF441FE8099AA940DA71C612,42581,0,5,5,38,48,1948
34842,34842,A0C13743AF441FE8099AA940DA71C612,11914,6,8,2,37,48,1898
34843,34843,A0C13743AF441FE8099AA940DA71C612,42581,8,9,1,38,48,1948
34844,34844,A0C13743AF441FE8099AA940DA71C612,11914,14,18,4,37,48,1898
34845,34845,A0C13743AF441FE8099AA940DA71C612,42581,18,23,5,38,48,1948
34858,34858,BC76CCD190FA1A5238AAD9129E2B96C9,40463,1,4,3,38,49,1949
34859,34859,BC76CCD190FA1A5238AAD9129E2B96C9,11461,4,5,1,37,49,1899
34860,34860,BC76CCD190FA1A5238AAD9129E2B96C9,40463,6,8,2,38,49,1949
34861,34861,BC76CCD190FA1A5238AAD9129E2B96C9,43281,9,11,2,37,48,1898
34862,34862,BC76CCD190FA1A5238AAD9129E2B96C9,11231,13,17,4,37,49,1899
34863,34863,BC76CCD190FA1A5238AAD9129E2B96C9,11271,20,23,3,37,48,1898
34867,34867,B95248A393261A4557DDFBDFBDBBE5C4,10221,0,8,8,34,49,1749
34868,34868,B95248A393261A4557DDFBDFBDBBE5C4,10295,9,11,2,30,47,1547
34869,34869,B95248A393261A4557DDFBDFBDBBE5C4,42523,11,13,2,31,47,1597
34870,34870,B95248A393261A4557DDFBDFBDBBE5C4,10295,15,18,3,30,47,1547
34871,34871,B95248A393261A4557DDFBDFBDBBE5C4,40882,18,23,5,34,49,1749
34875,34875,E88F39A65DCBFC647F6F44FF9039942F,12601,0,3,3,25,47,1297
34876,34876,E88F39A65DCBFC647F6F44FF9039942F,10634,4,13,9,27,45,1395
34877,34877,E88F39A65DCBFC647F6F44FF9039942F,13671,15,18,3,27,43,1393
34881,34881,76A84ED3D9838C789BD1A23EFB9BEE14,43061,0,6,6,43,46,2196
34882,34882,76A84ED3D9838C789BD1A23EFB9BEE14,13791,7,12,5,42,47,2147
34883,34883,76A84ED3D9838C789BD1A23EFB9BEE14,40951,17,18,1,36,49,1849
34884,34884,76A84ED3D9838C789BD1A23EFB9BEE14,12381,19,21,2,32,48,1648
34888,34888,0DDE82B46B6AFEAE992F7B7E010F1315,10151,0,8,8,34,47,1747
34889,34889,0DDE82B46B6AFEAE992F7B7E010F1315,40341,9,12,3,23,49,1199
34890,34890,0DDE82B46B6AFEAE992F7B7E010F1315,10151,18,23,5,34,47,1747
34894,34894,B5CE2B505EF1F2F117AA6F6CD61D03CB,11901,0,7,7,42,49,2149
34895,34895,B5CE2B505EF1F2F117AA6F6CD61D03CB,40341,11,14,3,23,49,1199
34896,34896,B5CE2B505EF1F2F117AA6F6CD61D03CB,12514,14,16,2,38,47,1947
34897,34897,B5CE2B505EF1F2F117AA6F6CD61D03CB,11301,17,18,1,41,49,2099
34898,34898,AF3BB2EB266D8BDC31553ED7C05B56FE,13671,3,7,4,27,43,1393
34899,34899,AF3BB2EB266D8BDC31553ED7C05B56FE,42151,9,11,2,35,45,1795
34900,34900,AF3BB2EB266D8BDC31553ED7C05B56FE,12311,15,17,2,30,44,1544
34901,34901,AF3BB2EB266D8BDC31553ED7C05B56FE,42151,21,22,1,35,45,1795
34905,34905,FC160433D15C688CE5726786D1AE9A44,40347,0,8,8,25,49,1299
34906,34906,FC160433D15C688CE5726786D1AE9A44,40343,11,17,6,24,49,1249
34907,34907,FC160433D15C688CE5726786D1AE9A44,11331,22,23,1,37,48,1898
34912,34912,A3888D7EAB222A3AD73AFFD8C3BCBF92,11831,0,7,7,32,45,1645
34913,34913,A3888D7EAB222A3AD73AFFD8C3BCBF92,10251,8,21,13,35,47,1797
34914,34914,A3888D7EAB222A3AD73AFFD8C3BCBF92,11831,21,22,1,32,45,1645
34919,34919,344A3CF0E215A1C44A25A9F391805F64,12921,0,7,7,9,41,491
34920,34920,344A3CF0E215A1C44A25A9F391805F64,10471,11,16,5,37,48,1898
34921,34921,344A3CF0E215A1C44A25A9F391805F64,12921,20,21,1,9,41,491
34936,34936,7F73EEE1198B300F5190B9A740E251E3,13911,5,6,1,39,46,1996
34937,34937,7F73EEE1198B300F5190B9A740E251E3,11261,9,11,2,36,46,1846
34938,34938,7F73EEE1198B300F5190B9A740E251E3,13911,13,15,2,39,46,1996
34939,34939,7F73EEE1198B300F5190B9A740E251E3,12491,17,19,2,36,43,1843
34940,34940,7F73EEE1198B300F5190B9A740E251E3,13911,20,23,3,39,46,1996
34941,34941,312060B326A149D1F0009EDC937831B5,10251,0,7,7,35,47,1797
34942,34942,312060B326A149D1F0009EDC937831B5,13071,11,12,1,41,41,2091
34943,34943,312060B326A149D1F0009EDC937831B5,10111,16,22,6,37,47,1897
34947,34947,AA541C733BB5F99408992FE5EC11F72D,13461,0,4,4,39,44,1994
34948,34948,AA541C733BB5F99408992FE5EC11F72D,42861,6,16,10,37,44,1894
34949,34949,AA541C733BB5F99408992FE5EC11F72D,11261,19,22,3,36,46,1846
34953,34953,EFA18B326F5752ABB01E6830CBCEF37F,13371,0,1,1,41,47,2097
34954,34954,EFA18B326F5752ABB01E6830CBCEF37F,13011,2,7,5,39,47,1997
34955,34955,EFA18B326F5752ABB01E6830CBCEF37F,10801,9,14,5,42,47,2147
34956,34956,EFA18B326F5752ABB01E6830CBCEF37F,13111,18,20,2,42,46,2146
34957,34957,EFA18B326F5752ABB01E6830CBCEF37F,13371,20,23,3,41,47,2097
34958,34958,63D46256AD6F86C8491C2B2581A93893,11291,0,5,5,40,49,2049
34959,34959,63D46256AD6F86C8491C2B2581A93893,11541,8,15,7,35,49,1799
34960,34960,63D46256AD6F86C8491C2B2581A93893,11291,19,23,4,40,49,2049
34961,34961,B0EA338E7DC6DCA36F1815FAB86B9F0C,11921,0,8,8,38,48,1948
34962,34962,B0EA338E7DC6DCA36F1815FAB86B9F0C,11861,12,13,1,32,47,1647
34963,34963,B0EA338E7DC6DCA36F1815FAB86B9F0C,10881,17,18,1,34,48,1748
34964,34964,B0EA338E7DC6DCA36F1815FAB86B9F0C,11921,19,23,4,38,48,1948
34965,34965,2B75D649D733D42AAC85CA634BF0D07B,42581,3,6,3,38,48,1948
34966,34966,2B75D649D733D42AAC85CA634BF0D07B,11914,9,11,2,37,48,1898
34967,34967,2B75D649D733D42AAC85CA634BF0D07B,42581,11,12,1,38,48,1948
34968,34968,2B75D649D733D42AAC85CA634BF0D07B,11914,14,15,1,37,48,1898
34969,34969,2B75D649D733D42AAC85CA634BF0D07B,42581,19,21,2,38,48,1948
34970,34970,4A69CEF881C930B26BF97D2854913ACB,43951,0,6,6,49,41,2491
34971,34971,4A69CEF881C930B26BF97D2854913ACB,43101,6,7,1,46,40,2340
34972,34972,4A69CEF881C930B26BF97D2854913ACB,43951,8,9,1,49,41,2491
34973,34973,4A69CEF881C930B26BF97D2854913ACB,43101,9,11,2,46,40,2340
34974,34974,4A69CEF881C930B26BF97D2854913ACB,43951,11,21,10,49,41,2491
34982,34982,284847A3C6721710FAF6E0CFEF216C5D,42521,0,15,15,31,47,1597
34983,34983,284847A3C6721710FAF6E0CFEF216C5D,12021,18,20,2,37,49,1899
34984,34984,284847A3C6721710FAF6E0CFEF216C5D,42521,21,23,2,31,47,1597
34985,34985,72272CDC285000236363EA14A7DE70DE,42301,0,7,7,36,47,1847
34986,34986,72272CDC285000236363EA14A7DE70DE,13141,12,14,2,23,30,1180
34987,34987,72272CDC285000236363EA14A7DE70DE,42031,17,19,2,40,46,2046
34988,34988,72272CDC285000236363EA14A7DE70DE,13791,19,20,1,42,47,2147
34989,34989,72272CDC285000236363EA14A7DE70DE,13841,21,23,2,40,46,2046
34990,34990,A992065279A55CB166B571950C59E281,43761,2,6,4,32,47,1647
34991,34991,A992065279A55CB166B571950C59E281,11021,8,13,5,36,49,1849
34992,34992,A992065279A55CB166B571950C59E281,11751,19,21,2,35,48,1798
34993,34993,0FD2E1FFD3EECE34FFF4C58B6016F8F2,11061,1,17,16,29,48,1498
34994,34994,0FD2E1FFD3EECE34FFF4C58B6016F8F2,13731,18,20,2,33,49,1699
34995,34995,0FD2E1FFD3EECE34FFF4C58B6016F8F2,11061,20,23,3,29,48,1498
34996,34996,C4D6D6893D15A40EF6C21B7CBC7CED3E,11861,1,7,6,32,47,1647
34997,34997,C4D6D6893D15A40EF6C21B7CBC7CED3E,11541,8,17,9,35,49,1799
34998,34998,C4D6D6893D15A40EF6C21B7CBC7CED3E,42021,21,22,1,33,47,1697
35003,35003,619B4993323BBB76F010058331D5BCE1,12491,0,6,6,36,43,1843
35004,35004,619B4993323BBB76F010058331D5BCE1,11261,6,11,5,36,46,1846
35005,35005,619B4993323BBB76F010058331D5BCE1,13911,16,23,7,39,46,1996
35006,35006,502BA7C99D6C789C99C98C286A11AFF4,43011,0,14,14,40,42,2042
35007,35007,502BA7C99D6C789C99C98C286A11AFF4,12221,15,16,1,43,44,2194
35008,35008,502BA7C99D6C789C99C98C286A11AFF4,43011,18,20,2,40,42,2042
35009,35009,502BA7C99D6C789C99C98C286A11AFF4,43051,21,22,1,46,45,2345
35010,35010,BC71A128CC1D1FD204F1FA3A371EA53A,43021,0,6,6,16,43,843
35011,35011,BC71A128CC1D1FD204F1FA3A371EA53A,12921,11,17,6,9,41,491
35012,35012,BC71A128CC1D1FD204F1FA3A371EA53A,43021,19,22,3,16,43,843
35013,35013,1B550A18B0397F926248F9A2C7B0A9DE,42341,0,8,8,43,49,2199
35014,35014,1B550A18B0397F926248F9A2C7B0A9DE,10221,11,14,3,34,49,1749
35015,35015,1B550A18B0397F926248F9A2C7B0A9DE,11954,15,16,1,32,49,1649
35016,35016,1B550A18B0397F926248F9A2C7B0A9DE,41591,19,20,1,34,49,1749
35017,35017,60F7A36E30F2A6AA75D382D47BF81CD3,10111,0,8,8,37,47,1897
35018,35018,60F7A36E30F2A6AA75D382D47BF81CD3,42161,10,11,1,36,47,1847
35019,35019,60F7A36E30F2A6AA75D382D47BF81CD3,10111,11,15,4,37,47,1897
35020,35020,60F7A36E30F2A6AA75D382D47BF81CD3,42161,19,21,2,36,47,1847
35021,35021,60F7A36E30F2A6AA75D382D47BF81CD3,42141,22,23,1,32,47,1647
35022,35022,B407E10E40F14F417BB48241B7C62C97,40833,0,6,6,41,47,2097
35023,35023,B407E10E40F14F417BB48241B7C62C97,10431,10,11,1,33,49,1699
35024,35024,B407E10E40F14F417BB48241B7C62C97,10107,11,17,6,38,49,1949
35025,35025,B407E10E40F14F417BB48241B7C62C97,13271,20,23,3,41,47,2097
35029,35029,02FDECAE0BC51A3A01B6057BDA9491B1,11151,3,4,1,30,48,1548
35030,35030,02FDECAE0BC51A3A01B6057BDA9491B1,43731,7,8,1,34,47,1747
35031,35031,02FDECAE0BC51A3A01B6057BDA9491B1,10971,8,16,8,35,47,1797
35032,35032,02FDECAE0BC51A3A01B6057BDA9491B1,43731,20,21,1,34,47,1747
35033,35033,9E8650B76E9047B63AD694EBC9D1BFBC,13941,0,1,1,41,47,2097
35034,35034,9E8650B76E9047B63AD694EBC9D1BFBC,42321,2,4,2,43,47,2197
35035,35035,9E8650B76E9047B63AD694EBC9D1BFBC,10631,5,7,2,28,46,1446
35036,35036,9E8650B76E9047B63AD694EBC9D1BFBC,10634,9,10,1,27,45,1395
35037,35037,9E8650B76E9047B63AD694EBC9D1BFBC,10631,11,15,4,28,46,1446
35038,35038,9E8650B76E9047B63AD694EBC9D1BFBC,11875,20,21,1,30,46,1546
35045,35045,6092FD55E1EB4218296F9EE2A24CDE24,10251,0,10,10,35,47,1797
35046,35046,6092FD55E1EB4218296F9EE2A24CDE24,42161,12,13,1,36,47,1847
35047,35047,6092FD55E1EB4218296F9EE2A24CDE24,43731,14,15,1,34,47,1747
35048,35048,6092FD55E1EB4218296F9EE2A24CDE24,40341,16,18,2,23,49,1199
35049,35049,6092FD55E1EB4218296F9EE2A24CDE24,10221,19,21,2,34,49,1749
35050,35050,6092FD55E1EB4218296F9EE2A24CDE24,42471,21,22,1,35,49,1799
35051,35051,C353889D9869D7F45F6E144219992470,12514,0,7,7,38,47,1947
35052,35052,C353889D9869D7F45F6E144219992470,10841,7,9,2,37,47,1897
35053,35053,C353889D9869D7F45F6E144219992470,43644,10,14,4,14,38,738
35054,35054,C353889D9869D7F45F6E144219992470,19181,14,15,1,8,40,440
35055,35055,C353889D9869D7F45F6E144219992470,10841,17,19,2,37,47,1897
35056,35056,C353889D9869D7F45F6E144219992470,12511,19,23,4,39,47,1997
35063,35063,D157376C3B3C86905830B8BD99123913,11941,0,8,8,37,46,1896
35064,35064,D157376C3B3C86905830B8BD99123913,12541,12,13,1,37,35,1885
35065,35065,D157376C3B3C86905830B8BD99123913,42021,15,16,1,33,47,1697
35066,35066,D157376C3B3C86905830B8BD99123913,11861,17,19,2,32,47,1647
35067,35067,D157376C3B3C86905830B8BD99123913,11151,21,22,1,30,48,1548
35071,35071,75EAA5D5D7B6FE8ECEA0752A1CC7D80F,12921,0,9,9,9,41,491
35072,35072,75EAA5D5D7B6FE8ECEA0752A1CC7D80F,40951,13,15,2,36,49,1849
35073,35073,75EAA5D5D7B6FE8ECEA0752A1CC7D80F,19621,17,23,6,5,46,296
35080,35080,39E8FB5C4AE9A0E0783441178F244CD5,10341,0,7,7,31,47,1597
35081,35081,39E8FB5C4AE9A0E0783441178F244CD5,11201,9,13,4,35,49,1799
35082,35082,39E8FB5C4AE9A0E0783441178F244CD5,11781,14,15,1,38,49,1949
35083,35083,39E8FB5C4AE9A0E0783441178F244CD5,10341,16,23,7,31,47,1597
35084,35084,9F08D51AB5A713D9DA81349F9F08E5F1,13601,0,3,3,34,47,1747
35085,35085,9F08D51AB5A713D9DA81349F9F08E5F1,42461,4,15,11,45,47,2297
35086,35086,9F08D51AB5A713D9DA81349F9F08E5F1,42204,19,22,3,43,46,2196
35087,35087,2FCC231DE348255A3F9CDA8D77EEA7DC,12581,0,5,5,24,48,1248
35088,35088,2FCC231DE348255A3F9CDA8D77EEA7DC,12051,5,10,5,20,47,1047
35089,35089,2FCC231DE348255A3F9CDA8D77EEA7DC,42541,10,13,3,25,47,1297
35090,35090,2FCC231DE348255A3F9CDA8D77EEA7DC,12581,14,23,9,24,48,1248
35091,35091,F8584A5277683398A2423E9367C858A2,40833,0,7,7,41,47,2097
35092,35092,F8584A5277683398A2423E9367C858A2,19744,9,15,6,6,43,343
35093,35093,F8584A5277683398A2423E9367C858A2,40833,17,21,4,41,47,2097
35094,35094,505FF343C6E446E7F99CFC0B5C13724B,13341,0,8,8,44,45,2245
35095,35095,505FF343C6E446E7F99CFC0B5C13724B,11541,9,10,1,35,49,1799
35096,35096,505FF343C6E446E7F99CFC0B5C13724B,13341,17,19,2,44,45,2245
35103,35103,CB89340A1F14607CB686C927E90B3821,10111,0,1,1,37,47,1897
35104,35104,CB89340A1F14607CB686C927E90B3821,42161,2,5,3,36,47,1847
35105,35105,CB89340A1F14607CB686C927E90B3821,10111,5,6,1,37,47,1897
35106,35106,CB89340A1F14607CB686C927E90B3821,42161,6,10,4,36,47,1847
35107,35107,CB89340A1F14607CB686C927E90B3821,10111,11,23,12,37,47,1897
35108,35108,08512C33BFE94ECF8502F4C4E647BC76,12141,0,11,11,42,45,2145
35109,35109,08512C33BFE94ECF8502F4C4E647BC76,40341,15,17,2,23,49,1199
35110,35110,08512C33BFE94ECF8502F4C4E647BC76,12141,18,19,1,42,45,2145
35111,35111,F7F6E311089E545E2ADE21E1CFF4D206,42921,2,6,4,33,47,1697
35112,35112,F7F6E311089E545E2ADE21E1CFF4D206,13601,7,8,1,34,47,1747
35113,35113,F7F6E311089E545E2ADE21E1CFF4D206,42921,11,14,3,33,47,1697
35114,35114,F7F6E311089E545E2ADE21E1CFF4D206,11861,14,15,1,32,47,1647
35115,35115,F7F6E311089E545E2ADE21E1CFF4D206,42921,16,18,2,33,47,1697
35116,35116,F7F6E311089E545E2ADE21E1CFF4D206,40636,21,23,2,35,48,1798
35120,35120,BCBB915A68F656D68AA2B85F9E93EB53,11381,0,10,10,30,47,1547
35121,35121,BCBB915A68F656D68AA2B85F9E93EB53,12391,10,12,2,36,49,1849
35122,35122,BCBB915A68F656D68AA2B85F9E93EB53,11381,13,15,2,30,47,1547
35123,35123,BCBB915A68F656D68AA2B85F9E93EB53,11831,15,19,4,32,45,1645
35124,35124,BCBB915A68F656D68AA2B85F9E93EB53,40331,20,23,3,30,47,1547
35125,35125,878BD48D7FC4D4EFC8601CC50E507D8D,12641,0,10,10,10,43,543
35126,35126,878BD48D7FC4D4EFC8601CC50E507D8D,43644,11,13,2,14,38,738
35127,35127,878BD48D7FC4D4EFC8601CC50E507D8D,12641,14,23,9,10,43,543
35128,35128,48D09EA1E123F030FD71CF37426D4799,42151,0,5,5,35,45,1795
35129,35129,48D09EA1E123F030FD71CF37426D4799,43011,8,9,1,40,42,2042
35130,35130,48D09EA1E123F030FD71CF37426D4799,42151,11,12,1,35,45,1795
35131,35131,48D09EA1E123F030FD71CF37426D4799,43011,13,15,2,40,42,2042
35132,35132,48D09EA1E123F030FD71CF37426D4799,42151,16,20,4,35,45,1795
35133,35133,48D09EA1E123F030FD71CF37426D4799,12211,21,22,1,41,44,2094
35140,35140,B694D2E9AE9172ACEBD42D7BCF42B07A,42341,9,12,3,43,49,2199
35141,35141,B694D2E9AE9172ACEBD42D7BCF42B07A,42131,14,16,2,44,48,2248
35142,35142,B694D2E9AE9172ACEBD42D7BCF42B07A,11331,21,23,2,37,48,1898
35143,35143,51591F8EA07D8177C3E0ABFE6A0BF706,42623,0,5,5,22,49,1149
35144,35144,51591F8EA07D8177C3E0ABFE6A0BF706,13731,16,17,1,33,49,1699
35145,35145,51591F8EA07D8177C3E0ABFE6A0BF706,42623,18,21,3,22,49,1149
35146,35146,135EF939D99CED11694D71795A5772B0,19031,2,10,8,1,42,92
35147,35147,135EF939D99CED11694D71795A5772B0,12641,10,18,8,10,43,543
35148,35148,135EF939D99CED11694D71795A5772B0,19031,19,22,3,1,42,92
35149,35149,67BCB76F611F63115F44CBB7619B7D68,43161,0,6,6,35,47,1797
35150,35150,67BCB76F611F63115F44CBB7619B7D68,11641,8,16,8,22,49,1149
35151,35151,67BCB76F611F63115F44CBB7619B7D68,43161,18,19,1,35,47,1797
35152,35152,67BCB76F611F63115F44CBB7619B7D68,12841,21,22,1,37,47,1897
35153,35153,14A26121D61284733518359391469C97,19571,0,4,4,1,36,86
35154,35154,14A26121D61284733518359391469C97,43644,5,16,11,14,38,738
35155,35155,14A26121D61284733518359391469C97,19571,20,23,3,1,36,86
35159,35159,0324B4BC4AC52B5FF38CABDD51C922F7,42141,0,5,5,32,47,1647
35160,35160,0324B4BC4AC52B5FF38CABDD51C922F7,12561,7,14,7,45,43,2293
35161,35161,0324B4BC4AC52B5FF38CABDD51C922F7,43011,15,16,1,40,42,2042
35162,35162,0324B4BC4AC52B5FF38CABDD51C922F7,42141,20,22,2,32,47,1647
35163,35163,143643B5EFA649E9AD25DE30A64DE053,11331,2,17,15,37,48,1898
35164,35164,143643B5EFA649E9AD25DE30A64DE053,40341,19,21,2,23,49,1199
35165,35165,143643B5EFA649E9AD25DE30A64DE053,43481,22,23,1,39,48,1998
35166,35166,D96201B04F49DA8FE5B344343C2EC845,10061,0,1,1,20,46,1046
35167,35167,D96201B04F49DA8FE5B344343C2EC845,11861,5,16,11,32,47,1647
35168,35168,D96201B04F49DA8FE5B344343C2EC845,42151,20,21,1,35,45,1795
35169,35169,D96201B04F49DA8FE5B344343C2EC845,12601,22,23,1,25,47,1297
35170,35170,7B27DF400F344F6F46338A9F907AAD49,19021,0,6,6,10,45,545
35171,35171,7B27DF400F344F6F46338A9F907AAD49,12641,7,18,11,10,43,543
35172,35172,7B27DF400F344F6F46338A9F907AAD49,43021,19,20,1,16,43,843
35173,35173,7B27DF400F344F6F46338A9F907AAD49,19021,20,23,3,10,45,545
35181,35181,5767DCB7927C2A22DA225038742C1BCE,13561,0,7,7,37,49,1899
35182,35182,5767DCB7927C2A22DA225038742C1BCE,11021,8,11,3,36,49,1849
35183,35183,5767DCB7927C2A22DA225038742C1BCE,13561,11,13,2,37,49,1899
35184,35184,5767DCB7927C2A22DA225038742C1BCE,11021,14,18,4,36,49,1849
35185,35185,5767DCB7927C2A22DA225038742C1BCE,13561,20,23,3,37,49,1899
35186,35186,8244C739056CFAB1A42C3D6A00AFAF26,19181,0,13,13,8,40,440
35187,35187,8244C739056CFAB1A42C3D6A00AFAF26,12641,16,17,1,10,43,543
35188,35188,8244C739056CFAB1A42C3D6A00AFAF26,19181,19,20,1,8,40,440
35196,35196,8F2DCDB1E6ACA3D4E7FFFCA1E99BF72D,10292,6,7,1,30,47,1547
35197,35197,8F2DCDB1E6ACA3D4E7FFFCA1E99BF72D,43161,10,11,1,35,47,1797
35198,35198,8F2DCDB1E6ACA3D4E7FFFCA1E99BF72D,42021,14,15,1,33,47,1697
35199,35199,8F2DCDB1E6ACA3D4E7FFFCA1E99BF72D,43161,16,18,2,35,47,1797
35216,35216,46624C7A7A05E81084BABC40FE8F937C,13314,0,14,14,31,39,1589
35217,35217,46624C7A7A05E81084BABC40FE8F937C,12521,16,18,2,35,41,1791
35218,35218,46624C7A7A05E81084BABC40FE8F937C,13314,22,23,1,31,39,1589
35226,35226,D1B134FECA3DB6C7BE84FCB03A2CF8F7,10661,0,16,16,37,49,1899
35227,35227,D1B134FECA3DB6C7BE84FCB03A2CF8F7,19901,19,21,2,7,44,394
35228,35228,D1B134FECA3DB6C7BE84FCB03A2CF8F7,11781,21,22,1,38,49,1949
35229,35229,FE72309A49FBEB6B76C0E42028E74707,19441,0,2,2,8,46,446
35230,35230,FE72309A49FBEB6B76C0E42028E74707,11571,6,8,2,13,46,696
35231,35231,FE72309A49FBEB6B76C0E42028E74707,19441,13,14,1,8,46,446
35232,35232,FE72309A49FBEB6B76C0E42028E74707,42041,15,21,6,10,47,547
35236,35236,73118727834AEF72D14D5BE83EC91BD1,11001,2,5,3,42,47,2147
35237,35237,73118727834AEF72D14D5BE83EC91BD1,10251,10,11,1,35,47,1797
35238,35238,73118727834AEF72D14D5BE83EC91BD1,11074,13,17,4,37,47,1897
35239,35239,73118727834AEF72D14D5BE83EC91BD1,11001,19,20,1,42,47,2147
35246,35246,69601DFFFCF880DD8BF9BB911205AC6A,11861,3,10,7,32,47,1647
35247,35247,69601DFFFCF880DD8BF9BB911205AC6A,13651,11,12,1,30,47,1547
35248,35248,69601DFFFCF880DD8BF9BB911205AC6A,10651,14,16,2,36,49,1849
35249,35249,69601DFFFCF880DD8BF9BB911205AC6A,11381,18,19,1,30,47,1547
35253,35253,A6E7C9F768A521D8C9E298A4B1559383,43181,0,1,1,39,48,1998
35254,35254,A6E7C9F768A521D8C9E298A4B1559383,42581,2,6,4,38,48,1948
35255,35255,A6E7C9F768A521D8C9E298A4B1559383,11914,8,12,4,37,48,1898
35256,35256,A6E7C9F768A521D8C9E298A4B1559383,42581,16,17,1,38,48,1948
35257,35257,A6E7C9F768A521D8C9E298A4B1559383,11914,18,21,3,37,48,1898
35272,35272,2317EEF942E511029895E416C1875CE5,19021,0,1,1,10,45,545
35273,35273,2317EEF942E511029895E416C1875CE5,10281,4,13,9,33,48,1698
35274,35274,2317EEF942E511029895E416C1875CE5,11541,13,14,1,35,49,1799
35275,35275,2317EEF942E511029895E416C1875CE5,10281,14,16,2,33,48,1698
35276,35276,2317EEF942E511029895E416C1875CE5,11061,17,23,6,29,48,1498
35277,35277,D9026A3CE10A3841EFEE0C49DAE389C6,12641,0,5,5,10,43,543
35278,35278,D9026A3CE10A3841EFEE0C49DAE389C6,19114,6,10,4,7,43,393
35279,35279,D9026A3CE10A3841EFEE0C49DAE389C6,12641,12,13,1,10,43,543
35280,35280,D9026A3CE10A3841EFEE0C49DAE389C6,19114,13,18,5,7,43,393
35281,35281,D9026A3CE10A3841EFEE0C49DAE389C6,12641,19,20,1,10,43,543
35282,35282,33DCEB99733F5490EC3E4641096F98E9,11861,0,8,8,32,47,1647
35283,35283,33DCEB99733F5490EC3E4641096F98E9,42861,11,15,4,37,44,1894
35284,35284,33DCEB99733F5490EC3E4641096F98E9,10271,18,20,2,37,46,1896
35289,35289,F587F66602084AF6E62D2423843D131D,43751,0,4,4,19,48,998
35290,35290,F587F66602084AF6E62D2423843D131D,10501,6,9,3,22,46,1146
35291,35291,F587F66602084AF6E62D2423843D131D,43751,12,23,11,19,48,998
35292,35292,C7DA09D84BB6D5A3ABEAD976C8C0731E,42861,0,5,5,37,44,1894
35293,35293,C7DA09D84BB6D5A3ABEAD976C8C0731E,11261,6,7,1,36,46,1846
35294,35294,C7DA09D84BB6D5A3ABEAD976C8C0731E,42861,11,13,2,37,44,1894
35295,35295,C7DA09D84BB6D5A3ABEAD976C8C0731E,11261,14,15,1,36,46,1846
35296,35296,C7DA09D84BB6D5A3ABEAD976C8C0731E,42861,18,23,5,37,44,1894
35323,35323,004D26DDA49F4E295E56D0D4EFA58427,10901,1,3,2,35,48,1798
35324,35324,004D26DDA49F4E295E56D0D4EFA58427,16071,5,14,9,3,3,153
35325,35325,004D26DDA49F4E295E56D0D4EFA58427,16211,19,23,4,4,3,203
35326,35326,2C3A1C890B30FB06A95DD4A9EF742265,19801,0,5,5,19,26,976
35327,35327,2C3A1C890B30FB06A95DD4A9EF742265,43121,6,9,3,25,27,1277
35328,35328,2C3A1C890B30FB06A95DD4A9EF742265,19801,13,23,10,19,26,976
35332,35332,6B78BA76894FB2D58CB6C48FC3CBEEF5,12311,0,4,4,30,44,1544
35333,35333,6B78BA76894FB2D58CB6C48FC3CBEEF5,10351,5,6,1,28,45,1445
35334,35334,6B78BA76894FB2D58CB6C48FC3CBEEF5,12311,6,8,2,30,44,1544
35335,35335,6B78BA76894FB2D58CB6C48FC3CBEEF5,10351,9,11,2,28,45,1445
35336,35336,6B78BA76894FB2D58CB6C48FC3CBEEF5,42231,15,18,3,37,46,1896
35337,35337,6B78BA76894FB2D58CB6C48FC3CBEEF5,10331,19,21,2,39,46,1996
35338,35338,29ED7585A7C0FD6B2E71E72A2B2372DE,42531,0,6,6,31,45,1595
35339,35339,29ED7585A7C0FD6B2E71E72A2B2372DE,11491,8,19,11,36,47,1847
35340,35340,29ED7585A7C0FD6B2E71E72A2B2372DE,42531,19,20,1,31,45,1595
35344,35344,C2875B036EF11350C84A956D5F7E5E6B,11061,0,1,1,29,48,1498
35345,35345,C2875B036EF11350C84A956D5F7E5E6B,40445,2,8,6,30,48,1548
35346,35346,C2875B036EF11350C84A956D5F7E5E6B,11061,12,14,2,29,48,1498
35347,35347,C2875B036EF11350C84A956D5F7E5E6B,40445,14,17,3,30,48,1548
35348,35348,C2875B036EF11350C84A956D5F7E5E6B,11061,19,20,1,29,48,1498
35349,35349,C2875B036EF11350C84A956D5F7E5E6B,40445,22,23,1,30,48,1548
35356,35356,FD9B1E1B13E838B2D5C0AE55FDD620A6,42791,0,8,8,35,45,1795
35357,35357,FD9B1E1B13E838B2D5C0AE55FDD620A6,10107,10,14,4,38,49,1949
35358,35358,FD9B1E1B13E838B2D5C0AE55FDD620A6,42791,15,18,3,35,45,1795
35359,35359,FD9B1E1B13E838B2D5C0AE55FDD620A6,11074,20,22,2,37,47,1897
35360,35360,7B4D6C9531BEA5C5F58764B7492E11BF,15641,0,6,6,9,21,471
35361,35361,7B4D6C9531BEA5C5F58764B7492E11BF,12871,7,8,1,22,33,1133
35362,35362,7B4D6C9531BEA5C5F58764B7492E11BF,19281,13,18,5,16,32,832
35367,35367,8EA53D8E1525E5DC764AA8B750C1926A,13411,1,2,1,49,42,2492
35368,35368,8EA53D8E1525E5DC764AA8B750C1926A,43951,5,9,4,49,41,2491
35369,35369,8EA53D8E1525E5DC764AA8B750C1926A,13411,11,19,8,49,42,2492
35370,35370,8EA53D8E1525E5DC764AA8B750C1926A,42301,21,22,1,36,47,1847
35375,35375,69BBAE4682F3941525E6F24ACF9BEA8A,12381,0,9,9,32,48,1648
35376,35376,69BBAE4682F3941525E6F24ACF9BEA8A,11954,9,12,3,32,49,1649
35377,35377,69BBAE4682F3941525E6F24ACF9BEA8A,10431,13,17,4,33,49,1699
35378,35378,69BBAE4682F3941525E6F24ACF9BEA8A,11701,19,22,3,43,48,2198
35383,35383,508A53F3E777F5ECDE2E5B976BFD7315,13911,10,11,1,39,46,1996
35384,35384,508A53F3E777F5ECDE2E5B976BFD7315,42351,12,14,2,38,45,1945
35385,35385,508A53F3E777F5ECDE2E5B976BFD7315,42231,14,16,2,37,46,1896
35386,35386,508A53F3E777F5ECDE2E5B976BFD7315,42351,16,17,1,38,45,1945
35387,35387,508A53F3E777F5ECDE2E5B976BFD7315,42231,20,23,3,37,46,1896
35388,35388,A630107A8EA694FA1AD17F13B8C68780,13511,2,11,9,34,48,1748
35389,35389,A630107A8EA694FA1AD17F13B8C68780,40951,14,15,1,36,49,1849
35390,35390,A630107A8EA694FA1AD17F13B8C68780,19114,18,19,1,7,43,393
35398,35398,2C985E374948E01B1511C56B4538B456,42861,0,5,5,37,44,1894
35399,35399,2C985E374948E01B1511C56B4538B456,11261,8,9,1,36,46,1846
35400,35400,2C985E374948E01B1511C56B4538B456,42861,11,13,2,37,44,1894
35401,35401,2C985E374948E01B1511C56B4538B456,11261,13,18,5,36,46,1846
35402,35402,2C985E374948E01B1511C56B4538B456,42861,21,23,2,37,44,1894
35410,35410,4C509DAD43983D918739E9C2A84598DC,11861,4,13,9,32,47,1647
35411,35411,4C509DAD43983D918739E9C2A84598DC,42971,14,16,2,43,49,2199
35412,35412,4C509DAD43983D918739E9C2A84598DC,13951,16,18,2,47,45,2395
35413,35413,4C509DAD43983D918739E9C2A84598DC,43761,22,23,1,32,47,1647
35424,35424,990529BE48C6A8DFFA6A404F72B17A5A,42861,6,10,4,37,44,1894
35425,35425,990529BE48C6A8DFFA6A404F72B17A5A,11261,12,13,1,36,46,1846
35426,35426,990529BE48C6A8DFFA6A404F72B17A5A,42861,14,15,1,37,44,1894
35427,35427,990529BE48C6A8DFFA6A404F72B17A5A,11261,19,20,1,36,46,1846
35428,35428,990529BE48C6A8DFFA6A404F72B17A5A,42861,22,23,1,37,44,1894
35432,35432,6EE4F6DB82C71BC0E14F018651F0C715,43481,0,6,6,39,48,1998
35433,35433,6EE4F6DB82C71BC0E14F018651F0C715,42271,10,12,2,40,47,2047
35434,35434,6EE4F6DB82C71BC0E14F018651F0C715,43481,13,14,1,39,48,1998
35435,35435,6EE4F6DB82C71BC0E14F018651F0C715,42621,19,20,1,24,49,1249
35436,35436,11768200DFB7170C18511E3DB0C03FED,42941,0,6,6,37,47,1897
35437,35437,11768200DFB7170C18511E3DB0C03FED,12881,10,19,9,47,22,2372
35438,35438,11768200DFB7170C18511E3DB0C03FED,15441,20,21,1,44,20,2220
35443,35443,20538B8C1777892DA77867D1D04B5D49,43761,1,3,2,32,47,1647
35444,35444,20538B8C1777892DA77867D1D04B5D49,11161,3,8,5,32,48,1648
35445,35445,20538B8C1777892DA77867D1D04B5D49,43761,10,17,7,32,47,1647
35446,35446,20538B8C1777892DA77867D1D04B5D49,11161,17,19,2,32,48,1648
35447,35447,20538B8C1777892DA77867D1D04B5D49,43761,22,23,1,32,47,1647
35448,35448,CA7675D4504FF649E5D3C79C1D770D57,10161,0,6,6,35,49,1799
35449,35449,CA7675D4504FF649E5D3C79C1D770D57,11151,6,16,10,30,48,1548
35450,35450,CA7675D4504FF649E5D3C79C1D770D57,10901,18,23,5,35,48,1798
35451,35451,FBFB039BFE202B4D733B8197A5DE9AA1,43751,0,5,5,19,48,998
35452,35452,FBFB039BFE202B4D733B8197A5DE9AA1,12051,10,13,3,20,47,1047
35453,35453,FBFB039BFE202B4D733B8197A5DE9AA1,12581,14,16,2,24,48,1248
35454,35454,FBFB039BFE202B4D733B8197A5DE9AA1,11361,16,18,2,22,48,1148
35455,35455,EBB6E8ADAA801E56A1029C697E2F9A64,11061,0,10,10,29,48,1498
35456,35456,EBB6E8ADAA801E56A1029C697E2F9A64,12601,11,13,2,25,47,1297
35457,35457,EBB6E8ADAA801E56A1029C697E2F9A64,10171,14,16,2,26,47,1347
35458,35458,EBB6E8ADAA801E56A1029C697E2F9A64,11061,16,18,2,29,48,1498
35459,35459,EBB6E8ADAA801E56A1029C697E2F9A64,10381,18,20,2,31,49,1599
35460,35460,EBB6E8ADAA801E56A1029C697E2F9A64,11061,20,23,3,29,48,1498
35487,35487,3CDE88E41494ADADB515291429110B2E,43481,0,2,2,39,48,1998
35488,35488,3CDE88E41494ADADB515291429110B2E,12514,2,3,1,38,47,1947
35489,35489,3CDE88E41494ADADB515291429110B2E,43481,3,5,2,39,48,1998
35490,35490,3CDE88E41494ADADB515291429110B2E,12514,5,6,1,38,47,1947
35491,35491,3CDE88E41494ADADB515291429110B2E,43481,6,16,10,39,48,1998
35492,35492,3CDE88E41494ADADB515291429110B2E,12511,16,17,1,39,47,1997
35493,35493,3CDE88E41494ADADB515291429110B2E,10221,18,20,2,34,49,1749
35494,35494,3CDE88E41494ADADB515291429110B2E,11461,21,22,1,37,49,1899
35505,35505,3E2728364EE0F8914C7020C6A1917CB0,42161,0,8,8,36,47,1847
35506,35506,3E2728364EE0F8914C7020C6A1917CB0,10971,13,14,1,35,47,1797
35507,35507,3E2728364EE0F8914C7020C6A1917CB0,10501,15,16,1,22,46,1146
35508,35508,3E2728364EE0F8914C7020C6A1917CB0,10971,21,22,1,35,47,1797
35512,35512,5A7048E29C457228347A8F7A9B03DD1B,42351,0,2,2,38,45,1945
35513,35513,5A7048E29C457228347A8F7A9B03DD1B,42301,2,7,5,36,47,1847
35514,35514,5A7048E29C457228347A8F7A9B03DD1B,10471,12,13,1,37,48,1898
35515,35515,5A7048E29C457228347A8F7A9B03DD1B,42581,15,16,1,38,48,1948
35516,35516,5A7048E29C457228347A8F7A9B03DD1B,10841,19,21,2,37,47,1897
35517,35517,C5BE39F043AAB34786E4C31AB48CACA0,12051,0,6,6,20,47,1047
35518,35518,C5BE39F043AAB34786E4C31AB48CACA0,42691,8,15,7,24,48,1248
35519,35519,C5BE39F043AAB34786E4C31AB48CACA0,43751,15,16,1,19,48,998
35520,35520,C5BE39F043AAB34786E4C31AB48CACA0,42691,18,19,1,24,48,1248
35521,35521,C5BE39F043AAB34786E4C31AB48CACA0,12051,21,23,2,20,47,1047
35532,35532,8AD0A849E2C76A5BE77A60097D94586A,13671,0,6,6,27,43,1393
35533,35533,8AD0A849E2C76A5BE77A60097D94586A,40341,10,12,2,23,49,1199
35534,35534,8AD0A849E2C76A5BE77A60097D94586A,11381,14,15,1,30,47,1547
35535,35535,8AD0A849E2C76A5BE77A60097D94586A,13671,18,23,5,27,43,1393
35536,35536,A2DD7BA75FCE1B5306A377D198F94491,12791,2,3,1,31,29,1579
35537,35537,A2DD7BA75FCE1B5306A377D198F94491,12792,7,8,1,34,30,1730
35538,35538,A2DD7BA75FCE1B5306A377D198F94491,15091,9,12,3,35,26,1776
35539,35539,A2DD7BA75FCE1B5306A377D198F94491,12792,15,18,3,34,30,1730
35540,35540,A2DD7BA75FCE1B5306A377D198F94491,15391,18,21,3,35,26,1776
35547,35547,83823305B701824CEA13C3092045A23D,19441,0,5,5,8,46,446
35548,35548,83823305B701824CEA13C3092045A23D,12621,6,7,1,10,48,548
35549,35549,83823305B701824CEA13C3092045A23D,19441,11,14,3,8,46,446
35550,35550,83823305B701824CEA13C3092045A23D,12621,15,16,1,10,48,548
35551,35551,83823305B701824CEA13C3092045A23D,19441,20,23,3,8,46,446
35552,35552,A845F5E6E274947D69D978D433D48E69,11914,0,9,9,37,48,1898
35553,35553,A845F5E6E274947D69D978D433D48E69,12601,10,17,7,25,47,1297
35554,35554,A845F5E6E274947D69D978D433D48E69,11914,18,20,2,37,48,1898
35558,35558,1E4ADDBFBD1C3EEA7DB4E1CBF005793C,11061,0,8,8,29,48,1498
35559,35559,1E4ADDBFBD1C3EEA7DB4E1CBF005793C,40691,12,14,2,42,48,2148
35560,35560,1E4ADDBFBD1C3EEA7DB4E1CBF005793C,40445,16,23,7,30,48,1548
35568,35568,329011D78CCD407A57D7741FD67F5153,10301,1,8,7,31,45,1595
35569,35569,329011D78CCD407A57D7741FD67F5153,10351,9,12,3,28,45,1445
35570,35570,329011D78CCD407A57D7741FD67F5153,11834,12,14,2,32,45,1645
35571,35571,329011D78CCD407A57D7741FD67F5153,10271,15,17,2,37,46,1896
35572,35572,329011D78CCD407A57D7741FD67F5153,11834,20,21,1,32,45,1645
35577,35577,E45BFF8A7B42DBE312092B84982F68A3,11861,0,6,6,32,47,1647
35578,35578,E45BFF8A7B42DBE312092B84982F68A3,11871,7,14,7,29,46,1496
35579,35579,E45BFF8A7B42DBE312092B84982F68A3,10634,14,16,2,27,45,1395
35580,35580,E45BFF8A7B42DBE312092B84982F68A3,11871,16,18,2,29,46,1496
35581,35581,E45BFF8A7B42DBE312092B84982F68A3,11861,19,23,4,32,47,1647
35582,35582,409A27121CD9E6BC90762C45B277F54C,11861,0,7,7,32,47,1647
35583,35583,409A27121CD9E6BC90762C45B277F54C,43281,9,11,2,37,48,1898
35584,35584,409A27121CD9E6BC90762C45B277F54C,11461,15,17,2,37,49,1899
35585,35585,409A27121CD9E6BC90762C45B277F54C,11861,17,22,5,32,47,1647
35586,35586,4159D43B297F1C5059F36ACC8EB9CB14,42151,3,5,2,35,45,1795
35587,35587,4159D43B297F1C5059F36ACC8EB9CB14,43751,6,10,4,19,48,998
35588,35588,4159D43B297F1C5059F36ACC8EB9CB14,12661,14,17,3,32,45,1645
35589,35589,4159D43B297F1C5059F36ACC8EB9CB14,11321,20,23,3,31,46,1596
35590,35590,37F1D2311F2383134D9A7BD374E33133,10501,0,3,3,22,46,1146
35591,35591,37F1D2311F2383134D9A7BD374E33133,43751,4,7,3,19,48,998
35592,35592,37F1D2311F2383134D9A7BD374E33133,11261,9,12,3,36,46,1846
35593,35593,37F1D2311F2383134D9A7BD374E33133,42864,13,14,1,38,44,1944
35594,35594,37F1D2311F2383134D9A7BD374E33133,11261,14,16,2,36,46,1846
35595,35595,37F1D2311F2383134D9A7BD374E33133,10501,21,22,1,22,46,1146
35596,35596,9F589AB01E58B6B2CA9FB997F96CB7F3,13071,0,5,5,41,41,2091
35597,35597,9F589AB01E58B6B2CA9FB997F96CB7F3,43451,7,11,4,37,40,1890
35598,35598,9F589AB01E58B6B2CA9FB997F96CB7F3,42381,11,13,2,39,41,1991
35599,35599,9F589AB01E58B6B2CA9FB997F96CB7F3,43451,15,16,1,37,40,1890
35600,35600,9F589AB01E58B6B2CA9FB997F96CB7F3,13071,21,23,2,41,41,2091
35601,35601,08DD8E127E963484A79CAD406FD976F9,11641,1,6,5,22,49,1149
35602,35602,08DD8E127E963484A79CAD406FD976F9,42621,7,10,3,24,49,1249
35603,35603,08DD8E127E963484A79CAD406FD976F9,11641,12,13,1,22,49,1149
35604,35604,08DD8E127E963484A79CAD406FD976F9,42621,16,17,1,24,49,1249
35605,35605,08DD8E127E963484A79CAD406FD976F9,11641,18,23,5,22,49,1149
35613,35613,D19CCADD05AE7D38BD327DD3B3A1E602,11491,1,7,6,36,47,1847
35614,35614,D19CCADD05AE7D38BD327DD3B3A1E602,42231,10,11,1,37,46,1896
35615,35615,D19CCADD05AE7D38BD327DD3B3A1E602,42351,11,13,2,38,45,1945
35616,35616,D19CCADD05AE7D38BD327DD3B3A1E602,42231,14,17,3,37,46,1896
35617,35617,D19CCADD05AE7D38BD327DD3B3A1E602,13711,21,22,1,38,46,1946
35618,35618,F40A23A3C64206CC00C54FEAD4057B67,11161,0,7,7,32,48,1648
35619,35619,F40A23A3C64206CC00C54FEAD4057B67,10221,10,15,5,34,49,1749
35620,35620,F40A23A3C64206CC00C54FEAD4057B67,42321,18,21,3,43,47,2197
35621,35621,F40A23A3C64206CC00C54FEAD4057B67,10971,22,23,1,35,47,1797
35630,35630,77E520F7CEBA79BB34C1A8DF61FF3923,42301,0,11,11,36,47,1847
35631,35631,77E520F7CEBA79BB34C1A8DF61FF3923,11021,11,13,2,36,49,1849
35632,35632,77E520F7CEBA79BB34C1A8DF61FF3923,15411,14,15,1,44,27,2227
35633,35633,77E520F7CEBA79BB34C1A8DF61FF3923,11701,20,22,2,43,48,2198
35637,35637,88EEF011B39BD7B890A7EF6400B4EB8C,12511,0,7,7,39,47,1997
35638,35638,88EEF011B39BD7B890A7EF6400B4EB8C,11171,9,10,1,33,48,1698
35639,35639,88EEF011B39BD7B890A7EF6400B4EB8C,11074,13,16,3,37,47,1897
35640,35640,88EEF011B39BD7B890A7EF6400B4EB8C,11201,20,21,1,35,49,1799
35641,35641,5BF45B486C4CF16F8A7FCFB6A5FB4FA5,11171,0,7,7,33,48,1698
35642,35642,5BF45B486C4CF16F8A7FCFB6A5FB4FA5,10251,8,10,2,35,47,1797
35643,35643,5BF45B486C4CF16F8A7FCFB6A5FB4FA5,11231,10,11,1,37,49,1899
35644,35644,5BF45B486C4CF16F8A7FCFB6A5FB4FA5,10251,12,17,5,35,47,1797
35645,35645,5BF45B486C4CF16F8A7FCFB6A5FB4FA5,12381,22,23,1,32,48,1648
35646,35646,92FB499978AE5927D502ECEF0280A31F,42511,0,3,3,37,47,1897
35647,35647,92FB499978AE5927D502ECEF0280A31F,13331,4,6,2,38,47,1947
35648,35648,92FB499978AE5927D502ECEF0280A31F,42511,6,7,1,37,47,1897
35649,35649,92FB499978AE5927D502ECEF0280A31F,12514,11,14,3,38,47,1947
35650,35650,92FB499978AE5927D502ECEF0280A31F,10841,18,19,1,37,47,1897
35651,35651,92FB499978AE5927D502ECEF0280A31F,11231,21,23,2,37,49,1899
35652,35652,2CF73DDA8C5E74B4300779F1FD471C57,12491,0,7,7,36,43,1843
35653,35653,2CF73DDA8C5E74B4300779F1FD471C57,11261,10,11,1,36,46,1846
35654,35654,2CF73DDA8C5E74B4300779F1FD471C57,12491,12,15,3,36,43,1843
35655,35655,2CF73DDA8C5E74B4300779F1FD471C57,11261,15,19,4,36,46,1846
35656,35656,2CF73DDA8C5E74B4300779F1FD471C57,12491,22,23,1,36,43,1843
35666,35666,C1CD30FCC21170A186224DCEDB85098D,10634,0,3,3,27,45,1395
35667,35667,C1CD30FCC21170A186224DCEDB85098D,11875,4,5,1,30,46,1546
35668,35668,C1CD30FCC21170A186224DCEDB85098D,42531,6,7,1,31,45,1595
35669,35669,C1CD30FCC21170A186224DCEDB85098D,11871,11,13,2,29,46,1496
35670,35670,C1CD30FCC21170A186224DCEDB85098D,42531,14,15,1,31,45,1595
35671,35671,C1CD30FCC21170A186224DCEDB85098D,11871,19,20,1,29,46,1496
35672,35672,C1CD30FCC21170A186224DCEDB85098D,11875,22,23,1,30,46,1546
35680,35680,DFA44588B9F7612E59AB24A1351E5F4F,11331,9,11,2,37,48,1898
35681,35681,DFA44588B9F7612E59AB24A1351E5F4F,40341,13,15,2,23,49,1199
35682,35682,DFA44588B9F7612E59AB24A1351E5F4F,49201,19,21,2,7,41,391
35683,35683,B45D59A19F6B61302F993D2909F39450,10491,0,8,8,33,48,1698
35684,35684,B45D59A19F6B61302F993D2909F39450,43971,8,11,3,30,48,1548
35685,35685,B45D59A19F6B61302F993D2909F39450,11061,11,14,3,29,48,1498
35686,35686,B45D59A19F6B61302F993D2909F39450,40445,15,16,1,30,48,1548
35687,35687,B45D59A19F6B61302F993D2909F39450,12031,19,23,4,33,48,1698
35692,35692,7D108BFB051387A341F75FDC13929BC0,10381,0,9,9,31,49,1599
35693,35693,7D108BFB051387A341F75FDC13929BC0,43361,11,13,2,38,48,1948
35694,35694,7D108BFB051387A341F75FDC13929BC0,10381,14,21,7,31,49,1599
35695,35695,4ECB0AF0BC82340C9B2682E9A14AD42C,11151,0,8,8,30,48,1548
35696,35696,4ECB0AF0BC82340C9B2682E9A14AD42C,40343,16,17,1,24,49,1249
35697,35697,4ECB0AF0BC82340C9B2682E9A14AD42C,11151,21,23,2,30,48,1548
35704,35704,1B914EA19E608B834149612681BFDCB4,43011,0,6,6,40,42,2042
35705,35705,1B914EA19E608B834149612681BFDCB4,12221,10,12,2,43,44,2194
35706,35706,1B914EA19E608B834149612681BFDCB4,43011,13,15,2,40,42,2042
35707,35707,1B914EA19E608B834149612681BFDCB4,12221,17,19,2,43,44,2194
35708,35708,1B914EA19E608B834149612681BFDCB4,43011,22,23,1,40,42,2042
35713,35713,5FB4300473343FD50128F198A02C672D,42071,4,16,12,31,49,1599
35714,35714,5FB4300473343FD50128F198A02C672D,42081,18,21,3,24,49,1249
35715,35715,5FB4300473343FD50128F198A02C672D,42071,22,23,1,31,49,1599
35716,35716,93C8A9BFC982F63705EDC3214DA05AC8,42471,0,3,3,35,49,1799
35717,35717,93C8A9BFC982F63705EDC3214DA05AC8,12841,4,7,3,37,47,1897
35718,35718,93C8A9BFC982F63705EDC3214DA05AC8,10411,9,10,1,36,48,1848
35719,35719,93C8A9BFC982F63705EDC3214DA05AC8,40343,12,21,9,24,49,1249
35724,35724,09C2A5500F5ABAEEAC932C07F5628EC4,11021,0,8,8,36,49,1849
35725,35725,09C2A5500F5ABAEEAC932C07F5628EC4,43161,9,12,3,35,47,1797
35726,35726,09C2A5500F5ABAEEAC932C07F5628EC4,11021,12,14,2,36,49,1849
35727,35727,09C2A5500F5ABAEEAC932C07F5628EC4,43161,14,18,4,35,47,1797
35728,35728,09C2A5500F5ABAEEAC932C07F5628EC4,11021,19,22,3,36,49,1849
35732,35732,F276DA0C0E39AE3BAD5B91AE46CB6EA8,11231,1,12,11,37,49,1899
35733,35733,F276DA0C0E39AE3BAD5B91AE46CB6EA8,10471,13,18,5,37,48,1898
35734,35734,F276DA0C0E39AE3BAD5B91AE46CB6EA8,11231,18,19,1,37,49,1899
35735,35735,F276DA0C0E39AE3BAD5B91AE46CB6EA8,42971,20,22,2,43,49,2199
35736,35736,BBCB9918D42B41DEDF16DD7F5A9BE26F,11861,0,11,11,32,47,1647
35737,35737,BBCB9918D42B41DEDF16DD7F5A9BE26F,11331,11,16,5,37,48,1898
35738,35738,BBCB9918D42B41DEDF16DD7F5A9BE26F,11861,17,23,6,32,47,1647
35742,35742,1D5FEB85097765A4DAC299D8A4D17B3D,10951,0,6,6,29,48,1498
35743,35743,1D5FEB85097765A4DAC299D8A4D17B3D,11161,7,8,1,32,48,1648
35744,35744,1D5FEB85097765A4DAC299D8A4D17B3D,10151,10,11,1,34,47,1747
35745,35745,1D5FEB85097765A4DAC299D8A4D17B3D,43311,18,20,2,31,48,1598
35746,35746,1D5FEB85097765A4DAC299D8A4D17B3D,42501,22,23,1,28,47,1447
35769,35769,C7D7B8368ECFDD4E151B86392208FA63,12661,1,2,1,32,45,1645
35770,35770,C7D7B8368ECFDD4E151B86392208FA63,12311,5,9,4,30,44,1544
35771,35771,C7D7B8368ECFDD4E151B86392208FA63,12481,14,16,2,37,49,1899
35772,35772,C7D7B8368ECFDD4E151B86392208FA63,12311,21,23,2,30,44,1544
35773,35773,CABDD8B2A8DF9C3C6F2F674E6DD5C884,11061,1,2,1,29,48,1498
35774,35774,CABDD8B2A8DF9C3C6F2F674E6DD5C884,11381,2,18,16,30,47,1547
35775,35775,CABDD8B2A8DF9C3C6F2F674E6DD5C884,10601,20,23,3,39,47,1997
35776,35776,D1161F75E2083066372593043FD61104,13331,0,3,3,38,47,1947
35777,35777,D1161F75E2083066372593043FD61104,42511,4,6,2,37,47,1897
35778,35778,D1161F75E2083066372593043FD61104,13331,7,8,1,38,47,1947
35779,35779,D1161F75E2083066372593043FD61104,42511,8,9,1,37,47,1897
35780,35780,D1161F75E2083066372593043FD61104,13331,11,22,11,38,47,1947
35787,35787,F083C7F1DD4EA05DF2E56B02B79D914A,10521,0,8,8,41,47,2097
35788,35788,F083C7F1DD4EA05DF2E56B02B79D914A,10251,10,14,4,35,47,1797
35789,35789,F083C7F1DD4EA05DF2E56B02B79D914A,10491,15,17,2,33,48,1698
35790,35790,F083C7F1DD4EA05DF2E56B02B79D914A,10251,20,23,3,35,47,1797
35791,35791,E4FD608720CF14FACCAF73A22E758728,13671,0,11,11,27,43,1393
35792,35792,E4FD608720CF14FACCAF73A22E758728,11875,14,16,2,30,46,1546
35793,35793,E4FD608720CF14FACCAF73A22E758728,11151,17,19,2,30,48,1548
35798,35798,132BAF41704DD845C2F70543C3732C4E,42231,0,1,1,37,46,1896
35799,35799,132BAF41704DD845C2F70543C3732C4E,13711,1,3,2,38,46,1946
35800,35800,132BAF41704DD845C2F70543C3732C4E,42231,5,8,3,37,46,1896
35801,35801,132BAF41704DD845C2F70543C3732C4E,13711,9,13,4,38,46,1946
35802,35802,132BAF41704DD845C2F70543C3732C4E,42231,13,16,3,37,46,1896
35803,35803,132BAF41704DD845C2F70543C3732C4E,13711,18,21,3,38,46,1946
35804,35804,04FDCC702F37E16DD9968ED131B1ACEB,13911,0,6,6,39,46,1996
35805,35805,04FDCC702F37E16DD9968ED131B1ACEB,11531,9,18,9,34,49,1749
35806,35806,04FDCC702F37E16DD9968ED131B1ACEB,42351,18,20,2,38,45,1945
35807,35807,04FDCC702F37E16DD9968ED131B1ACEB,13011,20,21,1,39,47,1997
35808,35808,04FDCC702F37E16DD9968ED131B1ACEB,13911,22,23,1,39,46,1996
35812,35812,A280969FD90AA928F73AE4BBEE919365,13101,0,6,6,40,47,2047
35813,35813,A280969FD90AA928F73AE4BBEE919365,40833,9,10,1,41,47,2097
35814,35814,A280969FD90AA928F73AE4BBEE919365,13101,11,18,7,40,47,2047
35815,35815,A280969FD90AA928F73AE4BBEE919365,13371,19,21,2,41,47,2097
35816,35816,A280969FD90AA928F73AE4BBEE919365,13101,22,23,1,40,47,2047
35824,35824,E6CC09C8EA4DC86E50A5380F4FF9CCAF,11351,5,10,5,36,48,1848
35825,35825,E6CC09C8EA4DC86E50A5380F4FF9CCAF,43121,13,14,1,25,27,1277
35826,35826,E6CC09C8EA4DC86E50A5380F4FF9CCAF,19801,17,18,1,19,26,976
35827,35827,C5A91DEC422BCFA163908CD15B529539,13011,0,12,12,39,47,1997
35828,35828,C5A91DEC422BCFA163908CD15B529539,42271,14,16,2,40,47,2047
35829,35829,C5A91DEC422BCFA163908CD15B529539,11806,16,17,1,41,48,2098
35830,35830,C5A91DEC422BCFA163908CD15B529539,13101,18,19,1,40,47,2047
35831,35831,C5A91DEC422BCFA163908CD15B529539,13011,22,23,1,39,47,1997
35832,35832,E1BB7B2CDA075A402737990C0757A672,40632,0,8,8,35,48,1798
35833,35833,E1BB7B2CDA075A402737990C0757A672,12481,12,14,2,37,49,1899
35834,35834,E1BB7B2CDA075A402737990C0757A672,11771,18,19,1,39,49,1999
35835,35835,E1BB7B2CDA075A402737990C0757A672,10161,21,22,1,35,49,1799
35836,35836,74B1AFCB5F944E1DAC044B57BB362A2A,13111,0,8,8,42,46,2146
35837,35837,74B1AFCB5F944E1DAC044B57BB362A2A,43051,12,14,2,46,45,2345
35838,35838,74B1AFCB5F944E1DAC044B57BB362A2A,40341,17,19,2,23,49,1199
35839,35839,74B1AFCB5F944E1DAC044B57BB362A2A,13111,22,23,1,42,46,2146
35840,35840,58F88D24C8D34253C1CFFF1E39E8BF81,10681,0,17,17,30,48,1548
35841,35841,58F88D24C8D34253C1CFFF1E39E8BF81,11061,18,19,1,29,48,1498
35842,35842,58F88D24C8D34253C1CFFF1E39E8BF81,40341,19,22,3,23,49,1199
35843,35843,FDF3A555382668B3FCFD730AFF8664D2,10411,0,7,7,36,48,1848
35844,35844,FDF3A555382668B3FCFD730AFF8664D2,11231,8,11,3,37,49,1899
35845,35845,FDF3A555382668B3FCFD730AFF8664D2,10411,12,13,1,36,48,1848
35846,35846,FDF3A555382668B3FCFD730AFF8664D2,10471,14,16,2,37,48,1898
35847,35847,FDF3A555382668B3FCFD730AFF8664D2,11231,16,17,1,37,49,1899
35848,35848,FDF3A555382668B3FCFD730AFF8664D2,10411,18,23,5,36,48,1848
35849,35849,A52680CFF3255B80F2E899094DC1E938,40171,0,1,1,38,48,1948
35850,35850,A52680CFF3255B80F2E899094DC1E938,13951,2,6,4,47,45,2395
35851,35851,A52680CFF3255B80F2E899094DC1E938,43951,7,10,3,49,41,2491
35852,35852,A52680CFF3255B80F2E899094DC1E938,13951,12,13,1,47,45,2395
35853,35853,A52680CFF3255B80F2E899094DC1E938,43951,16,17,1,49,41,2491
35854,35854,A52680CFF3255B80F2E899094DC1E938,13951,19,23,4,47,45,2395
35855,35855,012D304B65BB1C01DC9FFE26FE6AEE56,10111,0,9,9,37,47,1897
35856,35856,012D304B65BB1C01DC9FFE26FE6AEE56,41061,13,15,2,34,49,1749
35857,35857,012D304B65BB1C01DC9FFE26FE6AEE56,10901,17,20,3,35,48,1798
35858,35858,E92442C28CB44C67B1AFA3BE5AC81485,11541,0,4,4,35,49,1799
35859,35859,E92442C28CB44C67B1AFA3BE5AC81485,12921,5,14,9,9,41,491
35860,35860,E92442C28CB44C67B1AFA3BE5AC81485,49201,18,23,5,7,41,391
35870,35870,BCBA00BEAEB6DE0B9A71959AB040ABB5,12221,2,8,6,43,44,2194
35871,35871,BCBA00BEAEB6DE0B9A71959AB040ABB5,10281,11,13,2,33,48,1698
35872,35872,BCBA00BEAEB6DE0B9A71959AB040ABB5,11481,15,19,4,41,48,2098
35873,35873,FD926C96A4F9758B0E89829758CD18F3,10531,0,7,7,34,46,1746
35874,35874,FD926C96A4F9758B0E89829758CD18F3,40277,8,17,9,35,49,1799
35875,35875,FD926C96A4F9758B0E89829758CD18F3,11531,18,20,2,34,49,1749
35876,35876,FD926C96A4F9758B0E89829758CD18F3,10331,20,22,2,39,46,1996
35880,35880,89D5DF38DA8F80D442833FF738FFDD25,11074,0,7,7,37,47,1897
35881,35881,89D5DF38DA8F80D442833FF738FFDD25,40034,8,12,4,32,48,1648
35882,35882,89D5DF38DA8F80D442833FF738FFDD25,10161,12,14,2,35,49,1799
35883,35883,89D5DF38DA8F80D442833FF738FFDD25,12381,14,17,3,32,48,1648
35884,35884,89D5DF38DA8F80D442833FF738FFDD25,10771,20,21,1,41,46,2096
35885,35885,0315C10DA707626634C97FD0DD4A337B,10281,0,7,7,33,48,1698
35886,35886,0315C10DA707626634C97FD0DD4A337B,11861,8,10,2,32,47,1647
35887,35887,0315C10DA707626634C97FD0DD4A337B,10281,10,14,4,33,48,1698
35888,35888,0315C10DA707626634C97FD0DD4A337B,11861,14,16,2,32,47,1647
35889,35889,0315C10DA707626634C97FD0DD4A337B,10281,18,23,5,33,48,1698
35890,35890,CBDF034E68463476FF7CF3BFCDC64EE8,42941,0,7,7,37,47,1897
35891,35891,CBDF034E68463476FF7CF3BFCDC64EE8,10221,9,11,2,34,49,1749
35892,35892,CBDF034E68463476FF7CF3BFCDC64EE8,42511,11,13,2,37,47,1897
35893,35893,CBDF034E68463476FF7CF3BFCDC64EE8,40101,14,18,4,34,49,1749
35894,35894,CBDF034E68463476FF7CF3BFCDC64EE8,42511,18,20,2,37,47,1897
35895,35895,CBDF034E68463476FF7CF3BFCDC64EE8,43361,21,22,1,38,48,1948
35899,35899,B33429D7A00DB66721EA07FF9AC9AB45,11861,0,9,9,32,47,1647
35900,35900,B33429D7A00DB66721EA07FF9AC9AB45,11461,12,22,10,37,49,1899
35901,35901,B33429D7A00DB66721EA07FF9AC9AB45,11861,22,23,1,32,47,1647
35902,35902,50A8D48EEDC025C19A5AA5E39B3A8340,43761,1,7,6,32,47,1647
35903,35903,50A8D48EEDC025C19A5AA5E39B3A8340,13821,8,16,8,49,45,2495
35904,35904,50A8D48EEDC025C19A5AA5E39B3A8340,11861,17,23,6,32,47,1647
35905,35905,259F6E48951D41AE5936B8EB9EF0DFD3,42151,0,3,3,35,45,1795
35906,35906,259F6E48951D41AE5936B8EB9EF0DFD3,12211,3,7,4,41,44,2094
35907,35907,259F6E48951D41AE5936B8EB9EF0DFD3,42151,8,13,5,35,45,1795
35908,35908,259F6E48951D41AE5936B8EB9EF0DFD3,42371,17,18,1,34,46,1746
35909,35909,259F6E48951D41AE5936B8EB9EF0DFD3,42151,19,21,2,35,45,1795
35910,35910,452EB29CE3617E4C70004D20AD1B10AD,11491,1,3,2,36,47,1847
35911,35911,452EB29CE3617E4C70004D20AD1B10AD,42941,4,6,2,37,47,1897
35912,35912,452EB29CE3617E4C70004D20AD1B10AD,42301,7,8,1,36,47,1847
35913,35913,452EB29CE3617E4C70004D20AD1B10AD,10271,9,10,1,37,46,1896
35914,35914,452EB29CE3617E4C70004D20AD1B10AD,42301,12,23,11,36,47,1847
35915,35915,7D5A0E77703D6999456241ED42B99D9C,10911,0,14,14,39,46,1996
35916,35916,7D5A0E77703D6999456241ED42B99D9C,40951,15,16,1,36,49,1849
35917,35917,7D5A0E77703D6999456241ED42B99D9C,11751,19,21,2,35,48,1798
35918,35918,7D5A0E77703D6999456241ED42B99D9C,40951,21,22,1,36,49,1849
35925,35925,1F6BCFEB56D245CBF5160F742055C8A2,11151,1,7,6,30,48,1548
35926,35926,1F6BCFEB56D245CBF5160F742055C8A2,11061,7,11,4,29,48,1498
35927,35927,1F6BCFEB56D245CBF5160F742055C8A2,11151,12,14,2,30,48,1548
35928,35928,1F6BCFEB56D245CBF5160F742055C8A2,11061,14,18,4,29,48,1498
35929,35929,1F6BCFEB56D245CBF5160F742055C8A2,11151,21,23,2,30,48,1548
35930,35930,A218D71A521B998628574D399C487655,19244,1,4,3,1,43,93
35931,35931,A218D71A521B998628574D399C487655,12921,5,8,3,9,41,491
35932,35932,A218D71A521B998628574D399C487655,19181,11,13,2,8,40,440
35933,35933,A218D71A521B998628574D399C487655,19901,14,16,2,7,44,394
35934,35934,A218D71A521B998628574D399C487655,49201,18,21,3,7,41,391
35935,35935,356F6E1578C98AB3F5661AE6A4886228,42071,0,14,14,31,49,1599
35936,35936,356F6E1578C98AB3F5661AE6A4886228,42261,18,19,1,25,49,1299
35937,35937,356F6E1578C98AB3F5661AE6A4886228,42071,19,21,2,31,49,1599
35938,35938,FF0C11254BA355CCA708C36EE5C4353D,11381,0,7,7,30,47,1547
35939,35939,FF0C11254BA355CCA708C36EE5C4353D,42111,8,9,1,44,46,2246
35940,35940,FF0C11254BA355CCA708C36EE5C4353D,42201,13,14,1,43,46,2196
35941,35941,FF0C11254BA355CCA708C36EE5C4353D,42111,15,18,3,44,46,2246
35942,35942,FF0C11254BA355CCA708C36EE5C4353D,11381,18,23,5,30,47,1547
35946,35946,39AC07E35C9C929E0D6FB0AB415EDA84,10971,0,8,8,35,47,1797
35947,35947,39AC07E35C9C929E0D6FB0AB415EDA84,43731,9,10,1,34,47,1747
35948,35948,39AC07E35C9C929E0D6FB0AB415EDA84,10971,13,15,2,35,47,1797
35949,35949,39AC07E35C9C929E0D6FB0AB415EDA84,43731,15,17,2,34,47,1747
35950,35950,39AC07E35C9C929E0D6FB0AB415EDA84,10971,17,23,6,35,47,1797
35951,35951,345D4029BCC33DBFE6D7841DB885E7B2,42491,0,7,7,32,46,1646
35952,35952,345D4029BCC33DBFE6D7841DB885E7B2,42971,8,11,3,43,49,2199
35953,35953,345D4029BCC33DBFE6D7841DB885E7B2,11021,12,14,2,36,49,1849
35954,35954,345D4029BCC33DBFE6D7841DB885E7B2,11301,15,17,2,41,49,2099
35955,35955,345D4029BCC33DBFE6D7841DB885E7B2,40951,19,21,2,36,49,1849
35956,35956,E528C1BCF7730647027A4A7EFB058975,42631,0,6,6,43,45,2195
35957,35957,E528C1BCF7730647027A4A7EFB058975,13341,7,14,7,44,45,2245
35958,35958,E528C1BCF7730647027A4A7EFB058975,43061,15,16,1,43,46,2196
35959,35959,E528C1BCF7730647027A4A7EFB058975,13341,16,19,3,44,45,2245
35960,35960,E528C1BCF7730647027A4A7EFB058975,42631,19,23,4,43,45,2195
35970,35970,4512C33A5D25C12FE88068CD1CBDBC46,11921,0,4,4,38,48,1948
35971,35971,4512C33A5D25C12FE88068CD1CBDBC46,10301,5,8,3,31,45,1595
35972,35972,4512C33A5D25C12FE88068CD1CBDBC46,11914,12,18,6,37,48,1898
35973,35973,4512C33A5D25C12FE88068CD1CBDBC46,11074,19,22,3,37,47,1897
35974,35974,BFC66AC44DE3D0C3983BFF60677905F1,42511,0,6,6,37,47,1897
35975,35975,BFC66AC44DE3D0C3983BFF60677905F1,13121,8,18,10,38,46,1946
35976,35976,BFC66AC44DE3D0C3983BFF60677905F1,10381,19,20,1,31,49,1599
35977,35977,BFC66AC44DE3D0C3983BFF60677905F1,13121,21,22,1,38,46,1946
35985,35985,FF2A9B9E0E2FBE28272A9C73AC250253,13491,1,5,4,48,39,2439
35986,35986,FF2A9B9E0E2FBE28272A9C73AC250253,11381,7,10,3,30,47,1547
35987,35987,FF2A9B9E0E2FBE28272A9C73AC250253,11061,11,12,1,29,48,1498
35988,35988,FF2A9B9E0E2FBE28272A9C73AC250253,11381,16,18,2,30,47,1547
35989,35989,FF2A9B9E0E2FBE28272A9C73AC250253,11061,21,23,2,29,48,1498
35990,35990,723FE9C48BB44865402DC18F4D2F37D1,10351,1,2,1,28,45,1445
35991,35991,723FE9C48BB44865402DC18F4D2F37D1,13671,5,7,2,27,43,1393
35992,35992,723FE9C48BB44865402DC18F4D2F37D1,11381,8,9,1,30,47,1547
35993,35993,723FE9C48BB44865402DC18F4D2F37D1,40341,10,12,2,23,49,1199
35994,35994,723FE9C48BB44865402DC18F4D2F37D1,11381,13,16,3,30,47,1547
35995,35995,723FE9C48BB44865402DC18F4D2F37D1,10351,18,20,2,28,45,1445
35996,35996,723FE9C48BB44865402DC18F4D2F37D1,13091,21,23,2,20,42,1042
35997,35997,41A01DC1A08492F811E75051AA4EA6A5,11351,0,1,1,36,48,1848
35998,35998,41A01DC1A08492F811E75051AA4EA6A5,13511,2,14,12,34,48,1748
35999,35999,41A01DC1A08492F811E75051AA4EA6A5,13091,17,21,4,20,42,1042
36000,36000,5F14E1A15EFA1C13F8B10CBC543F107C,10191,0,9,9,40,48,2048
36001,36001,5F14E1A15EFA1C13F8B10CBC543F107C,19114,13,14,1,7,43,393
36002,36002,5F14E1A15EFA1C13F8B10CBC543F107C,12581,15,20,5,24,48,1248
36003,36003,5F14E1A15EFA1C13F8B10CBC543F107C,12401,21,22,1,39,49,1999
36026,36026,FADBD24FB94D9388BE2E59D5F595D57D,42161,1,9,8,36,47,1847
36027,36027,FADBD24FB94D9388BE2E59D5F595D57D,11481,12,14,2,41,48,2098
36028,36028,FADBD24FB94D9388BE2E59D5F595D57D,42201,16,17,1,43,46,2196
36029,36029,FADBD24FB94D9388BE2E59D5F595D57D,11481,18,20,2,41,48,2098
36030,36030,FADBD24FB94D9388BE2E59D5F595D57D,42161,21,22,1,36,47,1847
36031,36031,E199B3085D360FC080BC4E15FA4A56AD,12031,0,7,7,33,48,1698
36032,36032,E199B3085D360FC080BC4E15FA4A56AD,42371,7,8,1,34,46,1746
36033,36033,E199B3085D360FC080BC4E15FA4A56AD,42941,9,11,2,37,47,1897
36034,36034,E199B3085D360FC080BC4E15FA4A56AD,42161,14,15,1,36,47,1847
36035,36035,E199B3085D360FC080BC4E15FA4A56AD,43581,19,23,4,33,48,1698
36042,36042,26E97CCAAB10F50751FB25FC2D6D6457,11261,0,4,4,36,46,1846
36043,36043,26E97CCAAB10F50751FB25FC2D6D6457,42861,8,9,1,37,44,1894
36044,36044,26E97CCAAB10F50751FB25FC2D6D6457,11261,13,14,1,36,46,1846
36045,36045,26E97CCAAB10F50751FB25FC2D6D6457,42861,15,19,4,37,44,1894
36046,36046,26E97CCAAB10F50751FB25FC2D6D6457,11261,22,23,1,36,46,1846
36047,36047,F38AB0098BE65E711BE711E13E868DCB,13561,0,8,8,37,49,1899
36048,36048,F38AB0098BE65E711BE711E13E868DCB,10107,8,9,1,38,49,1949
36049,36049,F38AB0098BE65E711BE711E13E868DCB,13941,11,13,2,41,47,2097
36050,36050,F38AB0098BE65E711BE711E13E868DCB,43981,20,23,3,36,49,1849
36051,36051,E02A598CA1AD8D2358C2388838BF2E87,43751,2,5,3,19,48,998
36052,36052,E02A598CA1AD8D2358C2388838BF2E87,11261,9,16,7,36,46,1846
36053,36053,E02A598CA1AD8D2358C2388838BF2E87,10951,19,20,1,29,48,1498
36054,36054,2C4C69FF2D37C8E0A5BE3260BCFBEED1,11261,0,6,6,36,46,1846
36055,36055,2C4C69FF2D37C8E0A5BE3260BCFBEED1,42861,9,11,2,37,44,1894
36056,36056,2C4C69FF2D37C8E0A5BE3260BCFBEED1,11261,11,12,1,36,46,1846
36057,36057,2C4C69FF2D37C8E0A5BE3260BCFBEED1,42861,14,16,2,37,44,1894
36058,36058,2C4C69FF2D37C8E0A5BE3260BCFBEED1,11261,21,23,2,36,46,1846
36059,36059,8E7E1D3BA1392AF853A6068E181E9940,12971,0,14,14,32,48,1648
36060,36060,8E7E1D3BA1392AF853A6068E181E9940,11521,18,20,2,41,48,2098
36061,36061,8E7E1D3BA1392AF853A6068E181E9940,40941,21,23,2,32,48,1648
36065,36065,D5A1F589AD5A8A456E0D23A90489837D,43761,0,5,5,32,47,1647
36066,36066,D5A1F589AD5A8A456E0D23A90489837D,11231,9,17,8,37,49,1899
36067,36067,D5A1F589AD5A8A456E0D23A90489837D,43761,20,23,3,32,47,1647
36068,36068,E24AA397379428299A5C096089B7DF6B,11481,0,9,9,41,48,2098
36069,36069,E24AA397379428299A5C096089B7DF6B,11061,13,17,4,29,48,1498
36070,36070,E24AA397379428299A5C096089B7DF6B,11151,19,23,4,30,48,1548
36071,36071,6F6BFA140B8F0D41AE13D3CFA2E32A87,19114,0,5,5,7,43,393
36072,36072,6F6BFA140B8F0D41AE13D3CFA2E32A87,12641,8,9,1,10,43,543
36073,36073,6F6BFA140B8F0D41AE13D3CFA2E32A87,43021,11,14,3,16,43,843
36074,36074,6F6BFA140B8F0D41AE13D3CFA2E32A87,10171,18,19,1,26,47,1347
36081,36081,15BA009B68D87958E0A9656ADB01E7D6,10511,1,11,10,35,46,1796
36082,36082,15BA009B68D87958E0A9656ADB01E7D6,42371,14,18,4,34,46,1746
36083,36083,15BA009B68D87958E0A9656ADB01E7D6,43001,20,22,2,47,47,2397
36093,36093,E35CDBB00D3E79B32B1FCC49D04F4A1C,13121,7,9,2,38,46,1946
36094,36094,E35CDBB00D3E79B32B1FCC49D04F4A1C,10801,12,16,4,42,47,2147
36095,36095,E35CDBB00D3E79B32B1FCC49D04F4A1C,42321,19,21,2,43,47,2197
36096,36096,E35CDBB00D3E79B32B1FCC49D04F4A1C,10801,21,23,2,42,47,2147
36106,36106,5832F798017EC944959971DE10E6C76B,42231,0,1,1,37,46,1896
36107,36107,5832F798017EC944959971DE10E6C76B,12211,1,2,1,41,44,2094
36108,36108,5832F798017EC944959971DE10E6C76B,13911,7,8,1,39,46,1996
36109,36109,5832F798017EC944959971DE10E6C76B,42231,10,11,1,37,46,1896
36110,36110,5832F798017EC944959971DE10E6C76B,13911,15,16,1,39,46,1996
36111,36111,5832F798017EC944959971DE10E6C76B,11261,17,18,1,36,46,1846
36112,36112,5832F798017EC944959971DE10E6C76B,13911,18,19,1,39,46,1996
36113,36113,E748F2254AC2A75A1317C0ED54387A7E,42831,0,6,6,27,48,1398
36114,36114,E748F2254AC2A75A1317C0ED54387A7E,10381,7,11,4,31,49,1599
36115,36115,E748F2254AC2A75A1317C0ED54387A7E,42831,11,13,2,27,48,1398
36116,36116,E748F2254AC2A75A1317C0ED54387A7E,10381,14,17,3,31,49,1599
36117,36117,E748F2254AC2A75A1317C0ED54387A7E,42831,18,23,5,27,48,1398
36118,36118,57F944F67C1EB1D84B791C00DBD7D598,42161,0,2,2,36,47,1847
36119,36119,57F944F67C1EB1D84B791C00DBD7D598,13341,5,9,4,44,45,2245
36120,36120,57F944F67C1EB1D84B791C00DBD7D598,43451,13,14,1,37,40,1890
36121,36121,57F944F67C1EB1D84B791C00DBD7D598,13341,17,19,2,44,45,2245
36126,36126,D96C351A2D3BF2CB9C84E8F01C9997B6,19904,0,5,5,9,44,494
36127,36127,D96C351A2D3BF2CB9C84E8F01C9997B6,19021,7,8,1,10,45,545
36128,36128,D96C351A2D3BF2CB9C84E8F01C9997B6,11631,9,10,1,12,49,649
36129,36129,D96C351A2D3BF2CB9C84E8F01C9997B6,19021,14,16,2,10,45,545
36130,36130,D96C351A2D3BF2CB9C84E8F01C9997B6,12641,17,19,2,10,43,543
36135,36135,FDA9D6C3558498784AFFBE22F15784BA,12031,0,7,7,33,48,1698
36136,36136,FDA9D6C3558498784AFFBE22F15784BA,42204,8,15,7,43,46,2196
36137,36137,FDA9D6C3558498784AFFBE22F15784BA,11701,16,18,2,43,48,2198
36138,36138,FDA9D6C3558498784AFFBE22F15784BA,12031,19,23,4,33,48,1698
36142,36142,0AF743660C5ED3667FE12560B223379B,16016,0,8,8,4,5,205
36143,36143,0AF743660C5ED3667FE12560B223379B,11351,11,12,1,36,48,1848
36144,36144,0AF743660C5ED3667FE12560B223379B,16181,14,15,1,4,2,202
36145,36145,0AF743660C5ED3667FE12560B223379B,16016,17,23,6,4,5,205
36146,36146,457B779D00720128DC52229000CD7309,15371,0,9,9,15,22,772
36147,36147,457B779D00720128DC52229000CD7309,16441,13,15,2,15,17,767
36148,36148,457B779D00720128DC52229000CD7309,15114,16,23,7,22,16,1116
36149,36149,C783F573219BE815B78681C436E8AC03,11871,0,7,7,29,46,1496
36150,36150,C783F573219BE815B78681C436E8AC03,12601,11,13,2,25,47,1297
36151,36151,C783F573219BE815B78681C436E8AC03,11871,15,19,4,29,46,1496
36163,36163,568BFE566359C1641C1839AD6A581BCF,15404,0,6,6,40,24,2024
36164,36164,568BFE566359C1641C1839AD6A581BCF,13251,9,11,2,48,28,2428
36165,36165,568BFE566359C1641C1839AD6A581BCF,15311,11,14,3,43,25,2175
36166,36166,568BFE566359C1641C1839AD6A581BCF,12611,15,16,1,41,29,2079
36167,36167,568BFE566359C1641C1839AD6A581BCF,15404,17,23,6,40,24,2024
36168,36168,E9BB7B03EED7A0190F0D903E3C6E1AE4,11151,0,4,4,30,48,1548
36169,36169,E9BB7B03EED7A0190F0D903E3C6E1AE4,19181,13,16,3,8,40,440
36170,36170,E9BB7B03EED7A0190F0D903E3C6E1AE4,12921,19,21,2,9,41,491
36171,36171,CB9FC3FE9195AF3F0A6A77B7B82B22F1,11591,2,3,1,36,49,1849
36172,36172,CB9FC3FE9195AF3F0A6A77B7B82B22F1,42471,4,8,4,35,49,1799
36173,36173,CB9FC3FE9195AF3F0A6A77B7B82B22F1,11591,10,13,3,36,49,1849
36174,36174,CB9FC3FE9195AF3F0A6A77B7B82B22F1,42471,16,18,2,35,49,1799
36175,36175,CB9FC3FE9195AF3F0A6A77B7B82B22F1,11591,20,23,3,36,49,1849
36176,36176,74EBB90FA1C414F58477B49370E7F73F,11861,0,6,6,32,47,1647
36177,36177,74EBB90FA1C414F58477B49370E7F73F,12311,7,12,5,30,44,1544
36178,36178,74EBB90FA1C414F58477B49370E7F73F,10281,15,17,2,33,48,1698
36179,36179,74EBB90FA1C414F58477B49370E7F73F,11861,18,23,5,32,47,1647
36186,36186,0E002027D741B8AED4EE58E469659344,12584,1,2,1,24,48,1248
36187,36187,0E002027D741B8AED4EE58E469659344,12601,4,7,3,25,47,1297
36188,36188,0E002027D741B8AED4EE58E469659344,10501,9,10,1,22,46,1146
36189,36189,0E002027D741B8AED4EE58E469659344,10061,14,16,2,20,46,1046
36190,36190,0E002027D741B8AED4EE58E469659344,12584,17,18,1,24,48,1248
36191,36191,0E002027D741B8AED4EE58E469659344,10501,21,23,2,22,46,1146
36192,36192,BE6556F4F32DDBE17FA5A6143CEC24DA,42021,9,11,2,33,47,1697
36193,36193,BE6556F4F32DDBE17FA5A6143CEC24DA,11001,15,19,4,42,47,2147
36194,36194,BE6556F4F32DDBE17FA5A6143CEC24DA,10731,20,21,1,33,47,1697
36195,36195,BE6556F4F32DDBE17FA5A6143CEC24DA,10901,22,23,1,35,48,1798
36196,36196,FEA865DCCC374F062F7FD8F2AE9FF342,11021,0,8,8,36,49,1849
36197,36197,FEA865DCCC374F062F7FD8F2AE9FF342,11324,8,10,2,31,46,1596
36198,36198,FEA865DCCC374F062F7FD8F2AE9FF342,11021,13,23,10,36,49,1849
36203,36203,BD4F1B02E335A606DD6849B8E89B0BA2,42531,0,4,4,31,45,1595
36204,36204,BD4F1B02E335A606DD6849B8E89B0BA2,12311,7,15,8,30,44,1544
36205,36205,BD4F1B02E335A606DD6849B8E89B0BA2,42531,15,18,3,31,45,1595
36206,36206,BD4F1B02E335A606DD6849B8E89B0BA2,12311,18,21,3,30,44,1544
36207,36207,BD4F1B02E335A606DD6849B8E89B0BA2,42531,22,23,1,31,45,1595
36211,36211,CC2319CF46719506D8E322850B1EE19C,10731,0,1,1,33,47,1697
36212,36212,CC2319CF46719506D8E322850B1EE19C,10781,2,5,3,35,47,1797
36213,36213,CC2319CF46719506D8E322850B1EE19C,43731,9,13,4,34,47,1747
36214,36214,CC2319CF46719506D8E322850B1EE19C,11201,15,20,5,35,49,1799
36215,36215,CC2319CF46719506D8E322850B1EE19C,43731,21,23,2,34,47,1747
36216,36216,77806B76C9464C3352C73240356F598A,10771,0,7,7,41,46,2096
36217,36217,77806B76C9464C3352C73240356F598A,11481,8,9,1,41,48,2098
36218,36218,77806B76C9464C3352C73240356F598A,11021,10,12,2,36,49,1849
36219,36219,77806B76C9464C3352C73240356F598A,43161,15,16,1,35,47,1797
36220,36220,77806B76C9464C3352C73240356F598A,10771,17,18,1,41,46,2096
36221,36221,77806B76C9464C3352C73240356F598A,11551,20,21,1,39,49,1999
36222,36222,A5A342C5B79B8AEE00BA80AE678B8EC5,42331,0,7,7,39,46,1996
36223,36223,A5A342C5B79B8AEE00BA80AE678B8EC5,11151,9,10,1,30,48,1548
36224,36224,A5A342C5B79B8AEE00BA80AE678B8EC5,10331,12,23,11,39,46,1996
36236,36236,1A6A180FC1652CDA8F079E8572A81E38,42501,1,8,7,28,47,1447
36237,36237,1A6A180FC1652CDA8F079E8572A81E38,42981,9,12,3,36,49,1849
36238,36238,1A6A180FC1652CDA8F079E8572A81E38,11231,12,18,6,37,49,1899
36239,36239,1A6A180FC1652CDA8F079E8572A81E38,12121,20,23,3,29,47,1497
36251,36251,F14B27CFA07BFF1C03E8748CE04AA105,10341,0,8,8,31,47,1597
36252,36252,F14B27CFA07BFF1C03E8748CE04AA105,11061,11,13,2,29,48,1498
36253,36253,F14B27CFA07BFF1C03E8748CE04AA105,10544,16,17,1,28,48,1448
36254,36254,F14B27CFA07BFF1C03E8748CE04AA105,41601,19,21,2,39,49,1999
36258,36258,9467C00340FDB6745E40F052A8816117,43061,0,6,6,43,46,2196
36259,36259,9467C00340FDB6745E40F052A8816117,42461,8,9,1,45,47,2297
36260,36260,9467C00340FDB6745E40F052A8816117,11811,13,15,2,38,49,1949
36261,36261,9467C00340FDB6745E40F052A8816117,13941,18,23,5,41,47,2097
36273,36273,5D77C455155C654440C1FABC6822DC8C,11301,0,6,6,41,49,2099
36274,36274,5D77C455155C654440C1FABC6822DC8C,10716,8,17,9,30,46,1546
36275,36275,5D77C455155C654440C1FABC6822DC8C,11301,19,23,4,41,49,2099
36280,36280,5B38B567B1C7BA8CD66BEFDF9C575D7A,11231,0,14,14,37,49,1899
36281,36281,5B38B567B1C7BA8CD66BEFDF9C575D7A,12391,14,15,1,36,49,1849
36282,36282,5B38B567B1C7BA8CD66BEFDF9C575D7A,11151,19,21,2,30,48,1548
36283,36283,5B38B567B1C7BA8CD66BEFDF9C575D7A,11231,22,23,1,37,49,1899
36288,36288,F5C1BE202F75E1C698FE38620F315458,13351,1,7,6,48,48,2448
36289,36289,F5C1BE202F75E1C698FE38620F315458,42601,7,10,3,44,48,2248
36290,36290,F5C1BE202F75E1C698FE38620F315458,10921,13,23,10,43,48,2198
36294,36294,B8BEE4316240369D7D9EFEDD287F001E,43761,0,6,6,32,47,1647
36295,36295,B8BEE4316240369D7D9EFEDD287F001E,42021,8,11,3,33,47,1697
36296,36296,B8BEE4316240369D7D9EFEDD287F001E,11861,13,17,4,32,47,1647
36297,36297,B8BEE4316240369D7D9EFEDD287F001E,13601,17,19,2,34,47,1747
36298,36298,B8BEE4316240369D7D9EFEDD287F001E,42021,20,23,3,33,47,1697
36299,36299,CC542EA3A72441C176DD8B2A582775E3,40637,0,9,9,36,47,1847
36300,36300,CC542EA3A72441C176DD8B2A582775E3,10371,10,13,3,37,49,1899
36301,36301,CC542EA3A72441C176DD8B2A582775E3,11001,15,16,1,42,47,2147
36302,36302,CC542EA3A72441C176DD8B2A582775E3,42301,17,19,2,36,47,1847
36303,36303,CC542EA3A72441C176DD8B2A582775E3,10251,20,23,3,35,47,1797
36310,36310,DDC59E7493CEB296833CA56BFE302552,15661,0,6,6,36,26,1826
36311,36311,DDC59E7493CEB296833CA56BFE302552,15061,8,11,3,41,25,2075
36312,36312,DDC59E7493CEB296833CA56BFE302552,15091,12,13,1,35,26,1776
36313,36313,DDC59E7493CEB296833CA56BFE302552,15061,18,19,1,41,25,2075
36314,36314,DDC59E7493CEB296833CA56BFE302552,15661,20,23,3,36,26,1826
36319,36319,03A91EC93647A8BA652DF6ED44DA5BB9,42141,0,4,4,32,47,1647
36320,36320,03A91EC93647A8BA652DF6ED44DA5BB9,42321,5,7,2,43,47,2197
36321,36321,03A91EC93647A8BA652DF6ED44DA5BB9,42461,7,8,1,45,47,2297
36322,36322,03A91EC93647A8BA652DF6ED44DA5BB9,10281,11,16,5,33,48,1698
36323,36323,03A91EC93647A8BA652DF6ED44DA5BB9,12381,20,21,1,32,48,1648
36345,36345,7AC00E77E1B9AD669975B78394064594,11351,0,1,1,36,48,1848
36346,36346,7AC00E77E1B9AD669975B78394064594,11791,2,16,14,38,49,1949
36347,36347,7AC00E77E1B9AD669975B78394064594,13471,18,20,2,47,49,2399
36348,36348,7AC00E77E1B9AD669975B78394064594,13101,21,23,2,40,47,2047
36349,36349,E3CC826C12354D0B225810F9698A126C,49201,0,5,5,7,41,391
36350,36350,E3CC826C12354D0B225810F9698A126C,12921,7,8,1,9,41,491
36351,36351,E3CC826C12354D0B225810F9698A126C,49201,12,13,1,7,41,391
36352,36352,E3CC826C12354D0B225810F9698A126C,12921,14,15,1,9,41,491
36353,36353,E3CC826C12354D0B225810F9698A126C,49201,20,23,3,7,41,391
36354,36354,5FB7FCDE8733B3DE0082FB61D42FC13D,13371,0,4,4,41,47,2097
36355,36355,5FB7FCDE8733B3DE0082FB61D42FC13D,42321,7,12,5,43,47,2197
36356,36356,5FB7FCDE8733B3DE0082FB61D42FC13D,11201,15,16,1,35,49,1799
36357,36357,5FB7FCDE8733B3DE0082FB61D42FC13D,42321,18,21,3,43,47,2197
36358,36358,8F79DEBEC2513ED357831F892A2CF021,11211,0,1,1,34,49,1749
36359,36359,8F79DEBEC2513ED357831F892A2CF021,11541,2,7,5,35,49,1799
36360,36360,8F79DEBEC2513ED357831F892A2CF021,11211,11,12,1,34,49,1749
36361,36361,8F79DEBEC2513ED357831F892A2CF021,11021,16,18,2,36,49,1849
36362,36362,8F79DEBEC2513ED357831F892A2CF021,11541,22,23,1,35,49,1799
36363,36363,9EB2D4C047D1C44531372B893D265D46,13821,0,14,14,49,45,2495
36364,36364,9EB2D4C047D1C44531372B893D265D46,13341,14,16,2,44,45,2245
36365,36365,9EB2D4C047D1C44531372B893D265D46,13821,19,22,3,49,45,2495
36366,36366,6224797A94401F7316FE4DF239A66FE7,12561,2,15,13,45,43,2293
36367,36367,6224797A94401F7316FE4DF239A66FE7,13911,19,20,1,39,46,1996
36368,36368,6224797A94401F7316FE4DF239A66FE7,12561,21,23,2,45,43,2293
36372,36372,589E58EC73D828794BF6F25772EB0D10,10107,0,1,1,38,49,1949
36373,36373,589E58EC73D828794BF6F25772EB0D10,13961,1,8,7,42,48,2148
36374,36374,589E58EC73D828794BF6F25772EB0D10,11781,17,23,6,38,49,1949
36375,36375,D3A8E24567875F3C39102478CB1D4A49,42633,0,6,6,42,46,2146
36376,36376,D3A8E24567875F3C39102478CB1D4A49,11061,7,11,4,29,48,1498
36377,36377,D3A8E24567875F3C39102478CB1D4A49,43971,14,16,2,30,48,1548
36378,36378,D3A8E24567875F3C39102478CB1D4A49,42633,20,22,2,42,46,2146
36386,36386,ECBC886277109C0582E65AB313F27C1C,13314,0,6,6,31,39,1589
36387,36387,ECBC886277109C0582E65AB313F27C1C,12521,8,17,9,35,41,1791
36388,36388,ECBC886277109C0582E65AB313F27C1C,13314,17,23,6,31,39,1589
36389,36389,C60A92B9E4EA3B92240A484845EDC3BB,10295,0,8,8,30,47,1547
36390,36390,C60A92B9E4EA3B92240A484845EDC3BB,40733,8,11,3,32,48,1648
36391,36391,C60A92B9E4EA3B92240A484845EDC3BB,10295,11,14,3,30,47,1547
36392,36392,C60A92B9E4EA3B92240A484845EDC3BB,10107,19,20,1,38,49,1949
36393,36393,C60A92B9E4EA3B92240A484845EDC3BB,10151,22,23,1,34,47,1747
36400,36400,6BE2BAECEC18A1927DF47D706C3BF11B,10331,0,1,1,39,46,1996
36401,36401,6BE2BAECEC18A1927DF47D706C3BF11B,10221,2,9,7,34,49,1749
36402,36402,6BE2BAECEC18A1927DF47D706C3BF11B,41382,12,14,2,38,49,1949
36403,36403,6BE2BAECEC18A1927DF47D706C3BF11B,10221,19,23,4,34,49,1749
36404,36404,6324E038DED9EC12CD06DF2BDBC3BEAA,43021,0,2,2,16,43,843
36405,36405,6324E038DED9EC12CD06DF2BDBC3BEAA,19181,3,4,1,8,40,440
36406,36406,6324E038DED9EC12CD06DF2BDBC3BEAA,43021,4,5,1,16,43,843
36407,36407,6324E038DED9EC12CD06DF2BDBC3BEAA,19181,8,19,11,8,40,440
36408,36408,8248DF99B4A91AB1D64E8E1585D2D853,42071,0,4,4,31,49,1599
36409,36409,8248DF99B4A91AB1D64E8E1585D2D853,42081,5,7,2,24,49,1249
36410,36410,8248DF99B4A91AB1D64E8E1585D2D853,42071,9,22,13,31,49,1599
36427,36427,AC44646418C98ED88B49CF71AB62D672,11261,0,5,5,36,46,1846
36428,36428,AC44646418C98ED88B49CF71AB62D672,13071,9,11,2,41,41,2091
36429,36429,AC44646418C98ED88B49CF71AB62D672,12491,15,22,7,36,43,1843
36430,36430,2BEF2F1DF9F53E26FBA10E115C641BD7,12661,0,2,2,32,45,1645
36431,36431,2BEF2F1DF9F53E26FBA10E115C641BD7,13671,3,4,1,27,43,1393
36432,36432,2BEF2F1DF9F53E26FBA10E115C641BD7,12661,4,21,17,32,45,1645
36433,36433,119196C18578341D0084AF6B48A62632,11631,0,2,2,12,49,649
36434,36434,119196C18578341D0084AF6B48A62632,19021,4,8,4,10,45,545
36435,36435,119196C18578341D0084AF6B48A62632,11631,10,23,13,12,49,649
36436,36436,1DA79481C6B6D1D9223A378A0D81757A,10111,3,8,5,37,47,1897
36437,36437,1DA79481C6B6D1D9223A378A0D81757A,11211,9,17,8,34,49,1749
36438,36438,1DA79481C6B6D1D9223A378A0D81757A,10111,17,23,6,37,47,1897
36439,36439,C187943D20D187183526E0228C45660E,11021,0,7,7,36,49,1849
36440,36440,C187943D20D187183526E0228C45660E,11081,8,11,3,35,46,1796
36441,36441,C187943D20D187183526E0228C45660E,11021,12,15,3,36,49,1849
36442,36442,C187943D20D187183526E0228C45660E,12381,16,19,3,32,48,1648
36443,36443,C187943D20D187183526E0228C45660E,11021,20,22,2,36,49,1849
36444,36444,76163A1BE997C61FE0A20A92CF532DC2,10711,0,11,11,29,46,1496
36445,36445,76163A1BE997C61FE0A20A92CF532DC2,10491,13,15,2,33,48,1698
36446,36446,76163A1BE997C61FE0A20A92CF532DC2,42021,16,18,2,33,47,1697
36447,36447,76163A1BE997C61FE0A20A92CF532DC2,10711,21,23,2,29,46,1496
36448,36448,4FEF13C34931B0F26292910244AA9506,19061,10,12,2,3,43,193
36449,36449,4FEF13C34931B0F26292910244AA9506,11211,14,15,1,34,49,1749
36450,36450,4FEF13C34931B0F26292910244AA9506,11541,20,23,3,35,49,1799
36451,36451,E9E990F48245ACFDBDC8F1C95015FE95,42301,0,7,7,36,47,1847
36452,36452,E9E990F48245ACFDBDC8F1C95015FE95,40124,9,10,1,38,47,1947
36453,36453,E9E990F48245ACFDBDC8F1C95015FE95,42301,13,14,1,36,47,1847
36454,36454,E9E990F48245ACFDBDC8F1C95015FE95,13121,15,16,1,38,46,1946
36455,36455,E9E990F48245ACFDBDC8F1C95015FE95,42261,18,20,2,25,49,1299
36456,36456,F4A5CE128B0276BA64A57CF9F5D60F74,42831,0,7,7,27,48,1398
36457,36457,F4A5CE128B0276BA64A57CF9F5D60F74,42031,8,9,1,40,46,2046
36458,36458,F4A5CE128B0276BA64A57CF9F5D60F74,42831,11,18,7,27,48,1398
36459,36459,5A1FB078DC3D794E4EC9A5B5577C84F5,10111,0,6,6,37,47,1897
36460,36460,5A1FB078DC3D794E4EC9A5B5577C84F5,42161,6,7,1,36,47,1847
36461,36461,5A1FB078DC3D794E4EC9A5B5577C84F5,10111,7,12,5,37,47,1897
36462,36462,5A1FB078DC3D794E4EC9A5B5577C84F5,40673,14,18,4,36,48,1848
36463,36463,5A1FB078DC3D794E4EC9A5B5577C84F5,10111,18,23,5,37,47,1897
36467,36467,C6C2F095AF2A0174ED0BF77DE6D5240D,13941,0,6,6,41,47,2097
36468,36468,C6C2F095AF2A0174ED0BF77DE6D5240D,12481,7,10,3,37,49,1899
36469,36469,C6C2F095AF2A0174ED0BF77DE6D5240D,13271,13,23,10,41,47,2097
36473,36473,D3E46B15B35DC3C198E6EE945D227259,11806,0,5,5,41,48,2098
36474,36474,D3E46B15B35DC3C198E6EE945D227259,42271,6,11,5,40,47,2047
36475,36475,D3E46B15B35DC3C198E6EE945D227259,11806,12,13,1,41,48,2098
36476,36476,D3E46B15B35DC3C198E6EE945D227259,42271,14,21,7,40,47,2047
36477,36477,D3E46B15B35DC3C198E6EE945D227259,11806,21,22,1,41,48,2098
36482,36482,3F2FE95AB24E5E71D935604E5158C97B,41392,0,14,14,43,48,2198
36483,36483,3F2FE95AB24E5E71D935604E5158C97B,11261,16,17,1,36,46,1846
36484,36484,3F2FE95AB24E5E71D935604E5158C97B,42961,19,21,2,35,49,1799
36485,36485,9063D9BC124B90056525B5B4C08304A4,42461,3,11,8,45,47,2297
36486,36486,9063D9BC124B90056525B5B4C08304A4,11074,13,15,2,37,47,1897
36487,36487,9063D9BC124B90056525B5B4C08304A4,42461,20,21,1,45,47,2297
36488,36488,9063D9BC124B90056525B5B4C08304A4,42201,22,23,1,43,46,2196
36500,36500,0A0468FF0A302A728DA48EB76E20D325,42351,0,8,8,38,45,1945
36501,36501,0A0468FF0A302A728DA48EB76E20D325,11381,11,15,4,30,47,1547
36502,36502,0A0468FF0A302A728DA48EB76E20D325,42351,16,23,7,38,45,1945
36503,36503,A208246203303765025742FDE89787BA,10271,1,8,7,37,46,1896
36504,36504,A208246203303765025742FDE89787BA,40951,11,13,2,36,49,1849
36505,36505,A208246203303765025742FDE89787BA,10271,14,15,1,37,46,1896
36506,36506,A208246203303765025742FDE89787BA,12514,15,18,3,38,47,1947
36507,36507,A208246203303765025742FDE89787BA,42511,18,20,2,37,47,1897
36508,36508,A208246203303765025742FDE89787BA,10271,21,23,2,37,46,1896
36512,36512,530B60C597B34D2F4729C292F9EAB948,11104,2,6,4,17,47,897
36513,36513,530B60C597B34D2F4729C292F9EAB948,49201,9,12,3,7,41,391
36514,36514,530B60C597B34D2F4729C292F9EAB948,12921,14,19,5,9,41,491
36515,36515,530B60C597B34D2F4729C292F9EAB948,11104,22,23,1,17,47,897
36516,36516,6B614428F8D95ECFDE2207017437E97D,12871,5,11,6,22,33,1133
36517,36517,6B614428F8D95ECFDE2207017437E97D,19281,14,15,1,16,32,832
36518,36518,6B614428F8D95ECFDE2207017437E97D,12871,19,23,4,22,33,1133
36519,36519,7861278735CDA91B9BABB196FBF7605C,13411,2,5,3,49,42,2492
36520,36520,7861278735CDA91B9BABB196FBF7605C,13951,12,17,5,47,45,2395
36521,36521,7861278735CDA91B9BABB196FBF7605C,43951,18,19,1,49,41,2491
36525,36525,BDA85A3FC7D0CADE7856E29E49F9DA05,10251,0,8,8,35,47,1797
36526,36526,BDA85A3FC7D0CADE7856E29E49F9DA05,42381,9,10,1,39,41,1991
36527,36527,BDA85A3FC7D0CADE7856E29E49F9DA05,10971,11,12,1,35,47,1797
36528,36528,BDA85A3FC7D0CADE7856E29E49F9DA05,43731,14,15,1,34,47,1747
36529,36529,BDA85A3FC7D0CADE7856E29E49F9DA05,11081,16,18,2,35,46,1796
36530,36530,BDA85A3FC7D0CADE7856E29E49F9DA05,10251,21,23,2,35,47,1797
36531,36531,15AF53FBA0C13FBD61024895398ED2FD,11471,1,4,3,12,48,648
36532,36532,15AF53FBA0C13FBD61024895398ED2FD,42041,7,16,9,10,47,547
36533,36533,15AF53FBA0C13FBD61024895398ED2FD,19441,20,23,3,8,46,446
36534,36534,804B7737707030C63DF2E4BD94DF220F,42971,0,6,6,43,49,2199
36535,36535,804B7737707030C63DF2E4BD94DF220F,11806,8,12,4,41,48,2098
36536,36536,804B7737707030C63DF2E4BD94DF220F,42271,14,15,1,40,47,2047
36537,36537,804B7737707030C63DF2E4BD94DF220F,11806,18,23,5,41,48,2098
36538,36538,44AF7E3F6FD3AFD3E254BC36398928E0,12561,8,9,1,45,43,2293
36539,36539,44AF7E3F6FD3AFD3E254BC36398928E0,43011,12,14,2,40,42,2042
36540,36540,44AF7E3F6FD3AFD3E254BC36398928E0,12561,17,21,4,45,43,2293
36541,36541,44AF7E3F6FD3AFD3E254BC36398928E0,13071,21,23,2,41,41,2091
36542,36542,1F586282DD0AC03725A5E548411F5D82,12514,0,1,1,38,47,1947
36543,36543,1F586282DD0AC03725A5E548411F5D82,42221,1,9,8,38,48,1948
36544,36544,1F586282DD0AC03725A5E548411F5D82,10841,9,10,1,37,47,1897
36545,36545,1F586282DD0AC03725A5E548411F5D82,12514,14,19,5,38,47,1947
36546,36546,1F586282DD0AC03725A5E548411F5D82,10841,21,22,1,37,47,1897
36557,36557,3EEFB7BDF8C8012BA246A804A35191A0,15671,0,5,5,37,26,1876
36558,36558,3EEFB7BDF8C8012BA246A804A35191A0,15191,7,9,2,36,27,1827
36559,36559,3EEFB7BDF8C8012BA246A804A35191A0,12611,12,22,10,41,29,2079
36563,36563,662B4DE10B5E46302328673CD9C61795,10111,0,10,10,37,47,1897
36564,36564,662B4DE10B5E46302328673CD9C61795,42161,10,16,6,36,47,1847
36565,36565,662B4DE10B5E46302328673CD9C61795,11631,18,20,2,12,49,649
36581,36581,400659CE2E6F8BFF6D95D6F52F73DF5B,42921,0,5,5,33,47,1697
36582,36582,400659CE2E6F8BFF6D95D6F52F73DF5B,11861,5,11,6,32,47,1647
36583,36583,400659CE2E6F8BFF6D95D6F52F73DF5B,42921,12,13,1,33,47,1697
36584,36584,400659CE2E6F8BFF6D95D6F52F73DF5B,11861,13,18,5,32,47,1647
36585,36585,400659CE2E6F8BFF6D95D6F52F73DF5B,42921,19,23,4,33,47,1697
36586,36586,D1B681929BD44A1A7918A0268A3E43F0,12641,0,1,1,10,43,543
36587,36587,D1B681929BD44A1A7918A0268A3E43F0,43021,6,9,3,16,43,843
36588,36588,D1B681929BD44A1A7918A0268A3E43F0,12641,12,15,3,10,43,543
36589,36589,D1B681929BD44A1A7918A0268A3E43F0,43021,16,17,1,16,43,843
36590,36590,D1B681929BD44A1A7918A0268A3E43F0,12921,17,19,2,9,41,491
36591,36591,D1B681929BD44A1A7918A0268A3E43F0,43021,20,22,2,16,43,843
36603,36603,05A020FB3ED60AE565EDEADD6B0AE3FA,10691,0,6,6,33,48,1698
36604,36604,05A020FB3ED60AE565EDEADD6B0AE3FA,11661,18,20,2,40,49,2049
36605,36605,05A020FB3ED60AE565EDEADD6B0AE3FA,43581,21,22,1,33,48,1698
36615,36615,71CDB42BF8ABF4C8B89BDC81F92C39B7,10634,0,6,6,27,45,1395
36616,36616,71CDB42BF8ABF4C8B89BDC81F92C39B7,12601,7,8,1,25,47,1297
36617,36617,71CDB42BF8ABF4C8B89BDC81F92C39B7,10634,11,14,3,27,45,1395
36618,36618,71CDB42BF8ABF4C8B89BDC81F92C39B7,12601,14,17,3,25,47,1297
36619,36619,71CDB42BF8ABF4C8B89BDC81F92C39B7,10634,18,23,5,27,45,1395
36620,36620,97E4702F624CE098E267C7767A3602E0,42491,0,12,12,32,46,1646
36621,36621,97E4702F624CE098E267C7767A3602E0,11061,13,16,3,29,48,1498
36622,36622,97E4702F624CE098E267C7767A3602E0,12131,17,18,1,32,47,1647
36623,36623,97E4702F624CE098E267C7767A3602E0,42491,20,23,3,32,46,1646
36628,36628,5E8BB1A9FDE1AFD08848003FB8A60E0E,40673,0,8,8,36,48,1848
36629,36629,5E8BB1A9FDE1AFD08848003FB8A60E0E,43731,10,12,2,34,47,1747
36630,36630,5E8BB1A9FDE1AFD08848003FB8A60E0E,10411,12,13,1,36,48,1848
36631,36631,5E8BB1A9FDE1AFD08848003FB8A60E0E,43731,15,17,2,34,47,1747
36632,36632,5E8BB1A9FDE1AFD08848003FB8A60E0E,10971,17,19,2,35,47,1797
36633,36633,5E8BB1A9FDE1AFD08848003FB8A60E0E,10411,20,23,3,36,48,1848
36634,36634,0004E9A02B9F97024FE46D8B36381EE9,43021,0,7,7,16,43,843
36635,36635,0004E9A02B9F97024FE46D8B36381EE9,12311,10,12,2,30,44,1544
36636,36636,0004E9A02B9F97024FE46D8B36381EE9,10401,13,14,1,33,49,1699
36637,36637,0004E9A02B9F97024FE46D8B36381EE9,12311,15,16,1,30,44,1544
36638,36638,0004E9A02B9F97024FE46D8B36381EE9,11061,19,21,2,29,48,1498
36639,36639,7779D5C4E5073D864A9050EB76A5AC64,43341,0,1,1,41,46,2096
36640,36640,7779D5C4E5073D864A9050EB76A5AC64,42351,1,6,5,38,45,1945
36641,36641,7779D5C4E5073D864A9050EB76A5AC64,11261,8,9,1,36,46,1846
36642,36642,7779D5C4E5073D864A9050EB76A5AC64,43341,10,12,2,41,46,2096
36643,36643,7779D5C4E5073D864A9050EB76A5AC64,11261,13,23,10,36,46,1846
36644,36644,288D369FF27C2F58011E60F4D93BD67B,11061,0,7,7,29,48,1498
36645,36645,288D369FF27C2F58011E60F4D93BD67B,11381,9,11,2,30,47,1547
36646,36646,288D369FF27C2F58011E60F4D93BD67B,11061,12,14,2,29,48,1498
36647,36647,288D369FF27C2F58011E60F4D93BD67B,11381,16,17,1,30,47,1547
36648,36648,288D369FF27C2F58011E60F4D93BD67B,43761,19,21,2,32,47,1647
36649,36649,CA269BAD556781918B5BA94C8942431A,10292,4,7,3,30,47,1547
36650,36650,CA269BAD556781918B5BA94C8942431A,13111,11,16,5,42,46,2146
36651,36651,CA269BAD556781918B5BA94C8942431A,11151,18,19,1,30,48,1548
36656,36656,F93FC485E5AA02DFA65C5E4A357B61F3,13101,0,8,8,40,47,2047
36657,36657,F93FC485E5AA02DFA65C5E4A357B61F3,40401,8,11,3,40,46,2046
36658,36658,F93FC485E5AA02DFA65C5E4A357B61F3,11481,11,14,3,41,48,2098
36659,36659,F93FC485E5AA02DFA65C5E4A357B61F3,43341,15,17,2,41,46,2096
36660,36660,F93FC485E5AA02DFA65C5E4A357B61F3,16071,18,19,1,3,3,153
36661,36661,F93FC485E5AA02DFA65C5E4A357B61F3,11301,21,22,1,41,49,2099
36669,36669,6F17FD638D6EF96567788CDA26420695,10431,0,2,2,33,49,1699
36670,36670,6F17FD638D6EF96567788CDA26420695,10691,5,7,2,33,48,1698
36671,36671,6F17FD638D6EF96567788CDA26420695,10841,9,16,7,37,47,1897
36672,36672,6F17FD638D6EF96567788CDA26420695,11171,20,21,1,33,48,1698
36693,36693,1BC82CED77FF282C26C4EE3FA4614772,42221,2,9,7,38,48,1948
36694,36694,1BC82CED77FF282C26C4EE3FA4614772,11861,13,18,5,32,47,1647
36695,36695,1BC82CED77FF282C26C4EE3FA4614772,42021,20,21,1,33,47,1697
36699,36699,504467700DDD1C036193CD82D6D3619F,42521,0,8,8,31,47,1597
36700,36700,504467700DDD1C036193CD82D6D3619F,43761,10,11,1,32,47,1647
36701,36701,504467700DDD1C036193CD82D6D3619F,42521,12,13,1,31,47,1597
36702,36702,504467700DDD1C036193CD82D6D3619F,10295,18,20,2,30,47,1547
36703,36703,504467700DDD1C036193CD82D6D3619F,43761,22,23,1,32,47,1647
36704,36704,9B10EDD175FAD989501290F8E9AE500C,11631,9,10,1,12,49,649
36705,36705,9B10EDD175FAD989501290F8E9AE500C,11021,18,19,1,36,49,1849
36706,36706,9B10EDD175FAD989501290F8E9AE500C,40271,20,22,2,35,49,1799
36707,36707,AB35C432DC3D59E7929F031635A675AA,12601,0,3,3,25,47,1297
36708,36708,AB35C432DC3D59E7929F031635A675AA,10501,4,6,2,22,46,1146
36709,36709,AB35C432DC3D59E7929F031635A675AA,40833,9,10,1,41,47,2097
36710,36710,AB35C432DC3D59E7929F031635A675AA,12601,13,23,10,25,47,1297
36730,36730,F7B0DEB7BA567C33456EA83CB86454BE,12971,0,10,10,32,48,1648
36731,36731,F7B0DEB7BA567C33456EA83CB86454BE,10421,14,15,1,41,48,2098
36732,36732,F7B0DEB7BA567C33456EA83CB86454BE,12971,15,17,2,32,48,1648
36733,36733,F7B0DEB7BA567C33456EA83CB86454BE,43161,17,18,1,35,47,1797
36734,36734,F7B0DEB7BA567C33456EA83CB86454BE,12971,21,23,2,32,48,1648
36735,36735,6ACC9074DFDB9D8D0BCD53913B584369,42201,0,5,5,43,46,2196
36736,36736,6ACC9074DFDB9D8D0BCD53913B584369,11324,8,10,2,31,46,1596
36737,36737,6ACC9074DFDB9D8D0BCD53913B584369,42201,12,23,11,43,46,2196
36738,36738,16D740AE27D92BE968DE244652195181,13671,0,7,7,27,43,1393
36739,36739,16D740AE27D92BE968DE244652195181,12761,7,10,3,25,40,1290
36740,36740,16D740AE27D92BE968DE244652195181,13671,10,20,10,27,43,1393
36748,36748,D9FB9F3F4820A4EF951566780A770C45,11261,2,3,1,36,46,1846
36749,36749,D9FB9F3F4820A4EF951566780A770C45,42351,3,4,1,38,45,1945
36750,36750,D9FB9F3F4820A4EF951566780A770C45,11261,5,8,3,36,46,1846
36751,36751,D9FB9F3F4820A4EF951566780A770C45,13911,8,12,4,39,46,1996
36752,36752,D9FB9F3F4820A4EF951566780A770C45,11261,14,16,2,36,46,1846
36753,36753,D9FB9F3F4820A4EF951566780A770C45,13911,16,18,2,39,46,1996
36754,36754,D9FB9F3F4820A4EF951566780A770C45,11261,20,23,3,36,46,1846
36758,36758,E2C46C8E872A56146D94CCF191533F65,10661,0,1,1,37,49,1899
36759,36759,E2C46C8E872A56146D94CCF191533F65,43181,8,14,6,39,48,1998
36760,36760,E2C46C8E872A56146D94CCF191533F65,42071,19,21,2,31,49,1599
36761,36761,E2C46C8E872A56146D94CCF191533F65,12083,22,23,1,36,49,1849
36762,36762,59A0A66272AD58C53CB4B05B1CFA927F,15404,0,6,6,40,24,2024
36763,36763,59A0A66272AD58C53CB4B05B1CFA927F,13251,6,11,5,48,28,2428
36764,36764,59A0A66272AD58C53CB4B05B1CFA927F,15311,11,14,3,43,25,2175
36765,36765,59A0A66272AD58C53CB4B05B1CFA927F,12611,14,16,2,41,29,2079
36766,36766,59A0A66272AD58C53CB4B05B1CFA927F,15404,17,23,6,40,24,2024
36767,36767,294FB4B8E5D6BF128BF9CA2E5243FA86,10161,0,6,6,35,49,1799
36768,36768,294FB4B8E5D6BF128BF9CA2E5243FA86,11021,8,9,1,36,49,1849
36769,36769,294FB4B8E5D6BF128BF9CA2E5243FA86,13561,10,11,1,37,49,1899
36770,36770,294FB4B8E5D6BF128BF9CA2E5243FA86,11021,15,16,1,36,49,1849
36771,36771,294FB4B8E5D6BF128BF9CA2E5243FA86,11211,18,21,3,34,49,1749
36772,36772,64EA873D359181A561255128009EB239,42581,0,8,8,38,48,1948
36773,36773,64EA873D359181A561255128009EB239,11914,8,10,2,37,48,1898
36774,36774,64EA873D359181A561255128009EB239,42581,12,13,1,38,48,1948
36775,36775,64EA873D359181A561255128009EB239,11914,13,17,4,37,48,1898
36776,36776,64EA873D359181A561255128009EB239,42581,21,23,2,38,48,1948
36784,36784,7179E8D23C9EF0FE56A034B0F52DF3EB,42623,0,2,2,22,49,1149
36785,36785,7179E8D23C9EF0FE56A034B0F52DF3EB,42071,3,6,3,31,49,1599
36786,36786,7179E8D23C9EF0FE56A034B0F52DF3EB,42623,11,21,10,22,49,1149
36793,36793,C96AF7724AE07D1D1BE56C246C9FE7FC,42461,0,7,7,45,47,2297
36794,36794,C96AF7724AE07D1D1BE56C246C9FE7FC,13341,7,9,2,44,45,2245
36795,36795,C96AF7724AE07D1D1BE56C246C9FE7FC,42631,9,11,2,43,45,2195
36796,36796,C96AF7724AE07D1D1BE56C246C9FE7FC,10771,14,15,1,41,46,2096
36797,36797,C96AF7724AE07D1D1BE56C246C9FE7FC,13341,17,23,6,44,45,2245
36801,36801,7B7EC78C492826B1A2F98257774A5C01,11061,0,8,8,29,48,1498
36802,36802,7B7EC78C492826B1A2F98257774A5C01,40171,12,15,3,38,48,1948
36803,36803,7B7EC78C492826B1A2F98257774A5C01,11061,17,23,6,29,48,1498
36804,36804,E43A1713BA9589398F5DEA7CD1BD08F1,42204,0,8,8,43,46,2196
36805,36805,E43A1713BA9589398F5DEA7CD1BD08F1,10107,8,10,2,38,49,1949
36806,36806,E43A1713BA9589398F5DEA7CD1BD08F1,13671,12,13,1,27,43,1393
36807,36807,E43A1713BA9589398F5DEA7CD1BD08F1,11011,14,16,2,39,49,1999
36808,36808,E43A1713BA9589398F5DEA7CD1BD08F1,43061,21,23,2,43,46,2196
36817,36817,F9B50F8C0BC548F341BD45D3142A9731,10471,0,1,1,37,48,1898
36818,36818,F9B50F8C0BC548F341BD45D3142A9731,10221,1,9,8,34,49,1749
36819,36819,F9B50F8C0BC548F341BD45D3142A9731,10611,13,14,1,32,48,1648
36820,36820,F9B50F8C0BC548F341BD45D3142A9731,43671,14,17,3,35,48,1798
36821,36821,F9B50F8C0BC548F341BD45D3142A9731,11541,18,20,2,35,49,1799
36822,36822,F9B50F8C0BC548F341BD45D3142A9731,12971,20,21,1,32,48,1648
36823,36823,A922D7161F816C1FD25F52BCCB616DFE,40637,0,5,5,36,47,1847
36824,36824,A922D7161F816C1FD25F52BCCB616DFE,10251,6,9,3,35,47,1797
36825,36825,A922D7161F816C1FD25F52BCCB616DFE,40637,9,10,1,36,47,1847
36826,36826,A922D7161F816C1FD25F52BCCB616DFE,10251,10,12,2,35,47,1797
36827,36827,A922D7161F816C1FD25F52BCCB616DFE,42161,12,13,1,36,47,1847
36828,36828,A922D7161F816C1FD25F52BCCB616DFE,10251,17,19,2,35,47,1797
36829,36829,A922D7161F816C1FD25F52BCCB616DFE,40673,22,23,1,36,48,1848
36834,36834,7DF20745CA3702FAFFAC0138B1B2E95E,12083,4,8,4,36,49,1849
36835,36835,7DF20745CA3702FAFFAC0138B1B2E95E,42201,9,10,1,43,46,2196
36836,36836,7DF20745CA3702FAFFAC0138B1B2E95E,13821,12,13,1,49,45,2495
36837,36837,7DF20745CA3702FAFFAC0138B1B2E95E,13951,15,20,5,47,45,2395
36838,36838,47844E829FCB05D6E87386BF9A1380C3,13601,0,2,2,34,47,1747
36839,36839,47844E829FCB05D6E87386BF9A1380C3,13711,3,8,5,38,46,1946
36840,36840,47844E829FCB05D6E87386BF9A1380C3,42011,12,14,2,36,46,1846
36841,36841,47844E829FCB05D6E87386BF9A1380C3,11021,15,17,2,36,49,1849
36842,36842,47844E829FCB05D6E87386BF9A1380C3,10971,21,23,2,35,47,1797
36843,36843,6294C6841D209A4AD6799616BF189C3A,15051,0,12,12,19,4,954
36844,36844,6294C6841D209A4AD6799616BF189C3A,16281,12,14,2,11,4,554
36845,36845,6294C6841D209A4AD6799616BF189C3A,15051,18,23,5,19,4,954
36865,36865,5AF85D9ED958D0E5348613692DAC5B4D,42121,5,15,10,26,49,1349
36866,36866,5AF85D9ED958D0E5348613692DAC5B4D,43671,18,19,1,35,48,1798
36867,36867,5AF85D9ED958D0E5348613692DAC5B4D,11231,21,23,2,37,49,1899
36868,36868,525655B30753832E11A6455806FEB5D9,13121,1,6,5,38,46,1946
36869,36869,525655B30753832E11A6455806FEB5D9,11941,6,11,5,37,46,1896
36870,36870,525655B30753832E11A6455806FEB5D9,13711,13,17,4,38,46,1946
36871,36871,525655B30753832E11A6455806FEB5D9,40094,18,23,5,29,48,1498
36872,36872,001DCCFA6F6583D96864200E111F44CD,40673,1,8,7,36,48,1848
36873,36873,001DCCFA6F6583D96864200E111F44CD,13094,12,13,1,21,42,1092
36874,36874,001DCCFA6F6583D96864200E111F44CD,11161,14,16,2,32,48,1648
36875,36875,001DCCFA6F6583D96864200E111F44CD,10411,20,23,3,36,48,1848
36876,36876,ECE0FA03A797FCAE4E058BD1C3356073,10111,0,10,10,37,47,1897
36877,36877,ECE0FA03A797FCAE4E058BD1C3356073,42161,10,15,5,36,47,1847
36878,36878,ECE0FA03A797FCAE4E058BD1C3356073,13961,18,20,2,42,48,2148
36888,36888,6C841C7D2D2B53A8BCAAFC5972E77D1F,40341,0,1,1,23,49,1199
36889,36889,6C841C7D2D2B53A8BCAAFC5972E77D1F,42623,4,9,5,22,49,1149
36890,36890,6C841C7D2D2B53A8BCAAFC5972E77D1F,11061,10,11,1,29,48,1498
36891,36891,6C841C7D2D2B53A8BCAAFC5972E77D1F,42081,15,17,2,24,49,1249
36892,36892,6C841C7D2D2B53A8BCAAFC5972E77D1F,42623,18,20,2,22,49,1149
36893,36893,6C841C7D2D2B53A8BCAAFC5972E77D1F,42081,21,23,2,24,49,1249
36898,36898,2917A11EB625CB868E9962150273A0D4,10301,0,5,5,31,45,1595
36899,36899,2917A11EB625CB868E9962150273A0D4,40882,8,11,3,34,49,1749
36900,36900,2917A11EB625CB868E9962150273A0D4,10301,12,13,1,31,45,1595
36901,36901,2917A11EB625CB868E9962150273A0D4,40882,15,17,2,34,49,1749
36902,36902,2917A11EB625CB868E9962150273A0D4,42151,19,23,4,35,45,1795
36903,36903,9D14274002F2A355CCDB0E87AFF875A7,15191,4,16,12,36,27,1827
36904,36904,9D14274002F2A355CCDB0E87AFF875A7,43081,17,18,1,27,28,1378
36905,36905,9D14274002F2A355CCDB0E87AFF875A7,15191,18,19,1,36,27,1827
36906,36906,9D14274002F2A355CCDB0E87AFF875A7,15091,19,21,2,35,26,1776
36907,36907,ACD04627348D28EB014FAB46490D4B92,10351,1,4,3,28,45,1445
36908,36908,ACD04627348D28EB014FAB46490D4B92,13771,4,7,3,21,45,1095
36909,36909,ACD04627348D28EB014FAB46490D4B92,12601,12,15,3,25,47,1297
36910,36910,ACD04627348D28EB014FAB46490D4B92,10351,18,23,5,28,45,1445
36915,36915,3044AD5F90932CCE405DE87EFA97D7EF,19021,0,6,6,10,45,545
36916,36916,3044AD5F90932CCE405DE87EFA97D7EF,43021,8,13,5,16,43,843
36917,36917,3044AD5F90932CCE405DE87EFA97D7EF,19021,13,23,10,10,45,545
36924,36924,D4BA657F29238DB85063BCE654C96D65,40112,0,9,9,32,48,1648
36925,36925,D4BA657F29238DB85063BCE654C96D65,12601,12,13,1,25,47,1297
36926,36926,D4BA657F29238DB85063BCE654C96D65,12731,14,15,1,22,40,1140
36927,36927,D4BA657F29238DB85063BCE654C96D65,10431,17,23,6,33,49,1699
36931,36931,E962C3D0A8FC163364DD770DFBF0ADE9,13651,0,7,7,30,47,1547
36932,36932,E962C3D0A8FC163364DD770DFBF0ADE9,12311,8,12,4,30,44,1544
36933,36933,E962C3D0A8FC163364DD770DFBF0ADE9,41591,13,17,4,34,49,1749
36934,36934,E962C3D0A8FC163364DD770DFBF0ADE9,42941,19,20,1,37,47,1897
36935,36935,11D0C3BFA1EEA48E71CAB72BD84A5D2F,13671,0,6,6,27,43,1393
36936,36936,11D0C3BFA1EEA48E71CAB72BD84A5D2F,10634,7,8,1,27,45,1395
36937,36937,11D0C3BFA1EEA48E71CAB72BD84A5D2F,10351,8,17,9,28,45,1445
36938,36938,11D0C3BFA1EEA48E71CAB72BD84A5D2F,43481,22,23,1,39,48,1998
36939,36939,947EE86E96DF76B9619AD7271E46BF1E,12792,0,2,2,34,30,1730
36940,36940,947EE86E96DF76B9619AD7271E46BF1E,12791,5,6,1,31,29,1579
36941,36941,947EE86E96DF76B9619AD7271E46BF1E,15191,8,16,8,36,27,1827
36942,36942,947EE86E96DF76B9619AD7271E46BF1E,12792,16,17,1,34,30,1730
36943,36943,947EE86E96DF76B9619AD7271E46BF1E,15091,20,23,3,35,26,1776
36944,36944,1C184E544EE72EBCB4C6C69605221F85,42071,0,17,17,31,49,1599
36945,36945,1C184E544EE72EBCB4C6C69605221F85,42081,18,19,1,24,49,1249
36946,36946,1C184E544EE72EBCB4C6C69605221F85,10381,20,23,3,31,49,1599
36947,36947,84725685301668EC3A1E7D2CAE0AC87B,12971,1,7,6,32,48,1648
36948,36948,84725685301668EC3A1E7D2CAE0AC87B,11151,8,13,5,30,48,1548
36949,36949,84725685301668EC3A1E7D2CAE0AC87B,43391,13,14,1,29,48,1498
36950,36950,84725685301668EC3A1E7D2CAE0AC87B,11151,16,17,1,30,48,1548
36951,36951,84725685301668EC3A1E7D2CAE0AC87B,10721,21,23,2,31,48,1598
36963,36963,F49EE04071D0B4FCCD4263F4C2BBEA7A,11151,1,4,3,30,48,1548
36964,36964,F49EE04071D0B4FCCD4263F4C2BBEA7A,11061,7,8,1,29,48,1498
36965,36965,F49EE04071D0B4FCCD4263F4C2BBEA7A,10221,9,18,9,34,49,1749
36966,36966,F49EE04071D0B4FCCD4263F4C2BBEA7A,43761,18,20,2,32,47,1647
36967,36967,F49EE04071D0B4FCCD4263F4C2BBEA7A,11061,21,22,1,29,48,1498
36971,36971,1C0548F40841AD0870DAD8EC7BECCBC6,13314,0,13,13,31,39,1589
36972,36972,1C0548F40841AD0870DAD8EC7BECCBC6,12521,17,18,1,35,41,1791
36973,36973,1C0548F40841AD0870DAD8EC7BECCBC6,13314,21,23,2,31,39,1589
36980,36980,E648A6F090A3BE85617E0ED54A73B4F0,12601,0,2,2,25,47,1297
36981,36981,E648A6F090A3BE85617E0ED54A73B4F0,12671,5,8,3,21,43,1093
36982,36982,E648A6F090A3BE85617E0ED54A73B4F0,12601,9,21,12,25,47,1297
36983,36983,3C07D1557002BF4F1AA6A6D7A8949EF2,43761,0,2,2,32,47,1647
36984,36984,3C07D1557002BF4F1AA6A6D7A8949EF2,42523,2,6,4,31,47,1597
36985,36985,3C07D1557002BF4F1AA6A6D7A8949EF2,12601,8,16,8,25,47,1297
36986,36986,3C07D1557002BF4F1AA6A6D7A8949EF2,42523,18,21,3,31,47,1597
36990,36990,34D648C6A9802AEE7A4D1B7DAB354FFB,10111,0,6,6,37,47,1897
36991,36991,34D648C6A9802AEE7A4D1B7DAB354FFB,40341,7,8,1,23,49,1199
36992,36992,34D648C6A9802AEE7A4D1B7DAB354FFB,12401,9,11,2,39,49,1999
36993,36993,34D648C6A9802AEE7A4D1B7DAB354FFB,10111,12,16,4,37,47,1897
36994,36994,34D648C6A9802AEE7A4D1B7DAB354FFB,10107,19,20,1,38,49,1949
37007,37007,D9419B851F8839F5D675C951F631DB8E,10921,0,7,7,43,48,2198
37008,37008,D9419B851F8839F5D675C951F631DB8E,43101,7,16,9,46,40,2340
37009,37009,D9419B851F8839F5D675C951F631DB8E,10921,18,23,5,43,48,2198
37010,37010,62A4DF59E8BCEC0DCF6C971E2D9209AC,13711,0,7,7,38,46,1946
37011,37011,62A4DF59E8BCEC0DCF6C971E2D9209AC,42471,9,17,8,35,49,1799
37012,37012,62A4DF59E8BCEC0DCF6C971E2D9209AC,10271,19,22,3,37,46,1896
37022,37022,20DB5B836CD323620C599B861A0E47FE,15391,0,7,7,35,26,1776
37023,37023,20DB5B836CD323620C599B861A0E47FE,12792,8,10,2,34,30,1730
37024,37024,20DB5B836CD323620C599B861A0E47FE,16071,12,14,2,3,3,153
37025,37025,20DB5B836CD323620C599B861A0E47FE,12792,16,18,2,34,30,1730
37026,37026,20DB5B836CD323620C599B861A0E47FE,15191,18,19,1,36,27,1827
37027,37027,CA845E04D290A4599030887643A2A4A9,42623,0,7,7,22,49,1149
37028,37028,CA845E04D290A4599030887643A2A4A9,40094,8,11,3,29,48,1498
37029,37029,CA845E04D290A4599030887643A2A4A9,12971,11,14,3,32,48,1648
37030,37030,CA845E04D290A4599030887643A2A4A9,11061,15,16,1,29,48,1498
37031,37031,CA845E04D290A4599030887643A2A4A9,11641,21,23,2,22,49,1149
37035,37035,8B2FE44E562BD25082E7ACF17FCEA459,42271,0,1,1,40,47,2047
37036,37036,8B2FE44E562BD25082E7ACF17FCEA459,11806,5,6,1,41,48,2098
37037,37037,8B2FE44E562BD25082E7ACF17FCEA459,10591,7,9,2,39,48,1998
37038,37038,8B2FE44E562BD25082E7ACF17FCEA459,13681,12,17,5,38,47,1947
37039,37039,8B2FE44E562BD25082E7ACF17FCEA459,10591,18,23,5,39,48,1998
37040,37040,184C01DF5AF7FEEE2B90AA7395647187,42151,1,8,7,35,45,1795
37041,37041,184C01DF5AF7FEEE2B90AA7395647187,43061,12,13,1,43,46,2196
37042,37042,184C01DF5AF7FEEE2B90AA7395647187,42151,14,22,8,35,45,1795
37046,37046,8A524E85431660319A09E8D071AC107B,42321,0,5,5,43,47,2197
37047,37047,8A524E85431660319A09E8D071AC107B,12601,7,8,1,25,47,1297
37048,37048,8A524E85431660319A09E8D071AC107B,13091,12,13,1,20,42,1042
37049,37049,8A524E85431660319A09E8D071AC107B,10801,20,21,1,42,47,2147
37050,37050,8A524E85431660319A09E8D071AC107B,42321,22,23,1,43,47,2197
37069,37069,08DE1E1705AB0D9289DFA85E914CA601,42151,0,2,2,35,45,1795
37070,37070,08DE1E1705AB0D9289DFA85E914CA601,10351,3,4,1,28,45,1445
37071,37071,08DE1E1705AB0D9289DFA85E914CA601,42151,5,22,17,35,45,1795
37072,37072,1DAFF76ACB610741A4BE36A701B9B8ED,11791,0,7,7,38,49,1949
37073,37073,1DAFF76ACB610741A4BE36A701B9B8ED,42071,12,13,1,31,49,1599
37074,37074,1DAFF76ACB610741A4BE36A701B9B8ED,11791,19,23,4,38,49,1949
37075,37075,C5A23DE370CF4EECE90CFE5E8960B981,11641,0,7,7,22,49,1149
37076,37076,C5A23DE370CF4EECE90CFE5E8960B981,40341,11,13,2,23,49,1199
37077,37077,C5A23DE370CF4EECE90CFE5E8960B981,12021,18,19,1,37,49,1899
37088,37088,FF16D1104349162E539969031BE39A02,12511,2,7,5,39,47,1997
37089,37089,FF16D1104349162E539969031BE39A02,12514,8,12,4,38,47,1947
37090,37090,FF16D1104349162E539969031BE39A02,43481,13,15,2,39,48,1998
37091,37091,FF16D1104349162E539969031BE39A02,12511,15,19,4,39,47,1997
37092,37092,FF16D1104349162E539969031BE39A02,43481,21,22,1,39,48,1998
37096,37096,424BA52AF0708BAF01EF6D289BF0AC62,10301,0,13,13,31,45,1595
37097,37097,424BA52AF0708BAF01EF6D289BF0AC62,42511,15,17,2,37,47,1897
37098,37098,424BA52AF0708BAF01EF6D289BF0AC62,42301,18,20,2,36,47,1847
37110,37110,C83A24549690919D158BD0CE80AE31F4,11261,0,4,4,36,46,1846
37111,37111,C83A24549690919D158BD0CE80AE31F4,42864,5,7,2,38,44,1944
37112,37112,C83A24549690919D158BD0CE80AE31F4,11261,10,14,4,36,46,1846
37113,37113,C83A24549690919D158BD0CE80AE31F4,42861,15,16,1,37,44,1894
37114,37114,C83A24549690919D158BD0CE80AE31F4,11261,19,22,3,36,46,1846
37115,37115,D60640DE63138FE979CD83BAA9CD031E,13121,0,2,2,38,46,1946
37116,37116,D60640DE63138FE979CD83BAA9CD031E,43241,4,5,1,36,46,1846
37117,37117,D60640DE63138FE979CD83BAA9CD031E,13121,8,10,2,38,46,1946
37118,37118,D60640DE63138FE979CD83BAA9CD031E,43241,10,15,5,36,46,1846
37119,37119,D60640DE63138FE979CD83BAA9CD031E,13121,17,19,2,38,46,1946
37123,37123,1D0D6D4E6D7B585559D84DC32446A66A,42321,0,1,1,43,47,2197
37124,37124,1D0D6D4E6D7B585559D84DC32446A66A,11701,2,3,1,43,48,2198
37125,37125,1D0D6D4E6D7B585559D84DC32446A66A,42461,4,8,4,45,47,2297
37126,37126,1D0D6D4E6D7B585559D84DC32446A66A,41601,12,17,5,39,49,1999
37127,37127,1D0D6D4E6D7B585559D84DC32446A66A,42461,18,19,1,45,47,2297
37128,37128,1D0D6D4E6D7B585559D84DC32446A66A,11531,20,23,3,34,49,1749
37129,37129,0B929ACA970011AFF649AD1CE667839A,43021,2,7,5,16,43,843
37130,37130,0B929ACA970011AFF649AD1CE667839A,43644,10,11,1,14,38,738
37131,37131,0B929ACA970011AFF649AD1CE667839A,43021,13,23,10,16,43,843
37132,37132,8827A35309A216F0F6E4CBB2FFAC456D,10107,2,9,7,38,49,1949
37133,37133,8827A35309A216F0F6E4CBB2FFAC456D,41031,10,14,4,32,49,1649
37134,37134,8827A35309A216F0F6E4CBB2FFAC456D,42081,18,19,1,24,49,1249
37135,37135,8827A35309A216F0F6E4CBB2FFAC456D,11331,21,22,1,37,48,1898
37139,37139,A5073B9DCBD2B9DEFCC0B1F2FD0DC5E6,13651,0,16,16,30,47,1547
37140,37140,A5073B9DCBD2B9DEFCC0B1F2FD0DC5E6,42141,16,17,1,32,47,1647
37141,37141,A5073B9DCBD2B9DEFCC0B1F2FD0DC5E6,11211,19,21,2,34,49,1749
37142,37142,F2ED260BEE0CFBD7C0D8D1BC36233DE2,12121,0,1,1,29,47,1497
37143,37143,F2ED260BEE0CFBD7C0D8D1BC36233DE2,11381,1,4,3,30,47,1547
37144,37144,F2ED260BEE0CFBD7C0D8D1BC36233DE2,12121,6,8,2,29,47,1497
37145,37145,F2ED260BEE0CFBD7C0D8D1BC36233DE2,11381,9,11,2,30,47,1547
37146,37146,F2ED260BEE0CFBD7C0D8D1BC36233DE2,42521,15,17,2,31,47,1597
37147,37147,F2ED260BEE0CFBD7C0D8D1BC36233DE2,11061,18,20,2,29,48,1498
37148,37148,F2ED260BEE0CFBD7C0D8D1BC36233DE2,12121,21,22,1,29,47,1497
37153,37153,253A422C6572FACDA35B610A2E4ABDE3,15441,0,8,8,44,20,2220
37154,37154,253A422C6572FACDA35B610A2E4ABDE3,12881,9,10,1,47,22,2372
37155,37155,253A422C6572FACDA35B610A2E4ABDE3,15441,10,13,3,44,20,2220
37156,37156,253A422C6572FACDA35B610A2E4ABDE3,12881,14,16,2,47,22,2372
37157,37157,253A422C6572FACDA35B610A2E4ABDE3,15441,16,18,2,44,20,2220
37158,37158,253A422C6572FACDA35B610A2E4ABDE3,12881,20,22,2,47,22,2372
37159,37159,F8873BA61E732629639B137DF35F891C,19441,0,7,7,8,46,446
37160,37160,F8873BA61E732629639B137DF35F891C,11571,9,10,1,13,46,696
37161,37161,F8873BA61E732629639B137DF35F891C,19441,14,23,9,8,46,446
37165,37165,9A369E1280A8BB5227D2B6A5698033ED,13841,8,10,2,40,46,2046
37166,37166,9A369E1280A8BB5227D2B6A5698033ED,42161,11,12,1,36,47,1847
37167,37167,9A369E1280A8BB5227D2B6A5698033ED,11074,15,16,1,37,47,1897
37168,37168,9A369E1280A8BB5227D2B6A5698033ED,10251,16,22,6,35,47,1797
37169,37169,9526CA84048ECDF651C5107129654F39,15145,3,14,11,22,9,1109
37170,37170,9526CA84048ECDF651C5107129654F39,16151,18,19,1,13,11,661
37171,37171,9526CA84048ECDF651C5107129654F39,15145,21,23,2,22,9,1109
37178,37178,D69424C09FF3F80D1752690F40308B44,12601,0,7,7,25,47,1297
37179,37179,D69424C09FF3F80D1752690F40308B44,12311,9,10,1,30,44,1544
37180,37180,D69424C09FF3F80D1752690F40308B44,12601,12,23,11,25,47,1297
37184,37184,FCA3C665B5BF337F331669EDB597A6AC,42791,0,8,8,35,45,1795
37185,37185,FCA3C665B5BF337F331669EDB597A6AC,13121,8,9,1,38,46,1946
37186,37186,FCA3C665B5BF337F331669EDB597A6AC,10271,10,11,1,37,46,1896
37187,37187,FCA3C665B5BF337F331669EDB597A6AC,13121,12,14,2,38,46,1946
37188,37188,FCA3C665B5BF337F331669EDB597A6AC,10271,14,21,7,37,46,1896
37192,37192,2D9F8EEE0946858BEC66856CB73B8335,43021,0,5,5,16,43,843
37193,37193,2D9F8EEE0946858BEC66856CB73B8335,12921,6,17,11,9,41,491
37194,37194,2D9F8EEE0946858BEC66856CB73B8335,43021,20,22,2,16,43,843
37195,37195,C51E252CF4E3CCE91DAD548C30F00035,42021,0,7,7,33,47,1697
37196,37196,C51E252CF4E3CCE91DAD548C30F00035,43451,8,10,2,37,40,1890
37197,37197,C51E252CF4E3CCE91DAD548C30F00035,11021,13,21,8,36,49,1849
37198,37198,C51E252CF4E3CCE91DAD548C30F00035,42021,21,23,2,33,47,1697
37206,37206,C6F9FAB095B3C241CD16CABEB3ADAC42,10111,0,9,9,37,47,1897
37207,37207,C6F9FAB095B3C241CD16CABEB3ADAC42,10531,12,13,1,34,46,1746
37208,37208,C6F9FAB095B3C241CD16CABEB3ADAC42,10111,16,18,2,37,47,1897
37209,37209,C6F9FAB095B3C241CD16CABEB3ADAC42,11861,20,21,1,32,47,1647
37210,37210,EC909F98ED0E6EF5A40A37FA5726A995,42161,0,6,6,36,47,1847
37211,37211,EC909F98ED0E6EF5A40A37FA5726A995,43161,6,12,6,35,47,1797
37212,37212,EC909F98ED0E6EF5A40A37FA5726A995,11061,13,18,5,29,48,1498
37213,37213,EC909F98ED0E6EF5A40A37FA5726A995,10251,21,23,2,35,47,1797
37217,37217,0E91A13D0E931F32EE1FFD96FA252798,42151,7,8,1,35,45,1795
37218,37218,0E91A13D0E931F32EE1FFD96FA252798,42381,12,13,1,39,41,1991
37219,37219,0E91A13D0E931F32EE1FFD96FA252798,42151,14,16,2,35,45,1795
37220,37220,0E91A13D0E931F32EE1FFD96FA252798,42381,20,23,3,39,41,1991
37221,37221,78B0E510C8AC1F29BEBD74E6A2E2C73D,10191,0,7,7,40,48,2048
37222,37222,78B0E510C8AC1F29BEBD74E6A2E2C73D,11161,8,18,10,32,48,1648
37223,37223,78B0E510C8AC1F29BEBD74E6A2E2C73D,10191,18,20,2,40,48,2048
37234,37234,E3F199857752944062C87BF29578D10F,13711,0,11,11,38,46,1946
37235,37235,E3F199857752944062C87BF29578D10F,13731,13,14,1,33,49,1699
37236,37236,E3F199857752944062C87BF29578D10F,10271,17,18,1,37,46,1896
37237,37237,E3F199857752944062C87BF29578D10F,13711,20,23,3,38,46,1946
37242,37242,94092014F9DD3213271810B8D19555BE,49201,0,5,5,7,41,391
37243,37243,94092014F9DD3213271810B8D19555BE,19021,8,10,2,10,45,545
37244,37244,94092014F9DD3213271810B8D19555BE,49201,10,14,4,7,41,391
37245,37245,94092014F9DD3213271810B8D19555BE,43644,15,16,1,14,38,738
37246,37246,94092014F9DD3213271810B8D19555BE,49201,18,22,4,7,41,391
37247,37247,6FD652D798368C322ABC17921EC65CA1,15661,0,12,12,36,26,1826
37248,37248,6FD652D798368C322ABC17921EC65CA1,12511,14,16,2,39,47,1997
37249,37249,6FD652D798368C322ABC17921EC65CA1,10951,20,22,2,29,48,1498
37250,37250,26CDDE90E81CF115EC565EA62A47B92A,42491,0,6,6,32,46,1646
37251,37251,26CDDE90E81CF115EC565EA62A47B92A,10341,9,15,6,31,47,1597
37252,37252,26CDDE90E81CF115EC565EA62A47B92A,19021,17,19,2,10,45,545
37253,37253,11A1F6791BB139142B52DB3053B236D6,11861,2,6,4,32,47,1647
37254,37254,11A1F6791BB139142B52DB3053B236D6,13711,8,15,7,38,46,1946
37255,37255,11A1F6791BB139142B52DB3053B236D6,42801,19,20,1,40,49,2049
37256,37256,D4FFD3DBF31169ED7795F657992DBA3A,11161,0,8,8,32,48,1648
37257,37257,D4FFD3DBF31169ED7795F657992DBA3A,11921,8,10,2,38,48,1948
37258,37258,D4FFD3DBF31169ED7795F657992DBA3A,11021,13,14,1,36,49,1849
37259,37259,D4FFD3DBF31169ED7795F657992DBA3A,10811,15,17,2,38,46,1946
37260,37260,D4FFD3DBF31169ED7795F657992DBA3A,11161,18,23,5,32,48,1648
37261,37261,21CAF4F5B17C418623F51F25C8C984C0,11271,0,12,12,37,48,1898
37262,37262,21CAF4F5B17C418623F51F25C8C984C0,12651,14,15,1,43,47,2197
37263,37263,21CAF4F5B17C418623F51F25C8C984C0,10841,16,17,1,37,47,1897
37264,37264,21CAF4F5B17C418623F51F25C8C984C0,11271,18,23,5,37,48,1898
37271,37271,2C60CBDD38FCCC260C13A921C2C9974B,42691,1,2,1,24,48,1248
37272,37272,2C60CBDD38FCCC260C13A921C2C9974B,12051,6,16,10,20,47,1047
37273,37273,2C60CBDD38FCCC260C13A921C2C9974B,11361,16,20,4,22,48,1148
37274,37274,2C60CBDD38FCCC260C13A921C2C9974B,12581,21,22,1,24,48,1248
37281,37281,3BBCB15C0701B2CA8BD278C2DBBD04B4,42623,0,5,5,22,49,1149
37282,37282,3BBCB15C0701B2CA8BD278C2DBBD04B4,13731,7,8,1,33,49,1699
37283,37283,3BBCB15C0701B2CA8BD278C2DBBD04B4,42071,13,23,10,31,49,1599
37284,37284,1D51AC4BBFB933A632C5A69F521FA887,11861,0,12,12,32,47,1647
37285,37285,1D51AC4BBFB933A632C5A69F521FA887,11271,12,14,2,37,48,1898
37286,37286,1D51AC4BBFB933A632C5A69F521FA887,11861,14,23,9,32,47,1647
37290,37290,D6932FB45D03368B8FD3FCD5E6F4054F,11531,0,1,1,34,49,1749
37291,37291,D6932FB45D03368B8FD3FCD5E6F4054F,11481,1,9,8,41,48,2098
37292,37292,D6932FB45D03368B8FD3FCD5E6F4054F,11541,11,13,2,35,49,1799
37293,37293,D6932FB45D03368B8FD3FCD5E6F4054F,10221,13,15,2,34,49,1749
37294,37294,D6932FB45D03368B8FD3FCD5E6F4054F,42221,18,20,2,38,48,1948
37295,37295,D6932FB45D03368B8FD3FCD5E6F4054F,11481,20,23,3,41,48,2098
37296,37296,6FE087EF982BDB2568A12CCC091731A0,43841,0,6,6,40,37,2037
37297,37297,6FE087EF982BDB2568A12CCC091731A0,43451,8,14,6,37,40,1890
37298,37298,6FE087EF982BDB2568A12CCC091731A0,13071,14,18,4,41,41,2091
37299,37299,6FE087EF982BDB2568A12CCC091731A0,43841,21,23,2,40,37,2037
37300,37300,2F8CA12038D8BFDAC42D43FF94213821,42381,0,6,6,39,41,1991
37301,37301,2F8CA12038D8BFDAC42D43FF94213821,43451,6,8,2,37,40,1890
37302,37302,2F8CA12038D8BFDAC42D43FF94213821,13071,8,10,2,41,41,2091
37303,37303,2F8CA12038D8BFDAC42D43FF94213821,42381,12,13,1,39,41,1991
37304,37304,2F8CA12038D8BFDAC42D43FF94213821,43451,14,18,4,37,40,1890
37305,37305,2F8CA12038D8BFDAC42D43FF94213821,42381,18,22,4,39,41,1991
37310,37310,670568C520C89BECF36566995096FF80,10111,0,6,6,37,47,1897
37311,37311,670568C520C89BECF36566995096FF80,42381,10,11,1,39,41,1991
37312,37312,670568C520C89BECF36566995096FF80,41612,16,18,2,36,47,1847
37313,37313,670568C520C89BECF36566995096FF80,10111,18,20,2,37,47,1897
37317,37317,B9E127195A4DFA1F988A0F90827556AB,11875,8,10,2,30,46,1546
37318,37318,B9E127195A4DFA1F988A0F90827556AB,13951,12,20,8,47,45,2395
37319,37319,B9E127195A4DFA1F988A0F90827556AB,13791,21,23,2,42,47,2147
37320,37320,1F87CA1D778B027B6DE06AC8BD5FBD25,13314,0,8,8,31,39,1589
37321,37321,1F87CA1D778B027B6DE06AC8BD5FBD25,42851,10,12,2,35,41,1791
37322,37322,1F87CA1D778B027B6DE06AC8BD5FBD25,13314,12,23,11,31,39,1589
37323,37323,92A2E6F197B751F18C166017848DFE92,13511,0,8,8,34,48,1748
37324,37324,92A2E6F197B751F18C166017848DFE92,42381,10,12,2,39,41,1991
37325,37325,92A2E6F197B751F18C166017848DFE92,40341,15,17,2,23,49,1199
37326,37326,92A2E6F197B751F18C166017848DFE92,13511,21,22,1,34,48,1748
37327,37327,38E5585960AB9ECEEC01A64CD8D80212,12921,9,10,1,9,41,491
37328,37328,38E5585960AB9ECEEC01A64CD8D80212,12641,12,13,1,10,43,543
37329,37329,38E5585960AB9ECEEC01A64CD8D80212,19021,14,15,1,10,45,545
37330,37330,38E5585960AB9ECEEC01A64CD8D80212,12641,18,20,2,10,43,543
37331,37331,B36C8579A2DBF718933C4838B2421A42,13121,0,1,1,38,46,1946
37332,37332,B36C8579A2DBF718933C4838B2421A42,42511,3,4,1,37,47,1897
37333,37333,B36C8579A2DBF718933C4838B2421A42,13681,4,12,8,38,47,1947
37334,37334,B36C8579A2DBF718933C4838B2421A42,42511,16,17,1,37,47,1897
37335,37335,B36C8579A2DBF718933C4838B2421A42,13121,19,20,1,38,46,1946
37340,37340,1FEA6DBB1D6A3EFCAD8834B49E5C4977,11701,0,7,7,43,48,2198
37341,37341,1FEA6DBB1D6A3EFCAD8834B49E5C4977,13951,8,10,2,47,45,2395
37342,37342,1FEA6DBB1D6A3EFCAD8834B49E5C4977,42091,12,22,10,43,46,2196
37343,37343,1FEA6DBB1D6A3EFCAD8834B49E5C4977,11701,22,23,1,43,48,2198
37344,37344,C77F23D19DAEA5BB8ADE1BB3D3C261B4,13091,0,6,6,20,42,1042
37345,37345,C77F23D19DAEA5BB8ADE1BB3D3C261B4,13911,7,17,10,39,46,1996
37346,37346,C77F23D19DAEA5BB8ADE1BB3D3C261B4,13671,21,23,2,27,43,1393
37350,37350,8CC8D05179B1953DA68ADC08D4EBEE3E,11461,0,8,8,37,49,1899
37351,37351,8CC8D05179B1953DA68ADC08D4EBEE3E,42501,11,12,1,28,47,1447
37352,37352,8CC8D05179B1953DA68ADC08D4EBEE3E,11461,13,14,1,37,49,1899
37353,37353,8CC8D05179B1953DA68ADC08D4EBEE3E,11271,15,17,2,37,48,1898
37354,37354,8CC8D05179B1953DA68ADC08D4EBEE3E,11461,19,23,4,37,49,1899
37362,37362,7B4E6126570CADEFC5C95EC455FF20E3,11914,0,4,4,37,48,1898
37363,37363,7B4E6126570CADEFC5C95EC455FF20E3,43361,7,10,3,38,48,1948
37364,37364,7B4E6126570CADEFC5C95EC455FF20E3,11914,10,13,3,37,48,1898
37365,37365,7B4E6126570CADEFC5C95EC455FF20E3,11921,15,17,2,38,48,1948
37366,37366,7B4E6126570CADEFC5C95EC455FF20E3,11914,18,19,1,37,48,1898
37370,37370,33EAA7EC4927A769D83E7FFC99116427,12051,0,14,14,20,47,1047
37371,37371,33EAA7EC4927A769D83E7FFC99116427,12581,15,16,1,24,48,1248
37372,37372,33EAA7EC4927A769D83E7FFC99116427,12051,21,23,2,20,47,1047
37382,37382,C67AD33695FBB59FE91EDDED93659237,10544,0,8,8,28,48,1448
37383,37383,C67AD33695FBB59FE91EDDED93659237,40094,10,11,1,29,48,1498
37384,37384,C67AD33695FBB59FE91EDDED93659237,10544,13,15,2,28,48,1448
37385,37385,C67AD33695FBB59FE91EDDED93659237,11331,17,20,3,37,48,1898
37393,37393,B20D4CCCBBF9B534BB9F26A35B371E4C,13911,4,5,1,39,46,1996
37394,37394,B20D4CCCBBF9B534BB9F26A35B371E4C,42231,6,7,1,37,46,1896
37395,37395,B20D4CCCBBF9B534BB9F26A35B371E4C,13911,9,10,1,39,46,1996
37396,37396,B20D4CCCBBF9B534BB9F26A35B371E4C,42231,10,14,4,37,46,1896
37397,37397,B20D4CCCBBF9B534BB9F26A35B371E4C,42351,14,15,1,38,45,1945
37398,37398,B20D4CCCBBF9B534BB9F26A35B371E4C,42231,16,23,7,37,46,1896
37399,37399,9266FB789098E2B6437BA2AA65A0F021,10351,0,3,3,28,45,1445
37400,37400,9266FB789098E2B6437BA2AA65A0F021,13671,3,4,1,27,43,1393
37401,37401,9266FB789098E2B6437BA2AA65A0F021,10351,5,7,2,28,45,1445
37402,37402,9266FB789098E2B6437BA2AA65A0F021,11331,8,17,9,37,48,1898
37403,37403,9266FB789098E2B6437BA2AA65A0F021,13651,19,20,1,30,47,1547
37404,37404,87A579BD8EB5C5CE5240DDB8F2C166E2,13671,1,7,6,27,43,1393
37405,37405,87A579BD8EB5C5CE5240DDB8F2C166E2,12521,8,9,1,35,41,1791
37406,37406,87A579BD8EB5C5CE5240DDB8F2C166E2,13041,9,11,2,30,37,1537
37407,37407,87A579BD8EB5C5CE5240DDB8F2C166E2,13671,20,21,1,27,43,1393
37408,37408,87A579BD8EB5C5CE5240DDB8F2C166E2,13314,21,23,2,31,39,1589
37416,37416,0102436000D6EFDA91A3939751E37135,13341,1,6,5,44,45,2245
37417,37417,0102436000D6EFDA91A3939751E37135,12221,9,15,6,43,44,2194
37418,37418,0102436000D6EFDA91A3939751E37135,42631,16,18,2,43,45,2195
37419,37419,0102436000D6EFDA91A3939751E37135,12221,19,20,1,43,44,2194
37420,37420,0102436000D6EFDA91A3939751E37135,42631,21,22,1,43,45,2195
37421,37421,AAF4696620C6353C66227214077A10B8,10771,0,7,7,41,46,2096
37422,37422,AAF4696620C6353C66227214077A10B8,40637,8,9,1,36,47,1847
37423,37423,AAF4696620C6353C66227214077A10B8,10771,12,15,3,41,46,2096
37424,37424,AAF4696620C6353C66227214077A10B8,40637,16,17,1,36,47,1847
37425,37425,AAF4696620C6353C66227214077A10B8,42471,22,23,1,35,49,1799
37426,37426,71216C3E1F8418C02DB017A852AAEF0E,43021,0,16,16,16,43,843
37427,37427,71216C3E1F8418C02DB017A852AAEF0E,12921,17,18,1,9,41,491
37428,37428,71216C3E1F8418C02DB017A852AAEF0E,43021,20,23,3,16,43,843
37432,37432,7B34C273E34CE1CA5EC462EE747405EC,42031,0,6,6,40,46,2046
37433,37433,7B34C273E34CE1CA5EC462EE747405EC,43644,8,12,4,14,38,738
37434,37434,7B34C273E34CE1CA5EC462EE747405EC,12921,14,15,1,9,41,491
37435,37435,7B34C273E34CE1CA5EC462EE747405EC,42031,17,23,6,40,46,2046
37436,37436,9E2ADACD43779004056E7C6B6EAF2437,10921,0,6,6,43,48,2198
37437,37437,9E2ADACD43779004056E7C6B6EAF2437,11231,13,14,1,37,49,1899
37438,37438,9E2ADACD43779004056E7C6B6EAF2437,10901,17,18,1,35,48,1798
37439,37439,9E2ADACD43779004056E7C6B6EAF2437,11271,18,19,1,37,48,1898
37440,37440,2FCEA8AFEE1EB24BBCF386268B1232AC,43311,0,1,1,31,48,1598
37441,37441,2FCEA8AFEE1EB24BBCF386268B1232AC,11061,5,7,2,29,48,1498
37442,37442,2FCEA8AFEE1EB24BBCF386268B1232AC,43311,9,10,1,31,48,1598
37443,37443,2FCEA8AFEE1EB24BBCF386268B1232AC,11161,11,14,3,32,48,1648
37444,37444,2FCEA8AFEE1EB24BBCF386268B1232AC,11061,20,23,3,29,48,1498
37445,37445,FD25FFCA5F46CAEB4AF16FD428D5BE01,43061,0,10,10,43,46,2196
37446,37446,FD25FFCA5F46CAEB4AF16FD428D5BE01,42461,10,11,1,45,47,2297
37447,37447,FD25FFCA5F46CAEB4AF16FD428D5BE01,42091,11,13,2,43,46,2196
37448,37448,FD25FFCA5F46CAEB4AF16FD428D5BE01,42601,14,15,1,44,48,2248
37449,37449,FD25FFCA5F46CAEB4AF16FD428D5BE01,43061,19,23,4,43,46,2196
37450,37450,D429753EEB35077FBB0F7FD7B24671DA,42381,0,5,5,39,41,1991
37451,37451,D429753EEB35077FBB0F7FD7B24671DA,43451,6,9,3,37,40,1890
37452,37452,D429753EEB35077FBB0F7FD7B24671DA,42381,12,13,1,39,41,1991
37453,37453,D429753EEB35077FBB0F7FD7B24671DA,43451,14,18,4,37,40,1890
37454,37454,D429753EEB35077FBB0F7FD7B24671DA,42381,22,23,1,39,41,1991
37458,37458,5CD1F9F9A599BFBDCECB134735F43935,40322,0,9,9,38,46,1946
37459,37459,5CD1F9F9A599BFBDCECB134735F43935,42201,12,13,1,43,46,2196
37460,37460,5CD1F9F9A599BFBDCECB134735F43935,40322,14,23,9,38,46,1946
37464,37464,D256AE34DD31744D7365602849D9C40A,42491,0,7,7,32,46,1646
37465,37465,D256AE34DD31744D7365602849D9C40A,12971,9,12,3,32,48,1648
37466,37466,D256AE34DD31744D7365602849D9C40A,12601,13,15,2,25,47,1297
37467,37467,D256AE34DD31744D7365602849D9C40A,42491,19,21,2,32,46,1646
37468,37468,D256AE34DD31744D7365602849D9C40A,10341,22,23,1,31,47,1597
37469,37469,09757EDFE7795D1E67DCE5C4439A4727,12521,0,6,6,35,41,1791
37470,37470,09757EDFE7795D1E67DCE5C4439A4727,13314,7,8,1,31,39,1589
37471,37471,09757EDFE7795D1E67DCE5C4439A4727,12521,8,13,5,35,41,1791
37472,37472,09757EDFE7795D1E67DCE5C4439A4727,42381,14,16,2,39,41,1991
37473,37473,09757EDFE7795D1E67DCE5C4439A4727,12521,17,23,6,35,41,1791
37481,37481,1DD07CF7FD5B3CCCB4E85025836774E4,12381,0,6,6,32,48,1648
37482,37482,1DD07CF7FD5B3CCCB4E85025836774E4,11231,8,19,11,37,49,1899
37483,37483,1DD07CF7FD5B3CCCB4E85025836774E4,12841,21,23,2,37,47,1897
37484,37484,05286C4B5017A260B39768783F7D4555,42581,0,6,6,38,48,1948
37485,37485,05286C4B5017A260B39768783F7D4555,11914,10,12,2,37,48,1898
37486,37486,05286C4B5017A260B39768783F7D4555,40171,12,13,1,38,48,1948
37487,37487,05286C4B5017A260B39768783F7D4555,11914,15,18,3,37,48,1898
37488,37488,05286C4B5017A260B39768783F7D4555,42581,22,23,1,38,48,1948
37496,37496,4068458184BDA800557C817158947E7F,42521,0,6,6,31,47,1597
37497,37497,4068458184BDA800557C817158947E7F,43581,9,14,5,33,48,1698
37498,37498,4068458184BDA800557C817158947E7F,11201,18,19,1,35,49,1799
37518,37518,BD863194C2279CADB3036229DB39BCE7,10381,1,4,3,31,49,1599
37519,37519,BD863194C2279CADB3036229DB39BCE7,40872,4,7,3,30,49,1549
37520,37520,BD863194C2279CADB3036229DB39BCE7,10381,8,16,8,31,49,1599
37521,37521,BD863194C2279CADB3036229DB39BCE7,13561,19,21,2,37,49,1899
37522,37522,BD863194C2279CADB3036229DB39BCE7,10381,21,23,2,31,49,1599
37527,37527,751B7CB9C035034746EB082217066F97,10711,0,1,1,29,46,1496
37528,37528,751B7CB9C035034746EB082217066F97,10351,2,8,6,28,45,1445
37529,37529,751B7CB9C035034746EB082217066F97,10634,9,10,1,27,45,1395
37530,37530,751B7CB9C035034746EB082217066F97,10351,12,14,2,28,45,1445
37531,37531,751B7CB9C035034746EB082217066F97,10634,16,17,1,27,45,1395
37532,37532,751B7CB9C035034746EB082217066F97,10351,18,23,5,28,45,1445
37540,37540,A0C13743AF441FE8099AA940DA71C612,42581,0,8,8,38,48,1948
37541,37541,A0C13743AF441FE8099AA940DA71C612,11914,8,11,3,37,48,1898
37542,37542,A0C13743AF441FE8099AA940DA71C612,42581,11,13,2,38,48,1948
37543,37543,A0C13743AF441FE8099AA940DA71C612,11914,13,21,8,37,48,1898
37544,37544,A0C13743AF441FE8099AA940DA71C612,42581,21,23,2,38,48,1948
37548,37548,4FA7E2AF35091649A8D61648BF92F5C0,42581,0,7,7,38,48,1948
37549,37549,4FA7E2AF35091649A8D61648BF92F5C0,10471,7,11,4,37,48,1898
37550,37550,4FA7E2AF35091649A8D61648BF92F5C0,42581,12,14,2,38,48,1948
37551,37551,4FA7E2AF35091649A8D61648BF92F5C0,10471,14,21,7,37,48,1898
37552,37552,4FA7E2AF35091649A8D61648BF92F5C0,42581,21,22,1,38,48,1948
37553,37553,802D06E8811CDC65FDAB61E1A1D233B3,10501,0,5,5,22,46,1146
37554,37554,802D06E8811CDC65FDAB61E1A1D233B3,12601,5,8,3,25,47,1297
37555,37555,802D06E8811CDC65FDAB61E1A1D233B3,10691,9,18,9,33,48,1698
37556,37556,94A66B099C3B286235DEE73BAE7FEB6C,11861,0,6,6,32,47,1647
37557,37557,94A66B099C3B286235DEE73BAE7FEB6C,11651,7,8,1,33,47,1697
37558,37558,94A66B099C3B286235DEE73BAE7FEB6C,11861,8,12,4,32,47,1647
37559,37559,94A66B099C3B286235DEE73BAE7FEB6C,10281,12,17,5,33,48,1698
37560,37560,94A66B099C3B286235DEE73BAE7FEB6C,11861,17,23,6,32,47,1647
37565,37565,20EC99C79194942F90F25D8AB841D12A,40833,0,4,4,41,47,2097
37566,37566,20EC99C79194942F90F25D8AB841D12A,43101,7,13,6,46,40,2340
37567,37567,20EC99C79194942F90F25D8AB841D12A,13941,13,23,10,41,47,2097
37571,37571,B95248A393261A4557DDFBDFBDBBE5C4,10221,0,8,8,34,49,1749
37572,37572,B95248A393261A4557DDFBDFBDBBE5C4,42491,9,10,1,32,46,1646
37573,37573,B95248A393261A4557DDFBDFBDBBE5C4,10295,11,12,1,30,47,1547
37574,37574,B95248A393261A4557DDFBDFBDBBE5C4,42491,15,16,1,32,46,1646
37575,37575,B95248A393261A4557DDFBDFBDBBE5C4,11211,20,23,3,34,49,1749
37576,37576,A8DFAF39A5A26AE1BCD9E9DE060BB315,11091,0,5,5,29,47,1497
37577,37577,A8DFAF39A5A26AE1BCD9E9DE060BB315,13651,8,10,2,30,47,1547
37578,37578,A8DFAF39A5A26AE1BCD9E9DE060BB315,11091,11,13,2,29,47,1497
37579,37579,A8DFAF39A5A26AE1BCD9E9DE060BB315,13651,13,15,2,30,47,1547
37580,37580,A8DFAF39A5A26AE1BCD9E9DE060BB315,11091,17,23,6,29,47,1497
37581,37581,D5118C1060949637C0EC09FF8F34F070,42011,0,7,7,36,46,1846
37582,37582,D5118C1060949637C0EC09FF8F34F070,12521,12,13,1,35,41,1791
37583,37583,D5118C1060949637C0EC09FF8F34F070,43241,15,20,5,36,46,1846
37588,37588,550035E235750077DB6B90A64CB04939,11591,0,2,2,36,49,1849
37589,37589,550035E235750077DB6B90A64CB04939,13111,4,11,7,42,46,2146
37590,37590,550035E235750077DB6B90A64CB04939,42461,11,14,3,45,47,2297
37591,37591,550035E235750077DB6B90A64CB04939,42221,15,16,1,38,48,1948
37592,37592,550035E235750077DB6B90A64CB04939,13111,19,20,1,42,46,2146
37597,37597,A4CBFA774BBCB1E081978588796288CA,10901,0,8,8,35,48,1798
37598,37598,A4CBFA774BBCB1E081978588796288CA,11231,8,12,4,37,49,1899
37599,37599,A4CBFA774BBCB1E081978588796288CA,10901,13,14,1,35,48,1798
37600,37600,A4CBFA774BBCB1E081978588796288CA,11231,14,16,2,37,49,1899
37601,37601,A4CBFA774BBCB1E081978588796288CA,12083,17,20,3,36,49,1849
37602,37602,A4CBFA774BBCB1E081978588796288CA,10901,21,23,2,35,48,1798
37610,37610,FCF6425DA3F542476DF1F93935C075D8,42581,0,9,9,38,48,1948
37611,37611,FCF6425DA3F542476DF1F93935C075D8,11914,10,11,1,37,48,1898
37612,37612,FCF6425DA3F542476DF1F93935C075D8,42581,11,16,5,38,48,1948
37613,37613,FCF6425DA3F542476DF1F93935C075D8,11914,18,20,2,37,48,1898
37614,37614,FCF6425DA3F542476DF1F93935C075D8,42581,20,23,3,38,48,1948
37618,37618,3F6CAD363FEAD4E981410D341E6733D0,19441,1,7,6,8,46,446
37619,37619,3F6CAD363FEAD4E981410D341E6733D0,42261,17,19,2,25,49,1299
37620,37620,3F6CAD363FEAD4E981410D341E6733D0,19441,19,21,2,8,46,446
37621,37621,315EE087A7D3E5A0308BA99609B9790D,42531,1,2,1,31,45,1595
37622,37622,315EE087A7D3E5A0308BA99609B9790D,10351,2,6,4,28,45,1445
37623,37623,315EE087A7D3E5A0308BA99609B9790D,42531,8,11,3,31,45,1595
37624,37624,315EE087A7D3E5A0308BA99609B9790D,12491,14,15,1,36,43,1843
37625,37625,315EE087A7D3E5A0308BA99609B9790D,42531,16,23,7,31,45,1595
37639,37639,EABCA927F2D8ADAE0FAD484E88AA40F6,43391,0,7,7,29,48,1498
37640,37640,EABCA927F2D8ADAE0FAD484E88AA40F6,11151,11,12,1,30,48,1548
37641,37641,EABCA927F2D8ADAE0FAD484E88AA40F6,43391,13,15,2,29,48,1498
37642,37642,EABCA927F2D8ADAE0FAD484E88AA40F6,11271,18,19,1,37,48,1898
37643,37643,EABCA927F2D8ADAE0FAD484E88AA40F6,43391,20,23,3,29,48,1498
37650,37650,D65DA5D1BD2C644D67FC7D6BF26E08A8,11061,0,5,5,29,48,1498
37651,37651,D65DA5D1BD2C644D67FC7D6BF26E08A8,42271,8,15,7,40,47,2047
37652,37652,D65DA5D1BD2C644D67FC7D6BF26E08A8,11061,19,23,4,29,48,1498
37653,37653,4B5119258FB3482B746B53277561992F,12601,0,2,2,25,47,1297
37654,37654,4B5119258FB3482B746B53277561992F,12051,2,6,4,20,47,1047
37655,37655,4B5119258FB3482B746B53277561992F,12601,6,9,3,25,47,1297
37656,37656,4B5119258FB3482B746B53277561992F,12051,11,17,6,20,47,1047
37657,37657,4B5119258FB3482B746B53277561992F,12584,18,23,5,24,48,1248
37658,37658,63A1194DA67A916294F825B4249AD293,42511,3,4,1,37,47,1897
37659,37659,63A1194DA67A916294F825B4249AD293,42161,5,7,2,36,47,1847
37660,37660,63A1194DA67A916294F825B4249AD293,11261,8,17,9,36,46,1846
37661,37661,63A1194DA67A916294F825B4249AD293,42351,19,21,2,38,45,1945
37662,37662,63A1194DA67A916294F825B4249AD293,42161,21,23,2,36,47,1847
37666,37666,01DEAB04AFA02849D934CEB410F18A00,19114,0,7,7,7,43,393
37667,37667,01DEAB04AFA02849D934CEB410F18A00,19441,9,10,1,8,46,446
37668,37668,01DEAB04AFA02849D934CEB410F18A00,12641,12,14,2,10,43,543
37669,37669,01DEAB04AFA02849D934CEB410F18A00,19114,14,20,6,7,43,393
37670,37670,01DEAB04AFA02849D934CEB410F18A00,12641,20,22,2,10,43,543
37671,37671,A2D507EA5E3520526C66D89C2499D500,10901,0,7,7,35,48,1798
37672,37672,A2D507EA5E3520526C66D89C2499D500,11914,9,13,4,37,48,1898
37673,37673,A2D507EA5E3520526C66D89C2499D500,42351,13,14,1,38,45,1945
37674,37674,A2D507EA5E3520526C66D89C2499D500,11331,15,17,2,37,48,1898
37675,37675,A2D507EA5E3520526C66D89C2499D500,41591,18,20,2,34,49,1749
37676,37676,A2D507EA5E3520526C66D89C2499D500,10901,20,23,3,35,48,1798
37680,37680,B57FA6A577B54BB28114ABA28733D834,11061,0,16,16,29,48,1498
37681,37681,B57FA6A577B54BB28114ABA28733D834,11021,19,20,1,36,49,1849
37682,37682,B57FA6A577B54BB28114ABA28733D834,13711,21,23,2,38,46,1946
37683,37683,FD210E0B5EAF076DB99FE46F013666AB,42091,0,6,6,43,46,2196
37684,37684,FD210E0B5EAF076DB99FE46F013666AB,13951,8,10,2,47,45,2395
37685,37685,FD210E0B5EAF076DB99FE46F013666AB,13821,11,15,4,49,45,2495
37686,37686,FD210E0B5EAF076DB99FE46F013666AB,11771,17,18,1,39,49,1999
37687,37687,FD210E0B5EAF076DB99FE46F013666AB,42091,21,23,2,43,46,2196
37688,37688,E6C0B95DF19745278BB8C4C83FE2A959,12401,0,6,6,39,49,1999
37689,37689,E6C0B95DF19745278BB8C4C83FE2A959,10221,7,17,10,34,49,1749
37690,37690,E6C0B95DF19745278BB8C4C83FE2A959,12401,20,23,3,39,49,1999
37694,37694,B0EA338E7DC6DCA36F1815FAB86B9F0C,11921,0,7,7,38,48,1948
37695,37695,B0EA338E7DC6DCA36F1815FAB86B9F0C,11861,11,16,5,32,47,1647
37696,37696,B0EA338E7DC6DCA36F1815FAB86B9F0C,11921,18,20,2,38,48,1948
37697,37697,41CC65EB99FB6669F4CD36BC2DEA7CD3,11151,6,8,2,30,48,1548
37698,37698,41CC65EB99FB6669F4CD36BC2DEA7CD3,42121,10,14,4,26,49,1349
37699,37699,41CC65EB99FB6669F4CD36BC2DEA7CD3,42261,14,15,1,25,49,1299
37700,37700,41CC65EB99FB6669F4CD36BC2DEA7CD3,10381,16,19,3,31,49,1599
37701,37701,278E052036B3D515D9E893B8DA72FDF8,11031,0,7,7,42,49,2149
37702,37702,278E052036B3D515D9E893B8DA72FDF8,12601,10,14,4,25,47,1297
37703,37703,278E052036B3D515D9E893B8DA72FDF8,10621,19,21,2,41,49,2099
37704,37704,B7CEFBB66F723F79CB14F193E842A325,11351,0,8,8,36,48,1848
37705,37705,B7CEFBB66F723F79CB14F193E842A325,11061,11,13,2,29,48,1498
37706,37706,B7CEFBB66F723F79CB14F193E842A325,11351,18,19,1,36,48,1848
37710,37710,7F73A642AA11134206C46BA15C785E40,13121,7,8,1,38,46,1946
37711,37711,7F73A642AA11134206C46BA15C785E40,42521,12,14,2,31,47,1597
37712,37712,7F73A642AA11134206C46BA15C785E40,13651,15,22,7,30,47,1547
37713,37713,F8C15A91A86DF78F99B4C068225EACC1,42161,0,1,1,36,47,1847
37714,37714,F8C15A91A86DF78F99B4C068225EACC1,10251,2,3,1,35,47,1797
37715,37715,F8C15A91A86DF78F99B4C068225EACC1,10111,3,12,9,37,47,1897
37716,37716,F8C15A91A86DF78F99B4C068225EACC1,11331,13,18,5,37,48,1898
37717,37717,F8C15A91A86DF78F99B4C068225EACC1,42161,18,23,5,36,47,1847
37732,37732,D048F4DA46E2BE459D38C00513A81B07,11914,1,4,3,37,48,1898
37733,37733,D048F4DA46E2BE459D38C00513A81B07,40171,7,14,7,38,48,1948
37734,37734,D048F4DA46E2BE459D38C00513A81B07,10471,14,15,1,37,48,1898
37735,37735,D048F4DA46E2BE459D38C00513A81B07,40171,16,17,1,38,48,1948
37736,37736,D048F4DA46E2BE459D38C00513A81B07,11271,17,18,1,37,48,1898
37740,37740,F3B474CDCD415AC2258B7CBD95BD7C95,10711,0,6,6,29,46,1496
37741,37741,F3B474CDCD415AC2258B7CBD95BD7C95,10351,7,10,3,28,45,1445
37742,37742,F3B474CDCD415AC2258B7CBD95BD7C95,42871,11,13,2,30,45,1545
37743,37743,F3B474CDCD415AC2258B7CBD95BD7C95,42531,17,19,2,31,45,1595
37744,37744,F3B474CDCD415AC2258B7CBD95BD7C95,13711,21,23,2,38,46,1946
37748,37748,8AB561279CAFD673B81CFFF6F25401C3,12221,0,6,6,43,44,2194
37749,37749,8AB561279CAFD673B81CFFF6F25401C3,43011,6,15,9,40,42,2042
37750,37750,8AB561279CAFD673B81CFFF6F25401C3,12221,16,19,3,43,44,2194
37751,37751,8AB561279CAFD673B81CFFF6F25401C3,43011,21,22,1,40,42,2042
37756,37756,073EBE93660DAEAA6A02C36811E4AA2E,12381,0,9,9,32,48,1648
37757,37757,073EBE93660DAEAA6A02C36811E4AA2E,10471,10,17,7,37,48,1898
37758,37758,073EBE93660DAEAA6A02C36811E4AA2E,12381,19,23,4,32,48,1648
37759,37759,343FDB4C0A32FC084A16DC2CB8DF6772,13941,0,9,9,41,47,2097
37760,37760,343FDB4C0A32FC084A16DC2CB8DF6772,11231,9,11,2,37,49,1899
37761,37761,343FDB4C0A32FC084A16DC2CB8DF6772,13371,16,23,7,41,47,2097
37765,37765,3DBAFDEA494877045EB98704E3E793DC,13911,0,6,6,39,46,1996
37766,37766,3DBAFDEA494877045EB98704E3E793DC,42231,6,7,1,37,46,1896
37767,37767,3DBAFDEA494877045EB98704E3E793DC,42351,8,14,6,38,45,1945
37768,37768,3DBAFDEA494877045EB98704E3E793DC,42231,18,19,1,37,46,1896
37769,37769,3DBAFDEA494877045EB98704E3E793DC,13911,20,23,3,39,46,1996
37770,37770,7F4085A631AA6480B8F111E3ABD451D1,42151,7,9,2,35,45,1795
37771,37771,7F4085A631AA6480B8F111E3ABD451D1,13711,10,11,1,38,46,1946
37772,37772,7F4085A631AA6480B8F111E3ABD451D1,11074,13,15,2,37,47,1897
37773,37773,7F4085A631AA6480B8F111E3ABD451D1,12481,16,18,2,37,49,1899
37774,37774,7F4085A631AA6480B8F111E3ABD451D1,42151,18,23,5,35,45,1795
37775,37775,3A1B49B490CA109FD4D5251F0C86C9CB,43581,0,13,13,33,48,1698
37776,37776,3A1B49B490CA109FD4D5251F0C86C9CB,12601,14,17,3,25,47,1297
37777,37777,3A1B49B490CA109FD4D5251F0C86C9CB,43581,18,23,5,33,48,1698
37778,37778,7B7808F449A709BA37633BF3E740E9A3,42461,0,3,3,45,47,2297
37779,37779,7B7808F449A709BA37633BF3E740E9A3,43051,4,7,3,46,45,2345
37780,37780,7B7808F449A709BA37633BF3E740E9A3,13341,10,11,1,44,45,2245
37781,37781,7B7808F449A709BA37633BF3E740E9A3,43051,12,13,1,46,45,2345
37782,37782,7B7808F449A709BA37633BF3E740E9A3,12211,15,21,6,41,44,2094
37783,37783,7B7808F449A709BA37633BF3E740E9A3,43051,22,23,1,46,45,2345
37788,37788,0E9E7AFF4422B633BEB9D687C008FCF0,43761,0,7,7,32,47,1647
37789,37789,0E9E7AFF4422B633BEB9D687C008FCF0,42523,9,10,1,31,47,1597
37790,37790,0E9E7AFF4422B633BEB9D687C008FCF0,12311,11,15,4,30,44,1544
37791,37791,0E9E7AFF4422B633BEB9D687C008FCF0,43761,17,19,2,32,47,1647
37795,37795,1B550A18B0397F926248F9A2C7B0A9DE,10921,0,8,8,43,48,2198
37796,37796,1B550A18B0397F926248F9A2C7B0A9DE,11201,13,14,1,35,49,1799
37797,37797,1B550A18B0397F926248F9A2C7B0A9DE,10921,18,19,1,43,48,2198
37805,37805,3F7BC333AFC8445B1A1F538D40A9EDC8,11561,0,9,9,32,49,1649
37806,37806,3F7BC333AFC8445B1A1F538D40A9EDC8,42541,12,13,1,25,47,1297
37807,37807,3F7BC333AFC8445B1A1F538D40A9EDC8,41721,14,19,5,39,48,1998
37808,37808,CAB71ABEEBF1083C80884DF4D3D5CD01,11631,5,6,1,12,49,649
37809,37809,CAB71ABEEBF1083C80884DF4D3D5CD01,10471,8,11,3,37,48,1898
37810,37810,CAB71ABEEBF1083C80884DF4D3D5CD01,11201,12,13,1,35,49,1799
37811,37811,CAB71ABEEBF1083C80884DF4D3D5CD01,11811,14,16,2,38,49,1949
37812,37812,CAB71ABEEBF1083C80884DF4D3D5CD01,10471,18,22,4,37,48,1898
37813,37813,EF40E0066D2B74D398400E9B39CEC7B4,12221,0,5,5,43,44,2194
37814,37814,EF40E0066D2B74D398400E9B39CEC7B4,10751,6,8,2,47,43,2393
37815,37815,EF40E0066D2B74D398400E9B39CEC7B4,12211,11,13,2,41,44,2094
37816,37816,EF40E0066D2B74D398400E9B39CEC7B4,12221,14,18,4,43,44,2194
37817,37817,5EC66C5A4B87D37344B296F73CB04D80,11231,0,8,8,37,49,1899
37818,37818,5EC66C5A4B87D37344B296F73CB04D80,10471,9,11,2,37,48,1898
37819,37819,5EC66C5A4B87D37344B296F73CB04D80,11231,11,14,3,37,49,1899
37820,37820,5EC66C5A4B87D37344B296F73CB04D80,10471,15,18,3,37,48,1898
37821,37821,5EC66C5A4B87D37344B296F73CB04D80,11231,19,23,4,37,49,1899
37825,37825,B304D2AD98C7DE24CAE6DD0DA65095F0,10431,0,6,6,33,49,1699
37826,37826,B304D2AD98C7DE24CAE6DD0DA65095F0,43581,7,10,3,33,48,1698
37827,37827,B304D2AD98C7DE24CAE6DD0DA65095F0,42491,10,11,1,32,46,1646
37828,37828,B304D2AD98C7DE24CAE6DD0DA65095F0,43581,13,17,4,33,48,1698
37829,37829,B304D2AD98C7DE24CAE6DD0DA65095F0,10431,19,23,4,33,49,1699
37830,37830,6E4234E109445FFB7193B800D0A5359E,10801,6,8,2,42,47,2147
37831,37831,6E4234E109445FFB7193B800D0A5359E,11021,10,12,2,36,49,1849
37832,37832,6E4234E109445FFB7193B800D0A5359E,13791,17,18,1,42,47,2147
37833,37833,4B2C5F1CB416544E575393F8DC112063,10281,0,6,6,33,48,1698
37834,37834,4B2C5F1CB416544E575393F8DC112063,11861,6,10,4,32,47,1647
37835,37835,4B2C5F1CB416544E575393F8DC112063,42021,10,11,1,33,47,1697
37836,37836,4B2C5F1CB416544E575393F8DC112063,11861,13,18,5,32,47,1647
37837,37837,4B2C5F1CB416544E575393F8DC112063,10281,18,23,5,33,48,1698
37838,37838,EBE3D75CE08F0D8E7A2B9C1EECA988EC,13371,0,5,5,41,47,2097
37839,37839,EBE3D75CE08F0D8E7A2B9C1EECA988EC,13561,7,14,7,37,49,1899
37840,37840,EBE3D75CE08F0D8E7A2B9C1EECA988EC,43731,15,16,1,34,47,1747
37841,37841,EBE3D75CE08F0D8E7A2B9C1EECA988EC,10971,19,20,1,35,47,1797
37842,37842,EBE3D75CE08F0D8E7A2B9C1EECA988EC,13741,21,23,2,37,49,1899
37843,37843,34FB5BF239A7B5016E3CA81F47968839,42161,0,3,3,36,47,1847
37844,37844,34FB5BF239A7B5016E3CA81F47968839,43161,4,6,2,35,47,1797
37845,37845,34FB5BF239A7B5016E3CA81F47968839,42161,6,9,3,36,47,1847
37846,37846,34FB5BF239A7B5016E3CA81F47968839,40961,11,18,7,35,47,1797
37847,37847,34FB5BF239A7B5016E3CA81F47968839,42161,19,21,2,36,47,1847
37848,37848,34FB5BF239A7B5016E3CA81F47968839,40961,21,22,1,35,47,1797
37852,37852,D0C0DA106ECAAAC8A4CA44A17BA4860C,10711,1,12,11,29,46,1496
37853,37853,D0C0DA106ECAAAC8A4CA44A17BA4860C,42941,16,18,2,37,47,1897
37854,37854,D0C0DA106ECAAAC8A4CA44A17BA4860C,10301,22,23,1,31,45,1595
37861,37861,39E8FB5C4AE9A0E0783441178F244CD5,10341,0,7,7,31,47,1597
37862,37862,39E8FB5C4AE9A0E0783441178F244CD5,11201,9,12,3,35,49,1799
37863,37863,39E8FB5C4AE9A0E0783441178F244CD5,10341,13,23,10,31,47,1597
37867,37867,2FCC231DE348255A3F9CDA8D77EEA7DC,12581,0,5,5,24,48,1248
37868,37868,2FCC231DE348255A3F9CDA8D77EEA7DC,12051,6,10,4,20,47,1047
37869,37869,2FCC231DE348255A3F9CDA8D77EEA7DC,12581,13,23,10,24,48,1248
37873,37873,87B1169D5A9BB025C6A10231CEED2118,19621,1,14,13,5,46,296
37874,37874,87B1169D5A9BB025C6A10231CEED2118,13711,15,18,3,38,46,1946
37875,37875,87B1169D5A9BB025C6A10231CEED2118,11861,19,23,4,32,47,1647
37879,37879,F8584A5277683398A2423E9367C858A2,13941,0,7,7,41,47,2097
37880,37880,F8584A5277683398A2423E9367C858A2,19744,9,15,6,6,43,343
37881,37881,F8584A5277683398A2423E9367C858A2,40833,17,19,2,41,47,2097
37882,37882,F8584A5277683398A2423E9367C858A2,10251,21,23,2,35,47,1797
37883,37883,F6265BE8D5B1D90F759154EDAB63EA2C,15191,1,16,15,36,27,1827
37884,37884,F6265BE8D5B1D90F759154EDAB63EA2C,12792,17,19,2,34,30,1730
37885,37885,F6265BE8D5B1D90F759154EDAB63EA2C,15191,19,23,4,36,27,1827
37886,37886,BA7C8B1C36EFBF4BEFC9B5EF9E3EB4BC,10921,0,11,11,43,48,2198
37887,37887,BA7C8B1C36EFBF4BEFC9B5EF9E3EB4BC,10841,12,13,1,37,47,1897
37888,37888,BA7C8B1C36EFBF4BEFC9B5EF9E3EB4BC,10251,14,15,1,35,47,1797
37889,37889,BA7C8B1C36EFBF4BEFC9B5EF9E3EB4BC,40891,15,22,7,37,47,1897
37890,37890,BA7C8B1C36EFBF4BEFC9B5EF9E3EB4BC,10251,22,23,1,35,47,1797
37891,37891,3D2B6E5392F9F9C30BA70AF7A5672793,42581,1,4,3,38,48,1948
37892,37892,3D2B6E5392F9F9C30BA70AF7A5672793,11914,5,8,3,37,48,1898
37893,37893,3D2B6E5392F9F9C30BA70AF7A5672793,42581,11,13,2,38,48,1948
37894,37894,3D2B6E5392F9F9C30BA70AF7A5672793,11914,13,16,3,37,48,1898
37895,37895,3D2B6E5392F9F9C30BA70AF7A5672793,42581,17,22,5,38,48,1948
37899,37899,11C5ACA60B0246DE7069023057E8285F,11381,0,3,3,30,47,1547
37900,37900,11C5ACA60B0246DE7069023057E8285F,11061,4,15,11,29,48,1498
37901,37901,11C5ACA60B0246DE7069023057E8285F,10661,19,21,2,37,49,1899
37908,37908,878BD48D7FC4D4EFC8601CC50E507D8D,43644,0,1,1,14,38,738
37909,37909,878BD48D7FC4D4EFC8601CC50E507D8D,12641,1,14,13,10,43,543
37910,37910,878BD48D7FC4D4EFC8601CC50E507D8D,43021,14,22,8,16,43,843
37918,37918,3BD30092E78F928C91E4887B7831932C,42161,0,7,7,36,47,1847
37919,37919,3BD30092E78F928C91E4887B7831932C,10111,7,11,4,37,47,1897
37920,37920,3BD30092E78F928C91E4887B7831932C,42161,12,13,1,36,47,1847
37921,37921,3BD30092E78F928C91E4887B7831932C,10111,16,18,2,37,47,1897
37922,37922,3BD30092E78F928C91E4887B7831932C,42161,18,22,4,36,47,1847
37926,37926,51591F8EA07D8177C3E0ABFE6A0BF706,42623,0,5,5,22,49,1149
37927,37927,51591F8EA07D8177C3E0ABFE6A0BF706,13731,6,9,3,33,49,1699
37928,37928,51591F8EA07D8177C3E0ABFE6A0BF706,42623,21,22,1,22,49,1149
37932,37932,135EF939D99CED11694D71795A5772B0,19031,0,5,5,1,42,92
37933,37933,135EF939D99CED11694D71795A5772B0,12641,6,10,4,10,43,543
37934,37934,135EF939D99CED11694D71795A5772B0,19031,10,14,4,1,42,92
37935,37935,135EF939D99CED11694D71795A5772B0,12641,14,16,2,10,43,543
37936,37936,135EF939D99CED11694D71795A5772B0,19031,17,23,6,1,42,92
37937,37937,D3EF141BDC81929D7A3D2C86A2B15366,15411,0,9,9,44,27,2227
37938,37938,D3EF141BDC81929D7A3D2C86A2B15366,12611,12,21,9,41,29,2079
37939,37939,D3EF141BDC81929D7A3D2C86A2B15366,15411,22,23,1,44,27,2227
37944,37944,522EF83A0BB6C187BC51EA021D98EB82,10781,0,8,8,35,47,1797
37945,37945,522EF83A0BB6C187BC51EA021D98EB82,10191,8,9,1,40,48,2048
37946,37946,522EF83A0BB6C187BC51EA021D98EB82,10161,10,15,5,35,49,1799
37947,37947,522EF83A0BB6C187BC51EA021D98EB82,43161,18,22,4,35,47,1797
37961,37961,94659C4C1B1A469E566B81B441E10C1D,11074,0,6,6,37,47,1897
37962,37962,94659C4C1B1A469E566B81B441E10C1D,11301,7,16,9,41,49,2099
37963,37963,94659C4C1B1A469E566B81B441E10C1D,11381,20,22,2,30,47,1547
37964,37964,D96201B04F49DA8FE5B344343C2EC845,12601,1,5,4,25,47,1297
37965,37965,D96201B04F49DA8FE5B344343C2EC845,11861,5,11,6,32,47,1647
37966,37966,D96201B04F49DA8FE5B344343C2EC845,10281,11,15,4,33,48,1698
37967,37967,D96201B04F49DA8FE5B344343C2EC845,42151,16,19,3,35,45,1795
37971,37971,A5918B01A4D813C237D11A681347796F,12611,0,10,10,41,29,2079
37972,37972,A5918B01A4D813C237D11A681347796F,15411,14,16,2,44,27,2227
37973,37973,A5918B01A4D813C237D11A681347796F,43391,19,23,4,29,48,1498
37974,37974,7B27DF400F344F6F46338A9F907AAD49,19021,0,6,6,10,45,545
37975,37975,7B27DF400F344F6F46338A9F907AAD49,12641,10,11,1,10,43,543
37976,37976,7B27DF400F344F6F46338A9F907AAD49,19114,11,18,7,7,43,393
37977,37977,7B27DF400F344F6F46338A9F907AAD49,12641,18,23,5,10,43,543
37978,37978,FDC84ADB4B0F83BD345669E56268B1E0,13911,0,6,6,39,46,1996
37979,37979,FDC84ADB4B0F83BD345669E56268B1E0,42461,7,10,3,45,47,2297
37980,37980,FDC84ADB4B0F83BD345669E56268B1E0,13911,12,17,5,39,46,1996
37981,37981,FDC84ADB4B0F83BD345669E56268B1E0,12141,17,21,4,42,45,2145
37982,37982,AAC98D8EB5664A9B5DE56F266CB31991,16281,0,13,13,11,4,554
37983,37983,AAC98D8EB5664A9B5DE56F266CB31991,15143,14,16,2,18,7,907
37984,37984,AAC98D8EB5664A9B5DE56F266CB31991,16281,17,21,4,11,4,554
37985,37985,942A242C54C5AF79C66351D8C7F17676,42691,0,7,7,24,48,1248
37986,37986,942A242C54C5AF79C66351D8C7F17676,43161,9,15,6,35,47,1797
37987,37987,942A242C54C5AF79C66351D8C7F17676,10451,18,23,5,25,48,1298
37994,37994,A820F412F5FC0D875EFD02BFF26862AE,11301,0,8,8,41,49,2099
37995,37995,A820F412F5FC0D875EFD02BFF26862AE,10221,11,14,3,34,49,1749
37996,37996,A820F412F5FC0D875EFD02BFF26862AE,42623,18,20,2,22,49,1149
37997,37997,A820F412F5FC0D875EFD02BFF26862AE,11301,22,23,1,41,49,2099
37998,37998,8F2DCDB1E6ACA3D4E7FFFCA1E99BF72D,43161,2,3,1,35,47,1797
37999,37999,8F2DCDB1E6ACA3D4E7FFFCA1E99BF72D,13651,4,9,5,30,47,1547
38000,38000,8F2DCDB1E6ACA3D4E7FFFCA1E99BF72D,42491,10,12,2,32,46,1646
38001,38001,8F2DCDB1E6ACA3D4E7FFFCA1E99BF72D,43161,16,23,7,35,47,1797
38002,38002,CED172D4DF00B5D6609BC5975E9347F1,13511,1,9,8,34,48,1748
38003,38003,CED172D4DF00B5D6609BC5975E9347F1,11131,11,12,1,33,48,1698
38004,38004,CED172D4DF00B5D6609BC5975E9347F1,11201,13,15,2,35,49,1799
38005,38005,CED172D4DF00B5D6609BC5975E9347F1,10471,19,21,2,37,48,1898
38006,38006,CED172D4DF00B5D6609BC5975E9347F1,11591,21,23,2,36,49,1849
38017,38017,A53DAA006542212C0F792E33874BF547,11661,1,9,8,40,49,2049
38018,38018,A53DAA006542212C0F792E33874BF547,10231,12,18,6,39,49,1999
38019,38019,A53DAA006542212C0F792E33874BF547,43161,18,23,5,35,47,1797
38033,38033,BCCA36AC6DE92B5D284204C1D312B82A,10971,0,7,7,35,47,1797
38034,38034,BCCA36AC6DE92B5D284204C1D312B82A,42801,10,16,6,40,49,2049
38035,38035,BCCA36AC6DE92B5D284204C1D312B82A,43161,18,20,2,35,47,1797
38039,38039,4B0BD3168EF9CD1D084101907AF5A694,42231,0,6,6,37,46,1896
38040,38040,4B0BD3168EF9CD1D084101907AF5A694,43241,9,10,1,36,46,1846
38041,38041,4B0BD3168EF9CD1D084101907AF5A694,13711,12,13,1,38,46,1946
38042,38042,4B0BD3168EF9CD1D084101907AF5A694,43241,17,18,1,36,46,1846
38043,38043,4B0BD3168EF9CD1D084101907AF5A694,13121,21,23,2,38,46,1946
38044,38044,406EDA02B30F2BAE6E77943EDDABB841,42091,0,5,5,43,46,2196
38045,38045,406EDA02B30F2BAE6E77943EDDABB841,11291,6,9,3,40,49,2049
38046,38046,406EDA02B30F2BAE6E77943EDDABB841,42461,11,12,1,45,47,2297
38047,38047,406EDA02B30F2BAE6E77943EDDABB841,42801,13,19,6,40,49,2049
38048,38048,406EDA02B30F2BAE6E77943EDDABB841,42461,20,23,3,45,47,2297
38049,38049,46624C7A7A05E81084BABC40FE8F937C,13314,0,7,7,31,39,1589
38050,38050,46624C7A7A05E81084BABC40FE8F937C,12521,12,18,6,35,41,1791
38051,38051,46624C7A7A05E81084BABC40FE8F937C,13314,18,22,4,31,39,1589
38052,38052,BDB057B79992225ADFEC2992D590CF9A,10411,0,9,9,36,48,1848
38053,38053,BDB057B79992225ADFEC2992D590CF9A,12921,14,15,1,9,41,491
38054,38054,BDB057B79992225ADFEC2992D590CF9A,10411,19,23,4,36,48,1848
38061,38061,FE72309A49FBEB6B76C0E42028E74707,11571,8,11,3,13,46,696
38062,38062,FE72309A49FBEB6B76C0E42028E74707,19441,13,17,4,8,46,446
38063,38063,FE72309A49FBEB6B76C0E42028E74707,42041,20,21,1,10,47,547
38064,38064,4A1082E29116D07A4EA830C32D0BE5ED,12221,1,8,7,43,44,2194
38065,38065,4A1082E29116D07A4EA830C32D0BE5ED,13341,9,11,2,44,45,2245
38066,38066,4A1082E29116D07A4EA830C32D0BE5ED,12221,12,15,3,43,44,2194
38067,38067,4A1082E29116D07A4EA830C32D0BE5ED,12211,15,17,2,41,44,2094
38068,38068,4A1082E29116D07A4EA830C32D0BE5ED,12221,17,23,6,43,44,2194
38078,38078,0601C1762592A99CA3F0778FC011A2CE,13331,1,8,7,38,47,1947
38079,38079,0601C1762592A99CA3F0778FC011A2CE,10601,8,9,1,39,47,1997
38080,38080,0601C1762592A99CA3F0778FC011A2CE,12514,10,13,3,38,47,1947
38081,38081,0601C1762592A99CA3F0778FC011A2CE,10841,13,15,2,37,47,1897
38082,38082,0601C1762592A99CA3F0778FC011A2CE,10601,19,23,4,39,47,1997
38083,38083,B3B2A62E38CBAF40B040383E801282C5,10731,0,7,7,33,47,1697
38084,38084,B3B2A62E38CBAF40B040383E801282C5,10951,8,10,2,29,48,1498
38085,38085,B3B2A62E38CBAF40B040383E801282C5,43751,11,13,2,19,48,998
38086,38086,B3B2A62E38CBAF40B040383E801282C5,10221,17,18,1,34,49,1749
38093,38093,8E007C4DFBE066342DBB5AB7D666AD2F,13551,1,3,2,45,38,2288
38094,38094,8E007C4DFBE066342DBB5AB7D666AD2F,43101,4,6,2,46,40,2340
38095,38095,8E007C4DFBE066342DBB5AB7D666AD2F,12441,10,11,1,47,35,2385
38096,38096,8E007C4DFBE066342DBB5AB7D666AD2F,13551,12,14,2,45,38,2288
38097,38097,8E007C4DFBE066342DBB5AB7D666AD2F,12441,16,23,7,47,35,2385
38098,38098,F1249E9F0C0E4CFC8DF3A999C283E2E8,42791,0,7,7,35,45,1795
38099,38099,F1249E9F0C0E4CFC8DF3A999C283E2E8,10351,8,18,10,28,45,1445
38100,38100,F1249E9F0C0E4CFC8DF3A999C283E2E8,42791,19,23,4,35,45,1795
38101,38101,FA215D037E3ED3281544DD70764B37AD,11021,0,8,8,36,49,1849
38102,38102,FA215D037E3ED3281544DD70764B37AD,42071,11,14,3,31,49,1599
38103,38103,FA215D037E3ED3281544DD70764B37AD,11021,16,23,7,36,49,1849
38104,38104,51E47FDE51716EB36BE96125516194AB,11021,0,9,9,36,49,1849
38105,38105,51E47FDE51716EB36BE96125516194AB,10191,12,14,2,40,48,2048
38106,38106,51E47FDE51716EB36BE96125516194AB,11021,14,23,9,36,49,1849
38110,38110,07671EAD59DF19A3FD49DC960362A664,43161,0,1,1,35,47,1797
38111,38111,07671EAD59DF19A3FD49DC960362A664,42161,1,6,5,36,47,1847
38112,38112,07671EAD59DF19A3FD49DC960362A664,43161,8,9,1,35,47,1797
38113,38113,07671EAD59DF19A3FD49DC960362A664,42771,13,14,1,36,47,1847
38114,38114,07671EAD59DF19A3FD49DC960362A664,43161,16,22,6,35,47,1797
38115,38115,07671EAD59DF19A3FD49DC960362A664,42161,22,23,1,36,47,1847
38137,38137,D2BBD2EBA22826B7346B66497642352E,42271,0,7,7,40,47,2047
38138,38138,D2BBD2EBA22826B7346B66497642352E,11261,7,9,2,36,46,1846
38139,38139,D2BBD2EBA22826B7346B66497642352E,42271,9,12,3,40,47,2047
38140,38140,D2BBD2EBA22826B7346B66497642352E,11261,12,14,2,36,46,1846
38141,38141,D2BBD2EBA22826B7346B66497642352E,42271,14,23,9,40,47,2047
38146,38146,F93D646A1BCE1AFF390EB78A01863C9E,40171,1,5,4,38,48,1948
38147,38147,F93D646A1BCE1AFF390EB78A01863C9E,11914,6,15,9,37,48,1898
38148,38148,F93D646A1BCE1AFF390EB78A01863C9E,42581,15,16,1,38,48,1948
38149,38149,F93D646A1BCE1AFF390EB78A01863C9E,10471,19,22,3,37,48,1898
38150,38150,F93D646A1BCE1AFF390EB78A01863C9E,40171,22,23,1,38,48,1948
38154,38154,193603340935DA55C70322807542A372,19111,0,6,6,9,45,495
38155,38155,193603340935DA55C70322807542A372,12921,7,11,4,9,41,491
38156,38156,193603340935DA55C70322807542A372,11381,12,14,2,30,47,1547
38157,38157,193603340935DA55C70322807542A372,12641,14,17,3,10,43,543
38158,38158,193603340935DA55C70322807542A372,42201,20,23,3,43,46,2196
38159,38159,1A098A3B76F932E59895DF63E6CDA332,11731,0,8,8,36,48,1848
38160,38160,1A098A3B76F932E59895DF63E6CDA332,19114,11,13,2,7,43,393
38161,38161,1A098A3B76F932E59895DF63E6CDA332,11731,15,17,2,36,48,1848
38162,38162,1A098A3B76F932E59895DF63E6CDA332,12514,17,20,3,38,47,1947
38163,38163,1A098A3B76F932E59895DF63E6CDA332,11521,21,22,1,41,48,2098
38170,38170,B555730D2F5209EC18CE54AF1BDFD131,12921,8,9,1,9,41,491
38171,38171,B555730D2F5209EC18CE54AF1BDFD131,19744,11,14,3,6,43,343
38172,38172,B555730D2F5209EC18CE54AF1BDFD131,12921,14,16,2,9,41,491
38173,38173,B555730D2F5209EC18CE54AF1BDFD131,19744,18,22,4,6,43,343
38178,38178,3CD92C1587FA0BBA7305FC70788C8C0D,12561,0,1,1,45,43,2293
38179,38179,3CD92C1587FA0BBA7305FC70788C8C0D,42351,3,5,2,38,45,1945
38180,38180,3CD92C1587FA0BBA7305FC70788C8C0D,13911,6,19,13,39,46,1996
38181,38181,3CD92C1587FA0BBA7305FC70788C8C0D,12561,21,22,1,45,43,2293
38182,38182,92E340B82C56A45F91D53CD2B709557E,42581,1,6,5,38,48,1948
38183,38183,92E340B82C56A45F91D53CD2B709557E,11914,9,11,2,37,48,1898
38184,38184,92E340B82C56A45F91D53CD2B709557E,42581,11,12,1,38,48,1948
38185,38185,92E340B82C56A45F91D53CD2B709557E,11914,16,17,1,37,48,1898
38186,38186,92E340B82C56A45F91D53CD2B709557E,42581,18,21,3,38,48,1948
38187,38187,DE562E077213566DA78895C5D4449486,10411,0,9,9,36,48,1848
38188,38188,DE562E077213566DA78895C5D4449486,12921,11,17,6,9,41,491
38189,38189,DE562E077213566DA78895C5D4449486,10411,19,22,3,36,48,1848
38193,38193,F2229754FABF7F398D6839D6208AC86F,10544,0,8,8,28,48,1448
38194,38194,F2229754FABF7F398D6839D6208AC86F,10381,10,11,1,31,49,1599
38195,38195,F2229754FABF7F398D6839D6208AC86F,10544,12,14,2,28,48,1448
38196,38196,F2229754FABF7F398D6839D6208AC86F,10381,14,15,1,31,49,1599
38197,38197,F2229754FABF7F398D6839D6208AC86F,10544,18,23,5,28,48,1448
38212,38212,078D744FD5840DE4508E7DD5C66617FF,11261,0,5,5,36,46,1846
38213,38213,078D744FD5840DE4508E7DD5C66617FF,42351,6,10,4,38,45,1945
38214,38214,078D744FD5840DE4508E7DD5C66617FF,11261,10,13,3,36,46,1846
38215,38215,078D744FD5840DE4508E7DD5C66617FF,42351,14,19,5,38,45,1945
38216,38216,078D744FD5840DE4508E7DD5C66617FF,11261,20,23,3,36,46,1846
38220,38220,BB5C74D567FCC063983416A8D6F1DE57,42221,0,1,1,38,48,1948
38221,38221,BB5C74D567FCC063983416A8D6F1DE57,12514,1,7,6,38,47,1947
38222,38222,BB5C74D567FCC063983416A8D6F1DE57,15041,10,12,2,36,9,1809
38223,38223,BB5C74D567FCC063983416A8D6F1DE57,16451,14,17,3,5,5,255
38224,38224,BB5C74D567FCC063983416A8D6F1DE57,15041,18,19,1,36,9,1809
38225,38225,E1C859FD8CC74565ED07635B54DBAB6A,43761,0,3,3,32,47,1647
38226,38226,E1C859FD8CC74565ED07635B54DBAB6A,42021,4,6,2,33,47,1697
38227,38227,E1C859FD8CC74565ED07635B54DBAB6A,12601,9,10,1,25,47,1297
38228,38228,E1C859FD8CC74565ED07635B54DBAB6A,11061,11,18,7,29,48,1498
38229,38229,E1C859FD8CC74565ED07635B54DBAB6A,43761,20,23,3,32,47,1647
38234,38234,A5A090591E63A367211B3058D6F881BC,43021,3,4,1,16,43,843
38235,38235,A5A090591E63A367211B3058D6F881BC,12921,9,13,4,9,41,491
38236,38236,A5A090591E63A367211B3058D6F881BC,43021,15,20,5,16,43,843
38237,38237,A5A090591E63A367211B3058D6F881BC,12921,20,23,3,9,41,491
38238,38238,04618E39CCC1E5047B065A0EFB16FDCC,41031,3,8,5,32,49,1649
38239,38239,04618E39CCC1E5047B065A0EFB16FDCC,10781,9,12,3,35,47,1797
38240,38240,04618E39CCC1E5047B065A0EFB16FDCC,11541,16,23,7,35,49,1799
38241,38241,50654F68D94497D10A1C2B9ADDEB1DF4,11551,0,14,14,39,49,1999
38242,38242,50654F68D94497D10A1C2B9ADDEB1DF4,11151,15,17,2,30,48,1548
38243,38243,50654F68D94497D10A1C2B9ADDEB1DF4,12381,17,23,6,32,48,1648
38244,38244,CCBE9BD27BE45DF1D524AAA2624A3639,10841,1,6,5,37,47,1897
38245,38245,CCBE9BD27BE45DF1D524AAA2624A3639,12521,7,9,2,35,41,1791
38246,38246,CCBE9BD27BE45DF1D524AAA2624A3639,40891,14,23,9,37,47,1897
38247,38247,C1BC146C1B557BAE93465B186B08C3FA,42151,0,5,5,35,45,1795
38248,38248,C1BC146C1B557BAE93465B186B08C3FA,19571,8,9,1,1,36,86
38249,38249,C1BC146C1B557BAE93465B186B08C3FA,12311,11,16,5,30,44,1544
38250,38250,C1BC146C1B557BAE93465B186B08C3FA,12661,17,19,2,32,45,1645
38251,38251,C1BC146C1B557BAE93465B186B08C3FA,12311,20,21,1,30,44,1544
38262,38262,1416F951E5270E45A5AEA307C447B5B8,10634,0,14,14,27,45,1395
38263,38263,1416F951E5270E45A5AEA307C447B5B8,11381,15,17,2,30,47,1547
38264,38264,1416F951E5270E45A5AEA307C447B5B8,10351,18,19,1,28,45,1445
38265,38265,048173AED7FA8CAC9113D7DFCAC3F5D4,11201,1,2,1,35,49,1799
38266,38266,048173AED7FA8CAC9113D7DFCAC3F5D4,42491,5,7,2,32,46,1646
38267,38267,048173AED7FA8CAC9113D7DFCAC3F5D4,42141,11,13,2,32,47,1647
38268,38268,048173AED7FA8CAC9113D7DFCAC3F5D4,42491,14,23,9,32,46,1646
38272,38272,C23C395E1758AD19CFCD20328E385B2B,40637,0,7,7,36,47,1847
38273,38273,C23C395E1758AD19CFCD20328E385B2B,10621,8,10,2,41,49,2099
38274,38274,C23C395E1758AD19CFCD20328E385B2B,40637,11,15,4,36,47,1847
38275,38275,C23C395E1758AD19CFCD20328E385B2B,10801,18,20,2,42,47,2147
38276,38276,C23C395E1758AD19CFCD20328E385B2B,12651,20,21,1,43,47,2197
38277,38277,C23C395E1758AD19CFCD20328E385B2B,10801,22,23,1,42,47,2147
38278,38278,F74A692B863D412E165DF48C1089389E,42531,1,5,4,31,45,1595
38279,38279,F74A692B863D412E165DF48C1089389E,10634,8,9,1,27,45,1395
38280,38280,F74A692B863D412E165DF48C1089389E,12311,11,12,1,30,44,1544
38281,38281,F74A692B863D412E165DF48C1089389E,11875,18,19,1,30,46,1546
38282,38282,F74A692B863D412E165DF48C1089389E,12311,19,21,2,30,44,1544
38286,38286,1C04D8021AA3D6ACE9D6057D8C5BDA46,43011,0,16,16,40,42,2042
38287,38287,1C04D8021AA3D6ACE9D6057D8C5BDA46,12211,16,19,3,41,44,2094
38288,38288,1C04D8021AA3D6ACE9D6057D8C5BDA46,10751,21,22,1,47,43,2393
38302,38302,67C51402BBE69AA4B2460EAE686580B0,11081,0,7,7,35,46,1796
38303,38303,67C51402BBE69AA4B2460EAE686580B0,10351,8,15,7,28,45,1445
38304,38304,67C51402BBE69AA4B2460EAE686580B0,11081,19,23,4,35,46,1796
38305,38305,EE3063399E43CC6228D6CA995D624B6F,11431,0,11,11,29,47,1497
38306,38306,EE3063399E43CC6228D6CA995D624B6F,13351,13,17,4,48,48,2448
38307,38307,EE3063399E43CC6228D6CA995D624B6F,11431,19,23,4,29,47,1497
38308,38308,61B1D3194332702D384ACC7835B28F70,12921,0,6,6,9,41,491
38309,38309,61B1D3194332702D384ACC7835B28F70,49201,7,12,5,7,41,391
38310,38310,61B1D3194332702D384ACC7835B28F70,12921,12,14,2,9,41,491
38311,38311,61B1D3194332702D384ACC7835B28F70,49201,14,16,2,7,41,391
38312,38312,61B1D3194332702D384ACC7835B28F70,12921,19,23,4,9,41,491
38313,38313,FBFB039BFE202B4D733B8197A5DE9AA1,43751,1,5,4,19,48,998
38314,38314,FBFB039BFE202B4D733B8197A5DE9AA1,12581,6,17,11,24,48,1248
38315,38315,FBFB039BFE202B4D733B8197A5DE9AA1,43751,18,23,5,19,48,998
38316,38316,AE08A1E713DAA4F0C24DA0563595B4F9,11471,1,7,6,12,48,648
38317,38317,AE08A1E713DAA4F0C24DA0563595B4F9,19441,11,15,4,8,46,446
38318,38318,AE08A1E713DAA4F0C24DA0563595B4F9,12621,17,19,2,10,48,548
38319,38319,AE08A1E713DAA4F0C24DA0563595B4F9,19441,21,22,1,8,46,446
38324,38324,2527F3D0F0549E684FDB52737A33F2CC,42191,0,1,1,38,49,1949
38325,38325,2527F3D0F0549E684FDB52737A33F2CC,11381,1,11,10,30,47,1547
38326,38326,2527F3D0F0549E684FDB52737A33F2CC,40951,12,14,2,36,49,1849
38327,38327,2527F3D0F0549E684FDB52737A33F2CC,11381,18,23,5,30,47,1547
38337,38337,EC861FE21AFD755213652562865FFBF9,43101,9,13,4,46,40,2340
38338,38338,EC861FE21AFD755213652562865FFBF9,13071,14,16,2,41,41,2091
38339,38339,EC861FE21AFD755213652562865FFBF9,43101,16,17,1,46,40,2340
38340,38340,EC861FE21AFD755213652562865FFBF9,13071,17,19,2,41,41,2091
38341,38341,A99656E991272E2D0207AAB7A175C1B5,42981,2,9,7,36,49,1849
38342,38342,A99656E991272E2D0207AAB7A175C1B5,10471,9,10,1,37,48,1898
38343,38343,A99656E991272E2D0207AAB7A175C1B5,42981,11,16,5,36,49,1849
38344,38344,A99656E991272E2D0207AAB7A175C1B5,10471,18,19,1,37,48,1898
38345,38345,A99656E991272E2D0207AAB7A175C1B5,42981,19,23,4,36,49,1849
38349,38349,494D4CE05480984DBEB3A2073E0D7F93,42411,0,8,8,40,49,2049
38350,38350,494D4CE05480984DBEB3A2073E0D7F93,12381,9,13,4,32,48,1648
38351,38351,494D4CE05480984DBEB3A2073E0D7F93,11171,17,18,1,33,48,1698
38352,38352,494D4CE05480984DBEB3A2073E0D7F93,42411,22,23,1,40,49,2049
38353,38353,8B6448FD7DB9F8E2F8F73AFDDD5BFD38,43021,0,4,4,16,43,843
38354,38354,8B6448FD7DB9F8E2F8F73AFDDD5BFD38,12641,6,15,9,10,43,543
38355,38355,8B6448FD7DB9F8E2F8F73AFDDD5BFD38,12921,17,18,1,9,41,491
38356,38356,8B6448FD7DB9F8E2F8F73AFDDD5BFD38,43021,22,23,1,16,43,843
38357,38357,1A7FF5DB1B81FEDB0BCD61CF65662173,11914,0,1,1,37,48,1898
38358,38358,1A7FF5DB1B81FEDB0BCD61CF65662173,11921,2,5,3,38,48,1948
38359,38359,1A7FF5DB1B81FEDB0BCD61CF65662173,19061,13,14,1,3,43,193
38360,38360,1A7FF5DB1B81FEDB0BCD61CF65662173,11914,19,21,2,37,48,1898
38361,38361,1A7FF5DB1B81FEDB0BCD61CF65662173,13961,22,23,1,42,48,2148
38365,38365,BA02C3BCEE7A48A5C905C95BDC29D4FD,15391,1,2,1,35,26,1776
38366,38366,BA02C3BCEE7A48A5C905C95BDC29D4FD,12792,6,7,1,34,30,1730
38367,38367,BA02C3BCEE7A48A5C905C95BDC29D4FD,15391,7,14,7,35,26,1776
38368,38368,BA02C3BCEE7A48A5C905C95BDC29D4FD,12791,16,18,2,31,29,1579
38390,38390,BB6408B6449FE57F7E33631A828BC98E,40171,0,2,2,38,48,1948
38391,38391,BB6408B6449FE57F7E33631A828BC98E,11701,2,3,1,43,48,2198
38392,38392,BB6408B6449FE57F7E33631A828BC98E,42931,3,8,5,41,49,2099
38393,38393,BB6408B6449FE57F7E33631A828BC98E,42201,12,13,1,43,46,2196
38394,38394,BB6408B6449FE57F7E33631A828BC98E,11701,14,19,5,43,48,2198
38395,38395,47CD03C948687C96861434761EE3E932,10621,0,6,6,41,49,2099
38396,38396,47CD03C948687C96861434761EE3E932,19024,8,15,7,9,45,495
38397,38397,47CD03C948687C96861434761EE3E932,10621,17,23,6,41,49,2099
38398,38398,9F589AB01E58B6B2CA9FB997F96CB7F3,13071,0,7,7,41,41,2091
38399,38399,9F589AB01E58B6B2CA9FB997F96CB7F3,43451,9,17,8,37,40,1890
38400,38400,9F589AB01E58B6B2CA9FB997F96CB7F3,13071,19,23,4,41,41,2091
38401,38401,859846C23309918FCF7E37DF9FD45D9F,13911,0,1,1,39,46,1996
38402,38402,859846C23309918FCF7E37DF9FD45D9F,11261,1,2,1,36,46,1846
38403,38403,859846C23309918FCF7E37DF9FD45D9F,13911,3,9,6,39,46,1996
38404,38404,859846C23309918FCF7E37DF9FD45D9F,11261,9,10,1,36,46,1846
38405,38405,859846C23309918FCF7E37DF9FD45D9F,13911,12,16,4,39,46,1996
38406,38406,859846C23309918FCF7E37DF9FD45D9F,42231,16,18,2,37,46,1896
38407,38407,859846C23309918FCF7E37DF9FD45D9F,42351,20,23,3,38,45,1945
38442,38442,C4A46EA5408AA16A0ED0D09924B79885,11701,1,9,8,43,48,2198
38443,38443,C4A46EA5408AA16A0ED0D09924B79885,12083,13,21,8,36,49,1849
38444,38444,C4A46EA5408AA16A0ED0D09924B79885,12651,22,23,1,43,47,2197
38445,38445,C3597363CCC2831C97BE48A34DDBDED4,41021,0,7,7,38,47,1947
38446,38446,C3597363CCC2831C97BE48A34DDBDED4,19621,9,16,7,5,46,296
38447,38447,C3597363CCC2831C97BE48A34DDBDED4,11541,19,21,2,35,49,1799
38448,38448,19FF976328DAF40B2191A4FAD8E693E1,43451,6,17,11,37,40,1890
38449,38449,19FF976328DAF40B2191A4FAD8E693E1,42381,18,19,1,39,41,1991
38450,38450,19FF976328DAF40B2191A4FAD8E693E1,43011,20,21,1,40,42,2042
38451,38451,19FF976328DAF40B2191A4FAD8E693E1,42381,22,23,1,39,41,1991
38452,38452,59644621240D60A0095CD2C9DBFE93CE,12731,1,6,5,22,40,1140
38453,38453,59644621240D60A0095CD2C9DBFE93CE,12871,6,7,1,22,33,1133
38454,38454,59644621240D60A0095CD2C9DBFE93CE,19801,9,14,5,19,26,976
38455,38455,59644621240D60A0095CD2C9DBFE93CE,12871,17,18,1,22,33,1133
38459,38459,3B1652323581ED0C73DAFA8FB6CC2552,43021,3,4,1,16,43,843
38460,38460,3B1652323581ED0C73DAFA8FB6CC2552,12921,7,8,1,9,41,491
38461,38461,3B1652323581ED0C73DAFA8FB6CC2552,43021,9,10,1,16,43,843
38462,38462,3B1652323581ED0C73DAFA8FB6CC2552,12921,14,19,5,9,41,491
38463,38463,8C54F679DD59F109DAF19BDB41D1658A,12121,0,7,7,29,47,1497
38464,38464,8C54F679DD59F109DAF19BDB41D1658A,11461,12,13,1,37,49,1899
38465,38465,8C54F679DD59F109DAF19BDB41D1658A,40673,16,23,7,36,48,1848
38466,38466,D660806FD7BC9C46A70A9EA1D9DA04C6,11951,1,4,3,31,49,1599
38467,38467,D660806FD7BC9C46A70A9EA1D9DA04C6,11954,8,10,2,32,49,1649
38468,38468,D660806FD7BC9C46A70A9EA1D9DA04C6,10431,11,12,1,33,49,1699
38469,38469,D660806FD7BC9C46A70A9EA1D9DA04C6,11954,13,14,1,32,49,1649
38470,38470,D660806FD7BC9C46A70A9EA1D9DA04C6,12971,14,17,3,32,48,1648
38471,38471,D660806FD7BC9C46A70A9EA1D9DA04C6,11021,18,20,2,36,49,1849
38472,38472,D660806FD7BC9C46A70A9EA1D9DA04C6,10901,21,23,2,35,48,1798
38473,38473,90AC20E6CC0B4ABA3A4EAC5C3086C030,13561,0,14,14,37,49,1899
38474,38474,90AC20E6CC0B4ABA3A4EAC5C3086C030,11074,14,15,1,37,47,1897
38475,38475,90AC20E6CC0B4ABA3A4EAC5C3086C030,10151,16,17,1,34,47,1747
38476,38476,90AC20E6CC0B4ABA3A4EAC5C3086C030,13741,18,19,1,37,49,1899
38477,38477,90AC20E6CC0B4ABA3A4EAC5C3086C030,11271,20,22,2,37,48,1898
38484,38484,334215C8018B9C59A4BC561FC24FF2FA,15411,0,11,11,44,27,2227
38485,38485,334215C8018B9C59A4BC561FC24FF2FA,15311,11,12,1,43,25,2175
38486,38486,334215C8018B9C59A4BC561FC24FF2FA,12611,15,18,3,41,29,2079
38487,38487,334215C8018B9C59A4BC561FC24FF2FA,15411,21,23,2,44,27,2227
38491,38491,33BCEDD5738269CE383E561B031EE524,43011,0,6,6,40,42,2042
38492,38492,33BCEDD5738269CE383E561B031EE524,43451,9,17,8,37,40,1890
38493,38493,33BCEDD5738269CE383E561B031EE524,42381,18,23,5,39,41,1991
38494,38494,DFA44588B9F7612E59AB24A1351E5F4F,49201,0,1,1,7,41,391
38495,38495,DFA44588B9F7612E59AB24A1351E5F4F,12921,1,4,3,9,41,491
38496,38496,DFA44588B9F7612E59AB24A1351E5F4F,49201,5,8,3,7,41,391
38497,38497,DFA44588B9F7612E59AB24A1351E5F4F,19181,10,11,1,8,40,440
38498,38498,DFA44588B9F7612E59AB24A1351E5F4F,49201,12,14,2,7,41,391
38499,38499,DFA44588B9F7612E59AB24A1351E5F4F,12921,15,21,6,9,41,491
38500,38500,24576DC2C63BF30A46BA06C33A71F868,11261,6,9,3,36,46,1846
38501,38501,24576DC2C63BF30A46BA06C33A71F868,12491,11,12,1,36,43,1843
38502,38502,24576DC2C63BF30A46BA06C33A71F868,11261,14,16,2,36,46,1846
38503,38503,24576DC2C63BF30A46BA06C33A71F868,43041,19,21,2,41,46,2096
38504,38504,6EB03DEC41F60785258F0AA9E4E23DB1,11281,1,8,7,27,40,1390
38505,38505,6EB03DEC41F60785258F0AA9E4E23DB1,12521,9,18,9,35,41,1791
38506,38506,6EB03DEC41F60785258F0AA9E4E23DB1,11281,19,20,1,27,40,1390
38507,38507,B45D59A19F6B61302F993D2909F39450,12031,0,7,7,33,48,1698
38508,38508,B45D59A19F6B61302F993D2909F39450,43971,8,9,1,30,48,1548
38509,38509,B45D59A19F6B61302F993D2909F39450,11061,10,11,1,29,48,1498
38510,38510,B45D59A19F6B61302F993D2909F39450,43971,11,12,1,30,48,1548
38511,38511,B45D59A19F6B61302F993D2909F39450,12031,13,16,3,33,48,1698
38512,38512,B45D59A19F6B61302F993D2909F39450,13511,18,19,1,34,48,1748
38513,38513,B45D59A19F6B61302F993D2909F39450,12031,22,23,1,33,48,1698
38521,38521,7D108BFB051387A341F75FDC13929BC0,10381,1,7,6,31,49,1599
38522,38522,7D108BFB051387A341F75FDC13929BC0,43181,9,10,1,39,48,1998
38523,38523,7D108BFB051387A341F75FDC13929BC0,10381,15,23,8,31,49,1599
38524,38524,7CB7FF64BE81A0CF357C12C917AEAFB5,43451,0,6,6,37,40,1890
38525,38525,7CB7FF64BE81A0CF357C12C917AEAFB5,13071,9,11,2,41,41,2091
38526,38526,7CB7FF64BE81A0CF357C12C917AEAFB5,43451,13,21,8,37,40,1890
38527,38527,49EBFFED818B81ED7AB867F150330C08,10411,0,10,10,36,48,1848
38528,38528,49EBFFED818B81ED7AB867F150330C08,12921,13,15,2,9,41,491
38529,38529,49EBFFED818B81ED7AB867F150330C08,10411,19,23,4,36,48,1848
38530,38530,6E818382939E5D81157B6B7D4A59B043,10301,2,12,10,31,45,1595
38531,38531,6E818382939E5D81157B6B7D4A59B043,11941,14,18,4,37,46,1896
38532,38532,6E818382939E5D81157B6B7D4A59B043,11324,19,23,4,31,46,1596
38533,38533,E090AE745FE0157CE235544725EE3E3A,12514,0,5,5,38,47,1947
38534,38534,E090AE745FE0157CE235544725EE3E3A,13561,8,10,2,37,49,1899
38535,38535,E090AE745FE0157CE235544725EE3E3A,11021,10,11,1,36,49,1849
38536,38536,E090AE745FE0157CE235544725EE3E3A,13561,14,15,1,37,49,1899
38537,38537,E090AE745FE0157CE235544725EE3E3A,11021,15,17,2,36,49,1849
38538,38538,E090AE745FE0157CE235544725EE3E3A,12514,20,23,3,38,47,1947
38542,38542,C5670345EE4601F7322391B676C614AA,10292,0,8,8,30,47,1547
38543,38543,C5670345EE4601F7322391B676C614AA,13121,13,14,1,38,46,1946
38544,38544,C5670345EE4601F7322391B676C614AA,10292,18,23,5,30,47,1547
38545,38545,7977837C561DAF2BE63B159C5447A829,42371,0,6,6,34,46,1746
38546,38546,7977837C561DAF2BE63B159C5447A829,12731,8,9,1,22,40,1140
38547,38547,7977837C561DAF2BE63B159C5447A829,13671,11,13,2,27,43,1393
38548,38548,7977837C561DAF2BE63B159C5447A829,12521,13,16,3,35,41,1791
38549,38549,7977837C561DAF2BE63B159C5447A829,42371,19,23,4,34,46,1746
38550,38550,09C2A5500F5ABAEEAC932C07F5628EC4,11021,0,8,8,36,49,1849
38551,38551,09C2A5500F5ABAEEAC932C07F5628EC4,43161,8,12,4,35,47,1797
38552,38552,09C2A5500F5ABAEEAC932C07F5628EC4,11731,12,14,2,36,48,1848
38553,38553,09C2A5500F5ABAEEAC932C07F5628EC4,42161,14,19,5,36,47,1847
38554,38554,09C2A5500F5ABAEEAC932C07F5628EC4,11021,20,23,3,36,49,1849
38562,38562,BBCB9918D42B41DEDF16DD7F5A9BE26F,11861,0,9,9,32,47,1647
38563,38563,BBCB9918D42B41DEDF16DD7F5A9BE26F,42161,10,12,2,36,47,1847
38564,38564,BBCB9918D42B41DEDF16DD7F5A9BE26F,11331,13,18,5,37,48,1898
38565,38565,BBCB9918D42B41DEDF16DD7F5A9BE26F,11861,18,23,5,32,47,1647
38566,38566,FEDEF2AAA43A7294016C8832F60DF7EF,11061,0,9,9,29,48,1498
38567,38567,FEDEF2AAA43A7294016C8832F60DF7EF,40341,11,12,1,23,49,1199
38568,38568,FEDEF2AAA43A7294016C8832F60DF7EF,11061,13,22,9,29,48,1498
38569,38569,086873B6FDDAA95F5D97B0E7D1FDE099,13381,0,9,9,39,47,1997
38570,38570,086873B6FDDAA95F5D97B0E7D1FDE099,12514,12,15,3,38,47,1947
38571,38571,086873B6FDDAA95F5D97B0E7D1FDE099,15401,18,20,2,39,25,1975
38572,38572,086873B6FDDAA95F5D97B0E7D1FDE099,42091,21,22,1,43,46,2196
38576,38576,52885050E80DA80FB3437A699501E8B9,11951,0,8,8,31,49,1599
38577,38577,52885050E80DA80FB3437A699501E8B9,12131,12,14,2,32,47,1647
38578,38578,52885050E80DA80FB3437A699501E8B9,11951,14,16,2,31,49,1599
38579,38579,52885050E80DA80FB3437A699501E8B9,19621,18,20,2,5,46,296
38580,38580,52885050E80DA80FB3437A699501E8B9,10381,22,23,1,31,49,1599
38585,38585,D1DB6120B128D9B18D49ED97832CD7DC,12491,1,5,4,36,43,1843
38586,38586,D1DB6120B128D9B18D49ED97832CD7DC,13911,5,7,2,39,46,1996
38587,38587,D1DB6120B128D9B18D49ED97832CD7DC,42231,7,10,3,37,46,1896
38588,38588,D1DB6120B128D9B18D49ED97832CD7DC,11261,10,15,5,36,46,1846
38589,38589,D1DB6120B128D9B18D49ED97832CD7DC,42351,15,18,3,38,45,1945
38590,38590,D1DB6120B128D9B18D49ED97832CD7DC,11261,22,23,1,36,46,1846
38591,38591,9770EA0FBBA8DF8F116981A2C7A68FF7,12514,1,7,6,38,47,1947
38592,38592,9770EA0FBBA8DF8F116981A2C7A68FF7,42221,8,10,2,38,48,1948
38593,38593,9770EA0FBBA8DF8F116981A2C7A68FF7,11301,12,13,1,41,49,2099
38594,38594,9770EA0FBBA8DF8F116981A2C7A68FF7,42071,14,20,6,31,49,1599
38595,38595,9770EA0FBBA8DF8F116981A2C7A68FF7,42221,21,22,1,38,48,1948
38596,38596,878246F0994A234178E3A1EAB638937C,11011,0,6,6,39,49,1999
38597,38597,878246F0994A234178E3A1EAB638937C,40381,9,12,3,32,46,1646
38598,38598,878246F0994A234178E3A1EAB638937C,10107,16,18,2,38,49,1949
38599,38599,878246F0994A234178E3A1EAB638937C,11011,21,22,1,39,49,1999
38600,38600,81565F9704E60766FEFBB47B416D00DF,12581,0,5,5,24,48,1248
38601,38601,81565F9704E60766FEFBB47B416D00DF,12051,6,10,4,20,47,1047
38602,38602,81565F9704E60766FEFBB47B416D00DF,12581,10,23,13,24,48,1248
38603,38603,AD235EE6A83CA7956AB86E8BC887D3C7,11541,0,6,6,35,49,1799
38604,38604,AD235EE6A83CA7956AB86E8BC887D3C7,11021,8,10,2,36,49,1849
38605,38605,AD235EE6A83CA7956AB86E8BC887D3C7,13561,12,15,3,37,49,1899
38606,38606,AD235EE6A83CA7956AB86E8BC887D3C7,11021,15,19,4,36,49,1849
38607,38607,AD235EE6A83CA7956AB86E8BC887D3C7,11541,20,23,3,35,49,1799
38608,38608,809D30997DBB6653E10DF33CB05A97F7,13771,0,2,2,21,45,1095
38609,38609,809D30997DBB6653E10DF33CB05A97F7,12601,2,5,3,25,47,1297
38610,38610,809D30997DBB6653E10DF33CB05A97F7,13771,5,23,18,21,45,1095
38615,38615,5C087BE097BD7C65E07DEF266C8D9DC9,13121,0,1,1,38,46,1946
38616,38616,5C087BE097BD7C65E07DEF266C8D9DC9,43731,4,9,5,34,47,1747
38617,38617,5C087BE097BD7C65E07DEF266C8D9DC9,42161,9,23,14,36,47,1847
38618,38618,391812C5DCCB1AF30A21CF756A4156CF,15391,0,5,5,35,26,1776
38619,38619,391812C5DCCB1AF30A21CF756A4156CF,15191,6,8,2,36,27,1827
38620,38620,391812C5DCCB1AF30A21CF756A4156CF,12792,10,12,2,34,30,1730
38621,38621,391812C5DCCB1AF30A21CF756A4156CF,15191,14,21,7,36,27,1827
38637,38637,132BAF41704DD845C2F70543C3732C4E,13711,0,4,4,38,46,1946
38638,38638,132BAF41704DD845C2F70543C3732C4E,42231,4,9,5,37,46,1896
38639,38639,132BAF41704DD845C2F70543C3732C4E,13711,9,17,8,38,46,1946
38640,38640,132BAF41704DD845C2F70543C3732C4E,42231,17,21,4,37,46,1896
38641,38641,132BAF41704DD845C2F70543C3732C4E,13711,21,23,2,38,46,1946
38646,38646,316627655F42F54997AE20CC3444908E,43021,0,16,16,16,43,843
38647,38647,316627655F42F54997AE20CC3444908E,12921,17,18,1,9,41,491
38648,38648,316627655F42F54997AE20CC3444908E,43021,19,21,2,16,43,843
38649,38649,36C68D591F1BB1615F00290E59A07445,42041,0,5,5,10,47,547
38650,38650,36C68D591F1BB1615F00290E59A07445,19441,8,9,1,8,46,446
38651,38651,36C68D591F1BB1615F00290E59A07445,42041,12,13,1,10,47,547
38652,38652,36C68D591F1BB1615F00290E59A07445,19441,17,18,1,8,46,446
38653,38653,36C68D591F1BB1615F00290E59A07445,42041,19,23,4,10,47,547
38657,38657,15351107348D533F1A62174A9ED24724,12521,0,14,14,35,41,1791
38658,38658,15351107348D533F1A62174A9ED24724,43451,14,16,2,37,40,1890
38659,38659,15351107348D533F1A62174A9ED24724,12521,16,17,1,35,41,1791
38660,38660,15351107348D533F1A62174A9ED24724,13314,20,23,3,31,39,1589
38669,38669,5E3A9775EC6F71047834877FE6191C63,12121,0,7,7,29,47,1497
38670,38670,5E3A9775EC6F71047834877FE6191C63,13121,17,18,1,38,46,1946
38671,38671,5E3A9775EC6F71047834877FE6191C63,13941,19,21,2,41,47,2097
38675,38675,F07AF3102E8E2B1440F07F6A3036E0E0,10521,0,13,13,41,47,2097
38676,38676,F07AF3102E8E2B1440F07F6A3036E0E0,10271,14,15,1,37,46,1896
38677,38677,F07AF3102E8E2B1440F07F6A3036E0E0,11001,18,23,5,42,47,2147
38682,38682,FDF3A555382668B3FCFD730AFF8664D2,10411,0,8,8,36,48,1848
38683,38683,FDF3A555382668B3FCFD730AFF8664D2,10471,9,10,1,37,48,1898
38684,38684,FDF3A555382668B3FCFD730AFF8664D2,10411,11,13,2,36,48,1848
38685,38685,FDF3A555382668B3FCFD730AFF8664D2,10471,15,16,1,37,48,1898
38686,38686,FDF3A555382668B3FCFD730AFF8664D2,10411,19,23,4,36,48,1848
38693,38693,A545182A2F00A2DA09CC5229677054C0,13561,8,11,3,37,49,1899
38694,38694,A545182A2F00A2DA09CC5229677054C0,11531,12,13,1,34,49,1749
38695,38695,A545182A2F00A2DA09CC5229677054C0,11951,19,20,1,31,49,1599
38703,38703,E7A499EFF2705CCA8F4C4AD8B684EDF4,11201,0,8,8,35,49,1799
38704,38704,E7A499EFF2705CCA8F4C4AD8B684EDF4,42141,9,11,2,32,47,1647
38705,38705,E7A499EFF2705CCA8F4C4AD8B684EDF4,12311,16,17,1,30,44,1544
38706,38706,E7A499EFF2705CCA8F4C4AD8B684EDF4,43181,20,21,1,39,48,1998
38710,38710,F32DE273C6A6F5930E11B120C344FA64,42471,0,9,9,35,49,1799
38711,38711,F32DE273C6A6F5930E11B120C344FA64,10471,12,14,2,37,48,1898
38712,38712,F32DE273C6A6F5930E11B120C344FA64,42471,18,21,3,35,49,1799
38713,38713,F32DE273C6A6F5930E11B120C344FA64,40341,21,23,2,23,49,1199
38714,38714,B33328896E0D2DF8F24E9279DE1B216A,13941,7,8,1,41,47,2097
38715,38715,B33328896E0D2DF8F24E9279DE1B216A,10121,11,20,9,36,49,1849
38716,38716,B33328896E0D2DF8F24E9279DE1B216A,13941,20,22,2,41,47,2097
38717,38717,2898255842570985047C3D77FE88DD08,11541,0,6,6,35,49,1799
38718,38718,2898255842570985047C3D77FE88DD08,11021,8,9,1,36,49,1849
38719,38719,2898255842570985047C3D77FE88DD08,11541,11,12,1,35,49,1799
38720,38720,2898255842570985047C3D77FE88DD08,11021,12,16,4,36,49,1849
38721,38721,2898255842570985047C3D77FE88DD08,11541,18,23,5,35,49,1799
38726,38726,34B0487DA91675A6216B605C367EE35D,40094,1,7,6,29,48,1498
38727,38727,34B0487DA91675A6216B605C367EE35D,43581,9,15,6,33,48,1698
38728,38728,34B0487DA91675A6216B605C367EE35D,40951,18,19,1,36,49,1849
38729,38729,34B0487DA91675A6216B605C367EE35D,40094,21,23,2,29,48,1498
38733,38733,C36D58AFDD52041AEA2594D07E8A0F07,42371,0,6,6,34,46,1746
38734,38734,C36D58AFDD52041AEA2594D07E8A0F07,12661,7,8,1,32,45,1645
38735,38735,C36D58AFDD52041AEA2594D07E8A0F07,12491,13,15,2,36,43,1843
38736,38736,C36D58AFDD52041AEA2594D07E8A0F07,13671,16,18,2,27,43,1393
38737,38737,AAC7E9546787DDB508C41969C1E453E7,10292,0,7,7,30,47,1547
38738,38738,AAC7E9546787DDB508C41969C1E453E7,10801,12,15,3,42,47,2147
38739,38739,AAC7E9546787DDB508C41969C1E453E7,13651,18,19,1,30,47,1547
38744,38744,9ED28EE7B3C7580405AD01C155BD6DA2,11074,0,1,1,37,47,1897
38745,38745,9ED28EE7B3C7580405AD01C155BD6DA2,10281,3,19,16,33,48,1698
38746,38746,9ED28EE7B3C7580405AD01C155BD6DA2,42771,20,21,1,36,47,1847
38758,38758,1F6BCFEB56D245CBF5160F742055C8A2,11151,0,6,6,30,48,1548
38759,38759,1F6BCFEB56D245CBF5160F742055C8A2,11331,7,12,5,37,48,1898
38760,38760,1F6BCFEB56D245CBF5160F742055C8A2,11061,14,18,4,29,48,1498
38761,38761,1F6BCFEB56D245CBF5160F742055C8A2,11151,20,21,1,30,48,1548
38762,38762,7D5A0E77703D6999456241ED42B99D9C,10331,0,13,13,39,46,1996
38763,38763,7D5A0E77703D6999456241ED42B99D9C,40951,15,17,2,36,49,1849
38764,38764,7D5A0E77703D6999456241ED42B99D9C,11751,17,19,2,35,48,1798
38765,38765,7D5A0E77703D6999456241ED42B99D9C,40951,20,23,3,36,49,1849
38775,38775,708245445240AEE955295B4DABE28B19,11151,2,10,8,30,48,1548
38776,38776,708245445240AEE955295B4DABE28B19,10381,15,16,1,31,49,1599
38777,38777,708245445240AEE955295B4DABE28B19,11631,20,22,2,12,49,649
38778,38778,8820D655222FFDC13E2E08EC252AACD5,10971,0,8,8,35,47,1797
38779,38779,8820D655222FFDC13E2E08EC252AACD5,43731,9,11,2,34,47,1747
38780,38780,8820D655222FFDC13E2E08EC252AACD5,11491,13,14,1,36,47,1847
38781,38781,8820D655222FFDC13E2E08EC252AACD5,43731,17,18,1,34,47,1747
38782,38782,8820D655222FFDC13E2E08EC252AACD5,40431,20,22,2,36,47,1847
38783,38783,36B8ED34D53B26B1465947449FAB0DA5,10111,0,5,5,37,47,1897
38784,38784,36B8ED34D53B26B1465947449FAB0DA5,40341,7,8,1,23,49,1199
38785,38785,36B8ED34D53B26B1465947449FAB0DA5,12401,9,10,1,39,49,1999
38786,38786,36B8ED34D53B26B1465947449FAB0DA5,10111,12,18,6,37,47,1897
38787,38787,36B8ED34D53B26B1465947449FAB0DA5,10107,18,20,2,38,49,1949
38792,38792,EC8D784C19C185B8F2C30A9ECA831652,13911,0,6,6,39,46,1996
38793,38793,EC8D784C19C185B8F2C30A9ECA831652,11261,6,10,4,36,46,1846
38794,38794,EC8D784C19C185B8F2C30A9ECA831652,13911,13,14,1,39,46,1996
38795,38795,EC8D784C19C185B8F2C30A9ECA831652,11261,14,19,5,36,46,1846
38796,38796,EC8D784C19C185B8F2C30A9ECA831652,13911,21,22,1,39,46,1996
38797,38797,9DA4BB2C882A7F80C23A8CE3C669C4E5,12971,0,7,7,32,48,1648
38798,38798,9DA4BB2C882A7F80C23A8CE3C669C4E5,10721,11,13,2,31,48,1598
38799,38799,9DA4BB2C882A7F80C23A8CE3C669C4E5,10281,13,15,2,33,48,1698
38800,38800,9DA4BB2C882A7F80C23A8CE3C669C4E5,11021,15,16,1,36,49,1849
38801,38801,9DA4BB2C882A7F80C23A8CE3C669C4E5,12971,19,23,4,32,48,1648
38802,38802,F6FE1A260395BDD29DB061BE68D41F0B,10716,0,7,7,30,46,1546
38803,38803,F6FE1A260395BDD29DB061BE68D41F0B,12601,11,13,2,25,47,1297
38804,38804,F6FE1A260395BDD29DB061BE68D41F0B,42491,14,16,2,32,46,1646
38805,38805,F6FE1A260395BDD29DB061BE68D41F0B,10716,17,19,2,30,46,1546
38806,38806,F6FE1A260395BDD29DB061BE68D41F0B,42491,19,21,2,32,46,1646
38807,38807,F6FE1A260395BDD29DB061BE68D41F0B,10716,22,23,1,30,46,1546
38808,38808,3D10A8B91BAAB1D131EC95F16000CB8B,11021,8,11,3,36,49,1849
38809,38809,3D10A8B91BAAB1D131EC95F16000CB8B,42623,12,13,1,22,49,1149
38810,38810,3D10A8B91BAAB1D131EC95F16000CB8B,11021,16,18,2,36,49,1849
38814,38814,38EAD9C71E0631172BE43F523D61F0B8,42971,0,14,14,43,49,2199
38815,38815,38EAD9C71E0631172BE43F523D61F0B8,11381,15,18,3,30,47,1547
38816,38816,38EAD9C71E0631172BE43F523D61F0B8,42971,19,23,4,43,49,2199
38828,38828,7FC5EC6D5DFA02928A2B6D37E8B80603,43011,0,5,5,40,42,2042
38829,38829,7FC5EC6D5DFA02928A2B6D37E8B80603,43101,7,9,2,46,40,2340
38830,38830,7FC5EC6D5DFA02928A2B6D37E8B80603,13551,11,18,7,45,38,2288
38834,38834,9F99A72527E81B89BEB16DB21B613CC0,10281,0,13,13,33,48,1698
38835,38835,9F99A72527E81B89BEB16DB21B613CC0,40341,14,15,1,23,49,1199
38836,38836,9F99A72527E81B89BEB16DB21B613CC0,10281,18,21,3,33,48,1698
38837,38837,C8236143E8B93D5FDE499177CF2B28F7,11381,0,15,15,30,47,1547
38838,38838,C8236143E8B93D5FDE499177CF2B28F7,40094,15,16,1,29,48,1498
38839,38839,C8236143E8B93D5FDE499177CF2B28F7,11381,16,18,2,30,47,1547
38840,38840,C8236143E8B93D5FDE499177CF2B28F7,11151,19,21,2,30,48,1548
38841,38841,C8236143E8B93D5FDE499177CF2B28F7,11381,21,23,2,30,47,1547
38846,38846,1AA4035AA5CAFF9DEDB0DEF2EBA8DFEF,11914,7,8,1,37,48,1898
38847,38847,1AA4035AA5CAFF9DEDB0DEF2EBA8DFEF,10841,9,10,1,37,47,1897
38848,38848,1AA4035AA5CAFF9DEDB0DEF2EBA8DFEF,11331,11,12,1,37,48,1898
38849,38849,1AA4035AA5CAFF9DEDB0DEF2EBA8DFEF,10785,16,17,1,35,47,1797
38850,38850,1AA4035AA5CAFF9DEDB0DEF2EBA8DFEF,11914,17,23,6,37,48,1898
38854,38854,0240C6CB2D3A7939805C208EBF5A2082,13651,0,11,11,30,47,1547
38855,38855,0240C6CB2D3A7939805C208EBF5A2082,40951,13,15,2,36,49,1849
38856,38856,0240C6CB2D3A7939805C208EBF5A2082,12021,19,21,2,37,49,1899
38857,38857,D607A1387402F8DDB9B6F3E701F820EE,42121,7,12,5,26,49,1349
38858,38858,D607A1387402F8DDB9B6F3E701F820EE,11021,16,17,1,36,49,1849
38859,38859,D607A1387402F8DDB9B6F3E701F820EE,42121,20,22,2,26,49,1349
38863,38863,2E7B2253AC418B1A43B0E145571CC5CD,42511,0,9,9,37,47,1897
38864,38864,2E7B2253AC418B1A43B0E145571CC5CD,13101,12,13,1,40,47,2047
38865,38865,2E7B2253AC418B1A43B0E145571CC5CD,10781,15,16,1,35,47,1797
38866,38866,2E7B2253AC418B1A43B0E145571CC5CD,10221,18,19,1,34,49,1749
38870,38870,FADBD24FB94D9388BE2E59D5F595D57D,42201,10,11,1,43,46,2196
38871,38871,FADBD24FB94D9388BE2E59D5F595D57D,42461,15,17,2,45,47,2297
38872,38872,FADBD24FB94D9388BE2E59D5F595D57D,11481,17,20,3,41,48,2098
38873,38873,FADBD24FB94D9388BE2E59D5F595D57D,40431,22,23,1,36,47,1847
38880,38880,E4BBDF95EAE9C03A1D9EA65966C607FE,11661,0,8,8,40,49,2049
38881,38881,E4BBDF95EAE9C03A1D9EA65966C607FE,42401,9,18,9,36,47,1847
38882,38882,E4BBDF95EAE9C03A1D9EA65966C607FE,11661,20,23,3,40,49,2049
38886,38886,9F8B1DD6D80751B4C4B13C705B0FAEDB,15391,0,7,7,35,26,1776
38887,38887,9F8B1DD6D80751B4C4B13C705B0FAEDB,12792,8,9,1,34,30,1730
38888,38888,9F8B1DD6D80751B4C4B13C705B0FAEDB,15391,10,12,2,35,26,1776
38889,38889,9F8B1DD6D80751B4C4B13C705B0FAEDB,12792,12,22,10,34,30,1730
38897,38897,0D9AA89290D1F445356B85B4B256A343,11001,1,8,7,42,47,2147
38898,38898,0D9AA89290D1F445356B85B4B256A343,42201,8,10,2,43,46,2196
38899,38899,0D9AA89290D1F445356B85B4B256A343,11001,12,13,1,42,47,2147
38900,38900,0D9AA89290D1F445356B85B4B256A343,13941,13,15,2,41,47,2097
38901,38901,0D9AA89290D1F445356B85B4B256A343,11001,16,23,7,42,47,2147
38906,38906,CC9D6055E50B8BEAE50E7B56B0FCD1E7,10471,0,9,9,37,48,1898
38907,38907,CC9D6055E50B8BEAE50E7B56B0FCD1E7,11301,12,14,2,41,49,2099
38908,38908,CC9D6055E50B8BEAE50E7B56B0FCD1E7,10661,15,17,2,37,49,1899
38909,38909,CC9D6055E50B8BEAE50E7B56B0FCD1E7,10471,17,23,6,37,48,1898
38930,38930,004C4A1986E184D2F11887515F258CC6,12131,1,9,8,32,47,1647
38931,38931,004C4A1986E184D2F11887515F258CC6,42531,13,15,2,31,45,1595
38932,38932,004C4A1986E184D2F11887515F258CC6,12311,17,21,4,30,44,1544
38937,38937,15BA009B68D87958E0A9656ADB01E7D6,42371,2,8,6,34,46,1746
38938,38938,15BA009B68D87958E0A9656ADB01E7D6,10511,9,19,10,35,46,1796
38939,38939,15BA009B68D87958E0A9656ADB01E7D6,43001,20,22,2,47,47,2397
38946,38946,10ABDFD0F4CB2AA94EB148DB034D5020,10111,0,9,9,37,47,1897
38947,38947,10ABDFD0F4CB2AA94EB148DB034D5020,43761,13,16,3,32,47,1647
38948,38948,10ABDFD0F4CB2AA94EB148DB034D5020,10111,19,22,3,37,47,1897
38949,38949,DAFE070AC8164EB683B9455E05DD84E1,13101,0,1,1,40,47,2047
38950,38950,DAFE070AC8164EB683B9455E05DD84E1,40833,2,7,5,41,47,2097
38951,38951,DAFE070AC8164EB683B9455E05DD84E1,11481,8,10,2,41,48,2098
38952,38952,DAFE070AC8164EB683B9455E05DD84E1,40833,12,13,1,41,47,2097
38953,38953,DAFE070AC8164EB683B9455E05DD84E1,11481,14,15,1,41,48,2098
38954,38954,DAFE070AC8164EB683B9455E05DD84E1,13101,18,23,5,40,47,2047
38958,38958,0C082730D94DAD2A3534B4A3313D4403,13711,0,7,7,38,46,1946
38959,38959,0C082730D94DAD2A3534B4A3313D4403,42301,9,11,2,36,47,1847
38960,38960,0C082730D94DAD2A3534B4A3313D4403,13121,14,15,1,38,46,1946
38961,38961,0C082730D94DAD2A3534B4A3313D4403,42301,16,17,1,36,47,1847
38962,38962,0C082730D94DAD2A3534B4A3313D4403,13121,19,21,2,38,46,1946
38963,38963,0C082730D94DAD2A3534B4A3313D4403,42301,22,23,1,36,47,1847
38967,38967,E748F2254AC2A75A1317C0ED54387A7E,42831,0,6,6,27,48,1398
38968,38968,E748F2254AC2A75A1317C0ED54387A7E,42071,8,10,2,31,49,1599
38969,38969,E748F2254AC2A75A1317C0ED54387A7E,42831,12,23,11,27,48,1398
38970,38970,2510A335FA627692203CB5C3136C3C6E,43081,0,5,5,27,28,1378
38971,38971,2510A335FA627692203CB5C3136C3C6E,15184,5,6,1,29,22,1472
38972,38972,2510A335FA627692203CB5C3136C3C6E,43081,6,14,8,27,28,1378
38973,38973,2510A335FA627692203CB5C3136C3C6E,15321,15,21,6,29,26,1476
38983,38983,457B779D00720128DC52229000CD7309,15114,0,10,10,22,16,1116
38984,38984,457B779D00720128DC52229000CD7309,16441,12,13,1,15,17,767
38985,38985,457B779D00720128DC52229000CD7309,15114,16,18,2,22,16,1116
38986,38986,E42ED8B8B8ABEC36971CD7FB702F959D,11381,0,7,7,30,47,1547
38987,38987,E42ED8B8B8ABEC36971CD7FB702F959D,40381,8,10,2,32,46,1646
38988,38988,E42ED8B8B8ABEC36971CD7FB702F959D,13561,12,14,2,37,49,1899
38989,38989,E42ED8B8B8ABEC36971CD7FB702F959D,12391,15,18,3,36,49,1849
38990,38990,E42ED8B8B8ABEC36971CD7FB702F959D,11381,19,23,4,30,47,1547
38991,38991,DC736499F15CC90E33F3F344F148EB89,12083,0,1,1,36,49,1849
38992,38992,DC736499F15CC90E33F3F344F148EB89,40171,1,2,1,38,48,1948
38993,38993,DC736499F15CC90E33F3F344F148EB89,13271,3,23,20,41,47,2097
38997,38997,B8DCAC0FC6FA981D871032E55C240C8E,11914,1,5,4,37,48,1898
38998,38998,B8DCAC0FC6FA981D871032E55C240C8E,10921,7,9,2,43,48,2198
38999,38999,B8DCAC0FC6FA981D871032E55C240C8E,11914,11,22,11,37,48,1898
39009,39009,46D10B971C10D2856504DC61068F66E7,19024,0,7,7,9,45,495
39010,39010,46D10B971C10D2856504DC61068F66E7,11951,9,10,1,31,49,1599
39011,39011,46D10B971C10D2856504DC61068F66E7,19111,12,22,10,9,45,495
39015,39015,0E002027D741B8AED4EE58E469659344,10501,0,2,2,22,46,1146
39016,39016,0E002027D741B8AED4EE58E469659344,10061,6,8,2,20,46,1046
39017,39017,0E002027D741B8AED4EE58E469659344,12601,8,14,6,25,47,1297
39018,39018,0E002027D741B8AED4EE58E469659344,10061,15,17,2,20,46,1046
39019,39019,0E002027D741B8AED4EE58E469659344,10501,22,23,1,22,46,1146
39024,39024,130430CD9D77B92F7F996ACBC9C0CCF4,10221,0,9,9,34,49,1749
39025,39025,130430CD9D77B92F7F996ACBC9C0CCF4,11701,12,14,2,43,48,2198
39026,39026,130430CD9D77B92F7F996ACBC9C0CCF4,10221,14,15,1,34,49,1749
39027,39027,130430CD9D77B92F7F996ACBC9C0CCF4,42623,17,18,1,22,49,1149
39028,39028,130430CD9D77B92F7F996ACBC9C0CCF4,10221,21,22,1,34,49,1749
39029,39029,39179060954ADF536A44D5CDC3D7ADA4,10921,0,5,5,43,48,2198
39030,39030,39179060954ADF536A44D5CDC3D7ADA4,11261,7,10,3,36,46,1846
39031,39031,39179060954ADF536A44D5CDC3D7ADA4,13911,13,16,3,39,46,1996
39032,39032,39179060954ADF536A44D5CDC3D7ADA4,11261,16,23,7,36,46,1846
39033,39033,2AAF43D3E248BC96758C66C2CEB202CD,42531,0,7,7,31,45,1595
39034,39034,2AAF43D3E248BC96758C66C2CEB202CD,12311,9,13,4,30,44,1544
39035,39035,2AAF43D3E248BC96758C66C2CEB202CD,40341,15,18,3,23,49,1199
39036,39036,2AAF43D3E248BC96758C66C2CEB202CD,42531,21,23,2,31,45,1595
39040,39040,CFB5B91AB0CD7543884ADBE535AD19D6,43021,0,2,2,16,43,843
39041,39041,CFB5B91AB0CD7543884ADBE535AD19D6,12641,7,16,9,10,43,543
39042,39042,CFB5B91AB0CD7543884ADBE535AD19D6,19021,17,18,1,10,45,545
39043,39043,CFB5B91AB0CD7543884ADBE535AD19D6,12921,21,22,1,9,41,491
39048,39048,2AB1E00AE324EB01DB00242758B61F8A,11001,0,7,7,42,47,2147
39049,39049,2AB1E00AE324EB01DB00242758B61F8A,40951,9,10,1,36,49,1849
39050,39050,2AB1E00AE324EB01DB00242758B61F8A,10881,14,15,1,34,48,1748
39051,39051,2AB1E00AE324EB01DB00242758B61F8A,11001,17,23,6,42,47,2147
39052,39052,6DFBF28C4BB1FC2BFED5E053C4C14307,43581,0,6,6,33,48,1698
39053,39053,6DFBF28C4BB1FC2BFED5E053C4C14307,19441,8,9,1,8,46,446
39054,39054,6DFBF28C4BB1FC2BFED5E053C4C14307,43581,14,19,5,33,48,1698
39055,39055,6DFBF28C4BB1FC2BFED5E053C4C14307,19441,20,23,3,8,46,446
39062,39062,48BFDAC45FFDDC1EE0721263D1AD77D7,10841,0,8,8,37,47,1897
39063,39063,48BFDAC45FFDDC1EE0721263D1AD77D7,10251,9,10,1,35,47,1797
39064,39064,48BFDAC45FFDDC1EE0721263D1AD77D7,40637,12,13,1,36,47,1847
39065,39065,48BFDAC45FFDDC1EE0721263D1AD77D7,10251,14,21,7,35,47,1797
39066,39066,48BFDAC45FFDDC1EE0721263D1AD77D7,43361,22,23,1,38,48,1948
39067,39067,56577D7E072F237C8DE51C5D025371C7,11081,1,6,5,35,46,1796
39068,39068,56577D7E072F237C8DE51C5D025371C7,10121,7,14,7,36,49,1849
39069,39069,56577D7E072F237C8DE51C5D025371C7,10661,15,16,1,37,49,1899
39070,39070,56577D7E072F237C8DE51C5D025371C7,10121,17,23,6,36,49,1849
39071,39071,37C29D4674FBC06EF76342F2283F4E15,42031,0,7,7,40,46,2046
39072,39072,37C29D4674FBC06EF76342F2283F4E15,13671,7,16,9,27,43,1393
39073,39073,37C29D4674FBC06EF76342F2283F4E15,10841,17,22,5,37,47,1897
39074,39074,622CAD2A1CBEEB3E7C37B415C8550447,13561,0,8,8,37,49,1899
39075,39075,622CAD2A1CBEEB3E7C37B415C8550447,13121,9,10,1,38,46,1946
39076,39076,622CAD2A1CBEEB3E7C37B415C8550447,11261,12,16,4,36,46,1846
39077,39077,622CAD2A1CBEEB3E7C37B415C8550447,43161,17,18,1,35,47,1797
39078,39078,622CAD2A1CBEEB3E7C37B415C8550447,42321,19,21,2,43,47,2197
39079,39079,292AD485DA7AE4FB3CFCA1190DC036DF,42151,0,6,6,35,45,1795
39080,39080,292AD485DA7AE4FB3CFCA1190DC036DF,12311,6,10,4,30,44,1544
39081,39081,292AD485DA7AE4FB3CFCA1190DC036DF,42151,10,12,2,35,45,1795
39082,39082,292AD485DA7AE4FB3CFCA1190DC036DF,12311,14,16,2,30,44,1544
39083,39083,292AD485DA7AE4FB3CFCA1190DC036DF,42531,16,19,3,31,45,1595
39095,39095,111CDDD5FA2E313735C2BD7B109AA3EE,42861,3,4,1,37,44,1894
39096,39096,111CDDD5FA2E313735C2BD7B109AA3EE,42151,6,10,4,35,45,1795
39097,39097,111CDDD5FA2E313735C2BD7B109AA3EE,42861,11,15,4,37,44,1894
39098,39098,111CDDD5FA2E313735C2BD7B109AA3EE,42151,16,18,2,35,45,1795
39099,39099,111CDDD5FA2E313735C2BD7B109AA3EE,42861,21,22,1,37,44,1894
39100,39100,2E1C815B645A117CCE939C9B12660B1B,40801,0,8,8,43,46,2196
39101,39101,2E1C815B645A117CCE939C9B12660B1B,13561,10,11,1,37,49,1899
39102,39102,2E1C815B645A117CCE939C9B12660B1B,41591,12,14,2,34,49,1749
39103,39103,2E1C815B645A117CCE939C9B12660B1B,11701,16,17,1,43,48,2198
39104,39104,2E1C815B645A117CCE939C9B12660B1B,42511,18,21,3,37,47,1897
39105,39105,2E1C815B645A117CCE939C9B12660B1B,40801,21,23,2,43,46,2196
39106,39106,98029F333AC5519D4BA1B7A7F8079304,11021,0,2,2,36,49,1849
39107,39107,98029F333AC5519D4BA1B7A7F8079304,41721,2,9,7,39,48,1998
39108,39108,98029F333AC5519D4BA1B7A7F8079304,12971,9,10,1,32,48,1648
39109,39109,98029F333AC5519D4BA1B7A7F8079304,41721,12,13,1,39,48,1998
39110,39110,98029F333AC5519D4BA1B7A7F8079304,11641,14,16,2,22,49,1149
39111,39111,98029F333AC5519D4BA1B7A7F8079304,42261,18,20,2,25,49,1299
39112,39112,2E1F97F3ED6257DFD022D7BEBD45DD21,19244,4,6,2,1,43,93
39113,39113,2E1F97F3ED6257DFD022D7BEBD45DD21,19031,6,11,5,1,42,92
39114,39114,2E1F97F3ED6257DFD022D7BEBD45DD21,19244,13,15,2,1,43,93
39115,39115,2E1F97F3ED6257DFD022D7BEBD45DD21,19181,18,19,1,8,40,440
39116,39116,2E1F97F3ED6257DFD022D7BEBD45DD21,43644,20,22,2,14,38,738
39117,39117,3FBA130DE96D19DDB92B7C1710211CF0,10611,0,7,7,32,48,1648
39118,39118,3FBA130DE96D19DDB92B7C1710211CF0,10251,7,10,3,35,47,1797
39119,39119,3FBA130DE96D19DDB92B7C1710211CF0,10611,12,14,2,32,48,1648
39120,39120,3FBA130DE96D19DDB92B7C1710211CF0,13651,14,16,2,30,47,1547
39121,39121,3FBA130DE96D19DDB92B7C1710211CF0,10611,20,22,2,32,48,1648
39122,39122,71AB304A084EB4095E1F705C48CB0E23,11901,0,7,7,42,49,2149
39123,39123,71AB304A084EB4095E1F705C48CB0E23,11914,8,16,8,37,48,1898
39124,39124,71AB304A084EB4095E1F705C48CB0E23,42581,17,18,1,38,48,1948
39125,39125,71AB304A084EB4095E1F705C48CB0E23,11901,19,23,4,42,49,2149
39129,39129,B9E927B8C825AF1AC2891B310330CB7E,10271,0,6,6,37,46,1896
39130,39130,B9E927B8C825AF1AC2891B310330CB7E,42011,6,19,13,36,46,1846
39131,39131,B9E927B8C825AF1AC2891B310330CB7E,12311,20,22,2,30,44,1544
39138,39138,D1D02DF9C1212407C948C37939001BC3,13671,0,1,1,27,43,1393
39139,39139,D1D02DF9C1212407C948C37939001BC3,42531,3,4,1,31,45,1595
39140,39140,D1D02DF9C1212407C948C37939001BC3,12311,7,9,2,30,44,1544
39141,39141,D1D02DF9C1212407C948C37939001BC3,42531,11,21,10,31,45,1595
39146,39146,5601C1A44CC85C7B09354B38FD0628D1,12311,0,7,7,30,44,1544
39147,39147,5601C1A44CC85C7B09354B38FD0628D1,13731,8,16,8,33,49,1699
39148,39148,5601C1A44CC85C7B09354B38FD0628D1,12311,19,23,4,30,44,1544
39152,39152,1DA09CF3DD846164BECC97C839AAFF35,11731,0,3,3,36,48,1848
39153,39153,1DA09CF3DD846164BECC97C839AAFF35,13841,4,12,8,40,46,2046
39154,39154,1DA09CF3DD846164BECC97C839AAFF35,10771,13,14,1,41,46,2096
39155,39155,1DA09CF3DD846164BECC97C839AAFF35,13841,14,16,2,40,46,2046
39156,39156,1DA09CF3DD846164BECC97C839AAFF35,12221,19,20,1,43,44,2194
39157,39157,1DA09CF3DD846164BECC97C839AAFF35,13101,21,23,2,40,47,2047
39169,39169,08473490B9A4AA4AA42291969631E815,13551,1,5,4,45,38,2288
39170,39170,08473490B9A4AA4AA42291969631E815,11941,10,12,2,37,46,1896
39171,39171,08473490B9A4AA4AA42291969631E815,13121,12,14,2,38,46,1946
39172,39172,08473490B9A4AA4AA42291969631E815,43101,19,20,1,46,40,2340
39173,39173,245DE714507382DDB0203A65927397CC,41021,0,7,7,38,47,1947
39174,39174,245DE714507382DDB0203A65927397CC,42051,12,14,2,42,48,2148
39175,39175,245DE714507382DDB0203A65927397CC,13681,14,23,9,38,47,1947
39176,39176,69F41107244EDDE97DD1AAB2D554177A,12871,0,1,1,22,33,1133
39177,39177,69F41107244EDDE97DD1AAB2D554177A,19281,4,18,14,16,32,832
39178,39178,69F41107244EDDE97DD1AAB2D554177A,12871,21,23,2,22,33,1133
39179,39179,7CC7901DF094F799764E6157DE62B394,11231,1,9,8,37,49,1899
39180,39180,7CC7901DF094F799764E6157DE62B394,40951,9,12,3,36,49,1849
39181,39181,7CC7901DF094F799764E6157DE62B394,42961,13,19,6,35,49,1799
39182,39182,7CC7901DF094F799764E6157DE62B394,11171,20,21,1,33,48,1698
39183,39183,7CC7901DF094F799764E6157DE62B394,11231,21,23,2,37,49,1899
39191,39191,ECBC886277109C0582E65AB313F27C1C,13314,0,6,6,31,39,1589
39192,39192,ECBC886277109C0582E65AB313F27C1C,12521,9,12,3,35,41,1791
39193,39193,ECBC886277109C0582E65AB313F27C1C,13314,12,13,1,31,39,1589
39194,39194,ECBC886277109C0582E65AB313F27C1C,12521,15,16,1,35,41,1791
39195,39195,ECBC886277109C0582E65AB313F27C1C,13314,21,23,2,31,39,1589
39196,39196,7EF8399B7744B26431FFE3070C9BD313,19441,0,10,10,8,46,446
39197,39197,7EF8399B7744B26431FFE3070C9BD313,42041,10,12,2,10,47,547
39198,39198,7EF8399B7744B26431FFE3070C9BD313,19441,13,16,3,8,46,446
39199,39199,7EF8399B7744B26431FFE3070C9BD313,42041,17,19,2,10,47,547
39200,39200,7EF8399B7744B26431FFE3070C9BD313,19441,19,21,2,8,46,446
39201,39201,7EF8399B7744B26431FFE3070C9BD313,42041,21,23,2,10,47,547
39206,39206,B5F3581649228AFCDFA595ACA1F1686A,10281,0,12,12,33,48,1698
39207,39207,B5F3581649228AFCDFA595ACA1F1686A,11001,14,16,2,42,47,2147
39208,39208,B5F3581649228AFCDFA595ACA1F1686A,11861,19,23,4,32,47,1647
39209,39209,C493E8EAD829832CA31397E82BE4990B,43021,0,8,8,16,43,843
39210,39210,C493E8EAD829832CA31397E82BE4990B,12921,9,20,11,9,41,491
39211,39211,C493E8EAD829832CA31397E82BE4990B,43021,21,23,2,16,43,843
39218,39218,EA9924FFF1DCA912FAC17C9FCC9CB51A,10251,0,13,13,35,47,1797
39219,39219,EA9924FFF1DCA912FAC17C9FCC9CB51A,12311,17,19,2,30,44,1544
39220,39220,EA9924FFF1DCA912FAC17C9FCC9CB51A,10251,20,23,3,35,47,1797
39221,39221,AC44646418C98ED88B49CF71AB62D672,11261,1,6,5,36,46,1846
39222,39222,AC44646418C98ED88B49CF71AB62D672,43451,8,9,1,37,40,1890
39223,39223,AC44646418C98ED88B49CF71AB62D672,12521,9,10,1,35,41,1791
39224,39224,AC44646418C98ED88B49CF71AB62D672,43451,15,18,3,37,40,1890
39225,39225,AC44646418C98ED88B49CF71AB62D672,12491,20,22,2,36,43,1843
39233,39233,119196C18578341D0084AF6B48A62632,42551,1,2,1,14,48,748
39234,39234,119196C18578341D0084AF6B48A62632,11631,2,3,1,12,49,649
39235,39235,119196C18578341D0084AF6B48A62632,12641,4,7,3,10,43,543
39236,39236,119196C18578341D0084AF6B48A62632,11631,10,22,12,12,49,649
39244,39244,91C5B3238A8419D0CA530F7A4D0E4118,42633,0,7,7,42,46,2146
39245,39245,91C5B3238A8419D0CA530F7A4D0E4118,11794,11,19,8,38,49,1949
39246,39246,91C5B3238A8419D0CA530F7A4D0E4118,43061,19,23,4,43,46,2196
39247,39247,1DA79481C6B6D1D9223A378A0D81757A,10111,0,8,8,37,47,1897
39248,39248,1DA79481C6B6D1D9223A378A0D81757A,11211,9,17,8,34,49,1749
39249,39249,1DA79481C6B6D1D9223A378A0D81757A,10111,17,23,6,37,47,1897
39250,39250,BBA22655B692982B5517C3B173267A4A,19051,0,4,4,16,23,823
39251,39251,BBA22655B692982B5517C3B173267A4A,15371,5,8,3,15,22,772
39252,39252,BBA22655B692982B5517C3B173267A4A,19051,8,17,9,16,23,823
39253,39253,BBA22655B692982B5517C3B173267A4A,15371,17,19,2,15,22,772
39254,39254,BBA22655B692982B5517C3B173267A4A,19051,19,23,4,16,23,823
39262,39262,385D1A4CC58FEDAEC41BC65F6D2F38A3,13711,2,7,5,38,46,1946
39263,39263,385D1A4CC58FEDAEC41BC65F6D2F38A3,41031,9,17,8,32,49,1649
39264,39264,385D1A4CC58FEDAEC41BC65F6D2F38A3,13711,22,23,1,38,46,1946
39265,39265,64CF63AA7EC6AF96D12111E4A1601422,42121,0,6,6,26,49,1349
39266,39266,64CF63AA7EC6AF96D12111E4A1601422,11281,10,17,7,27,40,1390
39267,39267,64CF63AA7EC6AF96D12111E4A1601422,13671,19,23,4,27,43,1393
39279,39279,D3E46B15B35DC3C198E6EE945D227259,11806,0,5,5,41,48,2098
39280,39280,D3E46B15B35DC3C198E6EE945D227259,42271,6,11,5,40,47,2047
39281,39281,D3E46B15B35DC3C198E6EE945D227259,13381,12,14,2,39,47,1997
39282,39282,D3E46B15B35DC3C198E6EE945D227259,42271,15,18,3,40,47,2047
39283,39283,D3E46B15B35DC3C198E6EE945D227259,13381,19,22,3,39,47,1997
39284,39284,BE7158C7AB92D3D0F0FCC2D4500091EF,19901,0,10,10,7,44,394
39285,39285,BE7158C7AB92D3D0F0FCC2D4500091EF,42523,11,13,2,31,47,1597
39286,39286,BE7158C7AB92D3D0F0FCC2D4500091EF,19901,16,23,7,7,44,394
39294,39294,17AEFEF657B11D131BDD3C3B66C9A042,10271,0,8,8,37,46,1896
39295,39295,17AEFEF657B11D131BDD3C3B66C9A042,13711,8,9,1,38,46,1946
39296,39296,17AEFEF657B11D131BDD3C3B66C9A042,11941,10,11,1,37,46,1896
39297,39297,17AEFEF657B11D131BDD3C3B66C9A042,42011,14,19,5,36,46,1846
39298,39298,17AEFEF657B11D131BDD3C3B66C9A042,10271,20,23,3,37,46,1896
39299,39299,DA8DF678E14EB4FC9E9F96DBC114B97A,13671,0,13,13,27,43,1393
39300,39300,DA8DF678E14EB4FC9E9F96DBC114B97A,19114,15,17,2,7,43,393
39301,39301,DA8DF678E14EB4FC9E9F96DBC114B97A,10351,19,21,2,28,45,1445
39302,39302,E51EE41655D386174398555E16D6604B,12481,0,1,1,37,49,1899
39303,39303,E51EE41655D386174398555E16D6604B,12381,2,8,6,32,48,1648
39304,39304,E51EE41655D386174398555E16D6604B,11751,11,17,6,35,48,1798
39305,39305,E51EE41655D386174398555E16D6604B,10107,19,22,3,38,49,1949
39310,39310,6B614428F8D95ECFDE2207017437E97D,19281,1,16,15,16,32,832
39311,39311,6B614428F8D95ECFDE2207017437E97D,12871,16,19,3,22,33,1133
39312,39312,6B614428F8D95ECFDE2207017437E97D,19281,22,23,1,16,32,832
39313,39313,F8A2EC8C9348BFB1362087B807B825C5,43971,0,8,8,30,48,1548
39314,39314,F8A2EC8C9348BFB1362087B807B825C5,40271,9,16,7,35,49,1799
39315,39315,F8A2EC8C9348BFB1362087B807B825C5,11381,18,19,1,30,47,1547
39316,39316,F8A2EC8C9348BFB1362087B807B825C5,43971,21,23,2,30,48,1548
39320,39320,28EBDF129D422CC62555B67FAF051D3A,11231,9,11,2,37,49,1899
39321,39321,28EBDF129D422CC62555B67FAF051D3A,10901,13,14,1,35,48,1798
39322,39322,28EBDF129D422CC62555B67FAF051D3A,11231,15,17,2,37,49,1899
39323,39323,28EBDF129D422CC62555B67FAF051D3A,43761,20,21,1,32,47,1647
39330,39330,E969EC1FA6E19F3F5A602F2FE47F2E7D,13911,6,10,4,39,46,1996
39331,39331,E969EC1FA6E19F3F5A602F2FE47F2E7D,42151,11,12,1,35,45,1795
39332,39332,E969EC1FA6E19F3F5A602F2FE47F2E7D,11261,17,19,2,36,46,1846
39336,39336,5449CBB6DC35AD4CB937DE3654BC5A77,10161,1,9,8,35,49,1799
39337,39337,5449CBB6DC35AD4CB937DE3654BC5A77,13651,12,15,3,30,47,1547
39338,39338,5449CBB6DC35AD4CB937DE3654BC5A77,10161,16,19,3,35,49,1799
39339,39339,5449CBB6DC35AD4CB937DE3654BC5A77,11384,20,21,1,30,47,1547
39340,39340,CA13573EC489EC297A1DB55BF08926BD,42231,0,7,7,37,46,1896
39341,39341,CA13573EC489EC297A1DB55BF08926BD,11481,8,9,1,41,48,2098
39342,39342,CA13573EC489EC297A1DB55BF08926BD,42231,12,14,2,37,46,1896
39343,39343,CA13573EC489EC297A1DB55BF08926BD,11211,15,17,2,34,49,1749
39344,39344,CA13573EC489EC297A1DB55BF08926BD,42231,19,23,4,37,46,1896
39349,39349,15AF53FBA0C13FBD61024895398ED2FD,11471,1,4,3,12,48,648
39350,39350,15AF53FBA0C13FBD61024895398ED2FD,42041,6,8,2,10,47,547
39351,39351,15AF53FBA0C13FBD61024895398ED2FD,19441,11,13,2,8,46,446
39352,39352,15AF53FBA0C13FBD61024895398ED2FD,42041,15,16,1,10,47,547
39353,39353,15AF53FBA0C13FBD61024895398ED2FD,19441,20,21,1,8,46,446
39354,39354,D8063B7C8CAA23F18B002D2A443A5135,43951,0,6,6,49,41,2491
39355,39355,D8063B7C8CAA23F18B002D2A443A5135,43101,7,10,3,46,40,2340
39356,39356,D8063B7C8CAA23F18B002D2A443A5135,13071,13,18,5,41,41,2091
39357,39357,804B7737707030C63DF2E4BD94DF220F,42971,0,7,7,43,49,2199
39358,39358,804B7737707030C63DF2E4BD94DF220F,11806,7,12,5,41,48,2098
39359,39359,804B7737707030C63DF2E4BD94DF220F,13101,13,18,5,40,47,2047
39360,39360,804B7737707030C63DF2E4BD94DF220F,11806,19,22,3,41,48,2098
39369,39369,F552BBAFE22D025B0F7E0055A73A2709,42321,1,6,5,43,47,2197
39370,39370,F552BBAFE22D025B0F7E0055A73A2709,10801,7,8,1,42,47,2147
39371,39371,F552BBAFE22D025B0F7E0055A73A2709,42321,11,12,1,43,47,2197
39372,39372,F552BBAFE22D025B0F7E0055A73A2709,42021,15,16,1,33,47,1697
39373,39373,F552BBAFE22D025B0F7E0055A73A2709,10801,19,22,3,42,47,2147
39380,39380,FD26A6D5BBA5F38876B2DAAB4BBFF5D0,12121,0,16,16,29,47,1497
39381,39381,FD26A6D5BBA5F38876B2DAAB4BBFF5D0,10951,17,19,2,29,48,1498
39382,39382,FD26A6D5BBA5F38876B2DAAB4BBFF5D0,10531,21,23,2,34,46,1746
39383,39383,4F6A6D6BDB1CA40A8AF45B87F3BE9E9C,12971,0,15,15,32,48,1648
39384,39384,4F6A6D6BDB1CA40A8AF45B87F3BE9E9C,42261,19,21,2,25,49,1299
39385,39385,4F6A6D6BDB1CA40A8AF45B87F3BE9E9C,12381,22,23,1,32,48,1648
39390,39390,096FC9A1279CCD25D0E8126298EE77CC,10191,0,8,8,40,48,2048
39391,39391,096FC9A1279CCD25D0E8126298EE77CC,40941,9,17,8,32,48,1648
39392,39392,096FC9A1279CCD25D0E8126298EE77CC,10191,19,23,4,40,48,2048
39397,39397,924C94FEA337955066B022FCC7607D38,11361,1,2,1,22,48,1148
39398,39398,924C94FEA337955066B022FCC7607D38,12581,2,7,5,24,48,1248
39399,39399,924C94FEA337955066B022FCC7607D38,11361,7,12,5,22,48,1148
39400,39400,924C94FEA337955066B022FCC7607D38,40341,13,15,2,23,49,1199
39401,39401,924C94FEA337955066B022FCC7607D38,12581,17,20,3,24,48,1248
39402,39402,966592CD48E24DD17B5B9C8B94D59F8F,19261,0,6,6,6,37,337
39403,39403,966592CD48E24DD17B5B9C8B94D59F8F,19741,8,15,7,5,44,294
39404,39404,966592CD48E24DD17B5B9C8B94D59F8F,42071,17,19,2,31,49,1599
39405,39405,966592CD48E24DD17B5B9C8B94D59F8F,43644,21,22,1,14,38,738
39416,39416,400659CE2E6F8BFF6D95D6F52F73DF5B,42921,0,12,12,33,47,1697
39417,39417,400659CE2E6F8BFF6D95D6F52F73DF5B,12511,15,16,1,39,47,1997
39418,39418,400659CE2E6F8BFF6D95D6F52F73DF5B,42921,17,20,3,33,47,1697
39422,39422,A25BD81EC9134E523B096ACC3062CFB1,13271,1,7,6,41,47,2097
39423,39423,A25BD81EC9134E523B096ACC3062CFB1,11531,7,8,1,34,49,1749
39424,39424,A25BD81EC9134E523B096ACC3062CFB1,40833,17,23,6,41,47,2097
39425,39425,A9CB10B468D8E4AF35699B759EB26E7B,10251,0,8,8,35,47,1797
39426,39426,A9CB10B468D8E4AF35699B759EB26E7B,11794,11,13,2,38,49,1949
39427,39427,A9CB10B468D8E4AF35699B759EB26E7B,10251,13,23,10,35,47,1797
39428,39428,559777BBBCD664850DC1E8E7503633C6,10351,0,7,7,28,45,1445
39429,39429,559777BBBCD664850DC1E8E7503633C6,42531,8,16,8,31,45,1595
39430,39430,559777BBBCD664850DC1E8E7503633C6,40951,21,22,1,36,49,1849
39431,39431,B84457A74A0D9026A24466C3F8A7B15D,19741,0,5,5,5,44,294
39432,39432,B84457A74A0D9026A24466C3F8A7B15D,19441,6,9,3,8,46,446
39433,39433,B84457A74A0D9026A24466C3F8A7B15D,11851,11,14,3,13,47,697
39434,39434,B84457A74A0D9026A24466C3F8A7B15D,11471,14,15,1,12,48,648
39435,39435,B84457A74A0D9026A24466C3F8A7B15D,19441,16,19,3,8,46,446
39436,39436,B84457A74A0D9026A24466C3F8A7B15D,19741,22,23,1,5,44,294
39448,39448,71CDB42BF8ABF4C8B89BDC81F92C39B7,10634,0,6,6,27,45,1395
39449,39449,71CDB42BF8ABF4C8B89BDC81F92C39B7,12601,8,11,3,25,47,1297
39450,39450,71CDB42BF8ABF4C8B89BDC81F92C39B7,10634,11,14,3,27,45,1395
39451,39451,71CDB42BF8ABF4C8B89BDC81F92C39B7,12601,15,17,2,25,47,1297
39452,39452,71CDB42BF8ABF4C8B89BDC81F92C39B7,10634,19,23,4,27,45,1395
39456,39456,5E8BB1A9FDE1AFD08848003FB8A60E0E,40673,0,8,8,36,48,1848
39457,39457,5E8BB1A9FDE1AFD08848003FB8A60E0E,43731,10,12,2,34,47,1747
39458,39458,5E8BB1A9FDE1AFD08848003FB8A60E0E,40673,12,13,1,36,48,1848
39459,39459,5E8BB1A9FDE1AFD08848003FB8A60E0E,10971,15,18,3,35,47,1797
39460,39460,5E8BB1A9FDE1AFD08848003FB8A60E0E,40673,20,23,3,36,48,1848
39461,39461,8D188B1328CA03E5FCB5F80DC745FFDD,42523,1,7,6,31,47,1597
39462,39462,8D188B1328CA03E5FCB5F80DC745FFDD,10721,8,10,2,31,48,1598
39463,39463,8D188B1328CA03E5FCB5F80DC745FFDD,42523,13,16,3,31,47,1597
39464,39464,8D188B1328CA03E5FCB5F80DC745FFDD,11201,19,22,3,35,49,1799
39465,39465,8D188B1328CA03E5FCB5F80DC745FFDD,42523,22,23,1,31,47,1597
39469,39469,F0C7D7AB49810506760CC1E5D1A9A9A2,13791,0,14,14,42,47,2147
39470,39470,F0C7D7AB49810506760CC1E5D1A9A9A2,11074,15,17,2,37,47,1897
39471,39471,F0C7D7AB49810506760CC1E5D1A9A9A2,13791,18,23,5,42,47,2147
39472,39472,7779D5C4E5073D864A9050EB76A5AC64,43341,0,1,1,41,46,2096
39473,39473,7779D5C4E5073D864A9050EB76A5AC64,11261,1,2,1,36,46,1846
39474,39474,7779D5C4E5073D864A9050EB76A5AC64,43341,4,6,2,41,46,2096
39475,39475,7779D5C4E5073D864A9050EB76A5AC64,11261,7,9,2,36,46,1846
39476,39476,7779D5C4E5073D864A9050EB76A5AC64,43341,15,16,1,41,46,2096
39477,39477,7779D5C4E5073D864A9050EB76A5AC64,11261,19,23,4,36,46,1846
39482,39482,AF11A116F876E89A4D582C37AC3B2D5C,42121,0,5,5,26,49,1349
39483,39483,AF11A116F876E89A4D582C37AC3B2D5C,13671,7,11,4,27,43,1393
39484,39484,AF11A116F876E89A4D582C37AC3B2D5C,11281,11,13,2,27,40,1390
39485,39485,AF11A116F876E89A4D582C37AC3B2D5C,10381,15,16,1,31,49,1599
39486,39486,AF11A116F876E89A4D582C37AC3B2D5C,11281,16,17,1,27,40,1390
39487,39487,AF11A116F876E89A4D582C37AC3B2D5C,13671,18,22,4,27,43,1393
39488,39488,85E08E471C7B6BED9998BA8791A10348,13681,1,9,8,38,47,1947
39489,39489,85E08E471C7B6BED9998BA8791A10348,11074,12,13,1,37,47,1897
39490,39490,85E08E471C7B6BED9998BA8791A10348,42531,14,15,1,31,45,1595
39491,39491,85E08E471C7B6BED9998BA8791A10348,12521,19,23,4,35,41,1791
39502,39502,CA5A17D561EB9E25269F629C4481540B,42041,0,3,3,10,47,547
39503,39503,CA5A17D561EB9E25269F629C4481540B,19441,6,9,3,8,46,446
39504,39504,CA5A17D561EB9E25269F629C4481540B,42041,11,12,1,10,47,547
39505,39505,CA5A17D561EB9E25269F629C4481540B,19021,13,14,1,10,45,545
39506,39506,CA5A17D561EB9E25269F629C4481540B,19441,17,18,1,8,46,446
39507,39507,F1D52E271AD2CA60B9DB39C5E4BE77A4,12641,3,4,1,10,43,543
39508,39508,F1D52E271AD2CA60B9DB39C5E4BE77A4,19021,5,17,12,10,45,545
39509,39509,F1D52E271AD2CA60B9DB39C5E4BE77A4,19441,19,20,1,8,46,446
39510,39510,F1D52E271AD2CA60B9DB39C5E4BE77A4,12641,21,22,1,10,43,543
39511,39511,D9F9B6447DA94594850A6216548A7020,11791,0,6,6,38,49,1949
39512,39512,D9F9B6447DA94594850A6216548A7020,13651,11,15,4,30,47,1547
39513,39513,D9F9B6447DA94594850A6216548A7020,11791,18,23,5,38,49,1949
39514,39514,AC5E2D2DBE4624330996B666281808FE,12131,1,9,8,32,47,1647
39515,39515,AC5E2D2DBE4624330996B666281808FE,13681,13,19,6,38,47,1947
39516,39516,AC5E2D2DBE4624330996B666281808FE,42491,20,22,2,32,46,1646
39520,39520,24CACD73BA8D75767DDD668E5EA165E2,40171,1,5,4,38,48,1948
39521,39521,24CACD73BA8D75767DDD668E5EA165E2,11914,6,7,1,37,48,1898
39522,39522,24CACD73BA8D75767DDD668E5EA165E2,40171,7,13,6,38,48,1948
39523,39523,24CACD73BA8D75767DDD668E5EA165E2,11914,13,18,5,37,48,1898
39524,39524,24CACD73BA8D75767DDD668E5EA165E2,40171,20,23,3,38,48,1948
39528,39528,5FF9CE460A753808614E5114D88F66EB,40801,0,8,8,43,46,2196
39529,39529,5FF9CE460A753808614E5114D88F66EB,10841,9,11,2,37,47,1897
39530,39530,5FF9CE460A753808614E5114D88F66EB,40801,12,18,6,43,46,2196
39531,39531,5FF9CE460A753808614E5114D88F66EB,11351,20,21,1,36,48,1848
39532,39532,5FF9CE460A753808614E5114D88F66EB,40691,22,23,1,42,48,2148
39533,39533,7300FFB733BFFEA187DB110E4D4DC3D2,19181,0,6,6,8,40,440
39534,39534,7300FFB733BFFEA187DB110E4D4DC3D2,12921,8,9,1,9,41,491
39535,39535,7300FFB733BFFEA187DB110E4D4DC3D2,12641,10,11,1,10,43,543
39536,39536,7300FFB733BFFEA187DB110E4D4DC3D2,49201,12,21,9,7,41,391
39537,39537,7300FFB733BFFEA187DB110E4D4DC3D2,19181,22,23,1,8,40,440
39538,39538,3D6503EA24FE5F62CC35F44B28D43904,11481,0,2,2,41,48,2098
39539,39539,3D6503EA24FE5F62CC35F44B28D43904,10601,2,4,2,39,47,1997
39540,39540,3D6503EA24FE5F62CC35F44B28D43904,12514,5,8,3,38,47,1947
39541,39541,3D6503EA24FE5F62CC35F44B28D43904,10601,10,12,2,39,47,1997
39542,39542,3D6503EA24FE5F62CC35F44B28D43904,42471,13,14,1,35,49,1799
39543,39543,3D6503EA24FE5F62CC35F44B28D43904,10721,15,16,1,31,48,1598
39544,39544,3D6503EA24FE5F62CC35F44B28D43904,10601,18,19,1,39,47,1997
39545,39545,3D6503EA24FE5F62CC35F44B28D43904,13371,21,22,1,41,47,2097
39546,39546,EE011155820C4CF0BA812B7959F3205A,12611,2,4,2,41,29,2079
39547,39547,EE011155820C4CF0BA812B7959F3205A,15671,6,10,4,37,26,1876
39548,39548,EE011155820C4CF0BA812B7959F3205A,12611,12,20,8,41,29,2079
39549,39549,E06F248FC43DC08ED97FD0BB37D05DA2,40171,0,1,1,38,48,1948
39550,39550,E06F248FC43DC08ED97FD0BB37D05DA2,13341,4,11,7,44,45,2245
39551,39551,E06F248FC43DC08ED97FD0BB37D05DA2,12211,12,17,5,41,44,2094
39552,39552,E06F248FC43DC08ED97FD0BB37D05DA2,13341,21,22,1,44,45,2245
39556,39556,E131C5415CA4464B2E2B8BBC4B15D17C,42521,1,7,6,31,47,1597
39557,39557,E131C5415CA4464B2E2B8BBC4B15D17C,10221,11,15,4,34,49,1749
39558,39558,E131C5415CA4464B2E2B8BBC4B15D17C,10544,16,17,1,28,48,1448
39559,39559,E131C5415CA4464B2E2B8BBC4B15D17C,42521,20,21,1,31,47,1597
39567,39567,359C58DC4DBD35DF6CD4BC8F64D8BAD8,11061,10,11,1,29,48,1498
39568,39568,359C58DC4DBD35DF6CD4BC8F64D8BAD8,40341,12,16,4,23,49,1199
39569,39569,359C58DC4DBD35DF6CD4BC8F64D8BAD8,11631,18,23,5,12,49,649
39570,39570,A4FB037706170157DA9B94939FEE9474,13941,2,5,3,41,47,2097
39571,39571,A4FB037706170157DA9B94939FEE9474,11001,7,9,2,42,47,2147
39572,39572,A4FB037706170157DA9B94939FEE9474,13941,13,15,2,41,47,2097
39573,39573,A4FB037706170157DA9B94939FEE9474,11781,17,22,5,38,49,1949
39577,39577,16D740AE27D92BE968DE244652195181,12761,1,5,4,25,40,1290
39578,39578,16D740AE27D92BE968DE244652195181,13671,8,17,9,27,43,1393
39579,39579,16D740AE27D92BE968DE244652195181,12731,19,20,1,22,40,1140
39580,39580,1463E9838EB11802DBC75E65276D110F,42531,0,6,6,31,45,1595
39581,39581,1463E9838EB11802DBC75E65276D110F,43061,10,16,6,43,46,2196
39582,39582,1463E9838EB11802DBC75E65276D110F,13791,16,18,2,42,47,2147
39583,39583,1463E9838EB11802DBC75E65276D110F,42531,20,22,2,31,45,1595
39588,39588,4E4FA3262DF5F7B6F1852C92067A0539,11875,0,6,6,30,46,1546
39589,39589,4E4FA3262DF5F7B6F1852C92067A0539,12311,7,9,2,30,44,1544
39590,39590,4E4FA3262DF5F7B6F1852C92067A0539,11875,11,13,2,30,46,1546
39591,39591,4E4FA3262DF5F7B6F1852C92067A0539,12661,15,17,2,32,45,1645
39592,39592,4E4FA3262DF5F7B6F1852C92067A0539,12311,17,18,1,30,44,1544
39593,39593,4E4FA3262DF5F7B6F1852C92067A0539,11875,18,23,5,30,46,1546
39594,39594,C97D1EB6332A2DCE6ADB1DE5937351DA,42971,0,9,9,43,49,2199
39595,39595,C97D1EB6332A2DCE6ADB1DE5937351DA,42151,10,19,9,35,45,1795
39596,39596,C97D1EB6332A2DCE6ADB1DE5937351DA,13941,20,23,3,41,47,2097
39609,39609,4A1E2DF13E9399DEAE7966E1EFE6FC6B,11481,0,4,4,41,48,2098
39610,39610,4A1E2DF13E9399DEAE7966E1EFE6FC6B,12661,6,8,2,32,45,1645
39611,39611,4A1E2DF13E9399DEAE7966E1EFE6FC6B,42151,11,13,2,35,45,1795
39612,39612,4A1E2DF13E9399DEAE7966E1EFE6FC6B,10351,16,17,1,28,45,1445
39613,39613,4A1E2DF13E9399DEAE7966E1EFE6FC6B,13271,20,21,1,41,47,2097
39614,39614,CAD1FFF41FBB07303E4F900E7ED6962A,43391,0,6,6,29,48,1498
39615,39615,CAD1FFF41FBB07303E4F900E7ED6962A,40691,9,11,2,42,48,2148
39616,39616,CAD1FFF41FBB07303E4F900E7ED6962A,11151,11,13,2,30,48,1548
39617,39617,CAD1FFF41FBB07303E4F900E7ED6962A,10921,14,17,3,43,48,2198
39618,39618,CAD1FFF41FBB07303E4F900E7ED6962A,12971,18,19,1,32,48,1648
39619,39619,CAD1FFF41FBB07303E4F900E7ED6962A,11171,20,21,1,33,48,1698
39620,39620,6F1E603402DD531A5DAB34972B4EF757,19821,0,5,5,4,46,246
39621,39621,6F1E603402DD531A5DAB34972B4EF757,19621,5,6,1,5,46,296
39622,39622,6F1E603402DD531A5DAB34972B4EF757,12641,7,21,14,10,43,543
39623,39623,4433AB54AA3E659C9E10A7B4786241DF,11061,6,7,1,29,48,1498
39624,39624,4433AB54AA3E659C9E10A7B4786241DF,13481,10,13,3,26,31,1331
39625,39625,4433AB54AA3E659C9E10A7B4786241DF,11061,16,18,2,29,48,1498
39629,39629,00ED2280FB2BEC22D8FB36F8A7AFB1A5,42151,0,7,7,35,45,1795
39630,39630,00ED2280FB2BEC22D8FB36F8A7AFB1A5,13121,8,9,1,38,46,1946
39631,39631,00ED2280FB2BEC22D8FB36F8A7AFB1A5,10271,10,16,6,37,46,1896
39632,39632,00ED2280FB2BEC22D8FB36F8A7AFB1A5,13121,16,18,2,38,46,1946
39633,39633,00ED2280FB2BEC22D8FB36F8A7AFB1A5,10271,18,20,2,37,46,1896
39652,39652,5D8FA5419FA0CA7A8C3CA55000085D74,11021,0,10,10,36,49,1849
39653,39653,5D8FA5419FA0CA7A8C3CA55000085D74,13221,13,14,1,40,47,2047
39654,39654,5D8FA5419FA0CA7A8C3CA55000085D74,10601,16,20,4,39,47,1997
39655,39655,5D8FA5419FA0CA7A8C3CA55000085D74,11021,21,23,2,36,49,1849
39656,39656,CC1D3C2DA42F1EBED6688749C3DA1D87,10951,5,6,1,29,48,1498
39657,39657,CC1D3C2DA42F1EBED6688749C3DA1D87,11381,6,10,4,30,47,1547
39658,39658,CC1D3C2DA42F1EBED6688749C3DA1D87,11061,13,16,3,29,48,1498
39659,39659,CC1D3C2DA42F1EBED6688749C3DA1D87,11381,17,20,3,30,47,1547
39660,39660,CC1D3C2DA42F1EBED6688749C3DA1D87,43971,21,22,1,30,48,1548
39664,39664,EA84EDCB7C9475F6273168934FDD6476,19441,0,19,19,8,46,446
39665,39665,EA84EDCB7C9475F6273168934FDD6476,11571,20,21,1,13,46,696
39666,39666,EA84EDCB7C9475F6273168934FDD6476,19441,22,23,1,8,46,446
39667,39667,372A21350F3884793152DCFF165CE566,12561,0,1,1,45,43,2293
39668,39668,372A21350F3884793152DCFF165CE566,13341,2,6,4,44,45,2245
39669,39669,372A21350F3884793152DCFF165CE566,12211,6,8,2,41,44,2094
39670,39670,372A21350F3884793152DCFF165CE566,13341,11,23,12,44,45,2245
39674,39674,ECE0FA03A797FCAE4E058BD1C3356073,11741,0,1,1,42,49,2149
39675,39675,ECE0FA03A797FCAE4E058BD1C3356073,13961,2,6,4,42,48,2148
39676,39676,ECE0FA03A797FCAE4E058BD1C3356073,10111,6,23,17,37,47,1897
39677,39677,16CBC76213ABED7950FC4E36BC764C70,12341,0,7,7,26,38,1338
39678,39678,16CBC76213ABED7950FC4E36BC764C70,19181,10,11,1,8,40,440
39679,39679,16CBC76213ABED7950FC4E36BC764C70,12921,13,15,2,9,41,491
39680,39680,16CBC76213ABED7950FC4E36BC764C70,12341,19,23,4,26,38,1338
39691,39691,92E1BAA88B052422B820ED36A9E8F107,41392,0,6,6,43,48,2198
39692,39692,92E1BAA88B052422B820ED36A9E8F107,11914,8,9,1,37,48,1898
39693,39693,92E1BAA88B052422B820ED36A9E8F107,41392,12,23,11,43,48,2198
39694,39694,2917A11EB625CB868E9962150273A0D4,42151,0,7,7,35,45,1795
39695,39695,2917A11EB625CB868E9962150273A0D4,10431,8,11,3,33,49,1699
39696,39696,2917A11EB625CB868E9962150273A0D4,42531,15,16,1,31,45,1595
39697,39697,2917A11EB625CB868E9962150273A0D4,11541,19,21,2,35,49,1799
39705,39705,07952485C45B2F42535F88271FC57393,42031,1,10,9,40,46,2046
39706,39706,07952485C45B2F42535F88271FC57393,13371,12,16,4,41,47,2097
39707,39707,07952485C45B2F42535F88271FC57393,13071,19,23,4,41,41,2091
39708,39708,BF19ED7FC230E102BC843276EF275DE6,13651,0,11,11,30,47,1547
39709,39709,BF19ED7FC230E102BC843276EF275DE6,42521,11,12,1,31,47,1597
39710,39710,BF19ED7FC230E102BC843276EF275DE6,13651,12,17,5,30,47,1547
39711,39711,BF19ED7FC230E102BC843276EF275DE6,10661,18,21,3,37,49,1899
39725,39725,673E981702C477D5AB9A86D558094CFD,10161,0,7,7,35,49,1799
39726,39726,673E981702C477D5AB9A86D558094CFD,10901,13,16,3,35,48,1798
39727,39727,673E981702C477D5AB9A86D558094CFD,12491,17,18,1,36,43,1843
39728,39728,673E981702C477D5AB9A86D558094CFD,11151,20,21,1,30,48,1548
39729,39729,673E981702C477D5AB9A86D558094CFD,10901,21,23,2,35,48,1798
39747,39747,947EE86E96DF76B9619AD7271E46BF1E,15191,1,3,2,36,27,1827
39748,39748,947EE86E96DF76B9619AD7271E46BF1E,12791,4,5,1,31,29,1579
39749,39749,947EE86E96DF76B9619AD7271E46BF1E,15191,7,11,4,36,27,1827
39750,39750,947EE86E96DF76B9619AD7271E46BF1E,12791,13,14,1,31,29,1579
39751,39751,947EE86E96DF76B9619AD7271E46BF1E,15191,18,19,1,36,27,1827
39752,39752,8436FA510D59B3814E50B7F18BD1D92C,12921,7,8,1,9,41,491
39753,39753,8436FA510D59B3814E50B7F18BD1D92C,43644,11,14,3,14,38,738
39754,39754,8436FA510D59B3814E50B7F18BD1D92C,12641,15,17,2,10,43,543
39755,39755,8436FA510D59B3814E50B7F18BD1D92C,43644,20,22,2,14,38,738
39766,39766,074EDBFA2905A257C73498B46D180EB8,19281,1,8,7,16,32,832
39767,39767,074EDBFA2905A257C73498B46D180EB8,12871,10,11,1,22,33,1133
39768,39768,074EDBFA2905A257C73498B46D180EB8,19281,12,16,4,16,32,832
39769,39769,074EDBFA2905A257C73498B46D180EB8,43311,18,23,5,31,48,1598
39770,39770,9FE70E4B6B2CB4BF68BC98D789DF7939,43311,0,7,7,31,48,1598
39771,39771,9FE70E4B6B2CB4BF68BC98D789DF7939,11151,8,9,1,30,48,1548
39772,39772,9FE70E4B6B2CB4BF68BC98D789DF7939,11061,11,12,1,29,48,1498
39773,39773,9FE70E4B6B2CB4BF68BC98D789DF7939,12381,13,14,1,32,48,1648
39774,39774,9FE70E4B6B2CB4BF68BC98D789DF7939,11151,15,19,4,30,48,1548
39775,39775,BF5EFB3BDBF5437ACD467C87E9038A8B,43021,0,5,5,16,43,843
39776,39776,BF5EFB3BDBF5437ACD467C87E9038A8B,12921,6,19,13,9,41,491
39777,39777,BF5EFB3BDBF5437ACD467C87E9038A8B,43021,19,21,2,16,43,843
39778,39778,B6EDE923BA421C490CFB0E81830396F2,11231,0,13,13,37,49,1899
39779,39779,B6EDE923BA421C490CFB0E81830396F2,12121,14,15,1,29,47,1497
39780,39780,B6EDE923BA421C490CFB0E81830396F2,19114,16,17,1,7,43,393
39781,39781,B6EDE923BA421C490CFB0E81830396F2,11231,18,20,2,37,49,1899
39782,39782,B6EDE923BA421C490CFB0E81830396F2,11271,20,23,3,37,48,1898
39790,39790,81C16B7B4E2FCBA64E1ACB528552C8F7,13371,0,10,10,41,47,2097
39791,39791,81C16B7B4E2FCBA64E1ACB528552C8F7,11806,11,13,2,41,48,2098
39792,39792,81C16B7B4E2FCBA64E1ACB528552C8F7,10471,16,22,6,37,48,1898
39796,39796,1C0548F40841AD0870DAD8EC7BECCBC6,13314,0,6,6,31,39,1589
39797,39797,1C0548F40841AD0870DAD8EC7BECCBC6,12521,7,8,1,35,41,1791
39798,39798,1C0548F40841AD0870DAD8EC7BECCBC6,13314,11,23,12,31,39,1589
39799,39799,47E88EEB0ACD8A050A018340BD482B6B,10591,0,6,6,39,48,1998
39800,39800,47E88EEB0ACD8A050A018340BD482B6B,11074,6,7,1,37,47,1897
39801,39801,47E88EEB0ACD8A050A018340BD482B6B,11921,10,12,2,38,48,1948
39802,39802,47E88EEB0ACD8A050A018340BD482B6B,42583,14,15,1,40,48,2048
39803,39803,47E88EEB0ACD8A050A018340BD482B6B,11074,18,20,2,37,47,1897
39807,39807,B8EBCC6B2203DAA88707051EF909EE31,13711,0,4,4,38,46,1946
39808,39808,B8EBCC6B2203DAA88707051EF909EE31,42231,4,6,2,37,46,1896
39809,39809,B8EBCC6B2203DAA88707051EF909EE31,11261,9,17,8,36,46,1846
39810,39810,B8EBCC6B2203DAA88707051EF909EE31,42231,17,19,2,37,46,1896
39811,39811,B8EBCC6B2203DAA88707051EF909EE31,13711,21,22,1,38,46,1946
39812,39812,E648A6F090A3BE85617E0ED54A73B4F0,12601,0,3,3,25,47,1297
39813,39813,E648A6F090A3BE85617E0ED54A73B4F0,12671,4,6,2,21,43,1093
39814,39814,E648A6F090A3BE85617E0ED54A73B4F0,12601,8,22,14,25,47,1297
39815,39815,2E9DA8BFC00288392B827149BB3FB265,12641,0,1,1,10,43,543
39816,39816,2E9DA8BFC00288392B827149BB3FB265,43021,3,6,3,16,43,843
39817,39817,2E9DA8BFC00288392B827149BB3FB265,12641,8,21,13,10,43,543
39818,39818,3C07D1557002BF4F1AA6A6D7A8949EF2,42523,1,3,2,31,47,1597
39819,39819,3C07D1557002BF4F1AA6A6D7A8949EF2,43761,5,6,1,32,47,1647
39820,39820,3C07D1557002BF4F1AA6A6D7A8949EF2,12601,7,17,10,25,47,1297
39821,39821,3C07D1557002BF4F1AA6A6D7A8949EF2,42523,21,22,1,31,47,1597
39822,39822,098FE8401B48D35D8F8F23ACB7575A2C,43021,0,15,15,16,43,843
39823,39823,098FE8401B48D35D8F8F23ACB7575A2C,12921,15,17,2,9,41,491
39824,39824,098FE8401B48D35D8F8F23ACB7575A2C,43021,18,23,5,16,43,843
39825,39825,86A1DF8800E30C7989C62DDE6412CCA9,11021,1,9,8,36,49,1849
39826,39826,86A1DF8800E30C7989C62DDE6412CCA9,42961,10,11,1,35,49,1799
39827,39827,86A1DF8800E30C7989C62DDE6412CCA9,11021,12,15,3,36,49,1849
39828,39828,86A1DF8800E30C7989C62DDE6412CCA9,10787,16,18,2,38,46,1946
39832,39832,D9419B851F8839F5D675C951F631DB8E,10921,0,7,7,43,48,2198
39833,39833,D9419B851F8839F5D675C951F631DB8E,43101,10,15,5,46,40,2340
39834,39834,D9419B851F8839F5D675C951F631DB8E,10921,19,21,2,43,48,2198
39838,39838,6A76AEF510295C8181217D087B4161BA,11811,0,10,10,38,49,1949
39839,39839,6A76AEF510295C8181217D087B4161BA,42521,13,14,1,31,47,1597
39840,39840,6A76AEF510295C8181217D087B4161BA,11381,17,23,6,30,47,1547
39841,39841,DE3DB069CF0A068ED881835170BAD55A,11061,0,7,7,29,48,1498
39842,39842,DE3DB069CF0A068ED881835170BAD55A,12921,8,20,12,9,41,491
39843,39843,DE3DB069CF0A068ED881835170BAD55A,43021,22,23,1,16,43,843
39848,39848,52211AE5D673651DC9902BEAF51CF94C,11381,7,10,3,30,47,1547
39849,39849,52211AE5D673651DC9902BEAF51CF94C,11201,12,13,1,35,49,1799
39850,39850,52211AE5D673651DC9902BEAF51CF94C,42301,16,20,4,36,47,1847
39851,39851,698D330828DDD2FCACF2F1C2224B1477,10811,0,7,7,38,46,1946
39852,39852,698D330828DDD2FCACF2F1C2224B1477,12601,8,12,4,25,47,1297
39853,39853,698D330828DDD2FCACF2F1C2224B1477,11074,15,16,1,37,47,1897
39854,39854,698D330828DDD2FCACF2F1C2224B1477,10811,21,23,2,38,46,1946
39859,39859,CC6A63734928B4CD8F414AAB01241B9F,43311,0,7,7,31,48,1598
39860,39860,CC6A63734928B4CD8F414AAB01241B9F,12381,12,13,1,32,48,1648
39861,39861,CC6A63734928B4CD8F414AAB01241B9F,10121,16,17,1,36,49,1849
39862,39862,CC6A63734928B4CD8F414AAB01241B9F,10611,21,23,2,32,48,1648
39888,39888,931D1B9D3F88D7DAF9B270F67C939CF9,13941,3,8,5,41,47,2097
39889,39889,931D1B9D3F88D7DAF9B270F67C939CF9,42271,13,17,4,40,47,2047
39890,39890,931D1B9D3F88D7DAF9B270F67C939CF9,11861,21,22,1,32,47,1647
39891,39891,76DA946F4DC1318DD46A32E1D303D6B7,12521,0,7,7,35,41,1791
39892,39892,76DA946F4DC1318DD46A32E1D303D6B7,13314,8,11,3,31,39,1589
39893,39893,76DA946F4DC1318DD46A32E1D303D6B7,12521,12,23,11,35,41,1791
39894,39894,9508FAE0B774FCD97D7CFB3C4BD72215,10251,5,6,1,35,47,1797
39895,39895,9508FAE0B774FCD97D7CFB3C4BD72215,13911,8,9,1,39,46,1996
39896,39896,9508FAE0B774FCD97D7CFB3C4BD72215,10111,11,20,9,37,47,1897
39897,39897,9508FAE0B774FCD97D7CFB3C4BD72215,42401,22,23,1,36,47,1847
39898,39898,E275A4C2AEABEAB000BD6495EE76EA05,10771,0,1,1,41,46,2096
39899,39899,E275A4C2AEABEAB000BD6495EE76EA05,11231,1,2,1,37,49,1899
39900,39900,E275A4C2AEABEAB000BD6495EE76EA05,10771,3,19,16,41,46,2096
39901,39901,E275A4C2AEABEAB000BD6495EE76EA05,10111,20,21,1,37,47,1897
39902,39902,1DAFF76ACB610741A4BE36A701B9B8ED,11791,0,7,7,38,49,1949
39903,39903,1DAFF76ACB610741A4BE36A701B9B8ED,42071,11,13,2,31,49,1599
39904,39904,1DAFF76ACB610741A4BE36A701B9B8ED,11791,19,23,4,38,49,1949
39905,39905,6268A79D87E3CFA4E65FA8A748F9969C,13101,0,7,7,40,47,2047
39906,39906,6268A79D87E3CFA4E65FA8A748F9969C,11481,8,10,2,41,48,2098
39907,39907,6268A79D87E3CFA4E65FA8A748F9969C,13271,11,12,1,41,47,2097
39908,39908,6268A79D87E3CFA4E65FA8A748F9969C,13101,15,18,3,40,47,2047
39909,39909,6268A79D87E3CFA4E65FA8A748F9969C,11481,20,21,1,41,48,2098
39910,39910,DE69FEBC50432F9871EF62D07F7A5C1A,19181,1,4,3,8,40,440
39911,39911,DE69FEBC50432F9871EF62D07F7A5C1A,43021,5,6,1,16,43,843
39912,39912,DE69FEBC50432F9871EF62D07F7A5C1A,19181,6,23,17,8,40,440
39913,39913,DE2CF7635A4FCEF13695C4816E23FB11,10491,0,7,7,33,48,1698
39914,39914,DE2CF7635A4FCEF13695C4816E23FB11,10881,8,9,1,34,48,1748
39915,39915,DE2CF7635A4FCEF13695C4816E23FB11,10491,10,13,3,33,48,1698
39916,39916,DE2CF7635A4FCEF13695C4816E23FB11,16184,15,16,1,1,1,51
39917,39917,DE2CF7635A4FCEF13695C4816E23FB11,11131,18,23,5,33,48,1698
39928,39928,92A823D7887A55DA669369A749783D4F,11021,0,3,3,36,49,1849
39929,39929,92A823D7887A55DA669369A749783D4F,40341,15,16,1,23,49,1199
39930,39930,92A823D7887A55DA669369A749783D4F,11021,21,22,1,36,49,1849
39931,39931,F5BC1F3CE8793A57EF8A6B392B091737,43021,2,9,7,16,43,843
39932,39932,F5BC1F3CE8793A57EF8A6B392B091737,19114,12,21,9,7,43,393
39933,39933,F5BC1F3CE8793A57EF8A6B392B091737,12921,21,22,1,9,41,491
39934,39934,21214DF25ABBFE57C13DD19922691751,13911,0,6,6,39,46,1996
39935,39935,21214DF25ABBFE57C13DD19922691751,42351,7,8,1,38,45,1945
39936,39936,21214DF25ABBFE57C13DD19922691751,11261,12,15,3,36,46,1846
39937,39937,21214DF25ABBFE57C13DD19922691751,13221,16,18,2,40,47,2047
39938,39938,21214DF25ABBFE57C13DD19922691751,11261,18,21,3,36,46,1846
39939,39939,21214DF25ABBFE57C13DD19922691751,42351,22,23,1,38,45,1945
39940,39940,C83A24549690919D158BD0CE80AE31F4,42351,0,2,2,38,45,1945
39941,39941,C83A24549690919D158BD0CE80AE31F4,11261,4,6,2,36,46,1846
39942,39942,C83A24549690919D158BD0CE80AE31F4,42864,7,8,1,38,44,1944
39943,39943,C83A24549690919D158BD0CE80AE31F4,11261,8,12,4,36,46,1846
39944,39944,C83A24549690919D158BD0CE80AE31F4,13231,12,16,4,39,46,1996
39945,39945,C83A24549690919D158BD0CE80AE31F4,11261,17,21,4,36,46,1846
39952,39952,AFAE133FA88B98A999C46702AA923186,10911,1,8,7,39,46,1996
39953,39953,AFAE133FA88B98A999C46702AA923186,42501,11,12,1,28,47,1447
39954,39954,AFAE133FA88B98A999C46702AA923186,10601,13,16,3,39,47,1997
39955,39955,AFAE133FA88B98A999C46702AA923186,10841,20,23,3,37,47,1897
39960,39960,6A1D10B491D138F434BFB67E66419B4E,19441,3,7,4,8,46,446
39961,39961,6A1D10B491D138F434BFB67E66419B4E,42041,10,11,1,10,47,547
39962,39962,6A1D10B491D138F434BFB67E66419B4E,19441,12,17,5,8,46,446
39963,39963,6A1D10B491D138F434BFB67E66419B4E,11941,20,21,1,37,46,1896
39964,39964,7F8A8DCE46D67556DD5B831711335E3B,11381,2,4,2,30,47,1547
39965,39965,7F8A8DCE46D67556DD5B831711335E3B,10951,8,13,5,29,48,1498
39966,39966,7F8A8DCE46D67556DD5B831711335E3B,42221,14,15,1,38,48,1948
39967,39967,7F8A8DCE46D67556DD5B831711335E3B,10951,18,23,5,29,48,1498
39968,39968,253A422C6572FACDA35B610A2E4ABDE3,15441,0,7,7,44,20,2220
39969,39969,253A422C6572FACDA35B610A2E4ABDE3,12881,12,13,1,47,22,2372
39970,39970,253A422C6572FACDA35B610A2E4ABDE3,15441,15,22,7,44,20,2220
39981,39981,20816E69FB6F9D199E34B5C4EF146CB7,10634,4,6,2,27,45,1395
39982,39982,20816E69FB6F9D199E34B5C4EF146CB7,19441,7,17,10,8,46,446
39983,39983,20816E69FB6F9D199E34B5C4EF146CB7,12601,22,23,1,25,47,1297
39991,39991,2D9F8EEE0946858BEC66856CB73B8335,12921,9,10,1,9,41,491
39992,39992,2D9F8EEE0946858BEC66856CB73B8335,43021,12,14,2,16,43,843
39993,39993,2D9F8EEE0946858BEC66856CB73B8335,12921,14,15,1,9,41,491
39994,39994,2D9F8EEE0946858BEC66856CB73B8335,43021,19,20,1,16,43,843
39995,39995,E2817DCA7F56528BE742270C828413EF,10381,2,3,1,31,49,1599
39996,39996,E2817DCA7F56528BE742270C828413EF,11111,4,5,1,26,48,1348
39997,39997,E2817DCA7F56528BE742270C828413EF,12051,8,15,7,20,47,1047
39998,39998,E2817DCA7F56528BE742270C828413EF,12601,15,18,3,25,47,1297
40012,40012,07E6FCDB732C9B61420DA44E31B8B265,11741,0,7,7,42,49,2149
40013,40013,07E6FCDB732C9B61420DA44E31B8B265,11021,11,21,10,36,49,1849
40014,40014,07E6FCDB732C9B61420DA44E31B8B265,11741,22,23,1,42,49,2149
40019,40019,78B0E510C8AC1F29BEBD74E6A2E2C73D,42411,0,6,6,40,49,2049
40020,40020,78B0E510C8AC1F29BEBD74E6A2E2C73D,11161,9,14,5,32,48,1648
40021,40021,78B0E510C8AC1F29BEBD74E6A2E2C73D,10191,18,23,5,40,48,2048
40022,40022,66BF2E4899B4E57AFD9485A7423B59AE,11481,0,7,7,41,48,2098
40023,40023,66BF2E4899B4E57AFD9485A7423B59AE,11531,8,11,3,34,49,1749
40024,40024,66BF2E4899B4E57AFD9485A7423B59AE,11021,12,16,4,36,49,1849
40025,40025,66BF2E4899B4E57AFD9485A7423B59AE,11481,18,20,2,41,48,2098
40033,40033,25BB98ABDDC62E02F58BAA407868F675,11061,1,9,8,29,48,1498
40034,40034,25BB98ABDDC62E02F58BAA407868F675,13731,11,13,2,33,49,1699
40035,40035,25BB98ABDDC62E02F58BAA407868F675,11061,18,22,4,29,48,1498
40036,40036,360CAB205F052520FED1AC4C9779857A,43761,2,10,8,32,47,1647
40037,40037,360CAB205F052520FED1AC4C9779857A,13711,12,14,2,38,46,1946
40038,40038,360CAB205F052520FED1AC4C9779857A,12161,18,19,1,32,46,1646
40039,40039,360CAB205F052520FED1AC4C9779857A,11941,20,23,3,37,46,1896
40046,40046,D456818D1ABF2E338A137666497E2B37,42071,0,2,2,31,49,1599
40047,40047,D456818D1ABF2E338A137666497E2B37,11021,2,4,2,36,49,1849
40048,40048,D456818D1ABF2E338A137666497E2B37,42071,6,21,15,31,49,1599
40049,40049,6869A5F90DBC32E3AB5337DBC7DAA2BA,11281,0,3,3,27,40,1390
40050,40050,6869A5F90DBC32E3AB5337DBC7DAA2BA,43951,7,15,8,49,41,2491
40051,40051,6869A5F90DBC32E3AB5337DBC7DAA2BA,13411,17,19,2,49,42,2492
40052,40052,6869A5F90DBC32E3AB5337DBC7DAA2BA,42151,21,23,2,35,45,1795
40057,40057,785F4EBA3F4642EC7BD5BE5F80643D2E,43731,0,7,7,34,47,1747
40058,40058,785F4EBA3F4642EC7BD5BE5F80643D2E,42921,7,9,2,33,47,1697
40059,40059,785F4EBA3F4642EC7BD5BE5F80643D2E,43731,9,13,4,34,47,1747
40060,40060,785F4EBA3F4642EC7BD5BE5F80643D2E,42921,13,14,1,33,47,1697
40061,40061,785F4EBA3F4642EC7BD5BE5F80643D2E,13601,17,23,6,34,47,1747
40071,40071,B37F55B1E896762F46589F9911F856B8,43241,0,7,7,36,46,1846
40072,40072,B37F55B1E896762F46589F9911F856B8,42051,11,13,2,42,48,2148
40073,40073,B37F55B1E896762F46589F9911F856B8,12601,16,17,1,25,47,1297
40074,40074,B37F55B1E896762F46589F9911F856B8,42523,21,22,1,31,47,1597
40075,40075,1D51AC4BBFB933A632C5A69F521FA887,11861,0,12,12,32,47,1647
40076,40076,1D51AC4BBFB933A632C5A69F521FA887,11271,12,15,3,37,48,1898
40077,40077,1D51AC4BBFB933A632C5A69F521FA887,11861,16,23,7,32,47,1647
40078,40078,D6932FB45D03368B8FD3FCD5E6F4054F,11481,0,8,8,41,48,2098
40079,40079,D6932FB45D03368B8FD3FCD5E6F4054F,11541,11,13,2,35,49,1799
40080,40080,D6932FB45D03368B8FD3FCD5E6F4054F,10221,13,15,2,34,49,1749
40081,40081,D6932FB45D03368B8FD3FCD5E6F4054F,43341,18,19,1,41,46,2096
40082,40082,D6932FB45D03368B8FD3FCD5E6F4054F,11531,20,23,3,34,49,1749
40092,40092,EFA0A0E0EE0C6FB44CD26ED42802337A,12921,0,3,3,9,41,491
40093,40093,EFA0A0E0EE0C6FB44CD26ED42802337A,12641,4,6,2,10,43,543
40094,40094,EFA0A0E0EE0C6FB44CD26ED42802337A,19114,8,13,5,7,43,393
40095,40095,EFA0A0E0EE0C6FB44CD26ED42802337A,11794,17,18,1,38,49,1949
40096,40096,EFA0A0E0EE0C6FB44CD26ED42802337A,19114,21,23,2,7,43,393
40103,40103,DEA13AE4E25C1F5535D501BC3C7ECF55,19111,0,7,7,9,45,495
40104,40104,DEA13AE4E25C1F5535D501BC3C7ECF55,40051,9,15,6,32,49,1649
40105,40105,DEA13AE4E25C1F5535D501BC3C7ECF55,19111,16,18,2,9,45,495
40106,40106,DEA13AE4E25C1F5535D501BC3C7ECF55,42641,19,21,2,33,49,1699
40107,40107,DEA13AE4E25C1F5535D501BC3C7ECF55,19111,21,23,2,9,45,495
40108,40108,91C8CBC4A87AAB1961DD334B8BC382B1,10971,10,11,1,35,47,1797
40109,40109,91C8CBC4A87AAB1961DD334B8BC382B1,10301,12,13,1,31,45,1595
40110,40110,91C8CBC4A87AAB1961DD334B8BC382B1,10971,14,20,6,35,47,1797
40111,40111,2F8CA12038D8BFDAC42D43FF94213821,13071,1,5,4,41,41,2091
40112,40112,2F8CA12038D8BFDAC42D43FF94213821,43451,6,17,11,37,40,1890
40113,40113,2F8CA12038D8BFDAC42D43FF94213821,42381,18,22,4,39,41,1991
40117,40117,6F53521EC3B02D784FD183E95167CB83,10221,0,8,8,34,49,1749
40118,40118,6F53521EC3B02D784FD183E95167CB83,10251,9,10,1,35,47,1797
40119,40119,6F53521EC3B02D784FD183E95167CB83,42401,11,14,3,36,47,1847
40120,40120,6F53521EC3B02D784FD183E95167CB83,10111,15,17,2,37,47,1897
40121,40121,6F53521EC3B02D784FD183E95167CB83,13511,18,20,2,34,48,1748
40122,40122,6F53521EC3B02D784FD183E95167CB83,10221,21,23,2,34,49,1749
40127,40127,DD628D137A372FD9F2379158E8EE3966,12921,0,11,11,9,41,491
40128,40128,DD628D137A372FD9F2379158E8EE3966,42491,15,16,1,32,46,1646
40129,40129,DD628D137A372FD9F2379158E8EE3966,12921,18,20,2,9,41,491
40133,40133,CC3FA096FA296BC301B8FB82BD507846,10381,4,5,1,31,49,1599
40134,40134,CC3FA096FA296BC301B8FB82BD507846,42471,6,7,1,35,49,1799
40135,40135,CC3FA096FA296BC301B8FB82BD507846,11531,8,9,1,34,49,1749
40136,40136,CC3FA096FA296BC301B8FB82BD507846,42471,10,12,2,35,49,1799
40137,40137,CC3FA096FA296BC301B8FB82BD507846,11531,12,16,4,34,49,1749
40138,40138,CC3FA096FA296BC301B8FB82BD507846,42471,16,21,5,35,49,1799
40146,40146,25CC66D599A64006DB1C07E7C87CDB76,12641,0,2,2,10,43,543
40147,40147,25CC66D599A64006DB1C07E7C87CDB76,12921,3,5,2,9,41,491
40148,40148,25CC66D599A64006DB1C07E7C87CDB76,43021,9,11,2,16,43,843
40149,40149,25CC66D599A64006DB1C07E7C87CDB76,12921,12,16,4,9,41,491
40150,40150,25CC66D599A64006DB1C07E7C87CDB76,12641,17,19,2,10,43,543
40151,40151,25CC66D599A64006DB1C07E7C87CDB76,12921,19,21,2,9,41,491
40158,40158,ED87C555BEA1AC55CA76F90232ECA3BC,42531,0,14,14,31,45,1595
40159,40159,ED87C555BEA1AC55CA76F90232ECA3BC,40341,16,19,3,23,49,1199
40160,40160,ED87C555BEA1AC55CA76F90232ECA3BC,40381,20,21,1,32,46,1646
40171,40171,9EC6B7AAAAB1180EF9AB0AF812545D3E,11324,8,10,2,31,46,1596
40172,40172,9EC6B7AAAAB1180EF9AB0AF812545D3E,10381,15,16,1,31,49,1599
40173,40173,9EC6B7AAAAB1180EF9AB0AF812545D3E,13671,20,23,3,27,43,1393
40174,40174,62FCB15297A7724012720DDE29CC0405,13111,3,7,4,42,46,2146
40175,40175,62FCB15297A7724012720DDE29CC0405,13791,8,9,1,42,47,2147
40176,40176,62FCB15297A7724012720DDE29CC0405,11541,11,12,1,35,49,1799
40177,40177,62FCB15297A7724012720DDE29CC0405,42541,14,16,2,25,47,1297
40178,40178,62FCB15297A7724012720DDE29CC0405,42141,18,19,1,32,47,1647
40179,40179,62FCB15297A7724012720DDE29CC0405,10191,21,23,2,40,48,2048
40184,40184,35FE39B951D37418385844C98A76F454,15401,0,6,6,39,25,1975
40185,40185,35FE39B951D37418385844C98A76F454,15411,7,17,10,44,27,2227
40186,40186,35FE39B951D37418385844C98A76F454,15401,18,23,5,39,25,1975
40205,40205,996BCE0DAB75A26D5C00E852EA1E0939,42201,0,9,9,43,46,2196
40206,40206,996BCE0DAB75A26D5C00E852EA1E0939,40302,12,14,2,40,49,2049
40207,40207,996BCE0DAB75A26D5C00E852EA1E0939,42201,18,23,5,43,46,2196
40208,40208,A1A5867AEAAAEF8BC662DDDD8683129F,49201,0,5,5,7,41,391
40209,40209,A1A5867AEAAAEF8BC662DDDD8683129F,12921,8,9,1,9,41,491
40210,40210,A1A5867AEAAAEF8BC662DDDD8683129F,49201,11,13,2,7,41,391
40211,40211,A1A5867AEAAAEF8BC662DDDD8683129F,12921,14,15,1,9,41,491
40212,40212,A1A5867AEAAAEF8BC662DDDD8683129F,49201,18,23,5,7,41,391
40217,40217,4E8CF0BE1A57E085938ED2B5916A9E34,11381,2,7,5,30,47,1547
40218,40218,4E8CF0BE1A57E085938ED2B5916A9E34,11061,9,14,5,29,48,1498
40219,40219,4E8CF0BE1A57E085938ED2B5916A9E34,12601,15,17,2,25,47,1297
40220,40220,4E8CF0BE1A57E085938ED2B5916A9E34,11381,18,19,1,30,47,1547
40221,40221,3F458F6ABA1F2A91C8D3DACF4A48895B,11571,0,1,1,13,46,696
40222,40222,3F458F6ABA1F2A91C8D3DACF4A48895B,42551,2,6,4,14,48,748
40223,40223,3F458F6ABA1F2A91C8D3DACF4A48895B,11571,7,8,1,13,46,696
40224,40224,3F458F6ABA1F2A91C8D3DACF4A48895B,11061,11,17,6,29,48,1498
40225,40225,3F458F6ABA1F2A91C8D3DACF4A48895B,42801,20,22,2,40,49,2049
40229,40229,AAF4696620C6353C66227214077A10B8,10771,0,8,8,41,46,2096
40230,40230,AAF4696620C6353C66227214077A10B8,40637,9,11,2,36,47,1847
40231,40231,AAF4696620C6353C66227214077A10B8,42531,12,14,2,31,45,1595
40232,40232,AAF4696620C6353C66227214077A10B8,40637,15,17,2,36,47,1847
40233,40233,AAF4696620C6353C66227214077A10B8,10771,18,19,1,41,46,2096
40234,40234,CC63EA7467D4A1FC7EF1BC76C9DAF092,11261,0,9,9,36,46,1846
40235,40235,CC63EA7467D4A1FC7EF1BC76C9DAF092,12311,10,17,7,30,44,1544
40236,40236,CC63EA7467D4A1FC7EF1BC76C9DAF092,11261,18,22,4,36,46,1846
40237,40237,B5D78F653B8A0114EB8B8E19A50DA5F5,43041,0,7,7,41,46,2096
40238,40238,B5D78F653B8A0114EB8B8E19A50DA5F5,10951,9,12,3,29,48,1498
40239,40239,B5D78F653B8A0114EB8B8E19A50DA5F5,13601,13,14,1,34,47,1747
40240,40240,B5D78F653B8A0114EB8B8E19A50DA5F5,10951,15,18,3,29,48,1498
40247,40247,2314DE27120D265691CF1C06609F76CD,10771,0,9,9,41,46,2096
40248,40248,2314DE27120D265691CF1C06609F76CD,11531,13,21,8,34,49,1749
40249,40249,2314DE27120D265691CF1C06609F76CD,10661,22,23,1,37,49,1899
40253,40253,D429753EEB35077FBB0F7FD7B24671DA,42381,0,4,4,39,41,1991
40254,40254,D429753EEB35077FBB0F7FD7B24671DA,43451,7,11,4,37,40,1890
40255,40255,D429753EEB35077FBB0F7FD7B24671DA,13071,12,13,1,41,41,2091
40256,40256,D429753EEB35077FBB0F7FD7B24671DA,43451,15,18,3,37,40,1890
40257,40257,D429753EEB35077FBB0F7FD7B24671DA,42381,21,22,1,39,41,1991
40258,40258,AB6EA8E0EB921375D4ACF50883707DA2,10401,0,8,8,33,49,1699
40259,40259,AB6EA8E0EB921375D4ACF50883707DA2,10681,12,15,3,30,48,1548
40260,40260,AB6EA8E0EB921375D4ACF50883707DA2,10544,18,22,4,28,48,1448
40261,40261,5134C03EB3276C610A7AB253ED006E01,11021,0,17,17,36,49,1849
40262,40262,5134C03EB3276C610A7AB253ED006E01,11521,18,21,3,41,48,2098
40263,40263,5134C03EB3276C610A7AB253ED006E01,42981,22,23,1,36,49,1849
40264,40264,3A538B5D138CBEEA61D0BEFCECC34E8D,11381,0,7,7,30,47,1547
40265,40265,3A538B5D138CBEEA61D0BEFCECC34E8D,40101,8,9,1,34,49,1749
40266,40266,3A538B5D138CBEEA61D0BEFCECC34E8D,10951,13,15,2,29,48,1498
40267,40267,3A538B5D138CBEEA61D0BEFCECC34E8D,11381,16,23,7,30,47,1547
40275,40275,D256AE34DD31744D7365602849D9C40A,10341,0,7,7,31,47,1597
40276,40276,D256AE34DD31744D7365602849D9C40A,10351,8,16,8,28,45,1445
40277,40277,D256AE34DD31744D7365602849D9C40A,12601,16,18,2,25,47,1297
40278,40278,D256AE34DD31744D7365602849D9C40A,42491,18,21,3,32,46,1646
40279,40279,C10EEFAF39D689A1C1E5FEB245DEDC71,40872,1,8,7,30,49,1549
40280,40280,C10EEFAF39D689A1C1E5FEB245DEDC71,11061,9,10,1,29,48,1498
40281,40281,C10EEFAF39D689A1C1E5FEB245DEDC71,40872,11,14,3,30,49,1549
40282,40282,C10EEFAF39D689A1C1E5FEB245DEDC71,11061,15,18,3,29,48,1498
40283,40283,C10EEFAF39D689A1C1E5FEB245DEDC71,40872,21,23,2,30,49,1549
40298,40298,BF7D2FD9F03389CF59F37D5B5218D08C,11641,0,11,11,22,49,1149
40299,40299,BF7D2FD9F03389CF59F37D5B5218D08C,40951,12,13,1,36,49,1849
40300,40300,BF7D2FD9F03389CF59F37D5B5218D08C,42161,15,16,1,36,47,1847
40301,40301,BF7D2FD9F03389CF59F37D5B5218D08C,11751,17,19,2,35,48,1798
40302,40302,983364FA08EE78C75B91294E8BF61EB7,15411,0,8,8,44,27,2227
40303,40303,983364FA08EE78C75B91294E8BF61EB7,15191,13,14,1,36,27,1827
40304,40304,983364FA08EE78C75B91294E8BF61EB7,12792,17,18,1,34,30,1730
40305,40305,983364FA08EE78C75B91294E8BF61EB7,15411,18,19,1,44,27,2227
40306,40306,983364FA08EE78C75B91294E8BF61EB7,12611,20,21,1,41,29,2079
40313,40313,22DF08AB8625FB5CE36A655BC50A3649,40271,1,9,8,35,49,1799
40314,40314,22DF08AB8625FB5CE36A655BC50A3649,40981,12,13,1,34,47,1747
40315,40315,22DF08AB8625FB5CE36A655BC50A3649,10721,14,15,1,31,48,1598
40316,40316,22DF08AB8625FB5CE36A655BC50A3649,11541,17,20,3,35,49,1799
40317,40317,22DF08AB8625FB5CE36A655BC50A3649,10771,20,23,3,41,46,2096
40321,40321,CAB47C85629646AC05B696BEE2F5B14A,10214,0,7,7,15,49,799
40322,40322,CAB47C85629646AC05B696BEE2F5B14A,11861,9,15,6,32,47,1647
40323,40323,CAB47C85629646AC05B696BEE2F5B14A,10211,19,21,2,16,49,849
40333,40333,9CEB72790B4E3235CF5D503C20E94C43,11781,0,9,9,38,49,1949
40334,40334,9CEB72790B4E3235CF5D503C20E94C43,13094,11,14,3,21,42,1092
40335,40335,9CEB72790B4E3235CF5D503C20E94C43,11771,16,17,1,39,49,1999
40336,40336,9CEB72790B4E3235CF5D503C20E94C43,11631,20,21,1,12,49,649
40340,40340,4FA7E2AF35091649A8D61648BF92F5C0,42581,0,6,6,38,48,1948
40341,40341,4FA7E2AF35091649A8D61648BF92F5C0,10471,8,11,3,37,48,1898
40342,40342,4FA7E2AF35091649A8D61648BF92F5C0,42581,12,14,2,38,48,1948
40343,40343,4FA7E2AF35091649A8D61648BF92F5C0,10471,15,18,3,37,48,1898
40344,40344,4FA7E2AF35091649A8D61648BF92F5C0,42071,19,20,1,31,49,1599
40345,40345,7EA63201A47B68AA085BD7B8AF1F7767,10721,0,7,7,31,48,1598
40346,40346,7EA63201A47B68AA085BD7B8AF1F7767,12083,8,9,1,36,49,1849
40347,40347,7EA63201A47B68AA085BD7B8AF1F7767,11231,12,16,4,37,49,1899
40348,40348,7EA63201A47B68AA085BD7B8AF1F7767,10721,19,23,4,31,48,1598
40358,40358,A8DFAF39A5A26AE1BCD9E9DE060BB315,11091,0,5,5,29,47,1497
40359,40359,A8DFAF39A5A26AE1BCD9E9DE060BB315,11381,8,12,4,30,47,1547
40360,40360,A8DFAF39A5A26AE1BCD9E9DE060BB315,42521,13,14,1,31,47,1597
40361,40361,A8DFAF39A5A26AE1BCD9E9DE060BB315,13651,15,16,1,30,47,1547
40362,40362,A8DFAF39A5A26AE1BCD9E9DE060BB315,11091,18,23,5,29,47,1497
40363,40363,565005545D8DAD4FBDA185A153E90618,42041,0,5,5,10,47,547
40364,40364,565005545D8DAD4FBDA185A153E90618,19441,7,8,1,8,46,446
40365,40365,565005545D8DAD4FBDA185A153E90618,42041,11,13,2,10,47,547
40366,40366,565005545D8DAD4FBDA185A153E90618,11471,19,20,1,12,48,648
40367,40367,565005545D8DAD4FBDA185A153E90618,42041,21,22,1,10,47,547
40371,40371,9A365F6CD1EED4A94D460D848C733912,43021,0,6,6,16,43,843
40372,40372,9A365F6CD1EED4A94D460D848C733912,12921,7,10,3,9,41,491
40373,40373,9A365F6CD1EED4A94D460D848C733912,43021,12,13,1,16,43,843
40374,40374,9A365F6CD1EED4A94D460D848C733912,12921,14,17,3,9,41,491
40375,40375,9A365F6CD1EED4A94D460D848C733912,43021,19,20,1,16,43,843
40376,40376,BC7E26CA9C636872D72F8E2051181A1A,42231,0,6,6,37,46,1896
40377,40377,BC7E26CA9C636872D72F8E2051181A1A,12611,8,13,5,41,29,2079
40378,40378,BC7E26CA9C636872D72F8E2051181A1A,15411,15,18,3,44,27,2227
40379,40379,BC7E26CA9C636872D72F8E2051181A1A,42231,20,23,3,37,46,1896
40380,40380,A4CBFA774BBCB1E081978588796288CA,10901,0,8,8,35,48,1798
40381,40381,A4CBFA774BBCB1E081978588796288CA,11231,12,17,5,37,49,1899
40382,40382,A4CBFA774BBCB1E081978588796288CA,10681,18,23,5,30,48,1548
40402,40402,315EE087A7D3E5A0308BA99609B9790D,12311,2,4,2,30,44,1544
40403,40403,315EE087A7D3E5A0308BA99609B9790D,12661,7,16,9,32,45,1645
40404,40404,315EE087A7D3E5A0308BA99609B9790D,12491,16,18,2,36,43,1843
40405,40405,4EE541C2C77ED64C3476846B8EC5E510,43121,0,5,5,25,27,1277
40406,40406,4EE541C2C77ED64C3476846B8EC5E510,12871,8,15,7,22,33,1133
40407,40407,4EE541C2C77ED64C3476846B8EC5E510,19431,16,20,4,8,29,429
40408,40408,4EE541C2C77ED64C3476846B8EC5E510,49181,20,22,2,21,31,1081
40415,40415,344A3CF0E215A1C44A25A9F391805F64,12921,3,7,4,9,41,491
40416,40416,344A3CF0E215A1C44A25A9F391805F64,11061,10,11,1,29,48,1498
40417,40417,344A3CF0E215A1C44A25A9F391805F64,10471,15,21,6,37,48,1898
40418,40418,344A3CF0E215A1C44A25A9F391805F64,40271,22,23,1,35,49,1799
40423,40423,474FFA09EED2908FC53360D0633D492E,13791,0,6,6,42,47,2147
40424,40424,474FFA09EED2908FC53360D0633D492E,10221,11,18,7,34,49,1749
40425,40425,474FFA09EED2908FC53360D0633D492E,43061,19,21,2,43,46,2196
40426,40426,49C79AB3305EA0BDD0BE79CDFA7582CD,11074,1,7,6,37,47,1897
40427,40427,49C79AB3305EA0BDD0BE79CDFA7582CD,12661,8,18,10,32,45,1645
40428,40428,49C79AB3305EA0BDD0BE79CDFA7582CD,11074,21,23,2,37,47,1897
40429,40429,B9333E90F2201A4A32B443E6CC76B3ED,10721,0,11,11,31,48,1598
40430,40430,B9333E90F2201A4A32B443E6CC76B3ED,10214,18,19,1,15,49,799
40431,40431,B9333E90F2201A4A32B443E6CC76B3ED,10721,20,22,2,31,48,1598
40436,40436,A2D507EA5E3520526C66D89C2499D500,10901,0,7,7,35,48,1798
40437,40437,A2D507EA5E3520526C66D89C2499D500,11061,9,16,7,29,48,1498
40438,40438,A2D507EA5E3520526C66D89C2499D500,10901,19,21,2,35,48,1798
40439,40439,E6C0B95DF19745278BB8C4C83FE2A959,12401,0,7,7,39,49,1999
40440,40440,E6C0B95DF19745278BB8C4C83FE2A959,10221,7,17,10,34,49,1749
40441,40441,E6C0B95DF19745278BB8C4C83FE2A959,10191,18,23,5,40,48,2048
40445,40445,63D46256AD6F86C8491C2B2581A93893,11291,0,6,6,40,49,2049
40446,40446,63D46256AD6F86C8491C2B2581A93893,10251,7,8,1,35,47,1797
40447,40447,63D46256AD6F86C8491C2B2581A93893,11541,10,20,10,35,49,1799
40448,40448,63D46256AD6F86C8491C2B2581A93893,11291,21,23,2,40,49,2049
40456,40456,F8C15A91A86DF78F99B4C068225EACC1,42161,1,2,1,36,47,1847
40457,40457,F8C15A91A86DF78F99B4C068225EACC1,11271,3,5,2,37,48,1898
40458,40458,F8C15A91A86DF78F99B4C068225EACC1,10841,6,7,1,37,47,1897
40459,40459,F8C15A91A86DF78F99B4C068225EACC1,42301,10,19,9,36,47,1847
40460,40460,F8C15A91A86DF78F99B4C068225EACC1,10251,20,22,2,35,47,1797
40461,40461,729DA0C079717E4E4A0173A20CB90D98,11914,1,2,1,37,48,1898
40462,40462,729DA0C079717E4E4A0173A20CB90D98,40171,2,7,5,38,48,1948
40463,40463,729DA0C079717E4E4A0173A20CB90D98,11914,9,10,1,37,48,1898
40464,40464,729DA0C079717E4E4A0173A20CB90D98,40171,12,13,1,38,48,1948
40465,40465,729DA0C079717E4E4A0173A20CB90D98,10471,14,21,7,37,48,1898
40466,40466,46CB095EF81B7090747D900A43220105,42071,0,9,9,31,49,1599
40467,40467,46CB095EF81B7090747D900A43220105,42121,12,13,1,26,49,1349
40468,40468,46CB095EF81B7090747D900A43220105,10951,14,19,5,29,48,1498
40472,40472,FCA41D1A9AA28A78DFB3F79F3C4FFA6C,13231,0,5,5,39,46,1996
40473,40473,FCA41D1A9AA28A78DFB3F79F3C4FFA6C,12561,7,9,2,45,43,2293
40474,40474,FCA41D1A9AA28A78DFB3F79F3C4FFA6C,43011,10,11,1,40,42,2042
40475,40475,FCA41D1A9AA28A78DFB3F79F3C4FFA6C,10107,15,16,1,38,49,1949
40476,40476,FCA41D1A9AA28A78DFB3F79F3C4FFA6C,10331,20,22,2,39,46,1996
40477,40477,EFC4C4547AD5CF976DA613316B075F49,11771,0,8,8,39,49,1999
40478,40478,EFC4C4547AD5CF976DA613316B075F49,40124,9,10,1,38,47,1947
40479,40479,EFC4C4547AD5CF976DA613316B075F49,40951,11,12,1,36,49,1849
40480,40480,EFC4C4547AD5CF976DA613316B075F49,11751,16,17,1,35,48,1798
40481,40481,EFC4C4547AD5CF976DA613316B075F49,11551,19,23,4,39,49,1999
40488,40488,C4D6D6893D15A40EF6C21B7CBC7CED3E,11861,0,8,8,32,47,1647
40489,40489,C4D6D6893D15A40EF6C21B7CBC7CED3E,11541,8,17,9,35,49,1799
40490,40490,C4D6D6893D15A40EF6C21B7CBC7CED3E,11861,19,23,4,32,47,1647
40495,40495,8AB561279CAFD673B81CFFF6F25401C3,43011,0,5,5,40,42,2042
40496,40496,8AB561279CAFD673B81CFFF6F25401C3,12221,6,14,8,43,44,2194
40497,40497,8AB561279CAFD673B81CFFF6F25401C3,13951,16,18,2,47,45,2395
40498,40498,8AB561279CAFD673B81CFFF6F25401C3,43011,21,23,2,40,42,2042
40502,40502,3DBAFDEA494877045EB98704E3E793DC,42351,0,6,6,38,45,1945
40503,40503,3DBAFDEA494877045EB98704E3E793DC,42231,7,8,1,37,46,1896
40504,40504,3DBAFDEA494877045EB98704E3E793DC,13911,12,14,2,39,46,1996
40505,40505,3DBAFDEA494877045EB98704E3E793DC,42351,16,17,1,38,45,1945
40506,40506,3DBAFDEA494877045EB98704E3E793DC,13911,20,23,3,39,46,1996
40507,40507,42B28AE3CCE12BA9A899758E7A189C34,11806,0,8,8,41,48,2098
40508,40508,42B28AE3CCE12BA9A899758E7A189C34,10121,8,12,4,36,49,1849
40509,40509,42B28AE3CCE12BA9A899758E7A189C34,11806,13,15,2,41,48,2098
40510,40510,42B28AE3CCE12BA9A899758E7A189C34,12792,18,19,1,34,30,1730
40511,40511,42B28AE3CCE12BA9A899758E7A189C34,11806,22,23,1,41,48,2098
40512,40512,7B7808F449A709BA37633BF3E740E9A3,43051,0,6,6,46,45,2345
40513,40513,7B7808F449A709BA37633BF3E740E9A3,12211,7,10,3,41,44,2094
40514,40514,7B7808F449A709BA37633BF3E740E9A3,42461,12,14,2,45,47,2297
40515,40515,7B7808F449A709BA37633BF3E740E9A3,12211,15,23,8,41,44,2094
40516,40516,BC71A128CC1D1FD204F1FA3A371EA53A,43021,0,5,5,16,43,843
40517,40517,BC71A128CC1D1FD204F1FA3A371EA53A,12921,6,17,11,9,41,491
40518,40518,BC71A128CC1D1FD204F1FA3A371EA53A,43021,20,23,3,16,43,843
40519,40519,2FA2E23FD790DE0C56A37BB5AFA9D936,42623,0,17,17,22,49,1149
40520,40520,2FA2E23FD790DE0C56A37BB5AFA9D936,42511,18,20,2,37,47,1897
40521,40521,2FA2E23FD790DE0C56A37BB5AFA9D936,42623,21,23,2,22,49,1149
40529,40529,000D77C2A9F62BEDA00737D781A7BB24,42141,0,6,6,32,47,1647
40530,40530,000D77C2A9F62BEDA00737D781A7BB24,10161,14,16,2,35,49,1799
40531,40531,000D77C2A9F62BEDA00737D781A7BB24,42141,21,23,2,32,47,1647
40538,40538,0AD8838435D12A1009D3BADE4EAE690D,11381,0,8,8,30,47,1547
40539,40539,0AD8838435D12A1009D3BADE4EAE690D,10951,10,12,2,29,48,1498
40540,40540,0AD8838435D12A1009D3BADE4EAE690D,10634,12,14,2,27,45,1395
40541,40541,0AD8838435D12A1009D3BADE4EAE690D,11381,14,23,9,30,47,1547
40545,40545,9A32E318CA0CDE9DA0BCF043EF40ABC3,10771,0,3,3,41,46,2096
40546,40546,9A32E318CA0CDE9DA0BCF043EF40ABC3,10111,3,14,11,37,47,1897
40547,40547,9A32E318CA0CDE9DA0BCF043EF40ABC3,13711,16,22,6,38,46,1946
40548,40548,55536669E97AF41ACDE427113BB85731,10691,0,6,6,33,48,1698
40549,40549,55536669E97AF41ACDE427113BB85731,11861,7,8,1,32,47,1647
40550,40550,55536669E97AF41ACDE427113BB85731,11021,8,10,2,36,49,1849
40551,40551,55536669E97AF41ACDE427113BB85731,11861,13,14,1,32,47,1647
40552,40552,55536669E97AF41ACDE427113BB85731,10691,18,23,5,33,48,1698
40553,40553,B304D2AD98C7DE24CAE6DD0DA65095F0,10431,0,6,6,33,49,1699
40554,40554,B304D2AD98C7DE24CAE6DD0DA65095F0,43581,8,9,1,33,48,1698
40555,40555,B304D2AD98C7DE24CAE6DD0DA65095F0,10431,12,13,1,33,49,1699
40556,40556,B304D2AD98C7DE24CAE6DD0DA65095F0,43581,13,17,4,33,48,1698
40557,40557,B304D2AD98C7DE24CAE6DD0DA65095F0,10431,22,23,1,33,49,1699
40558,40558,421B430E1E1124DB6415F6C836BF69D8,13111,0,8,8,42,46,2146
40559,40559,421B430E1E1124DB6415F6C836BF69D8,40341,10,14,4,23,49,1199
40560,40560,421B430E1E1124DB6415F6C836BF69D8,40073,16,18,2,37,48,1898
40561,40561,34FB5BF239A7B5016E3CA81F47968839,42161,0,7,7,36,47,1847
40562,40562,34FB5BF239A7B5016E3CA81F47968839,40961,7,10,3,35,47,1797
40563,40563,34FB5BF239A7B5016E3CA81F47968839,42161,13,15,2,36,47,1847
40564,40564,34FB5BF239A7B5016E3CA81F47968839,10251,16,19,3,35,47,1797
40565,40565,34FB5BF239A7B5016E3CA81F47968839,42161,20,22,2,36,47,1847
40566,40566,C8FB6DD91273145B18290C22A7A7A7B5,10521,0,7,7,41,47,2097
40567,40567,C8FB6DD91273145B18290C22A7A7A7B5,12641,9,12,3,10,43,543
40568,40568,C8FB6DD91273145B18290C22A7A7A7B5,10521,13,20,7,41,47,2097
40569,40569,401DBF9291C70DB6E3FE8385830F996E,13791,0,7,7,42,47,2147
40570,40570,401DBF9291C70DB6E3FE8385830F996E,11021,12,14,2,36,49,1849
40571,40571,401DBF9291C70DB6E3FE8385830F996E,11201,15,16,1,35,49,1799
40572,40572,401DBF9291C70DB6E3FE8385830F996E,11591,19,23,4,36,49,1849
40573,40573,F5CAB8F803ECE6BB91E5E9B3677179B2,42401,1,8,7,36,47,1847
40574,40574,F5CAB8F803ECE6BB91E5E9B3677179B2,10811,10,12,2,38,46,1946
40575,40575,F5CAB8F803ECE6BB91E5E9B3677179B2,11801,16,17,1,42,48,2148
40576,40576,F5CAB8F803ECE6BB91E5E9B3677179B2,43161,18,20,2,35,47,1797
40577,40577,F5CAB8F803ECE6BB91E5E9B3677179B2,10111,20,23,3,37,47,1897
40578,40578,D157376C3B3C86905830B8BD99123913,11151,0,1,1,30,48,1548
40579,40579,D157376C3B3C86905830B8BD99123913,11861,2,17,15,32,47,1647
40580,40580,D157376C3B3C86905830B8BD99123913,11941,21,23,2,37,46,1896
40584,40584,D5D027DEC2E15CD439B6E37A42DFD8C1,12921,1,6,5,9,41,491
40585,40585,D5D027DEC2E15CD439B6E37A42DFD8C1,43021,8,18,10,16,43,843
40586,40586,D5D027DEC2E15CD439B6E37A42DFD8C1,12921,19,20,1,9,41,491
40590,40590,CA601ED32D4DA950EA12F7A37DA37141,12221,0,7,7,43,44,2194
40591,40591,CA601ED32D4DA950EA12F7A37DA37141,10471,8,18,10,37,48,1898
40592,40592,CA601ED32D4DA950EA12F7A37DA37141,12221,22,23,1,43,44,2194
40593,40593,DD7B8197066D2FDE311E6AE8E9360BB8,11381,2,3,1,30,47,1547
40594,40594,DD7B8197066D2FDE311E6AE8E9360BB8,43971,3,4,1,30,48,1548
40595,40595,DD7B8197066D2FDE311E6AE8E9360BB8,11381,5,6,1,30,47,1547
40596,40596,DD7B8197066D2FDE311E6AE8E9360BB8,13941,7,8,1,41,47,2097
40597,40597,DD7B8197066D2FDE311E6AE8E9360BB8,43971,15,16,1,30,48,1548
40598,40598,DD7B8197066D2FDE311E6AE8E9360BB8,11381,18,22,4,30,47,1547
40603,40603,B2F573AB6CB53B22A8C175BCAB9447CF,42981,0,13,13,36,49,1849
40604,40604,B2F573AB6CB53B22A8C175BCAB9447CF,40341,14,18,4,23,49,1199
40605,40605,B2F573AB6CB53B22A8C175BCAB9447CF,11021,19,21,2,36,49,1849
40606,40606,6BE5843499E6CFED477D0164702947CD,42261,6,8,2,25,49,1299
40607,40607,6BE5843499E6CFED477D0164702947CD,10951,11,13,2,29,48,1498
40608,40608,6BE5843499E6CFED477D0164702947CD,11151,17,19,2,30,48,1548
40612,40612,87B1169D5A9BB025C6A10231CEED2118,19621,1,7,6,5,46,296
40613,40613,87B1169D5A9BB025C6A10231CEED2118,11861,12,15,3,32,47,1647
40614,40614,87B1169D5A9BB025C6A10231CEED2118,11261,15,17,2,36,46,1846
40615,40615,87B1169D5A9BB025C6A10231CEED2118,11861,20,21,1,32,47,1647
40616,40616,F8584A5277683398A2423E9367C858A2,13941,0,7,7,41,47,2097
40617,40617,F8584A5277683398A2423E9367C858A2,19744,10,14,4,6,43,343
40618,40618,F8584A5277683398A2423E9367C858A2,11481,16,20,4,41,48,2098
40622,40622,85D152F1897A63243F91575C7A5903E5,11261,7,8,1,36,46,1846
40623,40623,85D152F1897A63243F91575C7A5903E5,13141,11,16,5,23,30,1180
40624,40624,85D152F1897A63243F91575C7A5903E5,11151,20,22,2,30,48,1548
40625,40625,2FC430E1448F290A8E229F5C2301E320,49201,3,4,1,7,41,391
40626,40626,2FC430E1448F290A8E229F5C2301E320,12641,4,7,3,10,43,543
40627,40627,2FC430E1448F290A8E229F5C2301E320,49201,8,23,15,7,41,391
40631,40631,56A58223BD482E883505738AA5DC8224,15191,1,7,6,36,27,1827
40632,40632,56A58223BD482E883505738AA5DC8224,12611,7,9,2,41,29,2079
40633,40633,56A58223BD482E883505738AA5DC8224,15653,11,17,6,40,25,2025
40634,40634,56A58223BD482E883505738AA5DC8224,11631,19,21,2,12,49,649
40639,40639,11C5ACA60B0246DE7069023057E8285F,11381,0,1,1,30,47,1547
40640,40640,11C5ACA60B0246DE7069023057E8285F,11061,3,7,4,29,48,1498
40641,40641,11C5ACA60B0246DE7069023057E8285F,11381,8,12,4,30,47,1547
40642,40642,11C5ACA60B0246DE7069023057E8285F,11061,12,19,7,29,48,1498
40643,40643,11C5ACA60B0246DE7069023057E8285F,10661,20,21,1,37,49,1899
40644,40644,11C5ACA60B0246DE7069023057E8285F,11061,22,23,1,29,48,1498
40657,40657,E9C5D67F82A2CCBA27E905D3F4A2B0C8,10221,0,8,8,34,49,1749
40658,40658,E9C5D67F82A2CCBA27E905D3F4A2B0C8,43161,8,9,1,35,47,1797
40659,40659,E9C5D67F82A2CCBA27E905D3F4A2B0C8,11771,13,19,6,39,49,1999
40660,40660,E9C5D67F82A2CCBA27E905D3F4A2B0C8,10221,20,23,3,34,49,1749
40661,40661,135EF939D99CED11694D71795A5772B0,19031,0,6,6,1,42,92
40662,40662,135EF939D99CED11694D71795A5772B0,12641,7,10,3,10,43,543
40663,40663,135EF939D99CED11694D71795A5772B0,19031,10,13,3,1,42,92
40664,40664,135EF939D99CED11694D71795A5772B0,12641,14,19,5,10,43,543
40665,40665,135EF939D99CED11694D71795A5772B0,19031,20,23,3,1,42,92
40666,40666,EA2FF49AFA8BAE81E231360D1149B249,42351,0,12,12,38,45,1945
40667,40667,EA2FF49AFA8BAE81E231360D1149B249,42864,14,15,1,38,44,1944
40668,40668,EA2FF49AFA8BAE81E231360D1149B249,11261,15,17,2,36,46,1846
40669,40669,EA2FF49AFA8BAE81E231360D1149B249,42351,19,20,1,38,45,1945
40670,40670,EA2FF49AFA8BAE81E231360D1149B249,10811,21,23,2,38,46,1946
40671,40671,DB5F58C0BF92D33E406DDC1B3C9B82ED,10161,0,6,6,35,49,1799
40672,40672,DB5F58C0BF92D33E406DDC1B3C9B82ED,10716,8,16,8,30,46,1546
40673,40673,DB5F58C0BF92D33E406DDC1B3C9B82ED,12381,18,20,2,32,48,1648
40674,40674,DB5F58C0BF92D33E406DDC1B3C9B82ED,10161,22,23,1,35,49,1799
40679,40679,D60685B98D8546585712AA6524505875,10951,0,4,4,29,48,1498
40680,40680,D60685B98D8546585712AA6524505875,11381,4,11,7,30,47,1547
40681,40681,D60685B98D8546585712AA6524505875,11201,16,19,3,35,49,1799
40682,40682,31100BE8BDE5B74B2D64B60F8888BAE5,10111,0,7,7,37,47,1897
40683,40683,31100BE8BDE5B74B2D64B60F8888BAE5,40637,9,10,1,36,47,1847
40684,40684,31100BE8BDE5B74B2D64B60F8888BAE5,10111,12,14,2,37,47,1897
40685,40685,31100BE8BDE5B74B2D64B60F8888BAE5,42401,15,16,1,36,47,1847
40686,40686,31100BE8BDE5B74B2D64B60F8888BAE5,10111,18,23,5,37,47,1897
40708,40708,9397083C419903E30A62F5C06D299D5C,42381,0,5,5,39,41,1991
40709,40709,9397083C419903E30A62F5C06D299D5C,43451,9,11,2,37,40,1890
40710,40710,9397083C419903E30A62F5C06D299D5C,42381,12,13,1,39,41,1991
40711,40711,9397083C419903E30A62F5C06D299D5C,43451,14,17,3,37,40,1890
40712,40712,9397083C419903E30A62F5C06D299D5C,42381,20,22,2,39,41,1991
40713,40713,D1B198FBEC3C8F15FED9970CD6DFF591,43451,8,16,8,37,40,1890
40714,40714,D1B198FBEC3C8F15FED9970CD6DFF591,13071,18,19,1,41,41,2091
40715,40715,D1B198FBEC3C8F15FED9970CD6DFF591,42151,21,23,2,35,45,1795
40716,40716,CADE9ADEC7B1B2F6454293174DEADF86,10681,0,7,7,30,48,1548
40717,40717,CADE9ADEC7B1B2F6454293174DEADF86,11021,8,10,2,36,49,1849
40718,40718,CADE9ADEC7B1B2F6454293174DEADF86,11151,10,23,13,30,48,1548
40729,40729,0A847938A95E9AA56A665AF0FA42CC38,11861,0,1,1,32,47,1647
40730,40730,0A847938A95E9AA56A665AF0FA42CC38,42021,5,9,4,33,47,1697
40731,40731,0A847938A95E9AA56A665AF0FA42CC38,11861,10,14,4,32,47,1647
40732,40732,0A847938A95E9AA56A665AF0FA42CC38,40691,18,19,1,42,48,2148
40733,40733,683193FAC39A23EAB0A08DD88DB175F9,42121,0,6,6,26,49,1349
40734,40734,683193FAC39A23EAB0A08DD88DB175F9,11281,8,20,12,27,40,1390
40735,40735,683193FAC39A23EAB0A08DD88DB175F9,13671,22,23,1,27,43,1393
40736,40736,4BEB96C1A6F8B99181CDADEF48D75275,42501,0,6,6,28,47,1447
40737,40737,4BEB96C1A6F8B99181CDADEF48D75275,42081,6,18,12,24,49,1249
40738,40738,4BEB96C1A6F8B99181CDADEF48D75275,42501,21,23,2,28,47,1447
40739,40739,A53DAA006542212C0F792E33874BF547,42161,0,6,6,36,47,1847
40740,40740,A53DAA006542212C0F792E33874BF547,42801,8,17,9,40,49,2049
40741,40741,A53DAA006542212C0F792E33874BF547,10251,17,20,3,35,47,1797
40742,40742,BCCA36AC6DE92B5D284204C1D312B82A,10971,0,7,7,35,47,1797
40743,40743,BCCA36AC6DE92B5D284204C1D312B82A,11551,10,17,7,39,49,1999
40744,40744,BCCA36AC6DE92B5D284204C1D312B82A,10781,18,23,5,35,47,1797
40745,40745,4B0BD3168EF9CD1D084101907AF5A694,13121,0,7,7,38,46,1946
40746,40746,4B0BD3168EF9CD1D084101907AF5A694,43241,7,8,1,36,46,1846
40747,40747,4B0BD3168EF9CD1D084101907AF5A694,13121,10,15,5,38,46,1946
40748,40748,4B0BD3168EF9CD1D084101907AF5A694,43241,15,20,5,36,46,1846
40749,40749,4B0BD3168EF9CD1D084101907AF5A694,13121,22,23,1,38,46,1946
40754,40754,7C7C7763ADA0CC64FB88CC4AF6EE7D4D,11921,0,7,7,38,48,1948
40755,40755,7C7C7763ADA0CC64FB88CC4AF6EE7D4D,11074,9,16,7,37,47,1897
40756,40756,7C7C7763ADA0CC64FB88CC4AF6EE7D4D,11921,19,21,2,38,48,1948
40757,40757,7C7C7763ADA0CC64FB88CC4AF6EE7D4D,13791,22,23,1,42,47,2147
40758,40758,2F1F7798F5E8889B4080CA59D71F0274,10271,5,6,1,37,46,1896
40759,40759,2F1F7798F5E8889B4080CA59D71F0274,11081,7,10,3,35,46,1796
40760,40760,2F1F7798F5E8889B4080CA59D71F0274,10271,12,13,1,37,46,1896
40761,40761,2F1F7798F5E8889B4080CA59D71F0274,13711,14,17,3,38,46,1946
40762,40762,2F1F7798F5E8889B4080CA59D71F0274,10271,19,21,2,37,46,1896
40772,40772,7F0F7E01EE512C1A933F7133254355CA,43021,1,5,4,16,43,843
40773,40773,7F0F7E01EE512C1A933F7133254355CA,12921,6,19,13,9,41,491
40774,40774,7F0F7E01EE512C1A933F7133254355CA,19901,21,23,2,7,44,394
40775,40775,5F59FDA04080FD89C696AFDB5CAE088C,10431,1,11,10,33,49,1699
40776,40776,5F59FDA04080FD89C696AFDB5CAE088C,12971,12,13,1,32,48,1648
40777,40777,5F59FDA04080FD89C696AFDB5CAE088C,10921,15,18,3,43,48,2198
40778,40778,5F59FDA04080FD89C696AFDB5CAE088C,11741,18,19,1,42,49,2149
40779,40779,5F59FDA04080FD89C696AFDB5CAE088C,11201,21,22,1,35,49,1799
40783,40783,DFE0075BA441F09CC854C6FA18C2E9B5,43971,0,9,9,30,48,1548
40784,40784,DFE0075BA441F09CC854C6FA18C2E9B5,42521,12,13,1,31,47,1597
40785,40785,DFE0075BA441F09CC854C6FA18C2E9B5,19621,15,16,1,5,46,296
40786,40786,DFE0075BA441F09CC854C6FA18C2E9B5,11161,18,23,5,32,48,1648
40790,40790,726D8BF6FE9D2B730CE8E7DD26F779CD,10491,0,13,13,33,48,1698
40791,40791,726D8BF6FE9D2B730CE8E7DD26F779CD,12121,13,15,2,29,47,1497
40792,40792,726D8BF6FE9D2B730CE8E7DD26F779CD,11381,15,17,2,30,47,1547
40793,40793,726D8BF6FE9D2B730CE8E7DD26F779CD,12121,19,21,2,29,47,1497
40794,40794,00AF64C30DD1AF7B063E67637E648889,43241,0,5,5,36,46,1846
40795,40795,00AF64C30DD1AF7B063E67637E648889,12221,9,11,2,43,44,2194
40796,40796,00AF64C30DD1AF7B063E67637E648889,10271,12,22,10,37,46,1896
40797,40797,B16AADC70667F1407A8020F9E0E0F89A,11921,0,4,4,38,48,1948
40798,40798,B16AADC70667F1407A8020F9E0E0F89A,43761,5,17,12,32,47,1647
40799,40799,B16AADC70667F1407A8020F9E0E0F89A,11921,18,23,5,38,48,1948
40800,40800,0601C1762592A99CA3F0778FC011A2CE,10601,1,4,3,39,47,1997
40801,40801,0601C1762592A99CA3F0778FC011A2CE,13331,5,7,2,38,47,1947
40802,40802,0601C1762592A99CA3F0778FC011A2CE,10601,9,10,1,39,47,1997
40803,40803,0601C1762592A99CA3F0778FC011A2CE,10841,16,17,1,37,47,1897
40804,40804,0601C1762592A99CA3F0778FC011A2CE,10601,20,22,2,39,47,1997
40805,40805,B3B2A62E38CBAF40B040383E801282C5,43751,0,11,11,19,48,998
40806,40806,B3B2A62E38CBAF40B040383E801282C5,11521,16,17,1,41,48,2098
40807,40807,B3B2A62E38CBAF40B040383E801282C5,11021,18,19,1,36,49,1849
40808,40808,B3B2A62E38CBAF40B040383E801282C5,12131,20,21,1,32,47,1647
40809,40809,F1249E9F0C0E4CFC8DF3A999C283E2E8,42791,0,7,7,35,45,1795
40810,40810,F1249E9F0C0E4CFC8DF3A999C283E2E8,10351,10,11,1,28,45,1445
40811,40811,F1249E9F0C0E4CFC8DF3A999C283E2E8,10634,15,18,3,27,45,1395
40812,40812,F1249E9F0C0E4CFC8DF3A999C283E2E8,42791,19,23,4,35,45,1795
40816,40816,878C5910D8B33E157EC121F0E7A41043,10971,0,1,1,35,47,1797
40817,40817,878C5910D8B33E157EC121F0E7A41043,43761,2,12,10,32,47,1647
40818,40818,878C5910D8B33E157EC121F0E7A41043,42021,13,15,2,33,47,1697
40819,40819,878C5910D8B33E157EC121F0E7A41043,10251,16,18,2,35,47,1797
40820,40820,878C5910D8B33E157EC121F0E7A41043,42021,19,23,4,33,47,1697
40821,40821,8EC6592A5302140A9CA2CC55F2BCF8B9,42201,0,7,7,43,46,2196
40822,40822,8EC6592A5302140A9CA2CC55F2BCF8B9,10971,16,17,1,35,47,1797
40823,40823,8EC6592A5302140A9CA2CC55F2BCF8B9,13951,18,20,2,47,45,2395
40824,40824,8EC6592A5302140A9CA2CC55F2BCF8B9,42201,22,23,1,43,46,2196
40825,40825,398D623EE0B3940964CA145E6AB47FBB,12481,2,9,7,37,49,1899
40826,40826,398D623EE0B3940964CA145E6AB47FBB,10221,12,13,1,34,49,1749
40827,40827,398D623EE0B3940964CA145E6AB47FBB,42521,15,16,1,31,47,1597
40828,40828,398D623EE0B3940964CA145E6AB47FBB,10107,17,18,1,38,49,1949
40829,40829,398D623EE0B3940964CA145E6AB47FBB,12021,19,21,2,37,49,1899
40830,40830,0DBEF203AA481B6A712DEA8847EB17DA,42851,0,11,11,35,41,1791
40831,40831,0DBEF203AA481B6A712DEA8847EB17DA,11331,12,13,1,37,48,1898
40832,40832,0DBEF203AA481B6A712DEA8847EB17DA,11231,18,20,2,37,49,1899
40833,40833,33DCEB99733F5490EC3E4641096F98E9,10601,2,7,5,39,47,1997
40834,40834,33DCEB99733F5490EC3E4641096F98E9,42861,12,14,2,37,44,1894
40835,40835,33DCEB99733F5490EC3E4641096F98E9,13121,18,21,3,38,46,1946
40836,40836,33DCEB99733F5490EC3E4641096F98E9,13101,21,23,2,40,47,2047
40837,40837,86D79D690C2F1F8AD0DA3D3F5AF4C54F,10521,1,6,5,41,47,2097
40838,40838,86D79D690C2F1F8AD0DA3D3F5AF4C54F,12491,10,12,2,36,43,1843
40839,40839,86D79D690C2F1F8AD0DA3D3F5AF4C54F,10521,17,23,6,41,47,2097
40850,40850,53B9F7992DB29A9E3000FDBC39A3F0DF,42221,2,3,1,38,48,1948
40851,40851,53B9F7992DB29A9E3000FDBC39A3F0DF,11074,5,7,2,37,47,1897
40852,40852,53B9F7992DB29A9E3000FDBC39A3F0DF,42271,7,9,2,40,47,2047
40853,40853,53B9F7992DB29A9E3000FDBC39A3F0DF,13381,12,15,3,39,47,1997
40854,40854,53B9F7992DB29A9E3000FDBC39A3F0DF,11074,19,20,1,37,47,1897
40855,40855,53B9F7992DB29A9E3000FDBC39A3F0DF,42271,22,23,1,40,47,2047
40856,40856,84E08947B80CC1BEFD5E320727C2FA39,11914,0,9,9,37,48,1898
40857,40857,84E08947B80CC1BEFD5E320727C2FA39,11151,13,14,1,30,48,1548
40858,40858,84E08947B80CC1BEFD5E320727C2FA39,11914,16,23,7,37,48,1898
40859,40859,085E6CB86740D18887476259D4B92672,43951,0,12,12,49,41,2491
40860,40860,085E6CB86740D18887476259D4B92672,40341,14,17,3,23,49,1199
40861,40861,085E6CB86740D18887476259D4B92672,43951,19,23,4,49,41,2491
40862,40862,DAF070E37522449552E837969D087804,10491,0,6,6,33,48,1698
40863,40863,DAF070E37522449552E837969D087804,40171,7,8,1,38,48,1948
40864,40864,DAF070E37522449552E837969D087804,11331,11,17,6,37,48,1898
40865,40865,DAF070E37522449552E837969D087804,10491,19,23,4,33,48,1698
40869,40869,7EFF4C1F410EC0093C0E819DD0DC2E31,10471,0,1,1,37,48,1898
40870,40870,7EFF4C1F410EC0093C0E819DD0DC2E31,42581,2,9,7,38,48,1948
40871,40871,7EFF4C1F410EC0093C0E819DD0DC2E31,10471,9,11,2,37,48,1898
40872,40872,7EFF4C1F410EC0093C0E819DD0DC2E31,42581,11,12,1,38,48,1948
40873,40873,7EFF4C1F410EC0093C0E819DD0DC2E31,10471,13,23,10,37,48,1898
40874,40874,3AE9C3B6C0E6A8AA6B3B6C58033F1358,13371,0,7,7,41,47,2097
40875,40875,3AE9C3B6C0E6A8AA6B3B6C58033F1358,10601,7,9,2,39,47,1997
40876,40876,3AE9C3B6C0E6A8AA6B3B6C58033F1358,11021,10,17,7,36,49,1849
40877,40877,3AE9C3B6C0E6A8AA6B3B6C58033F1358,13941,19,23,4,41,47,2097
40878,40878,826B40817E61853148AFBFECB1C48C70,42864,2,3,1,38,44,1944
40879,40879,826B40817E61853148AFBFECB1C48C70,42861,6,11,5,37,44,1894
40880,40880,826B40817E61853148AFBFECB1C48C70,42864,12,13,1,38,44,1944
40881,40881,826B40817E61853148AFBFECB1C48C70,42861,13,18,5,37,44,1894
40882,40882,826B40817E61853148AFBFECB1C48C70,11261,18,23,5,36,46,1846
40886,40886,BB0E31CCB78E9544800905BA3D455370,42623,8,9,1,22,49,1149
40887,40887,BB0E31CCB78E9544800905BA3D455370,42071,10,11,1,31,49,1599
40888,40888,BB0E31CCB78E9544800905BA3D455370,40341,11,14,3,23,49,1199
40889,40889,BB0E31CCB78E9544800905BA3D455370,42071,15,19,4,31,49,1599
40890,40890,BB0E31CCB78E9544800905BA3D455370,42121,21,22,1,26,49,1349
40891,40891,57FD3DF72D56B8959DFC5BC07AB7A02C,43061,0,7,7,43,46,2196
40892,40892,57FD3DF72D56B8959DFC5BC07AB7A02C,10971,11,18,7,35,47,1797
40893,40893,57FD3DF72D56B8959DFC5BC07AB7A02C,43061,19,23,4,43,46,2196
40901,40901,3CD92C1587FA0BBA7305FC70788C8C0D,43011,1,6,5,40,42,2042
40902,40902,3CD92C1587FA0BBA7305FC70788C8C0D,42351,6,20,14,38,45,1945
40903,40903,3CD92C1587FA0BBA7305FC70788C8C0D,12561,21,23,2,45,43,2293
40908,40908,7649F52C89D1670662DA3962910D6645,13011,0,6,6,39,47,1997
40909,40909,7649F52C89D1670662DA3962910D6645,42531,7,17,10,31,45,1595
40910,40910,7649F52C89D1670662DA3962910D6645,13011,21,23,2,39,47,1997
40911,40911,167F0AD4C372262B104F1E644C482559,43731,0,7,7,34,47,1747
40912,40912,167F0AD4C372262B104F1E644C482559,13121,10,11,1,38,46,1946
40913,40913,167F0AD4C372262B104F1E644C482559,42511,13,14,1,37,47,1897
40914,40914,167F0AD4C372262B104F1E644C482559,11541,18,21,3,35,49,1799
40915,40915,167F0AD4C372262B104F1E644C482559,12083,21,23,2,36,49,1849
40916,40916,44EC2B0D5EE5BD6B35ABC292F1B0BE4A,19901,1,6,5,7,44,394
40917,40917,44EC2B0D5EE5BD6B35ABC292F1B0BE4A,11381,7,10,3,30,47,1547
40918,40918,44EC2B0D5EE5BD6B35ABC292F1B0BE4A,12921,15,21,6,9,41,491
40923,40923,AD7C29E6E6B36CB21D8F3CF245254E21,11021,0,7,7,36,49,1849
40924,40924,AD7C29E6E6B36CB21D8F3CF245254E21,11491,12,15,3,36,47,1847
40925,40925,AD7C29E6E6B36CB21D8F3CF245254E21,16233,17,21,4,5,15,265
40926,40926,42F48035574F3655EC5C23A87BD7E10A,43391,0,8,8,29,48,1498
40927,40927,42F48035574F3655EC5C23A87BD7E10A,11151,8,10,2,30,48,1548
40928,40928,42F48035574F3655EC5C23A87BD7E10A,43391,12,14,2,29,48,1498
40929,40929,42F48035574F3655EC5C23A87BD7E10A,11151,16,17,1,30,48,1548
40930,40930,42F48035574F3655EC5C23A87BD7E10A,43391,18,22,4,29,48,1498
40931,40931,B07F9654999A27B565B093B7A4D6A968,11661,0,8,8,40,49,2049
40932,40932,B07F9654999A27B565B093B7A4D6A968,43161,12,14,2,35,47,1797
40933,40933,B07F9654999A27B565B093B7A4D6A968,42981,15,16,1,36,49,1849
40934,40934,B07F9654999A27B565B093B7A4D6A968,42511,19,20,1,37,47,1897
40935,40935,B07F9654999A27B565B093B7A4D6A968,11661,21,23,2,40,49,2049
40936,40936,F2229754FABF7F398D6839D6208AC86F,10544,0,7,7,28,48,1448
40937,40937,F2229754FABF7F398D6839D6208AC86F,10951,10,11,1,29,48,1498
40938,40938,F2229754FABF7F398D6839D6208AC86F,10544,12,14,2,28,48,1448
40939,40939,F2229754FABF7F398D6839D6208AC86F,10381,16,17,1,31,49,1599
40940,40940,F2229754FABF7F398D6839D6208AC86F,10544,21,23,2,28,48,1448
40941,40941,720E0747D5CFEEA7ABCF987512B0DAB4,40271,8,15,7,35,49,1799
40942,40942,720E0747D5CFEEA7ABCF987512B0DAB4,42031,17,19,2,40,46,2046
40943,40943,720E0747D5CFEEA7ABCF987512B0DAB4,42471,20,22,2,35,49,1799
40944,40944,9E85C057C1073FB1AC026E9446459498,19356,0,2,2,7,19,369
40945,40945,9E85C057C1073FB1AC026E9446459498,15641,2,4,2,9,21,471
40946,40946,9E85C057C1073FB1AC026E9446459498,19356,4,8,4,7,19,369
40947,40947,9E85C057C1073FB1AC026E9446459498,15641,11,15,4,9,21,471
40948,40948,9E85C057C1073FB1AC026E9446459498,11331,20,22,2,37,48,1898
40952,40952,57068447BEEE4D7969FF166D57966ECA,42541,0,6,6,25,47,1297
40953,40953,57068447BEEE4D7969FF166D57966ECA,12581,7,8,1,24,48,1248
40954,40954,57068447BEEE4D7969FF166D57966ECA,11361,13,15,2,22,48,1148
40955,40955,57068447BEEE4D7969FF166D57966ECA,10171,18,19,1,26,47,1347
40956,40956,57068447BEEE4D7969FF166D57966ECA,10501,21,22,1,22,46,1146
40957,40957,66E04FE458E7F0A691F219A1307BA20F,19441,0,6,6,8,46,446
40958,40958,66E04FE458E7F0A691F219A1307BA20F,11361,7,13,6,22,48,1148
40959,40959,66E04FE458E7F0A691F219A1307BA20F,43751,15,16,1,19,48,998
40960,40960,66E04FE458E7F0A691F219A1307BA20F,10951,21,22,1,29,48,1498
40961,40961,29ED7585A7C0FD6B2E71E72A2B2372DE,42531,0,6,6,31,45,1595
40962,40962,29ED7585A7C0FD6B2E71E72A2B2372DE,11491,9,18,9,36,47,1847
40963,40963,29ED7585A7C0FD6B2E71E72A2B2372DE,42531,21,22,1,31,45,1595
40964,40964,1BF34E4F000698DC8774DA1D8EF6C8C5,10971,10,18,8,35,47,1797
40965,40965,1BF34E4F000698DC8774DA1D8EF6C8C5,42191,19,20,1,38,49,1949
40966,40966,1BF34E4F000698DC8774DA1D8EF6C8C5,40171,21,23,2,38,48,1948
40970,40970,78520B675436202D640A52F7BAC3D2C7,12792,2,7,5,34,30,1730
40971,40971,78520B675436202D640A52F7BAC3D2C7,43081,10,12,2,27,28,1378
40972,40972,78520B675436202D640A52F7BAC3D2C7,12792,12,19,7,34,30,1730
40973,40973,C349AE9F224607E9AD4C9E2821659C73,13371,0,9,9,41,47,2097
40974,40974,C349AE9F224607E9AD4C9E2821659C73,10292,11,13,2,30,47,1547
40975,40975,C349AE9F224607E9AD4C9E2821659C73,13371,15,23,8,41,47,2097
40976,40976,4AAE6C9D4DFBCB791FACE24CA979FA54,13371,0,10,10,41,47,2097
40977,40977,4AAE6C9D4DFBCB791FACE24CA979FA54,43731,12,14,2,34,47,1747
40978,40978,4AAE6C9D4DFBCB791FACE24CA979FA54,40401,14,16,2,40,46,2046
40979,40979,4AAE6C9D4DFBCB791FACE24CA979FA54,11151,20,21,1,30,48,1548
40983,40983,84E097DF782FE990259E1DE5027828BD,13371,0,3,3,41,47,2097
40984,40984,84E097DF782FE990259E1DE5027828BD,11481,3,6,3,41,48,2098
40985,40985,84E097DF782FE990259E1DE5027828BD,13371,6,7,1,41,47,2097
40986,40986,84E097DF782FE990259E1DE5027828BD,40201,9,15,6,32,49,1649
40987,40987,84E097DF782FE990259E1DE5027828BD,13371,18,23,5,41,47,2097
40991,40991,0DD480B5A13E261C7A404CA1C7C938C6,42511,0,6,6,37,47,1897
40992,40992,0DD480B5A13E261C7A404CA1C7C938C6,13121,8,15,7,38,46,1946
40993,40993,0DD480B5A13E261C7A404CA1C7C938C6,42511,17,18,1,37,47,1897
40994,40994,0DD480B5A13E261C7A404CA1C7C938C6,10921,21,22,1,43,48,2198
40995,40995,1BABC9D2139583D8D5A8610AD83945FA,16281,0,7,7,11,4,554
40996,40996,1BABC9D2139583D8D5A8610AD83945FA,15051,7,11,4,19,4,954
40997,40997,1BABC9D2139583D8D5A8610AD83945FA,16281,11,21,10,11,4,554
41001,41001,A5A090591E63A367211B3058D6F881BC,43021,0,6,6,16,43,843
41002,41002,A5A090591E63A367211B3058D6F881BC,12921,6,8,2,9,41,491
41003,41003,A5A090591E63A367211B3058D6F881BC,43021,9,13,4,16,43,843
41004,41004,A5A090591E63A367211B3058D6F881BC,12921,13,15,2,9,41,491
41005,41005,A5A090591E63A367211B3058D6F881BC,43021,15,18,3,16,43,843
41006,41006,A5A090591E63A367211B3058D6F881BC,12921,19,21,2,9,41,491
41010,41010,D227D6EA815AD3E534730A42BDF45066,42631,0,7,7,43,45,2195
41011,41011,D227D6EA815AD3E534730A42BDF45066,13411,11,13,2,49,42,2492
41012,41012,D227D6EA815AD3E534730A42BDF45066,43951,15,16,1,49,41,2491
41013,41013,D227D6EA815AD3E534730A42BDF45066,42631,20,23,3,43,45,2195
41014,41014,E311A49FD79CE1E67702DBA9B7887B92,12641,0,6,6,10,43,543
41015,41015,E311A49FD79CE1E67702DBA9B7887B92,19021,6,8,2,10,45,545
41016,41016,E311A49FD79CE1E67702DBA9B7887B92,43021,8,11,3,16,43,843
41017,41017,E311A49FD79CE1E67702DBA9B7887B92,19021,13,22,9,10,45,545
41027,41027,4EBD15EE0952C12400DA8CFC8BED060C,10107,10,13,3,38,49,1949
41028,41028,4EBD15EE0952C12400DA8CFC8BED060C,13601,14,16,2,34,47,1747
41029,41029,4EBD15EE0952C12400DA8CFC8BED060C,10107,19,21,2,38,49,1949
41030,41030,4EBD15EE0952C12400DA8CFC8BED060C,42301,22,23,1,36,47,1847
41035,41035,9A5D80901504211B25011A66A0C236FE,43731,0,12,12,34,47,1747
41036,41036,9A5D80901504211B25011A66A0C236FE,42161,15,16,1,36,47,1847
41037,41037,9A5D80901504211B25011A66A0C236FE,42501,21,23,2,28,47,1447
41038,41038,65161D8F8A2EE0E4F87D9472311EE576,12514,0,3,3,38,47,1947
41039,41039,65161D8F8A2EE0E4F87D9472311EE576,10841,3,9,6,37,47,1897
41040,41040,65161D8F8A2EE0E4F87D9472311EE576,10271,10,12,2,37,46,1896
41041,41041,65161D8F8A2EE0E4F87D9472311EE576,12514,12,14,2,38,47,1947
41042,41042,65161D8F8A2EE0E4F87D9472311EE576,10841,14,17,3,37,47,1897
41043,41043,65161D8F8A2EE0E4F87D9472311EE576,12514,18,23,5,38,47,1947
41044,41044,699CA3A48CEA8EA72BCB189971019AED,11731,2,16,14,36,48,1848
41045,41045,699CA3A48CEA8EA72BCB189971019AED,10901,18,19,1,35,48,1798
41046,41046,699CA3A48CEA8EA72BCB189971019AED,11631,21,23,2,12,49,649
41047,41047,FD83EB410155E167A0352D04BF6CE250,11281,0,8,8,27,40,1390
41048,41048,FD83EB410155E167A0352D04BF6CE250,12521,8,11,3,35,41,1791
41049,41049,FD83EB410155E167A0352D04BF6CE250,43481,12,13,1,39,48,1998
41050,41050,FD83EB410155E167A0352D04BF6CE250,11231,17,20,3,37,49,1899
41054,41054,318608EA3FE88544F5C52BCECF823725,11541,0,1,1,35,49,1799
41055,41055,318608EA3FE88544F5C52BCECF823725,11751,2,10,8,35,48,1798
41056,41056,318608EA3FE88544F5C52BCECF823725,41591,12,17,5,34,49,1749
41057,41057,318608EA3FE88544F5C52BCECF823725,42121,19,21,2,26,49,1349
41058,41058,2C985E374948E01B1511C56B4538B456,42861,0,6,6,37,44,1894
41059,41059,2C985E374948E01B1511C56B4538B456,11261,9,10,1,36,46,1846
41060,41060,2C985E374948E01B1511C56B4538B456,42861,11,13,2,37,44,1894
41061,41061,2C985E374948E01B1511C56B4538B456,11261,15,16,1,36,46,1846
41062,41062,2C985E374948E01B1511C56B4538B456,42861,19,23,4,37,44,1894
41063,41063,384928A4B4A1A8204398D69E5619CEC2,43751,0,14,14,19,48,998
41064,41064,384928A4B4A1A8204398D69E5619CEC2,12581,16,18,2,24,48,1248
41065,41065,384928A4B4A1A8204398D69E5619CEC2,43751,18,23,5,19,48,998
41073,41073,6C7DE4B4696563CBDA9D3C6E4FCAB652,10341,0,7,7,31,47,1597
41074,41074,6C7DE4B4696563CBDA9D3C6E4FCAB652,42801,12,16,4,40,49,2049
41075,41075,6C7DE4B4696563CBDA9D3C6E4FCAB652,10292,17,19,2,30,47,1547
41076,41076,6C7DE4B4696563CBDA9D3C6E4FCAB652,42523,19,21,2,31,47,1597
41084,41084,5408DC5B0AFBD23C3FA2E4CCFD3A9C81,42633,0,14,14,42,46,2146
41085,41085,5408DC5B0AFBD23C3FA2E4CCFD3A9C81,11261,14,18,4,36,46,1846
41086,41086,5408DC5B0AFBD23C3FA2E4CCFD3A9C81,42633,20,23,3,42,46,2146
41091,41091,9F4FE5C66D1FE88FA924255DF3CD2B31,11811,0,7,7,38,49,1949
41092,41092,9F4FE5C66D1FE88FA924255DF3CD2B31,13651,9,15,6,30,47,1547
41093,41093,9F4FE5C66D1FE88FA924255DF3CD2B31,12021,20,22,2,37,49,1899
41094,41094,A847C99BCF3FA2F2462B28662C04DEC1,15191,6,10,4,36,27,1827
41095,41095,A847C99BCF3FA2F2462B28662C04DEC1,16281,15,20,5,11,4,554
41096,41096,A847C99BCF3FA2F2462B28662C04DEC1,15143,20,22,2,18,7,907
41101,41101,DF189E83BAB7254002D11C89D4F2D51F,10341,0,6,6,31,47,1597
41102,41102,DF189E83BAB7254002D11C89D4F2D51F,11011,7,8,1,39,49,1999
41103,41103,DF189E83BAB7254002D11C89D4F2D51F,10341,10,17,7,31,47,1597
41104,41104,DF189E83BAB7254002D11C89D4F2D51F,13091,17,19,2,20,42,1042
41105,41105,DF189E83BAB7254002D11C89D4F2D51F,43161,20,21,1,35,47,1797
41106,41106,20538B8C1777892DA77867D1D04B5D49,43761,0,3,3,32,47,1647
41107,41107,20538B8C1777892DA77867D1D04B5D49,11161,3,9,6,32,48,1648
41108,41108,20538B8C1777892DA77867D1D04B5D49,43761,10,12,2,32,47,1647
41109,41109,20538B8C1777892DA77867D1D04B5D49,11161,17,18,1,32,48,1648
41110,41110,20538B8C1777892DA77867D1D04B5D49,43761,19,23,4,32,47,1647
41117,41117,A0726C803D54356D79A20E6BD9BC86DB,10251,0,8,8,35,47,1797
41118,41118,A0726C803D54356D79A20E6BD9BC86DB,10771,8,15,7,41,46,2096
41119,41119,A0726C803D54356D79A20E6BD9BC86DB,10251,19,21,2,35,47,1797
41120,41120,A0726C803D54356D79A20E6BD9BC86DB,10471,22,23,1,37,48,1898
41121,41121,7DC0DA80C6E0F2203C3B9D6C77819B54,19741,0,6,6,5,44,294
41122,41122,7DC0DA80C6E0F2203C3B9D6C77819B54,11381,8,10,2,30,47,1547
41123,41123,7DC0DA80C6E0F2203C3B9D6C77819B54,19741,11,12,1,5,44,294
41124,41124,7DC0DA80C6E0F2203C3B9D6C77819B54,11631,15,23,8,12,49,649
41125,41125,AE08A1E713DAA4F0C24DA0563595B4F9,10211,0,2,2,16,49,849
41126,41126,AE08A1E713DAA4F0C24DA0563595B4F9,11471,5,6,1,12,48,648
41127,41127,AE08A1E713DAA4F0C24DA0563595B4F9,11231,9,12,3,37,49,1899
41128,41128,AE08A1E713DAA4F0C24DA0563595B4F9,19441,14,18,4,8,46,446
41129,41129,AE08A1E713DAA4F0C24DA0563595B4F9,11471,20,21,1,12,48,648
41130,41130,CA7675D4504FF649E5D3C79C1D770D57,10901,0,6,6,35,48,1798
41131,41131,CA7675D4504FF649E5D3C79C1D770D57,11151,6,18,12,30,48,1548
41132,41132,CA7675D4504FF649E5D3C79C1D770D57,10901,18,23,5,35,48,1798
41133,41133,7A3CCBEE1EF7E270B4B301C75856D62F,11861,0,12,12,32,47,1647
41134,41134,7A3CCBEE1EF7E270B4B301C75856D62F,13561,13,15,2,37,49,1899
41135,41135,7A3CCBEE1EF7E270B4B301C75856D62F,11861,18,23,5,32,47,1647
41136,41136,A447A45B90D6E3A14CAE8CC78AAACCC0,11701,0,7,7,43,48,2198
41137,41137,A447A45B90D6E3A14CAE8CC78AAACCC0,19441,9,10,1,8,46,446
41138,41138,A447A45B90D6E3A14CAE8CC78AAACCC0,19021,12,14,2,10,45,545
41139,41139,A447A45B90D6E3A14CAE8CC78AAACCC0,42091,18,19,1,43,46,2196
41140,41140,A447A45B90D6E3A14CAE8CC78AAACCC0,11701,20,21,1,43,48,2198
41141,41141,500C014CBE9399F889081A24DE4A0DB6,42191,0,8,8,38,49,1949
41142,41142,500C014CBE9399F889081A24DE4A0DB6,11921,8,10,2,38,48,1948
41143,41143,500C014CBE9399F889081A24DE4A0DB6,43181,10,14,4,39,48,1998
41144,41144,500C014CBE9399F889081A24DE4A0DB6,11921,14,18,4,38,48,1948
41145,41145,500C014CBE9399F889081A24DE4A0DB6,42191,18,23,5,38,49,1949
41146,41146,79180DDD86B22B2BAEB51E3552560D4E,11381,2,8,6,30,47,1547
41147,41147,79180DDD86B22B2BAEB51E3552560D4E,43761,9,11,2,32,47,1647
41148,41148,79180DDD86B22B2BAEB51E3552560D4E,11161,11,12,1,32,48,1648
41149,41149,79180DDD86B22B2BAEB51E3552560D4E,11381,17,19,2,30,47,1547
41150,41150,79180DDD86B22B2BAEB51E3552560D4E,10341,19,21,2,31,47,1597
41154,41154,800FED50F2F7737DBE05BF1B7626336F,12121,0,12,12,29,47,1497
41155,41155,800FED50F2F7737DBE05BF1B7626336F,12481,14,15,1,37,49,1899
41156,41156,800FED50F2F7737DBE05BF1B7626336F,12121,17,18,1,29,47,1497
41157,41157,800FED50F2F7737DBE05BF1B7626336F,11631,19,22,3,12,49,649
41158,41158,4C4BFC6596FD3FEC2B91BC1C914BF8BF,10221,0,2,2,34,49,1749
41159,41159,4C4BFC6596FD3FEC2B91BC1C914BF8BF,13511,2,3,1,34,48,1748
41160,41160,4C4BFC6596FD3FEC2B91BC1C914BF8BF,10221,4,5,1,34,49,1749
41161,41161,4C4BFC6596FD3FEC2B91BC1C914BF8BF,10881,7,11,4,34,48,1748
41162,41162,4C4BFC6596FD3FEC2B91BC1C914BF8BF,12871,13,15,2,22,33,1133
41163,41163,4C4BFC6596FD3FEC2B91BC1C914BF8BF,19281,15,17,2,16,32,832
41164,41164,4C4BFC6596FD3FEC2B91BC1C914BF8BF,12871,20,23,3,22,33,1133
41165,41165,39E8EC68B5351FA08172ACDD9F93F15C,15431,1,4,3,46,15,2315
41166,41166,39E8EC68B5351FA08172ACDD9F93F15C,15381,9,13,4,19,21,971
41167,41167,39E8EC68B5351FA08172ACDD9F93F15C,10971,18,23,5,35,47,1797
41168,41168,EC861FE21AFD755213652562865FFBF9,43101,0,3,3,46,40,2340
41169,41169,EC861FE21AFD755213652562865FFBF9,13551,4,6,2,45,38,2288
41170,41170,EC861FE21AFD755213652562865FFBF9,43101,6,18,12,46,40,2340
41171,41171,EC861FE21AFD755213652562865FFBF9,13071,19,20,1,41,41,2091
41172,41172,88182B8F0A08A7B6CD3790FE87C79F47,42351,0,7,7,38,45,1945
41173,41173,88182B8F0A08A7B6CD3790FE87C79F47,42231,8,9,1,37,46,1896
41174,41174,88182B8F0A08A7B6CD3790FE87C79F47,42351,10,12,2,38,45,1945
41175,41175,88182B8F0A08A7B6CD3790FE87C79F47,42231,16,21,5,37,46,1896
41176,41176,88182B8F0A08A7B6CD3790FE87C79F47,42351,22,23,1,38,45,1945
41177,41177,846C85CD309BB53F7D267BCD4A6ADE5D,15391,1,13,12,35,26,1776
41178,41178,846C85CD309BB53F7D267BCD4A6ADE5D,12792,13,14,1,34,30,1730
41179,41179,846C85CD309BB53F7D267BCD4A6ADE5D,15391,14,16,2,35,26,1776
41180,41180,846C85CD309BB53F7D267BCD4A6ADE5D,12792,19,21,2,34,30,1730
41190,41190,566A98F570A1628E8F6EFD9CFCC9370E,12491,0,1,1,36,43,1843
41191,41191,566A98F570A1628E8F6EFD9CFCC9370E,12661,1,2,1,32,45,1645
41192,41192,566A98F570A1628E8F6EFD9CFCC9370E,12491,3,6,3,36,43,1843
41193,41193,566A98F570A1628E8F6EFD9CFCC9370E,12661,8,9,1,32,45,1645
41194,41194,566A98F570A1628E8F6EFD9CFCC9370E,12491,9,17,8,36,43,1843
41195,41195,566A98F570A1628E8F6EFD9CFCC9370E,12661,19,20,1,32,45,1645
41199,41199,0722208BA05F2FA64560C4BADA491D8E,11381,0,4,4,30,47,1547
41200,41200,0722208BA05F2FA64560C4BADA491D8E,12121,5,6,1,29,47,1497
41201,41201,0722208BA05F2FA64560C4BADA491D8E,11381,9,10,1,30,47,1547
41202,41202,0722208BA05F2FA64560C4BADA491D8E,43761,11,12,1,32,47,1647
41203,41203,0722208BA05F2FA64560C4BADA491D8E,10292,13,17,4,30,47,1547
41204,41204,0722208BA05F2FA64560C4BADA491D8E,12121,19,21,2,29,47,1497
41208,41208,27B6DDFE3A356062F221ABD7AD70BB14,11061,0,6,6,29,48,1498
41209,41209,27B6DDFE3A356062F221ABD7AD70BB14,10681,7,11,4,30,48,1548
41210,41210,27B6DDFE3A356062F221ABD7AD70BB14,11061,11,14,3,29,48,1498
41211,41211,27B6DDFE3A356062F221ABD7AD70BB14,10681,14,15,1,30,48,1548
41212,41212,27B6DDFE3A356062F221ABD7AD70BB14,11061,18,22,4,29,48,1498
41216,41216,D25B9AC730B657F825EAE4962DB7814E,10634,0,6,6,27,45,1395
41217,41217,D25B9AC730B657F825EAE4962DB7814E,10351,10,11,1,28,45,1445
41218,41218,D25B9AC730B657F825EAE4962DB7814E,10634,12,13,1,27,45,1395
41219,41219,D25B9AC730B657F825EAE4962DB7814E,11351,15,17,2,36,48,1848
41220,41220,D25B9AC730B657F825EAE4962DB7814E,42501,19,20,1,28,47,1447
41221,41221,D25B9AC730B657F825EAE4962DB7814E,10634,20,21,1,27,45,1395
41222,41222,A2DD7BA75FCE1B5306A377D198F94491,15391,1,5,4,35,26,1776
41223,41223,A2DD7BA75FCE1B5306A377D198F94491,43121,5,7,2,25,27,1277
41224,41224,A2DD7BA75FCE1B5306A377D198F94491,12792,11,13,2,34,30,1730
41225,41225,A2DD7BA75FCE1B5306A377D198F94491,15391,16,21,5,35,26,1776
41226,41226,A2DD7BA75FCE1B5306A377D198F94491,12791,22,23,1,31,29,1579
41240,41240,96452439FA8965CAF4B8DE42BC3B7A33,40051,0,10,10,32,49,1649
41241,41241,96452439FA8965CAF4B8DE42BC3B7A33,40331,11,12,1,30,47,1547
41242,41242,96452439FA8965CAF4B8DE42BC3B7A33,42511,18,20,2,37,47,1897
41243,41243,BDF4B5C05609456B37F5960310F25B46,42031,0,8,8,40,46,2046
41244,41244,BDF4B5C05609456B37F5960310F25B46,40341,13,15,2,23,49,1199
41245,41245,BDF4B5C05609456B37F5960310F25B46,11324,16,23,7,31,46,1596
41246,41246,CB6CE8B284764CB65EC4187E6FE5A3FF,19021,0,5,5,10,45,545
41247,41247,CB6CE8B284764CB65EC4187E6FE5A3FF,43021,6,8,2,16,43,843
41248,41248,CB6CE8B284764CB65EC4187E6FE5A3FF,11571,12,14,2,13,46,696
41249,41249,CB6CE8B284764CB65EC4187E6FE5A3FF,43021,15,16,1,16,43,843
41250,41250,CB6CE8B284764CB65EC4187E6FE5A3FF,19021,17,19,2,10,45,545
41251,41251,409A27121CD9E6BC90762C45B277F54C,11861,0,7,7,32,47,1647
41252,41252,409A27121CD9E6BC90762C45B277F54C,43281,7,13,6,37,48,1898
41253,41253,409A27121CD9E6BC90762C45B277F54C,11461,13,17,4,37,49,1899
41254,41254,409A27121CD9E6BC90762C45B277F54C,11861,19,22,3,32,47,1647
41258,41258,B90520ED7BDDE423CEFE3ED6913620C9,10271,0,7,7,37,46,1896
41259,41259,B90520ED7BDDE423CEFE3ED6913620C9,12514,8,10,2,38,47,1947
41260,41260,B90520ED7BDDE423CEFE3ED6913620C9,10841,12,13,1,37,47,1897
41261,41261,B90520ED7BDDE423CEFE3ED6913620C9,12514,14,15,1,38,47,1947
41262,41262,B90520ED7BDDE423CEFE3ED6913620C9,10841,19,22,3,37,47,1897
41263,41263,9F589AB01E58B6B2CA9FB997F96CB7F3,13071,0,6,6,41,41,2091
41264,41264,9F589AB01E58B6B2CA9FB997F96CB7F3,43451,7,20,13,37,40,1890
41265,41265,9F589AB01E58B6B2CA9FB997F96CB7F3,13071,21,23,2,41,41,2091
41288,41288,E675A65705B47E64E764764AA7201F3F,15411,1,9,8,44,27,2227
41289,41289,E675A65705B47E64E764764AA7201F3F,15394,11,12,1,35,26,1776
41290,41290,E675A65705B47E64E764764AA7201F3F,15411,14,16,2,44,27,2227
41291,41291,E675A65705B47E64E764764AA7201F3F,12611,17,19,2,41,29,2079
41292,41292,E675A65705B47E64E764764AA7201F3F,15411,20,21,1,44,27,2227
41293,41293,E675A65705B47E64E764764AA7201F3F,15561,22,23,1,32,22,1622
41297,41297,185B38C3D93D7DE2F22B048990C6E7CC,11781,0,13,13,38,49,1949
41298,41298,185B38C3D93D7DE2F22B048990C6E7CC,11061,16,18,2,29,48,1498
41299,41299,185B38C3D93D7DE2F22B048990C6E7CC,11151,19,21,2,30,48,1548
41300,41300,185B38C3D93D7DE2F22B048990C6E7CC,11631,22,23,1,12,49,649
41308,41308,90AC20E6CC0B4ABA3A4EAC5C3086C030,13741,0,7,7,37,49,1899
41309,41309,90AC20E6CC0B4ABA3A4EAC5C3086C030,12083,10,12,2,36,49,1849
41310,41310,90AC20E6CC0B4ABA3A4EAC5C3086C030,13741,12,14,2,37,49,1899
41311,41311,90AC20E6CC0B4ABA3A4EAC5C3086C030,11074,15,17,2,37,47,1897
41312,41312,90AC20E6CC0B4ABA3A4EAC5C3086C030,11081,18,19,1,35,46,1796
41313,41313,90AC20E6CC0B4ABA3A4EAC5C3086C030,43471,19,21,2,31,49,1599
41314,41314,BEF31F045A546CF30A63CFBCD60FD3FA,13911,0,12,12,39,46,1996
41315,41315,BEF31F045A546CF30A63CFBCD60FD3FA,42151,13,14,1,35,45,1795
41316,41316,BEF31F045A546CF30A63CFBCD60FD3FA,42231,14,15,1,37,46,1896
41317,41317,BEF31F045A546CF30A63CFBCD60FD3FA,42351,16,19,3,38,45,1945
41318,41318,BEF31F045A546CF30A63CFBCD60FD3FA,42231,20,22,2,37,46,1896
41322,41322,8D7C0B857F663DDD976EFDB13B0F0F1F,11911,0,6,6,37,48,1898
41323,41323,8D7C0B857F663DDD976EFDB13B0F0F1F,11381,8,15,7,30,47,1547
41324,41324,8D7C0B857F663DDD976EFDB13B0F0F1F,10411,19,23,4,36,48,1848
41329,41329,92D731B11080166AE9677089A81E2175,10491,0,14,14,33,48,1698
41330,41330,92D731B11080166AE9677089A81E2175,11771,16,17,1,39,49,1999
41331,41331,92D731B11080166AE9677089A81E2175,10491,18,23,5,33,48,1698
41338,41338,DFA44588B9F7612E59AB24A1351E5F4F,49201,0,2,2,7,41,391
41339,41339,DFA44588B9F7612E59AB24A1351E5F4F,12921,2,7,5,9,41,491
41340,41340,DFA44588B9F7612E59AB24A1351E5F4F,49201,8,15,7,7,41,391
41341,41341,DFA44588B9F7612E59AB24A1351E5F4F,12921,15,16,1,9,41,491
41342,41342,DFA44588B9F7612E59AB24A1351E5F4F,49201,20,21,1,7,41,391
41343,41343,DFA44588B9F7612E59AB24A1351E5F4F,12921,21,23,2,9,41,491
41344,41344,24576DC2C63BF30A46BA06C33A71F868,42151,0,1,1,35,45,1795
41345,41345,24576DC2C63BF30A46BA06C33A71F868,11261,6,7,1,36,46,1846
41346,41346,24576DC2C63BF30A46BA06C33A71F868,13911,7,13,6,39,46,1996
41347,41347,24576DC2C63BF30A46BA06C33A71F868,11261,14,19,5,36,46,1846
41348,41348,EB9956C9DBC511BA5FF326EEE28E7DCD,10271,0,1,1,37,46,1896
41349,41349,EB9956C9DBC511BA5FF326EEE28E7DCD,13711,2,4,2,38,46,1946
41350,41350,EB9956C9DBC511BA5FF326EEE28E7DCD,10271,4,8,4,37,46,1896
41351,41351,EB9956C9DBC511BA5FF326EEE28E7DCD,13711,14,15,1,38,46,1946
41352,41352,EB9956C9DBC511BA5FF326EEE28E7DCD,10271,18,23,5,37,46,1896
41353,41353,0CF904518F996518DEC66442098817EE,11431,0,8,8,29,47,1497
41354,41354,0CF904518F996518DEC66442098817EE,12381,8,13,5,32,48,1648
41355,41355,0CF904518F996518DEC66442098817EE,10251,14,15,1,35,47,1797
41356,41356,0CF904518F996518DEC66442098817EE,13221,18,19,1,40,47,2047
41357,41357,0CF904518F996518DEC66442098817EE,11431,21,22,1,29,47,1497
41358,41358,A35071276CF6040BBB9F2CC0B19C39D4,43751,1,6,5,19,48,998
41359,41359,A35071276CF6040BBB9F2CC0B19C39D4,11641,8,9,1,22,49,1149
41360,41360,A35071276CF6040BBB9F2CC0B19C39D4,42691,12,20,8,24,48,1248
41361,41361,F90313BC40FFD1908C2B8D9FAFC50C6B,11261,0,6,6,36,46,1846
41362,41362,F90313BC40FFD1908C2B8D9FAFC50C6B,12601,11,16,5,25,47,1297
41363,41363,F90313BC40FFD1908C2B8D9FAFC50C6B,11261,18,23,5,36,46,1846
41364,41364,E090AE745FE0157CE235544725EE3E3A,12511,0,6,6,39,47,1997
41365,41365,E090AE745FE0157CE235544725EE3E3A,11021,8,13,5,36,49,1849
41366,41366,E090AE745FE0157CE235544725EE3E3A,11171,15,18,3,33,48,1698
41374,41374,09C2A5500F5ABAEEAC932C07F5628EC4,11021,0,7,7,36,49,1849
41375,41375,09C2A5500F5ABAEEAC932C07F5628EC4,43161,9,11,2,35,47,1797
41376,41376,09C2A5500F5ABAEEAC932C07F5628EC4,40463,13,14,1,38,49,1949
41377,41377,09C2A5500F5ABAEEAC932C07F5628EC4,42161,14,18,4,36,47,1847
41378,41378,09C2A5500F5ABAEEAC932C07F5628EC4,11021,19,23,4,36,49,1849
41379,41379,BBCB9918D42B41DEDF16DD7F5A9BE26F,11861,0,7,7,32,47,1647
41380,41380,BBCB9918D42B41DEDF16DD7F5A9BE26F,40637,9,14,5,36,47,1847
41381,41381,BBCB9918D42B41DEDF16DD7F5A9BE26F,11911,15,16,1,37,48,1898
41382,41382,BBCB9918D42B41DEDF16DD7F5A9BE26F,11861,16,23,7,32,47,1647
41383,41383,D4FB6B465C87A5D763D7E62820C6F264,19441,1,3,2,8,46,446
41384,41384,D4FB6B465C87A5D763D7E62820C6F264,12121,4,6,2,29,47,1497
41385,41385,D4FB6B465C87A5D763D7E62820C6F264,19441,8,23,15,8,46,446
41393,41393,424595F1C8846A1CBAEDBFB8FB93F25B,11061,0,3,3,29,48,1498
41394,41394,424595F1C8846A1CBAEDBFB8FB93F25B,12121,6,12,6,29,47,1497
41395,41395,424595F1C8846A1CBAEDBFB8FB93F25B,11381,15,16,1,30,47,1547
41396,41396,424595F1C8846A1CBAEDBFB8FB93F25B,40341,20,23,3,23,49,1199
41400,41400,AD235EE6A83CA7956AB86E8BC887D3C7,11541,0,6,6,35,49,1799
41401,41401,AD235EE6A83CA7956AB86E8BC887D3C7,11021,8,10,2,36,49,1849
41402,41402,AD235EE6A83CA7956AB86E8BC887D3C7,13561,10,11,1,37,49,1899
41403,41403,AD235EE6A83CA7956AB86E8BC887D3C7,11021,12,18,6,36,49,1849
41404,41404,AD235EE6A83CA7956AB86E8BC887D3C7,11541,20,23,3,35,49,1799
41419,41419,292601B04F25422CD848C3599CE12CBB,42321,0,7,7,43,47,2197
41420,41420,292601B04F25422CD848C3599CE12CBB,41271,7,16,9,38,48,1948
41421,41421,292601B04F25422CD848C3599CE12CBB,11541,18,21,3,35,49,1799
41422,41422,40A368CA34750DF505DA57A322872C86,12611,0,7,7,41,29,2079
41423,41423,40A368CA34750DF505DA57A322872C86,15411,7,10,3,44,27,2227
41424,41424,40A368CA34750DF505DA57A322872C86,12611,13,14,1,41,29,2079
41425,41425,40A368CA34750DF505DA57A322872C86,15411,14,21,7,44,27,2227
41426,41426,52DE1B5B29EB088C4F7CC0D4865B38F5,42151,0,5,5,35,45,1795
41427,41427,52DE1B5B29EB088C4F7CC0D4865B38F5,42861,6,8,2,37,44,1894
41428,41428,52DE1B5B29EB088C4F7CC0D4865B38F5,42151,8,9,1,35,45,1795
41429,41429,52DE1B5B29EB088C4F7CC0D4865B38F5,42861,11,15,4,37,44,1894
41430,41430,52DE1B5B29EB088C4F7CC0D4865B38F5,42151,16,23,7,35,45,1795
41435,41435,132BAF41704DD845C2F70543C3732C4E,13711,2,4,2,38,46,1946
41436,41436,132BAF41704DD845C2F70543C3732C4E,42231,4,11,7,37,46,1896
41437,41437,132BAF41704DD845C2F70543C3732C4E,13711,11,12,1,38,46,1946
41438,41438,132BAF41704DD845C2F70543C3732C4E,42231,13,14,1,37,46,1896
41439,41439,132BAF41704DD845C2F70543C3732C4E,13711,15,21,6,38,46,1946
41443,41443,D8649491D8359E263FDD367C6CA795FB,10161,0,10,10,35,49,1799
41444,41444,D8649491D8359E263FDD367C6CA795FB,10501,12,14,2,22,46,1146
41445,41445,D8649491D8359E263FDD367C6CA795FB,10161,16,18,2,35,49,1799
41446,41446,D8649491D8359E263FDD367C6CA795FB,10731,19,20,1,33,47,1697
41447,41447,D8649491D8359E263FDD367C6CA795FB,10161,22,23,1,35,49,1799
41451,41451,CDF6ADDC899F34326492126BCC50D6B8,12601,7,11,4,25,47,1297
41452,41452,CDF6ADDC899F34326492126BCC50D6B8,11361,13,15,2,22,48,1148
41453,41453,CDF6ADDC899F34326492126BCC50D6B8,10171,16,19,3,26,47,1347
41454,41454,CDF6ADDC899F34326492126BCC50D6B8,10711,20,23,3,29,46,1496
41455,41455,D48C648C1D8E99D79DDC90BDE949351A,13231,0,5,5,39,46,1996
41456,41456,D48C648C1D8E99D79DDC90BDE949351A,11261,6,11,5,36,46,1846
41457,41457,D48C648C1D8E99D79DDC90BDE949351A,13951,13,14,1,47,45,2395
41458,41458,D48C648C1D8E99D79DDC90BDE949351A,11261,17,20,3,36,46,1846
41462,41462,EFDA2C5B5C74A84C4F53E182DEEAC908,19441,0,1,1,8,46,446
41463,41463,EFDA2C5B5C74A84C4F53E182DEEAC908,11571,1,6,5,13,46,696
41464,41464,EFDA2C5B5C74A84C4F53E182DEEAC908,19441,10,18,8,8,46,446
41465,41465,EFDA2C5B5C74A84C4F53E182DEEAC908,42041,19,22,3,10,47,547
41466,41466,98BA7F3F4273010D1D66E32FADA4A17B,43751,0,6,6,19,48,998
41467,41467,98BA7F3F4273010D1D66E32FADA4A17B,42481,7,16,9,22,49,1149
41468,41468,98BA7F3F4273010D1D66E32FADA4A17B,42681,16,18,2,24,48,1248
41469,41469,98BA7F3F4273010D1D66E32FADA4A17B,43751,18,20,2,19,48,998
41470,41470,65721B81764EA1E4077E5DA989A8C0F7,42121,0,6,6,26,49,1349
41471,41471,65721B81764EA1E4077E5DA989A8C0F7,11281,8,20,12,27,40,1390
41472,41472,65721B81764EA1E4077E5DA989A8C0F7,13671,21,23,2,27,43,1393
41480,41480,960FD8FAF04E1E447A1CA2BDB9A16E8A,11861,0,5,5,32,47,1647
41481,41481,960FD8FAF04E1E447A1CA2BDB9A16E8A,11541,7,16,9,35,49,1799
41482,41482,960FD8FAF04E1E447A1CA2BDB9A16E8A,11861,18,23,5,32,47,1647
41483,41483,A52680CFF3255B80F2E899094DC1E938,13951,0,6,6,47,45,2395
41484,41484,A52680CFF3255B80F2E899094DC1E938,43951,7,18,11,49,41,2491
41485,41485,A52680CFF3255B80F2E899094DC1E938,13951,19,23,4,47,45,2395
41499,41499,0B48A85C2E63306F2732FBA1CEDC76FB,11021,1,5,4,36,49,1849
41500,41500,0B48A85C2E63306F2732FBA1CEDC76FB,10221,9,11,2,34,49,1749
41501,41501,0B48A85C2E63306F2732FBA1CEDC76FB,10951,13,14,1,29,48,1498
41502,41502,0B48A85C2E63306F2732FBA1CEDC76FB,11021,19,21,2,36,49,1849
41503,41503,E16EBF9DB1B661AB3BA331BB1570A330,12491,0,5,5,36,43,1843
41504,41504,E16EBF9DB1B661AB3BA331BB1570A330,43451,7,8,1,37,40,1890
41505,41505,E16EBF9DB1B661AB3BA331BB1570A330,13071,11,13,2,41,41,2091
41506,41506,E16EBF9DB1B661AB3BA331BB1570A330,42864,15,16,1,38,44,1944
41507,41507,E16EBF9DB1B661AB3BA331BB1570A330,12491,20,23,3,36,43,1843
41514,41514,1F6BCFEB56D245CBF5160F742055C8A2,11151,0,12,12,30,48,1548
41515,41515,1F6BCFEB56D245CBF5160F742055C8A2,43181,15,16,1,39,48,1998
41516,41516,1F6BCFEB56D245CBF5160F742055C8A2,11061,18,20,2,29,48,1498
41532,41532,965405E10916AAAABCBCC699D7FEC727,13371,0,9,9,41,47,2097
41533,41533,965405E10916AAAABCBCC699D7FEC727,13711,12,15,3,38,46,1946
41534,41534,965405E10916AAAABCBCC699D7FEC727,40401,15,18,3,40,46,2046
41535,41535,965405E10916AAAABCBCC699D7FEC727,11151,20,21,1,30,48,1548
41542,41542,21D55F604F2208FEFD830C0950342A72,41101,0,1,1,32,48,1648
41543,41543,21D55F604F2208FEFD830C0950342A72,10251,18,20,2,35,47,1797
41544,41544,21D55F604F2208FEFD830C0950342A72,11231,20,23,3,37,49,1899
41545,41545,765113C0EC03D9C2E8837F99909100D7,42401,0,6,6,36,47,1847
41546,41546,765113C0EC03D9C2E8837F99909100D7,10681,11,12,1,30,48,1548
41547,41547,765113C0EC03D9C2E8837F99909100D7,11201,13,14,1,35,49,1799
41548,41548,765113C0EC03D9C2E8837F99909100D7,10681,17,19,2,30,48,1548
41549,41549,765113C0EC03D9C2E8837F99909100D7,40637,20,21,1,36,47,1847
41554,41554,345D4029BCC33DBFE6D7841DB885E7B2,42491,0,7,7,32,46,1646
41555,41555,345D4029BCC33DBFE6D7841DB885E7B2,11301,7,10,3,41,49,2099
41556,41556,345D4029BCC33DBFE6D7841DB885E7B2,42471,12,14,2,35,49,1799
41557,41557,345D4029BCC33DBFE6D7841DB885E7B2,11301,15,18,3,41,49,2099
41558,41558,345D4029BCC33DBFE6D7841DB885E7B2,42491,19,23,4,32,46,1646
41559,41559,852BB5540E2D1D044093F0A403D4011D,19441,0,14,14,8,46,446
41560,41560,852BB5540E2D1D044093F0A403D4011D,11751,19,21,2,35,48,1798
41561,41561,852BB5540E2D1D044093F0A403D4011D,11531,21,23,2,34,49,1749
41570,41570,2AA2EBD5B59B2AAF33B9CF8E5CE3BCBA,19181,0,1,1,8,40,440
41571,41571,2AA2EBD5B59B2AAF33B9CF8E5CE3BCBA,12921,6,7,1,9,41,491
41572,41572,2AA2EBD5B59B2AAF33B9CF8E5CE3BCBA,19901,8,10,2,7,44,394
41573,41573,2AA2EBD5B59B2AAF33B9CF8E5CE3BCBA,19621,12,17,5,5,46,296
41574,41574,2AA2EBD5B59B2AAF33B9CF8E5CE3BCBA,12921,18,19,1,9,41,491
41575,41575,4512C33A5D25C12FE88068CD1CBDBC46,11914,0,6,6,37,48,1898
41576,41576,4512C33A5D25C12FE88068CD1CBDBC46,11571,7,11,4,13,46,696
41577,41577,4512C33A5D25C12FE88068CD1CBDBC46,11921,15,19,4,38,48,1948
41578,41578,4512C33A5D25C12FE88068CD1CBDBC46,11331,21,23,2,37,48,1898
41579,41579,1277ACA424D6A91D4C363B632562549C,12601,0,3,3,25,47,1297
41580,41580,1277ACA424D6A91D4C363B632562549C,10501,3,5,2,22,46,1146
41581,41581,1277ACA424D6A91D4C363B632562549C,12601,9,12,3,25,47,1297
41582,41582,1277ACA424D6A91D4C363B632562549C,10501,14,17,3,22,46,1146
41583,41583,1277ACA424D6A91D4C363B632562549C,12601,19,20,1,25,47,1297
41584,41584,5F14E1A15EFA1C13F8B10CBC543F107C,10191,0,13,13,40,48,2048
41585,41585,5F14E1A15EFA1C13F8B10CBC543F107C,12581,14,17,3,24,48,1248
41586,41586,5F14E1A15EFA1C13F8B10CBC543F107C,11481,18,20,2,41,48,2098
41590,41590,2B796358390FD846EE57DE8924EDBF14,42581,0,1,1,38,48,1948
41591,41591,2B796358390FD846EE57DE8924EDBF14,43181,4,5,1,39,48,1998
41592,41592,2B796358390FD846EE57DE8924EDBF14,42581,6,7,1,38,48,1948
41593,41593,2B796358390FD846EE57DE8924EDBF14,11914,8,18,10,37,48,1898
41594,41594,2B796358390FD846EE57DE8924EDBF14,42581,18,22,4,38,48,1948
41604,41604,40BF7E8E4E81DE7A3F0DD0CD7FEB88DA,42301,4,6,2,36,47,1847
41605,41605,40BF7E8E4E81DE7A3F0DD0CD7FEB88DA,40341,7,9,2,23,49,1199
41606,41606,40BF7E8E4E81DE7A3F0DD0CD7FEB88DA,42301,13,22,9,36,47,1847
41607,41607,77CF82999F1711B45C3ADB7CE62EA0FA,10841,5,14,9,37,47,1897
41608,41608,77CF82999F1711B45C3ADB7CE62EA0FA,10951,18,20,2,29,48,1498
41609,41609,77CF82999F1711B45C3ADB7CE62EA0FA,10221,21,22,1,34,49,1749
41610,41610,C08956364BE5991DC6E036A403FC40A9,11741,0,18,18,42,49,2149
41611,41611,C08956364BE5991DC6E036A403FC40A9,13381,19,20,1,39,47,1997
41612,41612,C08956364BE5991DC6E036A403FC40A9,42271,20,23,3,40,47,2047
41620,41620,29FEBE0C273EA30FAAD971E70827E56F,42081,4,6,2,24,49,1249
41621,41621,29FEBE0C273EA30FAAD971E70827E56F,42641,10,12,2,33,49,1699
41622,41622,29FEBE0C273EA30FAAD971E70827E56F,10544,22,23,1,28,48,1448
41629,41629,5F8C4AC7A3906DD7BDECDB975A9EEF5C,19031,0,6,6,1,42,92
41630,41630,5F8C4AC7A3906DD7BDECDB975A9EEF5C,12641,6,10,4,10,43,543
41631,41631,5F8C4AC7A3906DD7BDECDB975A9EEF5C,12921,14,21,7,9,41,491
41635,41635,F38AB0098BE65E711BE711E13E868DCB,43981,0,7,7,36,49,1849
41636,41636,F38AB0098BE65E711BE711E13E868DCB,13371,13,15,2,41,47,2097
41637,41637,F38AB0098BE65E711BE711E13E868DCB,13561,18,23,5,37,49,1899
41641,41641,8E7E1D3BA1392AF853A6068E181E9940,12971,0,8,8,32,48,1648
41642,41642,8E7E1D3BA1392AF853A6068E181E9940,10191,11,13,2,40,48,2048
41643,41643,8E7E1D3BA1392AF853A6068E181E9940,12971,18,20,2,32,48,1648
41644,41644,04FD7353544737B0FB3E8D9EE9BF752F,42371,0,7,7,34,46,1746
41645,41645,04FD7353544737B0FB3E8D9EE9BF752F,42523,9,11,2,31,47,1597
41646,41646,04FD7353544737B0FB3E8D9EE9BF752F,13651,14,16,2,30,47,1547
41647,41647,04FD7353544737B0FB3E8D9EE9BF752F,43761,19,23,4,32,47,1647
41651,41651,9F8B1DD6D80751B4C4B13C705B0FAEDB,15391,1,8,7,35,26,1776
41652,41652,9F8B1DD6D80751B4C4B13C705B0FAEDB,12792,10,13,3,34,30,1730
41653,41653,9F8B1DD6D80751B4C4B13C705B0FAEDB,15391,16,20,4,35,26,1776
41654,41654,9F8B1DD6D80751B4C4B13C705B0FAEDB,12792,20,23,3,34,30,1730
41655,41655,F4642913143D13E623E2653E0A9C754D,10491,0,6,6,33,48,1698
41656,41656,F4642913143D13E623E2653E0A9C754D,19441,7,8,1,8,46,446
41657,41657,F4642913143D13E623E2653E0A9C754D,10491,13,23,10,33,48,1698
41668,41668,85E6B4DC96BFA3920E08895C266F386F,10911,0,1,1,39,46,1996
41669,41669,85E6B4DC96BFA3920E08895C266F386F,13121,1,7,6,38,46,1946
41670,41670,85E6B4DC96BFA3920E08895C266F386F,13331,8,9,1,38,47,1947
41671,41671,85E6B4DC96BFA3920E08895C266F386F,11701,12,14,2,43,48,2198
41672,41672,85E6B4DC96BFA3920E08895C266F386F,13681,19,23,4,38,47,1947
41683,41683,1E80787B69718C7476B2A0E1C06850FD,10111,0,8,8,37,47,1897
41684,41684,1E80787B69718C7476B2A0E1C06850FD,42301,9,10,1,36,47,1847
41685,41685,1E80787B69718C7476B2A0E1C06850FD,10841,10,11,1,37,47,1897
41686,41686,1E80787B69718C7476B2A0E1C06850FD,11381,16,17,1,30,47,1547
41687,41687,1E80787B69718C7476B2A0E1C06850FD,10111,18,23,5,37,47,1897
41697,41697,E748F2254AC2A75A1317C0ED54387A7E,42831,0,6,6,27,48,1398
41698,41698,E748F2254AC2A75A1317C0ED54387A7E,42071,8,11,3,31,49,1599
41699,41699,E748F2254AC2A75A1317C0ED54387A7E,42831,11,13,2,27,48,1398
41700,41700,E748F2254AC2A75A1317C0ED54387A7E,42071,15,16,1,31,49,1599
41701,41701,E748F2254AC2A75A1317C0ED54387A7E,42831,18,23,5,27,48,1398
41702,41702,D96C351A2D3BF2CB9C84E8F01C9997B6,12641,4,7,3,10,43,543
41703,41703,D96C351A2D3BF2CB9C84E8F01C9997B6,19904,8,10,2,9,44,494
41704,41704,D96C351A2D3BF2CB9C84E8F01C9997B6,19111,13,14,1,9,45,495
41705,41705,D96C351A2D3BF2CB9C84E8F01C9997B6,19621,15,19,4,5,46,296
41719,41719,2139D822BACE7D7E0DE8D7E5E03E9504,13111,6,13,7,42,46,2146
41720,41720,2139D822BACE7D7E0DE8D7E5E03E9504,19801,17,18,1,19,26,976
41721,41721,2139D822BACE7D7E0DE8D7E5E03E9504,11151,20,21,1,30,48,1548
41722,41722,B8DCAC0FC6FA981D871032E55C240C8E,11914,0,4,4,37,48,1898
41723,41723,B8DCAC0FC6FA981D871032E55C240C8E,10921,8,9,1,43,48,2198
41724,41724,B8DCAC0FC6FA981D871032E55C240C8E,11914,11,23,12,37,48,1898
41728,41728,EBFB5708D8075AF034BD3DE24FA70ABA,15521,0,6,6,27,14,1364
41729,41729,EBFB5708D8075AF034BD3DE24FA70ABA,15041,7,9,2,36,9,1809
41730,41730,EBFB5708D8075AF034BD3DE24FA70ABA,15051,11,13,2,19,4,954
41731,41731,EBFB5708D8075AF034BD3DE24FA70ABA,16281,14,15,1,11,4,554
41732,41732,EBFB5708D8075AF034BD3DE24FA70ABA,15521,18,23,5,27,14,1364
41736,41736,74EBB90FA1C414F58477B49370E7F73F,11861,0,6,6,32,47,1647
41737,41737,74EBB90FA1C414F58477B49370E7F73F,12311,8,17,9,30,44,1544
41738,41738,74EBB90FA1C414F58477B49370E7F73F,11861,18,23,5,32,47,1647
41743,41743,715F7A42E71CC3B03C35CCDCAA47978E,43644,0,5,5,14,38,738
41744,41744,715F7A42E71CC3B03C35CCDCAA47978E,12641,6,8,2,10,43,543
41745,41745,715F7A42E71CC3B03C35CCDCAA47978E,12921,12,13,1,9,41,491
41746,41746,715F7A42E71CC3B03C35CCDCAA47978E,12641,15,16,1,10,43,543
41747,41747,715F7A42E71CC3B03C35CCDCAA47978E,19931,17,18,1,7,43,393
41748,41748,715F7A42E71CC3B03C35CCDCAA47978E,12641,18,19,1,10,43,543
41749,41749,A63A75F6DD3F080096B33CBA61C8F1AE,11331,0,6,6,37,48,1898
41750,41750,A63A75F6DD3F080096B33CBA61C8F1AE,42601,7,15,8,44,48,2248
41751,41751,A63A75F6DD3F080096B33CBA61C8F1AE,11331,18,23,5,37,48,1898
41752,41752,639EA486291B8A87A84D90343A87732A,10451,0,6,6,25,48,1298
41753,41753,639EA486291B8A87A84D90343A87732A,10661,7,8,1,37,49,1899
41754,41754,639EA486291B8A87A84D90343A87732A,40171,11,13,2,38,48,1948
41755,41755,639EA486291B8A87A84D90343A87732A,10661,13,17,4,37,49,1899
41756,41756,639EA486291B8A87A84D90343A87732A,11551,20,23,3,39,49,1999
41757,41757,176F4E967E986DAF00C74DDD3BF2A8FE,11806,0,9,9,41,48,2098
41758,41758,176F4E967E986DAF00C74DDD3BF2A8FE,12514,11,15,4,38,47,1947
41759,41759,176F4E967E986DAF00C74DDD3BF2A8FE,42401,18,20,2,36,47,1847
41760,41760,176F4E967E986DAF00C74DDD3BF2A8FE,11806,21,23,2,41,48,2098
41771,41771,292AD485DA7AE4FB3CFCA1190DC036DF,42151,0,5,5,35,45,1795
41772,41772,292AD485DA7AE4FB3CFCA1190DC036DF,12311,5,11,6,30,44,1544
41773,41773,292AD485DA7AE4FB3CFCA1190DC036DF,42151,11,13,2,35,45,1795
41774,41774,292AD485DA7AE4FB3CFCA1190DC036DF,12311,13,17,4,30,44,1544
41775,41775,292AD485DA7AE4FB3CFCA1190DC036DF,42151,19,23,4,35,45,1795
41779,41779,29E682BF994B2ACA314777BEAEB90BB7,42351,1,2,1,38,45,1945
41780,41780,29E682BF994B2ACA314777BEAEB90BB7,13911,4,6,2,39,46,1996
41781,41781,29E682BF994B2ACA314777BEAEB90BB7,42231,9,11,2,37,46,1896
41782,41782,29E682BF994B2ACA314777BEAEB90BB7,42351,11,12,1,38,45,1945
41783,41783,29E682BF994B2ACA314777BEAEB90BB7,42231,15,22,7,37,46,1896
41801,41801,FB55B20B748C0A1CF26B4BE2B509424A,12761,0,6,6,25,40,1290
41802,41802,FB55B20B748C0A1CF26B4BE2B509424A,13671,7,11,4,27,43,1393
41803,41803,FB55B20B748C0A1CF26B4BE2B509424A,10431,15,18,3,33,49,1699
41804,41804,FB55B20B748C0A1CF26B4BE2B509424A,13671,20,22,2,27,43,1393
41809,41809,AAC6347FC04E27D4907410C8A855C3EF,10841,0,8,8,37,47,1897
41810,41810,AAC6347FC04E27D4907410C8A855C3EF,12021,10,12,2,37,49,1899
41811,41811,AAC6347FC04E27D4907410C8A855C3EF,11481,19,20,1,41,48,2098
41812,41812,AAC6347FC04E27D4907410C8A855C3EF,40123,21,23,2,38,47,1947
41813,41813,8F4F34841BA1C373A7F156A7DC8C9C36,10431,0,8,8,33,49,1699
41814,41814,8F4F34841BA1C373A7F156A7DC8C9C36,11074,9,11,2,37,47,1897
41815,41815,8F4F34841BA1C373A7F156A7DC8C9C36,10491,18,20,2,33,48,1698
41816,41816,8F4F34841BA1C373A7F156A7DC8C9C36,42961,21,22,1,35,49,1799
41817,41817,9860684852E504726B6048155048EB49,42151,0,8,8,35,45,1795
41818,41818,9860684852E504726B6048155048EB49,12311,9,11,2,30,44,1544
41819,41819,9860684852E504726B6048155048EB49,42151,11,22,11,35,45,1795
41823,41823,2EBE142BB70D514367A5435D87FB646A,11061,3,8,5,29,48,1498
41824,41824,2EBE142BB70D514367A5435D87FB646A,11781,9,10,1,38,49,1949
41825,41825,2EBE142BB70D514367A5435D87FB646A,11061,13,23,10,29,48,1498
41839,41839,803884DAE228D36B780CDE250AFE5FD1,13711,0,8,8,38,46,1946
41840,41840,803884DAE228D36B780CDE250AFE5FD1,40171,12,13,1,38,48,1948
41841,41841,803884DAE228D36B780CDE250AFE5FD1,13711,13,18,5,38,46,1946
41842,41842,803884DAE228D36B780CDE250AFE5FD1,10901,19,22,3,35,48,1798
41843,41843,803884DAE228D36B780CDE250AFE5FD1,13711,22,23,1,38,46,1946
41844,41844,75E9901E37B333931DA19D3D307663B3,42681,0,1,1,24,48,1248
41845,41845,75E9901E37B333931DA19D3D307663B3,40343,2,3,1,24,49,1249
41846,41846,75E9901E37B333931DA19D3D307663B3,42681,4,6,2,24,48,1248
41847,41847,75E9901E37B333931DA19D3D307663B3,40343,10,12,2,24,49,1249
41848,41848,75E9901E37B333931DA19D3D307663B3,42681,14,17,3,24,48,1248
41849,41849,75E9901E37B333931DA19D3D307663B3,40343,21,23,2,24,49,1249
41850,41850,4EACE42588F1A3E8D92117CB80669AFA,11021,1,12,11,36,49,1849
41851,41851,4EACE42588F1A3E8D92117CB80669AFA,11641,15,17,2,22,49,1149
41852,41852,4EACE42588F1A3E8D92117CB80669AFA,11541,19,22,3,35,49,1799
41853,41853,71AB304A084EB4095E1F705C48CB0E23,11901,0,6,6,42,49,2149
41854,41854,71AB304A084EB4095E1F705C48CB0E23,11914,8,16,8,37,48,1898
41855,41855,71AB304A084EB4095E1F705C48CB0E23,11901,20,23,3,42,49,2149
41859,41859,AA51DE94270AE4663B2578A38D4EECC9,13961,0,7,7,42,48,2148
41860,41860,AA51DE94270AE4663B2578A38D4EECC9,11914,9,10,1,37,48,1898
41861,41861,AA51DE94270AE4663B2578A38D4EECC9,13961,11,23,12,42,48,2148
41878,41878,32C5253918A521B8F98B84B7F9A74915,11861,0,16,16,32,47,1647
41879,41879,32C5253918A521B8F98B84B7F9A74915,40341,17,19,2,23,49,1199
41880,41880,32C5253918A521B8F98B84B7F9A74915,11861,19,22,3,32,47,1647
41881,41881,03A91EC93647A8BA652DF6ED44DA5BB9,11161,0,8,8,32,48,1648
41882,41882,03A91EC93647A8BA652DF6ED44DA5BB9,43061,8,11,3,43,46,2196
41883,41883,03A91EC93647A8BA652DF6ED44DA5BB9,42141,13,20,7,32,47,1647
41884,41884,03A91EC93647A8BA652DF6ED44DA5BB9,42021,21,22,1,33,47,1697
41885,41885,460F97EBC86F8CBF93D1A8D6309E0ED8,43311,0,14,14,31,48,1598
41886,41886,460F97EBC86F8CBF93D1A8D6309E0ED8,42231,16,17,1,37,46,1896
41887,41887,460F97EBC86F8CBF93D1A8D6309E0ED8,43311,22,23,1,31,48,1598
41891,41891,9FC853D14B199D9AE09B3905110E90BD,12514,0,13,13,38,47,1947
41892,41892,9FC853D14B199D9AE09B3905110E90BD,11541,15,18,3,35,49,1799
41893,41893,9FC853D14B199D9AE09B3905110E90BD,12514,19,23,4,38,47,1947
41907,41907,720B1030F9AA451F5DB7F94C393FD381,10107,0,2,2,38,49,1949
41908,41908,720B1030F9AA451F5DB7F94C393FD381,12651,3,8,5,43,47,2197
41909,41909,720B1030F9AA451F5DB7F94C393FD381,11541,12,18,6,35,49,1799
41910,41910,720B1030F9AA451F5DB7F94C393FD381,40691,21,22,1,42,48,2148
41911,41911,EFD3CD287097CC7EB227645070325EE5,13341,0,7,7,44,45,2245
41912,41912,EFD3CD287097CC7EB227645070325EE5,42491,9,10,1,32,46,1646
41913,41913,EFD3CD287097CC7EB227645070325EE5,13341,12,23,11,44,45,2245
41923,41923,ECBC886277109C0582E65AB313F27C1C,13314,0,6,6,31,39,1589
41924,41924,ECBC886277109C0582E65AB313F27C1C,12521,7,16,9,35,41,1791
41925,41925,ECBC886277109C0582E65AB313F27C1C,13314,19,23,4,31,39,1589
41926,41926,7EF8399B7744B26431FFE3070C9BD313,19441,0,8,8,8,46,446
41927,41927,7EF8399B7744B26431FFE3070C9BD313,42041,9,11,2,10,47,547
41928,41928,7EF8399B7744B26431FFE3070C9BD313,19441,13,14,1,8,46,446
41929,41929,7EF8399B7744B26431FFE3070C9BD313,42041,18,19,1,10,47,547
41930,41930,7EF8399B7744B26431FFE3070C9BD313,19441,22,23,1,8,46,446
41934,41934,C493E8EAD829832CA31397E82BE4990B,43021,0,5,5,16,43,843
41935,41935,C493E8EAD829832CA31397E82BE4990B,12921,6,9,3,9,41,491
41936,41936,C493E8EAD829832CA31397E82BE4990B,43021,11,23,12,16,43,843
41937,41937,9F5215EB6F19506AA8AED2CAA1CBC8E6,43761,6,7,1,32,47,1647
41938,41938,9F5215EB6F19506AA8AED2CAA1CBC8E6,10511,8,12,4,35,46,1796
41939,41939,9F5215EB6F19506AA8AED2CAA1CBC8E6,42523,12,14,2,31,47,1597
41940,41940,9F5215EB6F19506AA8AED2CAA1CBC8E6,10511,15,17,2,35,46,1796
41941,41941,9F5215EB6F19506AA8AED2CAA1CBC8E6,10691,19,20,1,33,48,1698
41942,41942,9F5215EB6F19506AA8AED2CAA1CBC8E6,42523,20,21,1,31,47,1597
41946,41946,2D408F32CC4CD45CDF430A23DE2FCE4B,11794,0,2,2,38,49,1949
41947,41947,2D408F32CC4CD45CDF430A23DE2FCE4B,11151,2,10,8,30,48,1548
41948,41948,2D408F32CC4CD45CDF430A23DE2FCE4B,43391,11,13,2,29,48,1498
41949,41949,2D408F32CC4CD45CDF430A23DE2FCE4B,11151,14,17,3,30,48,1548
41950,41950,2D408F32CC4CD45CDF430A23DE2FCE4B,43391,22,23,1,29,48,1498
41955,41955,BF29A9480BAB7B58A18F76AD129514BD,10111,0,7,7,37,47,1897
41956,41956,BF29A9480BAB7B58A18F76AD129514BD,42521,9,10,1,31,47,1597
41957,41957,BF29A9480BAB7B58A18F76AD129514BD,10111,18,23,5,37,47,1897
41958,41958,119196C18578341D0084AF6B48A62632,42551,1,3,2,14,48,748
41959,41959,119196C18578341D0084AF6B48A62632,12641,4,7,3,10,43,543
41960,41960,119196C18578341D0084AF6B48A62632,11631,10,21,11,12,49,649
41961,41961,119196C18578341D0084AF6B48A62632,42551,21,22,1,14,48,748
41962,41962,350909571DAF40BC1326F0871B6F4AC2,42371,0,7,7,34,46,1746
41963,41963,350909571DAF40BC1326F0871B6F4AC2,42523,10,11,1,31,47,1597
41964,41964,350909571DAF40BC1326F0871B6F4AC2,11361,14,16,2,22,48,1148
41965,41965,350909571DAF40BC1326F0871B6F4AC2,42371,20,23,3,34,46,1746
41969,41969,1AEA44F051EC107D454C59951DC8E3E5,13111,1,7,6,42,46,2146
41970,41970,1AEA44F051EC107D454C59951DC8E3E5,10221,9,13,4,34,49,1749
41971,41971,1AEA44F051EC107D454C59951DC8E3E5,10161,14,20,6,35,49,1799
41972,41972,1AEA44F051EC107D454C59951DC8E3E5,13111,21,23,2,42,46,2146
41976,41976,220BB9CC5F3F3413B665192BBE457CBF,11874,0,8,8,29,46,1496
41977,41977,220BB9CC5F3F3413B665192BBE457CBF,43581,12,15,3,33,48,1698
41978,41978,220BB9CC5F3F3413B665192BBE457CBF,11871,17,23,6,29,46,1496
41979,41979,668B25EA27DB62433F6B97341A2F29D6,42401,0,8,8,36,47,1847
41980,41980,668B25EA27DB62433F6B97341A2F29D6,43731,13,14,1,34,47,1747
41981,41981,668B25EA27DB62433F6B97341A2F29D6,42531,16,17,1,31,45,1595
41982,41982,668B25EA27DB62433F6B97341A2F29D6,43731,19,20,1,34,47,1747
41983,41983,668B25EA27DB62433F6B97341A2F29D6,10251,20,23,3,35,47,1797
41984,41984,F4A5CE128B0276BA64A57CF9F5D60F74,42831,0,12,12,27,48,1398
41985,41985,F4A5CE128B0276BA64A57CF9F5D60F74,10161,15,16,1,35,49,1799
41986,41986,F4A5CE128B0276BA64A57CF9F5D60F74,42831,18,23,5,27,48,1398
41987,41987,BD3C2CBB97F3C8A079B0FA1DDDA6726E,43311,0,6,6,31,48,1598
41988,41988,BD3C2CBB97F3C8A079B0FA1DDDA6726E,40341,7,9,2,23,49,1199
41989,41989,BD3C2CBB97F3C8A079B0FA1DDDA6726E,43311,11,23,12,31,48,1598
41996,41996,09B258FCC1A04CEAAFFB93000EF42A6F,10811,0,6,6,38,46,1946
41997,41997,09B258FCC1A04CEAAFFB93000EF42A6F,11074,7,8,1,37,47,1897
41998,41998,09B258FCC1A04CEAAFFB93000EF42A6F,42271,8,10,2,40,47,2047
41999,41999,09B258FCC1A04CEAAFFB93000EF42A6F,10601,13,16,3,39,47,1997
42000,42000,09B258FCC1A04CEAAFFB93000EF42A6F,10811,20,23,3,38,46,1946
42007,42007,C5ED324891B8B95E257970408E8D4150,12491,0,9,9,36,43,1843
42008,42008,C5ED324891B8B95E257970408E8D4150,13911,11,12,1,39,46,1996
42009,42009,C5ED324891B8B95E257970408E8D4150,11261,14,17,3,36,46,1846
42010,42010,C5ED324891B8B95E257970408E8D4150,12491,21,22,1,36,43,1843
42021,42021,453C575E79B3550D775ECCDD977110E9,10771,1,2,1,41,46,2096
42022,42022,453C575E79B3550D775ECCDD977110E9,13111,2,6,4,42,46,2146
42023,42023,453C575E79B3550D775ECCDD977110E9,12561,9,16,7,45,43,2293
42024,42024,453C575E79B3550D775ECCDD977110E9,13111,18,20,2,42,46,2146
42032,42032,957150E694558F54E6E276B5EB88E298,13561,0,1,1,37,49,1899
42033,42033,957150E694558F54E6E276B5EB88E298,11951,2,19,17,31,49,1599
42034,42034,957150E694558F54E6E276B5EB88E298,11271,21,23,2,37,48,1898
42044,42044,A208246203303765025742FDE89787BA,13121,1,2,1,38,46,1946
42045,42045,A208246203303765025742FDE89787BA,10271,2,8,6,37,46,1896
42046,42046,A208246203303765025742FDE89787BA,10841,12,14,2,37,47,1897
42047,42047,A208246203303765025742FDE89787BA,10271,15,17,2,37,46,1896
42048,42048,A208246203303765025742FDE89787BA,11271,19,21,2,37,48,1898
42049,42049,A208246203303765025742FDE89787BA,13511,22,23,1,34,48,1748
42063,42063,7861278735CDA91B9BABB196FBF7605C,13411,1,5,4,49,42,2492
42064,42064,7861278735CDA91B9BABB196FBF7605C,13951,12,16,4,47,45,2395
42065,42065,7861278735CDA91B9BABB196FBF7605C,13411,19,21,2,49,42,2492
42066,42066,7861278735CDA91B9BABB196FBF7605C,43951,22,23,1,49,41,2491
42067,42067,EC0CD2E0A87A920DF9017CC7054B6188,12971,0,1,1,32,48,1648
42068,42068,EC0CD2E0A87A920DF9017CC7054B6188,13101,3,10,7,40,47,2047
42069,42069,EC0CD2E0A87A920DF9017CC7054B6188,11481,11,13,2,41,48,2098
42070,42070,EC0CD2E0A87A920DF9017CC7054B6188,13101,13,15,2,40,47,2047
42071,42071,EC0CD2E0A87A920DF9017CC7054B6188,10491,18,19,1,33,48,1698
42072,42072,37FD993175423D4A4F3973BD90B3E646,43341,0,6,6,41,46,2096
42073,42073,37FD993175423D4A4F3973BD90B3E646,10107,7,8,1,38,49,1949
42074,42074,37FD993175423D4A4F3973BD90B3E646,11231,14,16,2,37,49,1899
42075,42075,37FD993175423D4A4F3973BD90B3E646,10901,19,21,2,35,48,1798
42080,42080,15AF53FBA0C13FBD61024895398ED2FD,42041,0,3,3,10,47,547
42081,42081,15AF53FBA0C13FBD61024895398ED2FD,19441,4,8,4,8,46,446
42082,42082,15AF53FBA0C13FBD61024895398ED2FD,42041,8,10,2,10,47,547
42083,42083,15AF53FBA0C13FBD61024895398ED2FD,19441,13,18,5,8,46,446
42084,42084,15AF53FBA0C13FBD61024895398ED2FD,42041,19,21,2,10,47,547
42085,42085,15AF53FBA0C13FBD61024895398ED2FD,11471,22,23,1,12,48,648
42093,42093,7F683BD350227B09C7ECC1328A0C4739,43241,0,3,3,36,46,1846
42094,42094,7F683BD350227B09C7ECC1328A0C4739,10271,4,8,4,37,46,1896
42095,42095,7F683BD350227B09C7ECC1328A0C4739,42011,9,10,1,36,46,1846
42096,42096,7F683BD350227B09C7ECC1328A0C4739,10271,11,16,5,37,46,1896
42097,42097,7F683BD350227B09C7ECC1328A0C4739,13711,19,21,2,38,46,1946
42101,42101,F552BBAFE22D025B0F7E0055A73A2709,42321,0,11,11,43,47,2197
42102,42102,F552BBAFE22D025B0F7E0055A73A2709,42021,14,17,3,33,47,1697
42103,42103,F552BBAFE22D025B0F7E0055A73A2709,10251,20,22,2,35,47,1797
42107,42107,088CE2D4CBB6E08E0181B816402A112A,42921,0,1,1,33,47,1697
42108,42108,088CE2D4CBB6E08E0181B816402A112A,13651,2,12,10,30,47,1547
42109,42109,088CE2D4CBB6E08E0181B816402A112A,42523,12,13,1,31,47,1597
42110,42110,088CE2D4CBB6E08E0181B816402A112A,10292,16,17,1,30,47,1547
42111,42111,088CE2D4CBB6E08E0181B816402A112A,10491,18,19,1,33,48,1698
42112,42112,088CE2D4CBB6E08E0181B816402A112A,13561,21,22,1,37,49,1899
42116,42116,56C9E3E7FB7F4770AB5F1398CDE12961,42281,0,8,8,40,48,2048
42117,42117,56C9E3E7FB7F4770AB5F1398CDE12961,11481,9,11,2,41,48,2098
42118,42118,56C9E3E7FB7F4770AB5F1398CDE12961,42041,14,16,2,10,47,547
42119,42119,56C9E3E7FB7F4770AB5F1398CDE12961,42281,19,22,3,40,48,2048
42120,42120,58B59FD7AA0814C0C6E50CF40955E7AA,12601,5,7,2,25,47,1297
42121,42121,58B59FD7AA0814C0C6E50CF40955E7AA,13771,11,13,2,21,45,1095
42122,42122,58B59FD7AA0814C0C6E50CF40955E7AA,12601,13,14,1,25,47,1297
42123,42123,58B59FD7AA0814C0C6E50CF40955E7AA,10634,15,20,5,27,45,1395
42124,42124,58B59FD7AA0814C0C6E50CF40955E7AA,12601,21,23,2,25,47,1297
42128,42128,5D3AB87CDE152EA5E956E4DDC06AC59B,40171,1,3,2,38,48,1948
42129,42129,5D3AB87CDE152EA5E956E4DDC06AC59B,10471,4,7,3,37,48,1898
42130,42130,5D3AB87CDE152EA5E956E4DDC06AC59B,42581,7,10,3,38,48,1948
42131,42131,5D3AB87CDE152EA5E956E4DDC06AC59B,11914,10,16,6,37,48,1898
42132,42132,5D3AB87CDE152EA5E956E4DDC06AC59B,42581,16,18,2,38,48,1948
42133,42133,5D3AB87CDE152EA5E956E4DDC06AC59B,10471,20,21,1,37,48,1898
42134,42134,8AC8B1E6CB950C4620C9ADD9BF2E2AE1,42281,2,6,4,40,48,2048
42135,42135,8AC8B1E6CB950C4620C9ADD9BF2E2AE1,10951,9,11,2,29,48,1498
42136,42136,8AC8B1E6CB950C4620C9ADD9BF2E2AE1,42071,14,21,7,31,49,1599
42140,42140,559777BBBCD664850DC1E8E7503633C6,10351,1,14,13,28,45,1445
42141,42141,559777BBBCD664850DC1E8E7503633C6,42531,16,17,1,31,45,1595
42142,42142,559777BBBCD664850DC1E8E7503633C6,42491,19,20,1,32,46,1646
42143,42143,559777BBBCD664850DC1E8E7503633C6,11861,20,23,3,32,47,1647
42144,42144,DF6451E86EE4B7B98BCA60FC558F51EE,11151,0,3,3,30,48,1548
42145,42145,DF6451E86EE4B7B98BCA60FC558F51EE,11061,6,7,1,29,48,1498
42146,42146,DF6451E86EE4B7B98BCA60FC558F51EE,12121,11,15,4,29,47,1497
42147,42147,DF6451E86EE4B7B98BCA60FC558F51EE,11061,19,20,1,29,48,1498
42148,42148,DF6451E86EE4B7B98BCA60FC558F51EE,11151,22,23,1,30,48,1548
42168,42168,3AE63A5055E736CBCC5634D603296607,11461,0,7,7,37,49,1899
42169,42169,3AE63A5055E736CBCC5634D603296607,10401,12,13,1,33,49,1699
42170,42170,3AE63A5055E736CBCC5634D603296607,12971,13,14,1,32,48,1648
42171,42171,3AE63A5055E736CBCC5634D603296607,11231,15,23,8,37,49,1899
42175,42175,0C653DC860B823A0FBD73915967D7A74,13341,0,5,5,44,45,2245
42176,42176,0C653DC860B823A0FBD73915967D7A74,42631,7,11,4,43,45,2195
42177,42177,0C653DC860B823A0FBD73915967D7A74,12221,14,15,1,43,44,2194
42178,42178,0C653DC860B823A0FBD73915967D7A74,42631,17,18,1,43,45,2195
42179,42179,0C653DC860B823A0FBD73915967D7A74,13341,19,21,2,44,45,2245
42183,42183,5E8BB1A9FDE1AFD08848003FB8A60E0E,40673,0,8,8,36,48,1848
42184,42184,5E8BB1A9FDE1AFD08848003FB8A60E0E,43731,10,11,1,34,47,1747
42185,42185,5E8BB1A9FDE1AFD08848003FB8A60E0E,40673,12,13,1,36,48,1848
42186,42186,5E8BB1A9FDE1AFD08848003FB8A60E0E,10971,15,16,1,35,47,1797
42187,42187,5E8BB1A9FDE1AFD08848003FB8A60E0E,40673,18,23,5,36,48,1848
42188,42188,5035F765D303F0FAB3342A6F7FF56448,42623,5,6,1,22,49,1149
42189,42189,5035F765D303F0FAB3342A6F7FF56448,11954,13,18,5,32,49,1649
42190,42190,5035F765D303F0FAB3342A6F7FF56448,42071,18,21,3,31,49,1599
42195,42195,AB344DE4B941A811FEF62BEEA16971A6,43471,0,9,9,31,49,1599
42196,42196,AB344DE4B941A811FEF62BEEA16971A6,12971,9,12,3,32,48,1648
42197,42197,AB344DE4B941A811FEF62BEEA16971A6,43181,21,23,2,39,48,1998
42201,42201,F446BD66986C8D0106C0CF1D69F54FAE,42151,0,7,7,35,45,1795
42202,42202,F446BD66986C8D0106C0CF1D69F54FAE,13671,7,12,5,27,43,1393
42203,42203,F446BD66986C8D0106C0CF1D69F54FAE,42151,16,22,6,35,45,1795
42204,42204,1A71FA18AA428C4DDAD1FCB8BD6DCCEA,42281,0,7,7,40,48,2048
42205,42205,1A71FA18AA428C4DDAD1FCB8BD6DCCEA,11211,7,9,2,34,49,1749
42206,42206,1A71FA18AA428C4DDAD1FCB8BD6DCCEA,10401,10,12,2,33,49,1699
42207,42207,1A71FA18AA428C4DDAD1FCB8BD6DCCEA,12083,13,15,2,36,49,1849
42208,42208,1A71FA18AA428C4DDAD1FCB8BD6DCCEA,11211,15,21,6,34,49,1749
42212,42212,096291A7826A281BB9AE079B593A0255,42691,1,12,11,24,48,1248
42213,42213,096291A7826A281BB9AE079B593A0255,11361,12,13,1,22,48,1148
42214,42214,096291A7826A281BB9AE079B593A0255,12581,15,17,2,24,48,1248
42215,42215,096291A7826A281BB9AE079B593A0255,11201,19,21,2,35,49,1799
42216,42216,288D369FF27C2F58011E60F4D93BD67B,11061,1,7,6,29,48,1498
42217,42217,288D369FF27C2F58011E60F4D93BD67B,11861,8,9,1,32,47,1647
42218,42218,288D369FF27C2F58011E60F4D93BD67B,11061,13,14,1,29,48,1498
42219,42219,288D369FF27C2F58011E60F4D93BD67B,11381,15,16,1,30,47,1547
42220,42220,288D369FF27C2F58011E60F4D93BD67B,43761,19,20,1,32,47,1647
42221,42221,288D369FF27C2F58011E60F4D93BD67B,11061,22,23,1,29,48,1498
42229,42229,070FBAC74203F15EE9C689471AF11573,40242,0,9,9,36,49,1849
42230,42230,070FBAC74203F15EE9C689471AF11573,43391,13,14,1,29,48,1498
42231,42231,070FBAC74203F15EE9C689471AF11573,40242,17,18,1,36,49,1849
42235,42235,12CD49247659842CCDEA8C017DBD960B,13471,0,4,4,47,49,2399
42236,42236,12CD49247659842CCDEA8C017DBD960B,11701,6,16,10,43,48,2198
42237,42237,12CD49247659842CCDEA8C017DBD960B,13471,18,21,3,47,49,2399
42244,42244,7300FFB733BFFEA187DB110E4D4DC3D2,49201,0,1,1,7,41,391
42245,42245,7300FFB733BFFEA187DB110E4D4DC3D2,19181,5,6,1,8,40,440
42246,42246,7300FFB733BFFEA187DB110E4D4DC3D2,12921,9,12,3,9,41,491
42247,42247,7300FFB733BFFEA187DB110E4D4DC3D2,19181,13,14,1,8,40,440
42248,42248,7300FFB733BFFEA187DB110E4D4DC3D2,12921,15,19,4,9,41,491
42249,42249,7300FFB733BFFEA187DB110E4D4DC3D2,49201,19,20,1,7,41,391
42254,42254,11FECEE7865049CDA55CAB34FACD3089,15391,0,7,7,35,26,1776
42255,42255,11FECEE7865049CDA55CAB34FACD3089,11871,12,13,1,29,46,1496
42256,42256,11FECEE7865049CDA55CAB34FACD3089,11061,15,17,2,29,48,1498
42257,42257,11FECEE7865049CDA55CAB34FACD3089,11875,21,23,2,30,46,1546
42265,42265,886E2D7F4784182ED324B3C76B8399C9,12051,0,12,12,20,47,1047
42266,42266,886E2D7F4784182ED324B3C76B8399C9,12581,15,16,1,24,48,1248
42267,42267,886E2D7F4784182ED324B3C76B8399C9,12051,19,20,1,20,47,1047
42268,42268,CDBC81E4D19722F29366755075477C21,13651,0,4,4,30,47,1547
42269,42269,CDBC81E4D19722F29366755075477C21,42521,5,7,2,31,47,1597
42270,42270,CDBC81E4D19722F29366755075477C21,13651,9,15,6,30,47,1547
42271,42271,CDBC81E4D19722F29366755075477C21,11791,18,23,5,38,49,1949
42272,42272,73701CC9434D9172C828A8DD1EB9C8FD,19114,0,6,6,7,43,393
42273,42273,73701CC9434D9172C828A8DD1EB9C8FD,12921,7,9,2,9,41,491
42274,42274,73701CC9434D9172C828A8DD1EB9C8FD,49201,10,11,1,7,41,391
42275,42275,73701CC9434D9172C828A8DD1EB9C8FD,19114,12,13,1,7,43,393
42276,42276,73701CC9434D9172C828A8DD1EB9C8FD,49201,15,18,3,7,41,391
42277,42277,73701CC9434D9172C828A8DD1EB9C8FD,19114,20,22,2,7,43,393
42278,42278,1FA24F76587DEEEE9ED93C46D3D68950,42371,1,2,1,34,46,1746
42279,42279,1FA24F76587DEEEE9ED93C46D3D68950,12491,2,3,1,36,43,1843
42280,42280,1FA24F76587DEEEE9ED93C46D3D68950,42861,3,5,2,37,44,1894
42281,42281,1FA24F76587DEEEE9ED93C46D3D68950,42371,8,18,10,34,46,1746
42285,42285,2D3C63D05872EB19B4F311BB51B82DFD,11021,1,15,14,36,49,1849
42286,42286,2D3C63D05872EB19B4F311BB51B82DFD,40341,15,17,2,23,49,1199
42287,42287,2D3C63D05872EB19B4F311BB51B82DFD,11021,21,23,2,36,49,1849
42291,42291,A4FB037706170157DA9B94939FEE9474,11001,2,7,5,42,47,2147
42292,42292,A4FB037706170157DA9B94939FEE9474,10841,11,17,6,37,47,1897
42293,42293,A4FB037706170157DA9B94939FEE9474,11941,19,21,2,37,46,1896
42294,42294,AB33B0C33D5A8AB69BB147D674F32282,19031,0,2,2,1,42,92
42295,42295,AB33B0C33D5A8AB69BB147D674F32282,19744,3,6,3,6,43,343
42296,42296,AB33B0C33D5A8AB69BB147D674F32282,19031,6,23,17,1,42,92
42297,42297,ACB971F1F5FC2426FE94D1AF3C5A3F58,12381,0,4,4,32,48,1648
42298,42298,ACB971F1F5FC2426FE94D1AF3C5A3F58,42091,5,9,4,43,46,2196
42299,42299,ACB971F1F5FC2426FE94D1AF3C5A3F58,10107,10,11,1,38,49,1949
42300,42300,ACB971F1F5FC2426FE94D1AF3C5A3F58,42091,18,23,5,43,46,2196
42309,42309,3C5EB3D934314AD006AD5B79ACDC766A,43644,6,7,1,14,38,738
42310,42310,3C5EB3D934314AD006AD5B79ACDC766A,12921,10,11,1,9,41,491
42311,42311,3C5EB3D934314AD006AD5B79ACDC766A,19261,15,22,7,6,37,337
42312,42312,7C5210855A5DFB6ACF7A087ADA0E2F3D,12311,0,5,5,30,44,1544
42313,42313,7C5210855A5DFB6ACF7A087ADA0E2F3D,13911,6,8,2,39,46,1996
42314,42314,7C5210855A5DFB6ACF7A087ADA0E2F3D,42231,11,12,1,37,46,1896
42315,42315,7C5210855A5DFB6ACF7A087ADA0E2F3D,13911,16,17,1,39,46,1996
42316,42316,7C5210855A5DFB6ACF7A087ADA0E2F3D,42231,18,19,1,37,46,1896
42317,42317,7C5210855A5DFB6ACF7A087ADA0E2F3D,13911,20,22,2,39,46,1996
42318,42318,7C5210855A5DFB6ACF7A087ADA0E2F3D,42231,22,23,1,37,46,1896
42328,42328,39A12A7E8C423731CE90191A15A5C3F4,43021,0,4,4,16,43,843
42329,42329,39A12A7E8C423731CE90191A15A5C3F4,12641,4,5,1,10,43,543
42330,42330,39A12A7E8C423731CE90191A15A5C3F4,12921,6,10,4,9,41,491
42331,42331,39A12A7E8C423731CE90191A15A5C3F4,43021,12,14,2,16,43,843
42332,42332,39A12A7E8C423731CE90191A15A5C3F4,12921,14,19,5,9,41,491
42333,42333,39A12A7E8C423731CE90191A15A5C3F4,12641,19,21,2,10,43,543
42334,42334,42450E4607B078BD3F39C67BF93F8737,11111,0,8,8,26,48,1348
42335,42335,42450E4607B078BD3F39C67BF93F8737,11151,11,17,6,30,48,1548
42336,42336,42450E4607B078BD3F39C67BF93F8737,12021,18,22,4,37,49,1899
42337,42337,294FB4B8E5D6BF128BF9CA2E5243FA86,10161,0,7,7,35,49,1799
42338,42338,294FB4B8E5D6BF128BF9CA2E5243FA86,11211,11,12,1,34,49,1749
42339,42339,294FB4B8E5D6BF128BF9CA2E5243FA86,11021,13,14,1,36,49,1849
42340,42340,294FB4B8E5D6BF128BF9CA2E5243FA86,13561,15,16,1,37,49,1899
42341,42341,294FB4B8E5D6BF128BF9CA2E5243FA86,10161,18,23,5,35,49,1799
42342,42342,64EA873D359181A561255128009EB239,42581,0,4,4,38,48,1948
42343,42343,64EA873D359181A561255128009EB239,11914,6,11,5,37,48,1898
42344,42344,64EA873D359181A561255128009EB239,42581,11,12,1,38,48,1948
42345,42345,64EA873D359181A561255128009EB239,11914,15,18,3,37,48,1898
42346,42346,64EA873D359181A561255128009EB239,42581,22,23,1,38,48,1948
42347,42347,FCC81FB1D89F2E284C3312E5101F2149,42151,0,6,6,35,45,1795
42348,42348,FCC81FB1D89F2E284C3312E5101F2149,42861,8,10,2,37,44,1894
42349,42349,FCC81FB1D89F2E284C3312E5101F2149,42151,11,14,3,35,45,1795
42350,42350,FCC81FB1D89F2E284C3312E5101F2149,42861,17,18,1,37,44,1894
42351,42351,FCC81FB1D89F2E284C3312E5101F2149,42151,22,23,1,35,45,1795
42355,42355,7179E8D23C9EF0FE56A034B0F52DF3EB,42623,3,6,3,22,49,1149
42356,42356,7179E8D23C9EF0FE56A034B0F52DF3EB,11151,7,8,1,30,48,1548
42357,42357,7179E8D23C9EF0FE56A034B0F52DF3EB,42623,10,12,2,22,49,1149
42358,42358,7179E8D23C9EF0FE56A034B0F52DF3EB,42071,13,15,2,31,49,1599
42359,42359,7179E8D23C9EF0FE56A034B0F52DF3EB,42623,16,23,7,22,49,1149
42360,42360,CAD1FFF41FBB07303E4F900E7ED6962A,43391,0,6,6,29,48,1498
42361,42361,CAD1FFF41FBB07303E4F900E7ED6962A,40691,8,17,9,42,48,2148
42362,42362,CAD1FFF41FBB07303E4F900E7ED6962A,11701,18,19,1,43,48,2198
42363,42363,CAD1FFF41FBB07303E4F900E7ED6962A,11061,21,23,2,29,48,1498
42364,42364,C48A2131ED4AF3611EE267706D412806,13651,0,7,7,30,47,1547
42365,42365,C48A2131ED4AF3611EE267706D412806,43181,8,9,1,39,48,1998
42366,42366,C48A2131ED4AF3611EE267706D412806,11381,14,17,3,30,47,1547
42367,42367,C48A2131ED4AF3611EE267706D412806,11551,20,23,3,39,49,1999
42371,42371,00ED2280FB2BEC22D8FB36F8A7AFB1A5,42791,0,7,7,35,45,1795
42372,42372,00ED2280FB2BEC22D8FB36F8A7AFB1A5,10271,10,11,1,37,46,1896
42373,42373,00ED2280FB2BEC22D8FB36F8A7AFB1A5,10351,11,12,1,28,45,1445
42374,42374,00ED2280FB2BEC22D8FB36F8A7AFB1A5,10271,15,17,2,37,46,1896
42375,42375,00ED2280FB2BEC22D8FB36F8A7AFB1A5,13711,18,20,2,38,46,1946
42376,42376,00ED2280FB2BEC22D8FB36F8A7AFB1A5,42151,21,23,2,35,45,1795
42377,42377,1C12FD1823A36FA85667FC8316128B0A,13331,0,3,3,38,47,1947
42378,42378,1C12FD1823A36FA85667FC8316128B0A,42301,4,7,3,36,47,1847
42379,42379,1C12FD1823A36FA85667FC8316128B0A,13331,7,10,3,38,47,1947
42380,42380,1C12FD1823A36FA85667FC8316128B0A,13121,14,20,6,38,46,1946
42381,42381,1C12FD1823A36FA85667FC8316128B0A,13331,22,23,1,38,47,1947
42382,42382,71CE75E939DBD7C24E73F9A2DFA6B85E,10221,0,14,14,34,49,1749
42383,42383,71CE75E939DBD7C24E73F9A2DFA6B85E,43671,18,19,1,35,48,1798
42384,42384,71CE75E939DBD7C24E73F9A2DFA6B85E,11074,20,22,2,37,47,1897
42385,42385,8B0DA6168EF35F0A187851C6201FC197,43761,2,12,10,32,47,1647
42386,42386,8B0DA6168EF35F0A187851C6201FC197,11231,15,18,3,37,49,1899
42387,42387,8B0DA6168EF35F0A187851C6201FC197,43761,21,23,2,32,47,1647
42394,42394,F6D5F0720A4C82E72FD0C591B5570DDC,43471,0,8,8,31,49,1599
42395,42395,F6D5F0720A4C82E72FD0C591B5570DDC,43061,10,13,3,43,46,2196
42396,42396,F6D5F0720A4C82E72FD0C591B5570DDC,10381,14,23,9,31,49,1599
42397,42397,3668A484BABF64A24B33B58BBBC417A2,42491,0,14,14,32,46,1646
42398,42398,3668A484BABF64A24B33B58BBBC417A2,42633,15,17,2,42,46,2146
42399,42399,3668A484BABF64A24B33B58BBBC417A2,42501,18,20,2,28,47,1447
42400,42400,3668A484BABF64A24B33B58BBBC417A2,13511,22,23,1,34,48,1748
42404,42404,D7349708A10855AEF98FEB8D22C33E59,40833,0,7,7,41,47,2097
42405,42405,D7349708A10855AEF98FEB8D22C33E59,11231,10,15,5,37,49,1899
42406,42406,D7349708A10855AEF98FEB8D22C33E59,40833,19,23,4,41,47,2097
42413,42413,9D7E28E179E5F5D009F8D277D0F434A8,11861,0,5,5,32,47,1647
42414,42414,9D7E28E179E5F5D009F8D277D0F434A8,42581,7,9,2,38,48,1948
42415,42415,9D7E28E179E5F5D009F8D277D0F434A8,11861,12,19,7,32,47,1647
42416,42416,9D7E28E179E5F5D009F8D277D0F434A8,10731,19,22,3,33,47,1697
42417,42417,BC9422B03E95BF5ACF5110FC545EF7FA,40637,0,2,2,36,47,1847
42418,42418,BC9422B03E95BF5ACF5110FC545EF7FA,40673,4,5,1,36,48,1848
42419,42419,BC9422B03E95BF5ACF5110FC545EF7FA,40637,6,7,1,36,47,1847
42420,42420,BC9422B03E95BF5ACF5110FC545EF7FA,12051,10,11,1,20,47,1047
42421,42421,BC9422B03E95BF5ACF5110FC545EF7FA,12601,12,13,1,25,47,1297
42422,42422,BC9422B03E95BF5ACF5110FC545EF7FA,40673,15,16,1,36,48,1848
42423,42423,BC9422B03E95BF5ACF5110FC545EF7FA,40637,18,23,5,36,47,1847
42424,42424,92E1BAA88B052422B820ED36A9E8F107,41392,0,6,6,43,48,2198
42425,42425,92E1BAA88B052422B820ED36A9E8F107,40171,6,9,3,38,48,1948
42426,42426,92E1BAA88B052422B820ED36A9E8F107,41392,11,14,3,43,48,2198
42427,42427,92E1BAA88B052422B820ED36A9E8F107,40171,15,17,2,38,48,1948
42428,42428,92E1BAA88B052422B820ED36A9E8F107,11701,20,23,3,43,48,2198
42429,42429,2917A11EB625CB868E9962150273A0D4,10301,0,7,7,31,45,1595
42430,42430,2917A11EB625CB868E9962150273A0D4,13671,12,13,1,27,43,1393
42431,42431,2917A11EB625CB868E9962150273A0D4,10431,14,17,3,33,49,1699
42432,42432,2917A11EB625CB868E9962150273A0D4,10301,18,22,4,31,45,1595
42446,42446,872183B3A170CBB8288E057DA79A27BD,10811,0,9,9,38,46,1946
42447,42447,872183B3A170CBB8288E057DA79A27BD,12021,11,13,2,37,49,1899
42448,42448,872183B3A170CBB8288E057DA79A27BD,42491,14,15,1,32,46,1646
42449,42449,872183B3A170CBB8288E057DA79A27BD,10811,16,23,7,38,46,1946
42450,42450,A36FC51CF8D96EF7C4D42DADD5566352,43081,0,2,2,27,28,1378
42451,42451,A36FC51CF8D96EF7C4D42DADD5566352,15091,6,7,1,35,26,1776
42452,42452,A36FC51CF8D96EF7C4D42DADD5566352,12792,11,23,12,34,30,1730
42453,42453,E45B0EC44E00842EDD865C65A561543D,11791,0,8,8,38,49,1949
42454,42454,E45B0EC44E00842EDD865C65A561543D,10471,8,11,3,37,48,1898
42455,42455,E45B0EC44E00842EDD865C65A561543D,11231,11,16,5,37,49,1899
42456,42456,E45B0EC44E00842EDD865C65A561543D,10471,17,20,3,37,48,1898
42457,42457,E45B0EC44E00842EDD865C65A561543D,11231,21,22,1,37,49,1899
42458,42458,0262D446D971791F20E3BB61298CD2A6,11074,0,11,11,37,47,1897
42459,42459,0262D446D971791F20E3BB61298CD2A6,10731,14,16,2,33,47,1697
42460,42460,0262D446D971791F20E3BB61298CD2A6,11331,17,18,1,37,48,1898
42461,42461,0262D446D971791F20E3BB61298CD2A6,12514,19,20,1,38,47,1947
42462,42462,0262D446D971791F20E3BB61298CD2A6,11074,21,23,2,37,47,1897
42463,42463,4CDC8B55805F54C701951AA286ACE261,42521,0,5,5,31,47,1597
42464,42464,4CDC8B55805F54C701951AA286ACE261,11954,10,16,6,32,49,1649
42465,42465,4CDC8B55805F54C701951AA286ACE261,11751,21,22,1,35,48,1798
42466,42466,8436FA510D59B3814E50B7F18BD1D92C,19571,0,6,6,1,36,86
42467,42467,8436FA510D59B3814E50B7F18BD1D92C,12641,6,17,11,10,43,543
42468,42468,8436FA510D59B3814E50B7F18BD1D92C,43644,20,23,3,14,38,738
42473,42473,B587C9E11BF2CDFAA894E59FA9E36E12,42151,1,7,6,35,45,1795
42474,42474,B587C9E11BF2CDFAA894E59FA9E36E12,12311,8,13,5,30,44,1544
42475,42475,B587C9E11BF2CDFAA894E59FA9E36E12,40341,17,18,1,23,49,1199
42476,42476,B587C9E11BF2CDFAA894E59FA9E36E12,12311,21,22,1,30,44,1544
42480,42480,8A128AB67434D6E9DF4F916C5235B6B9,42401,0,11,11,36,47,1847
42481,42481,8A128AB67434D6E9DF4F916C5235B6B9,11074,13,14,1,37,47,1897
42482,42482,8A128AB67434D6E9DF4F916C5235B6B9,10251,15,17,2,35,47,1797
42483,42483,8A128AB67434D6E9DF4F916C5235B6B9,42321,19,20,1,43,47,2197
42484,42484,8A128AB67434D6E9DF4F916C5235B6B9,10111,21,23,2,37,47,1897
42488,42488,2CB91117B8C0592A65F2A476D7776E07,10771,1,8,7,41,46,2096
42489,42489,2CB91117B8C0592A65F2A476D7776E07,12561,13,19,6,45,43,2293
42490,42490,2CB91117B8C0592A65F2A476D7776E07,42461,21,23,2,45,47,2297
42491,42491,34A498ECBF094B1655F6385A2FF4F5D2,11361,1,8,7,22,48,1148
42492,42492,34A498ECBF094B1655F6385A2FF4F5D2,11914,10,11,1,37,48,1898
42493,42493,34A498ECBF094B1655F6385A2FF4F5D2,11361,11,23,12,22,48,1148
42498,42498,1C0548F40841AD0870DAD8EC7BECCBC6,13314,0,7,7,31,39,1589
42499,42499,1C0548F40841AD0870DAD8EC7BECCBC6,12521,8,9,1,35,41,1791
42500,42500,1C0548F40841AD0870DAD8EC7BECCBC6,13314,11,13,2,31,39,1589
42501,42501,1C0548F40841AD0870DAD8EC7BECCBC6,12521,13,14,1,35,41,1791
42502,42502,1C0548F40841AD0870DAD8EC7BECCBC6,13314,15,23,8,31,39,1589
42506,42506,E648A6F090A3BE85617E0ED54A73B4F0,12601,0,3,3,25,47,1297
42507,42507,E648A6F090A3BE85617E0ED54A73B4F0,12671,4,7,3,21,43,1093
42508,42508,E648A6F090A3BE85617E0ED54A73B4F0,12601,8,13,5,25,47,1297
42509,42509,E648A6F090A3BE85617E0ED54A73B4F0,12671,13,15,2,21,43,1093
42510,42510,E648A6F090A3BE85617E0ED54A73B4F0,12601,16,23,7,25,47,1297
42511,42511,3C07D1557002BF4F1AA6A6D7A8949EF2,42523,0,6,6,31,47,1597
42512,42512,3C07D1557002BF4F1AA6A6D7A8949EF2,12601,7,17,10,25,47,1297
42513,42513,3C07D1557002BF4F1AA6A6D7A8949EF2,42523,18,20,2,31,47,1597
42517,42517,DD11EC5E596BBBC5A00C9F6952DD9EC0,10281,1,8,7,33,48,1698
42518,42518,DD11EC5E596BBBC5A00C9F6952DD9EC0,11021,13,15,2,36,49,1849
42519,42519,DD11EC5E596BBBC5A00C9F6952DD9EC0,10281,16,20,4,33,48,1698
42520,42520,DD11EC5E596BBBC5A00C9F6952DD9EC0,11461,21,22,1,37,49,1899
42521,42521,D9419B851F8839F5D675C951F631DB8E,10921,0,7,7,43,48,2198
42522,42522,D9419B851F8839F5D675C951F631DB8E,43101,8,17,9,46,40,2340
42523,42523,D9419B851F8839F5D675C951F631DB8E,10921,19,23,4,43,48,2198
42524,42524,2F66AC01887397A198C9CCA6611EA97B,12521,0,6,6,35,41,1791
42525,42525,2F66AC01887397A198C9CCA6611EA97B,13314,8,9,1,31,39,1589
42526,42526,2F66AC01887397A198C9CCA6611EA97B,12521,9,23,14,35,41,1791
42531,42531,62A4DF59E8BCEC0DCF6C971E2D9209AC,13711,1,5,4,38,46,1946
42532,42532,62A4DF59E8BCEC0DCF6C971E2D9209AC,11021,8,16,8,36,49,1849
42533,42533,62A4DF59E8BCEC0DCF6C971E2D9209AC,10271,19,23,4,37,46,1896
42537,42537,F37F3F6EE44D5E50ACC3545985E675A1,19114,0,8,8,7,43,393
42538,42538,F37F3F6EE44D5E50ACC3545985E675A1,12641,9,10,1,10,43,543
42539,42539,F37F3F6EE44D5E50ACC3545985E675A1,19114,11,13,2,7,43,393
42540,42540,F37F3F6EE44D5E50ACC3545985E675A1,12641,15,16,1,10,43,543
42541,42541,F37F3F6EE44D5E50ACC3545985E675A1,19114,16,23,7,7,43,393
42542,42542,DE3DB069CF0A068ED881835170BAD55A,43021,0,4,4,16,43,843
42543,42543,DE3DB069CF0A068ED881835170BAD55A,12921,8,9,1,9,41,491
42544,42544,DE3DB069CF0A068ED881835170BAD55A,12641,14,16,2,10,43,543
42545,42545,DE3DB069CF0A068ED881835170BAD55A,12921,17,19,2,9,41,491
42549,42549,65B75E82020367859A22E7DE9545AC27,40891,0,7,7,37,47,1897
42550,42550,65B75E82020367859A22E7DE9545AC27,11381,7,10,3,30,47,1547
42551,42551,65B75E82020367859A22E7DE9545AC27,42511,12,23,11,37,47,1897
42555,42555,17E9510A8DA02573EB1D3840D8B93074,42071,1,4,3,31,49,1599
42556,42556,17E9510A8DA02573EB1D3840D8B93074,10451,8,11,3,25,48,1298
42557,42557,17E9510A8DA02573EB1D3840D8B93074,42071,18,23,5,31,49,1599
42558,42558,9BBBC00C93BA6A3176E2B008E6F8A88E,42351,2,5,3,38,45,1945
42559,42559,9BBBC00C93BA6A3176E2B008E6F8A88E,11261,6,11,5,36,46,1846
42560,42560,9BBBC00C93BA6A3176E2B008E6F8A88E,13911,11,13,2,39,46,1996
42561,42561,9BBBC00C93BA6A3176E2B008E6F8A88E,11261,13,16,3,36,46,1846
42562,42562,9BBBC00C93BA6A3176E2B008E6F8A88E,13911,16,17,1,39,46,1996
42563,42563,9BBBC00C93BA6A3176E2B008E6F8A88E,11261,17,22,5,36,46,1846
42575,42575,A1B1493AD1E4959D25E397CB780FB65E,42531,1,5,4,31,45,1595
42576,42576,A1B1493AD1E4959D25E397CB780FB65E,12311,7,8,1,30,44,1544
42577,42577,A1B1493AD1E4959D25E397CB780FB65E,42871,11,12,1,30,45,1545
42578,42578,A1B1493AD1E4959D25E397CB780FB65E,42531,13,14,1,31,45,1595
42579,42579,A1B1493AD1E4959D25E397CB780FB65E,12661,17,19,2,32,45,1645
42580,42580,A1B1493AD1E4959D25E397CB780FB65E,42531,19,22,3,31,45,1595
42581,42581,151AF07FE1353F98EA8933566E4D900D,12921,0,19,19,9,41,491
42582,42582,151AF07FE1353F98EA8933566E4D900D,43021,20,21,1,16,43,843
42583,42583,151AF07FE1353F98EA8933566E4D900D,12921,22,23,1,9,41,491
42587,42587,8A524E85431660319A09E8D071AC107B,42321,0,5,5,43,47,2197
42588,42588,8A524E85431660319A09E8D071AC107B,12601,10,11,1,25,47,1297
42589,42589,8A524E85431660319A09E8D071AC107B,13091,12,13,1,20,42,1042
42590,42590,8A524E85431660319A09E8D071AC107B,12601,14,17,3,25,47,1297
42591,42591,8A524E85431660319A09E8D071AC107B,42321,21,23,2,43,47,2197
42592,42592,649CA0B4C9C73F10630BCAC6C100E533,42531,6,7,1,31,45,1595
42593,42593,649CA0B4C9C73F10630BCAC6C100E533,12311,7,10,3,30,44,1544
42594,42594,649CA0B4C9C73F10630BCAC6C100E533,42151,11,12,1,35,45,1795
42595,42595,649CA0B4C9C73F10630BCAC6C100E533,12311,13,17,4,30,44,1544
42596,42596,649CA0B4C9C73F10630BCAC6C100E533,42151,19,23,4,35,45,1795
42597,42597,0BF9081B921E7C1EC68F2248D31F0D32,16281,9,11,2,11,4,554
42598,42598,0BF9081B921E7C1EC68F2248D31F0D32,15143,12,13,1,18,7,907
42599,42599,0BF9081B921E7C1EC68F2248D31F0D32,16281,15,18,3,11,4,554
42600,42600,0BF9081B921E7C1EC68F2248D31F0D32,15143,19,20,1,18,7,907
42613,42613,FF16D1104349162E539969031BE39A02,12511,2,3,1,39,47,1997
42614,42614,FF16D1104349162E539969031BE39A02,12514,5,7,2,38,47,1947
42615,42615,FF16D1104349162E539969031BE39A02,12511,9,13,4,39,47,1997
42616,42616,FF16D1104349162E539969031BE39A02,12514,16,19,3,38,47,1947
42617,42617,FF16D1104349162E539969031BE39A02,43481,19,22,3,39,48,1998
42635,42635,0B929ACA970011AFF649AD1CE667839A,12921,1,7,6,9,41,491
42636,42636,0B929ACA970011AFF649AD1CE667839A,43021,8,12,4,16,43,843
42637,42637,0B929ACA970011AFF649AD1CE667839A,12921,13,14,1,9,41,491
42638,42638,0B929ACA970011AFF649AD1CE667839A,43021,14,23,9,16,43,843
42639,42639,445C282EC1EF2D9CD074B953D3F4BD6F,11324,5,7,2,31,46,1596
42640,42640,445C282EC1EF2D9CD074B953D3F4BD6F,11151,8,14,6,30,48,1548
42641,42641,445C282EC1EF2D9CD074B953D3F4BD6F,11061,16,17,1,29,48,1498
42642,42642,445C282EC1EF2D9CD074B953D3F4BD6F,11151,17,19,2,30,48,1548
42643,42643,445C282EC1EF2D9CD074B953D3F4BD6F,42071,19,20,1,31,49,1599
42654,42654,253A422C6572FACDA35B610A2E4ABDE3,15441,0,5,5,44,20,2220
42655,42655,253A422C6572FACDA35B610A2E4ABDE3,15171,8,9,1,42,21,2121
42656,42656,253A422C6572FACDA35B610A2E4ABDE3,15441,13,14,1,44,20,2220
42657,42657,253A422C6572FACDA35B610A2E4ABDE3,12881,14,16,2,47,22,2372
42658,42658,253A422C6572FACDA35B610A2E4ABDE3,15441,18,20,2,44,20,2220
42659,42659,D6B662C0D72BBB94314A69A6BE13D66E,43761,0,8,8,32,47,1647
42660,42660,D6B662C0D72BBB94314A69A6BE13D66E,10841,12,13,1,37,47,1897
42661,42661,D6B662C0D72BBB94314A69A6BE13D66E,10731,15,16,1,33,47,1697
42662,42662,D6B662C0D72BBB94314A69A6BE13D66E,43761,19,23,4,32,47,1647
42663,42663,E32E32E885662E60289D48F3D2242235,43471,1,9,8,31,49,1599
42664,42664,E32E32E885662E60289D48F3D2242235,11491,11,13,2,36,47,1847
42665,42665,E32E32E885662E60289D48F3D2242235,43471,18,19,1,31,49,1599
42666,42666,E32E32E885662E60289D48F3D2242235,11201,20,21,1,35,49,1799
42667,42667,E32E32E885662E60289D48F3D2242235,40872,22,23,1,30,49,1549
42671,42671,FAB7310BEC2AACEAAB0173BD441351AC,42871,3,5,2,30,45,1545
42672,42672,FAB7310BEC2AACEAAB0173BD441351AC,12311,8,10,2,30,44,1544
42673,42673,FAB7310BEC2AACEAAB0173BD441351AC,11871,13,14,1,29,46,1496
42674,42674,FAB7310BEC2AACEAAB0173BD441351AC,42871,15,16,1,30,45,1545
42675,42675,FAB7310BEC2AACEAAB0173BD441351AC,11871,19,22,3,29,46,1496
42676,42676,DE315A9B98B8B286B43F502CB8D73C57,43191,0,8,8,40,49,2049
42677,42677,DE315A9B98B8B286B43F502CB8D73C57,10421,9,14,5,41,48,2098
42678,42678,DE315A9B98B8B286B43F502CB8D73C57,43151,14,15,1,40,49,2049
42679,42679,DE315A9B98B8B286B43F502CB8D73C57,13351,18,22,4,48,48,2448
42680,42680,34CC2E0F290DBAD6162BFABEC143C619,19264,9,12,3,10,36,536
42681,42681,34CC2E0F290DBAD6162BFABEC143C619,19261,16,17,1,6,37,337
42682,42682,34CC2E0F290DBAD6162BFABEC143C619,43644,18,20,2,14,38,738
42683,42683,85061C43999146706723F4E0700EE955,13911,0,7,7,39,46,1996
42684,42684,85061C43999146706723F4E0700EE955,42231,7,11,4,37,46,1896
42685,42685,85061C43999146706723F4E0700EE955,13911,12,13,1,39,46,1996
42686,42686,85061C43999146706723F4E0700EE955,11261,14,16,2,36,46,1846
42687,42687,85061C43999146706723F4E0700EE955,42231,17,18,1,37,46,1896
42699,42699,2D9F8EEE0946858BEC66856CB73B8335,12921,5,10,5,9,41,491
42700,42700,2D9F8EEE0946858BEC66856CB73B8335,43021,10,12,2,16,43,843
42701,42701,2D9F8EEE0946858BEC66856CB73B8335,12921,15,19,4,9,41,491
42702,42702,2D9F8EEE0946858BEC66856CB73B8335,43021,19,20,1,16,43,843
42703,42703,35DAC6756C7F4B57C2B1C6F65896CD31,12601,2,4,2,25,47,1297
42704,42704,35DAC6756C7F4B57C2B1C6F65896CD31,10351,6,14,8,28,45,1445
42705,42705,35DAC6756C7F4B57C2B1C6F65896CD31,12601,17,18,1,25,47,1297
42710,42710,AC9A35D001464E087369411DD671E08D,42301,0,6,6,36,47,1847
42711,42711,AC9A35D001464E087369411DD671E08D,19431,9,12,3,8,29,429
42712,42712,AC9A35D001464E087369411DD671E08D,42161,16,20,4,36,47,1847
42713,42713,AC9A35D001464E087369411DD671E08D,43361,20,23,3,38,48,1948
42714,42714,EC909F98ED0E6EF5A40A37FA5726A995,10901,0,3,3,35,48,1798
42715,42715,EC909F98ED0E6EF5A40A37FA5726A995,13511,3,5,2,34,48,1748
42716,42716,EC909F98ED0E6EF5A40A37FA5726A995,10251,5,12,7,35,47,1797
42717,42717,EC909F98ED0E6EF5A40A37FA5726A995,11061,13,18,5,29,48,1498
42718,42718,EC909F98ED0E6EF5A40A37FA5726A995,42231,19,20,1,37,46,1896
42719,42719,EC909F98ED0E6EF5A40A37FA5726A995,42161,21,23,2,36,47,1847
42720,42720,0E91A13D0E931F32EE1FFD96FA252798,42381,0,6,6,39,41,1991
42721,42721,0E91A13D0E931F32EE1FFD96FA252798,42151,8,16,8,35,45,1795
42722,42722,0E91A13D0E931F32EE1FFD96FA252798,13071,19,22,3,41,41,2091
42723,42723,A7CD79686A076BFDAD2F291D2D57B5D6,10251,0,9,9,35,47,1797
42724,42724,A7CD79686A076BFDAD2F291D2D57B5D6,11651,9,10,1,33,47,1697
42725,42725,A7CD79686A076BFDAD2F291D2D57B5D6,10251,12,15,3,35,47,1797
42726,42726,A7CD79686A076BFDAD2F291D2D57B5D6,42921,15,17,2,33,47,1697
42727,42727,A7CD79686A076BFDAD2F291D2D57B5D6,43731,18,19,1,34,47,1747
42728,42728,A7CD79686A076BFDAD2F291D2D57B5D6,10251,21,23,2,35,47,1797
42733,42733,95E46EDC59FF5DC7B2780E8A91CFB9BB,19114,0,6,6,7,43,393
42734,42734,95E46EDC59FF5DC7B2780E8A91CFB9BB,19111,7,9,2,9,45,495
42735,42735,95E46EDC59FF5DC7B2780E8A91CFB9BB,12921,9,11,2,9,41,491
42736,42736,95E46EDC59FF5DC7B2780E8A91CFB9BB,19114,12,13,1,7,43,393
42737,42737,95E46EDC59FF5DC7B2780E8A91CFB9BB,12921,14,16,2,9,41,491
42738,42738,95E46EDC59FF5DC7B2780E8A91CFB9BB,19114,17,23,6,7,43,393
42739,42739,08B22EEE6E957330DAD27E7217103ACF,13071,0,7,7,41,41,2091
42740,42740,08B22EEE6E957330DAD27E7217103ACF,42381,7,8,1,39,41,1991
42741,42741,08B22EEE6E957330DAD27E7217103ACF,11914,12,14,2,37,48,1898
42742,42742,08B22EEE6E957330DAD27E7217103ACF,43011,16,18,2,40,42,2042
42743,42743,08B22EEE6E957330DAD27E7217103ACF,11914,20,22,2,37,48,1898
42754,42754,7891B7CAFE636F79B910CD86C28C9F07,43161,0,1,1,35,47,1797
42755,42755,7891B7CAFE636F79B910CD86C28C9F07,10281,2,4,2,33,48,1698
42756,42756,7891B7CAFE636F79B910CD86C28C9F07,43161,5,6,1,35,47,1797
42757,42757,7891B7CAFE636F79B910CD86C28C9F07,13961,19,20,1,42,48,2148
42758,42758,7891B7CAFE636F79B910CD86C28C9F07,11301,20,23,3,41,49,2099
42759,42759,2770DAF26F856B8C604C0FF1601A7902,19031,0,4,4,1,42,92
42760,42760,2770DAF26F856B8C604C0FF1601A7902,12921,5,7,2,9,41,491
42761,42761,2770DAF26F856B8C604C0FF1601A7902,19031,12,18,6,1,42,92
42762,42762,360CAB205F052520FED1AC4C9779857A,42523,1,8,7,31,47,1597
42763,42763,360CAB205F052520FED1AC4C9779857A,43761,8,10,2,32,47,1647
42764,42764,360CAB205F052520FED1AC4C9779857A,42231,12,14,2,37,46,1896
42765,42765,360CAB205F052520FED1AC4C9779857A,12161,18,20,2,32,46,1646
42766,42766,B6B0375BFA2C1ACA985FC18F0886DD84,10491,1,8,7,33,48,1698
42767,42767,B6B0375BFA2C1ACA985FC18F0886DD84,10611,9,10,1,32,48,1648
42768,42768,B6B0375BFA2C1ACA985FC18F0886DD84,10221,12,14,2,34,49,1749
42769,42769,B6B0375BFA2C1ACA985FC18F0886DD84,40073,14,16,2,37,48,1898
42770,42770,B6B0375BFA2C1ACA985FC18F0886DD84,13741,16,20,4,37,49,1899
42774,42774,EDC6874ABD6F7BEFD833FD9685C8AB3C,11211,0,15,15,34,49,1749
42775,42775,EDC6874ABD6F7BEFD833FD9685C8AB3C,10421,17,19,2,41,48,2098
42776,42776,EDC6874ABD6F7BEFD833FD9685C8AB3C,10107,19,22,3,38,49,1949
42780,42780,8285E7CFD2208E724767098E1AD19936,19024,3,9,6,9,45,495
42781,42781,8285E7CFD2208E724767098E1AD19936,42041,14,17,3,10,47,547
42782,42782,8285E7CFD2208E724767098E1AD19936,19821,18,20,2,4,46,246
42783,42783,8285E7CFD2208E724767098E1AD19936,19024,21,23,2,9,45,495
42784,42784,3C8677E9E8B20808A9E56DEC1E101AB0,11541,1,10,9,35,49,1799
42785,42785,3C8677E9E8B20808A9E56DEC1E101AB0,40341,11,15,4,23,49,1199
42786,42786,3C8677E9E8B20808A9E56DEC1E101AB0,11541,15,22,7,35,49,1799
42795,42795,21D029E4FB71F3A5DA880019FDFB9BC1,12491,0,5,5,36,43,1843
42796,42796,21D029E4FB71F3A5DA880019FDFB9BC1,42864,6,10,4,38,44,1944
42797,42797,21D029E4FB71F3A5DA880019FDFB9BC1,12491,12,13,1,36,43,1843
42798,42798,21D029E4FB71F3A5DA880019FDFB9BC1,42151,14,18,4,35,45,1795
42799,42799,21D029E4FB71F3A5DA880019FDFB9BC1,12491,19,23,4,36,43,1843
42800,42800,9C2C2A9A5923C3E8476FE17BB2B155DD,19021,0,1,1,10,45,545
42801,42801,9C2C2A9A5923C3E8476FE17BB2B155DD,19114,1,6,5,7,43,393
42802,42802,9C2C2A9A5923C3E8476FE17BB2B155DD,12641,6,16,10,10,43,543
42803,42803,9C2C2A9A5923C3E8476FE17BB2B155DD,19114,19,22,3,7,43,393
42804,42804,2295C74F0BD2BB081A3FCDFFDED68B9C,43021,4,6,2,16,43,843
42805,42805,2295C74F0BD2BB081A3FCDFFDED68B9C,12921,7,8,1,9,41,491
42806,42806,2295C74F0BD2BB081A3FCDFFDED68B9C,12641,11,23,12,10,43,543
42807,42807,A30C524CE1CE6CCC97F57F505F7BFDED,42601,0,1,1,44,48,2248
42808,42808,A30C524CE1CE6CCC97F57F505F7BFDED,11701,2,4,2,43,48,2198
42809,42809,A30C524CE1CE6CCC97F57F505F7BFDED,42321,4,5,1,43,47,2197
42810,42810,A30C524CE1CE6CCC97F57F505F7BFDED,11701,5,6,1,43,48,2198
42811,42811,A30C524CE1CE6CCC97F57F505F7BFDED,42601,7,10,3,44,48,2248
42812,42812,A30C524CE1CE6CCC97F57F505F7BFDED,11201,12,15,3,35,49,1799
42813,42813,A30C524CE1CE6CCC97F57F505F7BFDED,41591,18,23,5,34,49,1749
42820,42820,2AAA65FF8D48E6E229451FC5A45CB446,42071,8,9,1,31,49,1599
42821,42821,2AAA65FF8D48E6E229451FC5A45CB446,42121,13,15,2,26,49,1349
42822,42822,2AAA65FF8D48E6E229451FC5A45CB446,42071,18,22,4,31,49,1599
42823,42823,0A753885BE5CDC6D1CF1B7B35F1C199C,42523,0,14,14,31,47,1597
42824,42824,0A753885BE5CDC6D1CF1B7B35F1C199C,40951,14,16,2,36,49,1849
42825,42825,0A753885BE5CDC6D1CF1B7B35F1C199C,10295,19,22,3,30,47,1547
42826,42826,F736C39F560B9A4948E68A46A6A6DDA8,41031,0,6,6,32,49,1649
42827,42827,F736C39F560B9A4948E68A46A6A6DDA8,13711,8,9,1,38,46,1946
42828,42828,F736C39F560B9A4948E68A46A6A6DDA8,41031,12,23,11,32,49,1649
42829,42829,2F8CA12038D8BFDAC42D43FF94213821,42381,0,1,1,39,41,1991
42830,42830,2F8CA12038D8BFDAC42D43FF94213821,13071,1,5,4,41,41,2091
42831,42831,2F8CA12038D8BFDAC42D43FF94213821,43451,6,11,5,37,40,1890
42832,42832,2F8CA12038D8BFDAC42D43FF94213821,42381,13,14,1,39,41,1991
42833,42833,2F8CA12038D8BFDAC42D43FF94213821,11631,19,23,4,12,49,649
42837,42837,055660D96102C90837257CF6FD6D548A,13911,1,7,6,39,46,1996
42838,42838,055660D96102C90837257CF6FD6D548A,42151,9,10,1,35,45,1795
42839,42839,055660D96102C90837257CF6FD6D548A,11261,14,15,1,36,46,1846
42840,42840,055660D96102C90837257CF6FD6D548A,13911,18,20,2,39,46,1996
42847,42847,015977F21CA69DACA3E876A5F028B2A4,13341,3,7,4,44,45,2245
42848,42848,015977F21CA69DACA3E876A5F028B2A4,43011,11,13,2,40,42,2042
42849,42849,015977F21CA69DACA3E876A5F028B2A4,42461,18,19,1,45,47,2297
42850,42850,015977F21CA69DACA3E876A5F028B2A4,43051,21,23,2,46,45,2345
42851,42851,1F87CA1D778B027B6DE06AC8BD5FBD25,13314,0,8,8,31,39,1589
42852,42852,1F87CA1D778B027B6DE06AC8BD5FBD25,12521,8,13,5,35,41,1791
42853,42853,1F87CA1D778B027B6DE06AC8BD5FBD25,13314,13,14,1,31,39,1589
42854,42854,1F87CA1D778B027B6DE06AC8BD5FBD25,10381,19,20,1,31,49,1599
42859,42859,DD628D137A372FD9F2379158E8EE3966,12921,0,8,8,9,41,491
42860,42860,DD628D137A372FD9F2379158E8EE3966,42491,9,10,1,32,46,1646
42861,42861,DD628D137A372FD9F2379158E8EE3966,12921,12,22,10,9,41,491
42865,42865,89E5A7FBADD8F5F593AB966798D6300A,11731,0,2,2,36,48,1848
42866,42866,89E5A7FBADD8F5F593AB966798D6300A,10271,3,9,6,37,46,1896
42867,42867,89E5A7FBADD8F5F593AB966798D6300A,13121,10,12,2,38,46,1946
42868,42868,89E5A7FBADD8F5F593AB966798D6300A,10271,12,15,3,37,46,1896
42869,42869,89E5A7FBADD8F5F593AB966798D6300A,10301,19,20,1,31,45,1595
42870,42870,89E5A7FBADD8F5F593AB966798D6300A,13121,21,23,2,38,46,1946
42874,42874,CC3FA096FA296BC301B8FB82BD507846,42071,0,2,2,31,49,1599
42875,42875,CC3FA096FA296BC301B8FB82BD507846,42471,6,7,1,35,49,1799
42876,42876,CC3FA096FA296BC301B8FB82BD507846,11021,11,23,12,36,49,1849
42883,42883,EDBE9058BB0B28E0915A84395E9226D9,11261,0,5,5,36,46,1846
42884,42884,EDBE9058BB0B28E0915A84395E9226D9,42861,6,8,2,37,44,1894
42885,42885,EDBE9058BB0B28E0915A84395E9226D9,11261,9,17,8,36,46,1846
42886,42886,EDBE9058BB0B28E0915A84395E9226D9,42861,18,20,2,37,44,1894
42887,42887,EDBE9058BB0B28E0915A84395E9226D9,11261,21,23,2,36,46,1846
42891,42891,C71D7298130C81422FA6CFC8CFA3EA36,11074,8,11,3,37,47,1897
42892,42892,C71D7298130C81422FA6CFC8CFA3EA36,10931,13,15,2,41,48,2098
42893,42893,C71D7298130C81422FA6CFC8CFA3EA36,13101,17,18,1,40,47,2047
42894,42894,3E3400E81F33727D0845365703B2CDF7,42961,0,7,7,35,49,1799
42895,42895,3E3400E81F33727D0845365703B2CDF7,10924,8,17,9,43,49,2199
42896,42896,3E3400E81F33727D0845365703B2CDF7,10161,20,23,3,35,49,1799
42900,42900,091DCC0237DDF0F056E1A7BFB1F57890,43021,3,6,3,16,43,843
42901,42901,091DCC0237DDF0F056E1A7BFB1F57890,19021,10,11,1,10,45,545
42902,42902,091DCC0237DDF0F056E1A7BFB1F57890,12641,13,14,1,10,43,543
42903,42903,091DCC0237DDF0F056E1A7BFB1F57890,19021,19,20,1,10,45,545
42904,42904,091DCC0237DDF0F056E1A7BFB1F57890,12641,21,23,2,10,43,543
42905,42905,2A91E3542FC9B1A56EDFF91DEB22828A,11161,0,8,8,32,48,1648
42906,42906,2A91E3542FC9B1A56EDFF91DEB22828A,12587,10,11,1,25,48,1298
42907,42907,2A91E3542FC9B1A56EDFF91DEB22828A,11201,12,13,1,35,49,1799
42908,42908,2A91E3542FC9B1A56EDFF91DEB22828A,12581,15,16,1,24,48,1248
42909,42909,2A91E3542FC9B1A56EDFF91DEB22828A,11161,19,23,4,32,48,1648
42918,42918,B20D4CCCBBF9B534BB9F26A35B371E4C,13911,3,4,1,39,46,1996
42919,42919,B20D4CCCBBF9B534BB9F26A35B371E4C,42351,6,8,2,38,45,1945
42920,42920,B20D4CCCBBF9B534BB9F26A35B371E4C,42231,8,10,2,37,46,1896
42921,42921,B20D4CCCBBF9B534BB9F26A35B371E4C,42351,10,18,8,38,45,1945
42922,42922,B20D4CCCBBF9B534BB9F26A35B371E4C,42231,19,20,1,37,46,1896
42932,42932,B89706C42E69C6D6A83DDA3D4BFBBFB0,42201,1,2,1,43,46,2196
42933,42933,B89706C42E69C6D6A83DDA3D4BFBBFB0,42111,4,5,1,44,46,2246
42934,42934,B89706C42E69C6D6A83DDA3D4BFBBFB0,42201,6,16,10,43,46,2196
42935,42935,B89706C42E69C6D6A83DDA3D4BFBBFB0,10841,19,21,2,37,47,1897
42936,42936,B89706C42E69C6D6A83DDA3D4BFBBFB0,42201,22,23,1,43,46,2196
42941,42941,BA6F91C8DB332B28B4CFAA6DD9B35517,10151,0,13,13,34,47,1747
42942,42942,BA6F91C8DB332B28B4CFAA6DD9B35517,13121,16,17,1,38,46,1946
42943,42943,BA6F91C8DB332B28B4CFAA6DD9B35517,10107,19,21,2,38,49,1949
42944,42944,4DA21EF09DE00955AFF28F16D2698178,15391,1,3,2,35,26,1776
42945,42945,4DA21EF09DE00955AFF28F16D2698178,12792,4,8,4,34,30,1730
42946,42946,4DA21EF09DE00955AFF28F16D2698178,15391,10,12,2,35,26,1776
42947,42947,4DA21EF09DE00955AFF28F16D2698178,12792,13,15,2,34,30,1730
42948,42948,4DA21EF09DE00955AFF28F16D2698178,15661,16,22,6,36,26,1826
42952,42952,1F49E26C341B3738FA1E54F232E557D3,12514,1,9,8,38,47,1947
42953,42953,1F49E26C341B3738FA1E54F232E557D3,11201,12,15,3,35,49,1799
42954,42954,1F49E26C341B3738FA1E54F232E557D3,43281,16,17,1,37,48,1898
42955,42955,1F49E26C341B3738FA1E54F232E557D3,42633,18,20,2,42,46,2146
42956,42956,1F49E26C341B3738FA1E54F232E557D3,12514,20,23,3,38,47,1947
42974,42974,8A4EE976F1E8BC4CA88390DFA08CB5DF,43281,8,10,2,37,48,1898
42975,42975,8A4EE976F1E8BC4CA88390DFA08CB5DF,11531,13,15,2,34,49,1749
42976,42976,8A4EE976F1E8BC4CA88390DFA08CB5DF,40691,18,23,5,42,48,2148
42977,42977,CAFD76C380AFDC0FEC510F56BF3B1C8D,10911,0,1,1,39,46,1996
42978,42978,CAFD76C380AFDC0FEC510F56BF3B1C8D,11841,2,8,6,33,46,1696
42979,42979,CAFD76C380AFDC0FEC510F56BF3B1C8D,43041,8,16,8,41,46,2096
42980,42980,CAFD76C380AFDC0FEC510F56BF3B1C8D,11231,17,18,1,37,49,1899
42981,42981,CAFD76C380AFDC0FEC510F56BF3B1C8D,10154,19,23,4,33,47,1697
42982,42982,D8F61CF3289E3928FCE68B7F3A3EF9A7,42633,3,4,1,42,46,2146
42983,42983,D8F61CF3289E3928FCE68B7F3A3EF9A7,43041,5,7,2,41,46,2096
42984,42984,D8F61CF3289E3928FCE68B7F3A3EF9A7,11074,9,18,9,37,47,1897
42985,42985,D8F61CF3289E3928FCE68B7F3A3EF9A7,43041,20,23,3,41,46,2096
42990,42990,D429753EEB35077FBB0F7FD7B24671DA,13071,4,5,1,41,41,2091
42991,42991,D429753EEB35077FBB0F7FD7B24671DA,43451,6,18,12,37,40,1890
42992,42992,D429753EEB35077FBB0F7FD7B24671DA,42381,21,22,1,39,41,1991
42993,42993,AB6EA8E0EB921375D4ACF50883707DA2,10681,0,8,8,30,48,1548
42994,42994,AB6EA8E0EB921375D4ACF50883707DA2,11211,9,10,1,34,49,1749
42995,42995,AB6EA8E0EB921375D4ACF50883707DA2,10191,14,16,2,40,48,2048
42996,42996,AB6EA8E0EB921375D4ACF50883707DA2,10681,18,23,5,30,48,1548
43010,43010,D256AE34DD31744D7365602849D9C40A,10341,0,7,7,31,47,1597
43011,43011,D256AE34DD31744D7365602849D9C40A,12601,9,12,3,25,47,1297
43012,43012,D256AE34DD31744D7365602849D9C40A,10351,12,14,2,28,45,1445
43013,43013,D256AE34DD31744D7365602849D9C40A,12601,14,15,1,25,47,1297
43014,43014,D256AE34DD31744D7365602849D9C40A,42491,19,23,4,32,46,1646
43015,43015,59E8BD2B3B6F40BDD7AA0B26E7BC6262,13471,1,6,5,47,49,2399
43016,43016,59E8BD2B3B6F40BDD7AA0B26E7BC6262,42601,7,8,1,44,48,2248
43017,43017,59E8BD2B3B6F40BDD7AA0B26E7BC6262,43621,10,11,1,46,48,2348
43018,43018,59E8BD2B3B6F40BDD7AA0B26E7BC6262,13471,12,13,1,47,49,2399
43019,43019,59E8BD2B3B6F40BDD7AA0B26E7BC6262,43621,15,16,1,46,48,2348
43020,43020,59E8BD2B3B6F40BDD7AA0B26E7BC6262,13471,20,22,2,47,49,2399
43021,43021,05286C4B5017A260B39768783F7D4555,42581,0,6,6,38,48,1948
43022,43022,05286C4B5017A260B39768783F7D4555,10471,8,11,3,37,48,1898
43023,43023,05286C4B5017A260B39768783F7D4555,40171,14,15,1,38,48,1948
43024,43024,05286C4B5017A260B39768783F7D4555,11111,17,19,2,26,48,1348
43025,43025,05286C4B5017A260B39768783F7D4555,42581,22,23,1,38,48,1948
43029,43029,E2F2F4143F844EB76521711717E3F1F1,12731,0,6,6,22,40,1140
43030,43030,E2F2F4143F844EB76521711717E3F1F1,12921,6,7,1,9,41,491
43031,43031,E2F2F4143F844EB76521711717E3F1F1,19261,12,14,2,6,37,337
43032,43032,E2F2F4143F844EB76521711717E3F1F1,12641,17,19,2,10,43,543
43033,43033,E2F2F4143F844EB76521711717E3F1F1,19261,19,21,2,6,37,337
43034,43034,E2F2F4143F844EB76521711717E3F1F1,12731,22,23,1,22,40,1140
43038,43038,B058065183522F147594E81A7C362AFB,11331,0,8,8,37,48,1898
43039,43039,B058065183522F147594E81A7C362AFB,42511,9,15,6,37,47,1897
43040,43040,B058065183522F147594E81A7C362AFB,43061,17,21,4,43,46,2196
43045,43045,1C18101ADA4B02F048DFDA93997493B8,42491,0,8,8,32,46,1646
43046,43046,1C18101ADA4B02F048DFDA93997493B8,12131,8,11,3,32,47,1647
43047,43047,1C18101ADA4B02F048DFDA93997493B8,42491,11,14,3,32,46,1646
43048,43048,1C18101ADA4B02F048DFDA93997493B8,42523,17,19,2,31,47,1597
43049,43049,1C18101ADA4B02F048DFDA93997493B8,42491,21,23,2,32,46,1646
43050,43050,63553F8CC9364E1AF443AB982740AC2C,13671,0,3,3,27,43,1393
43051,43051,63553F8CC9364E1AF443AB982740AC2C,12671,4,5,1,21,43,1093
43052,43052,63553F8CC9364E1AF443AB982740AC2C,13671,6,18,12,27,43,1393
43053,43053,63553F8CC9364E1AF443AB982740AC2C,10351,21,22,1,28,45,1445
43058,43058,D3F6CC79419CB8E677F2F17C3DF072CD,13121,0,5,5,38,46,1946
43059,43059,D3F6CC79419CB8E677F2F17C3DF072CD,11941,6,11,5,37,46,1896
43060,43060,D3F6CC79419CB8E677F2F17C3DF072CD,13121,12,13,1,38,46,1946
43061,43061,D3F6CC79419CB8E677F2F17C3DF072CD,11941,13,14,1,37,46,1896
43062,43062,D3F6CC79419CB8E677F2F17C3DF072CD,10811,14,22,8,38,46,1946
43066,43066,B951230F2D8FB21FF5FBA5B70040A128,10681,6,7,1,30,48,1548
43067,43067,B951230F2D8FB21FF5FBA5B70040A128,11061,12,13,1,29,48,1498
43068,43068,B951230F2D8FB21FF5FBA5B70040A128,10681,13,14,1,30,48,1548
43069,43069,B951230F2D8FB21FF5FBA5B70040A128,10121,15,16,1,36,49,1849
43070,43070,B951230F2D8FB21FF5FBA5B70040A128,11151,20,22,2,30,48,1548
43071,43071,35316FE348B437315DD3048276353522,11914,1,8,7,37,48,1898
43072,43072,35316FE348B437315DD3048276353522,11381,10,12,2,30,47,1547
43073,43073,35316FE348B437315DD3048276353522,42581,14,15,1,38,48,1948
43074,43074,35316FE348B437315DD3048276353522,11914,16,20,4,37,48,1898
43078,43078,914FCCE81925BD3B7C09A01C1E108BA6,11001,0,3,3,42,47,2147
43079,43079,914FCCE81925BD3B7C09A01C1E108BA6,43621,6,7,1,46,48,2348
43080,43080,914FCCE81925BD3B7C09A01C1E108BA6,42461,8,9,1,45,47,2297
43081,43081,914FCCE81925BD3B7C09A01C1E108BA6,43621,10,13,3,46,48,2348
43082,43082,914FCCE81925BD3B7C09A01C1E108BA6,42461,16,18,2,45,47,2297
43086,43086,A573FF285872EC96818445928AD4461A,11281,0,3,3,27,40,1390
43087,43087,A573FF285872EC96818445928AD4461A,13671,3,5,2,27,43,1393
43088,43088,A573FF285872EC96818445928AD4461A,43011,6,7,1,40,42,2042
43089,43089,A573FF285872EC96818445928AD4461A,13671,8,10,2,27,43,1393
43090,43090,A573FF285872EC96818445928AD4461A,43011,13,21,8,40,42,2042
43091,43091,5C25C6089E8DACB17B508C7CA789551E,11541,1,10,9,35,49,1799
43092,43092,5C25C6089E8DACB17B508C7CA789551E,40341,12,14,2,23,49,1199
43093,43093,5C25C6089E8DACB17B508C7CA789551E,11541,15,23,8,35,49,1799
43094,43094,28AE6FF44E8686DC354D2E3DF7700FCC,42461,0,6,6,45,47,2297
43095,43095,28AE6FF44E8686DC354D2E3DF7700FCC,11701,10,11,1,43,48,2198
43096,43096,28AE6FF44E8686DC354D2E3DF7700FCC,42461,12,13,1,45,47,2297
43097,43097,28AE6FF44E8686DC354D2E3DF7700FCC,11701,16,17,1,43,48,2198
43098,43098,28AE6FF44E8686DC354D2E3DF7700FCC,42461,20,22,2,45,47,2297
43114,43114,4FA7E2AF35091649A8D61648BF92F5C0,42581,0,6,6,38,48,1948
43115,43115,4FA7E2AF35091649A8D61648BF92F5C0,10471,7,10,3,37,48,1898
43116,43116,4FA7E2AF35091649A8D61648BF92F5C0,42581,11,13,2,38,48,1948
43117,43117,4FA7E2AF35091649A8D61648BF92F5C0,10471,14,18,4,37,48,1898
43118,43118,4FA7E2AF35091649A8D61648BF92F5C0,42581,22,23,1,38,48,1948
43119,43119,1317C72E5A9622054904D4946F5A3E59,12121,0,7,7,29,47,1497
43120,43120,1317C72E5A9622054904D4946F5A3E59,10151,8,19,11,34,47,1747
43121,43121,1317C72E5A9622054904D4946F5A3E59,11381,20,23,3,30,47,1547
43122,43122,F34BB6ACFCE210E7291D20313D1902FC,19441,0,2,2,8,46,446
43123,43123,F34BB6ACFCE210E7291D20313D1902FC,42041,2,3,1,10,47,547
43124,43124,F34BB6ACFCE210E7291D20313D1902FC,19441,6,7,1,8,46,446
43125,43125,F34BB6ACFCE210E7291D20313D1902FC,19741,12,13,1,5,44,294
43126,43126,F34BB6ACFCE210E7291D20313D1902FC,19441,18,22,4,8,46,446
43127,43127,7EA63201A47B68AA085BD7B8AF1F7767,10721,0,7,7,31,48,1598
43128,43128,7EA63201A47B68AA085BD7B8AF1F7767,11231,8,16,8,37,49,1899
43129,43129,7EA63201A47B68AA085BD7B8AF1F7767,13341,19,23,4,44,45,2245
43136,43136,FD5EF28EAD4BB7B6215FEE28B08DAD3E,12661,0,8,8,32,45,1645
43137,43137,FD5EF28EAD4BB7B6215FEE28B08DAD3E,12311,8,9,1,30,44,1544
43138,43138,FD5EF28EAD4BB7B6215FEE28B08DAD3E,12661,11,13,2,32,45,1645
43139,43139,FD5EF28EAD4BB7B6215FEE28B08DAD3E,10221,16,20,4,34,49,1749
43143,43143,EDD72D29B8CAB7737CF6608FA3F3E204,11471,0,6,6,12,48,648
43144,43144,EDD72D29B8CAB7737CF6608FA3F3E204,19441,6,11,5,8,46,446
43145,43145,EDD72D29B8CAB7737CF6608FA3F3E204,11471,12,14,2,12,48,648
43146,43146,EDD72D29B8CAB7737CF6608FA3F3E204,19441,14,19,5,8,46,446
43147,43147,EDD72D29B8CAB7737CF6608FA3F3E204,11471,19,23,4,12,48,648
43151,43151,E88F39A65DCBFC647F6F44FF9039942F,10634,1,2,1,27,45,1395
43152,43152,E88F39A65DCBFC647F6F44FF9039942F,12601,4,13,9,25,47,1297
43153,43153,E88F39A65DCBFC647F6F44FF9039942F,10634,14,16,2,27,45,1395
43154,43154,E88F39A65DCBFC647F6F44FF9039942F,12601,17,21,4,25,47,1297
43155,43155,E88F39A65DCBFC647F6F44FF9039942F,11101,22,23,1,18,48,948
43159,43159,56CB8CCC38429BB3710A84699A896EC0,41724,0,9,9,38,48,1948
43160,43160,56CB8CCC38429BB3710A84699A896EC0,43581,12,14,2,33,48,1698
43161,43161,56CB8CCC38429BB3710A84699A896EC0,10221,15,18,3,34,49,1749
43162,43162,56CB8CCC38429BB3710A84699A896EC0,11021,21,23,2,36,49,1849
43166,43166,09E76C7E5F88F1AE9CA216C706232DAD,42141,0,8,8,32,47,1647
43167,43167,09E76C7E5F88F1AE9CA216C706232DAD,40341,12,15,3,23,49,1199
43168,43168,09E76C7E5F88F1AE9CA216C706232DAD,42141,17,23,6,32,47,1647
43169,43169,BC7E26CA9C636872D72F8E2051181A1A,42231,0,6,6,37,46,1896
43170,43170,BC7E26CA9C636872D72F8E2051181A1A,15411,7,17,10,44,27,2227
43171,43171,BC7E26CA9C636872D72F8E2051181A1A,42231,19,23,4,37,46,1896
43172,43172,A4CBFA774BBCB1E081978588796288CA,10681,0,7,7,30,48,1548
43173,43173,A4CBFA774BBCB1E081978588796288CA,10901,11,13,2,35,48,1798
43174,43174,A4CBFA774BBCB1E081978588796288CA,11231,13,18,5,37,49,1899
43175,43175,A4CBFA774BBCB1E081978588796288CA,10681,19,23,4,30,48,1548
43180,43180,E798B778C510EAE2B47A353D8CC843E2,42161,0,1,1,36,47,1847
43181,43181,E798B778C510EAE2B47A353D8CC843E2,43731,3,4,1,34,47,1747
43182,43182,E798B778C510EAE2B47A353D8CC843E2,42161,5,8,3,36,47,1847
43183,43183,E798B778C510EAE2B47A353D8CC843E2,10251,10,15,5,35,47,1797
43184,43184,E798B778C510EAE2B47A353D8CC843E2,10881,17,19,2,34,48,1748
43185,43185,FCF6425DA3F542476DF1F93935C075D8,42581,0,8,8,38,48,1948
43186,43186,FCF6425DA3F542476DF1F93935C075D8,11914,8,11,3,37,48,1898
43187,43187,FCF6425DA3F542476DF1F93935C075D8,42581,12,16,4,38,48,1948
43188,43188,FCF6425DA3F542476DF1F93935C075D8,11914,16,17,1,37,48,1898
43189,43189,FCF6425DA3F542476DF1F93935C075D8,42581,17,19,2,38,48,1948
43190,43190,F584084BD0C4D0FD14EABE044AD44274,41392,0,7,7,43,48,2198
43191,43191,F584084BD0C4D0FD14EABE044AD44274,10292,10,17,7,30,47,1547
43192,43192,F584084BD0C4D0FD14EABE044AD44274,11701,21,23,2,43,48,2198
43200,43200,B321D710BE19B79E61E5CA850CAD58B2,11541,0,2,2,35,49,1799
43201,43201,B321D710BE19B79E61E5CA850CAD58B2,11631,5,6,1,12,49,649
43202,43202,B321D710BE19B79E61E5CA850CAD58B2,11531,9,18,9,34,49,1749
43203,43203,B321D710BE19B79E61E5CA850CAD58B2,11541,18,23,5,35,49,1799
43207,43207,D2578266F73D82CE39B27D41DDD354D4,13071,0,15,15,41,41,2091
43208,43208,D2578266F73D82CE39B27D41DDD354D4,43101,16,18,2,46,40,2340
43209,43209,D2578266F73D82CE39B27D41DDD354D4,13071,18,23,5,41,41,2091
43210,43210,474FFA09EED2908FC53360D0633D492E,43061,0,1,1,43,46,2196
43211,43211,474FFA09EED2908FC53360D0633D492E,13111,1,8,7,42,46,2146
43212,43212,474FFA09EED2908FC53360D0633D492E,11201,11,16,5,35,49,1799
43213,43213,474FFA09EED2908FC53360D0633D492E,13511,17,19,2,34,48,1748
43214,43214,D941D34F40666D67B4DE6038E66E1F6A,12141,0,1,1,42,45,2145
43215,43215,D941D34F40666D67B4DE6038E66E1F6A,12211,2,3,1,41,44,2094
43216,43216,D941D34F40666D67B4DE6038E66E1F6A,43011,5,6,1,40,42,2042
43217,43217,D941D34F40666D67B4DE6038E66E1F6A,12141,18,22,4,42,45,2145
43218,43218,D941D34F40666D67B4DE6038E66E1F6A,12561,22,23,1,45,43,2293
43222,43222,F4F7E5CEFA3206C18BB61231AE746441,10341,2,17,15,31,47,1597
43223,43223,F4F7E5CEFA3206C18BB61231AE746441,11231,19,21,2,37,49,1899
43224,43224,F4F7E5CEFA3206C18BB61231AE746441,42523,21,22,1,31,47,1597
43225,43225,B57FA6A577B54BB28114ABA28733D834,13711,0,7,7,38,46,1946
43226,43226,B57FA6A577B54BB28114ABA28733D834,13671,8,17,9,27,43,1393
43227,43227,B57FA6A577B54BB28114ABA28733D834,13711,21,22,1,38,46,1946
43231,43231,437E81C27E134BCB6F811BB637566A12,43751,2,9,7,19,48,998
43232,43232,437E81C27E134BCB6F811BB637566A12,42501,11,16,5,28,47,1447
43233,43233,437E81C27E134BCB6F811BB637566A12,42623,19,20,1,22,49,1149
43234,43234,25A0E61F1DC4EDCA55BC31768CCB616A,15061,0,13,13,41,25,2075
43235,43235,25A0E61F1DC4EDCA55BC31768CCB616A,13941,14,20,6,41,47,2097
43236,43236,25A0E61F1DC4EDCA55BC31768CCB616A,11001,21,23,2,42,47,2147
43246,43246,FCA41D1A9AA28A78DFB3F79F3C4FFA6C,42031,0,6,6,40,46,2046
43247,43247,FCA41D1A9AA28A78DFB3F79F3C4FFA6C,12561,7,8,1,45,43,2293
43248,43248,FCA41D1A9AA28A78DFB3F79F3C4FFA6C,43011,8,10,2,40,42,2042
43249,43249,FCA41D1A9AA28A78DFB3F79F3C4FFA6C,42031,12,13,1,40,46,2046
43250,43250,FCA41D1A9AA28A78DFB3F79F3C4FFA6C,13231,13,15,2,39,46,1996
43251,43251,FCA41D1A9AA28A78DFB3F79F3C4FFA6C,12561,15,16,1,45,43,2293
43252,43252,FCA41D1A9AA28A78DFB3F79F3C4FFA6C,12211,16,18,2,41,44,2094
43253,43253,4DAFB85C918047225CA596E4134A09D3,42141,0,6,6,32,47,1647
43254,43254,4DAFB85C918047225CA596E4134A09D3,13651,6,8,2,30,47,1547
43255,43255,4DAFB85C918047225CA596E4134A09D3,42523,9,10,1,31,47,1597
43256,43256,4DAFB85C918047225CA596E4134A09D3,13651,13,14,1,30,47,1547
43257,43257,4DAFB85C918047225CA596E4134A09D3,43761,18,23,5,32,47,1647
43264,43264,8AB561279CAFD673B81CFFF6F25401C3,12221,2,13,11,43,44,2194
43265,43265,8AB561279CAFD673B81CFFF6F25401C3,13951,14,16,2,47,45,2395
43266,43266,8AB561279CAFD673B81CFFF6F25401C3,43011,20,23,3,40,42,2042
43274,43274,6EC25BB5BAEED237275896EB7FD004D5,10341,1,7,6,31,47,1597
43275,43275,6EC25BB5BAEED237275896EB7FD004D5,11541,10,12,2,35,49,1799
43276,43276,6EC25BB5BAEED237275896EB7FD004D5,42201,15,16,1,43,46,2196
43277,43277,6EC25BB5BAEED237275896EB7FD004D5,11541,19,21,2,35,49,1799
43278,43278,619B4993323BBB76F010058331D5BCE1,13911,0,6,6,39,46,1996
43279,43279,619B4993323BBB76F010058331D5BCE1,11261,8,9,1,36,46,1846
43280,43280,619B4993323BBB76F010058331D5BCE1,13911,12,13,1,39,46,1996
43281,43281,619B4993323BBB76F010058331D5BCE1,11261,14,16,2,36,46,1846
43282,43282,619B4993323BBB76F010058331D5BCE1,13911,17,19,2,39,46,1996
43286,43286,5B7E7E4FB63F70E50B23EF4DECA2F359,19621,0,6,6,5,46,296
43287,43287,5B7E7E4FB63F70E50B23EF4DECA2F359,12641,10,11,1,10,43,543
43288,43288,5B7E7E4FB63F70E50B23EF4DECA2F359,19901,12,22,10,7,44,394
43289,43289,0E9E7AFF4422B633BEB9D687C008FCF0,43761,3,7,4,32,47,1647
43290,43290,0E9E7AFF4422B633BEB9D687C008FCF0,42523,7,9,2,31,47,1597
43291,43291,0E9E7AFF4422B633BEB9D687C008FCF0,12311,13,17,4,30,44,1544
43292,43292,0E9E7AFF4422B633BEB9D687C008FCF0,10341,21,22,1,31,47,1597
43299,43299,CAB71ABEEBF1083C80884DF4D3D5CD01,10471,0,15,15,37,48,1898
43300,43300,CAB71ABEEBF1083C80884DF4D3D5CD01,13941,16,17,1,41,47,2097
43301,43301,CAB71ABEEBF1083C80884DF4D3D5CD01,10471,19,23,4,37,48,1898
43302,43302,C1664BA564BC8FF7C20F47733006D06C,11301,0,7,7,41,49,2099
43303,43303,C1664BA564BC8FF7C20F47733006D06C,40101,10,15,5,34,49,1749
43304,43304,C1664BA564BC8FF7C20F47733006D06C,40302,21,23,2,40,49,2049
43308,43308,4D92520D1E60176F5F81838CD0F00070,10681,0,7,7,30,48,1548
43309,43309,4D92520D1E60176F5F81838CD0F00070,11021,9,11,2,36,49,1849
43310,43310,4D92520D1E60176F5F81838CD0F00070,10681,12,22,10,30,48,1548
43311,43311,55536669E97AF41ACDE427113BB85731,10691,0,6,6,33,48,1698
43312,43312,55536669E97AF41ACDE427113BB85731,42941,7,8,1,37,47,1897
43313,43313,55536669E97AF41ACDE427113BB85731,11861,12,17,5,32,47,1647
43314,43314,55536669E97AF41ACDE427113BB85731,10491,20,21,1,33,48,1698
43324,43324,EBE3D75CE08F0D8E7A2B9C1EECA988EC,13741,6,9,3,37,49,1899
43325,43325,EBE3D75CE08F0D8E7A2B9C1EECA988EC,43731,12,14,2,34,47,1747
43326,43326,EBE3D75CE08F0D8E7A2B9C1EECA988EC,43481,15,18,3,39,48,1998
43327,43327,EBE3D75CE08F0D8E7A2B9C1EECA988EC,42271,19,21,2,40,47,2047
43328,43328,4C0B4AC61D24A3A943FEC75230408343,10381,0,19,19,31,49,1599
43329,43329,4C0B4AC61D24A3A943FEC75230408343,42831,19,20,1,27,48,1398
43330,43330,4C0B4AC61D24A3A943FEC75230408343,10381,20,23,3,31,49,1599
43335,43335,28C900416D6AF4E146D9298312A567F1,10411,0,7,7,36,48,1848
43336,43336,28C900416D6AF4E146D9298312A567F1,13951,9,10,1,47,45,2395
43337,43337,28C900416D6AF4E146D9298312A567F1,40951,12,13,1,36,49,1849
43338,43338,28C900416D6AF4E146D9298312A567F1,43581,15,17,2,33,48,1698
43339,43339,28C900416D6AF4E146D9298312A567F1,10161,19,20,1,35,49,1799
43340,43340,28C900416D6AF4E146D9298312A567F1,11701,21,23,2,43,48,2198
43341,43341,A1D58FB832B7159FF1E9EF25474936EB,19531,0,8,8,17,30,880
43342,43342,A1D58FB832B7159FF1E9EF25474936EB,40341,13,16,3,23,49,1199
43343,43343,A1D58FB832B7159FF1E9EF25474936EB,19531,17,22,5,17,30,880
43347,43347,C50F95F31F14C0EC9A55706C3B181C1C,12792,0,2,2,34,30,1730
43348,43348,C50F95F31F14C0EC9A55706C3B181C1C,15391,3,4,1,35,26,1776
43349,43349,C50F95F31F14C0EC9A55706C3B181C1C,12792,7,18,11,34,30,1730
43363,43363,DDA0748B2338452391EBA627D104CDA8,10971,0,8,8,35,47,1797
43364,43364,DDA0748B2338452391EBA627D104CDA8,10401,11,12,1,33,49,1699
43365,43365,DDA0748B2338452391EBA627D104CDA8,11751,17,19,2,35,48,1798
43366,43366,DDA0748B2338452391EBA627D104CDA8,11954,21,22,1,32,49,1649
43367,43367,39E8FB5C4AE9A0E0783441178F244CD5,10341,1,7,6,31,47,1597
43368,43368,39E8FB5C4AE9A0E0783441178F244CD5,10221,9,19,10,34,49,1749
43369,43369,39E8FB5C4AE9A0E0783441178F244CD5,10341,20,23,3,31,47,1597
43373,43373,70DFAD9CC535457B59206F2CD88E5D55,13711,0,8,8,38,46,1946
43374,43374,70DFAD9CC535457B59206F2CD88E5D55,11861,9,11,2,32,47,1647
43375,43375,70DFAD9CC535457B59206F2CD88E5D55,13711,13,19,6,38,46,1946
43391,43391,4C3E8C1CDF60EC341D8B9147E6C7B114,10691,0,6,6,33,48,1698
43392,43392,4C3E8C1CDF60EC341D8B9147E6C7B114,42491,9,10,1,32,46,1646
43393,43393,4C3E8C1CDF60EC341D8B9147E6C7B114,11561,11,12,1,32,49,1649
43394,43394,4C3E8C1CDF60EC341D8B9147E6C7B114,42491,13,14,1,32,46,1646
43395,43395,4C3E8C1CDF60EC341D8B9147E6C7B114,10401,15,16,1,33,49,1699
43396,43396,4C3E8C1CDF60EC341D8B9147E6C7B114,10691,19,22,3,33,48,1698
43407,43407,02E0A804DFD9ADA3EF12DCC2B70B2BCE,43761,0,5,5,32,47,1647
43408,43408,02E0A804DFD9ADA3EF12DCC2B70B2BCE,13094,10,12,2,21,42,1092
43409,43409,02E0A804DFD9ADA3EF12DCC2B70B2BCE,10151,16,19,3,34,47,1747
43410,43410,135EF939D99CED11694D71795A5772B0,19031,0,5,5,1,42,92
43411,43411,135EF939D99CED11694D71795A5772B0,12641,6,11,5,10,43,543
43412,43412,135EF939D99CED11694D71795A5772B0,19031,12,15,3,1,42,92
43413,43413,135EF939D99CED11694D71795A5772B0,12641,15,17,2,10,43,543
43414,43414,135EF939D99CED11694D71795A5772B0,19031,17,23,6,1,42,92
43415,43415,0EC1D2502267B7D6F36C8EA9D8EC3DDA,10171,0,7,7,26,47,1347
43416,43416,0EC1D2502267B7D6F36C8EA9D8EC3DDA,11001,9,17,8,42,47,2147
43417,43417,0EC1D2502267B7D6F36C8EA9D8EC3DDA,10171,20,23,3,26,47,1347
43418,43418,460BCCD73137885B18E012CDD09AD9D1,42623,0,1,1,22,49,1149
43419,43419,460BCCD73137885B18E012CDD09AD9D1,10681,5,6,1,30,48,1548
43420,43420,460BCCD73137885B18E012CDD09AD9D1,10951,8,9,1,29,48,1498
43421,43421,460BCCD73137885B18E012CDD09AD9D1,42081,17,19,2,24,49,1249
43422,43422,460BCCD73137885B18E012CDD09AD9D1,42071,20,21,1,31,49,1599
43423,43423,3AEA3CF422288C2FFB9C65FD7BE694C9,12921,4,5,1,9,41,491
43424,43424,3AEA3CF422288C2FFB9C65FD7BE694C9,19931,6,7,1,7,43,393
43425,43425,3AEA3CF422288C2FFB9C65FD7BE694C9,12921,7,8,1,9,41,491
43426,43426,3AEA3CF422288C2FFB9C65FD7BE694C9,19931,8,11,3,7,43,393
43427,43427,3AEA3CF422288C2FFB9C65FD7BE694C9,12921,11,12,1,9,41,491
43428,43428,3AEA3CF422288C2FFB9C65FD7BE694C9,19931,14,18,4,7,43,393
43438,43438,99C7ECB8A04AED18341CF71575998F26,10811,0,14,14,38,46,1946
43439,43439,99C7ECB8A04AED18341CF71575998F26,12561,15,16,1,45,43,2293
43440,43440,99C7ECB8A04AED18341CF71575998F26,10811,20,23,3,38,46,1946
43441,43441,D1B198FBEC3C8F15FED9970CD6DFF591,13071,1,2,1,41,41,2091
43442,43442,D1B198FBEC3C8F15FED9970CD6DFF591,43451,3,21,18,37,40,1890
43443,43443,D1B198FBEC3C8F15FED9970CD6DFF591,13071,22,23,1,41,41,2091
43444,43444,5767DCB7927C2A22DA225038742C1BCE,13561,0,8,8,37,49,1899
43445,43445,5767DCB7927C2A22DA225038742C1BCE,11021,8,10,2,36,49,1849
43446,43446,5767DCB7927C2A22DA225038742C1BCE,13561,12,13,1,37,49,1899
43447,43447,5767DCB7927C2A22DA225038742C1BCE,11021,13,18,5,36,49,1849
43448,43448,5767DCB7927C2A22DA225038742C1BCE,13561,20,22,2,37,49,1899
43449,43449,CADE9ADEC7B1B2F6454293174DEADF86,10681,0,7,7,30,48,1548
43450,43450,CADE9ADEC7B1B2F6454293174DEADF86,11541,9,11,2,35,49,1799
43451,43451,CADE9ADEC7B1B2F6454293174DEADF86,11151,12,23,11,30,48,1548
43452,43452,942A242C54C5AF79C66351D8C7F17676,42691,0,7,7,24,48,1248
43453,43453,942A242C54C5AF79C66351D8C7F17676,43161,8,18,10,35,47,1797
43454,43454,942A242C54C5AF79C66351D8C7F17676,10451,19,21,2,25,48,1298
43455,43455,B11D0772E55A8E3DB68878EB64D9DA1C,10781,0,9,9,35,47,1797
43456,43456,B11D0772E55A8E3DB68878EB64D9DA1C,42161,11,12,1,36,47,1847
43457,43457,B11D0772E55A8E3DB68878EB64D9DA1C,10781,13,15,2,35,47,1797
43458,43458,B11D0772E55A8E3DB68878EB64D9DA1C,11151,19,21,2,30,48,1548
43459,43459,B11D0772E55A8E3DB68878EB64D9DA1C,10781,22,23,1,35,47,1797
43460,43460,6E3A482A59CE9925DB19971C6ACB206A,11811,2,5,3,38,49,1949
43461,43461,6E3A482A59CE9925DB19971C6ACB206A,10471,5,10,5,37,48,1898
43462,43462,6E3A482A59CE9925DB19971C6ACB206A,40171,11,14,3,38,48,1948
43463,43463,6E3A482A59CE9925DB19971C6ACB206A,11914,14,20,6,37,48,1898
43464,43464,6E3A482A59CE9925DB19971C6ACB206A,40171,21,23,2,38,48,1948
43465,43465,4E1126CD1AF86FC47E3B081AF053FA88,43761,0,8,8,32,47,1647
43466,43466,4E1126CD1AF86FC47E3B081AF053FA88,42523,8,10,2,31,47,1597
43467,43467,4E1126CD1AF86FC47E3B081AF053FA88,42141,11,12,1,32,47,1647
43468,43468,4E1126CD1AF86FC47E3B081AF053FA88,42491,15,17,2,32,46,1646
43469,43469,4E1126CD1AF86FC47E3B081AF053FA88,43761,19,23,4,32,47,1647
43470,43470,4BEB96C1A6F8B99181CDADEF48D75275,42501,0,6,6,28,47,1447
43471,43471,4BEB96C1A6F8B99181CDADEF48D75275,40343,7,18,11,24,49,1249
43472,43472,4BEB96C1A6F8B99181CDADEF48D75275,42501,19,23,4,28,47,1447
43473,43473,BCCA36AC6DE92B5D284204C1D312B82A,43161,0,6,6,35,47,1797
43474,43474,BCCA36AC6DE92B5D284204C1D312B82A,42801,8,14,6,40,49,2049
43475,43475,BCCA36AC6DE92B5D284204C1D312B82A,43161,16,23,7,35,47,1797
43476,43476,46624C7A7A05E81084BABC40FE8F937C,13314,0,7,7,31,39,1589
43477,43477,46624C7A7A05E81084BABC40FE8F937C,12521,8,13,5,35,41,1791
43478,43478,46624C7A7A05E81084BABC40FE8F937C,13314,14,23,9,31,39,1589
43479,43479,AF0D58D384C1FE05074B2A2FC409ECEA,42191,0,10,10,38,49,1949
43480,43480,AF0D58D384C1FE05074B2A2FC409ECEA,41601,12,13,1,39,49,1999
43481,43481,AF0D58D384C1FE05074B2A2FC409ECEA,43761,15,19,4,32,47,1647
43482,43482,072E7C9C59FDFE5CE6B3541F02C0CDFE,42081,1,4,3,24,49,1249
43483,43483,072E7C9C59FDFE5CE6B3541F02C0CDFE,12671,9,10,1,21,43,1093
43484,43484,072E7C9C59FDFE5CE6B3541F02C0CDFE,13091,10,13,3,20,42,1042
43485,43485,072E7C9C59FDFE5CE6B3541F02C0CDFE,42623,14,23,9,22,49,1149
43489,43489,7F0F7E01EE512C1A933F7133254355CA,43021,0,5,5,16,43,843
43490,43490,7F0F7E01EE512C1A933F7133254355CA,12921,6,10,4,9,41,491
43491,43491,7F0F7E01EE512C1A933F7133254355CA,43021,11,19,8,16,43,843
43492,43492,7F0F7E01EE512C1A933F7133254355CA,11631,22,23,1,12,49,649
43493,43493,AC9035C1C6921632550AD12AB6A87C96,11381,0,11,11,30,47,1547
43494,43494,AC9035C1C6921632550AD12AB6A87C96,11061,12,20,8,29,48,1498
43495,43495,AC9035C1C6921632550AD12AB6A87C96,11631,20,23,3,12,49,649
43496,43496,726D8BF6FE9D2B730CE8E7DD26F779CD,12121,2,3,1,29,47,1497
43497,43497,726D8BF6FE9D2B730CE8E7DD26F779CD,11381,4,5,1,30,47,1547
43498,43498,726D8BF6FE9D2B730CE8E7DD26F779CD,12121,6,8,2,29,47,1497
43499,43499,726D8BF6FE9D2B730CE8E7DD26F779CD,11381,12,15,3,30,47,1547
43500,43500,726D8BF6FE9D2B730CE8E7DD26F779CD,11231,15,18,3,37,49,1899
43501,43501,726D8BF6FE9D2B730CE8E7DD26F779CD,11381,21,23,2,30,47,1547
43515,43515,A0E63C19881C3EAB783B3E1E3BB95F15,13381,0,13,13,39,47,1997
43516,43516,A0E63C19881C3EAB783B3E1E3BB95F15,12311,14,15,1,30,44,1544
43517,43517,A0E63C19881C3EAB783B3E1E3BB95F15,13381,19,23,4,39,47,1997
43518,43518,A1E490700FE526497C6D06909C6A4A1B,11861,1,12,11,32,47,1647
43519,43519,A1E490700FE526497C6D06909C6A4A1B,40073,15,16,1,37,48,1898
43520,43520,A1E490700FE526497C6D06909C6A4A1B,12481,17,18,1,37,49,1899
43521,43521,A1E490700FE526497C6D06909C6A4A1B,42371,19,20,1,34,46,1746
43522,43522,A1E490700FE526497C6D06909C6A4A1B,11861,22,23,1,32,47,1647
43530,43530,718F9C02C6A67F792D4A34A4E958BCFE,11751,0,3,3,35,48,1798
43531,43531,718F9C02C6A67F792D4A34A4E958BCFE,13381,5,8,3,39,47,1997
43532,43532,718F9C02C6A67F792D4A34A4E958BCFE,13101,12,16,4,40,47,2047
43533,43533,718F9C02C6A67F792D4A34A4E958BCFE,40951,18,22,4,36,49,1849
43534,43534,9B49BEB65E16F10DE8E30D5D01D652E3,10811,1,8,7,38,46,1946
43535,43535,9B49BEB65E16F10DE8E30D5D01D652E3,42351,12,13,1,38,45,1945
43536,43536,9B49BEB65E16F10DE8E30D5D01D652E3,12311,14,17,3,30,44,1544
43537,43537,9B49BEB65E16F10DE8E30D5D01D652E3,10811,21,23,2,38,46,1946
43542,43542,EECB7510E2F1A50FBF2C7F4547480446,10221,0,14,14,34,49,1749
43543,43543,EECB7510E2F1A50FBF2C7F4547480446,43061,15,16,1,43,46,2196
43544,43544,EECB7510E2F1A50FBF2C7F4547480446,10221,21,22,1,34,49,1749
43549,43549,F292E588F5B97B789B94F3BB973BBEB5,42141,0,1,1,32,47,1647
43550,43550,F292E588F5B97B789B94F3BB973BBEB5,10281,2,5,3,33,48,1698
43551,43551,F292E588F5B97B789B94F3BB973BBEB5,42141,8,15,7,32,47,1647
43552,43552,F292E588F5B97B789B94F3BB973BBEB5,42081,15,18,3,24,49,1249
43553,43553,B217126F85B5F090E7D376CA23C6FEE9,42971,0,8,8,43,49,2199
43554,43554,B217126F85B5F090E7D376CA23C6FEE9,10251,18,21,3,35,47,1797
43555,43555,B217126F85B5F090E7D376CA23C6FEE9,12514,21,23,2,38,47,1947
43560,43560,F294E1A20262A46A35C127275EA3D6A6,11061,0,7,7,29,48,1498
43561,43561,F294E1A20262A46A35C127275EA3D6A6,40637,8,14,6,36,47,1847
43562,43562,F294E1A20262A46A35C127275EA3D6A6,11061,19,20,1,29,48,1498
43566,43566,3D0E1B656C5536FA930B97A859157563,41612,0,6,6,36,47,1847
43567,43567,3D0E1B656C5536FA930B97A859157563,12601,9,15,6,25,47,1297
43568,43568,3D0E1B656C5536FA930B97A859157563,10881,18,20,2,34,48,1748
43569,43569,3D0E1B656C5536FA930B97A859157563,10411,20,23,3,36,48,1848
43570,43570,393F5524259520584332C02612814AC9,11091,0,13,13,29,47,1497
43571,43571,393F5524259520584332C02612814AC9,12561,14,17,3,45,43,2293
43572,43572,393F5524259520584332C02612814AC9,11091,21,23,2,29,47,1497
43576,43576,193603340935DA55C70322807542A372,12083,0,2,2,36,49,1849
43577,43577,193603340935DA55C70322807542A372,11074,2,3,1,37,47,1897
43578,43578,193603340935DA55C70322807542A372,19111,4,6,2,9,45,495
43579,43579,193603340935DA55C70322807542A372,12921,7,19,12,9,41,491
43580,43580,193603340935DA55C70322807542A372,13121,21,23,2,38,46,1946
43584,43584,3AE9C3B6C0E6A8AA6B3B6C58033F1358,13941,0,6,6,41,47,2097
43585,43585,3AE9C3B6C0E6A8AA6B3B6C58033F1358,10121,7,18,11,36,49,1849
43586,43586,3AE9C3B6C0E6A8AA6B3B6C58033F1358,13941,19,22,3,41,47,2097
43593,43593,3CD92C1587FA0BBA7305FC70788C8C0D,12561,1,2,1,45,43,2293
43594,43594,3CD92C1587FA0BBA7305FC70788C8C0D,42351,7,17,10,38,45,1945
43595,43595,3CD92C1587FA0BBA7305FC70788C8C0D,12561,19,22,3,45,43,2293
43596,43596,AC795E4562887C767AA55A8BC4B9AFDC,11021,1,13,12,36,49,1849
43597,43597,AC795E4562887C767AA55A8BC4B9AFDC,40341,16,17,1,23,49,1199
43598,43598,AC795E4562887C767AA55A8BC4B9AFDC,11021,20,22,2,36,49,1849
43602,43602,3F04B8786209E9BE46CC243C370DA5F6,42091,0,6,6,43,46,2196
43603,43603,3F04B8786209E9BE46CC243C370DA5F6,42521,8,17,9,31,47,1597
43604,43604,3F04B8786209E9BE46CC243C370DA5F6,40341,18,19,1,23,49,1199
43608,43608,E2D0D6B3100D66AA6E7AA50C1F44E7ED,11791,0,1,1,38,49,1949
43609,43609,E2D0D6B3100D66AA6E7AA50C1F44E7ED,12401,1,7,6,39,49,1999
43610,43610,E2D0D6B3100D66AA6E7AA50C1F44E7ED,11791,8,10,2,38,49,1949
43611,43611,E2D0D6B3100D66AA6E7AA50C1F44E7ED,10771,12,14,2,41,46,2096
43612,43612,E2D0D6B3100D66AA6E7AA50C1F44E7ED,43731,18,20,2,34,47,1747
43617,43617,2C3A1C890B30FB06A95DD4A9EF742265,15321,0,1,1,29,26,1476
43618,43618,2C3A1C890B30FB06A95DD4A9EF742265,19801,2,4,2,19,26,976
43619,43619,2C3A1C890B30FB06A95DD4A9EF742265,43121,7,11,4,25,27,1277
43620,43620,2C3A1C890B30FB06A95DD4A9EF742265,19801,11,15,4,19,26,976
43621,43621,2C3A1C890B30FB06A95DD4A9EF742265,43121,15,19,4,25,27,1277
43622,43622,2C3A1C890B30FB06A95DD4A9EF742265,19801,19,20,1,19,26,976
43629,43629,1420486C9FFB0F1C4F47BBAE2CD15BC4,13141,4,9,5,23,30,1180
43630,43630,1420486C9FFB0F1C4F47BBAE2CD15BC4,49181,11,13,2,21,31,1081
43631,43631,1420486C9FFB0F1C4F47BBAE2CD15BC4,13141,13,15,2,23,30,1180
43632,43632,1420486C9FFB0F1C4F47BBAE2CD15BC4,13481,19,20,1,26,31,1331
43633,43633,1420486C9FFB0F1C4F47BBAE2CD15BC4,49181,20,22,2,21,31,1081
43634,43634,181B5103F0FBF120AFF5BEC3A26A3DB7,43761,0,7,7,32,47,1647
43635,43635,181B5103F0FBF120AFF5BEC3A26A3DB7,10431,8,11,3,33,49,1699
43636,43636,181B5103F0FBF120AFF5BEC3A26A3DB7,43761,12,13,1,32,47,1647
43637,43637,181B5103F0FBF120AFF5BEC3A26A3DB7,10431,14,18,4,33,49,1699
43638,43638,181B5103F0FBF120AFF5BEC3A26A3DB7,43761,18,23,5,32,47,1647
43639,43639,84E097DF782FE990259E1DE5027828BD,40201,8,14,6,32,49,1649
43640,43640,84E097DF782FE990259E1DE5027828BD,13371,15,19,4,41,47,2097
43641,43641,84E097DF782FE990259E1DE5027828BD,11541,21,22,1,35,49,1799
43642,43642,DB889186FEB7E9AF029B386FEDCE28A5,10971,0,7,7,35,47,1797
43643,43643,DB889186FEB7E9AF029B386FEDCE28A5,13651,9,11,2,30,47,1547
43644,43644,DB889186FEB7E9AF029B386FEDCE28A5,10971,13,22,9,35,47,1797
43655,43655,A2F70AB1F2A2920D28FC20CFCB0C3EEE,10351,8,9,1,28,45,1445
43656,43656,A2F70AB1F2A2920D28FC20CFCB0C3EEE,10251,12,13,1,35,47,1797
43657,43657,A2F70AB1F2A2920D28FC20CFCB0C3EEE,13601,14,15,1,34,47,1747
43658,43658,A2F70AB1F2A2920D28FC20CFCB0C3EEE,42161,16,22,6,36,47,1847
43682,43682,6C7DE4B4696563CBDA9D3C6E4FCAB652,10341,0,7,7,31,47,1597
43683,43683,6C7DE4B4696563CBDA9D3C6E4FCAB652,10841,10,12,2,37,47,1897
43684,43684,6C7DE4B4696563CBDA9D3C6E4FCAB652,10341,12,14,2,31,47,1597
43685,43685,6C7DE4B4696563CBDA9D3C6E4FCAB652,10292,16,17,1,30,47,1547
43686,43686,6C7DE4B4696563CBDA9D3C6E4FCAB652,42523,19,20,1,31,47,1597
43687,43687,C049B170495375BB5253D6DC1568AF09,10491,0,7,7,33,48,1698
43688,43688,C049B170495375BB5253D6DC1568AF09,11481,8,14,6,41,48,2098
43689,43689,C049B170495375BB5253D6DC1568AF09,10431,14,16,2,33,49,1699
43690,43690,C049B170495375BB5253D6DC1568AF09,40361,17,19,2,42,48,2148
43695,43695,C415343168773013C92CA13C873C9F99,12311,0,6,6,30,44,1544
43696,43696,C415343168773013C92CA13C873C9F99,12881,8,9,1,47,22,2372
43697,43697,C415343168773013C92CA13C873C9F99,15441,12,15,3,44,20,2220
43698,43698,C415343168773013C92CA13C873C9F99,12881,16,18,2,47,22,2372
43699,43699,C415343168773013C92CA13C873C9F99,11875,19,20,1,30,46,1546
43709,43709,C2E86EFC64EB6193632DD1776BAD5A6A,12971,0,6,6,32,48,1648
43710,43710,C2E86EFC64EB6193632DD1776BAD5A6A,10661,14,16,2,37,49,1899
43711,43711,C2E86EFC64EB6193632DD1776BAD5A6A,11954,16,18,2,32,49,1649
43712,43712,C2E86EFC64EB6193632DD1776BAD5A6A,11551,19,23,4,39,49,1999
43722,43722,479BB88DD9C776BA69F274C628C53893,13121,0,6,6,38,46,1946
43723,43723,479BB88DD9C776BA69F274C628C53893,13331,7,8,1,38,47,1947
43724,43724,479BB88DD9C776BA69F274C628C53893,10271,8,9,1,37,46,1896
43725,43725,479BB88DD9C776BA69F274C628C53893,13121,11,12,1,38,46,1946
43726,43726,479BB88DD9C776BA69F274C628C53893,13331,14,16,2,38,47,1947
43727,43727,479BB88DD9C776BA69F274C628C53893,10271,16,17,1,37,46,1896
43728,43728,479BB88DD9C776BA69F274C628C53893,13121,18,23,5,38,46,1946
43729,43729,61B1D3194332702D384ACC7835B28F70,12921,1,6,5,9,41,491
43730,43730,61B1D3194332702D384ACC7835B28F70,19244,7,9,2,1,43,93
43731,43731,61B1D3194332702D384ACC7835B28F70,12921,11,13,2,9,41,491
43732,43732,61B1D3194332702D384ACC7835B28F70,19244,14,15,1,1,43,93
43733,43733,61B1D3194332702D384ACC7835B28F70,49201,16,18,2,7,41,391
43734,43734,61B1D3194332702D384ACC7835B28F70,19244,19,20,1,1,43,93
43738,43738,A0726C803D54356D79A20E6BD9BC86DB,10471,0,2,2,37,48,1898
43739,43739,A0726C803D54356D79A20E6BD9BC86DB,10251,3,8,5,35,47,1797
43740,43740,A0726C803D54356D79A20E6BD9BC86DB,10771,11,17,6,41,46,2096
43741,43741,A0726C803D54356D79A20E6BD9BC86DB,10251,18,23,5,35,47,1797
43742,43742,BAF8CBAEABDF4063FF5ED369E100E588,43281,0,10,10,37,48,1898
43743,43743,BAF8CBAEABDF4063FF5ED369E100E588,12083,11,15,4,36,49,1849
43744,43744,BAF8CBAEABDF4063FF5ED369E100E588,13331,15,17,2,38,47,1947
43745,43745,BAF8CBAEABDF4063FF5ED369E100E588,11074,18,19,1,37,47,1897
43746,43746,BAF8CBAEABDF4063FF5ED369E100E588,12083,20,23,3,36,49,1849
43747,43747,9C52FD29B03EF1A5729C28BEF7100CC4,13314,0,7,7,31,39,1589
43748,43748,9C52FD29B03EF1A5729C28BEF7100CC4,12521,8,15,7,35,41,1791
43749,43749,9C52FD29B03EF1A5729C28BEF7100CC4,13314,20,23,3,31,39,1589
43750,43750,E908468A4151400394D5313058C7E35A,12601,0,2,2,25,47,1297
43751,43751,E908468A4151400394D5313058C7E35A,13091,2,5,3,20,42,1042
43752,43752,E908468A4151400394D5313058C7E35A,12601,5,21,16,25,47,1297
43753,43753,2F380CE2E674806561EC26C449F15D1B,41393,0,8,8,43,49,2199
43754,43754,2F380CE2E674806561EC26C449F15D1B,10431,9,11,2,33,49,1699
43755,43755,2F380CE2E674806561EC26C449F15D1B,11201,12,14,2,35,49,1799
43756,43756,2F380CE2E674806561EC26C449F15D1B,10431,14,16,2,33,49,1699
43757,43757,2F380CE2E674806561EC26C449F15D1B,10221,20,23,3,34,49,1749
43761,43761,C0570363D945AD563B5483C8E4053ECC,12391,0,7,7,36,49,1849
43762,43762,C0570363D945AD563B5483C8E4053ECC,11231,9,15,6,37,49,1899
43763,43763,C0570363D945AD563B5483C8E4053ECC,11301,18,20,2,41,49,2099
43764,43764,C0570363D945AD563B5483C8E4053ECC,11231,21,23,2,37,49,1899
43765,43765,AD318EF32C0809165B01885B23F1F0E6,10121,0,8,8,36,49,1849
43766,43766,AD318EF32C0809165B01885B23F1F0E6,13231,10,11,1,39,46,1996
43767,43767,AD318EF32C0809165B01885B23F1F0E6,42351,15,17,2,38,45,1945
43768,43768,AD318EF32C0809165B01885B23F1F0E6,13231,18,19,1,39,46,1996
43769,43769,AD318EF32C0809165B01885B23F1F0E6,13561,20,23,3,37,49,1899
43770,43770,4C4BFC6596FD3FEC2B91BC1C914BF8BF,12871,0,4,4,22,33,1133
43771,43771,4C4BFC6596FD3FEC2B91BC1C914BF8BF,19531,6,8,2,17,30,880
43772,43772,4C4BFC6596FD3FEC2B91BC1C914BF8BF,19281,12,23,11,16,32,832
43777,43777,A81638617545A61CA275F98CB5E7FC67,10061,3,4,1,20,46,1046
43778,43778,A81638617545A61CA275F98CB5E7FC67,11081,6,18,12,35,46,1796
43779,43779,A81638617545A61CA275F98CB5E7FC67,12601,20,22,2,25,47,1297
43780,43780,1CD741282378ACECE229BFA3E57C9431,19441,0,7,7,8,46,446
43781,43781,1CD741282378ACECE229BFA3E57C9431,42041,11,12,1,10,47,547
43782,43782,1CD741282378ACECE229BFA3E57C9431,19441,14,16,2,8,46,446
43783,43783,1CD741282378ACECE229BFA3E57C9431,42041,17,20,3,10,47,547
43784,43784,1CD741282378ACECE229BFA3E57C9431,19441,21,23,2,8,46,446
43785,43785,A9FAA4B4C51A5D14416D1899F40B6E9A,19801,2,3,1,19,26,976
43786,43786,A9FAA4B4C51A5D14416D1899F40B6E9A,19531,4,6,2,17,30,880
43787,43787,A9FAA4B4C51A5D14416D1899F40B6E9A,19801,10,11,1,19,26,976
43788,43788,A9FAA4B4C51A5D14416D1899F40B6E9A,13481,12,13,1,26,31,1331
43789,43789,A9FAA4B4C51A5D14416D1899F40B6E9A,19101,18,19,1,17,29,879
43790,43790,A9FAA4B4C51A5D14416D1899F40B6E9A,19801,20,22,2,19,26,976
43797,43797,79AB37E4BA910BB73519FC84F2A35B1A,12921,0,2,2,9,41,491
43798,43798,79AB37E4BA910BB73519FC84F2A35B1A,19181,2,4,2,8,40,440
43799,43799,79AB37E4BA910BB73519FC84F2A35B1A,12921,6,17,11,9,41,491
43800,43800,79AB37E4BA910BB73519FC84F2A35B1A,43021,21,23,2,16,43,843
43801,43801,2B629CC0A3BF66C0EF746336B5C36B0A,11011,0,2,2,39,49,1999
43802,43802,2B629CC0A3BF66C0EF746336B5C36B0A,11701,5,6,1,43,48,2198
43803,43803,2B629CC0A3BF66C0EF746336B5C36B0A,11801,7,8,1,42,48,2148
43804,43804,2B629CC0A3BF66C0EF746336B5C36B0A,11481,12,23,11,41,48,2098
43808,43808,9F07E2341EC43516CD02BDC269F3E6AA,11061,0,6,6,29,48,1498
43809,43809,9F07E2341EC43516CD02BDC269F3E6AA,11381,8,9,1,30,47,1547
43810,43810,9F07E2341EC43516CD02BDC269F3E6AA,11061,13,15,2,29,48,1498
43811,43811,9F07E2341EC43516CD02BDC269F3E6AA,11381,16,20,4,30,47,1547
43812,43812,9F07E2341EC43516CD02BDC269F3E6AA,11061,22,23,1,29,48,1498
43813,43813,27B6DDFE3A356062F221ABD7AD70BB14,11061,0,5,5,29,48,1498
43814,43814,27B6DDFE3A356062F221ABD7AD70BB14,10681,7,12,5,30,48,1548
43815,43815,27B6DDFE3A356062F221ABD7AD70BB14,11061,12,14,2,29,48,1498
43816,43816,27B6DDFE3A356062F221ABD7AD70BB14,10681,14,16,2,30,48,1548
43817,43817,27B6DDFE3A356062F221ABD7AD70BB14,11061,18,23,5,29,48,1498
43821,43821,3685D6C71438FECB08DB0F37510D88D0,12514,0,7,7,38,47,1947
43822,43822,3685D6C71438FECB08DB0F37510D88D0,42961,11,15,4,35,49,1799
43823,43823,3685D6C71438FECB08DB0F37510D88D0,10841,16,23,7,37,47,1897
43824,43824,83823305B701824CEA13C3092045A23D,19441,0,4,4,8,46,446
43825,43825,83823305B701824CEA13C3092045A23D,19821,8,9,1,4,46,246
43826,43826,83823305B701824CEA13C3092045A23D,19441,11,14,3,8,46,446
43827,43827,83823305B701824CEA13C3092045A23D,19821,15,16,1,4,46,246
43828,43828,83823305B701824CEA13C3092045A23D,19441,18,21,3,8,46,446
43839,43839,CB6CE8B284764CB65EC4187E6FE5A3FF,11571,0,6,6,13,46,696
43840,43840,CB6CE8B284764CB65EC4187E6FE5A3FF,43021,7,16,9,16,43,843
43841,43841,CB6CE8B284764CB65EC4187E6FE5A3FF,19021,19,23,4,10,45,545
43842,43842,81B3D3DE315A50BFF7647F0A1B64DB94,42041,0,6,6,10,47,547
43843,43843,81B3D3DE315A50BFF7647F0A1B64DB94,19441,11,15,4,8,46,446
43844,43844,81B3D3DE315A50BFF7647F0A1B64DB94,19114,17,19,2,7,43,393
43848,43848,47CD03C948687C96861434761EE3E932,10621,0,6,6,41,49,2099
43849,43849,47CD03C948687C96861434761EE3E932,19024,8,17,9,9,45,495
43850,43850,47CD03C948687C96861434761EE3E932,10621,18,23,5,41,49,2099
43854,43854,409A27121CD9E6BC90762C45B277F54C,11861,0,6,6,32,47,1647
43855,43855,409A27121CD9E6BC90762C45B277F54C,43281,8,19,11,37,48,1898
43856,43856,409A27121CD9E6BC90762C45B277F54C,11861,19,22,3,32,47,1647
43864,43864,65DC6D7E0D0711C631BBF21B13250F06,13101,1,7,6,40,47,2047
43865,43865,65DC6D7E0D0711C631BBF21B13250F06,13941,10,15,5,41,47,2097
43866,43866,65DC6D7E0D0711C631BBF21B13250F06,13101,16,17,1,40,47,2047
43867,43867,65DC6D7E0D0711C631BBF21B13250F06,13941,19,20,1,41,47,2097
43868,43868,65DC6D7E0D0711C631BBF21B13250F06,12511,20,22,2,39,47,1997
43869,43869,65DC6D7E0D0711C631BBF21B13250F06,13941,22,23,1,41,47,2097
43870,43870,8AAB036B09D3D2F76995D9AF3741FD6E,10381,0,8,8,31,49,1599
43871,43871,8AAB036B09D3D2F76995D9AF3741FD6E,42081,10,12,2,24,49,1249
43872,43872,8AAB036B09D3D2F76995D9AF3741FD6E,43391,13,21,8,29,48,1498
43877,43877,B9FBDBB8262D526458E71FBF2697E7B4,11351,0,10,10,36,48,1848
43878,43878,B9FBDBB8262D526458E71FBF2697E7B4,40343,12,15,3,24,49,1249
43879,43879,B9FBDBB8262D526458E71FBF2697E7B4,10251,19,20,1,35,47,1797
43880,43880,B9FBDBB8262D526458E71FBF2697E7B4,11351,22,23,1,36,48,1848
43881,43881,36E4D456967ADF7C503C23EAE8460AAD,42523,1,2,1,31,47,1597
43882,43882,36E4D456967ADF7C503C23EAE8460AAD,13651,3,10,7,30,47,1547
43883,43883,36E4D456967ADF7C503C23EAE8460AAD,42521,11,13,2,31,47,1597
43884,43884,36E4D456967ADF7C503C23EAE8460AAD,40331,13,14,1,30,47,1547
43885,43885,36E4D456967ADF7C503C23EAE8460AAD,42523,15,17,2,31,47,1597
43886,43886,36E4D456967ADF7C503C23EAE8460AAD,13651,18,20,2,30,47,1547
43887,43887,36E4D456967ADF7C503C23EAE8460AAD,11431,22,23,1,29,47,1497
43888,43888,470BE60325DA2FBBD1F75F1607157E14,12521,0,10,10,35,41,1791
43889,43889,470BE60325DA2FBBD1F75F1607157E14,13314,10,11,1,31,39,1589
43890,43890,470BE60325DA2FBBD1F75F1607157E14,12521,11,23,12,35,41,1791
43891,43891,E675A65705B47E64E764764AA7201F3F,15411,0,8,8,44,27,2227
43892,43892,E675A65705B47E64E764764AA7201F3F,12611,8,9,1,41,29,2079
43893,43893,E675A65705B47E64E764764AA7201F3F,15411,10,23,13,44,27,2227
43894,43894,1228A94EA6C2D4622CFEAC816DA2851D,10901,9,11,2,35,48,1798
43895,43895,1228A94EA6C2D4622CFEAC816DA2851D,12083,12,17,5,36,49,1849
43896,43896,1228A94EA6C2D4622CFEAC816DA2851D,13221,19,20,1,40,47,2047
43900,43900,D5C98D28246C767D0FFD7F7274CFF193,13314,0,14,14,31,39,1589
43901,43901,D5C98D28246C767D0FFD7F7274CFF193,12491,15,16,1,36,43,1843
43902,43902,D5C98D28246C767D0FFD7F7274CFF193,42151,16,18,2,35,45,1795
43903,43903,D5C98D28246C767D0FFD7F7274CFF193,13314,18,23,5,31,39,1589
43904,43904,D214CC95B9E9D4FFF0AC533F3348CC17,10951,9,10,1,29,48,1498
43905,43905,D214CC95B9E9D4FFF0AC533F3348CC17,11541,13,15,2,35,49,1799
43906,43906,D214CC95B9E9D4FFF0AC533F3348CC17,42071,16,18,2,31,49,1599
43916,43916,C1CD30FCC21170A186224DCEDB85098D,11875,0,6,6,30,46,1546
43917,43917,C1CD30FCC21170A186224DCEDB85098D,11871,7,8,1,29,46,1496
43918,43918,C1CD30FCC21170A186224DCEDB85098D,42531,13,15,2,31,45,1595
43919,43919,C1CD30FCC21170A186224DCEDB85098D,10634,18,19,1,27,45,1395
43920,43920,C1CD30FCC21170A186224DCEDB85098D,11875,20,23,3,30,46,1546
43921,43921,92D731B11080166AE9677089A81E2175,10491,0,8,8,33,48,1698
43922,43922,92D731B11080166AE9677089A81E2175,41601,12,14,2,39,49,1999
43923,43923,92D731B11080166AE9677089A81E2175,10491,15,23,8,33,48,1698
43928,43928,DFA44588B9F7612E59AB24A1351E5F4F,12921,1,7,6,9,41,491
43929,43929,DFA44588B9F7612E59AB24A1351E5F4F,49201,9,10,1,7,41,391
43930,43930,DFA44588B9F7612E59AB24A1351E5F4F,12921,12,13,1,9,41,491
43931,43931,DFA44588B9F7612E59AB24A1351E5F4F,49201,15,18,3,7,41,391
43932,43932,DFA44588B9F7612E59AB24A1351E5F4F,12921,20,22,2,9,41,491
43943,43943,6EB03DEC41F60785258F0AA9E4E23DB1,12761,0,7,7,25,40,1290
43944,43944,6EB03DEC41F60785258F0AA9E4E23DB1,13314,10,15,5,31,39,1589
43945,43945,6EB03DEC41F60785258F0AA9E4E23DB1,12521,17,23,6,35,41,1791
43949,43949,B45D59A19F6B61302F993D2909F39450,12031,0,7,7,33,48,1698
43950,43950,B45D59A19F6B61302F993D2909F39450,11061,8,10,2,29,48,1498
43951,43951,B45D59A19F6B61302F993D2909F39450,40445,10,13,3,30,48,1548
43952,43952,B45D59A19F6B61302F993D2909F39450,11061,13,14,1,29,48,1498
43953,43953,B45D59A19F6B61302F993D2909F39450,12031,15,16,1,33,48,1698
43954,43954,B45D59A19F6B61302F993D2909F39450,43971,16,17,1,30,48,1548
43955,43955,B45D59A19F6B61302F993D2909F39450,10881,18,22,4,34,48,1748
43956,43956,D204F66438DC4B5F5A1EF1781831E902,11291,0,10,10,40,49,2049
43957,43957,D204F66438DC4B5F5A1EF1781831E902,40341,13,16,3,23,49,1199
43958,43958,D204F66438DC4B5F5A1EF1781831E902,11291,19,23,4,40,49,2049
43959,43959,6CD008CBF5332727B7FB0E79DB4BAD66,11861,1,14,13,32,47,1647
43960,43960,6CD008CBF5332727B7FB0E79DB4BAD66,10161,17,19,2,35,49,1799
43961,43961,6CD008CBF5332727B7FB0E79DB4BAD66,12083,19,20,1,36,49,1849
43962,43962,7977837C561DAF2BE63B159C5447A829,42371,0,6,6,34,46,1746
43963,43963,7977837C561DAF2BE63B159C5447A829,13671,7,14,7,27,43,1393
43964,43964,7977837C561DAF2BE63B159C5447A829,42371,18,22,4,34,46,1746
43968,43968,09C2A5500F5ABAEEAC932C07F5628EC4,11021,0,8,8,36,49,1849
43969,43969,09C2A5500F5ABAEEAC932C07F5628EC4,43161,8,12,4,35,47,1797
43970,43970,09C2A5500F5ABAEEAC932C07F5628EC4,11021,12,13,1,36,49,1849
43971,43971,09C2A5500F5ABAEEAC932C07F5628EC4,43161,14,19,5,35,47,1797
43972,43972,09C2A5500F5ABAEEAC932C07F5628EC4,11021,20,22,2,36,49,1849
43979,43979,F276DA0C0E39AE3BAD5B91AE46CB6EA8,42971,0,5,5,43,49,2199
43980,43980,F276DA0C0E39AE3BAD5B91AE46CB6EA8,10471,6,11,5,37,48,1898
43981,43981,F276DA0C0E39AE3BAD5B91AE46CB6EA8,11231,11,12,1,37,49,1899
43982,43982,F276DA0C0E39AE3BAD5B91AE46CB6EA8,10471,12,20,8,37,48,1898
43983,43983,F276DA0C0E39AE3BAD5B91AE46CB6EA8,13941,21,22,1,41,47,2097
43987,43987,665D84DE00719CFBCFE85E60D38EDE84,10841,0,5,5,37,47,1897
43988,43988,665D84DE00719CFBCFE85E60D38EDE84,12511,9,10,1,39,47,1997
43989,43989,665D84DE00719CFBCFE85E60D38EDE84,12514,11,13,2,38,47,1947
43990,43990,665D84DE00719CFBCFE85E60D38EDE84,10841,15,16,1,37,47,1897
43991,43991,665D84DE00719CFBCFE85E60D38EDE84,11541,20,23,3,35,49,1799
43992,43992,FEDEF2AAA43A7294016C8832F60DF7EF,11061,0,10,10,29,48,1498
43993,43993,FEDEF2AAA43A7294016C8832F60DF7EF,42381,12,14,2,39,41,1991
43994,43994,FEDEF2AAA43A7294016C8832F60DF7EF,11061,16,21,5,29,48,1498
43995,43995,BBCB9918D42B41DEDF16DD7F5A9BE26F,11861,0,10,10,32,47,1647
43996,43996,BBCB9918D42B41DEDF16DD7F5A9BE26F,11331,12,16,4,37,48,1898
43997,43997,BBCB9918D42B41DEDF16DD7F5A9BE26F,11861,17,23,6,32,47,1647
44001,44001,7B2A043D515CB61698DD480E69194AE5,19901,1,6,5,7,44,394
44002,44002,7B2A043D515CB61698DD480E69194AE5,12921,10,16,6,9,41,491
44003,44003,7B2A043D515CB61698DD480E69194AE5,19621,19,23,4,5,46,296
44007,44007,92C6D620DD1EA6C51C8E9A9B9F8BCAFB,10061,0,5,5,20,46,1046
44008,44008,92C6D620DD1EA6C51C8E9A9B9F8BCAFB,11074,11,12,1,37,47,1897
44009,44009,92C6D620DD1EA6C51C8E9A9B9F8BCAFB,42301,12,23,11,36,47,1847
44010,44010,E429D5687CEEDF3C035534BDDBC8B9F3,13271,1,5,4,41,47,2097
44011,44011,E429D5687CEEDF3C035534BDDBC8B9F3,13101,7,10,3,40,47,2047
44012,44012,E429D5687CEEDF3C035534BDDBC8B9F3,11806,12,13,1,41,48,2098
44013,44013,E429D5687CEEDF3C035534BDDBC8B9F3,13271,16,17,1,41,47,2097
44014,44014,E429D5687CEEDF3C035534BDDBC8B9F3,13101,17,19,2,40,47,2047
44015,44015,AD235EE6A83CA7956AB86E8BC887D3C7,11541,0,6,6,35,49,1799
44016,44016,AD235EE6A83CA7956AB86E8BC887D3C7,11021,6,11,5,36,49,1849
44017,44017,AD235EE6A83CA7956AB86E8BC887D3C7,13561,13,16,3,37,49,1899
44018,44018,AD235EE6A83CA7956AB86E8BC887D3C7,11021,16,17,1,36,49,1849
44019,44019,AD235EE6A83CA7956AB86E8BC887D3C7,11541,19,23,4,35,49,1799
44020,44020,809D30997DBB6653E10DF33CB05A97F7,13771,0,2,2,21,45,1095
44021,44021,809D30997DBB6653E10DF33CB05A97F7,12601,2,4,2,25,47,1297
44022,44022,809D30997DBB6653E10DF33CB05A97F7,13771,4,15,11,21,45,1095
44023,44023,809D30997DBB6653E10DF33CB05A97F7,12601,17,19,2,25,47,1297
44024,44024,809D30997DBB6653E10DF33CB05A97F7,13771,20,21,1,21,45,1095
44025,44025,D1161F75E2083066372593043FD61104,42511,0,4,4,37,47,1897
44026,44026,D1161F75E2083066372593043FD61104,40123,6,7,1,38,47,1947
44027,44027,D1161F75E2083066372593043FD61104,42511,9,10,1,37,47,1897
44028,44028,D1161F75E2083066372593043FD61104,12514,13,21,8,38,47,1947
44029,44029,D1161F75E2083066372593043FD61104,42511,21,22,1,37,47,1897
44033,44033,384DFF9F4EC9F66B0D32D11AEF340F73,10601,0,6,6,39,47,1997
44034,44034,384DFF9F4EC9F66B0D32D11AEF340F73,43321,7,8,1,36,49,1849
44035,44035,384DFF9F4EC9F66B0D32D11AEF340F73,10601,19,23,4,39,47,1997
44036,44036,40A368CA34750DF505DA57A322872C86,15411,0,1,1,44,27,2227
44037,44037,40A368CA34750DF505DA57A322872C86,13781,1,4,3,48,32,2432
44038,44038,40A368CA34750DF505DA57A322872C86,15411,6,8,2,44,27,2227
44039,44039,40A368CA34750DF505DA57A322872C86,12611,9,23,14,41,29,2079
44040,44040,132BAF41704DD845C2F70543C3732C4E,42231,3,4,1,37,46,1896
44041,44041,132BAF41704DD845C2F70543C3732C4E,13711,5,6,1,38,46,1946
44042,44042,132BAF41704DD845C2F70543C3732C4E,42231,7,8,1,37,46,1896
44043,44043,132BAF41704DD845C2F70543C3732C4E,13711,11,16,5,38,46,1946
44044,44044,132BAF41704DD845C2F70543C3732C4E,42231,16,22,6,37,46,1896
44045,44045,04FDCC702F37E16DD9968ED131B1ACEB,42351,0,6,6,38,45,1945
44046,44046,04FDCC702F37E16DD9968ED131B1ACEB,11531,15,17,2,34,49,1749
44047,44047,04FDCC702F37E16DD9968ED131B1ACEB,42351,20,23,3,38,45,1945
44051,44051,8631F5DFCE39718648FAD1AB435C0892,12521,0,8,8,35,41,1791
44052,44052,8631F5DFCE39718648FAD1AB435C0892,13314,13,14,1,31,39,1589
44053,44053,8631F5DFCE39718648FAD1AB435C0892,12521,18,23,5,35,41,1791
44054,44054,15351107348D533F1A62174A9ED24724,13314,0,7,7,31,39,1589
44055,44055,15351107348D533F1A62174A9ED24724,12521,8,16,8,35,41,1791
44056,44056,15351107348D533F1A62174A9ED24724,13314,19,23,4,31,39,1589
44063,44063,2AC8E4C41FCDCF53C09A83820985C782,10171,2,13,11,26,47,1347
44064,44064,2AC8E4C41FCDCF53C09A83820985C782,13561,13,16,3,37,49,1899
44065,44065,2AC8E4C41FCDCF53C09A83820985C782,42523,17,18,1,31,47,1597
44066,44066,2AC8E4C41FCDCF53C09A83820985C782,10171,19,20,1,26,47,1347
44070,44070,B8EDADC48576B0A1D5B2B3A1DB073379,42281,0,7,7,40,48,2048
44071,44071,B8EDADC48576B0A1D5B2B3A1DB073379,12311,11,13,2,30,44,1544
44072,44072,B8EDADC48576B0A1D5B2B3A1DB073379,42281,16,19,3,40,48,2048
44073,44073,60BB861F94B96C3B82B1EC87E2C7E89A,40891,0,2,2,37,47,1897
44074,44074,60BB861F94B96C3B82B1EC87E2C7E89A,43581,3,8,5,33,48,1698
44075,44075,60BB861F94B96C3B82B1EC87E2C7E89A,11201,8,12,4,35,49,1799
44076,44076,60BB861F94B96C3B82B1EC87E2C7E89A,43471,14,15,1,31,49,1599
44077,44077,60BB861F94B96C3B82B1EC87E2C7E89A,11151,16,17,1,30,48,1548
44078,44078,60BB861F94B96C3B82B1EC87E2C7E89A,43361,21,23,2,38,48,1948
44083,44083,1E478A5FEF40D5F63DF757696B4C9EAC,13511,0,1,1,34,48,1748
44084,44084,1E478A5FEF40D5F63DF757696B4C9EAC,42531,3,15,12,31,45,1595
44085,44085,1E478A5FEF40D5F63DF757696B4C9EAC,11061,15,17,2,29,48,1498
44086,44086,1E478A5FEF40D5F63DF757696B4C9EAC,13511,19,20,1,34,48,1748
44094,44094,A52680CFF3255B80F2E899094DC1E938,13951,0,13,13,47,45,2395
44095,44095,A52680CFF3255B80F2E899094DC1E938,43951,14,17,3,49,41,2491
44096,44096,A52680CFF3255B80F2E899094DC1E938,13951,18,23,5,47,45,2395
44104,44104,BCBA00BEAEB6DE0B9A71959AB040ABB5,42631,0,8,8,43,45,2195
44105,44105,BCBA00BEAEB6DE0B9A71959AB040ABB5,12221,8,13,5,43,44,2194
44106,44106,BCBA00BEAEB6DE0B9A71959AB040ABB5,11481,15,18,3,41,48,2098
44107,44107,BCBA00BEAEB6DE0B9A71959AB040ABB5,42151,20,21,1,35,45,1795
44108,44108,BCBA00BEAEB6DE0B9A71959AB040ABB5,11481,22,23,1,41,48,2098
44109,44109,E6D81E469C44EB9F04595FA339D668BE,11541,1,11,10,35,49,1799
44110,44110,E6D81E469C44EB9F04595FA339D668BE,40341,12,16,4,23,49,1199
44111,44111,E6D81E469C44EB9F04595FA339D668BE,11541,16,23,7,35,49,1799
44125,44125,27FD8A6CDE751A5F2BC12F75826C7985,43021,3,4,1,16,43,843
44126,44126,27FD8A6CDE751A5F2BC12F75826C7985,12921,6,16,10,9,41,491
44127,44127,27FD8A6CDE751A5F2BC12F75826C7985,43021,17,21,4,16,43,843
44128,44128,B33429D7A00DB66721EA07FF9AC9AB45,11861,0,9,9,32,47,1647
44129,44129,B33429D7A00DB66721EA07FF9AC9AB45,11231,9,22,13,37,49,1899
44130,44130,B33429D7A00DB66721EA07FF9AC9AB45,11861,22,23,1,32,47,1647
44131,44131,08B6161A63F0BFCCF67BFC0EA5B81E44,42621,0,7,7,24,49,1249
44132,44132,08B6161A63F0BFCCF67BFC0EA5B81E44,40341,8,10,2,23,49,1199
44133,44133,08B6161A63F0BFCCF67BFC0EA5B81E44,42621,11,13,2,24,49,1249
44134,44134,08B6161A63F0BFCCF67BFC0EA5B81E44,40341,14,18,4,23,49,1199
44135,44135,08B6161A63F0BFCCF67BFC0EA5B81E44,42081,18,23,5,24,49,1249
44136,44136,DB020001015A5B58B041C450BD45A3E6,40636,0,1,1,35,48,1798
44137,44137,DB020001015A5B58B041C450BD45A3E6,11381,2,8,6,30,47,1547
44138,44138,DB020001015A5B58B041C450BD45A3E6,10951,9,16,7,29,48,1498
44139,44139,DB020001015A5B58B041C450BD45A3E6,11381,17,19,2,30,47,1547
44140,44140,DB020001015A5B58B041C450BD45A3E6,10951,19,20,1,29,48,1498
44141,44141,DB020001015A5B58B041C450BD45A3E6,11381,22,23,1,30,47,1547
44142,44142,346BF3F539A4C5C04EF0491F7207CF76,19114,0,5,5,7,43,393
44143,44143,346BF3F539A4C5C04EF0491F7207CF76,12641,10,11,1,10,43,543
44144,44144,346BF3F539A4C5C04EF0491F7207CF76,19114,15,17,2,7,43,393
44145,44145,346BF3F539A4C5C04EF0491F7207CF76,19021,17,19,2,10,45,545
44146,44146,346BF3F539A4C5C04EF0491F7207CF76,19114,21,23,2,7,43,393
44147,44147,E70D7D9FFCA3595072E46938E2BC5479,11921,0,1,1,38,48,1948
44148,44148,E70D7D9FFCA3595072E46938E2BC5479,11914,2,7,5,37,48,1898
44149,44149,E70D7D9FFCA3595072E46938E2BC5479,11921,11,12,1,38,48,1948
44150,44150,E70D7D9FFCA3595072E46938E2BC5479,10591,17,18,1,39,48,1998
44151,44151,E70D7D9FFCA3595072E46938E2BC5479,11921,21,22,1,38,48,1948
44155,44155,8CA5541DB161F52D96D581A76882C352,42201,0,7,7,43,46,2196
44156,44156,8CA5541DB161F52D96D581A76882C352,42461,8,11,3,45,47,2297
44157,44157,8CA5541DB161F52D96D581A76882C352,41393,12,13,1,43,49,2199
44158,44158,8CA5541DB161F52D96D581A76882C352,13911,15,19,4,39,46,1996
44159,44159,8CA5541DB161F52D96D581A76882C352,42461,19,20,1,45,47,2297
44163,44163,7BF71B893274BD2453B5FAE00144C714,10292,1,15,14,30,47,1547
44164,44164,7BF71B893274BD2453B5FAE00144C714,10251,15,17,2,35,47,1797
44165,44165,7BF71B893274BD2453B5FAE00144C714,13651,18,21,3,30,47,1547
44172,44172,4F067AC0455A0AD68F9A6EB159316E5A,40271,0,1,1,35,49,1799
44173,44173,4F067AC0455A0AD68F9A6EB159316E5A,11331,2,10,8,37,48,1898
44174,44174,4F067AC0455A0AD68F9A6EB159316E5A,12841,13,14,1,37,47,1897
44175,44175,4F067AC0455A0AD68F9A6EB159316E5A,42161,14,16,2,36,47,1847
44176,44176,4F067AC0455A0AD68F9A6EB159316E5A,12841,16,18,2,37,47,1897
44177,44177,4F067AC0455A0AD68F9A6EB159316E5A,42471,18,19,1,35,49,1799
44178,44178,4F067AC0455A0AD68F9A6EB159316E5A,10111,20,23,3,37,47,1897
44186,44186,1F2097BFD376C7AE91373DF4BF4B7973,10471,5,13,8,37,48,1898
44187,44187,1F2097BFD376C7AE91373DF4BF4B7973,42521,14,15,1,31,47,1597
44188,44188,1F2097BFD376C7AE91373DF4BF4B7973,10471,18,23,5,37,48,1898
44193,44193,EC8D784C19C185B8F2C30A9ECA831652,13911,0,4,4,39,46,1996
44194,44194,EC8D784C19C185B8F2C30A9ECA831652,11261,6,11,5,36,46,1846
44195,44195,EC8D784C19C185B8F2C30A9ECA831652,13911,12,14,2,39,46,1996
44196,44196,EC8D784C19C185B8F2C30A9ECA831652,11261,14,17,3,36,46,1846
44197,44197,EC8D784C19C185B8F2C30A9ECA831652,13911,21,23,2,39,46,1996
44198,44198,6587B781598530C86F6C53CA6F1512D2,10431,0,8,8,33,49,1699
44199,44199,6587B781598530C86F6C53CA6F1512D2,10351,8,10,2,28,45,1445
44200,44200,6587B781598530C86F6C53CA6F1512D2,10631,16,17,1,28,46,1446
44201,44201,6587B781598530C86F6C53CA6F1512D2,10431,20,23,3,33,49,1699
44202,44202,34E034C7E252A713FC4B001D32811D5C,11021,0,2,2,36,49,1849
44203,44203,34E034C7E252A713FC4B001D32811D5C,13561,3,6,3,37,49,1899
44204,44204,34E034C7E252A713FC4B001D32811D5C,11021,7,8,1,36,49,1849
44205,44205,34E034C7E252A713FC4B001D32811D5C,11211,8,12,4,34,49,1749
44206,44206,34E034C7E252A713FC4B001D32811D5C,11541,13,14,1,35,49,1799
44207,44207,34E034C7E252A713FC4B001D32811D5C,43581,16,17,1,33,48,1698
44208,44208,34E034C7E252A713FC4B001D32811D5C,11541,18,19,1,35,49,1799
44209,44209,34E034C7E252A713FC4B001D32811D5C,41061,21,22,1,34,49,1749
44210,44210,E528C1BCF7730647027A4A7EFB058975,42631,0,2,2,43,45,2195
44211,44211,E528C1BCF7730647027A4A7EFB058975,13341,3,4,1,44,45,2245
44212,44212,E528C1BCF7730647027A4A7EFB058975,42631,5,6,1,43,45,2195
44213,44213,E528C1BCF7730647027A4A7EFB058975,13341,7,8,1,44,45,2245
44214,44214,E528C1BCF7730647027A4A7EFB058975,43061,11,14,3,43,46,2196
44215,44215,E528C1BCF7730647027A4A7EFB058975,42631,18,23,5,43,45,2195
44216,44216,6FB797EB6199E5FFE9AFEE7B6DE6AC00,40343,4,5,1,24,49,1249
44217,44217,6FB797EB6199E5FFE9AFEE7B6DE6AC00,42681,8,9,1,24,48,1248
44218,44218,6FB797EB6199E5FFE9AFEE7B6DE6AC00,11641,10,11,1,22,49,1149
44219,44219,6FB797EB6199E5FFE9AFEE7B6DE6AC00,42681,11,13,2,24,48,1248
44220,44220,6FB797EB6199E5FFE9AFEE7B6DE6AC00,40343,14,16,2,24,49,1249
44221,44221,6FB797EB6199E5FFE9AFEE7B6DE6AC00,10381,17,19,2,31,49,1599
44222,44222,6FB797EB6199E5FFE9AFEE7B6DE6AC00,40343,22,23,1,24,49,1249
44226,44226,1277ACA424D6A91D4C363B632562549C,12601,1,2,1,25,47,1297
44227,44227,1277ACA424D6A91D4C363B632562549C,10501,5,6,1,22,46,1146
44228,44228,1277ACA424D6A91D4C363B632562549C,12601,6,14,8,25,47,1297
44229,44229,1277ACA424D6A91D4C363B632562549C,10501,14,16,2,22,46,1146
44230,44230,1277ACA424D6A91D4C363B632562549C,12601,17,23,6,25,47,1297
44231,44231,7FC5EC6D5DFA02928A2B6D37E8B80603,43011,3,6,3,40,42,2042
44232,44232,7FC5EC6D5DFA02928A2B6D37E8B80603,43101,6,9,3,46,40,2340
44233,44233,7FC5EC6D5DFA02928A2B6D37E8B80603,43011,11,13,2,40,42,2042
44234,44234,7FC5EC6D5DFA02928A2B6D37E8B80603,13551,14,16,2,45,38,2288
44235,44235,7FC5EC6D5DFA02928A2B6D37E8B80603,43101,21,22,1,46,40,2340
44236,44236,ECC55A41DE7DF4FF6A356DE1634B0C55,19264,0,6,6,10,36,536
44237,44237,ECC55A41DE7DF4FF6A356DE1634B0C55,19261,8,10,2,6,37,337
44238,44238,ECC55A41DE7DF4FF6A356DE1634B0C55,43644,10,11,1,14,38,738
44239,44239,ECC55A41DE7DF4FF6A356DE1634B0C55,19264,12,19,7,10,36,536
44240,44240,93DD2C863C5AA53C83002ED6F1D5AEBB,19031,0,6,6,1,42,92
44241,44241,93DD2C863C5AA53C83002ED6F1D5AEBB,12641,7,8,1,10,43,543
44242,44242,93DD2C863C5AA53C83002ED6F1D5AEBB,49201,10,13,3,7,41,391
44243,44243,93DD2C863C5AA53C83002ED6F1D5AEBB,12641,15,17,2,10,43,543
44244,44244,93DD2C863C5AA53C83002ED6F1D5AEBB,49201,19,23,4,7,41,391
44245,44245,5F14E1A15EFA1C13F8B10CBC543F107C,10191,0,6,6,40,48,2048
44246,44246,5F14E1A15EFA1C13F8B10CBC543F107C,12581,8,10,2,24,48,1248
44247,44247,5F14E1A15EFA1C13F8B10CBC543F107C,42583,12,20,8,40,48,2048
44255,44255,7C975D0C88EA67D672EB56E3A3056887,13314,0,7,7,31,39,1589
44256,44256,7C975D0C88EA67D672EB56E3A3056887,13671,9,17,8,27,43,1393
44257,44257,7C975D0C88EA67D672EB56E3A3056887,13314,19,20,1,31,39,1589
44258,44258,7C975D0C88EA67D672EB56E3A3056887,13671,20,23,3,27,43,1393
44263,44263,756266AA2D3282E41A15D30D8262945F,43311,0,9,9,31,48,1598
44264,44264,756266AA2D3282E41A15D30D8262945F,11074,10,11,1,37,47,1897
44265,44265,756266AA2D3282E41A15D30D8262945F,12381,16,18,2,32,48,1648
44266,44266,756266AA2D3282E41A15D30D8262945F,43311,21,22,1,31,48,1598
44267,44267,7771A00C4CF355D8E5B79CE90CE8001F,19114,0,10,10,7,43,393
44268,44268,7771A00C4CF355D8E5B79CE90CE8001F,40691,14,16,2,42,48,2148
44269,44269,7771A00C4CF355D8E5B79CE90CE8001F,13351,18,19,1,48,48,2448
44274,44274,7FC90A7046789407FE1CCFF00DDA96C6,10911,0,7,7,39,46,1996
44275,44275,7FC90A7046789407FE1CCFF00DDA96C6,40343,7,8,1,24,49,1249
44276,44276,7FC90A7046789407FE1CCFF00DDA96C6,40347,12,14,2,25,49,1299
44277,44277,7FC90A7046789407FE1CCFF00DDA96C6,10544,16,18,2,28,48,1448
44278,44278,7FC90A7046789407FE1CCFF00DDA96C6,42121,18,19,1,26,49,1349
44279,44279,7FC90A7046789407FE1CCFF00DDA96C6,10331,22,23,1,39,46,1996
44284,44284,5ADA9660158083BA681D3EABE7C6BBBF,42864,2,4,2,38,44,1944
44285,44285,5ADA9660158083BA681D3EABE7C6BBBF,42861,5,10,5,37,44,1894
44286,44286,5ADA9660158083BA681D3EABE7C6BBBF,11261,12,13,1,36,46,1846
44287,44287,5ADA9660158083BA681D3EABE7C6BBBF,42861,14,18,4,37,44,1894
44288,44288,5ADA9660158083BA681D3EABE7C6BBBF,42864,19,22,3,38,44,1944
44289,44289,40DFEFDD084B7E6FA138B7FBB6CFBE81,13711,1,3,2,38,46,1946
44290,44290,40DFEFDD084B7E6FA138B7FBB6CFBE81,10951,8,12,4,29,48,1498
44291,44291,40DFEFDD084B7E6FA138B7FBB6CFBE81,13711,15,16,1,38,46,1946
44292,44292,40DFEFDD084B7E6FA138B7FBB6CFBE81,10881,18,23,5,34,48,1748
44299,44299,FADBD24FB94D9388BE2E59D5F595D57D,42161,6,8,2,36,47,1847
44300,44300,FADBD24FB94D9388BE2E59D5F595D57D,11481,11,15,4,41,48,2098
44301,44301,FADBD24FB94D9388BE2E59D5F595D57D,42461,15,17,2,45,47,2297
44302,44302,FADBD24FB94D9388BE2E59D5F595D57D,11481,17,19,2,41,48,2098
44303,44303,8041A15FE7194930A61AB1E513A40329,11231,0,8,8,37,49,1899
44304,44304,8041A15FE7194930A61AB1E513A40329,12792,9,10,1,34,30,1730
44305,44305,8041A15FE7194930A61AB1E513A40329,10661,12,23,11,37,49,1899
44306,44306,B7C01AFA6392259D8F950CD5BD5A252C,43751,0,6,6,19,48,998
44307,44307,B7C01AFA6392259D8F950CD5BD5A252C,42481,9,10,1,22,49,1149
44308,44308,B7C01AFA6392259D8F950CD5BD5A252C,12581,12,17,5,24,48,1248
44309,44309,B7C01AFA6392259D8F950CD5BD5A252C,43751,19,23,4,19,48,998
44313,44313,FF54F805BED15CA535E79C80702C6E46,10431,3,7,4,33,49,1699
44314,44314,FF54F805BED15CA535E79C80702C6E46,11231,7,8,1,37,49,1899
44315,44315,FF54F805BED15CA535E79C80702C6E46,10471,11,13,2,37,48,1898
44316,44316,FF54F805BED15CA535E79C80702C6E46,11231,14,17,3,37,49,1899
44317,44317,FF54F805BED15CA535E79C80702C6E46,10431,21,22,1,33,49,1699
44318,44318,8E7E1D3BA1392AF853A6068E181E9940,10191,0,1,1,40,48,2048
44319,44319,8E7E1D3BA1392AF853A6068E181E9940,12971,2,17,15,32,48,1648
44320,44320,8E7E1D3BA1392AF853A6068E181E9940,10191,20,23,3,40,48,2048
44324,44324,E6FF42AEECF0CDA6C42BDBDEFD456416,13951,0,7,7,47,45,2395
44325,44325,E6FF42AEECF0CDA6C42BDBDEFD456416,43951,12,16,4,49,41,2491
44326,44326,E6FF42AEECF0CDA6C42BDBDEFD456416,13411,16,17,1,49,42,2492
44327,44327,E6FF42AEECF0CDA6C42BDBDEFD456416,13951,20,23,3,47,45,2395
44328,44328,BD8BD67215D62E878894988C5EE5CD9E,10681,0,12,12,30,48,1548
44329,44329,BD8BD67215D62E878894988C5EE5CD9E,11061,12,17,5,29,48,1498
44330,44330,BD8BD67215D62E878894988C5EE5CD9E,40341,17,19,2,23,49,1199
44331,44331,BD8BD67215D62E878894988C5EE5CD9E,11061,19,23,4,29,48,1498
44336,44336,6F6BFA140B8F0D41AE13D3CFA2E32A87,19114,0,4,4,7,43,393
44337,44337,6F6BFA140B8F0D41AE13D3CFA2E32A87,10171,7,13,6,26,47,1347
44338,44338,6F6BFA140B8F0D41AE13D3CFA2E32A87,10634,13,17,4,27,45,1395
44339,44339,6F6BFA140B8F0D41AE13D3CFA2E32A87,19114,18,23,5,7,43,393
44344,44344,85E6B4DC96BFA3920E08895C266F386F,13121,0,7,7,38,46,1946
44345,44345,85E6B4DC96BFA3920E08895C266F386F,42601,9,10,1,44,48,2248
44346,44346,85E6B4DC96BFA3920E08895C266F386F,13121,13,16,3,38,46,1946
44347,44347,85E6B4DC96BFA3920E08895C266F386F,42511,17,21,4,37,47,1897
44348,44348,85E6B4DC96BFA3920E08895C266F386F,13681,22,23,1,38,47,1947
44353,44353,2808B465D0CA5BE626B66BA705E41B68,42351,0,4,4,38,45,1945
44354,44354,2808B465D0CA5BE626B66BA705E41B68,42864,6,9,3,38,44,1944
44355,44355,2808B465D0CA5BE626B66BA705E41B68,42861,9,10,1,37,44,1894
44356,44356,2808B465D0CA5BE626B66BA705E41B68,42864,15,18,3,38,44,1944
44357,44357,2808B465D0CA5BE626B66BA705E41B68,11261,21,22,1,36,46,1846
44364,44364,04B22D086E14946EF9C7AA50F41B8F3E,40891,0,9,9,37,47,1897
44365,44365,04B22D086E14946EF9C7AA50F41B8F3E,42161,10,12,2,36,47,1847
44366,44366,04B22D086E14946EF9C7AA50F41B8F3E,40341,15,18,3,23,49,1199
44367,44367,04B22D086E14946EF9C7AA50F41B8F3E,10841,19,21,2,37,47,1897
44368,44368,3DA0BCC83518894F0CE5D638362ECC1B,43731,5,6,1,34,47,1747
44369,44369,3DA0BCC83518894F0CE5D638362ECC1B,15331,10,13,3,38,24,1924
44370,44370,3DA0BCC83518894F0CE5D638362ECC1B,10971,14,15,1,35,47,1797
44371,44371,3DA0BCC83518894F0CE5D638362ECC1B,43731,16,23,7,34,47,1747
44372,44372,FA05CF18A6BF06D3E5C89C49E2940179,43311,0,8,8,31,48,1598
44373,44373,FA05CF18A6BF06D3E5C89C49E2940179,13651,9,10,1,30,47,1547
44374,44374,FA05CF18A6BF06D3E5C89C49E2940179,43971,13,14,1,30,48,1548
44375,44375,FA05CF18A6BF06D3E5C89C49E2940179,11061,19,20,1,29,48,1498
44376,44376,FA05CF18A6BF06D3E5C89C49E2940179,11381,20,21,1,30,47,1547
44386,44386,BF866CAC6181D104CF2321FFD1D54D90,10292,0,7,7,30,47,1547
44387,44387,BF866CAC6181D104CF2321FFD1D54D90,11461,12,16,4,37,49,1899
44388,44388,BF866CAC6181D104CF2321FFD1D54D90,42623,19,20,1,22,49,1149
44399,44399,AD874B03182CDBF19F3B1BFBBB851008,15411,0,4,4,44,27,2227
44400,44400,AD874B03182CDBF19F3B1BFBBB851008,12611,5,7,2,41,29,2079
44401,44401,AD874B03182CDBF19F3B1BFBBB851008,15411,7,19,12,44,27,2227
44402,44402,E748F2254AC2A75A1317C0ED54387A7E,42831,0,6,6,27,48,1398
44403,44403,E748F2254AC2A75A1317C0ED54387A7E,10381,7,10,3,31,49,1599
44404,44404,E748F2254AC2A75A1317C0ED54387A7E,42831,11,13,2,27,48,1398
44405,44405,E748F2254AC2A75A1317C0ED54387A7E,10381,14,18,4,31,49,1599
44406,44406,E748F2254AC2A75A1317C0ED54387A7E,43391,20,22,2,29,48,1498
44407,44407,1F8D58B5730B6C0C264ABCDF1183B8AF,11861,0,9,9,32,47,1647
44408,44408,1F8D58B5730B6C0C264ABCDF1183B8AF,13341,10,14,4,44,45,2245
44409,44409,1F8D58B5730B6C0C264ABCDF1183B8AF,11861,15,17,2,32,47,1647
44410,44410,1F8D58B5730B6C0C264ABCDF1183B8AF,42471,18,21,3,35,49,1799
44411,44411,1F8D58B5730B6C0C264ABCDF1183B8AF,11861,22,23,1,32,47,1647
44428,44428,1C1F6C68185E32864EF19C73864604BB,42581,1,5,4,38,48,1948
44429,44429,1C1F6C68185E32864EF19C73864604BB,11914,8,9,1,37,48,1898
44430,44430,1C1F6C68185E32864EF19C73864604BB,12514,12,13,1,38,47,1947
44431,44431,1C1F6C68185E32864EF19C73864604BB,11914,15,18,3,37,48,1898
44432,44432,1C1F6C68185E32864EF19C73864604BB,42581,22,23,1,38,48,1948
44439,44439,C7FD2E7279929E720FB03466CB10E8E1,12514,2,6,4,38,47,1947
44440,44440,C7FD2E7279929E720FB03466CB10E8E1,42511,6,15,9,37,47,1897
44441,44441,C7FD2E7279929E720FB03466CB10E8E1,11201,17,22,5,35,49,1799
44449,44449,C783F573219BE815B78681C436E8AC03,11875,0,1,1,30,46,1546
44450,44450,C783F573219BE815B78681C436E8AC03,42871,1,4,3,30,45,1545
44451,44451,C783F573219BE815B78681C436E8AC03,11871,5,7,2,29,46,1496
44452,44452,C783F573219BE815B78681C436E8AC03,12601,13,15,2,25,47,1297
44453,44453,C783F573219BE815B78681C436E8AC03,11871,16,22,6,29,46,1496
44454,44454,9F9C2F2F8130961C8BF9030EE1BC7203,13314,9,12,3,31,39,1589
44455,44455,9F9C2F2F8130961C8BF9030EE1BC7203,12521,13,16,3,35,41,1791
44456,44456,9F9C2F2F8130961C8BF9030EE1BC7203,13314,18,21,3,31,39,1589
44464,44464,946768BFA72752D5660750415178C67F,12971,0,1,1,32,48,1648
44465,44465,946768BFA72752D5660750415178C67F,13601,1,7,6,34,47,1747
44466,44466,946768BFA72752D5660750415178C67F,42161,7,9,2,36,47,1847
44467,44467,946768BFA72752D5660750415178C67F,11651,15,17,2,33,47,1697
44468,44468,946768BFA72752D5660750415178C67F,11021,17,20,3,36,49,1849
44469,44469,03D6FFA8E0742D0181BD0480CCE1246D,42511,0,6,6,37,47,1897
44470,44470,03D6FFA8E0742D0181BD0480CCE1246D,13911,9,11,2,39,46,1996
44471,44471,03D6FFA8E0742D0181BD0480CCE1246D,10841,11,13,2,37,47,1897
44472,44472,03D6FFA8E0742D0181BD0480CCE1246D,12514,18,20,2,38,47,1947
44473,44473,03D6FFA8E0742D0181BD0480CCE1246D,42511,21,23,2,37,47,1897
44474,44474,B0DB1916CBE4951CF5091A191DB66ADA,13101,0,6,6,40,47,2047
44475,44475,B0DB1916CBE4951CF5091A191DB66ADA,11781,8,9,1,38,49,1949
44476,44476,B0DB1916CBE4951CF5091A191DB66ADA,13101,12,14,2,40,47,2047
44477,44477,B0DB1916CBE4951CF5091A191DB66ADA,13271,15,19,4,41,47,2097
44478,44478,B0DB1916CBE4951CF5091A191DB66ADA,13101,20,21,1,40,47,2047
44479,44479,3821B66A00758CF4502F36B7CE2D17D9,13071,0,1,1,41,41,2091
44480,44480,3821B66A00758CF4502F36B7CE2D17D9,12491,3,5,2,36,43,1843
44481,44481,3821B66A00758CF4502F36B7CE2D17D9,13071,5,6,1,41,41,2091
44482,44482,3821B66A00758CF4502F36B7CE2D17D9,43451,7,18,11,37,40,1890
44483,44483,3821B66A00758CF4502F36B7CE2D17D9,10811,21,23,2,38,46,1946
44484,44484,3E43826B2F3C90E1974FF5F797EBAA40,42581,0,6,6,38,48,1948
44485,44485,3E43826B2F3C90E1974FF5F797EBAA40,13731,9,18,9,33,49,1699
44486,44486,3E43826B2F3C90E1974FF5F797EBAA40,42581,19,22,3,38,48,1948
44487,44487,715F7A42E71CC3B03C35CCDCAA47978E,19031,0,1,1,1,42,92
44488,44488,715F7A42E71CC3B03C35CCDCAA47978E,43644,2,3,1,14,38,738
44489,44489,715F7A42E71CC3B03C35CCDCAA47978E,12641,6,23,17,10,43,543
44494,44494,74EBB90FA1C414F58477B49370E7F73F,11861,0,6,6,32,47,1647
44495,44495,74EBB90FA1C414F58477B49370E7F73F,12311,7,15,8,30,44,1544
44496,44496,74EBB90FA1C414F58477B49370E7F73F,11861,17,23,6,32,47,1647
44508,44508,EDA2C4329FB051DF0E6F73929F00D19F,42961,9,11,2,35,49,1799
44509,44509,EDA2C4329FB051DF0E6F73929F00D19F,11231,12,14,2,37,49,1899
44510,44510,EDA2C4329FB051DF0E6F73929F00D19F,40341,16,17,1,23,49,1199
44511,44511,EDA2C4329FB051DF0E6F73929F00D19F,11231,19,23,4,37,49,1899
44512,44512,BE6088EB7EB5EC1D9FF63325D41ACC66,42921,9,14,5,33,47,1697
44513,44513,BE6088EB7EB5EC1D9FF63325D41ACC66,40341,17,18,1,23,49,1199
44514,44514,BE6088EB7EB5EC1D9FF63325D41ACC66,40112,21,23,2,32,48,1648
44515,44515,4F218B591484142BCC1168E4506477B5,10431,0,8,8,33,49,1699
44516,44516,4F218B591484142BCC1168E4506477B5,43361,8,10,2,38,48,1948
44517,44517,4F218B591484142BCC1168E4506477B5,12971,11,23,12,32,48,1648
44522,44522,A5A342C5B79B8AEE00BA80AE678B8EC5,10331,0,7,7,39,46,1996
44523,44523,A5A342C5B79B8AEE00BA80AE678B8EC5,11151,8,10,2,30,48,1548
44524,44524,A5A342C5B79B8AEE00BA80AE678B8EC5,10331,12,13,1,39,46,1996
44525,44525,A5A342C5B79B8AEE00BA80AE678B8EC5,11151,15,17,2,30,48,1548
44526,44526,A5A342C5B79B8AEE00BA80AE678B8EC5,10331,18,23,5,39,46,1996
44527,44527,FBABF28F2DF8A279507A0073CB75F7F3,11651,9,11,2,33,47,1697
44528,44528,FBABF28F2DF8A279507A0073CB75F7F3,11781,14,17,3,38,49,1949
44529,44529,FBABF28F2DF8A279507A0073CB75F7F3,11801,21,23,2,42,48,2148
44530,44530,6DFBF28C4BB1FC2BFED5E053C4C14307,19441,0,9,9,8,46,446
44531,44531,6DFBF28C4BB1FC2BFED5E053C4C14307,11301,13,14,1,41,49,2099
44532,44532,6DFBF28C4BB1FC2BFED5E053C4C14307,19441,16,23,7,8,46,446
44540,44540,1EE2B4662D91A666115765FFC90D9A2E,43311,0,7,7,31,48,1598
44541,44541,1EE2B4662D91A666115765FFC90D9A2E,11061,8,13,5,29,48,1498
44542,44542,1EE2B4662D91A666115765FFC90D9A2E,43234,15,16,1,37,49,1899
44543,44543,1EE2B4662D91A666115765FFC90D9A2E,11381,21,23,2,30,47,1547
44544,44544,1B79EB886A5576DB94A20A87F2358771,43751,0,7,7,19,48,998
44545,44545,1B79EB886A5576DB94A20A87F2358771,42681,8,9,1,24,48,1248
44546,44546,1B79EB886A5576DB94A20A87F2358771,43751,9,14,5,19,48,998
44547,44547,1B79EB886A5576DB94A20A87F2358771,11101,15,16,1,18,48,948
44548,44548,1B79EB886A5576DB94A20A87F2358771,43751,18,23,5,19,48,998
44549,44549,48BFDAC45FFDDC1EE0721263D1AD77D7,42511,0,6,6,37,47,1897
44550,44550,48BFDAC45FFDDC1EE0721263D1AD77D7,10107,6,9,3,38,49,1949
44551,44551,48BFDAC45FFDDC1EE0721263D1AD77D7,42511,9,14,5,37,47,1897
44552,44552,48BFDAC45FFDDC1EE0721263D1AD77D7,10251,14,15,1,35,47,1797
44553,44553,48BFDAC45FFDDC1EE0721263D1AD77D7,10841,16,17,1,37,47,1897
44554,44554,48BFDAC45FFDDC1EE0721263D1AD77D7,11211,19,21,2,34,49,1749
44555,44555,48BFDAC45FFDDC1EE0721263D1AD77D7,42511,22,23,1,37,47,1897
44556,44556,2DDB60F9B283A15F9C74B796D02976EA,10161,1,13,12,35,49,1799
44557,44557,2DDB60F9B283A15F9C74B796D02976EA,42351,15,16,1,38,45,1945
44558,44558,2DDB60F9B283A15F9C74B796D02976EA,11751,17,23,6,35,48,1798
44559,44559,C67418603C6E14DD008E5DE04041F064,10271,0,5,5,37,46,1896
44560,44560,C67418603C6E14DD008E5DE04041F064,10841,7,11,4,37,47,1897
44561,44561,C67418603C6E14DD008E5DE04041F064,40341,12,16,4,23,49,1199
44562,44562,C67418603C6E14DD008E5DE04041F064,40891,17,22,5,37,47,1897
44563,44563,53650105F7F25F79263F92D3A7D439AB,42461,2,6,4,45,47,2297
44564,44564,53650105F7F25F79263F92D3A7D439AB,42111,10,12,2,44,46,2246
44565,44565,53650105F7F25F79263F92D3A7D439AB,13941,14,16,2,41,47,2097
44566,44566,53650105F7F25F79263F92D3A7D439AB,42461,17,18,1,45,47,2297
44567,44567,53650105F7F25F79263F92D3A7D439AB,13941,18,21,3,41,47,2097
44571,44571,292AD485DA7AE4FB3CFCA1190DC036DF,42151,0,3,3,35,45,1795
44572,44572,292AD485DA7AE4FB3CFCA1190DC036DF,13231,4,5,1,39,46,1996
44573,44573,292AD485DA7AE4FB3CFCA1190DC036DF,42151,5,14,9,35,45,1795
44574,44574,292AD485DA7AE4FB3CFCA1190DC036DF,12311,14,15,1,30,44,1544
44575,44575,292AD485DA7AE4FB3CFCA1190DC036DF,42151,17,18,1,35,45,1795
44585,44585,6BA615ABDB457D99CABF3A037F4BEFF7,42301,0,10,10,36,47,1847
44586,44586,6BA615ABDB457D99CABF3A037F4BEFF7,13791,15,17,2,42,47,2147
44587,44587,6BA615ABDB457D99CABF3A037F4BEFF7,42301,19,21,2,36,47,1847
44588,44588,6BA615ABDB457D99CABF3A037F4BEFF7,11161,22,23,1,32,48,1648
44593,44593,2E1C815B645A117CCE939C9B12660B1B,40801,1,17,16,43,46,2196
44594,44594,2E1C815B645A117CCE939C9B12660B1B,11541,18,21,3,35,49,1799
44595,44595,2E1C815B645A117CCE939C9B12660B1B,40801,22,23,1,43,46,2196
44596,44596,9860684852E504726B6048155048EB49,42531,0,4,4,31,45,1595
44597,44597,9860684852E504726B6048155048EB49,42151,5,14,9,35,45,1795
44598,44598,9860684852E504726B6048155048EB49,10601,16,19,3,39,47,1997
44599,44599,9860684852E504726B6048155048EB49,42151,21,23,2,35,45,1795
44600,44600,570FC5697D4CEEA6951BDA07BB9D84E2,43061,0,2,2,43,46,2196
44601,44601,570FC5697D4CEEA6951BDA07BB9D84E2,13951,2,9,7,47,45,2395
44602,44602,570FC5697D4CEEA6951BDA07BB9D84E2,43061,10,13,3,43,46,2196
44603,44603,570FC5697D4CEEA6951BDA07BB9D84E2,41031,18,19,1,32,49,1649
44604,44604,570FC5697D4CEEA6951BDA07BB9D84E2,13951,22,23,1,47,45,2395
44605,44605,755A1FA6C962DCA1F0C6C27EDC12A160,13371,0,17,17,41,47,2097
44606,44606,755A1FA6C962DCA1F0C6C27EDC12A160,43731,18,19,1,34,47,1747
44607,44607,755A1FA6C962DCA1F0C6C27EDC12A160,13371,20,23,3,41,47,2097
44615,44615,62AE0185320B5BD682F77890C7D9A32E,11104,1,2,1,17,47,897
44616,44616,62AE0185320B5BD682F77890C7D9A32E,12771,2,5,3,20,46,1046
44617,44617,62AE0185320B5BD682F77890C7D9A32E,40951,10,11,1,36,49,1849
44618,44618,62AE0185320B5BD682F77890C7D9A32E,10901,12,13,1,35,48,1798
44619,44619,62AE0185320B5BD682F77890C7D9A32E,12391,13,15,2,36,49,1849
44620,44620,62AE0185320B5BD682F77890C7D9A32E,12771,17,22,5,20,46,1046
44624,44624,440A5BC995406F5A39B97937FE6675EC,12641,0,2,2,10,43,543
44625,44625,440A5BC995406F5A39B97937FE6675EC,19031,3,4,1,1,42,92
44626,44626,440A5BC995406F5A39B97937FE6675EC,12921,7,8,1,9,41,491
44627,44627,440A5BC995406F5A39B97937FE6675EC,43644,9,10,1,14,38,738
44628,44628,440A5BC995406F5A39B97937FE6675EC,19031,14,16,2,1,42,92
44629,44629,440A5BC995406F5A39B97937FE6675EC,12921,17,18,1,9,41,491
44630,44630,440A5BC995406F5A39B97937FE6675EC,12641,20,23,3,10,43,543
44631,44631,93F2A6A1CC13873D05580CA5FB37A1C7,10841,0,13,13,37,47,1897
44632,44632,93F2A6A1CC13873D05580CA5FB37A1C7,10431,15,17,2,33,49,1699
44633,44633,93F2A6A1CC13873D05580CA5FB37A1C7,10111,21,23,2,37,47,1897
44634,44634,D5E956C95B9299FC5483CEC2293475B0,10901,0,17,17,35,48,1798
44635,44635,D5E956C95B9299FC5483CEC2293475B0,40341,18,19,1,23,49,1199
44636,44636,D5E956C95B9299FC5483CEC2293475B0,10901,20,23,3,35,48,1798
44637,44637,8901C834A10BBD863479FEA29CB07080,13911,0,6,6,39,46,1996
44638,44638,8901C834A10BBD863479FEA29CB07080,12491,11,12,1,36,43,1843
44639,44639,8901C834A10BBD863479FEA29CB07080,42351,13,23,10,38,45,1945
44640,44640,5B38B567B1C7BA8CD66BEFDF9C575D7A,11231,0,12,12,37,49,1899
44641,44641,5B38B567B1C7BA8CD66BEFDF9C575D7A,10681,14,19,5,30,48,1548
44642,44642,5B38B567B1C7BA8CD66BEFDF9C575D7A,43321,22,23,1,36,49,1849
44643,44643,168224C57B653A50506E25377C396A3E,42521,0,14,14,31,47,1597
44644,44644,168224C57B653A50506E25377C396A3E,11384,15,17,2,30,47,1547
44645,44645,168224C57B653A50506E25377C396A3E,40636,18,19,1,35,48,1798
44646,44646,B9E927B8C825AF1AC2891B310330CB7E,13121,0,6,6,38,46,1946
44647,44647,B9E927B8C825AF1AC2891B310330CB7E,43361,8,9,1,38,48,1948
44648,44648,B9E927B8C825AF1AC2891B310330CB7E,13511,10,15,5,34,48,1748
44649,44649,B9E927B8C825AF1AC2891B310330CB7E,42011,15,19,4,36,46,1846
44650,44650,B9E927B8C825AF1AC2891B310330CB7E,12311,20,23,3,30,44,1544
44654,44654,8420BC80E057341A3D646D0572754A34,11074,0,8,8,37,47,1897
44655,44655,8420BC80E057341A3D646D0572754A34,12121,10,12,2,29,47,1497
44656,44656,8420BC80E057341A3D646D0572754A34,42501,13,14,1,28,47,1447
44657,44657,8420BC80E057341A3D646D0572754A34,12921,17,23,6,9,41,491
44658,44658,52D41928FE5974AA22101E4543346076,43731,0,7,7,34,47,1747
44659,44659,52D41928FE5974AA22101E4543346076,42871,12,13,1,30,45,1545
44660,44660,52D41928FE5974AA22101E4543346076,43761,15,18,3,32,47,1647
44664,44664,6E198FFF8A0EEA3FE2F6EEE55F7012CE,19114,0,5,5,7,43,393
44665,44665,6E198FFF8A0EEA3FE2F6EEE55F7012CE,12641,6,10,4,10,43,543
44666,44666,6E198FFF8A0EEA3FE2F6EEE55F7012CE,19114,11,12,1,7,43,393
44667,44667,6E198FFF8A0EEA3FE2F6EEE55F7012CE,12641,13,18,5,10,43,543
44668,44668,6E198FFF8A0EEA3FE2F6EEE55F7012CE,19114,19,23,4,7,43,393
44672,44672,AD3EDA3142ED65E7DCEA2ECC9D2EC5AC,19181,3,7,4,8,40,440
44673,44673,AD3EDA3142ED65E7DCEA2ECC9D2EC5AC,12921,7,8,1,9,41,491
44674,44674,AD3EDA3142ED65E7DCEA2ECC9D2EC5AC,19181,8,10,2,8,40,440
44675,44675,AD3EDA3142ED65E7DCEA2ECC9D2EC5AC,12921,18,20,2,9,41,491
44676,44676,AD3EDA3142ED65E7DCEA2ECC9D2EC5AC,19181,21,22,1,8,40,440
44677,44677,9A0E1728710A4135A2CED14F55D7DC99,10721,1,5,4,31,48,1598
44678,44678,9A0E1728710A4135A2CED14F55D7DC99,43471,5,8,3,31,49,1599
44679,44679,9A0E1728710A4135A2CED14F55D7DC99,40302,9,11,2,40,49,2049
44680,44680,9A0E1728710A4135A2CED14F55D7DC99,43621,17,23,6,46,48,2348
44687,44687,460F97EBC86F8CBF93D1A8D6309E0ED8,43311,0,9,9,31,48,1598
44688,44688,460F97EBC86F8CBF93D1A8D6309E0ED8,11731,9,11,2,36,48,1848
44689,44689,460F97EBC86F8CBF93D1A8D6309E0ED8,43311,12,17,5,31,48,1598
44690,44690,460F97EBC86F8CBF93D1A8D6309E0ED8,42021,18,19,1,33,47,1697
44691,44691,460F97EBC86F8CBF93D1A8D6309E0ED8,41591,19,20,1,34,49,1749
44692,44692,460F97EBC86F8CBF93D1A8D6309E0ED8,43311,21,23,2,31,48,1598
44697,44697,23179CE474279BF26E56795AAD67CA26,12792,1,4,3,34,30,1730
44698,44698,23179CE474279BF26E56795AAD67CA26,15391,4,6,2,35,26,1776
44699,44699,23179CE474279BF26E56795AAD67CA26,12792,6,12,6,34,30,1730
44700,44700,23179CE474279BF26E56795AAD67CA26,15391,18,20,2,35,26,1776
44701,44701,23179CE474279BF26E56795AAD67CA26,12792,21,22,1,34,30,1730
44702,44702,3578C39840212012BBEC7A08D6782A20,19441,0,2,2,8,46,446
44703,44703,3578C39840212012BBEC7A08D6782A20,42551,2,3,1,14,48,748
44704,44704,3578C39840212012BBEC7A08D6782A20,19821,5,10,5,4,46,246
44705,44705,3578C39840212012BBEC7A08D6782A20,41101,13,19,6,32,48,1648
44706,44706,3578C39840212012BBEC7A08D6782A20,19441,20,23,3,8,46,446
44707,44707,52A3E1CE4491060F392925C38B78647A,12381,0,7,7,32,48,1648
44708,44708,52A3E1CE4491060F392925C38B78647A,11074,10,18,8,37,47,1897
44709,44709,52A3E1CE4491060F392925C38B78647A,11771,19,20,1,39,49,1999
44710,44710,40DB4CF5D6D9C80EA6537121F89C3F43,10251,0,8,8,35,47,1797
44711,44711,40DB4CF5D6D9C80EA6537121F89C3F43,10711,9,11,2,29,46,1496
44712,44712,40DB4CF5D6D9C80EA6537121F89C3F43,10251,12,23,11,35,47,1797
44713,44713,ED765AC07D21387339B2A29ECDD013E0,10251,0,8,8,35,47,1797
44714,44714,ED765AC07D21387339B2A29ECDD013E0,11531,10,13,3,34,49,1749
44715,44715,ED765AC07D21387339B2A29ECDD013E0,10251,14,17,3,35,47,1797
44716,44716,ED765AC07D21387339B2A29ECDD013E0,12401,21,22,1,39,49,1999
44717,44717,E0D0733577A14F359296CCED3D780940,41392,0,9,9,43,48,2198
44718,44718,E0D0733577A14F359296CCED3D780940,10107,10,13,3,38,49,1949
44719,44719,E0D0733577A14F359296CCED3D780940,43151,14,16,2,40,49,2049
44720,44720,E0D0733577A14F359296CCED3D780940,11201,17,18,1,35,49,1799
44721,44721,E0D0733577A14F359296CCED3D780940,41392,20,23,3,43,48,2198
44722,44722,83D4CEED38BB3CF6CFCB6A83B566A9F4,13411,0,2,2,49,42,2492
44723,44723,83D4CEED38BB3CF6CFCB6A83B566A9F4,12561,6,7,1,45,43,2293
44724,44724,83D4CEED38BB3CF6CFCB6A83B566A9F4,43951,8,22,14,49,41,2491
44728,44728,4A64F91296EF8C1DAA19E0A02FF0729A,11151,0,7,7,30,48,1548
44729,44729,4A64F91296EF8C1DAA19E0A02FF0729A,10231,8,12,4,39,49,1999
44730,44730,4A64F91296EF8C1DAA19E0A02FF0729A,10251,14,15,1,35,47,1797
44731,44731,4A64F91296EF8C1DAA19E0A02FF0729A,12021,15,17,2,37,49,1899
44732,44732,4A64F91296EF8C1DAA19E0A02FF0729A,10231,19,22,3,39,49,1999
44733,44733,ED1B197D1A6AAA8BFAE9A2A66FB2A911,19901,0,5,5,7,44,394
44734,44734,ED1B197D1A6AAA8BFAE9A2A66FB2A911,12921,8,16,8,9,41,491
44735,44735,ED1B197D1A6AAA8BFAE9A2A66FB2A911,49201,16,22,6,7,41,391
44739,44739,ACC7AC3B8DE3474C386625E5186B4C58,42301,0,6,6,36,47,1847
44740,44740,ACC7AC3B8DE3474C386625E5186B4C58,11331,6,7,1,37,48,1898
44741,44741,ACC7AC3B8DE3474C386625E5186B4C58,42941,12,13,1,37,47,1897
44742,44742,ACC7AC3B8DE3474C386625E5186B4C58,11331,17,18,1,37,48,1898
44743,44743,ACC7AC3B8DE3474C386625E5186B4C58,42301,18,23,5,36,47,1847
44747,44747,69F41107244EDDE97DD1AAB2D554177A,11834,7,9,2,32,45,1645
44748,44748,69F41107244EDDE97DD1AAB2D554177A,19281,10,17,7,16,32,832
44749,44749,69F41107244EDDE97DD1AAB2D554177A,12871,17,20,3,22,33,1133
44750,44750,69F41107244EDDE97DD1AAB2D554177A,19281,20,21,1,16,32,832
44751,44751,A024933EE5A95A6F350C3391AE682A8C,11081,2,9,7,35,46,1796
44752,44752,A024933EE5A95A6F350C3391AE682A8C,10971,13,16,3,35,47,1797
44753,44753,A024933EE5A95A6F350C3391AE682A8C,10841,17,20,3,37,47,1897
44754,44754,A024933EE5A95A6F350C3391AE682A8C,11231,21,23,2,37,49,1899
44755,44755,8C3628324299DC68FA43E3CAFCDFF1AB,43761,0,8,8,32,47,1647
44756,44756,8C3628324299DC68FA43E3CAFCDFF1AB,11061,13,15,2,29,48,1498
44757,44757,8C3628324299DC68FA43E3CAFCDFF1AB,11521,19,21,2,41,48,2098
44762,44762,ECBC886277109C0582E65AB313F27C1C,13314,0,5,5,31,39,1589
44763,44763,ECBC886277109C0582E65AB313F27C1C,12521,7,21,14,35,41,1791
44764,44764,ECBC886277109C0582E65AB313F27C1C,13314,22,23,1,31,39,1589
44768,44768,2F3FBE39EE4E3AB748593134D6A2A772,42231,1,6,5,37,46,1896
44769,44769,2F3FBE39EE4E3AB748593134D6A2A772,42351,8,9,1,38,45,1945
44770,44770,2F3FBE39EE4E3AB748593134D6A2A772,42231,10,13,3,37,46,1896
44771,44771,2F3FBE39EE4E3AB748593134D6A2A772,10811,15,17,2,38,46,1946
44772,44772,2F3FBE39EE4E3AB748593134D6A2A772,42231,20,22,2,37,46,1896
44773,44773,6324E038DED9EC12CD06DF2BDBC3BEAA,12641,1,3,2,10,43,543
44774,44774,6324E038DED9EC12CD06DF2BDBC3BEAA,43021,4,6,2,16,43,843
44775,44775,6324E038DED9EC12CD06DF2BDBC3BEAA,19181,7,21,14,8,40,440
44779,44779,B979677A3209603458A98A1EBBD15F5B,11791,0,8,8,38,49,1949
44780,44780,B979677A3209603458A98A1EBBD15F5B,42523,10,14,4,31,47,1597
44781,44781,B979677A3209603458A98A1EBBD15F5B,11791,17,23,6,38,49,1949
44788,44788,FD322523EB6A9D4099904987A1AAA3C0,11351,0,4,4,36,48,1848
44789,44789,FD322523EB6A9D4099904987A1AAA3C0,11331,4,7,3,37,48,1898
44790,44790,FD322523EB6A9D4099904987A1AAA3C0,11351,8,19,11,36,48,1848
44791,44791,FD322523EB6A9D4099904987A1AAA3C0,11861,19,20,1,32,47,1647
44792,44792,FD322523EB6A9D4099904987A1AAA3C0,11351,22,23,1,36,48,1848
44797,44797,A923C41770F47C64367C4A31C06C83C7,10292,2,5,3,30,47,1547
44798,44798,A923C41770F47C64367C4A31C06C83C7,42491,5,12,7,32,46,1646
44799,44799,A923C41770F47C64367C4A31C06C83C7,13651,14,15,1,30,47,1547
44800,44800,A923C41770F47C64367C4A31C06C83C7,42523,19,20,1,31,47,1597
44801,44801,A923C41770F47C64367C4A31C06C83C7,13651,20,23,3,30,47,1547
44802,44802,BC3DA9BAF9B0A0C935A79D91ECBDA067,19441,0,6,6,8,46,446
44803,44803,BC3DA9BAF9B0A0C935A79D91ECBDA067,12491,7,9,2,36,43,1843
44804,44804,BC3DA9BAF9B0A0C935A79D91ECBDA067,42151,9,20,11,35,45,1795
44805,44805,D9AF0A0BEFAFF72D2F6D04084706EE69,43051,0,7,7,46,45,2345
44806,44806,D9AF0A0BEFAFF72D2F6D04084706EE69,11151,9,11,2,30,48,1548
44807,44807,D9AF0A0BEFAFF72D2F6D04084706EE69,10381,11,16,5,31,49,1599
44808,44808,D9AF0A0BEFAFF72D2F6D04084706EE69,43051,20,23,3,46,45,2345
44809,44809,119196C18578341D0084AF6B48A62632,11631,1,3,2,12,49,649
44810,44810,119196C18578341D0084AF6B48A62632,12641,4,7,3,10,43,543
44811,44811,119196C18578341D0084AF6B48A62632,11631,8,22,14,12,49,649
44812,44812,05BD882F25219A49EB57A8F905CE344B,43281,0,7,7,37,48,1898
44813,44813,05BD882F25219A49EB57A8F905CE344B,12161,8,18,10,32,46,1646
44814,44814,05BD882F25219A49EB57A8F905CE344B,12391,21,22,1,36,49,1849
44828,44828,BBB180103068E98D503C4D3D2B6186F0,40302,0,10,10,40,49,2049
44829,44829,BBB180103068E98D503C4D3D2B6186F0,43671,18,19,1,35,48,1798
44830,44830,BBB180103068E98D503C4D3D2B6186F0,40302,20,23,3,40,49,2049
44835,44835,5B606639B0DDA81D89C67819EC5B7D64,13271,1,7,6,41,47,2097
44836,44836,5B606639B0DDA81D89C67819EC5B7D64,13101,10,12,2,40,47,2047
44837,44837,5B606639B0DDA81D89C67819EC5B7D64,13271,14,17,3,41,47,2097
44838,44838,5B606639B0DDA81D89C67819EC5B7D64,13101,17,21,4,40,47,2047
44839,44839,5B606639B0DDA81D89C67819EC5B7D64,13271,21,23,2,41,47,2097
44849,44849,107D1726F8C033576BB195D0BA52D8F8,11021,1,11,10,36,49,1849
44850,44850,107D1726F8C033576BB195D0BA52D8F8,12021,11,13,2,37,49,1899
44851,44851,107D1726F8C033576BB195D0BA52D8F8,11701,14,15,1,43,48,2198
44852,44852,107D1726F8C033576BB195D0BA52D8F8,10161,20,21,1,35,49,1799
44853,44853,394B81CC36B31D897120A6153D7C1457,11061,0,4,4,29,48,1498
44854,44854,394B81CC36B31D897120A6153D7C1457,12121,5,9,4,29,47,1497
44855,44855,394B81CC36B31D897120A6153D7C1457,42501,9,10,1,28,47,1447
44856,44856,394B81CC36B31D897120A6153D7C1457,12121,15,16,1,29,47,1497
44857,44857,394B81CC36B31D897120A6153D7C1457,11061,20,21,1,29,48,1498
44865,44865,6E7236528B0F2FB48F3D09E01C9E884E,12881,9,10,1,47,22,2372
44866,44866,6E7236528B0F2FB48F3D09E01C9E884E,15441,14,15,1,44,20,2220
44867,44867,6E7236528B0F2FB48F3D09E01C9E884E,12881,15,18,3,47,22,2372
44868,44868,6E7236528B0F2FB48F3D09E01C9E884E,15311,22,23,1,43,25,2175
44869,44869,1615B5C2884ACE0897DDC23BDC159D99,10901,3,10,7,35,48,1798
44870,44870,1615B5C2884ACE0897DDC23BDC159D99,43981,12,14,2,36,49,1849
44871,44871,1615B5C2884ACE0897DDC23BDC159D99,11351,15,17,2,36,48,1848
44872,44872,1615B5C2884ACE0897DDC23BDC159D99,11151,18,19,1,30,48,1548
44873,44873,1615B5C2884ACE0897DDC23BDC159D99,42961,21,23,2,35,49,1799
44880,44880,A208246203303765025742FDE89787BA,13511,0,1,1,34,48,1748
44881,44881,A208246203303765025742FDE89787BA,10271,2,8,6,37,46,1896
44882,44882,A208246203303765025742FDE89787BA,13681,11,12,1,38,47,1947
44883,44883,A208246203303765025742FDE89787BA,10271,13,14,1,37,46,1896
44884,44884,A208246203303765025742FDE89787BA,13331,15,16,1,38,47,1947
44885,44885,A208246203303765025742FDE89787BA,40341,18,21,3,23,49,1199
44886,44886,A208246203303765025742FDE89787BA,13121,21,23,2,38,46,1946
44887,44887,2873DE93703B028193B7B9719DCFE691,12521,0,7,7,35,41,1791
44888,44888,2873DE93703B028193B7B9719DCFE691,43451,7,9,2,37,40,1890
44889,44889,2873DE93703B028193B7B9719DCFE691,12521,10,13,3,35,41,1791
44890,44890,2873DE93703B028193B7B9719DCFE691,43451,14,17,3,37,40,1890
44891,44891,2873DE93703B028193B7B9719DCFE691,12521,20,22,2,35,41,1791
44892,44892,56FFB418111C23B804F686A7F7BBBBC0,12311,0,7,7,30,44,1544
44893,44893,56FFB418111C23B804F686A7F7BBBBC0,16451,11,14,3,5,5,255
44894,44894,56FFB418111C23B804F686A7F7BBBBC0,10221,18,19,1,34,49,1749
44895,44895,4A63BD8790639E943B30CD82E5123621,40094,0,4,4,29,48,1498
44896,44896,4A63BD8790639E943B30CD82E5123621,13041,6,8,2,30,37,1537
44897,44897,4A63BD8790639E943B30CD82E5123621,11151,11,16,5,30,48,1548
44898,44898,4A63BD8790639E943B30CD82E5123621,11061,16,23,7,29,48,1498
44910,44910,7861278735CDA91B9BABB196FBF7605C,13411,1,7,6,49,42,2492
44911,44911,7861278735CDA91B9BABB196FBF7605C,43951,8,9,1,49,41,2491
44912,44912,7861278735CDA91B9BABB196FBF7605C,13951,12,17,5,47,45,2395
44913,44913,7861278735CDA91B9BABB196FBF7605C,13411,17,19,2,49,42,2492
44914,44914,7861278735CDA91B9BABB196FBF7605C,43951,21,23,2,49,41,2491
44915,44915,09E35A3086ED2C100882D697DC471A83,42231,0,8,8,37,46,1896
44916,44916,09E35A3086ED2C100882D697DC471A83,11861,10,12,2,32,47,1647
44917,44917,09E35A3086ED2C100882D697DC471A83,11381,12,13,1,30,47,1547
44918,44918,09E35A3086ED2C100882D697DC471A83,11861,14,17,3,32,47,1647
44919,44919,09E35A3086ED2C100882D697DC471A83,42231,19,23,4,37,46,1896
44920,44920,28EBDF129D422CC62555B67FAF051D3A,43761,0,7,7,32,47,1647
44921,44921,28EBDF129D422CC62555B67FAF051D3A,10901,9,10,1,35,48,1798
44922,44922,28EBDF129D422CC62555B67FAF051D3A,11231,11,12,1,37,49,1899
44923,44923,28EBDF129D422CC62555B67FAF051D3A,43761,13,23,10,32,47,1647
44931,44931,E6B3319150AF45B35054FA69E6F2866E,42981,0,1,1,36,49,1849
44932,44932,E6B3319150AF45B35054FA69E6F2866E,10107,3,5,2,38,49,1949
44933,44933,E6B3319150AF45B35054FA69E6F2866E,42981,5,7,2,36,49,1849
44934,44934,E6B3319150AF45B35054FA69E6F2866E,10107,8,16,8,38,49,1949
44935,44935,E6B3319150AF45B35054FA69E6F2866E,40341,16,18,2,23,49,1199
44936,44936,E6B3319150AF45B35054FA69E6F2866E,10107,20,23,3,38,49,1949
44940,44940,6BF85B7300ADAE0F83C20B2AF5821019,12391,2,4,2,36,49,1849
44941,44941,6BF85B7300ADAE0F83C20B2AF5821019,11381,6,18,12,30,47,1547
44942,44942,6BF85B7300ADAE0F83C20B2AF5821019,10221,18,19,1,34,49,1749
44943,44943,C69DB833C5C233DF7718BBF8E4312DAA,11861,0,9,9,32,47,1647
44944,44944,C69DB833C5C233DF7718BBF8E4312DAA,11875,10,11,1,30,46,1546
44945,44945,C69DB833C5C233DF7718BBF8E4312DAA,10301,12,18,6,31,45,1595
44946,44946,C69DB833C5C233DF7718BBF8E4312DAA,11875,19,20,1,30,46,1546
44947,44947,C69DB833C5C233DF7718BBF8E4312DAA,42871,21,23,2,30,45,1545
44948,44948,A3FAF330124CA173A9985CFE7EAC668F,10271,2,8,6,37,46,1896
44949,44949,A3FAF330124CA173A9985CFE7EAC668F,40124,9,11,2,38,47,1947
44950,44950,A3FAF330124CA173A9985CFE7EAC668F,11074,11,12,1,37,47,1897
44951,44951,A3FAF330124CA173A9985CFE7EAC668F,10271,14,16,2,37,46,1896
44952,44952,A3FAF330124CA173A9985CFE7EAC668F,12514,20,21,1,38,47,1947
44953,44953,A7889E15E0F93853EAB5CF324793B9C0,15411,8,9,1,44,27,2227
44954,44954,A7889E15E0F93853EAB5CF324793B9C0,12611,12,16,4,41,29,2079
44955,44955,A7889E15E0F93853EAB5CF324793B9C0,15411,16,23,7,44,27,2227
44956,44956,ACAA72670A3AC749DD3D299B9A2146A5,19031,0,5,5,1,42,92
44957,44957,ACAA72670A3AC749DD3D299B9A2146A5,12641,6,19,13,10,43,543
44958,44958,ACAA72670A3AC749DD3D299B9A2146A5,19931,20,21,1,7,43,393
44959,44959,ACAA72670A3AC749DD3D299B9A2146A5,12641,21,23,2,10,43,543
44960,44960,AA98F3536DB0C9A531CA597216F8D06C,42961,0,8,8,35,49,1799
44961,44961,AA98F3536DB0C9A531CA597216F8D06C,40341,9,11,2,23,49,1199
44962,44962,AA98F3536DB0C9A531CA597216F8D06C,11231,15,18,3,37,49,1899
44963,44963,AA98F3536DB0C9A531CA597216F8D06C,10121,21,22,1,36,49,1849
44964,44964,702644C92C0404461EBFCE9C6654E9F3,42111,0,4,4,44,46,2246
44965,44965,702644C92C0404461EBFCE9C6654E9F3,13821,4,16,12,49,45,2495
44966,44966,702644C92C0404461EBFCE9C6654E9F3,10107,20,22,2,38,49,1949
44967,44967,F552BBAFE22D025B0F7E0055A73A2709,42321,4,12,8,43,47,2197
44968,44968,F552BBAFE22D025B0F7E0055A73A2709,42021,15,17,2,33,47,1697
44969,44969,F552BBAFE22D025B0F7E0055A73A2709,42321,18,20,2,43,47,2197
44970,44970,F552BBAFE22D025B0F7E0055A73A2709,13941,21,23,2,41,47,2097
44971,44971,1F586282DD0AC03725A5E548411F5D82,12514,0,1,1,38,47,1947
44972,44972,1F586282DD0AC03725A5E548411F5D82,42221,2,13,11,38,48,1948
44973,44973,1F586282DD0AC03725A5E548411F5D82,40341,16,17,1,23,49,1199
44974,44974,1F586282DD0AC03725A5E548411F5D82,12514,21,22,1,38,47,1947
44975,44975,3ABAE8637B752C50709003FE46CFCDF8,11301,0,10,10,41,49,2099
44976,44976,3ABAE8637B752C50709003FE46CFCDF8,11111,14,17,3,26,48,1348
44977,44977,3ABAE8637B752C50709003FE46CFCDF8,10431,22,23,1,33,49,1699
44978,44978,DE6709015B79F307E57CED7DDDF807DA,12491,0,5,5,36,43,1843
44979,44979,DE6709015B79F307E57CED7DDDF807DA,42861,6,10,4,37,44,1894
44980,44980,DE6709015B79F307E57CED7DDDF807DA,12491,14,15,1,36,43,1843
44981,44981,DE6709015B79F307E57CED7DDDF807DA,42151,16,18,2,35,45,1795
44982,44982,DE6709015B79F307E57CED7DDDF807DA,12491,20,21,1,36,43,1843
44986,44986,FD26A6D5BBA5F38876B2DAAB4BBFF5D0,12121,0,8,8,29,47,1497
44987,44987,FD26A6D5BBA5F38876B2DAAB4BBFF5D0,10951,13,14,1,29,48,1498
44988,44988,FD26A6D5BBA5F38876B2DAAB4BBFF5D0,12584,15,17,2,24,48,1248
44989,44989,FD26A6D5BBA5F38876B2DAAB4BBFF5D0,12121,19,23,4,29,47,1497
44990,44990,8167EF05D15F996A6B93D96BD3E78468,13371,0,2,2,41,47,2097
44991,44991,8167EF05D15F996A6B93D96BD3E78468,11001,2,10,8,42,47,2147
44992,44992,8167EF05D15F996A6B93D96BD3E78468,12514,12,15,3,38,47,1947
44993,44993,8167EF05D15F996A6B93D96BD3E78468,42271,16,17,1,40,47,2047
44994,44994,8167EF05D15F996A6B93D96BD3E78468,12514,19,20,1,38,47,1947
44995,44995,8167EF05D15F996A6B93D96BD3E78468,11794,21,23,2,38,49,1949
44996,44996,A6FD529C3EA66C1845775EA07FC46A8F,12601,0,4,4,25,47,1297
44997,44997,A6FD529C3EA66C1845775EA07FC46A8F,12051,8,10,2,20,47,1047
44998,44998,A6FD529C3EA66C1845775EA07FC46A8F,12601,14,23,9,25,47,1297
45002,45002,CEB63AF3249F9F759AAF501C4D1F5357,42583,0,13,13,40,48,2048
45003,45003,CEB63AF3249F9F759AAF501C4D1F5357,11751,16,18,2,35,48,1798
45004,45004,CEB63AF3249F9F759AAF501C4D1F5357,10471,22,23,1,37,48,1898
45005,45005,0B302A96FA0DFDEB2B3F6999345F0CFE,11834,0,1,1,32,45,1645
45006,45006,0B302A96FA0DFDEB2B3F6999345F0CFE,12311,1,7,6,30,44,1544
45007,45007,0B302A96FA0DFDEB2B3F6999345F0CFE,10154,9,12,3,33,47,1697
45008,45008,0B302A96FA0DFDEB2B3F6999345F0CFE,12311,13,15,2,30,44,1544
45009,45009,0B302A96FA0DFDEB2B3F6999345F0CFE,42871,17,19,2,30,45,1545
45010,45010,0B302A96FA0DFDEB2B3F6999345F0CFE,12311,20,21,1,30,44,1544
45019,45019,32B8548C5B9A5E1F6F33716C43996D17,42091,0,2,2,43,46,2196
45020,45020,32B8548C5B9A5E1F6F33716C43996D17,13371,3,11,8,41,47,2097
45021,45021,32B8548C5B9A5E1F6F33716C43996D17,11074,14,15,1,37,47,1897
45022,45022,32B8548C5B9A5E1F6F33716C43996D17,13371,19,21,2,41,47,2097
45023,45023,32B8548C5B9A5E1F6F33716C43996D17,43361,21,23,2,38,48,1948
45024,45024,BDB18D500D8DE6AC2EF56E2D3677B566,11701,0,9,9,43,48,2198
45025,45025,BDB18D500D8DE6AC2EF56E2D3677B566,43621,9,16,7,46,48,2348
45026,45026,BDB18D500D8DE6AC2EF56E2D3677B566,13511,18,23,5,34,48,1748
45027,45027,85607240C9BD04B747A3B4F445524A75,10161,0,8,8,35,49,1799
45028,45028,85607240C9BD04B747A3B4F445524A75,12121,8,11,3,29,47,1497
45029,45029,85607240C9BD04B747A3B4F445524A75,11201,12,17,5,35,49,1799
45030,45030,85607240C9BD04B747A3B4F445524A75,11061,20,22,2,29,48,1498
45031,45031,1259660DE4B3820AACC09E5D86C7BBF3,10111,0,2,2,37,47,1897
45032,45032,1259660DE4B3820AACC09E5D86C7BBF3,42011,2,8,6,36,46,1846
45033,45033,1259660DE4B3820AACC09E5D86C7BBF3,13821,10,11,1,49,45,2495
45034,45034,1259660DE4B3820AACC09E5D86C7BBF3,42941,12,13,1,37,47,1897
45035,45035,1259660DE4B3820AACC09E5D86C7BBF3,42011,14,20,6,36,46,1846
45036,45036,1259660DE4B3820AACC09E5D86C7BBF3,13711,21,23,2,38,46,1946
45047,45047,164DF51AA6ED954014D50FCEFF961260,12641,0,6,6,10,43,543
45048,45048,164DF51AA6ED954014D50FCEFF961260,19621,8,10,2,5,46,296
45049,45049,164DF51AA6ED954014D50FCEFF961260,12641,13,16,3,10,43,543
45050,45050,164DF51AA6ED954014D50FCEFF961260,19114,19,20,1,7,43,393
45051,45051,164DF51AA6ED954014D50FCEFF961260,12641,21,23,2,10,43,543
45055,45055,3D514E4E67A21E1A34FB75EA946F21E7,11875,0,6,6,30,46,1546
45056,45056,3D514E4E67A21E1A34FB75EA946F21E7,11871,10,13,3,29,46,1496
45057,45057,3D514E4E67A21E1A34FB75EA946F21E7,12311,17,18,1,30,44,1544
45058,45058,3D514E4E67A21E1A34FB75EA946F21E7,11871,18,19,1,29,46,1496
45059,45059,3D514E4E67A21E1A34FB75EA946F21E7,11875,22,23,1,30,46,1546
45060,45060,06016F24A252442BA48A4FC294986131,42641,9,12,3,33,49,1699
45061,45061,06016F24A252442BA48A4FC294986131,13041,13,17,4,30,37,1537
45062,45062,06016F24A252442BA48A4FC294986131,42261,19,20,1,25,49,1299
45073,45073,B840292594AF9493A71A59EA7A649385,10544,0,13,13,28,48,1448
45074,45074,B840292594AF9493A71A59EA7A649385,11201,15,17,2,35,49,1799
45075,45075,B840292594AF9493A71A59EA7A649385,10544,17,22,5,28,48,1448
45076,45076,25DF23F398DD0B4C6CED78808A57A933,11091,0,9,9,29,47,1497
45077,45077,25DF23F398DD0B4C6CED78808A57A933,11074,10,11,1,37,47,1897
45078,45078,25DF23F398DD0B4C6CED78808A57A933,10292,12,21,9,30,47,1547
45079,45079,25DF23F398DD0B4C6CED78808A57A933,11091,21,23,2,29,47,1497
45093,45093,C2155D5C42247E7E781AF1E5B78AF552,42531,1,5,4,31,45,1595
45094,45094,C2155D5C42247E7E781AF1E5B78AF552,12491,6,9,3,36,43,1843
45095,45095,C2155D5C42247E7E781AF1E5B78AF552,42531,11,21,10,31,45,1595
45106,45106,7BD5666208D4C4EF90CAAD8A97E6ED7C,12491,0,6,6,36,43,1843
45107,45107,7BD5666208D4C4EF90CAAD8A97E6ED7C,13671,9,17,8,27,43,1393
45108,45108,7BD5666208D4C4EF90CAAD8A97E6ED7C,42151,22,23,1,35,45,1795
45109,45109,096291A7826A281BB9AE079B593A0255,12581,8,9,1,24,48,1248
45110,45110,096291A7826A281BB9AE079B593A0255,11101,12,13,1,18,48,948
45111,45111,096291A7826A281BB9AE079B593A0255,11361,17,18,1,22,48,1148
45112,45112,096291A7826A281BB9AE079B593A0255,40343,20,21,1,24,49,1249
45113,45113,5C81004482023832AD545CD8F1DA1576,42351,4,5,1,38,45,1945
45114,45114,5C81004482023832AD545CD8F1DA1576,13911,6,7,1,39,46,1996
45115,45115,5C81004482023832AD545CD8F1DA1576,42231,10,11,1,37,46,1896
45116,45116,5C81004482023832AD545CD8F1DA1576,13911,14,17,3,39,46,1996
45117,45117,5C81004482023832AD545CD8F1DA1576,42231,17,19,2,37,46,1896
45118,45118,5C81004482023832AD545CD8F1DA1576,13911,21,22,1,39,46,1996
45119,45119,4FB7544A1E67AE742452DB3735E5F7CF,10771,0,3,3,41,46,2096
45120,45120,4FB7544A1E67AE742452DB3735E5F7CF,11001,3,6,3,42,47,2147
45121,45121,4FB7544A1E67AE742452DB3735E5F7CF,12561,7,8,1,45,43,2293
45122,45122,4FB7544A1E67AE742452DB3735E5F7CF,13341,14,15,1,44,45,2245
45123,45123,4FB7544A1E67AE742452DB3735E5F7CF,42631,15,17,2,43,45,2195
45124,45124,4FB7544A1E67AE742452DB3735E5F7CF,10771,20,23,3,41,46,2096
45125,45125,25C8E48F46CE3AC7F14FD7208B98656B,12121,0,4,4,29,47,1497
45126,45126,25C8E48F46CE3AC7F14FD7208B98656B,13651,4,7,3,30,47,1547
45127,45127,25C8E48F46CE3AC7F14FD7208B98656B,12601,9,11,2,25,47,1297
45128,45128,25C8E48F46CE3AC7F14FD7208B98656B,42141,16,17,1,32,47,1647
45129,45129,25C8E48F46CE3AC7F14FD7208B98656B,13651,19,23,4,30,47,1547
45130,45130,E46021F2EBB1FF86CE07D74A4E5B9C9F,12921,0,5,5,9,41,491
45131,45131,E46021F2EBB1FF86CE07D74A4E5B9C9F,49201,7,13,6,7,41,391
45132,45132,E46021F2EBB1FF86CE07D74A4E5B9C9F,19181,14,16,2,8,40,440
45133,45133,E46021F2EBB1FF86CE07D74A4E5B9C9F,12921,16,18,2,9,41,491
45134,45134,E46021F2EBB1FF86CE07D74A4E5B9C9F,49201,20,21,1,7,41,391
45138,45138,BE479955BE8DB525AD0928AEF33C6562,13101,3,6,3,40,47,2047
45139,45139,BE479955BE8DB525AD0928AEF33C6562,40833,7,8,1,41,47,2097
45140,45140,BE479955BE8DB525AD0928AEF33C6562,11481,8,10,2,41,48,2098
45141,45141,BE479955BE8DB525AD0928AEF33C6562,13271,11,17,6,41,47,2097
45142,45142,BE479955BE8DB525AD0928AEF33C6562,11481,18,19,1,41,48,2098
45143,45143,BE479955BE8DB525AD0928AEF33C6562,13271,21,23,2,41,47,2097
45144,45144,BF2293DC6BB562420437DEEB375D8B3A,10191,0,8,8,40,48,2048
45145,45145,BF2293DC6BB562420437DEEB375D8B3A,11201,10,11,1,35,49,1799
45146,45146,BF2293DC6BB562420437DEEB375D8B3A,40041,13,16,3,40,49,2049
45147,45147,BF2293DC6BB562420437DEEB375D8B3A,42471,17,19,2,35,49,1799
45148,45148,BF2293DC6BB562420437DEEB375D8B3A,40041,21,23,2,40,49,2049
45149,45149,AF11A116F876E89A4D582C37AC3B2D5C,43011,0,1,1,40,42,2042
45150,45150,AF11A116F876E89A4D582C37AC3B2D5C,13671,1,6,5,27,43,1393
45151,45151,AF11A116F876E89A4D582C37AC3B2D5C,11281,8,11,3,27,40,1390
45152,45152,AF11A116F876E89A4D582C37AC3B2D5C,13671,13,21,8,27,43,1393
45157,45157,134DE55405BEF261D5BD51612163C60F,10841,5,6,1,37,47,1897
45158,45158,134DE55405BEF261D5BD51612163C60F,10251,8,10,2,35,47,1797
45159,45159,134DE55405BEF261D5BD51612163C60F,43981,11,15,4,36,49,1849
45160,45160,134DE55405BEF261D5BD51612163C60F,11081,19,20,1,35,46,1796
45161,45161,134DE55405BEF261D5BD51612163C60F,11021,21,23,2,36,49,1849
45165,45165,0FCC9992AE8D71AAE404BB0E597A281E,11861,0,5,5,32,47,1647
45166,45166,0FCC9992AE8D71AAE404BB0E597A281E,10171,5,17,12,26,47,1347
45167,45167,0FCC9992AE8D71AAE404BB0E597A281E,11861,18,23,5,32,47,1647
45168,45168,DAD4C4CCB9D717CA848AB20853599079,10292,1,3,2,30,47,1547
45169,45169,DAD4C4CCB9D717CA848AB20853599079,11101,4,8,4,18,48,948
45170,45170,DAD4C4CCB9D717CA848AB20853599079,42523,12,14,2,31,47,1597
45171,45171,DAD4C4CCB9D717CA848AB20853599079,10161,17,18,1,35,49,1799
45172,45172,DAD4C4CCB9D717CA848AB20853599079,10221,18,20,2,34,49,1749
45173,45173,1FF68150E8292356C054DC6700B7527E,11701,0,9,9,43,48,2198
45174,45174,1FF68150E8292356C054DC6700B7527E,42523,11,13,2,31,47,1597
45175,45175,1FF68150E8292356C054DC6700B7527E,11701,14,17,3,43,48,2198
45176,45176,1FF68150E8292356C054DC6700B7527E,40691,18,21,3,42,48,2148
45177,45177,1FF68150E8292356C054DC6700B7527E,11701,22,23,1,43,48,2198
45181,45181,11FECEE7865049CDA55CAB34FACD3089,12311,4,5,1,30,44,1544
45182,45182,11FECEE7865049CDA55CAB34FACD3089,42871,7,9,2,30,45,1545
45183,45183,11FECEE7865049CDA55CAB34FACD3089,11871,12,17,5,29,46,1496
45184,45184,11FECEE7865049CDA55CAB34FACD3089,10681,17,18,1,30,48,1548
45185,45185,11FECEE7865049CDA55CAB34FACD3089,43391,20,23,3,29,48,1498
45193,45193,886E2D7F4784182ED324B3C76B8399C9,12581,5,8,3,24,48,1248
45194,45194,886E2D7F4784182ED324B3C76B8399C9,12051,11,14,3,20,47,1047
45195,45195,886E2D7F4784182ED324B3C76B8399C9,12581,15,19,4,24,48,1248
45196,45196,886E2D7F4784182ED324B3C76B8399C9,12051,19,20,1,20,47,1047
45197,45197,27FC12A9CC22785E872C74022BAA62BA,16071,0,7,7,3,3,153
45198,45198,27FC12A9CC22785E872C74022BAA62BA,16281,8,10,2,11,4,554
45199,45199,27FC12A9CC22785E872C74022BAA62BA,16071,13,14,1,3,3,153
45200,45200,27FC12A9CC22785E872C74022BAA62BA,16421,15,17,2,8,2,402
45201,45201,27FC12A9CC22785E872C74022BAA62BA,16071,17,22,5,3,3,153
45206,45206,63053F23FCD04F14418687ED6291EC6F,10634,0,7,7,27,45,1395
45207,45207,63053F23FCD04F14418687ED6291EC6F,42623,20,21,1,22,49,1149
45208,45208,63053F23FCD04F14418687ED6291EC6F,42541,22,23,1,25,47,1297
45209,45209,1FA24F76587DEEEE9ED93C46D3D68950,11834,4,7,3,32,45,1645
45210,45210,1FA24F76587DEEEE9ED93C46D3D68950,42371,8,9,1,34,46,1746
45211,45211,1FA24F76587DEEEE9ED93C46D3D68950,42861,13,14,1,37,44,1894
45212,45212,1FA24F76587DEEEE9ED93C46D3D68950,42151,15,17,2,35,45,1795
45213,45213,1FA24F76587DEEEE9ED93C46D3D68950,12491,18,19,1,36,43,1843
45217,45217,D4DA3197A662684566E277EDA1852707,42141,0,3,3,32,47,1647
45218,45218,D4DA3197A662684566E277EDA1852707,10281,4,5,1,33,48,1698
45219,45219,D4DA3197A662684566E277EDA1852707,42021,7,8,1,33,47,1697
45220,45220,D4DA3197A662684566E277EDA1852707,10281,9,10,1,33,48,1698
45221,45221,D4DA3197A662684566E277EDA1852707,11861,15,19,4,32,47,1647
45222,45222,D4DA3197A662684566E277EDA1852707,10281,21,23,2,33,48,1698
45223,45223,D7C02B7CA8299277629CE9C4380C2496,11061,9,10,1,29,48,1498
45224,45224,D7C02B7CA8299277629CE9C4380C2496,42081,11,13,2,24,49,1249
45225,45225,D7C02B7CA8299277629CE9C4380C2496,42071,15,20,5,31,49,1599
45240,45240,E22B1C54A0FAFCF3D8C5712FD60B6323,11521,0,7,7,41,48,2098
45241,45241,E22B1C54A0FAFCF3D8C5712FD60B6323,11801,8,11,3,42,48,2148
45242,45242,E22B1C54A0FAFCF3D8C5712FD60B6323,10161,15,22,7,35,49,1799
45243,45243,1463E9838EB11802DBC75E65276D110F,42531,0,4,4,31,45,1595
45244,45244,1463E9838EB11802DBC75E65276D110F,13314,8,12,4,31,39,1589
45245,45245,1463E9838EB11802DBC75E65276D110F,12521,12,18,6,35,41,1791
45246,45246,1463E9838EB11802DBC75E65276D110F,42531,20,23,3,31,45,1595
45258,45258,506260504ADDFFEBDF6F921DD8023DFE,12121,0,4,4,29,47,1497
45259,45259,506260504ADDFFEBDF6F921DD8023DFE,11381,5,11,6,30,47,1547
45260,45260,506260504ADDFFEBDF6F921DD8023DFE,12121,15,16,1,29,47,1497
45261,45261,506260504ADDFFEBDF6F921DD8023DFE,11381,17,18,1,30,47,1547
45262,45262,506260504ADDFFEBDF6F921DD8023DFE,12121,18,20,2,29,47,1497
45263,45263,506260504ADDFFEBDF6F921DD8023DFE,11381,21,22,1,30,47,1547
45267,45267,F4EA0796F6ED2114017EAA0B13BA4D20,43761,0,2,2,32,47,1647
45268,45268,F4EA0796F6ED2114017EAA0B13BA4D20,42021,3,11,8,33,47,1697
45269,45269,F4EA0796F6ED2114017EAA0B13BA4D20,43761,11,12,1,32,47,1647
45270,45270,F4EA0796F6ED2114017EAA0B13BA4D20,42021,13,14,1,33,47,1697
45271,45271,F4EA0796F6ED2114017EAA0B13BA4D20,43761,18,21,3,32,47,1647
45272,45272,F4EA0796F6ED2114017EAA0B13BA4D20,42021,21,22,1,33,47,1697
45273,45273,024AB2D90319DF57F94996854D076E3D,13271,0,8,8,41,47,2097
45274,45274,024AB2D90319DF57F94996854D076E3D,11541,8,15,7,35,49,1799
45275,45275,024AB2D90319DF57F94996854D076E3D,11531,18,19,1,34,49,1749
45276,45276,024AB2D90319DF57F94996854D076E3D,42471,21,23,2,35,49,1799
45281,45281,39A12A7E8C423731CE90191A15A5C3F4,43021,3,9,6,16,43,843
45282,45282,39A12A7E8C423731CE90191A15A5C3F4,12921,10,11,1,9,41,491
45283,45283,39A12A7E8C423731CE90191A15A5C3F4,43021,12,13,1,16,43,843
45284,45284,39A12A7E8C423731CE90191A15A5C3F4,12641,17,19,2,10,43,543
45285,45285,39A12A7E8C423731CE90191A15A5C3F4,43021,22,23,1,16,43,843
45286,45286,E2C46C8E872A56146D94CCF191533F65,11074,0,1,1,37,47,1897
45287,45287,E2C46C8E872A56146D94CCF191533F65,42071,19,20,1,31,49,1599
45288,45288,E2C46C8E872A56146D94CCF191533F65,10901,21,23,2,35,48,1798
45292,45292,C7D4935453BFEC1CB164593EE1B84EA4,15391,0,2,2,35,26,1776
45293,45293,C7D4935453BFEC1CB164593EE1B84EA4,12792,2,3,1,34,30,1730
45294,45294,C7D4935453BFEC1CB164593EE1B84EA4,15391,5,8,3,35,26,1776
45295,45295,C7D4935453BFEC1CB164593EE1B84EA4,12792,9,11,2,34,30,1730
45296,45296,C7D4935453BFEC1CB164593EE1B84EA4,15391,11,16,5,35,26,1776
45297,45297,C7D4935453BFEC1CB164593EE1B84EA4,12792,16,18,2,34,30,1730
45298,45298,C7D4935453BFEC1CB164593EE1B84EA4,15391,19,20,1,35,26,1776
45299,45299,C97D1EB6332A2DCE6ADB1DE5937351DA,42971,0,9,9,43,49,2199
45300,45300,C97D1EB6332A2DCE6ADB1DE5937351DA,12661,12,15,3,32,45,1645
45301,45301,C97D1EB6332A2DCE6ADB1DE5937351DA,13941,18,22,4,41,47,2097
45302,45302,0F0A6A4CC11202C2774DA4E99B191143,13511,0,1,1,34,48,1748
45303,45303,0F0A6A4CC11202C2774DA4E99B191143,13331,1,9,8,38,47,1947
45304,45304,0F0A6A4CC11202C2774DA4E99B191143,13121,11,13,2,38,46,1946
45305,45305,0F0A6A4CC11202C2774DA4E99B191143,13331,13,16,3,38,47,1947
45306,45306,0F0A6A4CC11202C2774DA4E99B191143,40341,18,20,2,23,49,1199
45307,45307,0F0A6A4CC11202C2774DA4E99B191143,13331,22,23,1,38,47,1947
45314,45314,4A1E2DF13E9399DEAE7966E1EFE6FC6B,13271,0,4,4,41,47,2097
45315,45315,4A1E2DF13E9399DEAE7966E1EFE6FC6B,12311,6,12,6,30,44,1544
45316,45316,4A1E2DF13E9399DEAE7966E1EFE6FC6B,42871,15,16,1,30,45,1545
45317,45317,4A1E2DF13E9399DEAE7966E1EFE6FC6B,10351,17,22,5,28,45,1445
45318,45318,82B9DE1C452C89862B559CE0DF4F04BF,15051,0,9,9,19,4,954
45319,45319,82B9DE1C452C89862B559CE0DF4F04BF,16281,9,10,1,11,4,554
45320,45320,82B9DE1C452C89862B559CE0DF4F04BF,15051,13,17,4,19,4,954
45321,45321,82B9DE1C452C89862B559CE0DF4F04BF,16281,18,19,1,11,4,554
45322,45322,82B9DE1C452C89862B559CE0DF4F04BF,15051,20,23,3,19,4,954
45330,45330,CAD1FFF41FBB07303E4F900E7ED6962A,43391,0,17,17,29,48,1498
45331,45331,CAD1FFF41FBB07303E4F900E7ED6962A,11901,18,19,1,42,49,2149
45332,45332,CAD1FFF41FBB07303E4F900E7ED6962A,40951,20,23,3,36,49,1849
45337,45337,F43476BBF49FF8A7E4D0E7D4165D7B1D,12491,0,7,7,36,43,1843
45338,45338,F43476BBF49FF8A7E4D0E7D4165D7B1D,11261,7,9,2,36,46,1846
45339,45339,F43476BBF49FF8A7E4D0E7D4165D7B1D,42861,10,12,2,37,44,1894
45340,45340,F43476BBF49FF8A7E4D0E7D4165D7B1D,11261,14,19,5,36,46,1846
45341,45341,F43476BBF49FF8A7E4D0E7D4165D7B1D,42231,19,23,4,37,46,1896
45346,45346,C96AF7724AE07D1D1BE56C246C9FE7FC,13341,0,3,3,44,45,2245
45347,45347,C96AF7724AE07D1D1BE56C246C9FE7FC,42461,6,7,1,45,47,2297
45348,45348,C96AF7724AE07D1D1BE56C246C9FE7FC,42631,8,10,2,43,45,2195
45349,45349,C96AF7724AE07D1D1BE56C246C9FE7FC,13341,13,15,2,44,45,2245
45350,45350,C96AF7724AE07D1D1BE56C246C9FE7FC,42631,17,18,1,43,45,2195
45351,45351,7B7EC78C492826B1A2F98257774A5C01,11061,0,10,10,29,48,1498
45352,45352,7B7EC78C492826B1A2F98257774A5C01,40171,12,19,7,38,48,1948
45353,45353,7B7EC78C492826B1A2F98257774A5C01,11061,22,23,1,29,48,1498
45358,45358,9C17C707743AE50FBFFE4446783207FB,42071,0,9,9,31,49,1599
45359,45359,9C17C707743AE50FBFFE4446783207FB,40343,10,12,2,24,49,1249
45360,45360,9C17C707743AE50FBFFE4446783207FB,11201,12,13,1,35,49,1799
45361,45361,9C17C707743AE50FBFFE4446783207FB,10381,14,20,6,31,49,1599
45362,45362,9C17C707743AE50FBFFE4446783207FB,11201,22,23,1,35,49,1799
45367,45367,EF36708C9A85FB86CAB3007E1278AA65,10061,5,6,1,20,46,1046
45368,45368,EF36708C9A85FB86CAB3007E1278AA65,10351,7,15,8,28,45,1445
45369,45369,EF36708C9A85FB86CAB3007E1278AA65,12601,17,19,2,25,47,1297
45376,45376,8CD5156CF883DA15618BAFE58DDCF2A7,42581,2,5,3,38,48,1948
45377,45377,8CD5156CF883DA15618BAFE58DDCF2A7,11914,7,10,3,37,48,1898
45378,45378,8CD5156CF883DA15618BAFE58DDCF2A7,12514,13,14,1,38,47,1947
45379,45379,8CD5156CF883DA15618BAFE58DDCF2A7,11914,16,19,3,37,48,1898
45380,45380,8CD5156CF883DA15618BAFE58DDCF2A7,42581,19,23,4,38,48,1948
45384,45384,5039947620D7A56E43378E84C9E78F81,12161,0,10,10,32,46,1646
45385,45385,5039947620D7A56E43378E84C9E78F81,12841,12,14,2,37,47,1897
45386,45386,5039947620D7A56E43378E84C9E78F81,43361,16,17,1,38,48,1948
45387,45387,5039947620D7A56E43378E84C9E78F81,12841,19,21,2,37,47,1897
45388,45388,D7349708A10855AEF98FEB8D22C33E59,40833,0,7,7,41,47,2097
45389,45389,D7349708A10855AEF98FEB8D22C33E59,11231,8,16,8,37,49,1899
45390,45390,D7349708A10855AEF98FEB8D22C33E59,40833,19,23,4,41,47,2097
45398,45398,C3E7E27638EA741DDDE69937A4FC718E,49201,0,7,7,7,41,391
45399,45399,C3E7E27638EA741DDDE69937A4FC718E,12921,12,15,3,9,41,491
45400,45400,C3E7E27638EA741DDDE69937A4FC718E,43644,19,23,4,14,38,738
45401,45401,855AF0077FBE2FE365D2D9E5D044E5A4,43761,0,2,2,32,47,1647
45402,45402,855AF0077FBE2FE365D2D9E5D044E5A4,42523,3,4,1,31,47,1597
45403,45403,855AF0077FBE2FE365D2D9E5D044E5A4,43761,6,13,7,32,47,1647
45404,45404,855AF0077FBE2FE365D2D9E5D044E5A4,42523,17,18,1,31,47,1597
45405,45405,855AF0077FBE2FE365D2D9E5D044E5A4,43761,19,21,2,32,47,1647
45406,45406,C64854E86A3681C3669A53990E16514C,42301,0,1,1,36,47,1847
45407,45407,C64854E86A3681C3669A53990E16514C,10111,1,8,7,37,47,1897
45408,45408,C64854E86A3681C3669A53990E16514C,16451,12,15,3,5,5,255
45409,45409,C64854E86A3681C3669A53990E16514C,10111,19,23,4,37,47,1897
45417,45417,711A729D73D390B3128E8E166ADEC6D6,42583,0,9,9,40,48,2048
45418,45418,711A729D73D390B3128E8E166ADEC6D6,42231,9,13,4,37,46,1896
45419,45419,711A729D73D390B3128E8E166ADEC6D6,42351,14,23,9,38,45,1945
45424,45424,92E1BAA88B052422B820ED36A9E8F107,11701,0,6,6,43,48,2198
45425,45425,92E1BAA88B052422B820ED36A9E8F107,42191,8,10,2,38,49,1949
45426,45426,92E1BAA88B052422B820ED36A9E8F107,41392,11,14,3,43,48,2198
45427,45427,92E1BAA88B052422B820ED36A9E8F107,40171,16,17,1,38,48,1948
45428,45428,92E1BAA88B052422B820ED36A9E8F107,41392,20,23,3,43,48,2198
45435,45435,D7B4DEFCB86C55D027A1210EEC02063B,11231,0,1,1,37,49,1899
45436,45436,D7B4DEFCB86C55D027A1210EEC02063B,11021,1,14,13,36,49,1849
45437,45437,D7B4DEFCB86C55D027A1210EEC02063B,10841,14,15,1,37,47,1897
45438,45438,D7B4DEFCB86C55D027A1210EEC02063B,11021,16,19,3,36,49,1849
45439,45439,D7B4DEFCB86C55D027A1210EEC02063B,11231,20,23,3,37,49,1899
45446,45446,EB5113FABCD8A586909D22BBE114596E,12971,0,11,11,32,48,1648
45447,45447,EB5113FABCD8A586909D22BBE114596E,10251,11,14,3,35,47,1797
45448,45448,EB5113FABCD8A586909D22BBE114596E,42161,17,21,4,36,47,1847
45449,45449,E45B0EC44E00842EDD865C65A561543D,11231,8,14,6,37,49,1899
45450,45450,E45B0EC44E00842EDD865C65A561543D,10471,17,18,1,37,48,1898
45451,45451,E45B0EC44E00842EDD865C65A561543D,42121,19,20,1,26,49,1349
45452,45452,11D0C3BFA1EEA48E71CAB72BD84A5D2F,13671,1,6,5,27,43,1393
45453,45453,11D0C3BFA1EEA48E71CAB72BD84A5D2F,10634,10,11,1,27,45,1395
45454,45454,11D0C3BFA1EEA48E71CAB72BD84A5D2F,10351,11,12,1,28,45,1445
45455,45455,11D0C3BFA1EEA48E71CAB72BD84A5D2F,10711,17,18,1,29,46,1496
45463,45463,F004825C5EEC7F8B7A184D4985895C55,13341,0,7,7,44,45,2245
45464,45464,F004825C5EEC7F8B7A184D4985895C55,42631,8,17,9,43,45,2195
45465,45465,F004825C5EEC7F8B7A184D4985895C55,13341,17,18,1,44,45,2245
45466,45466,F004825C5EEC7F8B7A184D4985895C55,13221,20,22,2,40,47,2047
45470,45470,8436FA510D59B3814E50B7F18BD1D92C,19571,0,4,4,1,36,86
45471,45471,8436FA510D59B3814E50B7F18BD1D92C,43644,4,6,2,14,38,738
45472,45472,8436FA510D59B3814E50B7F18BD1D92C,12641,6,10,4,10,43,543
45473,45473,8436FA510D59B3814E50B7F18BD1D92C,19571,13,14,1,1,36,86
45474,45474,8436FA510D59B3814E50B7F18BD1D92C,12641,14,18,4,10,43,543
45475,45475,8436FA510D59B3814E50B7F18BD1D92C,43644,19,21,2,14,38,738
45480,45480,E8F5F4A78C0DE5C1EE8D56EB7226C7B2,11131,1,14,13,33,48,1698
45481,45481,E8F5F4A78C0DE5C1EE8D56EB7226C7B2,19101,16,20,4,17,29,879
45482,45482,E8F5F4A78C0DE5C1EE8D56EB7226C7B2,10331,21,23,2,39,46,1996
45483,45483,1556F2F689A33FDB51E57BDF7D017FA3,11061,0,10,10,29,48,1498
45484,45484,1556F2F689A33FDB51E57BDF7D017FA3,43471,11,12,1,31,49,1599
45485,45485,1556F2F689A33FDB51E57BDF7D017FA3,10951,13,17,4,29,48,1498
45486,45486,1556F2F689A33FDB51E57BDF7D017FA3,11151,18,19,1,30,48,1548
45487,45487,1556F2F689A33FDB51E57BDF7D017FA3,43391,20,21,1,29,48,1498
45496,45496,E24EEC92B5E6CF5B1FB2EBF2AE3ED499,10501,0,5,5,22,46,1146
45497,45497,E24EEC92B5E6CF5B1FB2EBF2AE3ED499,42501,9,10,1,28,47,1447
45498,45498,E24EEC92B5E6CF5B1FB2EBF2AE3ED499,43241,15,18,3,36,46,1846
45499,45499,827BF5EA812D262D83B15CA76EB0A042,15371,0,4,4,15,22,772
45500,45500,827BF5EA812D262D83B15CA76EB0A042,15381,4,5,1,19,21,971
45501,45501,827BF5EA812D262D83B15CA76EB0A042,15121,6,7,1,27,19,1369
45502,45502,827BF5EA812D262D83B15CA76EB0A042,19051,12,17,5,16,23,823
45503,45503,827BF5EA812D262D83B15CA76EB0A042,15381,18,23,5,19,21,971
45507,45507,392F2B932A839BB0C6F602E5FA556570,11074,0,6,6,37,47,1897
45508,45508,392F2B932A839BB0C6F602E5FA556570,10601,9,13,4,39,47,1997
45509,45509,392F2B932A839BB0C6F602E5FA556570,10681,14,16,2,30,48,1548
45510,45510,392F2B932A839BB0C6F602E5FA556570,11074,20,23,3,37,47,1897
45514,45514,5F7BF9C3E2207B45D738D0D2E031C4FF,11741,0,11,11,42,49,2149
45515,45515,5F7BF9C3E2207B45D738D0D2E031C4FF,40951,15,17,2,36,49,1849
45516,45516,5F7BF9C3E2207B45D738D0D2E031C4FF,11741,21,23,2,42,49,2149
45517,45517,F49EE04071D0B4FCCD4263F4C2BBEA7A,11061,0,11,11,29,48,1498
45518,45518,F49EE04071D0B4FCCD4263F4C2BBEA7A,42521,11,12,1,31,47,1597
45519,45519,F49EE04071D0B4FCCD4263F4C2BBEA7A,11061,12,15,3,29,48,1498
45520,45520,F49EE04071D0B4FCCD4263F4C2BBEA7A,42521,18,20,2,31,47,1597
45521,45521,F49EE04071D0B4FCCD4263F4C2BBEA7A,11151,21,23,2,30,48,1548
45525,45525,6E490D907A7F7D7A9707FACC4A45B418,10491,0,11,11,33,48,1698
45526,45526,6E490D907A7F7D7A9707FACC4A45B418,42231,15,16,1,37,46,1896
45527,45527,6E490D907A7F7D7A9707FACC4A45B418,40951,18,20,2,36,49,1849
45528,45528,6E490D907A7F7D7A9707FACC4A45B418,10491,21,23,2,33,48,1698
45532,45532,1C0548F40841AD0870DAD8EC7BECCBC6,13314,0,7,7,31,39,1589
45533,45533,1C0548F40841AD0870DAD8EC7BECCBC6,12521,9,11,2,35,41,1791
45534,45534,1C0548F40841AD0870DAD8EC7BECCBC6,13314,11,13,2,31,39,1589
45535,45535,1C0548F40841AD0870DAD8EC7BECCBC6,12521,13,15,2,35,41,1791
45536,45536,1C0548F40841AD0870DAD8EC7BECCBC6,13314,17,23,6,31,39,1589
45540,45540,E648A6F090A3BE85617E0ED54A73B4F0,12601,0,1,1,25,47,1297
45541,45541,E648A6F090A3BE85617E0ED54A73B4F0,12671,4,9,5,21,43,1093
45542,45542,E648A6F090A3BE85617E0ED54A73B4F0,12601,9,14,5,25,47,1297
45543,45543,E648A6F090A3BE85617E0ED54A73B4F0,12671,14,17,3,21,43,1093
45544,45544,E648A6F090A3BE85617E0ED54A73B4F0,12601,17,23,6,25,47,1297
45545,45545,3C07D1557002BF4F1AA6A6D7A8949EF2,42523,0,4,4,31,47,1597
45546,45546,3C07D1557002BF4F1AA6A6D7A8949EF2,12601,8,17,9,25,47,1297
45547,45547,3C07D1557002BF4F1AA6A6D7A8949EF2,42523,19,23,4,31,47,1597
45548,45548,848A877E923FAE990F640409C3D68042,17771,10,11,1,42,2,2102
45549,45549,848A877E923FAE990F640409C3D68042,42351,13,14,1,38,45,1945
45550,45550,848A877E923FAE990F640409C3D68042,11074,14,15,1,37,47,1897
45551,45551,848A877E923FAE990F640409C3D68042,43731,16,18,2,34,47,1747
45552,45552,B3570D76A0EC2332DBB1383A77DAE874,13711,1,14,13,38,46,1946
45553,45553,B3570D76A0EC2332DBB1383A77DAE874,13951,14,16,2,47,45,2395
45554,45554,B3570D76A0EC2332DBB1383A77DAE874,13711,20,22,2,38,46,1946
45573,45573,2F66AC01887397A198C9CCA6611EA97B,12521,0,13,13,35,41,1791
45574,45574,2F66AC01887397A198C9CCA6611EA97B,13314,14,16,2,31,39,1589
45575,45575,2F66AC01887397A198C9CCA6611EA97B,12521,18,23,5,35,41,1791
45579,45579,A534FD7E51A551BE3196665029DD0400,19931,0,6,6,7,43,393
45580,45580,A534FD7E51A551BE3196665029DD0400,19031,7,16,9,1,42,92
45581,45581,A534FD7E51A551BE3196665029DD0400,12641,20,22,2,10,43,543
45582,45582,F37F3F6EE44D5E50ACC3545985E675A1,19114,0,7,7,7,43,393
45583,45583,F37F3F6EE44D5E50ACC3545985E675A1,12641,7,11,4,10,43,543
45584,45584,F37F3F6EE44D5E50ACC3545985E675A1,19114,11,14,3,7,43,393
45585,45585,F37F3F6EE44D5E50ACC3545985E675A1,12641,14,16,2,10,43,543
45586,45586,F37F3F6EE44D5E50ACC3545985E675A1,19114,17,23,6,7,43,393
45590,45590,642CD1BCB1D6034CF33B22265CC8DC30,42501,5,8,3,28,47,1447
45591,45591,642CD1BCB1D6034CF33B22265CC8DC30,11061,12,16,4,29,48,1498
45592,45592,642CD1BCB1D6034CF33B22265CC8DC30,42921,20,21,1,33,47,1697
45593,45593,9641FF809BC99375A7EB0913A38DD4C9,42161,0,5,5,36,47,1847
45594,45594,9641FF809BC99375A7EB0913A38DD4C9,11061,6,10,4,29,48,1498
45595,45595,9641FF809BC99375A7EB0913A38DD4C9,42071,14,16,2,31,49,1599
45596,45596,9641FF809BC99375A7EB0913A38DD4C9,40925,19,20,1,35,49,1799
45597,45597,9641FF809BC99375A7EB0913A38DD4C9,11491,21,23,2,36,47,1847
45601,45601,034BF108F7447DC54755E0BD15E86728,42351,0,6,6,38,45,1945
45602,45602,034BF108F7447DC54755E0BD15E86728,19621,7,11,4,5,46,296
45603,45603,034BF108F7447DC54755E0BD15E86728,13911,13,16,3,39,46,1996
45604,45604,034BF108F7447DC54755E0BD15E86728,42864,16,17,1,38,44,1944
45605,45605,034BF108F7447DC54755E0BD15E86728,11261,18,21,3,36,46,1846
45606,45606,9BBBC00C93BA6A3176E2B008E6F8A88E,42351,0,1,1,38,45,1945
45607,45607,9BBBC00C93BA6A3176E2B008E6F8A88E,12211,1,5,4,41,44,2094
45608,45608,9BBBC00C93BA6A3176E2B008E6F8A88E,11261,5,10,5,36,46,1846
45609,45609,9BBBC00C93BA6A3176E2B008E6F8A88E,12211,11,12,1,41,44,2094
45610,45610,9BBBC00C93BA6A3176E2B008E6F8A88E,11261,14,16,2,36,46,1846
45611,45611,9BBBC00C93BA6A3176E2B008E6F8A88E,13911,21,22,1,39,46,1996
45615,45615,A336F8D086418A70D6F2B0EA33768B6C,10811,0,14,14,38,46,1946
45616,45616,A336F8D086418A70D6F2B0EA33768B6C,15261,16,19,3,39,13,1963
45617,45617,A336F8D086418A70D6F2B0EA33768B6C,10811,21,23,2,38,46,1946
45626,45626,13CC40471AC83D6354BC2D2A78721A9B,10721,1,9,8,31,48,1598
45627,45627,13CC40471AC83D6354BC2D2A78721A9B,11021,13,15,2,36,49,1849
45628,45628,13CC40471AC83D6354BC2D2A78721A9B,10721,15,23,8,31,48,1598
45629,45629,5DC656AE1F755A21D4CE0049D29039D4,12521,1,6,5,35,41,1791
45630,45630,5DC656AE1F755A21D4CE0049D29039D4,12491,7,8,1,36,43,1843
45631,45631,5DC656AE1F755A21D4CE0049D29039D4,43451,9,12,3,37,40,1890
45632,45632,5DC656AE1F755A21D4CE0049D29039D4,12491,14,16,2,36,43,1843
45633,45633,5DC656AE1F755A21D4CE0049D29039D4,11751,18,19,1,35,48,1798
45634,45634,5DC656AE1F755A21D4CE0049D29039D4,11261,21,23,2,36,46,1846
45638,45638,B72BE68D8DDF608BDEDA242C48A4D997,12121,0,9,9,29,47,1497
45639,45639,B72BE68D8DDF608BDEDA242C48A4D997,40341,11,12,1,23,49,1199
45640,45640,B72BE68D8DDF608BDEDA242C48A4D997,40094,17,21,4,29,48,1498
45641,45641,931D1B9D3F88D7DAF9B270F67C939CF9,13941,0,8,8,41,47,2097
45642,45642,931D1B9D3F88D7DAF9B270F67C939CF9,11061,13,15,2,29,48,1498
45643,45643,931D1B9D3F88D7DAF9B270F67C939CF9,10681,15,17,2,30,48,1548
45644,45644,931D1B9D3F88D7DAF9B270F67C939CF9,11061,17,23,6,29,48,1498
45654,45654,649CA0B4C9C73F10630BCAC6C100E533,42151,0,4,4,35,45,1795
45655,45655,649CA0B4C9C73F10630BCAC6C100E533,12311,5,17,12,30,44,1544
45656,45656,649CA0B4C9C73F10630BCAC6C100E533,13671,18,19,1,27,43,1393
45657,45657,649CA0B4C9C73F10630BCAC6C100E533,42291,20,22,2,29,48,1498
45658,45658,0C67E52564A59548E0D196BFCB2BFDD6,12521,1,3,2,35,41,1791
45659,45659,0C67E52564A59548E0D196BFCB2BFDD6,13671,4,7,3,27,43,1393
45660,45660,0C67E52564A59548E0D196BFCB2BFDD6,11281,7,22,15,27,40,1390
45661,45661,F8084386F8D8B590AAD7E167CF79BD62,12661,3,4,1,32,45,1645
45662,45662,F8084386F8D8B590AAD7E167CF79BD62,12491,4,8,4,36,43,1843
45663,45663,F8084386F8D8B590AAD7E167CF79BD62,12661,12,16,4,32,45,1645
45664,45664,F8084386F8D8B590AAD7E167CF79BD62,12491,17,19,2,36,43,1843
45669,45669,806A9140D4F11D37CD665345EE97E730,12641,0,1,1,10,43,543
45670,45670,806A9140D4F11D37CD665345EE97E730,12921,2,4,2,9,41,491
45671,45671,806A9140D4F11D37CD665345EE97E730,12641,7,10,3,10,43,543
45672,45672,806A9140D4F11D37CD665345EE97E730,12921,11,16,5,9,41,491
45673,45673,806A9140D4F11D37CD665345EE97E730,12641,18,19,1,10,43,543
45674,45674,DE69FEBC50432F9871EF62D07F7A5C1A,43641,1,3,2,16,38,838
45675,45675,DE69FEBC50432F9871EF62D07F7A5C1A,19021,4,6,2,10,45,545
45676,45676,DE69FEBC50432F9871EF62D07F7A5C1A,19181,7,21,14,8,40,440
45687,45687,04D73C3CD00D40CB611F6BA5801F802C,13314,0,13,13,31,39,1589
45688,45688,04D73C3CD00D40CB611F6BA5801F802C,12521,13,15,2,35,41,1791
45689,45689,04D73C3CD00D40CB611F6BA5801F802C,13314,19,21,2,31,39,1589
45700,45700,7D1E9F2CC6D6398A0EC8499740665A71,11061,0,6,6,29,48,1498
45701,45701,7D1E9F2CC6D6398A0EC8499740665A71,11151,9,14,5,30,48,1548
45702,45702,7D1E9F2CC6D6398A0EC8499740665A71,43731,15,17,2,34,47,1747
45703,45703,7D1E9F2CC6D6398A0EC8499740665A71,10251,19,21,2,35,47,1797
45707,45707,2A849162EEF6D4292E0DF13614EBF1C0,43481,3,8,5,39,48,1998
45708,45708,2A849162EEF6D4292E0DF13614EBF1C0,42271,9,15,6,40,47,2047
45709,45709,2A849162EEF6D4292E0DF13614EBF1C0,11151,16,18,2,30,48,1548
45710,45710,3F8C79D23BA3CECAEC7D2EB99D1DC0C9,40637,0,12,12,36,47,1847
45711,45711,3F8C79D23BA3CECAEC7D2EB99D1DC0C9,42511,13,18,5,37,47,1897
45712,45712,3F8C79D23BA3CECAEC7D2EB99D1DC0C9,40341,21,22,1,23,49,1199
45716,45716,2E9ACB5217DEAC635E911A6AAEF6DCF5,11261,0,6,6,36,46,1846
45717,45717,2E9ACB5217DEAC635E911A6AAEF6DCF5,19031,7,12,5,1,42,92
45718,45718,2E9ACB5217DEAC635E911A6AAEF6DCF5,11261,14,23,9,36,46,1846
45719,45719,275CBF4E53D7FD1E1541818FAB02A8D4,11321,1,17,16,31,46,1596
45720,45720,275CBF4E53D7FD1E1541818FAB02A8D4,10531,18,20,2,34,46,1746
45721,45721,275CBF4E53D7FD1E1541818FAB02A8D4,10111,20,23,3,37,47,1897
45725,45725,AFAE133FA88B98A999C46702AA923186,10911,0,9,9,39,46,1996
45726,45726,AFAE133FA88B98A999C46702AA923186,13221,12,13,1,40,47,2047
45727,45727,AFAE133FA88B98A999C46702AA923186,13791,14,15,1,42,47,2147
45728,45728,AFAE133FA88B98A999C46702AA923186,11271,17,19,2,37,48,1898
45729,45729,AFAE133FA88B98A999C46702AA923186,42511,20,23,3,37,47,1897
45730,45730,4AFE4F64A4241A18C27A9622FF1285EA,10221,0,8,8,34,49,1749
45731,45731,4AFE4F64A4241A18C27A9622FF1285EA,10171,10,11,1,26,47,1347
45732,45732,4AFE4F64A4241A18C27A9622FF1285EA,40055,13,15,2,31,49,1599
45733,45733,4AFE4F64A4241A18C27A9622FF1285EA,10221,17,19,2,34,49,1749
45734,45734,4AFE4F64A4241A18C27A9622FF1285EA,11661,20,22,2,40,49,2049
45743,45743,7C715FFD8A4BAD934A322B8DA7E771CE,11481,7,9,2,41,48,2098
45744,45744,7C715FFD8A4BAD934A322B8DA7E771CE,13101,11,17,6,40,47,2047
45745,45745,7C715FFD8A4BAD934A322B8DA7E771CE,41591,19,21,2,34,49,1749
45746,45746,05FAC26C716C22886CC30B6006B2DDD9,10281,6,7,1,33,48,1698
45747,45747,05FAC26C716C22886CC30B6006B2DDD9,43761,9,10,1,32,47,1647
45748,45748,05FAC26C716C22886CC30B6006B2DDD9,13371,13,14,1,41,47,2097
45749,45749,05FAC26C716C22886CC30B6006B2DDD9,13041,15,22,7,30,37,1537
45760,45760,775CA947FF37432092AA3395F5AA137B,43161,1,8,7,35,47,1797
45761,45761,775CA947FF37432092AA3395F5AA137B,15411,10,12,2,44,27,2227
45762,45762,775CA947FF37432092AA3395F5AA137B,10111,13,16,3,37,47,1897
45763,45763,775CA947FF37432092AA3395F5AA137B,11171,20,23,3,33,48,1698
45764,45764,619F4C0C078F2336C466CAB36FF98B97,40341,9,10,1,23,49,1199
45765,45765,619F4C0C078F2336C466CAB36FF98B97,42623,11,17,6,22,49,1149
45766,45766,619F4C0C078F2336C466CAB36FF98B97,43751,21,22,1,19,48,998
45781,45781,5EA4DF9236E98845ACB80913F5636AE6,10591,4,5,1,39,48,1998
45782,45782,5EA4DF9236E98845ACB80913F5636AE6,42581,6,7,1,38,48,1948
45783,45783,5EA4DF9236E98845ACB80913F5636AE6,10591,7,13,6,39,48,1998
45784,45784,5EA4DF9236E98845ACB80913F5636AE6,40341,14,18,4,23,49,1199
45785,45785,5EA4DF9236E98845ACB80913F5636AE6,10591,19,22,3,39,48,1998
45786,45786,5EA4DF9236E98845ACB80913F5636AE6,11481,22,23,1,41,48,2098
45787,45787,95E46EDC59FF5DC7B2780E8A91CFB9BB,19114,0,6,6,7,43,393
45788,45788,95E46EDC59FF5DC7B2780E8A91CFB9BB,12641,8,9,1,10,43,543
45789,45789,95E46EDC59FF5DC7B2780E8A91CFB9BB,19114,11,13,2,7,43,393
45790,45790,95E46EDC59FF5DC7B2780E8A91CFB9BB,19901,19,20,1,7,44,394
45791,45791,95E46EDC59FF5DC7B2780E8A91CFB9BB,19621,20,22,2,5,46,296
45805,45805,2770DAF26F856B8C604C0FF1601A7902,43644,0,2,2,14,38,738
45806,45806,2770DAF26F856B8C604C0FF1601A7902,19031,7,12,5,1,42,92
45807,45807,2770DAF26F856B8C604C0FF1601A7902,12921,12,14,2,9,41,491
45808,45808,2770DAF26F856B8C604C0FF1601A7902,19181,17,18,1,8,40,440
45809,45809,94092014F9DD3213271810B8D19555BE,49201,0,5,5,7,41,391
45810,45810,94092014F9DD3213271810B8D19555BE,12641,5,9,4,10,43,543
45811,45811,94092014F9DD3213271810B8D19555BE,49201,11,15,4,7,41,391
45812,45812,94092014F9DD3213271810B8D19555BE,12641,15,17,2,10,43,543
45813,45813,94092014F9DD3213271810B8D19555BE,49201,17,23,6,7,41,391
45814,45814,360CAB205F052520FED1AC4C9779857A,42523,1,2,1,31,47,1597
45815,45815,360CAB205F052520FED1AC4C9779857A,43761,2,12,10,32,47,1647
45816,45816,360CAB205F052520FED1AC4C9779857A,13711,13,18,5,38,46,1946
45821,45821,B6B0375BFA2C1ACA985FC18F0886DD84,10491,0,9,9,33,48,1698
45822,45822,B6B0375BFA2C1ACA985FC18F0886DD84,13741,11,14,3,37,49,1899
45823,45823,B6B0375BFA2C1ACA985FC18F0886DD84,40341,16,18,2,23,49,1199
45824,45824,B6B0375BFA2C1ACA985FC18F0886DD84,13741,19,21,2,37,49,1899
45825,45825,10026EC528DC65E6B062D4E8B47727C1,11701,0,1,1,43,48,2198
45826,45826,10026EC528DC65E6B062D4E8B47727C1,11201,1,10,9,35,49,1799
45827,45827,10026EC528DC65E6B062D4E8B47727C1,11021,11,12,1,36,49,1849
45828,45828,10026EC528DC65E6B062D4E8B47727C1,11074,17,23,6,37,47,1897
45829,45829,EEB3CBC85DF19031E292162C06516E43,11381,1,15,14,30,47,1547
45830,45830,EEB3CBC85DF19031E292162C06516E43,40951,15,18,3,36,49,1849
45831,45831,EEB3CBC85DF19031E292162C06516E43,11381,19,21,2,30,47,1547
45835,45835,67CF36E2E5BC17C0F7BA1FDED8D7D21B,12211,0,1,1,41,44,2094
45836,45836,67CF36E2E5BC17C0F7BA1FDED8D7D21B,43011,5,7,2,40,42,2042
45837,45837,67CF36E2E5BC17C0F7BA1FDED8D7D21B,12561,9,12,3,45,43,2293
45838,45838,67CF36E2E5BC17C0F7BA1FDED8D7D21B,12141,13,15,2,42,45,2145
45839,45839,67CF36E2E5BC17C0F7BA1FDED8D7D21B,43011,17,19,2,40,42,2042
45840,45840,67CF36E2E5BC17C0F7BA1FDED8D7D21B,12561,19,21,2,45,43,2293
45848,45848,1511CFAF94B568A5555A92AE32FB6139,43181,0,8,8,39,48,1998
45849,45849,1511CFAF94B568A5555A92AE32FB6139,10191,12,14,2,40,48,2048
45850,45850,1511CFAF94B568A5555A92AE32FB6139,10221,15,16,1,34,49,1749
45851,45851,1511CFAF94B568A5555A92AE32FB6139,43181,16,19,3,39,48,1998
45852,45852,1511CFAF94B568A5555A92AE32FB6139,10191,19,21,2,40,48,2048
45853,45853,A8CFBCA9A33C65DE4AB357D9A64460F4,12514,0,1,1,38,47,1947
45854,45854,A8CFBCA9A33C65DE4AB357D9A64460F4,10591,1,6,5,39,48,1998
45855,45855,A8CFBCA9A33C65DE4AB357D9A64460F4,12514,7,8,1,38,47,1947
45856,45856,A8CFBCA9A33C65DE4AB357D9A64460F4,10841,8,11,3,37,47,1897
45857,45857,A8CFBCA9A33C65DE4AB357D9A64460F4,12514,13,17,4,38,47,1947
45858,45858,A8CFBCA9A33C65DE4AB357D9A64460F4,11074,17,20,3,37,47,1897
45859,45859,3C2CF83B2DD5D0214CD62929F3FC2037,10731,0,8,8,33,47,1697
45860,45860,3C2CF83B2DD5D0214CD62929F3FC2037,42381,12,14,2,39,41,1991
45861,45861,3C2CF83B2DD5D0214CD62929F3FC2037,42921,18,23,5,33,47,1697
45868,45868,9C2C2A9A5923C3E8476FE17BB2B155DD,19114,0,4,4,7,43,393
45869,45869,9C2C2A9A5923C3E8476FE17BB2B155DD,12641,6,10,4,10,43,543
45870,45870,9C2C2A9A5923C3E8476FE17BB2B155DD,19114,11,13,2,7,43,393
45871,45871,9C2C2A9A5923C3E8476FE17BB2B155DD,12641,14,19,5,10,43,543
45872,45872,9C2C2A9A5923C3E8476FE17BB2B155DD,19114,22,23,1,7,43,393
45873,45873,AD7CC231E9A06A341390A5207E22E658,10811,0,6,6,38,46,1946
45874,45874,AD7CC231E9A06A341390A5207E22E658,10801,9,10,1,42,47,2147
45875,45875,AD7CC231E9A06A341390A5207E22E658,13711,14,15,1,38,46,1946
45876,45876,AD7CC231E9A06A341390A5207E22E658,10801,16,17,1,42,47,2147
45877,45877,AD7CC231E9A06A341390A5207E22E658,13711,20,23,3,38,46,1946
45878,45878,2295C74F0BD2BB081A3FCDFFDED68B9C,43644,3,4,1,14,38,738
45879,45879,2295C74F0BD2BB081A3FCDFFDED68B9C,12921,8,14,6,9,41,491
45880,45880,2295C74F0BD2BB081A3FCDFFDED68B9C,12641,18,19,1,10,43,543
45881,45881,6E49C6F71E5A970917CF8DD4B702C69B,11571,0,14,14,13,46,696
45882,45882,6E49C6F71E5A970917CF8DD4B702C69B,19441,16,17,1,8,46,446
45883,45883,6E49C6F71E5A970917CF8DD4B702C69B,11571,20,23,3,13,46,696
45891,45891,D6932FB45D03368B8FD3FCD5E6F4054F,11481,0,9,9,41,48,2098
45892,45892,D6932FB45D03368B8FD3FCD5E6F4054F,11261,10,11,1,36,46,1846
45893,45893,D6932FB45D03368B8FD3FCD5E6F4054F,12841,14,15,1,37,47,1897
45894,45894,D6932FB45D03368B8FD3FCD5E6F4054F,11301,18,19,1,41,49,2099
45895,45895,D6932FB45D03368B8FD3FCD5E6F4054F,12514,21,23,2,38,47,1947
45905,45905,5820CC6FC4348E018115CFA2871713F1,13271,0,11,11,41,47,2097
45906,45906,5820CC6FC4348E018115CFA2871713F1,40951,12,14,2,36,49,1849
45907,45907,5820CC6FC4348E018115CFA2871713F1,11381,17,18,1,30,47,1547
45908,45908,5820CC6FC4348E018115CFA2871713F1,11751,20,21,1,35,48,1798
45915,45915,95A50FC77E468146BAD45CC8BD317370,43731,0,2,2,34,47,1747
45916,45916,95A50FC77E468146BAD45CC8BD317370,42921,2,4,2,33,47,1697
45917,45917,95A50FC77E468146BAD45CC8BD317370,43731,4,6,2,34,47,1747
45918,45918,95A50FC77E468146BAD45CC8BD317370,42921,6,7,1,33,47,1697
45919,45919,95A50FC77E468146BAD45CC8BD317370,43731,13,14,1,34,47,1747
45920,45920,95A50FC77E468146BAD45CC8BD317370,11061,16,19,3,29,48,1498
45934,45934,2B669899B17D298773D06E725A61EAE8,11021,0,6,6,36,49,1849
45935,45935,2B669899B17D298773D06E725A61EAE8,40341,9,10,1,23,49,1199
45936,45936,2B669899B17D298773D06E725A61EAE8,12651,12,14,2,43,47,2197
45937,45937,2B669899B17D298773D06E725A61EAE8,43321,15,23,8,36,49,1849
45938,45938,EB7EB6074C1F2A07A41462E31EDA6629,42161,0,10,10,36,47,1847
45939,45939,EB7EB6074C1F2A07A41462E31EDA6629,10841,10,12,2,37,47,1897
45940,45940,EB7EB6074C1F2A07A41462E31EDA6629,42161,12,16,4,36,47,1847
45941,45941,EB7EB6074C1F2A07A41462E31EDA6629,10841,16,21,5,37,47,1897
45942,45942,EB7EB6074C1F2A07A41462E31EDA6629,42161,21,23,2,36,47,1847
45943,45943,F649882584C99520FD0CF1A30C0BF12B,42271,2,7,5,40,47,2047
45944,45944,F649882584C99520FD0CF1A30C0BF12B,11806,10,12,2,41,48,2098
45945,45945,F649882584C99520FD0CF1A30C0BF12B,42271,13,15,2,40,47,2047
45946,45946,F649882584C99520FD0CF1A30C0BF12B,11806,16,18,2,41,48,2098
45947,45947,F649882584C99520FD0CF1A30C0BF12B,40341,20,22,2,23,49,1199
45951,45951,E572D34D15CCFF06895D9E2C410E6273,10381,2,12,10,31,49,1599
45952,45952,E572D34D15CCFF06895D9E2C410E6273,42081,14,16,2,24,49,1249
45953,45953,E572D34D15CCFF06895D9E2C410E6273,12971,21,23,2,32,48,1648
45958,45958,1F899C425E1D44BC86781F60DDEF728E,43021,0,14,14,16,43,843
45959,45959,1F899C425E1D44BC86781F60DDEF728E,12921,15,17,2,9,41,491
45960,45960,1F899C425E1D44BC86781F60DDEF728E,42511,18,22,4,37,47,1897
45961,45961,1F87CA1D778B027B6DE06AC8BD5FBD25,13314,0,13,13,31,39,1589
45962,45962,1F87CA1D778B027B6DE06AC8BD5FBD25,12521,14,16,2,35,41,1791
45963,45963,1F87CA1D778B027B6DE06AC8BD5FBD25,40341,19,22,3,23,49,1199
45964,45964,38E5585960AB9ECEEC01A64CD8D80212,12641,6,7,1,10,43,543
45965,45965,38E5585960AB9ECEEC01A64CD8D80212,43644,9,10,1,14,38,738
45966,45966,38E5585960AB9ECEEC01A64CD8D80212,12641,11,20,9,10,43,543
45967,45967,1A439866C72DC101B5B9389EACAD1E10,10681,0,14,14,30,48,1548
45968,45968,1A439866C72DC101B5B9389EACAD1E10,12601,15,16,1,25,47,1297
45969,45969,1A439866C72DC101B5B9389EACAD1E10,10681,20,23,3,30,48,1548
45973,45973,2DB515479A31C3CA09E575C0D0494834,11231,0,13,13,37,49,1899
45974,45974,2DB515479A31C3CA09E575C0D0494834,10221,14,17,3,34,49,1749
45975,45975,2DB515479A31C3CA09E575C0D0494834,12971,17,19,2,32,48,1648
45976,45976,2DB515479A31C3CA09E575C0D0494834,11231,21,23,2,37,49,1899
45977,45977,5358E9F8F0F992AFA66CAEFAFD90ADED,11261,2,6,4,36,46,1846
45978,45978,5358E9F8F0F992AFA66CAEFAFD90ADED,12211,7,8,1,41,44,2094
45979,45979,5358E9F8F0F992AFA66CAEFAFD90ADED,11261,9,14,5,36,46,1846
45980,45980,5358E9F8F0F992AFA66CAEFAFD90ADED,11074,15,17,2,37,47,1897
45981,45981,5358E9F8F0F992AFA66CAEFAFD90ADED,11261,21,23,2,36,46,1846
45985,45985,CDA1EB7B89E47C48A7CAC823B0773234,12661,0,9,9,32,45,1645
45986,45986,CDA1EB7B89E47C48A7CAC823B0773234,41007,12,13,1,37,47,1897
45987,45987,CDA1EB7B89E47C48A7CAC823B0773234,12661,17,23,6,32,45,1645
45992,45992,890E28003097AE1252F2C7F02F9B8CC8,13911,0,10,10,39,46,1996
45993,45993,890E28003097AE1252F2C7F02F9B8CC8,42351,11,12,1,38,45,1945
45994,45994,890E28003097AE1252F2C7F02F9B8CC8,42531,16,18,2,31,45,1595
45998,45998,5928512D4C3F12C4F256440554362CB3,12521,0,13,13,35,41,1791
45999,45999,5928512D4C3F12C4F256440554362CB3,13041,13,16,3,30,37,1537
46000,46000,5928512D4C3F12C4F256440554362CB3,12521,18,22,4,35,41,1791
46011,46011,CAACA858123D57B1053C320BC0D4ADE1,13111,7,9,2,42,46,2146
46012,46012,CAACA858123D57B1053C320BC0D4ADE1,42601,9,11,2,44,48,2248
46013,46013,CAACA858123D57B1053C320BC0D4ADE1,43061,12,13,1,43,46,2196
46014,46014,CAACA858123D57B1053C320BC0D4ADE1,13711,15,17,2,38,46,1946
46015,46015,CAACA858123D57B1053C320BC0D4ADE1,13111,18,22,4,42,46,2146
46022,46022,3E3400E81F33727D0845365703B2CDF7,42981,0,7,7,36,49,1849
46023,46023,3E3400E81F33727D0845365703B2CDF7,41393,8,11,3,43,49,2199
46024,46024,3E3400E81F33727D0845365703B2CDF7,10161,12,17,5,35,49,1799
46025,46025,3E3400E81F33727D0845365703B2CDF7,11151,19,20,1,30,48,1548
46026,46026,3E3400E81F33727D0845365703B2CDF7,10161,20,23,3,35,49,1799
46027,46027,5DAE8FB10D3FBEF5B02F98DB4BFD46E9,42861,0,1,1,37,44,1894
46028,46028,5DAE8FB10D3FBEF5B02F98DB4BFD46E9,42351,2,3,1,38,45,1945
46029,46029,5DAE8FB10D3FBEF5B02F98DB4BFD46E9,42861,5,6,1,37,44,1894
46030,46030,5DAE8FB10D3FBEF5B02F98DB4BFD46E9,42231,10,12,2,37,46,1896
46031,46031,5DAE8FB10D3FBEF5B02F98DB4BFD46E9,42351,12,15,3,38,45,1945
46032,46032,5DAE8FB10D3FBEF5B02F98DB4BFD46E9,42231,15,16,1,37,46,1896
46033,46033,5DAE8FB10D3FBEF5B02F98DB4BFD46E9,42351,16,18,2,38,45,1945
46034,46034,5DAE8FB10D3FBEF5B02F98DB4BFD46E9,13911,22,23,1,39,46,1996
46035,46035,C57E69593CB95494477C252AABEFF884,10811,1,10,9,38,46,1946
46036,46036,C57E69593CB95494477C252AABEFF884,10111,10,11,1,37,47,1897
46037,46037,C57E69593CB95494477C252AABEFF884,12514,13,15,2,38,47,1947
46038,46038,C57E69593CB95494477C252AABEFF884,40341,16,18,2,23,49,1199
46039,46039,C57E69593CB95494477C252AABEFF884,12514,20,22,2,38,47,1947
46040,46040,62F6BE848412C7FADEB816AFD62C431F,15521,1,6,5,27,14,1364
46041,46041,62F6BE848412C7FADEB816AFD62C431F,15111,7,9,2,26,16,1316
46042,46042,62F6BE848412C7FADEB816AFD62C431F,16151,12,14,2,13,11,661
46043,46043,62F6BE848412C7FADEB816AFD62C431F,15521,14,16,2,27,14,1364
46044,46044,62F6BE848412C7FADEB816AFD62C431F,16151,17,20,3,13,11,661
46055,46055,D92D00150BC27A9BD4FD19E6AAF05E52,11806,0,4,4,41,48,2098
46056,46056,D92D00150BC27A9BD4FD19E6AAF05E52,42271,4,7,3,40,47,2047
46057,46057,D92D00150BC27A9BD4FD19E6AAF05E52,11806,8,9,1,41,48,2098
46058,46058,D92D00150BC27A9BD4FD19E6AAF05E52,42271,14,17,3,40,47,2047
46059,46059,D92D00150BC27A9BD4FD19E6AAF05E52,11806,18,19,1,41,48,2098
46060,46060,D92D00150BC27A9BD4FD19E6AAF05E52,40951,20,22,2,36,49,1849
46067,46067,2DEB62A2944501D04D7EC09A6CAB2BEC,10634,4,6,2,27,45,1395
46068,46068,2DEB62A2944501D04D7EC09A6CAB2BEC,10351,6,8,2,28,45,1445
46069,46069,2DEB62A2944501D04D7EC09A6CAB2BEC,11324,13,14,1,31,46,1596
46070,46070,2DEB62A2944501D04D7EC09A6CAB2BEC,13651,14,16,2,30,47,1547
46071,46071,2DEB62A2944501D04D7EC09A6CAB2BEC,42491,17,19,2,32,46,1646
46072,46072,2DEB62A2944501D04D7EC09A6CAB2BEC,11324,21,22,1,31,46,1596
46073,46073,F7A05B3FECD253C9C578617425D22E9D,13351,3,7,4,48,48,2448
46074,46074,F7A05B3FECD253C9C578617425D22E9D,40302,7,9,2,40,49,2049
46075,46075,F7A05B3FECD253C9C578617425D22E9D,19114,15,16,1,7,43,393
46076,46076,F7A05B3FECD253C9C578617425D22E9D,10421,20,23,3,41,48,2098
46083,46083,A769D23649FC88977888E37E432489C6,11261,5,14,9,36,46,1846
46084,46084,A769D23649FC88977888E37E432489C6,11631,17,18,1,12,49,649
46085,46085,A769D23649FC88977888E37E432489C6,11381,19,20,1,30,47,1547
46086,46086,1F49E26C341B3738FA1E54F232E557D3,12514,0,13,13,38,47,1947
46087,46087,1F49E26C341B3738FA1E54F232E557D3,42633,15,17,2,42,46,2146
46088,46088,1F49E26C341B3738FA1E54F232E557D3,11751,19,20,1,35,48,1798
46089,46089,099F2311565313A4B9C2BDC1623EF98A,19024,0,8,8,9,45,495
46090,46090,099F2311565313A4B9C2BDC1623EF98A,19441,9,10,1,8,46,446
46091,46091,099F2311565313A4B9C2BDC1623EF98A,19021,14,15,1,10,45,545
46092,46092,099F2311565313A4B9C2BDC1623EF98A,11571,16,18,2,13,46,696
46093,46093,099F2311565313A4B9C2BDC1623EF98A,19024,21,22,1,9,45,495
46094,46094,670481A6A6FDB5646DF53C0039FD1C41,10951,0,9,9,29,48,1498
46095,46095,670481A6A6FDB5646DF53C0039FD1C41,42021,9,13,4,33,47,1697
46096,46096,670481A6A6FDB5646DF53C0039FD1C41,40636,20,23,3,35,48,1798
46100,46100,2E539AC6B5EE453A303FF282CE24EA33,19931,2,5,3,7,43,393
46101,46101,2E539AC6B5EE453A303FF282CE24EA33,12921,7,9,2,9,41,491
46102,46102,2E539AC6B5EE453A303FF282CE24EA33,19114,12,13,1,7,43,393
46103,46103,2E539AC6B5EE453A303FF282CE24EA33,12921,15,17,2,9,41,491
46104,46104,2E539AC6B5EE453A303FF282CE24EA33,19114,20,23,3,7,43,393
46105,46105,AAF4696620C6353C66227214077A10B8,10771,0,16,16,41,46,2096
46106,46106,AAF4696620C6353C66227214077A10B8,40637,18,20,2,36,47,1847
46107,46107,AAF4696620C6353C66227214077A10B8,43041,22,23,1,41,46,2096
46114,46114,732CCF1BC496C93C41B70E7FF8357762,10634,0,7,7,27,45,1395
46115,46115,732CCF1BC496C93C41B70E7FF8357762,11171,10,11,1,33,48,1698
46116,46116,732CCF1BC496C93C41B70E7FF8357762,10351,15,18,3,28,45,1445
46117,46117,732CCF1BC496C93C41B70E7FF8357762,10634,18,23,5,27,45,1395
46118,46118,2FCEA8AFEE1EB24BBCF386268B1232AC,43311,0,5,5,31,48,1598
46119,46119,2FCEA8AFEE1EB24BBCF386268B1232AC,11161,6,8,2,32,48,1648
46120,46120,2FCEA8AFEE1EB24BBCF386268B1232AC,43311,9,12,3,31,48,1598
46121,46121,2FCEA8AFEE1EB24BBCF386268B1232AC,11161,13,14,1,32,48,1648
46122,46122,2FCEA8AFEE1EB24BBCF386268B1232AC,11381,15,17,2,30,47,1547
46123,46123,2FCEA8AFEE1EB24BBCF386268B1232AC,11061,20,21,1,29,48,1498
46124,46124,2FCEA8AFEE1EB24BBCF386268B1232AC,11161,21,23,2,32,48,1648
46129,46129,D429753EEB35077FBB0F7FD7B24671DA,42381,0,6,6,39,41,1991
46130,46130,D429753EEB35077FBB0F7FD7B24671DA,43451,7,11,4,37,40,1890
46131,46131,D429753EEB35077FBB0F7FD7B24671DA,42381,12,13,1,39,41,1991
46132,46132,D429753EEB35077FBB0F7FD7B24671DA,43451,14,17,3,37,40,1890
46133,46133,D429753EEB35077FBB0F7FD7B24671DA,42381,22,23,1,39,41,1991
46137,46137,3A538B5D138CBEEA61D0BEFCECC34E8D,11381,0,14,14,30,47,1547
46138,46138,3A538B5D138CBEEA61D0BEFCECC34E8D,42771,15,17,2,36,47,1847
46139,46139,3A538B5D138CBEEA61D0BEFCECC34E8D,41007,18,19,1,37,47,1897
46140,46140,3A538B5D138CBEEA61D0BEFCECC34E8D,11381,20,22,2,30,47,1547
46141,46141,58F4B9A08B6039F60DDC1B2355F01053,42351,0,7,7,38,45,1945
46142,46142,58F4B9A08B6039F60DDC1B2355F01053,42321,9,11,2,43,47,2197
46143,46143,58F4B9A08B6039F60DDC1B2355F01053,10801,14,16,2,42,47,2147
46144,46144,58F4B9A08B6039F60DDC1B2355F01053,13911,18,23,5,39,46,1996
46158,46158,C4C98DA3205A9459DEF69764F0BB2EEE,42501,1,12,11,28,47,1447
46159,46159,C4C98DA3205A9459DEF69764F0BB2EEE,10901,13,16,3,35,48,1798
46160,46160,C4C98DA3205A9459DEF69764F0BB2EEE,12514,21,22,1,38,47,1947
46164,46164,4F99B7E3CAE951E85A255B8F8129E57F,10711,0,13,13,29,46,1496
46165,46165,4F99B7E3CAE951E85A255B8F8129E57F,42861,17,18,1,37,44,1894
46166,46166,4F99B7E3CAE951E85A255B8F8129E57F,42151,21,22,1,35,45,1795
46170,46170,0CED0A2998E753C043314DC59E2912AD,15114,0,3,3,22,16,1116
46171,46171,0CED0A2998E753C043314DC59E2912AD,15143,3,11,8,18,7,907
46172,46172,0CED0A2998E753C043314DC59E2912AD,16151,13,23,10,13,11,661
46173,46173,CD5F8D7604C7020A19DDE3C48998E9F5,13314,1,5,4,31,39,1589
46174,46174,CD5F8D7604C7020A19DDE3C48998E9F5,12521,8,11,3,35,41,1791
46175,46175,CD5F8D7604C7020A19DDE3C48998E9F5,13314,12,13,1,31,39,1589
46176,46176,CD5F8D7604C7020A19DDE3C48998E9F5,12521,14,17,3,35,41,1791
46177,46177,CD5F8D7604C7020A19DDE3C48998E9F5,13041,21,23,2,30,37,1537
46178,46178,A02CC63C83B0DB8DAC13DDD011BB9A96,11161,1,7,6,32,48,1648
46179,46179,A02CC63C83B0DB8DAC13DDD011BB9A96,13951,10,16,6,47,45,2395
46180,46180,A02CC63C83B0DB8DAC13DDD011BB9A96,11161,20,23,3,32,48,1648
46181,46181,E2F2F4143F844EB76521711717E3F1F1,12731,0,6,6,22,40,1140
46182,46182,E2F2F4143F844EB76521711717E3F1F1,12641,6,8,2,10,43,543
46183,46183,E2F2F4143F844EB76521711717E3F1F1,12921,11,13,2,9,41,491
46184,46184,E2F2F4143F844EB76521711717E3F1F1,12641,16,20,4,10,43,543
46185,46185,29D0A6984D06B1D20AB655BABC09F11F,10381,0,12,12,31,49,1599
46186,46186,29D0A6984D06B1D20AB655BABC09F11F,10107,13,15,2,38,49,1949
46187,46187,29D0A6984D06B1D20AB655BABC09F11F,11541,16,18,2,35,49,1799
46188,46188,29D0A6984D06B1D20AB655BABC09F11F,10381,19,21,2,31,49,1599
46189,46189,29D0A6984D06B1D20AB655BABC09F11F,42623,21,23,2,22,49,1149
46190,46190,D2007E56CDD263F500CAE75A804D6B50,42871,0,6,6,30,45,1545
46191,46191,D2007E56CDD263F500CAE75A804D6B50,12311,6,9,3,30,44,1544
46192,46192,D2007E56CDD263F500CAE75A804D6B50,11324,11,12,1,31,46,1596
46193,46193,D2007E56CDD263F500CAE75A804D6B50,42871,13,14,1,30,45,1545
46194,46194,D2007E56CDD263F500CAE75A804D6B50,10301,17,19,2,31,45,1595
46195,46195,E02F57B26F613B95B8A8C38410D07E2A,12581,3,4,1,24,48,1248
46196,46196,E02F57B26F613B95B8A8C38410D07E2A,11361,4,6,2,22,48,1148
46197,46197,E02F57B26F613B95B8A8C38410D07E2A,10451,10,11,1,25,48,1298
46198,46198,E02F57B26F613B95B8A8C38410D07E2A,11361,18,19,1,22,48,1148
46199,46199,E02F57B26F613B95B8A8C38410D07E2A,42681,21,23,2,24,48,1248
46207,46207,D3F6CC79419CB8E677F2F17C3DF072CD,13121,3,4,1,38,46,1946
46208,46208,D3F6CC79419CB8E677F2F17C3DF072CD,10911,6,8,2,39,46,1996
46209,46209,D3F6CC79419CB8E677F2F17C3DF072CD,13711,10,11,1,38,46,1946
46210,46210,D3F6CC79419CB8E677F2F17C3DF072CD,42151,13,14,1,35,45,1795
46211,46211,D3F6CC79419CB8E677F2F17C3DF072CD,10811,14,15,1,38,46,1946
46212,46212,D3F6CC79419CB8E677F2F17C3DF072CD,10911,18,19,1,39,46,1996
46217,46217,41CF3442BFCF16BFC5F18EAE7E1CBBB1,43621,0,6,6,46,48,2348
46218,46218,41CF3442BFCF16BFC5F18EAE7E1CBBB1,42341,9,12,3,43,49,2199
46219,46219,41CF3442BFCF16BFC5F18EAE7E1CBBB1,10621,13,14,1,41,49,2099
46220,46220,41CF3442BFCF16BFC5F18EAE7E1CBBB1,42341,14,17,3,43,49,2199
46221,46221,41CF3442BFCF16BFC5F18EAE7E1CBBB1,11861,19,21,2,32,47,1647
46226,46226,F10F5F870D2BAF9C3378171A398BFD7F,42861,0,9,9,37,44,1894
46227,46227,F10F5F870D2BAF9C3378171A398BFD7F,12661,11,12,1,32,45,1645
46228,46228,F10F5F870D2BAF9C3378171A398BFD7F,42861,15,22,7,37,44,1894
46229,46229,66DA37F53902A8ECF7913718601F658F,40891,0,15,15,37,47,1897
46230,46230,66DA37F53902A8ECF7913718601F658F,40341,15,18,3,23,49,1199
46231,46231,66DA37F53902A8ECF7913718601F658F,10841,19,22,3,37,47,1897
46235,46235,58FF60972C1637520443DC5766A2AB67,13411,0,6,6,49,42,2492
46236,46236,58FF60972C1637520443DC5766A2AB67,43951,6,9,3,49,41,2491
46237,46237,58FF60972C1637520443DC5766A2AB67,13411,12,13,1,49,42,2492
46238,46238,58FF60972C1637520443DC5766A2AB67,43951,13,17,4,49,41,2491
46239,46239,58FF60972C1637520443DC5766A2AB67,13411,19,23,4,49,42,2492
46240,46240,920D7F9EAF74BF0D4FDDA895C3D0EC7B,42231,0,5,5,37,46,1896
46241,46241,920D7F9EAF74BF0D4FDDA895C3D0EC7B,19741,10,11,1,5,44,294
46242,46242,920D7F9EAF74BF0D4FDDA895C3D0EC7B,19114,12,14,2,7,43,393
46243,46243,920D7F9EAF74BF0D4FDDA895C3D0EC7B,19741,16,18,2,5,44,294
46244,46244,A249659AA4285866F354A5650B26A07F,42161,0,5,5,36,47,1847
46245,46245,A249659AA4285866F354A5650B26A07F,10111,7,11,4,37,47,1897
46246,46246,A249659AA4285866F354A5650B26A07F,42161,12,15,3,36,47,1847
46247,46247,A249659AA4285866F354A5650B26A07F,10111,18,19,1,37,47,1897
46248,46248,A249659AA4285866F354A5650B26A07F,42161,19,23,4,36,47,1847
46249,46249,5513A4EBEB51AF5647B29C75D8B8CC2C,11161,2,8,6,32,48,1648
46250,46250,5513A4EBEB51AF5647B29C75D8B8CC2C,43361,12,13,1,38,48,1948
46251,46251,5513A4EBEB51AF5647B29C75D8B8CC2C,11701,14,15,1,43,48,2198
46252,46252,5513A4EBEB51AF5647B29C75D8B8CC2C,11161,15,16,1,32,48,1648
46253,46253,5513A4EBEB51AF5647B29C75D8B8CC2C,11751,17,23,6,35,48,1798
46257,46257,914FCCE81925BD3B7C09A01C1E108BA6,43621,0,7,7,46,48,2348
46258,46258,914FCCE81925BD3B7C09A01C1E108BA6,13481,12,13,1,26,31,1331
46259,46259,914FCCE81925BD3B7C09A01C1E108BA6,11001,14,21,7,42,47,2147
46260,46260,914FCCE81925BD3B7C09A01C1E108BA6,43621,22,23,1,46,48,2348
46261,46261,22DF08AB8625FB5CE36A655BC50A3649,40271,0,14,14,35,49,1799
46262,46262,22DF08AB8625FB5CE36A655BC50A3649,13951,15,16,1,47,45,2395
46263,46263,22DF08AB8625FB5CE36A655BC50A3649,40271,18,22,4,35,49,1799
46264,46264,22DF08AB8625FB5CE36A655BC50A3649,10751,22,23,1,47,43,2393
46265,46265,A573FF285872EC96818445928AD4461A,11281,3,11,8,27,40,1390
46266,46266,A573FF285872EC96818445928AD4461A,42151,11,15,4,35,45,1795
46267,46267,A573FF285872EC96818445928AD4461A,11281,16,17,1,27,40,1390
46268,46268,A573FF285872EC96818445928AD4461A,13671,21,22,1,27,43,1393
46279,46279,28AE6FF44E8686DC354D2E3DF7700FCC,42461,0,6,6,45,47,2297
46280,46280,28AE6FF44E8686DC354D2E3DF7700FCC,42321,10,11,1,43,47,2197
46281,46281,28AE6FF44E8686DC354D2E3DF7700FCC,42461,12,15,3,45,47,2297
46282,46282,28AE6FF44E8686DC354D2E3DF7700FCC,11701,15,17,2,43,48,2198
46283,46283,28AE6FF44E8686DC354D2E3DF7700FCC,42461,18,23,5,45,47,2297
46284,46284,C587B8BBA49D2BF4E222CE1A0182D385,10931,0,10,10,41,48,2098
46285,46285,C587B8BBA49D2BF4E222CE1A0182D385,42301,11,13,2,36,47,1847
46286,46286,C587B8BBA49D2BF4E222CE1A0182D385,11771,16,18,2,39,49,1999
46287,46287,C587B8BBA49D2BF4E222CE1A0182D385,10107,18,19,1,38,49,1949
46291,46291,CAB47C85629646AC05B696BEE2F5B14A,10211,0,6,6,16,49,849
46292,46292,CAB47C85629646AC05B696BEE2F5B14A,11861,8,15,7,32,47,1647
46293,46293,CAB47C85629646AC05B696BEE2F5B14A,10211,19,22,3,16,49,849
46297,46297,C68BD884038901FC3E44D28FCEB3DA1A,12311,2,15,13,30,44,1544
46298,46298,C68BD884038901FC3E44D28FCEB3DA1A,42531,16,17,1,31,45,1595
46299,46299,C68BD884038901FC3E44D28FCEB3DA1A,12311,17,19,2,30,44,1544
46300,46300,C68BD884038901FC3E44D28FCEB3DA1A,10211,19,21,2,16,49,849
46301,46301,85AF3F568DC121A84EF6CC84157293A0,12651,0,9,9,43,47,2197
46302,46302,85AF3F568DC121A84EF6CC84157293A0,13951,11,12,1,47,45,2395
46303,46303,85AF3F568DC121A84EF6CC84157293A0,13941,15,17,2,41,47,2097
46304,46304,85AF3F568DC121A84EF6CC84157293A0,12651,18,23,5,43,47,2197
46305,46305,FA34681C91C9E16E3D387DA8AA6FC6EE,11074,0,7,7,37,47,1897
46306,46306,FA34681C91C9E16E3D387DA8AA6FC6EE,12621,10,11,1,10,48,548
46307,46307,FA34681C91C9E16E3D387DA8AA6FC6EE,19441,12,16,4,8,46,446
46308,46308,FA34681C91C9E16E3D387DA8AA6FC6EE,12621,18,20,2,10,48,548
46312,46312,4FA7E2AF35091649A8D61648BF92F5C0,42581,0,6,6,38,48,1948
46313,46313,4FA7E2AF35091649A8D61648BF92F5C0,10471,7,11,4,37,48,1898
46314,46314,4FA7E2AF35091649A8D61648BF92F5C0,43181,13,14,1,39,48,1998
46315,46315,4FA7E2AF35091649A8D61648BF92F5C0,11921,14,18,4,38,48,1948
46316,46316,4FA7E2AF35091649A8D61648BF92F5C0,10471,19,21,2,37,48,1898
46317,46317,4FA7E2AF35091649A8D61648BF92F5C0,42581,22,23,1,38,48,1948
46322,46322,3FFAC3F99B451D0208FE1C282ECAF5E9,12651,0,7,7,43,47,2197
46323,46323,3FFAC3F99B451D0208FE1C282ECAF5E9,11491,10,18,8,36,47,1847
46324,46324,3FFAC3F99B451D0208FE1C282ECAF5E9,13731,21,23,2,33,49,1699
46325,46325,7EA63201A47B68AA085BD7B8AF1F7767,13341,0,7,7,44,45,2245
46326,46326,7EA63201A47B68AA085BD7B8AF1F7767,11231,8,10,2,37,49,1899
46327,46327,7EA63201A47B68AA085BD7B8AF1F7767,10901,13,14,1,35,48,1798
46328,46328,7EA63201A47B68AA085BD7B8AF1F7767,11231,14,20,6,37,49,1899
46329,46329,7EA63201A47B68AA085BD7B8AF1F7767,11791,21,23,2,38,49,1949
46330,46330,B64D0B1A37868D451F664C706E7D126E,10781,0,7,7,35,47,1797
46331,46331,B64D0B1A37868D451F664C706E7D126E,11261,9,17,8,36,46,1846
46332,46332,B64D0B1A37868D451F664C706E7D126E,11381,20,22,2,30,47,1547
46336,46336,D2D49AEA430F940B45CDC832BBBCB09C,43731,6,8,2,34,47,1747
46337,46337,D2D49AEA430F940B45CDC832BBBCB09C,40636,9,12,3,35,48,1798
46338,46338,D2D49AEA430F940B45CDC832BBBCB09C,43731,13,16,3,34,47,1747
46339,46339,D2D49AEA430F940B45CDC832BBBCB09C,10251,17,18,1,35,47,1797
46340,46340,D2D49AEA430F940B45CDC832BBBCB09C,43731,18,23,5,34,47,1747
46341,46341,3268EA35855C3341CDAA2F7B87F28DC3,42461,0,10,10,45,47,2297
46342,46342,3268EA35855C3341CDAA2F7B87F28DC3,10251,14,15,1,35,47,1797
46343,46343,3268EA35855C3341CDAA2F7B87F28DC3,40951,16,17,1,36,49,1849
46344,46344,3268EA35855C3341CDAA2F7B87F28DC3,42461,20,22,2,45,47,2297
46345,46345,802D06E8811CDC65FDAB61E1A1D233B3,10501,0,2,2,22,46,1146
46346,46346,802D06E8811CDC65FDAB61E1A1D233B3,12601,3,6,3,25,47,1297
46347,46347,802D06E8811CDC65FDAB61E1A1D233B3,10691,9,19,10,33,48,1698
46348,46348,EDD72D29B8CAB7737CF6608FA3F3E204,11471,1,3,2,12,48,648
46349,46349,EDD72D29B8CAB7737CF6608FA3F3E204,19441,7,9,2,8,46,446
46350,46350,EDD72D29B8CAB7737CF6608FA3F3E204,11471,12,13,1,12,48,648
46351,46351,EDD72D29B8CAB7737CF6608FA3F3E204,19441,14,18,4,8,46,446
46352,46352,EDD72D29B8CAB7737CF6608FA3F3E204,11471,21,23,2,12,48,648
46353,46353,A20432510D121F9223B7E6763258E5B5,13314,0,2,2,31,39,1589
46354,46354,A20432510D121F9223B7E6763258E5B5,43451,3,5,2,37,40,1890
46355,46355,A20432510D121F9223B7E6763258E5B5,12831,6,10,4,34,38,1738
46356,46356,A20432510D121F9223B7E6763258E5B5,12521,11,14,3,35,41,1791
46357,46357,A20432510D121F9223B7E6763258E5B5,13314,15,17,2,31,39,1589
46358,46358,A20432510D121F9223B7E6763258E5B5,12831,17,23,6,34,38,1738
46370,46370,9A365F6CD1EED4A94D460D848C733912,43021,0,6,6,16,43,843
46371,46371,9A365F6CD1EED4A94D460D848C733912,12921,9,10,1,9,41,491
46372,46372,9A365F6CD1EED4A94D460D848C733912,43021,11,14,3,16,43,843
46373,46373,9A365F6CD1EED4A94D460D848C733912,12921,17,18,1,9,41,491
46374,46374,95954D33643718A90AEF4D14409F8C12,12311,7,14,7,30,44,1544
46375,46375,95954D33643718A90AEF4D14409F8C12,13314,16,18,2,31,39,1589
46376,46376,95954D33643718A90AEF4D14409F8C12,13671,18,20,2,27,43,1393
46381,46381,885A83C6A65271C3FFBE8FB5E38DB301,42271,0,7,7,40,47,2047
46382,46382,885A83C6A65271C3FFBE8FB5E38DB301,11806,8,10,2,41,48,2098
46383,46383,885A83C6A65271C3FFBE8FB5E38DB301,42271,10,14,4,40,47,2047
46384,46384,885A83C6A65271C3FFBE8FB5E38DB301,11806,15,19,4,41,48,2098
46385,46385,885A83C6A65271C3FFBE8FB5E38DB301,42271,20,21,1,40,47,2047
46386,46386,550035E235750077DB6B90A64CB04939,43061,0,5,5,43,46,2196
46387,46387,550035E235750077DB6B90A64CB04939,42321,8,16,8,43,47,2197
46388,46388,550035E235750077DB6B90A64CB04939,11271,17,19,2,37,48,1898
46395,46395,3904BFA0DAEEBCA85365DF524DB867F2,19031,0,6,6,1,42,92
46396,46396,3904BFA0DAEEBCA85365DF524DB867F2,12641,7,9,2,10,43,543
46397,46397,3904BFA0DAEEBCA85365DF524DB867F2,19031,12,13,1,1,42,92
46398,46398,3904BFA0DAEEBCA85365DF524DB867F2,12641,14,15,1,10,43,543
46399,46399,3904BFA0DAEEBCA85365DF524DB867F2,19031,17,23,6,1,42,92
46400,46400,A4CBFA774BBCB1E081978588796288CA,10681,0,7,7,30,48,1548
46401,46401,A4CBFA774BBCB1E081978588796288CA,11231,8,20,12,37,49,1899
46402,46402,A4CBFA774BBCB1E081978588796288CA,40491,21,22,1,39,49,1999
46410,46410,C274E980163D9B5AB7EB2F3B2E54C4BC,12311,0,1,1,30,44,1544
46411,46411,C274E980163D9B5AB7EB2F3B2E54C4BC,42531,3,4,1,31,45,1595
46412,46412,C274E980163D9B5AB7EB2F3B2E54C4BC,42151,9,10,1,35,45,1795
46413,46413,C274E980163D9B5AB7EB2F3B2E54C4BC,12311,13,14,1,30,44,1544
46414,46414,C274E980163D9B5AB7EB2F3B2E54C4BC,11834,18,19,1,32,45,1645
46415,46415,C274E980163D9B5AB7EB2F3B2E54C4BC,12311,21,22,1,30,44,1544
46419,46419,315EE087A7D3E5A0308BA99609B9790D,42531,0,17,17,31,45,1595
46420,46420,315EE087A7D3E5A0308BA99609B9790D,12491,18,19,1,36,43,1843
46421,46421,315EE087A7D3E5A0308BA99609B9790D,42531,20,23,3,31,45,1595
46425,46425,1B811243CBFDF69EF6596707541E2065,11751,0,1,1,35,48,1798
46426,46426,1B811243CBFDF69EF6596707541E2065,11011,4,6,2,39,49,1999
46427,46427,1B811243CBFDF69EF6596707541E2065,10211,14,18,4,16,49,849
46437,46437,344A3CF0E215A1C44A25A9F391805F64,42471,0,2,2,35,49,1799
46438,46438,344A3CF0E215A1C44A25A9F391805F64,11461,3,4,1,37,49,1899
46439,46439,344A3CF0E215A1C44A25A9F391805F64,10681,5,10,5,30,48,1548
46440,46440,344A3CF0E215A1C44A25A9F391805F64,11061,12,13,1,29,48,1498
46441,46441,344A3CF0E215A1C44A25A9F391805F64,12921,16,19,3,9,41,491
46442,46442,87B23E2F96F200D77D510D2BBA339661,19114,0,7,7,7,43,393
46443,46443,87B23E2F96F200D77D510D2BBA339661,10107,10,13,3,38,49,1949
46444,46444,87B23E2F96F200D77D510D2BBA339661,43581,14,15,1,33,48,1698
46445,46445,87B23E2F96F200D77D510D2BBA339661,19114,17,23,6,7,43,393
46450,46450,D7D05175178ECCC354BF6E061771BD76,42941,1,7,6,37,47,1897
46451,46451,D7D05175178ECCC354BF6E061771BD76,42091,15,17,2,43,46,2196
46452,46452,D7D05175178ECCC354BF6E061771BD76,11491,19,23,4,36,47,1847
46453,46453,563A85870A10F76208EC9A8B0C58B71C,13561,8,10,2,37,49,1899
46454,46454,563A85870A10F76208EC9A8B0C58B71C,10451,13,18,5,25,48,1298
46455,46455,563A85870A10F76208EC9A8B0C58B71C,42071,18,19,1,31,49,1599
46460,46460,67EEF12624F5A3B71954681C5774CEB1,42331,0,7,7,39,46,1996
46461,46461,67EEF12624F5A3B71954681C5774CEB1,11231,10,11,1,37,49,1899
46462,46462,67EEF12624F5A3B71954681C5774CEB1,10811,15,16,1,38,46,1946
46463,46463,67EEF12624F5A3B71954681C5774CEB1,42221,20,23,3,38,48,1948
46464,46464,63A1194DA67A916294F825B4249AD293,42161,1,4,3,36,47,1847
46465,46465,63A1194DA67A916294F825B4249AD293,42511,6,7,1,37,47,1897
46466,46466,63A1194DA67A916294F825B4249AD293,42161,8,9,1,36,47,1847
46467,46467,63A1194DA67A916294F825B4249AD293,11261,11,16,5,36,46,1846
46468,46468,63A1194DA67A916294F825B4249AD293,10841,21,23,2,37,47,1897
46469,46469,A2FF2B3E007AEF697BBECF6D3F01B855,43021,0,6,6,16,43,843
46470,46470,A2FF2B3E007AEF697BBECF6D3F01B855,19021,10,20,10,10,45,545
46471,46471,A2FF2B3E007AEF697BBECF6D3F01B855,43021,20,21,1,16,43,843
46472,46472,B57FA6A577B54BB28114ABA28733D834,10661,0,2,2,37,49,1899
46473,46473,B57FA6A577B54BB28114ABA28733D834,13711,3,7,4,38,46,1946
46474,46474,B57FA6A577B54BB28114ABA28733D834,42501,10,19,9,28,47,1447
46475,46475,B57FA6A577B54BB28114ABA28733D834,13711,19,21,2,38,46,1946
46476,46476,B57FA6A577B54BB28114ABA28733D834,11331,21,23,2,37,48,1898
46483,46483,7821010DB86E586C9ADE1CC21372F2E6,13711,0,6,6,38,46,1946
46484,46484,7821010DB86E586C9ADE1CC21372F2E6,12381,9,13,4,32,48,1648
46485,46485,7821010DB86E586C9ADE1CC21372F2E6,13711,15,22,7,38,46,1946
46492,46492,A1182D77FBD520E2E1D818514447208A,42071,10,11,1,31,49,1599
46493,46493,A1182D77FBD520E2E1D818514447208A,42121,16,17,1,26,49,1349
46494,46494,A1182D77FBD520E2E1D818514447208A,42261,19,20,1,25,49,1299
46495,46495,6CC3FE89A8F1A15E71D203BFCADF8D3A,11701,0,6,6,43,48,2198
46496,46496,6CC3FE89A8F1A15E71D203BFCADF8D3A,10251,7,19,12,35,47,1797
46497,46497,6CC3FE89A8F1A15E71D203BFCADF8D3A,11781,21,23,2,38,49,1949
46501,46501,46CB095EF81B7090747D900A43220105,42071,1,4,3,31,49,1599
46502,46502,46CB095EF81B7090747D900A43220105,10951,8,10,2,29,48,1498
46503,46503,46CB095EF81B7090747D900A43220105,42121,14,15,1,26,49,1349
46504,46504,46CB095EF81B7090747D900A43220105,42071,16,20,4,31,49,1599
46505,46505,46CB095EF81B7090747D900A43220105,10951,21,22,1,29,48,1498
46506,46506,EEE3AE7ABA4C03B6F4B079A7B52295B8,10731,2,16,14,33,47,1697
46507,46507,EEE3AE7ABA4C03B6F4B079A7B52295B8,40073,17,19,2,37,48,1898
46508,46508,EEE3AE7ABA4C03B6F4B079A7B52295B8,11651,19,21,2,33,47,1697
46509,46509,1B9FE9A5F78DA05BDEBCDA8F33F50E01,42501,9,10,1,28,47,1447
46510,46510,1B9FE9A5F78DA05BDEBCDA8F33F50E01,13711,12,14,2,38,46,1946
46511,46511,1B9FE9A5F78DA05BDEBCDA8F33F50E01,43241,14,18,4,36,46,1846
46519,46519,8AB561279CAFD673B81CFFF6F25401C3,12221,0,12,12,43,44,2194
46520,46520,8AB561279CAFD673B81CFFF6F25401C3,43011,13,14,1,40,42,2042
46521,46521,8AB561279CAFD673B81CFFF6F25401C3,13951,16,18,2,47,45,2395
46532,46532,3A1B49B490CA109FD4D5251F0C86C9CB,43581,0,14,14,33,48,1698
46533,46533,3A1B49B490CA109FD4D5251F0C86C9CB,12601,15,19,4,25,47,1297
46534,46534,3A1B49B490CA109FD4D5251F0C86C9CB,43581,20,23,3,33,48,1698
46538,46538,61EF45CB4DCE9C888F0C3EA5C62FC6EC,10251,0,8,8,35,47,1797
46539,46539,61EF45CB4DCE9C888F0C3EA5C62FC6EC,12083,9,12,3,36,49,1849
46540,46540,61EF45CB4DCE9C888F0C3EA5C62FC6EC,10251,12,16,4,35,47,1797
46541,46541,61EF45CB4DCE9C888F0C3EA5C62FC6EC,40951,16,19,3,36,49,1849
46542,46542,61EF45CB4DCE9C888F0C3EA5C62FC6EC,10251,20,23,3,35,47,1797
46553,46553,5AF7A250F769DD424B6F153B49B360AA,10901,0,7,7,35,48,1798
46554,46554,5AF7A250F769DD424B6F153B49B360AA,12601,9,16,7,25,47,1297
46555,46555,5AF7A250F769DD424B6F153B49B360AA,10901,17,23,6,35,48,1798
46564,46564,A5630108861A248FF687B4053732186B,40833,0,14,14,41,47,2097
46565,46565,A5630108861A248FF687B4053732186B,10401,14,16,2,33,49,1699
46566,46566,A5630108861A248FF687B4053732186B,13271,17,23,6,41,47,2097
46570,46570,DC4909E42C27451AF7115D80FD524792,11381,0,17,17,30,47,1547
46571,46571,DC4909E42C27451AF7115D80FD524792,42623,18,20,2,22,49,1149
46572,46572,DC4909E42C27451AF7115D80FD524792,11381,22,23,1,30,47,1547
46573,46573,C50F95F31F14C0EC9A55706C3B181C1C,43121,2,4,2,25,27,1277
46574,46574,C50F95F31F14C0EC9A55706C3B181C1C,12792,7,11,4,34,30,1730
46575,46575,C50F95F31F14C0EC9A55706C3B181C1C,43121,13,16,3,25,27,1277
46576,46576,C50F95F31F14C0EC9A55706C3B181C1C,15391,16,23,7,35,26,1776
46588,46588,35DE934E09014E3A56964C528E95BB57,12121,1,8,7,29,47,1497
46589,46589,35DE934E09014E3A56964C528E95BB57,11651,9,11,2,33,47,1697
46590,46590,35DE934E09014E3A56964C528E95BB57,40637,12,18,6,36,47,1847
46591,46591,35DE934E09014E3A56964C528E95BB57,10901,20,22,2,35,48,1798
46592,46592,CED2E140B216F950F7D7F7935269042E,40241,0,10,10,35,49,1799
46593,46593,CED2E140B216F950F7D7F7935269042E,11021,12,14,2,36,49,1849
46594,46594,CED2E140B216F950F7D7F7935269042E,13321,15,16,1,41,37,2087
46595,46595,CED2E140B216F950F7D7F7935269042E,40241,17,21,4,35,49,1799
46596,46596,C644771D2D9F4182BC18DB70E907DF2B,11914,0,1,1,37,48,1898
46597,46597,C644771D2D9F4182BC18DB70E907DF2B,42581,2,8,6,38,48,1948
46598,46598,C644771D2D9F4182BC18DB70E907DF2B,11914,8,11,3,37,48,1898
46599,46599,C644771D2D9F4182BC18DB70E907DF2B,43181,14,16,2,39,48,1998
46600,46600,C644771D2D9F4182BC18DB70E907DF2B,10107,20,22,2,38,49,1949
46605,46605,C6AE43BCF2EE1FC6074AAD8338B9AA5D,42521,0,18,18,31,47,1597
46606,46606,C6AE43BCF2EE1FC6074AAD8338B9AA5D,40341,19,21,2,23,49,1199
46607,46607,C6AE43BCF2EE1FC6074AAD8338B9AA5D,42521,22,23,1,31,47,1597
46608,46608,2FCC231DE348255A3F9CDA8D77EEA7DC,12581,0,5,5,24,48,1248
46609,46609,2FCC231DE348255A3F9CDA8D77EEA7DC,12051,5,10,5,20,47,1047
46610,46610,2FCC231DE348255A3F9CDA8D77EEA7DC,12581,10,11,1,24,48,1248
46611,46611,2FCC231DE348255A3F9CDA8D77EEA7DC,12051,12,14,2,20,47,1047
46612,46612,2FCC231DE348255A3F9CDA8D77EEA7DC,12581,16,23,7,24,48,1248
46613,46613,9697B9F61B38351656D148BBCAC6B04D,41392,0,14,14,43,48,2198
46614,46614,9697B9F61B38351656D148BBCAC6B04D,40171,14,17,3,38,48,1948
46615,46615,9697B9F61B38351656D148BBCAC6B04D,41392,20,23,3,43,48,2198
46616,46616,DF4AFBE0E1EA2875709E73E5EAF86C7E,10401,0,14,14,33,49,1699
46617,46617,DF4AFBE0E1EA2875709E73E5EAF86C7E,11061,14,16,2,29,48,1498
46618,46618,DF4AFBE0E1EA2875709E73E5EAF86C7E,10381,18,19,1,31,49,1599
46619,46619,EF2E66853800FD0F0FDF1A24C24F87DD,12514,0,13,13,38,47,1947
46620,46620,EF2E66853800FD0F0FDF1A24C24F87DD,13381,16,17,1,39,47,1997
46621,46621,EF2E66853800FD0F0FDF1A24C24F87DD,13511,21,23,2,34,48,1748
46632,46632,B2173839FD782B1D15908D4D39D23EB4,12311,0,18,18,30,44,1544
46633,46633,B2173839FD782B1D15908D4D39D23EB4,12381,19,21,2,32,48,1648
46634,46634,B2173839FD782B1D15908D4D39D23EB4,12311,22,23,1,30,44,1544
46635,46635,B3C5BF844B9304CFB34455A8DA7AE3BE,42271,0,7,7,40,47,2047
46636,46636,B3C5BF844B9304CFB34455A8DA7AE3BE,11806,8,12,4,41,48,2098
46637,46637,B3C5BF844B9304CFB34455A8DA7AE3BE,42271,13,14,1,40,47,2047
46638,46638,B3C5BF844B9304CFB34455A8DA7AE3BE,11806,17,19,2,41,48,2098
46639,46639,B3C5BF844B9304CFB34455A8DA7AE3BE,40341,20,22,2,23,49,1199
46654,46654,5487427E39C73D6D38EF674DFDFC2E03,11861,8,12,4,32,47,1647
46655,46655,5487427E39C73D6D38EF674DFDFC2E03,12311,13,17,4,30,44,1544
46656,46656,5487427E39C73D6D38EF674DFDFC2E03,11861,18,23,5,32,47,1647
46657,46657,66AFBD9C113F67320652DF95B713C893,12221,10,11,1,43,44,2194
46658,46658,66AFBD9C113F67320652DF95B713C893,13221,15,16,1,40,47,2047
46659,46659,66AFBD9C113F67320652DF95B713C893,10111,20,21,1,37,47,1897
46670,46670,A09B631BCC319D5EC41B3CFE0EF885AC,10191,0,9,9,40,48,2048
46671,46671,A09B631BCC319D5EC41B3CFE0EF885AC,12601,13,16,3,25,47,1297
46672,46672,A09B631BCC319D5EC41B3CFE0EF885AC,43731,18,19,1,34,47,1747
46673,46673,A09B631BCC319D5EC41B3CFE0EF885AC,11211,21,22,1,34,49,1749
46678,46678,172F302F5199600F927C0E74978E3B3A,10111,0,8,8,37,47,1897
46679,46679,172F302F5199600F927C0E74978E3B3A,10401,9,11,2,33,49,1699
46680,46680,172F302F5199600F927C0E74978E3B3A,10111,12,23,11,37,47,1897
46688,46688,57030A6B246337C372ECD8CBCE2783A5,11771,0,6,6,39,49,1999
46689,46689,57030A6B246337C372ECD8CBCE2783A5,42271,9,10,1,40,47,2047
46690,46690,57030A6B246337C372ECD8CBCE2783A5,11771,11,13,2,39,49,1999
46691,46691,57030A6B246337C372ECD8CBCE2783A5,42271,14,15,1,40,47,2047
46692,46692,57030A6B246337C372ECD8CBCE2783A5,11771,18,23,5,39,49,1999
46693,46693,135EF939D99CED11694D71795A5772B0,19031,0,15,15,1,42,92
46694,46694,135EF939D99CED11694D71795A5772B0,12641,15,19,4,10,43,543
46695,46695,135EF939D99CED11694D71795A5772B0,19031,20,23,3,1,42,92
46696,46696,996E78B516B54BE4ADEF09770F316D9D,13341,0,4,4,44,45,2245
46697,46697,996E78B516B54BE4ADEF09770F316D9D,43391,7,20,13,29,48,1498
46698,46698,996E78B516B54BE4ADEF09770F316D9D,13341,22,23,1,44,45,2245
46699,46699,0EC1D2502267B7D6F36C8EA9D8EC3DDA,10171,0,7,7,26,47,1347
46700,46700,0EC1D2502267B7D6F36C8EA9D8EC3DDA,11001,9,11,2,42,47,2147
46701,46701,0EC1D2502267B7D6F36C8EA9D8EC3DDA,10171,15,22,7,26,47,1347
46702,46702,14A26121D61284733518359391469C97,19571,0,3,3,1,36,86
46703,46703,14A26121D61284733518359391469C97,43644,5,16,11,14,38,738
46704,46704,14A26121D61284733518359391469C97,19261,16,17,1,6,37,337
46705,46705,14A26121D61284733518359391469C97,43644,17,23,6,14,38,738
46706,46706,068FED97D465E9858DEA740965A57348,11231,9,17,8,37,49,1899
46707,46707,068FED97D465E9858DEA740965A57348,11861,18,20,2,32,47,1647
46708,46708,068FED97D465E9858DEA740965A57348,40073,20,23,3,37,48,1898
46709,46709,DA0CCACC9125EA2DFA666F381DBCB51C,43041,4,11,7,41,46,2096
46710,46710,DA0CCACC9125EA2DFA666F381DBCB51C,13221,12,13,1,40,47,2047
46711,46711,DA0CCACC9125EA2DFA666F381DBCB51C,12561,14,15,1,45,43,2293
46712,46712,DA0CCACC9125EA2DFA666F381DBCB51C,43041,15,23,8,41,46,2096
46719,46719,D96201B04F49DA8FE5B344343C2EC845,10281,0,7,7,33,48,1698
46720,46720,D96201B04F49DA8FE5B344343C2EC845,42151,8,19,11,35,45,1795
46721,46721,D96201B04F49DA8FE5B344343C2EC845,11861,19,23,4,32,47,1647
46729,46729,9397083C419903E30A62F5C06D299D5C,43011,1,3,2,40,42,2042
46730,46730,9397083C419903E30A62F5C06D299D5C,43451,6,9,3,37,40,1890
46731,46731,9397083C419903E30A62F5C06D299D5C,42381,12,13,1,39,41,1991
46732,46732,9397083C419903E30A62F5C06D299D5C,43451,13,18,5,37,40,1890
46733,46733,9397083C419903E30A62F5C06D299D5C,13071,19,21,2,41,41,2091
46740,46740,4E1126CD1AF86FC47E3B081AF053FA88,43761,0,6,6,32,47,1647
46741,46741,4E1126CD1AF86FC47E3B081AF053FA88,10341,6,9,3,31,47,1597
46742,46742,4E1126CD1AF86FC47E3B081AF053FA88,43761,12,14,2,32,47,1647
46743,46743,4E1126CD1AF86FC47E3B081AF053FA88,42523,15,18,3,31,47,1597
46744,46744,4E1126CD1AF86FC47E3B081AF053FA88,43761,21,22,1,32,47,1647
46748,46748,683193FAC39A23EAB0A08DD88DB175F9,10351,2,5,3,28,45,1445
46749,46749,683193FAC39A23EAB0A08DD88DB175F9,11281,7,12,5,27,40,1390
46750,46750,683193FAC39A23EAB0A08DD88DB175F9,13671,12,13,1,27,43,1393
46751,46751,683193FAC39A23EAB0A08DD88DB175F9,11281,18,20,2,27,40,1390
46752,46752,683193FAC39A23EAB0A08DD88DB175F9,13671,20,21,1,27,43,1393
46753,46753,9E2EB523208A345DE4509D7FD0839517,40861,0,1,1,34,48,1748
46754,46754,9E2EB523208A345DE4509D7FD0839517,13471,2,7,5,47,49,2399
46755,46755,9E2EB523208A345DE4509D7FD0839517,43621,8,9,1,46,48,2348
46756,46756,9E2EB523208A345DE4509D7FD0839517,11701,10,11,1,43,48,2198
46757,46757,9E2EB523208A345DE4509D7FD0839517,13471,12,14,2,47,49,2399
46758,46758,9E2EB523208A345DE4509D7FD0839517,43621,14,17,3,46,48,2348
46759,46759,9E2EB523208A345DE4509D7FD0839517,13471,21,23,2,47,49,2399
46760,46760,A61D0F5D6E4730E77483BB5A83F54B2C,42401,0,8,8,36,47,1847
46761,46761,A61D0F5D6E4730E77483BB5A83F54B2C,10191,11,13,2,40,48,2048
46762,46762,A61D0F5D6E4730E77483BB5A83F54B2C,10841,14,18,4,37,47,1897
46763,46763,A61D0F5D6E4730E77483BB5A83F54B2C,13841,21,23,2,40,46,2046
46767,46767,6F415A6C9280D88B8110CAC697EDE5B3,43311,0,10,10,31,48,1598
46768,46768,6F415A6C9280D88B8110CAC697EDE5B3,19281,11,13,2,16,32,832
46769,46769,6F415A6C9280D88B8110CAC697EDE5B3,12871,13,20,7,22,33,1133
46770,46770,91DE37EA0CCED8ED79761F87F43C0822,40171,6,8,2,38,48,1948
46771,46771,91DE37EA0CCED8ED79761F87F43C0822,13481,10,12,2,26,31,1331
46772,46772,91DE37EA0CCED8ED79761F87F43C0822,42623,16,17,1,22,49,1149
46773,46773,91DE37EA0CCED8ED79761F87F43C0822,40171,20,23,3,38,48,1948
46774,46774,D0D54F11AE6E916A7FB4D7681D5BE6D5,19821,5,11,6,4,46,246
46775,46775,D0D54F11AE6E916A7FB4D7681D5BE6D5,12971,13,19,6,32,48,1648
46776,46776,D0D54F11AE6E916A7FB4D7681D5BE6D5,19441,20,21,1,8,46,446
46777,46777,7C7C7763ADA0CC64FB88CC4AF6EE7D4D,13791,0,5,5,42,47,2147
46778,46778,7C7C7763ADA0CC64FB88CC4AF6EE7D4D,11074,9,17,8,37,47,1897
46779,46779,7C7C7763ADA0CC64FB88CC4AF6EE7D4D,11921,19,22,3,38,48,1948
46780,46780,28DE4C4AE78D936136FCFA3D860A887C,11271,5,6,1,37,48,1898
46781,46781,28DE4C4AE78D936136FCFA3D860A887C,10221,7,8,1,34,49,1749
46782,46782,28DE4C4AE78D936136FCFA3D860A887C,13094,10,11,1,21,42,1092
46783,46783,28DE4C4AE78D936136FCFA3D860A887C,10221,12,13,1,34,49,1749
46784,46784,28DE4C4AE78D936136FCFA3D860A887C,11491,16,23,7,36,47,1847
46785,46785,F3E865F547634F229EE0C4B82ED36B57,43761,0,7,7,32,47,1647
46786,46786,F3E865F547634F229EE0C4B82ED36B57,19031,9,12,3,1,42,92
46787,46787,F3E865F547634F229EE0C4B82ED36B57,12641,14,15,1,10,43,543
46788,46788,F3E865F547634F229EE0C4B82ED36B57,12311,16,19,3,30,44,1544
46792,46792,FBAEDDC35131773D9B34EA9CA44E2AF3,13121,0,3,3,38,46,1946
46793,46793,FBAEDDC35131773D9B34EA9CA44E2AF3,43731,5,7,2,34,47,1747
46794,46794,FBAEDDC35131773D9B34EA9CA44E2AF3,10971,8,9,1,35,47,1797
46795,46795,FBAEDDC35131773D9B34EA9CA44E2AF3,12391,13,14,1,36,49,1849
46796,46796,FBAEDDC35131773D9B34EA9CA44E2AF3,13341,17,20,3,44,45,2245
46797,46797,FBAEDDC35131773D9B34EA9CA44E2AF3,10971,21,22,1,35,47,1797
46801,46801,1A5BED51D45595E1322F7C9DAB1FCF2D,43061,0,6,6,43,46,2196
46802,46802,1A5BED51D45595E1322F7C9DAB1FCF2D,43051,7,10,3,46,45,2345
46803,46803,1A5BED51D45595E1322F7C9DAB1FCF2D,13041,12,18,6,30,37,1537
46804,46804,9918FEABB0433C4402810CC88ACF5496,12311,0,10,10,30,44,1544
46805,46805,9918FEABB0433C4402810CC88ACF5496,43161,10,11,1,35,47,1797
46806,46806,9918FEABB0433C4402810CC88ACF5496,43731,11,12,1,34,47,1747
46807,46807,9918FEABB0433C4402810CC88ACF5496,12311,13,23,10,30,44,1544
46814,46814,4A1082E29116D07A4EA830C32D0BE5ED,12514,1,2,1,38,47,1947
46815,46815,4A1082E29116D07A4EA830C32D0BE5ED,42031,3,10,7,40,46,2046
46816,46816,4A1082E29116D07A4EA830C32D0BE5ED,12221,11,22,11,43,44,2194
46820,46820,73118727834AEF72D14D5BE83EC91BD1,11001,0,7,7,42,47,2147
46821,46821,73118727834AEF72D14D5BE83EC91BD1,13941,10,11,1,41,47,2097
46822,46822,73118727834AEF72D14D5BE83EC91BD1,11074,13,21,8,37,47,1897
46823,46823,6A22B907A7F1FA4A685D409A00615D34,13911,0,6,6,39,46,1996
46824,46824,6A22B907A7F1FA4A685D409A00615D34,11261,8,10,2,36,46,1846
46825,46825,6A22B907A7F1FA4A685D409A00615D34,13911,11,14,3,39,46,1996
46826,46826,6A22B907A7F1FA4A685D409A00615D34,11261,14,19,5,36,46,1846
46827,46827,6A22B907A7F1FA4A685D409A00615D34,12491,21,23,2,36,43,1843
46828,46828,5666912162A4CBB7EA17E3775FF42DAA,11171,0,7,7,33,48,1698
46829,46829,5666912162A4CBB7EA17E3775FF42DAA,10431,8,10,2,33,49,1699
46830,46830,5666912162A4CBB7EA17E3775FF42DAA,10921,12,13,1,43,48,2198
46831,46831,5666912162A4CBB7EA17E3775FF42DAA,41031,18,20,2,32,49,1649
46843,46843,4DA57F9F33C37E2CA21407DE781C18AF,13911,0,5,5,39,46,1996
46844,46844,4DA57F9F33C37E2CA21407DE781C18AF,11261,6,7,1,36,46,1846
46845,46845,4DA57F9F33C37E2CA21407DE781C18AF,42231,9,10,1,37,46,1896
46846,46846,4DA57F9F33C37E2CA21407DE781C18AF,13911,11,16,5,39,46,1996
46847,46847,4DA57F9F33C37E2CA21407DE781C18AF,11261,19,20,1,36,46,1846
46848,46848,4DA57F9F33C37E2CA21407DE781C18AF,42351,22,23,1,38,45,1945
46849,46849,27FCD71F327E3F620FD79B87D9B02AEA,12514,0,7,7,38,47,1947
46850,46850,27FCD71F327E3F620FD79B87D9B02AEA,43311,8,10,2,31,48,1598
46851,46851,27FCD71F327E3F620FD79B87D9B02AEA,12514,12,14,2,38,47,1947
46852,46852,27FCD71F327E3F620FD79B87D9B02AEA,43311,15,18,3,31,48,1598
46853,46853,27FCD71F327E3F620FD79B87D9B02AEA,11074,19,20,1,37,47,1897
46857,46857,CEDE33B1516DA1FDFA461E824873495E,11151,0,7,7,30,48,1548
46858,46858,CEDE33B1516DA1FDFA461E824873495E,43391,9,13,4,29,48,1498
46859,46859,CEDE33B1516DA1FDFA461E824873495E,43731,15,18,3,34,47,1747
46860,46860,CEDE33B1516DA1FDFA461E824873495E,10251,19,22,3,35,47,1797
46861,46861,FA7A94CADC962325319C28486D92F065,15051,0,5,5,19,4,954
46862,46862,FA7A94CADC962325319C28486D92F065,16281,9,10,1,11,4,554
46863,46863,FA7A94CADC962325319C28486D92F065,15051,12,13,1,19,4,954
46864,46864,FA7A94CADC962325319C28486D92F065,16281,15,16,1,11,4,554
46865,46865,FA7A94CADC962325319C28486D92F065,15051,21,23,2,19,4,954
46866,46866,D4215C93311874F9D33E283EC2F816A1,10681,1,11,10,30,48,1548
46867,46867,D4215C93311874F9D33E283EC2F816A1,11381,13,14,1,30,47,1547
46868,46868,D4215C93311874F9D33E283EC2F816A1,11231,15,21,6,37,49,1899
46869,46869,77E5E75CEF06541677BE06631B9D1AB2,13094,0,5,5,21,42,1092
46870,46870,77E5E75CEF06541677BE06631B9D1AB2,11281,8,9,1,27,40,1390
46871,46871,77E5E75CEF06541677BE06631B9D1AB2,13671,14,20,6,27,43,1393
46872,46872,77E5E75CEF06541677BE06631B9D1AB2,13094,20,23,3,21,42,1092
46877,46877,2317EEF942E511029895E416C1875CE5,43751,0,2,2,19,48,998
46878,46878,2317EEF942E511029895E416C1875CE5,10491,4,18,14,33,48,1698
46879,46879,2317EEF942E511029895E416C1875CE5,11561,18,21,3,32,49,1649
46880,46880,2317EEF942E511029895E416C1875CE5,10281,22,23,1,33,48,1698
46881,46881,751F5E5DDEA35965577223E8F147F079,11011,0,8,8,39,49,1999
46882,46882,751F5E5DDEA35965577223E8F147F079,11861,12,14,2,32,47,1647
46883,46883,751F5E5DDEA35965577223E8F147F079,43731,18,20,2,34,47,1747
46884,46884,D9026A3CE10A3841EFEE0C49DAE389C6,12641,0,6,6,10,43,543
46885,46885,D9026A3CE10A3841EFEE0C49DAE389C6,19114,6,7,1,7,43,393
46886,46886,D9026A3CE10A3841EFEE0C49DAE389C6,12641,11,13,2,10,43,543
46887,46887,D9026A3CE10A3841EFEE0C49DAE389C6,19114,13,18,5,7,43,393
46888,46888,D9026A3CE10A3841EFEE0C49DAE389C6,12641,19,23,4,10,43,543
46892,46892,BF3354E7653978B437BDBF5412A04932,12871,0,1,1,22,33,1133
46893,46893,BF3354E7653978B437BDBF5412A04932,19281,5,10,5,16,32,832
46894,46894,BF3354E7653978B437BDBF5412A04932,12871,12,14,2,22,33,1133
46895,46895,BF3354E7653978B437BDBF5412A04932,19281,17,20,3,16,32,832
46896,46896,BF3354E7653978B437BDBF5412A04932,12871,20,22,2,22,33,1133
46897,46897,393F5524259520584332C02612814AC9,11091,0,13,13,29,47,1497
46898,46898,393F5524259520584332C02612814AC9,12561,15,16,1,45,43,2293
46899,46899,393F5524259520584332C02612814AC9,11091,19,22,3,29,47,1497
46900,46900,C51EE78995B692FB9DA132D6AABD43B2,10651,0,7,7,36,49,1849
46901,46901,C51EE78995B692FB9DA132D6AABD43B2,10811,8,9,1,38,46,1946
46902,46902,C51EE78995B692FB9DA132D6AABD43B2,11801,12,14,2,42,48,2148
46903,46903,C51EE78995B692FB9DA132D6AABD43B2,40697,15,16,1,43,48,2198
46904,46904,C51EE78995B692FB9DA132D6AABD43B2,10651,20,23,3,36,49,1849
46905,46905,3C480ADCAE38479CAE26A016FCDCC13B,13371,0,12,12,41,47,2097
46906,46906,3C480ADCAE38479CAE26A016FCDCC13B,11701,13,15,2,43,48,2198
46907,46907,3C480ADCAE38479CAE26A016FCDCC13B,11631,19,21,2,12,49,649
46911,46911,3AE9C3B6C0E6A8AA6B3B6C58033F1358,13941,0,6,6,41,47,2097
46912,46912,3AE9C3B6C0E6A8AA6B3B6C58033F1358,42981,7,14,7,36,49,1849
46913,46913,3AE9C3B6C0E6A8AA6B3B6C58033F1358,13941,19,23,4,41,47,2097
46921,46921,E9A997EAD20100BC8DA950F1F1E8DDFE,11074,3,6,3,37,47,1897
46922,46922,E9A997EAD20100BC8DA950F1F1E8DDFE,40341,7,9,2,23,49,1199
46923,46923,E9A997EAD20100BC8DA950F1F1E8DDFE,10621,11,12,1,41,49,2099
46924,46924,E9A997EAD20100BC8DA950F1F1E8DDFE,40302,13,16,3,40,49,2049
46925,46925,E9A997EAD20100BC8DA950F1F1E8DDFE,40833,17,20,3,41,47,2097
46926,46926,E9A997EAD20100BC8DA950F1F1E8DDFE,11074,20,21,1,37,47,1897
46927,46927,F54C9D4E2001ACEF8FFE7EEF806B67B0,10121,0,9,9,36,49,1849
46928,46928,F54C9D4E2001ACEF8FFE7EEF806B67B0,15261,12,16,4,39,13,1963
46929,46929,F54C9D4E2001ACEF8FFE7EEF806B67B0,10121,21,23,2,36,49,1849
46933,46933,2C19FDC386B0B2E924F75B25676D719F,42351,0,8,8,38,45,1945
46934,46934,2C19FDC386B0B2E924F75B25676D719F,42231,11,12,1,37,46,1896
46935,46935,2C19FDC386B0B2E924F75B25676D719F,12481,21,23,2,37,49,1899
46936,46936,E03B05F0FB01917EEB19D58711FDBCBD,13071,0,10,10,41,41,2091
46937,46937,E03B05F0FB01917EEB19D58711FDBCBD,43101,10,13,3,46,40,2340
46938,46938,E03B05F0FB01917EEB19D58711FDBCBD,13071,15,17,2,41,41,2091
46939,46939,E03B05F0FB01917EEB19D58711FDBCBD,43101,17,20,3,46,40,2340
46940,46940,E03B05F0FB01917EEB19D58711FDBCBD,13071,20,22,2,41,41,2091
46941,46941,64A2E9501F429B6DEC66E8EE627CCABA,11061,0,8,8,29,48,1498
46942,46942,64A2E9501F429B6DEC66E8EE627CCABA,10301,12,14,2,31,45,1595
46943,46943,64A2E9501F429B6DEC66E8EE627CCABA,10107,15,18,3,38,49,1949
46948,46948,C54D86E5520DA9763CF81E383AB734CE,13314,8,9,1,31,39,1589
46949,46949,C54D86E5520DA9763CF81E383AB734CE,12521,12,19,7,35,41,1791
46950,46950,C54D86E5520DA9763CF81E383AB734CE,13314,21,23,2,31,39,1589
46954,46954,8DCBE913047A4EFA5302E4AB5EEAE30F,41392,1,7,6,43,48,2198
46955,46955,8DCBE913047A4EFA5302E4AB5EEAE30F,42471,10,12,2,35,49,1799
46956,46956,8DCBE913047A4EFA5302E4AB5EEAE30F,12381,12,14,2,32,48,1648
46957,46957,8DCBE913047A4EFA5302E4AB5EEAE30F,10471,18,20,2,37,48,1898
46958,46958,8DCBE913047A4EFA5302E4AB5EEAE30F,10221,20,22,2,34,49,1749
46959,46959,5E6AB6B686A00A7ED3B8EAE75C21937D,42864,0,9,9,38,44,1944
46960,46960,5E6AB6B686A00A7ED3B8EAE75C21937D,11261,9,11,2,36,46,1846
46961,46961,5E6AB6B686A00A7ED3B8EAE75C21937D,42461,12,13,1,45,47,2297
46962,46962,5E6AB6B686A00A7ED3B8EAE75C21937D,11261,17,18,1,36,46,1846
46963,46963,5E6AB6B686A00A7ED3B8EAE75C21937D,42864,20,22,2,38,44,1944
46964,46964,C6869A64CA9EF97A25D7192A00726FC2,42161,0,12,12,36,47,1847
46965,46965,C6869A64CA9EF97A25D7192A00726FC2,11701,14,15,1,43,48,2198
46966,46966,C6869A64CA9EF97A25D7192A00726FC2,10251,15,19,4,35,47,1797
46967,46967,C6869A64CA9EF97A25D7192A00726FC2,42401,20,23,3,36,47,1847
46968,46968,57068447BEEE4D7969FF166D57966ECA,42541,0,5,5,25,47,1297
46969,46969,57068447BEEE4D7969FF166D57966ECA,12051,7,8,1,20,47,1047
46970,46970,57068447BEEE4D7969FF166D57966ECA,11361,9,11,2,22,48,1148
46971,46971,57068447BEEE4D7969FF166D57966ECA,42541,12,13,1,25,47,1297
46972,46972,57068447BEEE4D7969FF166D57966ECA,11361,13,17,4,22,48,1148
46973,46973,57068447BEEE4D7969FF166D57966ECA,10171,19,20,1,26,47,1347
46974,46974,57068447BEEE4D7969FF166D57966ECA,42541,21,23,2,25,47,1297
46975,46975,29ED7585A7C0FD6B2E71E72A2B2372DE,42531,1,6,5,31,45,1595
46976,46976,29ED7585A7C0FD6B2E71E72A2B2372DE,42781,9,16,7,36,46,1846
46977,46977,29ED7585A7C0FD6B2E71E72A2B2372DE,42531,18,19,1,31,45,1595
46978,46978,DBE56CF804EFF98F06EBBF480586FC01,43021,1,7,6,16,43,843
46979,46979,DBE56CF804EFF98F06EBBF480586FC01,12921,8,18,10,9,41,491
46980,46980,DBE56CF804EFF98F06EBBF480586FC01,43021,21,23,2,16,43,843
46988,46988,7B4D6C9531BEA5C5F58764B7492E11BF,19491,0,6,6,14,27,727
46989,46989,7B4D6C9531BEA5C5F58764B7492E11BF,12871,8,20,12,22,33,1133
46990,46990,7B4D6C9531BEA5C5F58764B7492E11BF,19531,21,22,1,17,30,880
46995,46995,1BABC9D2139583D8D5A8610AD83945FA,16281,1,3,2,11,4,554
46996,46996,1BABC9D2139583D8D5A8610AD83945FA,15051,7,9,2,19,4,954
46997,46997,1BABC9D2139583D8D5A8610AD83945FA,16281,9,14,5,11,4,554
46998,46998,1BABC9D2139583D8D5A8610AD83945FA,15051,14,15,1,19,4,954
46999,46999,1BABC9D2139583D8D5A8610AD83945FA,16281,16,17,1,11,4,554
47000,47000,1BABC9D2139583D8D5A8610AD83945FA,15051,17,18,1,19,4,954
47001,47001,1BABC9D2139583D8D5A8610AD83945FA,16281,18,20,2,11,4,554
47005,47005,A5A090591E63A367211B3058D6F881BC,12921,1,8,7,9,41,491
47006,47006,A5A090591E63A367211B3058D6F881BC,43021,8,10,2,16,43,843
47007,47007,A5A090591E63A367211B3058D6F881BC,12921,12,13,1,9,41,491
47008,47008,A5A090591E63A367211B3058D6F881BC,43021,13,20,7,16,43,843
47009,47009,A5A090591E63A367211B3058D6F881BC,12921,21,22,1,9,41,491
47014,47014,4BE03AB7B88CA8091DBCEF6257C15779,43761,0,4,4,32,47,1647
47015,47015,4BE03AB7B88CA8091DBCEF6257C15779,11161,8,9,1,32,48,1648
47016,47016,4BE03AB7B88CA8091DBCEF6257C15779,43761,11,14,3,32,47,1647
47017,47017,4BE03AB7B88CA8091DBCEF6257C15779,42521,15,17,2,31,47,1597
47018,47018,4BE03AB7B88CA8091DBCEF6257C15779,43761,17,19,2,32,47,1647
47019,47019,4BE03AB7B88CA8091DBCEF6257C15779,42521,20,22,2,31,47,1597
47043,47043,BF19E34EF22C25E20CB766DD1F94922D,43751,2,5,3,19,48,998
47044,47044,BF19E34EF22C25E20CB766DD1F94922D,42681,6,7,1,24,48,1248
47045,47045,BF19E34EF22C25E20CB766DD1F94922D,43751,11,21,10,19,48,998
47046,47046,BF19E34EF22C25E20CB766DD1F94922D,12051,21,23,2,20,47,1047
47054,47054,51ED9F876F31E20E4E986B031FE77283,42631,0,7,7,43,45,2195
47055,47055,51ED9F876F31E20E4E986B031FE77283,43061,10,11,1,43,46,2196
47056,47056,51ED9F876F31E20E4E986B031FE77283,13341,13,16,3,44,45,2245
47057,47057,51ED9F876F31E20E4E986B031FE77283,40341,19,21,2,23,49,1199
47058,47058,C415343168773013C92CA13C873C9F99,12311,0,5,5,30,44,1544
47059,47059,C415343168773013C92CA13C873C9F99,12881,9,11,2,47,22,2372
47060,47060,C415343168773013C92CA13C873C9F99,15441,11,14,3,44,20,2220
47061,47061,C415343168773013C92CA13C873C9F99,13671,19,20,1,27,43,1393
47062,47062,C415343168773013C92CA13C873C9F99,12311,22,23,1,30,44,1544
47063,47063,AD3E01B55BE3A10979B701E17C93952E,11361,0,4,4,22,48,1148
47064,47064,AD3E01B55BE3A10979B701E17C93952E,42691,5,8,3,24,48,1248
47065,47065,AD3E01B55BE3A10979B701E17C93952E,11361,9,11,2,22,48,1148
47066,47066,AD3E01B55BE3A10979B701E17C93952E,43751,16,17,1,19,48,998
47067,47067,AD3E01B55BE3A10979B701E17C93952E,12581,22,23,1,24,48,1248
47071,47071,8B0BB25047AAE6F78630300FC92F043E,40833,0,6,6,41,47,2097
47072,47072,8B0BB25047AAE6F78630300FC92F043E,10801,11,17,6,42,47,2147
47073,47073,8B0BB25047AAE6F78630300FC92F043E,11271,17,18,1,37,48,1898
47074,47074,8B0BB25047AAE6F78630300FC92F043E,13271,19,20,1,41,47,2097
47075,47075,8B0BB25047AAE6F78630300FC92F043E,10801,22,23,1,42,47,2147
47076,47076,B2E1A9593E19D988BDD0EE32D9CE9188,11281,0,2,2,27,40,1390
47077,47077,B2E1A9593E19D988BDD0EE32D9CE9188,13311,2,4,2,27,39,1389
47078,47078,B2E1A9593E19D988BDD0EE32D9CE9188,11281,4,8,4,27,40,1390
47079,47079,B2E1A9593E19D988BDD0EE32D9CE9188,12601,8,15,7,25,47,1297
47080,47080,B2E1A9593E19D988BDD0EE32D9CE9188,13311,19,21,2,27,39,1389
47087,47087,6D62BE8B751688E1124EF442CD693D0D,19904,0,5,5,9,44,494
47088,47088,6D62BE8B751688E1124EF442CD693D0D,19021,6,8,2,10,45,545
47089,47089,6D62BE8B751688E1124EF442CD693D0D,19114,10,12,2,7,43,393
47090,47090,6D62BE8B751688E1124EF442CD693D0D,19021,15,18,3,10,45,545
47091,47091,6D62BE8B751688E1124EF442CD693D0D,19114,18,20,2,7,43,393
47092,47092,6D62BE8B751688E1124EF442CD693D0D,12641,20,22,2,10,43,543
47096,47096,BAF8CBAEABDF4063FF5ED369E100E588,12083,0,14,14,36,49,1849
47097,47097,BAF8CBAEABDF4063FF5ED369E100E588,11161,19,21,2,32,48,1648
47098,47098,BAF8CBAEABDF4063FF5ED369E100E588,12083,22,23,1,36,49,1849
47099,47099,A0726C803D54356D79A20E6BD9BC86DB,10251,0,10,10,35,47,1797
47100,47100,A0726C803D54356D79A20E6BD9BC86DB,11791,11,13,2,38,49,1949
47101,47101,A0726C803D54356D79A20E6BD9BC86DB,11851,19,21,2,13,47,697
47106,47106,9BE9B638A03223167AF819AA94751264,43121,0,6,6,25,27,1277
47107,47107,9BE9B638A03223167AF819AA94751264,15321,8,10,2,29,26,1476
47108,47108,9BE9B638A03223167AF819AA94751264,43121,10,23,13,25,27,1277
47109,47109,559E48D9BCBF38B1AE94C6F9C414A4F8,42623,0,1,1,22,49,1149
47110,47110,559E48D9BCBF38B1AE94C6F9C414A4F8,42261,1,3,2,25,49,1299
47111,47111,559E48D9BCBF38B1AE94C6F9C414A4F8,42121,4,5,1,26,49,1349
47112,47112,559E48D9BCBF38B1AE94C6F9C414A4F8,42261,9,13,4,25,49,1299
47113,47113,559E48D9BCBF38B1AE94C6F9C414A4F8,42071,17,18,1,31,49,1599
47114,47114,7A3CCBEE1EF7E270B4B301C75856D62F,11861,0,9,9,32,47,1647
47115,47115,7A3CCBEE1EF7E270B4B301C75856D62F,40951,12,13,1,36,49,1849
47116,47116,7A3CCBEE1EF7E270B4B301C75856D62F,11861,14,23,9,32,47,1647
47117,47117,9C52FD29B03EF1A5729C28BEF7100CC4,13314,0,8,8,31,39,1589
47118,47118,9C52FD29B03EF1A5729C28BEF7100CC4,43451,12,14,2,37,40,1890
47119,47119,9C52FD29B03EF1A5729C28BEF7100CC4,12521,17,18,1,35,41,1791
47120,47120,9C52FD29B03EF1A5729C28BEF7100CC4,13314,18,23,5,31,39,1589
47124,47124,0F1E7ADD98288D36843B90ADC158C3AC,11231,5,9,4,37,49,1899
47125,47125,0F1E7ADD98288D36843B90ADC158C3AC,42501,12,13,1,28,47,1447
47126,47126,0F1E7ADD98288D36843B90ADC158C3AC,11021,17,19,2,36,49,1849
47130,47130,2F380CE2E674806561EC26C449F15D1B,41393,0,8,8,43,49,2199
47131,47131,2F380CE2E674806561EC26C449F15D1B,42281,10,12,2,40,48,2048
47132,47132,2F380CE2E674806561EC26C449F15D1B,10781,13,14,1,35,47,1797
47133,47133,2F380CE2E674806561EC26C449F15D1B,11541,15,20,5,35,49,1799
47134,47134,CA7675D4504FF649E5D3C79C1D770D57,10901,0,6,6,35,48,1798
47135,47135,CA7675D4504FF649E5D3C79C1D770D57,11151,10,14,4,30,48,1548
47136,47136,CA7675D4504FF649E5D3C79C1D770D57,10901,18,23,5,35,48,1798
47146,47146,4C4BFC6596FD3FEC2B91BC1C914BF8BF,19281,0,6,6,16,32,832
47147,47147,4C4BFC6596FD3FEC2B91BC1C914BF8BF,12871,10,14,4,22,33,1133
47148,47148,4C4BFC6596FD3FEC2B91BC1C914BF8BF,19281,19,23,4,16,32,832
47149,47149,39E8EC68B5351FA08172ACDD9F93F15C,40411,1,2,1,34,48,1748
47150,47150,39E8EC68B5351FA08172ACDD9F93F15C,10661,2,3,1,37,49,1899
47151,47151,39E8EC68B5351FA08172ACDD9F93F15C,10251,3,7,4,35,47,1797
47152,47152,39E8EC68B5351FA08172ACDD9F93F15C,15381,18,23,5,19,21,971
47153,47153,A99656E991272E2D0207AAB7A175C1B5,11021,0,7,7,36,49,1849
47154,47154,A99656E991272E2D0207AAB7A175C1B5,40171,10,12,2,38,48,1948
47155,47155,A99656E991272E2D0207AAB7A175C1B5,42981,12,14,2,36,49,1849
47156,47156,A99656E991272E2D0207AAB7A175C1B5,42801,16,17,1,40,49,2049
47157,47157,A99656E991272E2D0207AAB7A175C1B5,42981,19,23,4,36,49,1849
47158,47158,6F6F174BF3BBBF4A283E7794B5A58265,42581,0,6,6,38,48,1948
47159,47159,6F6F174BF3BBBF4A283E7794B5A58265,11914,8,10,2,37,48,1898
47160,47160,6F6F174BF3BBBF4A283E7794B5A58265,12514,13,14,1,38,47,1947
47161,47161,6F6F174BF3BBBF4A283E7794B5A58265,11914,14,19,5,37,48,1898
47162,47162,6F6F174BF3BBBF4A283E7794B5A58265,42191,19,21,2,38,49,1949
47166,47166,3CDE88E41494ADADB515291429110B2E,43481,0,4,4,39,48,1998
47167,47167,3CDE88E41494ADADB515291429110B2E,12511,4,8,4,39,47,1997
47168,47168,3CDE88E41494ADADB515291429110B2E,11781,13,14,1,38,49,1949
47169,47169,3CDE88E41494ADADB515291429110B2E,12511,15,17,2,39,47,1997
47170,47170,3CDE88E41494ADADB515291429110B2E,42864,18,19,1,38,44,1944
47171,47171,54658564149AD4B046EBE6EA727EC5D8,42351,0,8,8,38,45,1945
47172,47172,54658564149AD4B046EBE6EA727EC5D8,11231,8,14,6,37,49,1899
47173,47173,54658564149AD4B046EBE6EA727EC5D8,10107,15,16,1,38,49,1949
47174,47174,54658564149AD4B046EBE6EA727EC5D8,10811,18,19,1,38,46,1946
47175,47175,54658564149AD4B046EBE6EA727EC5D8,42351,20,23,3,38,45,1945
47176,47176,A9FAA4B4C51A5D14416D1899F40B6E9A,19531,0,4,4,17,30,880
47177,47177,A9FAA4B4C51A5D14416D1899F40B6E9A,13481,8,14,6,26,31,1331
47178,47178,A9FAA4B4C51A5D14416D1899F40B6E9A,43081,16,18,2,27,28,1378
47179,47179,A9FAA4B4C51A5D14416D1899F40B6E9A,19801,18,19,1,19,26,976
47180,47180,A9FAA4B4C51A5D14416D1899F40B6E9A,13481,21,23,2,26,31,1331
47185,47185,41CAC9DF49C2630DDC9CCE4D449CEA81,11021,0,9,9,36,49,1849
47186,47186,41CAC9DF49C2630DDC9CCE4D449CEA81,11161,13,15,2,32,48,1648
47187,47187,41CAC9DF49C2630DDC9CCE4D449CEA81,13651,17,21,4,30,47,1547
47188,47188,3E2728364EE0F8914C7020C6A1917CB0,10251,0,7,7,35,47,1797
47189,47189,3E2728364EE0F8914C7020C6A1917CB0,12601,8,11,3,25,47,1297
47190,47190,3E2728364EE0F8914C7020C6A1917CB0,13511,14,20,6,34,48,1748
47191,47191,3E2728364EE0F8914C7020C6A1917CB0,40951,22,23,1,36,49,1849
47192,47192,BA444E3EED1E8BBD92378A028029977A,10921,0,14,14,43,48,2198
47193,47193,BA444E3EED1E8BBD92378A028029977A,10151,16,17,1,34,47,1747
47194,47194,BA444E3EED1E8BBD92378A028029977A,10921,17,23,6,43,48,2198
47199,47199,566A98F570A1628E8F6EFD9CFCC9370E,12491,2,8,6,36,43,1843
47200,47200,566A98F570A1628E8F6EFD9CFCC9370E,12661,8,14,6,32,45,1645
47201,47201,566A98F570A1628E8F6EFD9CFCC9370E,42381,15,17,2,39,41,1991
47202,47202,566A98F570A1628E8F6EFD9CFCC9370E,12661,18,23,5,32,45,1645
47203,47203,BC23CCB174B0C9B579BCB72E42FDA002,11381,0,17,17,30,47,1547
47204,47204,BC23CCB174B0C9B579BCB72E42FDA002,11751,18,19,1,35,48,1798
47205,47205,BC23CCB174B0C9B579BCB72E42FDA002,40951,20,21,1,36,49,1849
47206,47206,852A679DBA85E8EC93E7E59DB87D7BB9,10661,0,8,8,37,49,1899
47207,47207,852A679DBA85E8EC93E7E59DB87D7BB9,42471,9,11,2,35,49,1799
47208,47208,852A679DBA85E8EC93E7E59DB87D7BB9,10661,12,17,5,37,49,1899
47209,47209,852A679DBA85E8EC93E7E59DB87D7BB9,40341,20,22,2,23,49,1199
47210,47210,8B6448FD7DB9F8E2F8F73AFDDD5BFD38,43021,0,2,2,16,43,843
47211,47211,8B6448FD7DB9F8E2F8F73AFDDD5BFD38,19021,2,3,1,10,45,545
47212,47212,8B6448FD7DB9F8E2F8F73AFDDD5BFD38,12641,6,19,13,10,43,543
47213,47213,1A7FF5DB1B81FEDB0BCD61CF65662173,11921,0,6,6,38,48,1948
47214,47214,1A7FF5DB1B81FEDB0BCD61CF65662173,11074,6,7,1,37,47,1897
47215,47215,1A7FF5DB1B81FEDB0BCD61CF65662173,11914,8,9,1,37,48,1898
47216,47216,1A7FF5DB1B81FEDB0BCD61CF65662173,10221,12,13,1,34,49,1749
47217,47217,1A7FF5DB1B81FEDB0BCD61CF65662173,11841,18,20,2,33,46,1696
47218,47218,1A7FF5DB1B81FEDB0BCD61CF65662173,11381,21,22,1,30,47,1547
47232,47232,97EED02186157B67ACCA35C5CC13851D,10531,1,12,11,34,46,1746
47233,47233,97EED02186157B67ACCA35C5CC13851D,11231,12,14,2,37,49,1899
47234,47234,97EED02186157B67ACCA35C5CC13851D,43731,22,23,1,34,47,1747
47235,47235,26F16F4B4BD5DFFEDAD769BAA487660D,12083,0,1,1,36,49,1849
47236,47236,26F16F4B4BD5DFFEDAD769BAA487660D,10431,2,15,13,33,49,1699
47237,47237,26F16F4B4BD5DFFEDAD769BAA487660D,42021,18,19,1,33,47,1697
47238,47238,26F16F4B4BD5DFFEDAD769BAA487660D,11751,20,23,3,35,48,1798
47246,47246,CB6CE8B284764CB65EC4187E6FE5A3FF,43021,0,6,6,16,43,843
47247,47247,CB6CE8B284764CB65EC4187E6FE5A3FF,19021,9,12,3,10,45,545
47248,47248,CB6CE8B284764CB65EC4187E6FE5A3FF,11571,15,16,1,13,46,696
47249,47249,CB6CE8B284764CB65EC4187E6FE5A3FF,19021,16,21,5,10,45,545
47257,47257,47CD03C948687C96861434761EE3E932,10621,0,5,5,41,49,2099
47258,47258,47CD03C948687C96861434761EE3E932,19024,7,15,8,9,45,495
47259,47259,47CD03C948687C96861434761EE3E932,10621,18,23,5,41,49,2099
47260,47260,AB57CFBC7FBBD1B4F46C04046F726522,15171,0,4,4,42,21,2121
47261,47261,AB57CFBC7FBBD1B4F46C04046F726522,15021,6,10,4,46,18,2318
47262,47262,AB57CFBC7FBBD1B4F46C04046F726522,12881,12,13,1,47,22,2372
47263,47263,AB57CFBC7FBBD1B4F46C04046F726522,15021,14,17,3,46,18,2318
47264,47264,AB57CFBC7FBBD1B4F46C04046F726522,15171,21,23,2,42,21,2121
47265,47265,F3ADE38A6219C04719D8BAB38E16EC80,10811,0,8,8,38,46,1946
47266,47266,F3ADE38A6219C04719D8BAB38E16EC80,10251,8,10,2,35,47,1797
47267,47267,F3ADE38A6219C04719D8BAB38E16EC80,10621,11,14,3,41,49,2099
47268,47268,F3ADE38A6219C04719D8BAB38E16EC80,42471,19,22,3,35,49,1799
47269,47269,2DC192DC303083B8FEFB2CD2D1161047,42201,9,14,5,43,46,2196
47270,47270,2DC192DC303083B8FEFB2CD2D1161047,42523,15,16,1,31,47,1597
47271,47271,2DC192DC303083B8FEFB2CD2D1161047,42201,17,23,6,43,46,2196
47276,47276,9F589AB01E58B6B2CA9FB997F96CB7F3,13071,0,13,13,41,41,2091
47277,47277,9F589AB01E58B6B2CA9FB997F96CB7F3,43451,14,16,2,37,40,1890
47278,47278,9F589AB01E58B6B2CA9FB997F96CB7F3,13071,19,23,4,41,41,2091
47279,47279,65DC6D7E0D0711C631BBF21B13250F06,13101,0,9,9,40,47,2047
47280,47280,65DC6D7E0D0711C631BBF21B13250F06,40341,14,18,4,23,49,1199
47281,47281,65DC6D7E0D0711C631BBF21B13250F06,13101,21,23,2,40,47,2047
47282,47282,65D4345A2D3576315A5C944F8DDA0CFE,42864,0,5,5,38,44,1944
47283,47283,65D4345A2D3576315A5C944F8DDA0CFE,11261,8,9,1,36,46,1846
47284,47284,65D4345A2D3576315A5C944F8DDA0CFE,42864,11,13,2,38,44,1944
47285,47285,65D4345A2D3576315A5C944F8DDA0CFE,11261,13,19,6,36,46,1846
47286,47286,65D4345A2D3576315A5C944F8DDA0CFE,42864,20,23,3,38,44,1944
47287,47287,D19CCADD05AE7D38BD327DD3B3A1E602,42351,0,6,6,38,45,1945
47288,47288,D19CCADD05AE7D38BD327DD3B3A1E602,42231,8,10,2,37,46,1896
47289,47289,D19CCADD05AE7D38BD327DD3B3A1E602,42351,10,11,1,38,45,1945
47290,47290,D19CCADD05AE7D38BD327DD3B3A1E602,42231,14,15,1,37,46,1896
47291,47291,D19CCADD05AE7D38BD327DD3B3A1E602,42351,15,23,8,38,45,1945
47298,47298,39D31A0736E84EC278E2E1BEF3539CFA,42861,0,6,6,37,44,1894
47299,47299,39D31A0736E84EC278E2E1BEF3539CFA,11261,8,10,2,36,46,1846
47300,47300,39D31A0736E84EC278E2E1BEF3539CFA,42861,10,13,3,37,44,1894
47301,47301,39D31A0736E84EC278E2E1BEF3539CFA,11261,18,19,1,36,46,1846
47302,47302,39D31A0736E84EC278E2E1BEF3539CFA,42861,21,23,2,37,44,1894
47306,47306,DA463EC53133A1A19CECE2080B91DCC5,42221,0,5,5,38,48,1948
47307,47307,DA463EC53133A1A19CECE2080B91DCC5,12511,5,6,1,39,47,1997
47308,47308,DA463EC53133A1A19CECE2080B91DCC5,13601,10,16,6,34,47,1747
47309,47309,DA463EC53133A1A19CECE2080B91DCC5,12511,18,19,1,39,47,1997
47310,47310,50B64A0D66E0407A6F48E6696EB3B50E,13511,2,11,9,34,48,1748
47311,47311,50B64A0D66E0407A6F48E6696EB3B50E,42321,14,16,2,43,47,2197
47312,47312,50B64A0D66E0407A6F48E6696EB3B50E,11751,18,20,2,35,48,1798
47313,47313,DC67CBE246F1C7084622F521835B8559,11431,0,8,8,29,47,1497
47314,47314,DC67CBE246F1C7084622F521835B8559,10471,9,13,4,37,48,1898
47315,47315,DC67CBE246F1C7084622F521835B8559,11794,21,23,2,38,49,1949
47316,47316,A39BF7F02FF0E23830FC596E941B3C27,11541,0,7,7,35,49,1799
47317,47317,A39BF7F02FF0E23830FC596E941B3C27,10544,8,17,9,28,48,1448
47318,47318,A39BF7F02FF0E23830FC596E941B3C27,11201,19,20,1,35,49,1799
47319,47319,A39BF7F02FF0E23830FC596E941B3C27,11591,21,22,1,36,49,1849
47320,47320,F3B16B9F2FE5D66DD896BE8E61C1FA80,12311,0,5,5,30,44,1544
47321,47321,F3B16B9F2FE5D66DD896BE8E61C1FA80,10301,8,9,1,31,45,1595
47322,47322,F3B16B9F2FE5D66DD896BE8E61C1FA80,10351,13,15,2,28,45,1445
47323,47323,F3B16B9F2FE5D66DD896BE8E61C1FA80,10301,16,19,3,31,45,1595
47324,47324,F3B16B9F2FE5D66DD896BE8E61C1FA80,10351,22,23,1,28,45,1445
47325,47325,2C9F9127F2AECFBA8069624790D23C60,10471,0,14,14,37,48,1898
47326,47326,2C9F9127F2AECFBA8069624790D23C60,42531,16,18,2,31,45,1595
47327,47327,2C9F9127F2AECFBA8069624790D23C60,10471,19,23,4,37,48,1898
47332,47332,0C3159AA16F6DC6ADBB9AD6D902653D7,12121,2,12,10,29,47,1497
47333,47333,0C3159AA16F6DC6ADBB9AD6D902653D7,43281,12,16,4,37,48,1898
47334,47334,0C3159AA16F6DC6ADBB9AD6D902653D7,42641,19,20,1,33,49,1699
47335,47335,0C3159AA16F6DC6ADBB9AD6D902653D7,42161,21,22,1,36,47,1847
47339,47339,D5C98D28246C767D0FFD7F7274CFF193,13314,0,6,6,31,39,1589
47340,47340,D5C98D28246C767D0FFD7F7274CFF193,42151,7,9,2,35,45,1795
47341,47341,D5C98D28246C767D0FFD7F7274CFF193,13314,11,14,3,31,39,1589
47342,47342,D5C98D28246C767D0FFD7F7274CFF193,12491,14,17,3,36,43,1843
47343,47343,D5C98D28246C767D0FFD7F7274CFF193,13314,19,22,3,31,39,1589
47347,47347,F5B51F953CD3F7A1DB23953A4B9121A3,19281,7,8,1,16,32,832
47348,47348,F5B51F953CD3F7A1DB23953A4B9121A3,12871,9,16,7,22,33,1133
47349,47349,F5B51F953CD3F7A1DB23953A4B9121A3,19281,16,19,3,16,32,832
47350,47350,F5B51F953CD3F7A1DB23953A4B9121A3,12871,19,20,1,22,33,1133
47354,47354,12ADB141CA14BE5E4E819B1A4FBA459C,11941,0,8,8,37,46,1896
47355,47355,12ADB141CA14BE5E4E819B1A4FBA459C,11211,12,13,1,34,49,1749
47356,47356,12ADB141CA14BE5E4E819B1A4FBA459C,11941,17,23,6,37,46,1896
47357,47357,9CA777C26F090A99FBBCE57B69E10F32,11161,0,8,8,32,48,1648
47358,47358,9CA777C26F090A99FBBCE57B69E10F32,43761,11,12,1,32,47,1647
47359,47359,9CA777C26F090A99FBBCE57B69E10F32,11161,13,14,1,32,48,1648
47360,47360,9CA777C26F090A99FBBCE57B69E10F32,43761,15,17,2,32,47,1647
47361,47361,9CA777C26F090A99FBBCE57B69E10F32,11161,19,21,2,32,48,1648
47362,47362,BEF31F045A546CF30A63CFBCD60FD3FA,13911,0,1,1,39,46,1996
47363,47363,BEF31F045A546CF30A63CFBCD60FD3FA,43341,3,4,1,41,46,2096
47364,47364,BEF31F045A546CF30A63CFBCD60FD3FA,13911,6,15,9,39,46,1996
47365,47365,BEF31F045A546CF30A63CFBCD60FD3FA,42231,19,20,1,37,46,1896
47366,47366,BEF31F045A546CF30A63CFBCD60FD3FA,13911,20,22,2,39,46,1996
47367,47367,1AA169564F26346ABB6AD9BF731FCA16,43581,0,6,6,33,48,1698
47368,47368,1AA169564F26346ABB6AD9BF731FCA16,42941,9,18,9,37,47,1897
47369,47369,1AA169564F26346ABB6AD9BF731FCA16,12031,20,23,3,33,48,1698
47387,47387,1FF80D2D93D85E7E7CD7674A4424222F,43501,5,15,10,27,48,1398
47388,47388,1FF80D2D93D85E7E7CD7674A4424222F,10661,16,17,1,37,49,1899
47389,47389,1FF80D2D93D85E7E7CD7674A4424222F,12641,21,22,1,10,43,543
47397,47397,6467ABE12A2D20486940C38A8EB346F8,10411,0,7,7,36,48,1848
47398,47398,6467ABE12A2D20486940C38A8EB346F8,10401,11,12,1,33,49,1699
47399,47399,6467ABE12A2D20486940C38A8EB346F8,11291,13,14,1,40,49,2049
47400,47400,6467ABE12A2D20486940C38A8EB346F8,10411,16,23,7,36,48,1848
47404,47404,C14301D176E25088812F98971E3C8174,40093,0,12,12,31,48,1598
47405,47405,C14301D176E25088812F98971E3C8174,40951,15,17,2,36,49,1849
47406,47406,C14301D176E25088812F98971E3C8174,40093,17,19,2,31,48,1598
47407,47407,C0CA0E848CB7969D4CC610C37FAA41A6,43761,0,12,12,32,47,1647
47408,47408,C0CA0E848CB7969D4CC610C37FAA41A6,11794,14,16,2,38,49,1949
47409,47409,C0CA0E848CB7969D4CC610C37FAA41A6,43761,16,18,2,32,47,1647
47410,47410,C0CA0E848CB7969D4CC610C37FAA41A6,40341,18,20,2,23,49,1199
47415,47415,13E7A6F369190548695041BB510055CA,13791,0,6,6,42,47,2147
47416,47416,13E7A6F369190548695041BB510055CA,10041,8,11,3,39,49,1999
47417,47417,13E7A6F369190548695041BB510055CA,13791,12,14,2,42,47,2147
47418,47418,13E7A6F369190548695041BB510055CA,10231,15,16,1,39,49,1999
47419,47419,13E7A6F369190548695041BB510055CA,13941,20,21,1,41,47,2097
47423,47423,4F6A74BBD714EF065A4DB365EFF3390D,11271,0,7,7,37,48,1898
47424,47424,4F6A74BBD714EF065A4DB365EFF3390D,11291,8,15,7,40,49,2049
47425,47425,4F6A74BBD714EF065A4DB365EFF3390D,11271,16,17,1,37,48,1898
47426,47426,4F6A74BBD714EF065A4DB365EFF3390D,10231,17,20,3,39,49,1999
47427,47427,4F6A74BBD714EF065A4DB365EFF3390D,10411,22,23,1,36,48,1848
47428,47428,1206CD8A013308907070315A8285F2C6,42161,0,3,3,36,47,1847
47429,47429,1206CD8A013308907070315A8285F2C6,42941,8,9,1,37,47,1897
47430,47430,1206CD8A013308907070315A8285F2C6,42161,12,15,3,36,47,1847
47431,47431,1206CD8A013308907070315A8285F2C6,12161,17,18,1,32,46,1646
47432,47432,1206CD8A013308907070315A8285F2C6,12131,19,21,2,32,47,1647
47433,47433,1206CD8A013308907070315A8285F2C6,11491,22,23,1,36,47,1847
47437,47437,2D868D5BE3CEB8F6D73B9B7117AF4556,41591,1,15,14,34,49,1749
47438,47438,2D868D5BE3CEB8F6D73B9B7117AF4556,10251,16,18,2,35,47,1797
47439,47439,2D868D5BE3CEB8F6D73B9B7117AF4556,10191,18,19,1,40,48,2048
47440,47440,2D868D5BE3CEB8F6D73B9B7117AF4556,11541,20,23,3,35,49,1799
47441,47441,AC414DB8853E95A441FB40B4893530F7,10351,0,5,5,28,45,1445
47442,47442,AC414DB8853E95A441FB40B4893530F7,10711,8,9,1,29,46,1496
47443,47443,AC414DB8853E95A441FB40B4893530F7,10634,9,11,2,27,45,1395
47444,47444,AC414DB8853E95A441FB40B4893530F7,10711,15,16,1,29,46,1496
47445,47445,AC414DB8853E95A441FB40B4893530F7,10351,18,19,1,28,45,1445
47446,47446,AC414DB8853E95A441FB40B4893530F7,11871,20,21,1,29,46,1496
47447,47447,AC414DB8853E95A441FB40B4893530F7,10351,21,22,1,28,45,1445
47448,47448,5E1BBAE6A1AB78C09E8201C8FF351A4E,12514,0,6,6,38,47,1947
47449,47449,5E1BBAE6A1AB78C09E8201C8FF351A4E,10841,8,9,1,37,47,1897
47450,47450,5E1BBAE6A1AB78C09E8201C8FF351A4E,10731,12,15,3,33,47,1697
47451,47451,5E1BBAE6A1AB78C09E8201C8FF351A4E,12514,18,19,1,38,47,1947
47452,47452,AB1E27033ABBCFEAE4B83A799FB358FD,19744,0,5,5,6,43,343
47453,47453,AB1E27033ABBCFEAE4B83A799FB358FD,12311,6,16,10,30,44,1544
47454,47454,AB1E27033ABBCFEAE4B83A799FB358FD,19744,19,23,4,6,43,343
47455,47455,AD7F7BB46EF09C86333AC9999F5D1555,10271,0,13,13,37,46,1896
47456,47456,AD7F7BB46EF09C86333AC9999F5D1555,13121,13,14,1,38,46,1946
47457,47457,AD7F7BB46EF09C86333AC9999F5D1555,10271,16,19,3,37,46,1896
47458,47458,AD7F7BB46EF09C86333AC9999F5D1555,13121,20,21,1,38,46,1946
47459,47459,AD7F7BB46EF09C86333AC9999F5D1555,10271,22,23,1,37,46,1896
47460,47460,F276DA0C0E39AE3BAD5B91AE46CB6EA8,42971,0,7,7,43,49,2199
47461,47461,F276DA0C0E39AE3BAD5B91AE46CB6EA8,10471,10,12,2,37,48,1898
47462,47462,F276DA0C0E39AE3BAD5B91AE46CB6EA8,11231,12,19,7,37,49,1899
47463,47463,F276DA0C0E39AE3BAD5B91AE46CB6EA8,10471,19,21,2,37,48,1898
47464,47464,F276DA0C0E39AE3BAD5B91AE46CB6EA8,11231,22,23,1,37,49,1899
47468,47468,BBCB9918D42B41DEDF16DD7F5A9BE26F,11861,0,10,10,32,47,1647
47469,47469,BBCB9918D42B41DEDF16DD7F5A9BE26F,11331,11,17,6,37,48,1898
47470,47470,BBCB9918D42B41DEDF16DD7F5A9BE26F,11861,17,23,6,32,47,1647
47471,47471,04895415E76D1FFF866D6B8869FD01BC,40637,1,7,6,36,47,1847
47472,47472,04895415E76D1FFF866D6B8869FD01BC,10251,7,16,9,35,47,1797
47473,47473,04895415E76D1FFF866D6B8869FD01BC,42381,18,19,1,39,41,1991
47474,47474,04895415E76D1FFF866D6B8869FD01BC,40637,21,23,2,36,47,1847
47475,47475,7B2A043D515CB61698DD480E69194AE5,19621,0,6,6,5,46,296
47476,47476,7B2A043D515CB61698DD480E69194AE5,12921,10,17,7,9,41,491
47477,47477,7B2A043D515CB61698DD480E69194AE5,19031,18,19,1,1,42,92
47478,47478,95CCF589A9220F3D300E82C46D963125,13111,0,6,6,42,46,2146
47479,47479,95CCF589A9220F3D300E82C46D963125,42321,7,9,2,43,47,2197
47480,47480,95CCF589A9220F3D300E82C46D963125,13111,12,14,2,42,46,2146
47481,47481,95CCF589A9220F3D300E82C46D963125,10801,14,18,4,42,47,2147
47482,47482,95CCF589A9220F3D300E82C46D963125,13111,19,23,4,42,46,2146
47483,47483,29996ED69B9ED83DE66401B38685CA40,42071,0,1,1,31,49,1599
47484,47484,29996ED69B9ED83DE66401B38685CA40,42081,3,4,1,24,49,1249
47485,47485,29996ED69B9ED83DE66401B38685CA40,13731,21,22,1,33,49,1699
47486,47486,0F999234E8875DBB989D1F6CE06BB65C,10107,9,10,1,38,49,1949
47487,47487,0F999234E8875DBB989D1F6CE06BB65C,11381,11,12,1,30,47,1547
47488,47488,0F999234E8875DBB989D1F6CE06BB65C,42321,13,14,1,43,47,2197
47489,47489,0F999234E8875DBB989D1F6CE06BB65C,40341,16,21,5,23,49,1199
47490,47490,C7D7B8368ECFDD4E151B86392208FA63,12311,0,9,9,30,44,1544
47491,47491,C7D7B8368ECFDD4E151B86392208FA63,10161,11,12,1,35,49,1799
47492,47492,C7D7B8368ECFDD4E151B86392208FA63,12311,16,23,7,30,44,1544
47496,47496,6EB93CCAB2222C7D454DB87232E2BFCB,40341,4,5,1,23,49,1199
47497,47497,6EB93CCAB2222C7D454DB87232E2BFCB,42623,10,16,6,22,49,1149
47498,47498,6EB93CCAB2222C7D454DB87232E2BFCB,42071,20,21,1,31,49,1599
47499,47499,5B005239AD91B224060A740123F8C94E,13231,0,5,5,39,46,1996
47500,47500,5B005239AD91B224060A740123F8C94E,42231,9,10,1,37,46,1896
47501,47501,5B005239AD91B224060A740123F8C94E,13231,11,12,1,39,46,1996
47502,47502,5B005239AD91B224060A740123F8C94E,42231,12,20,8,37,46,1896
47503,47503,5B005239AD91B224060A740123F8C94E,13231,21,23,2,39,46,1996
47504,47504,F8E55215F750DCB5A7BB76D5AC42DE85,13511,1,2,1,34,48,1748
47505,47505,F8E55215F750DCB5A7BB76D5AC42DE85,43731,3,4,1,34,47,1747
47506,47506,F8E55215F750DCB5A7BB76D5AC42DE85,13511,6,7,1,34,48,1748
47507,47507,F8E55215F750DCB5A7BB76D5AC42DE85,43731,18,20,2,34,47,1747
47508,47508,F8E55215F750DCB5A7BB76D5AC42DE85,42921,21,22,1,33,47,1697
47513,47513,FA73CEEF86E3045F96788E3868F3C71A,10161,0,11,11,35,49,1799
47514,47514,FA73CEEF86E3045F96788E3868F3C71A,12141,12,13,1,42,45,2145
47515,47515,FA73CEEF86E3045F96788E3868F3C71A,10161,14,16,2,35,49,1799
47516,47516,FA73CEEF86E3045F96788E3868F3C71A,11331,16,19,3,37,48,1898
47517,47517,FA73CEEF86E3045F96788E3868F3C71A,10161,19,20,1,35,49,1799
47518,47518,FA73CEEF86E3045F96788E3868F3C71A,11331,20,21,1,37,48,1898
47519,47519,DDC302F1F99EDC922514CC6D6B327E3E,12561,0,7,7,45,43,2293
47520,47520,DDC302F1F99EDC922514CC6D6B327E3E,12971,8,10,2,32,48,1648
47521,47521,DDC302F1F99EDC922514CC6D6B327E3E,13951,11,14,3,47,45,2395
47522,47522,DDC302F1F99EDC922514CC6D6B327E3E,43051,16,22,6,46,45,2345
47529,47529,42900B423407C136B6BC879ABB23EA83,10431,0,10,10,33,49,1699
47530,47530,42900B423407C136B6BC879ABB23EA83,43041,12,17,5,41,46,2096
47531,47531,42900B423407C136B6BC879ABB23EA83,11701,19,22,3,43,48,2198
47532,47532,36C68D591F1BB1615F00290E59A07445,42041,0,5,5,10,47,547
47533,47533,36C68D591F1BB1615F00290E59A07445,19441,7,11,4,8,46,446
47534,47534,36C68D591F1BB1615F00290E59A07445,11101,16,18,2,18,48,948
47542,47542,D135A99298B694887A1E4018850E3A32,43051,2,6,4,46,45,2345
47543,47543,D135A99298B694887A1E4018850E3A32,11806,9,10,1,41,48,2098
47544,47544,D135A99298B694887A1E4018850E3A32,42271,15,18,3,40,47,2047
47545,47545,D135A99298B694887A1E4018850E3A32,11806,19,23,4,41,48,2098
47546,47546,CDF6ADDC899F34326492126BCC50D6B8,11361,3,11,8,22,48,1148
47547,47547,CDF6ADDC899F34326492126BCC50D6B8,12601,11,13,2,25,47,1297
47548,47548,CDF6ADDC899F34326492126BCC50D6B8,10171,16,20,4,26,47,1347
47549,47549,15351107348D533F1A62174A9ED24724,13314,0,6,6,31,39,1589
47550,47550,15351107348D533F1A62174A9ED24724,12521,7,13,6,35,41,1791
47551,47551,15351107348D533F1A62174A9ED24724,13314,18,23,5,31,39,1589
47555,47555,68A24D68E1EE6F85D7484BA18462FF82,12971,1,11,10,32,48,1648
47556,47556,68A24D68E1EE6F85D7484BA18462FF82,42091,15,17,2,43,46,2196
47557,47557,68A24D68E1EE6F85D7484BA18462FF82,42523,19,20,1,31,47,1597
47558,47558,1C4D9C3B4ACCE12D2B04BB20561492BF,42581,1,2,1,38,48,1948
47559,47559,1C4D9C3B4ACCE12D2B04BB20561492BF,13101,3,6,3,40,47,2047
47560,47560,1C4D9C3B4ACCE12D2B04BB20561492BF,13271,10,16,6,41,47,2097
47561,47561,1C4D9C3B4ACCE12D2B04BB20561492BF,13101,17,21,4,40,47,2047
47562,47562,1C4D9C3B4ACCE12D2B04BB20561492BF,13271,22,23,1,41,47,2097
47563,47563,182A42BB7961D14AD940FD065D4EDF33,13121,0,2,2,38,46,1946
47564,47564,182A42BB7961D14AD940FD065D4EDF33,10271,3,4,1,37,46,1896
47565,47565,182A42BB7961D14AD940FD065D4EDF33,13121,5,6,1,38,46,1946
47566,47566,182A42BB7961D14AD940FD065D4EDF33,11941,9,10,1,37,46,1896
47567,47567,182A42BB7961D14AD940FD065D4EDF33,13121,19,21,2,38,46,1946
47568,47568,182A42BB7961D14AD940FD065D4EDF33,11231,21,23,2,37,49,1899
47579,47579,B883C459BDD14F868DF1C5D6903BABA2,10191,0,2,2,40,48,2048
47580,47580,B883C459BDD14F868DF1C5D6903BABA2,10931,3,6,3,41,48,2098
47581,47581,B883C459BDD14F868DF1C5D6903BABA2,10191,7,8,1,40,48,2048
47582,47582,B883C459BDD14F868DF1C5D6903BABA2,10281,10,13,3,33,48,1698
47583,47583,B883C459BDD14F868DF1C5D6903BABA2,11061,14,16,2,29,48,1498
47584,47584,B883C459BDD14F868DF1C5D6903BABA2,11151,17,19,2,30,48,1548
47585,47585,F1C03493C93CA25BBABF2DBA1FB3A09C,11571,1,6,5,13,46,696
47586,47586,F1C03493C93CA25BBABF2DBA1FB3A09C,19621,8,10,2,5,46,296
47587,47587,F1C03493C93CA25BBABF2DBA1FB3A09C,19441,10,20,10,8,46,446
47588,47588,F1C03493C93CA25BBABF2DBA1FB3A09C,11571,21,23,2,13,46,696
47589,47589,73BB02B492444F6C22DA7784C4E36BAE,19741,0,4,4,5,44,294
47590,47590,73BB02B492444F6C22DA7784C4E36BAE,12921,5,8,3,9,41,491
47591,47591,73BB02B492444F6C22DA7784C4E36BAE,19741,10,23,13,5,44,294
47592,47592,3D43206B2F8CBCFEA36F31149307E300,12381,0,5,5,32,48,1648
47593,47593,3D43206B2F8CBCFEA36F31149307E300,43311,6,9,3,31,48,1598
47594,47594,3D43206B2F8CBCFEA36F31149307E300,10681,10,14,4,30,48,1548
47595,47595,3D43206B2F8CBCFEA36F31149307E300,13941,16,18,2,41,47,2097
47604,47604,104C7B4B7606A62E54D0F0C8A8FC6416,10295,0,9,9,30,47,1547
47605,47605,104C7B4B7606A62E54D0F0C8A8FC6416,10107,10,14,4,38,49,1949
47606,47606,104C7B4B7606A62E54D0F0C8A8FC6416,10292,21,23,2,30,47,1547
47613,47613,1D2C42504060298C354A97579B2F0A92,13411,2,4,2,49,42,2492
47614,47614,1D2C42504060298C354A97579B2F0A92,13951,8,18,10,47,45,2395
47615,47615,1D2C42504060298C354A97579B2F0A92,43951,20,21,1,49,41,2491
47620,47620,27FD8A6CDE751A5F2BC12F75826C7985,43021,0,6,6,16,43,843
47621,47621,27FD8A6CDE751A5F2BC12F75826C7985,12921,6,8,2,9,41,491
47622,47622,27FD8A6CDE751A5F2BC12F75826C7985,43021,11,13,2,16,43,843
47623,47623,27FD8A6CDE751A5F2BC12F75826C7985,19181,14,16,2,8,40,440
47624,47624,27FD8A6CDE751A5F2BC12F75826C7985,12921,19,23,4,9,41,491
47628,47628,362CF58B32D978DCF17B65B310F5E090,15661,0,1,1,36,26,1826
47629,47629,362CF58B32D978DCF17B65B310F5E090,15671,1,7,6,37,26,1876
47630,47630,362CF58B32D978DCF17B65B310F5E090,11781,9,11,2,38,49,1949
47631,47631,362CF58B32D978DCF17B65B310F5E090,15061,20,23,3,41,25,2075
47632,47632,346BF3F539A4C5C04EF0491F7207CF76,19114,0,3,3,7,43,393
47633,47633,346BF3F539A4C5C04EF0491F7207CF76,12641,6,10,4,10,43,543
47634,47634,346BF3F539A4C5C04EF0491F7207CF76,43021,12,14,2,16,43,843
47635,47635,346BF3F539A4C5C04EF0491F7207CF76,12641,18,19,1,10,43,543
47636,47636,346BF3F539A4C5C04EF0491F7207CF76,19931,20,23,3,7,43,393
47640,47640,23473E2E03D0A65C4003DD5C7AD8CFFA,43361,3,9,6,38,48,1948
47641,47641,23473E2E03D0A65C4003DD5C7AD8CFFA,42371,12,14,2,34,46,1746
47642,47642,23473E2E03D0A65C4003DD5C7AD8CFFA,10511,18,23,5,35,46,1796
47643,47643,0D04AEE5D0D9747786113FB147421EF2,12921,0,6,6,9,41,491
47644,47644,0D04AEE5D0D9747786113FB147421EF2,43724,11,13,2,35,33,1783
47645,47645,0D04AEE5D0D9747786113FB147421EF2,12921,17,19,2,9,41,491
47646,47646,0D04AEE5D0D9747786113FB147421EF2,12641,19,21,2,10,43,543
47653,47653,3BC1FEC85921C44B1F7DC483EC4194E1,43061,0,5,5,43,46,2196
47654,47654,3BC1FEC85921C44B1F7DC483EC4194E1,42461,5,14,9,45,47,2297
47655,47655,3BC1FEC85921C44B1F7DC483EC4194E1,42511,18,19,1,37,47,1897
47656,47656,3BC1FEC85921C44B1F7DC483EC4194E1,43061,20,23,3,43,46,2196
47657,47657,CDB8954535B1E24855DD1CA6D51F5A16,11321,0,7,7,31,46,1596
47658,47658,CDB8954535B1E24855DD1CA6D51F5A16,42021,11,12,1,33,47,1697
47659,47659,CDB8954535B1E24855DD1CA6D51F5A16,15411,16,18,2,44,27,2227
47660,47660,CDB8954535B1E24855DD1CA6D51F5A16,11321,21,23,2,31,46,1596
47665,47665,49237ECED003BFEF5E21C688FECB20EC,19061,0,17,17,3,43,193
47666,47666,49237ECED003BFEF5E21C688FECB20EC,11061,17,19,2,29,48,1498
47667,47667,49237ECED003BFEF5E21C688FECB20EC,11151,21,23,2,30,48,1548
47671,47671,FCE20E2B8F81E094609EF23CE6476C3B,12971,0,1,1,32,48,1648
47672,47672,FCE20E2B8F81E094609EF23CE6476C3B,43761,4,10,6,32,47,1647
47673,47673,FCE20E2B8F81E094609EF23CE6476C3B,42521,11,12,1,31,47,1597
47674,47674,FCE20E2B8F81E094609EF23CE6476C3B,11061,17,18,1,29,48,1498
47675,47675,FCE20E2B8F81E094609EF23CE6476C3B,12601,19,20,1,25,47,1297
47676,47676,FCE20E2B8F81E094609EF23CE6476C3B,11201,21,23,2,35,49,1799
47677,47677,E9E9C9DE1050FFAD63256F714329F12B,42201,0,15,15,43,46,2196
47678,47678,E9E9C9DE1050FFAD63256F714329F12B,13951,18,19,1,47,45,2395
47679,47679,E9E9C9DE1050FFAD63256F714329F12B,42201,19,23,4,43,46,2196
47683,47683,CDD868B7CD2EE63A11365508386D7821,42371,0,6,6,34,46,1746
47684,47684,CDD868B7CD2EE63A11365508386D7821,11061,8,9,1,29,48,1498
47685,47685,CDD868B7CD2EE63A11365508386D7821,42371,12,14,2,34,46,1746
47686,47686,CDD868B7CD2EE63A11365508386D7821,11861,16,19,3,32,47,1647
47691,47691,5540EC4B9A79A2803AEA3D2399D9018F,11261,1,6,5,36,46,1846
47692,47692,5540EC4B9A79A2803AEA3D2399D9018F,13461,8,9,1,39,44,1994
47693,47693,5540EC4B9A79A2803AEA3D2399D9018F,11261,11,19,8,36,46,1846
47698,47698,345D4029BCC33DBFE6D7841DB885E7B2,42491,0,7,7,32,46,1646
47699,47699,345D4029BCC33DBFE6D7841DB885E7B2,11741,8,11,3,42,49,2149
47700,47700,345D4029BCC33DBFE6D7841DB885E7B2,42961,12,14,2,35,49,1799
47701,47701,345D4029BCC33DBFE6D7841DB885E7B2,11301,15,16,1,41,49,2099
47702,47702,345D4029BCC33DBFE6D7841DB885E7B2,10951,21,23,2,29,48,1498
47706,47706,0FC8E17E72D3C375F9E9191DBEAFEBE8,11731,0,9,9,36,48,1848
47707,47707,0FC8E17E72D3C375F9E9191DBEAFEBE8,10681,13,14,1,30,48,1548
47708,47708,0FC8E17E72D3C375F9E9191DBEAFEBE8,11751,14,16,2,35,48,1798
47709,47709,0FC8E17E72D3C375F9E9191DBEAFEBE8,40951,17,19,2,36,49,1849
47710,47710,0FC8E17E72D3C375F9E9191DBEAFEBE8,11731,21,23,2,36,48,1848
47714,47714,A3A77D2599A2BF9F99F7B68059141180,12211,0,1,1,41,44,2094
47715,47715,A3A77D2599A2BF9F99F7B68059141180,12561,1,7,6,45,43,2293
47716,47716,A3A77D2599A2BF9F99F7B68059141180,12221,7,23,16,43,44,2194
47724,47724,38EAD9C71E0631172BE43F523D61F0B8,42971,1,6,5,43,49,2199
47725,47725,38EAD9C71E0631172BE43F523D61F0B8,11381,8,9,1,30,47,1547
47726,47726,38EAD9C71E0631172BE43F523D61F0B8,42971,12,14,2,43,49,2199
47727,47727,38EAD9C71E0631172BE43F523D61F0B8,42521,14,15,1,31,47,1597
47728,47728,38EAD9C71E0631172BE43F523D61F0B8,11381,17,18,1,30,47,1547
47729,47729,38EAD9C71E0631172BE43F523D61F0B8,42971,20,23,3,43,49,2199
47734,47734,2417DDB60A9909CB5199D91F850EB8C6,42031,0,9,9,40,46,2046
47735,47735,2417DDB60A9909CB5199D91F850EB8C6,40341,10,13,3,23,49,1199
47736,47736,2417DDB60A9909CB5199D91F850EB8C6,42031,14,18,4,40,46,2046
47737,47737,2417DDB60A9909CB5199D91F850EB8C6,10381,21,23,2,31,49,1599
47741,47741,A3D004010CFF0F87B360B764CC2F3D8A,10634,4,6,2,27,45,1395
47742,47742,A3D004010CFF0F87B360B764CC2F3D8A,10351,7,10,3,28,45,1445
47743,47743,A3D004010CFF0F87B360B764CC2F3D8A,13651,15,23,8,30,47,1547
47751,47751,EDAA922713654FF36B4E3A7C199ADC11,19111,0,1,1,9,45,495
47752,47752,EDAA922713654FF36B4E3A7C199ADC11,19114,1,6,5,7,43,393
47753,47753,EDAA922713654FF36B4E3A7C199ADC11,12921,8,9,1,9,41,491
47754,47754,EDAA922713654FF36B4E3A7C199ADC11,19111,9,12,3,9,45,495
47755,47755,EDAA922713654FF36B4E3A7C199ADC11,19021,13,14,1,10,45,545
47756,47756,EDAA922713654FF36B4E3A7C199ADC11,19111,15,21,6,9,45,495
47757,47757,35217EACD99DFE586FDD79C48317E8FE,13314,0,4,4,31,39,1589
47758,47758,35217EACD99DFE586FDD79C48317E8FE,12521,4,13,9,35,41,1791
47759,47759,35217EACD99DFE586FDD79C48317E8FE,13314,13,23,10,31,39,1589
47760,47760,31E3C6E91E6520C2C5D7BFDA47CC8641,11061,0,1,1,29,48,1498
47761,47761,31E3C6E91E6520C2C5D7BFDA47CC8641,11381,2,9,7,30,47,1547
47762,47762,31E3C6E91E6520C2C5D7BFDA47CC8641,11061,12,14,2,29,48,1498
47763,47763,31E3C6E91E6520C2C5D7BFDA47CC8641,11381,16,17,1,30,47,1547
47764,47764,31E3C6E91E6520C2C5D7BFDA47CC8641,11061,22,23,1,29,48,1498
47765,47765,93DD2C863C5AA53C83002ED6F1D5AEBB,19031,0,13,13,1,42,92
47766,47766,93DD2C863C5AA53C83002ED6F1D5AEBB,19181,16,17,1,8,40,440
47767,47767,93DD2C863C5AA53C83002ED6F1D5AEBB,49201,20,22,2,7,41,391
47768,47768,5F14E1A15EFA1C13F8B10CBC543F107C,11271,0,1,1,37,48,1898
47769,47769,5F14E1A15EFA1C13F8B10CBC543F107C,10931,1,8,7,41,48,2098
47770,47770,5F14E1A15EFA1C13F8B10CBC543F107C,42981,8,10,2,36,49,1849
47771,47771,5F14E1A15EFA1C13F8B10CBC543F107C,11541,11,14,3,35,49,1799
47772,47772,5F14E1A15EFA1C13F8B10CBC543F107C,11331,14,17,3,37,48,1898
47773,47773,5F14E1A15EFA1C13F8B10CBC543F107C,12581,20,21,1,24,48,1248
47774,47774,007883C4896DAF2F56308DBC4E144D6F,40034,0,10,10,32,48,1648
47775,47775,007883C4896DAF2F56308DBC4E144D6F,42381,11,12,1,39,41,1991
47776,47776,007883C4896DAF2F56308DBC4E144D6F,10411,17,18,1,36,48,1848
47777,47777,007883C4896DAF2F56308DBC4E144D6F,40034,19,21,2,32,48,1648
47782,47782,BBA244405FCBF580331CF1C7DC28986A,13671,0,1,1,27,43,1393
47783,47783,BBA244405FCBF580331CF1C7DC28986A,12521,3,6,3,35,41,1791
47784,47784,BBA244405FCBF580331CF1C7DC28986A,13671,9,11,2,27,43,1393
47785,47785,BBA244405FCBF580331CF1C7DC28986A,13314,12,13,1,31,39,1589
47786,47786,BBA244405FCBF580331CF1C7DC28986A,12601,15,16,1,25,47,1297
47787,47787,BBA244405FCBF580331CF1C7DC28986A,13671,20,23,3,27,43,1393
47791,47791,C8236143E8B93D5FDE499177CF2B28F7,11381,0,5,5,30,47,1547
47792,47792,C8236143E8B93D5FDE499177CF2B28F7,42301,7,8,1,36,47,1847
47793,47793,C8236143E8B93D5FDE499177CF2B28F7,42861,12,14,2,37,44,1894
47794,47794,C8236143E8B93D5FDE499177CF2B28F7,11261,15,17,2,36,46,1846
47795,47795,C8236143E8B93D5FDE499177CF2B28F7,11381,19,23,4,30,47,1547
47800,47800,0ABF15EDFCAA333ABA775777DB9BDACA,42031,9,11,2,40,46,2046
47801,47801,0ABF15EDFCAA333ABA775777DB9BDACA,42121,18,20,2,26,49,1349
47802,47802,0ABF15EDFCAA333ABA775777DB9BDACA,10121,21,23,2,36,49,1849
47803,47803,414AA00EC00DAA3D830C87A4F3E4DD09,13601,0,1,1,34,47,1747
47804,47804,414AA00EC00DAA3D830C87A4F3E4DD09,11861,2,9,7,32,47,1647
47805,47805,414AA00EC00DAA3D830C87A4F3E4DD09,12391,9,11,2,36,49,1849
47806,47806,414AA00EC00DAA3D830C87A4F3E4DD09,11231,14,16,2,37,49,1899
47807,47807,414AA00EC00DAA3D830C87A4F3E4DD09,10731,18,19,1,33,47,1697
47808,47808,414AA00EC00DAA3D830C87A4F3E4DD09,11861,21,22,1,32,47,1647
47816,47816,5ADA9660158083BA681D3EABE7C6BBBF,42864,1,3,2,38,44,1944
47817,47817,5ADA9660158083BA681D3EABE7C6BBBF,42861,5,10,5,37,44,1894
47818,47818,5ADA9660158083BA681D3EABE7C6BBBF,42864,11,13,2,38,44,1944
47819,47819,5ADA9660158083BA681D3EABE7C6BBBF,11261,13,18,5,36,46,1846
47820,47820,5ADA9660158083BA681D3EABE7C6BBBF,42864,18,20,2,38,44,1944
47821,47821,5ADA9660158083BA681D3EABE7C6BBBF,11261,20,21,1,36,46,1846
47822,47822,5ADA9660158083BA681D3EABE7C6BBBF,42864,22,23,1,38,44,1944
47823,47823,EC6418CB8A4E98C7CABE129D8207DF2D,42231,0,10,10,37,46,1896
47824,47824,EC6418CB8A4E98C7CABE129D8207DF2D,11201,11,13,2,35,49,1799
47825,47825,EC6418CB8A4E98C7CABE129D8207DF2D,43041,14,17,3,41,46,2096
47826,47826,EC6418CB8A4E98C7CABE129D8207DF2D,11861,18,22,4,32,47,1647
47827,47827,0A501EA010779C8F9EB8C2F8834C3F4F,10301,4,6,2,31,45,1595
47828,47828,0A501EA010779C8F9EB8C2F8834C3F4F,10351,6,8,2,28,45,1445
47829,47829,0A501EA010779C8F9EB8C2F8834C3F4F,10301,9,11,2,31,45,1595
47830,47830,0A501EA010779C8F9EB8C2F8834C3F4F,10351,11,13,2,28,45,1445
47831,47831,0A501EA010779C8F9EB8C2F8834C3F4F,10301,14,20,6,31,45,1595
47832,47832,0A501EA010779C8F9EB8C2F8834C3F4F,10351,21,23,2,28,45,1445
47836,47836,2E6ECF3A2D9F0F99E9DEBA2062D89A0D,10351,0,3,3,28,45,1445
47837,47837,2E6ECF3A2D9F0F99E9DEBA2062D89A0D,10634,4,8,4,27,45,1395
47838,47838,2E6ECF3A2D9F0F99E9DEBA2062D89A0D,10351,11,15,4,28,45,1445
47839,47839,2E6ECF3A2D9F0F99E9DEBA2062D89A0D,12601,19,21,2,25,47,1297
47840,47840,2E6ECF3A2D9F0F99E9DEBA2062D89A0D,13771,21,23,2,21,45,1095
47841,47841,FADBD24FB94D9388BE2E59D5F595D57D,42161,0,7,7,36,47,1847
47842,47842,FADBD24FB94D9388BE2E59D5F595D57D,42461,10,11,1,45,47,2297
47843,47843,FADBD24FB94D9388BE2E59D5F595D57D,11491,15,17,2,36,47,1847
47844,47844,FADBD24FB94D9388BE2E59D5F595D57D,42201,17,18,1,43,46,2196
47845,47845,FADBD24FB94D9388BE2E59D5F595D57D,11481,19,20,1,41,48,2098
47846,47846,AF5A01CC6810A302A5F3ABA8915E6058,43011,0,13,13,40,42,2042
47847,47847,AF5A01CC6810A302A5F3ABA8915E6058,40341,16,18,2,23,49,1199
47848,47848,AF5A01CC6810A302A5F3ABA8915E6058,43011,20,23,3,40,42,2042
47849,47849,A26526FCE25758DA240C3B314B205E8A,19024,0,6,6,9,45,495
47850,47850,A26526FCE25758DA240C3B314B205E8A,19114,9,12,3,7,43,393
47851,47851,A26526FCE25758DA240C3B314B205E8A,12641,15,16,1,10,43,543
47852,47852,A26526FCE25758DA240C3B314B205E8A,19021,16,18,2,10,45,545
47853,47853,A26526FCE25758DA240C3B314B205E8A,19024,19,23,4,9,45,495
47857,47857,F38AB0098BE65E711BE711E13E868DCB,13561,0,7,7,37,49,1899
47858,47858,F38AB0098BE65E711BE711E13E868DCB,12661,11,16,5,32,45,1645
47859,47859,F38AB0098BE65E711BE711E13E868DCB,13561,18,19,1,37,49,1899
47860,47860,F38AB0098BE65E711BE711E13E868DCB,10221,20,21,1,34,49,1749
47868,47868,8E7E1D3BA1392AF853A6068E181E9940,12971,0,14,14,32,48,1648
47869,47869,8E7E1D3BA1392AF853A6068E181E9940,10251,14,15,1,35,47,1797
47870,47870,8E7E1D3BA1392AF853A6068E181E9940,10107,16,18,2,38,49,1949
47871,47871,8E7E1D3BA1392AF853A6068E181E9940,12971,18,20,2,32,48,1648
47872,47872,8E7E1D3BA1392AF853A6068E181E9940,10191,21,23,2,40,48,2048
47877,47877,D5A1F589AD5A8A456E0D23A90489837D,43761,2,5,3,32,47,1647
47878,47878,D5A1F589AD5A8A456E0D23A90489837D,11231,8,18,10,37,49,1899
47879,47879,D5A1F589AD5A8A456E0D23A90489837D,43761,19,22,3,32,47,1647
47889,47889,0D9AA89290D1F445356B85B4B256A343,11001,0,4,4,42,47,2147
47890,47890,0D9AA89290D1F445356B85B4B256A343,13941,6,7,1,41,47,2097
47891,47891,0D9AA89290D1F445356B85B4B256A343,42201,10,11,1,43,46,2196
47892,47892,0D9AA89290D1F445356B85B4B256A343,11001,12,13,1,42,47,2147
47893,47893,0D9AA89290D1F445356B85B4B256A343,42031,14,15,1,40,46,2046
47894,47894,0D9AA89290D1F445356B85B4B256A343,13941,17,18,1,41,47,2097
47895,47895,2158D922C46E0A92417041C9C40770E9,42091,0,8,8,43,46,2196
47896,47896,2158D922C46E0A92417041C9C40770E9,40463,12,14,2,38,49,1949
47897,47897,2158D922C46E0A92417041C9C40770E9,42091,15,16,1,43,46,2196
47898,47898,2158D922C46E0A92417041C9C40770E9,11781,16,18,2,38,49,1949
47902,47902,BA91B9470249EAFC3720D0B9152253D7,42501,0,7,7,28,47,1447
47903,47903,BA91B9470249EAFC3720D0B9152253D7,11781,10,12,2,38,49,1949
47904,47904,BA91B9470249EAFC3720D0B9152253D7,10191,13,14,1,40,48,2048
47905,47905,BA91B9470249EAFC3720D0B9152253D7,42501,16,19,3,28,47,1447
47906,47906,BA91B9470249EAFC3720D0B9152253D7,11381,19,21,2,30,47,1547
47916,47916,59034BC39B9C86A66266244E495D2830,42151,0,6,6,35,45,1795
47917,47917,59034BC39B9C86A66266244E495D2830,12311,9,11,2,30,44,1544
47918,47918,59034BC39B9C86A66266244E495D2830,42151,13,22,9,35,45,1795
47919,47919,883DFAEC3F162850CD6BAEF4493650A8,10731,0,8,8,33,47,1697
47920,47920,883DFAEC3F162850CD6BAEF4493650A8,10107,13,14,1,38,49,1949
47921,47921,883DFAEC3F162850CD6BAEF4493650A8,10731,15,18,3,33,47,1697
47922,47922,4ACCCEC0D28A845226D041C7B092D890,40302,0,8,8,40,49,2049
47923,47923,4ACCCEC0D28A845226D041C7B092D890,11301,9,10,1,41,49,2099
47924,47924,4ACCCEC0D28A845226D041C7B092D890,40302,10,12,2,40,49,2049
47925,47925,4ACCCEC0D28A845226D041C7B092D890,42623,14,23,9,22,49,1149
47935,47935,19956B718F2ADC42549D30EDFE2FF042,10681,0,8,8,30,48,1548
47936,47936,19956B718F2ADC42549D30EDFE2FF042,40341,12,13,1,23,49,1199
47937,47937,19956B718F2ADC42549D30EDFE2FF042,10681,15,20,5,30,48,1548
47938,47938,15BA009B68D87958E0A9656ADB01E7D6,42371,0,1,1,34,46,1746
47939,47939,15BA009B68D87958E0A9656ADB01E7D6,10511,5,6,1,35,46,1796
47940,47940,15BA009B68D87958E0A9656ADB01E7D6,42371,6,13,7,34,46,1746
47941,47941,15BA009B68D87958E0A9656ADB01E7D6,10221,14,15,1,34,49,1749
47942,47942,15BA009B68D87958E0A9656ADB01E7D6,10531,17,18,1,34,46,1746
47943,47943,15BA009B68D87958E0A9656ADB01E7D6,43001,20,22,2,47,47,2397
47944,47944,FCA1EAEE7E44DEF112E09E949BE6A553,19801,0,1,1,19,26,976
47945,47945,FCA1EAEE7E44DEF112E09E949BE6A553,43081,4,6,2,27,28,1378
47946,47946,FCA1EAEE7E44DEF112E09E949BE6A553,13481,7,10,3,26,31,1331
47947,47947,FCA1EAEE7E44DEF112E09E949BE6A553,19801,12,18,6,19,26,976
47951,47951,E35CDBB00D3E79B32B1FCC49D04F4A1C,42321,0,11,11,43,47,2197
47952,47952,E35CDBB00D3E79B32B1FCC49D04F4A1C,13951,13,14,1,47,45,2395
47953,47953,E35CDBB00D3E79B32B1FCC49D04F4A1C,42321,17,18,1,43,47,2197
47954,47954,E35CDBB00D3E79B32B1FCC49D04F4A1C,42091,19,20,1,43,46,2196
47955,47955,E35CDBB00D3E79B32B1FCC49D04F4A1C,42321,22,23,1,43,47,2197
47956,47956,724E5EE97D6AFFB2D12972B04CAB97D7,11021,0,9,9,36,49,1849
47957,47957,724E5EE97D6AFFB2D12972B04CAB97D7,11481,12,13,1,41,48,2098
47958,47958,724E5EE97D6AFFB2D12972B04CAB97D7,11021,14,19,5,36,49,1849
47965,47965,D429059E8DAFE4585A03A4BAC5119A7D,42271,0,7,7,40,47,2047
47966,47966,D429059E8DAFE4585A03A4BAC5119A7D,42381,8,9,1,39,41,1991
47967,47967,D429059E8DAFE4585A03A4BAC5119A7D,11806,11,12,1,41,48,2098
47968,47968,D429059E8DAFE4585A03A4BAC5119A7D,42271,13,23,10,40,47,2047
47972,47972,96B100113D40E22B39686C026F5DA397,43451,9,10,1,37,40,1890
47973,47973,96B100113D40E22B39686C026F5DA397,11261,11,12,1,36,46,1846
47974,47974,96B100113D40E22B39686C026F5DA397,13231,13,14,1,39,46,1996
47975,47975,96B100113D40E22B39686C026F5DA397,11261,14,20,6,36,46,1846
47980,47980,359B9EE25E5F4F6D8F1DEACDAFD76D8C,19441,0,6,6,8,46,446
47981,47981,359B9EE25E5F4F6D8F1DEACDAFD76D8C,19901,9,10,1,7,44,394
47982,47982,359B9EE25E5F4F6D8F1DEACDAFD76D8C,10491,14,16,2,33,48,1698
47983,47983,359B9EE25E5F4F6D8F1DEACDAFD76D8C,19621,17,19,2,5,46,296
47984,47984,359B9EE25E5F4F6D8F1DEACDAFD76D8C,42041,21,22,1,10,47,547
47985,47985,12DEA1DA3771036BD63E685161069ABA,11021,0,8,8,36,49,1849
47986,47986,12DEA1DA3771036BD63E685161069ABA,40341,8,9,1,23,49,1199
47987,47987,12DEA1DA3771036BD63E685161069ABA,11021,12,16,4,36,49,1849
47988,47988,12DEA1DA3771036BD63E685161069ABA,40341,17,21,4,23,49,1199
47995,47995,6C0E943C8B3CE3071E466B3888DE833C,12311,6,11,5,30,44,1544
47996,47996,6C0E943C8B3CE3071E466B3888DE833C,42531,13,16,3,31,45,1595
47997,47997,6C0E943C8B3CE3071E466B3888DE833C,12311,16,18,2,30,44,1544
47998,47998,6C0E943C8B3CE3071E466B3888DE833C,19744,20,21,1,6,43,343
47999,47999,B8DCAC0FC6FA981D871032E55C240C8E,11914,2,11,9,37,48,1898
48000,48000,B8DCAC0FC6FA981D871032E55C240C8E,42581,11,13,2,38,48,1948
48001,48001,B8DCAC0FC6FA981D871032E55C240C8E,11914,13,15,2,37,48,1898
48002,48002,B8DCAC0FC6FA981D871032E55C240C8E,42581,15,16,1,38,48,1948
48003,48003,B8DCAC0FC6FA981D871032E55C240C8E,11914,16,22,6,37,48,1898
48004,48004,AA2539D9B54CFE4AD7D4B893AF5D182C,42401,0,10,10,36,47,1847
48005,48005,AA2539D9B54CFE4AD7D4B893AF5D182C,43341,18,20,2,41,46,2096
48006,48006,AA2539D9B54CFE4AD7D4B893AF5D182C,42301,20,23,3,36,47,1847
48007,48007,D1E639022E7218C1A13796203903D6B3,10221,0,10,10,34,49,1749
48008,48008,D1E639022E7218C1A13796203903D6B3,40343,12,13,1,24,49,1249
48009,48009,D1E639022E7218C1A13796203903D6B3,10221,15,23,8,34,49,1749
48010,48010,6B301C33659FC7DDF1FEBEFD22E1FEA8,42931,0,11,11,41,49,2099
48011,48011,6B301C33659FC7DDF1FEBEFD22E1FEA8,43761,11,14,3,32,47,1647
48012,48012,6B301C33659FC7DDF1FEBEFD22E1FEA8,42021,15,16,1,33,47,1697
48013,48013,6B301C33659FC7DDF1FEBEFD22E1FEA8,10107,18,19,1,38,49,1949
48014,48014,6B301C33659FC7DDF1FEBEFD22E1FEA8,43761,20,22,2,32,47,1647
48015,48015,CB9FC3FE9195AF3F0A6A77B7B82B22F1,11591,6,12,6,36,49,1849
48016,48016,CB9FC3FE9195AF3F0A6A77B7B82B22F1,42471,12,13,1,35,49,1799
48017,48017,CB9FC3FE9195AF3F0A6A77B7B82B22F1,11591,14,19,5,36,49,1849
48018,48018,CB9FC3FE9195AF3F0A6A77B7B82B22F1,42471,20,22,2,35,49,1799
48019,48019,CB9FC3FE9195AF3F0A6A77B7B82B22F1,11591,22,23,1,36,49,1849
48020,48020,3E43826B2F3C90E1974FF5F797EBAA40,42581,0,6,6,38,48,1948
48021,48021,3E43826B2F3C90E1974FF5F797EBAA40,13731,8,9,1,33,49,1699
48022,48022,3E43826B2F3C90E1974FF5F797EBAA40,42581,22,23,1,38,48,1948
48023,48023,73C082AD21C824DD19FA5A08414F4F35,40361,7,9,2,42,48,2148
48024,48024,73C082AD21C824DD19FA5A08414F4F35,11875,14,16,2,30,46,1546
48025,48025,73C082AD21C824DD19FA5A08414F4F35,11801,17,19,2,42,48,2148
48029,48029,1B7D09E4B3040D1177382305D6A3EF74,12381,1,9,8,32,48,1648
48030,48030,1B7D09E4B3040D1177382305D6A3EF74,40341,9,11,2,23,49,1199
48031,48031,1B7D09E4B3040D1177382305D6A3EF74,12381,12,22,10,32,48,1648
48032,48032,74EBB90FA1C414F58477B49370E7F73F,11861,0,7,7,32,47,1647
48033,48033,74EBB90FA1C414F58477B49370E7F73F,12311,8,18,10,30,44,1544
48034,48034,74EBB90FA1C414F58477B49370E7F73F,11861,18,22,4,32,47,1647
48038,48038,42A16EFB84F2A02AEC5229D088C54FF3,13911,1,2,1,39,46,1996
48039,48039,42A16EFB84F2A02AEC5229D088C54FF3,42231,2,4,2,37,46,1896
48040,48040,42A16EFB84F2A02AEC5229D088C54FF3,13911,7,10,3,39,46,1996
48041,48041,42A16EFB84F2A02AEC5229D088C54FF3,42231,13,14,1,37,46,1896
48042,48042,42A16EFB84F2A02AEC5229D088C54FF3,13911,15,21,6,39,46,1996
48046,48046,B1B743419183DD2007BCF08AA357C60C,10841,0,15,15,37,47,1897
48047,48047,B1B743419183DD2007BCF08AA357C60C,40341,17,18,1,23,49,1199
48048,48048,B1B743419183DD2007BCF08AA357C60C,10841,19,23,4,37,47,1897
48052,48052,639EA486291B8A87A84D90343A87732A,10451,0,7,7,25,48,1298
48053,48053,639EA486291B8A87A84D90343A87732A,10661,12,13,1,37,49,1899
48054,48054,639EA486291B8A87A84D90343A87732A,10451,21,23,2,25,48,1298
48055,48055,4F218B591484142BCC1168E4506477B5,12971,0,7,7,32,48,1648
48056,48056,4F218B591484142BCC1168E4506477B5,10121,8,12,4,36,49,1849
48057,48057,4F218B591484142BCC1168E4506477B5,10431,16,17,1,33,49,1699
48058,48058,4F218B591484142BCC1168E4506477B5,12971,19,23,4,32,48,1648
48059,48059,176F4E967E986DAF00C74DDD3BF2A8FE,11806,5,11,6,41,48,2098
48060,48060,176F4E967E986DAF00C74DDD3BF2A8FE,13331,14,17,3,38,47,1947
48061,48061,176F4E967E986DAF00C74DDD3BF2A8FE,13711,21,23,2,38,46,1946
48062,48062,48BF3DD00ACEAC27721E2AAA83ACFDBE,40833,0,7,7,41,47,2097
48063,48063,48BF3DD00ACEAC27721E2AAA83ACFDBE,13101,7,9,2,40,47,2047
48064,48064,48BF3DD00ACEAC27721E2AAA83ACFDBE,40833,9,11,2,41,47,2097
48065,48065,48BF3DD00ACEAC27721E2AAA83ACFDBE,13101,16,17,1,40,47,2047
48066,48066,48BF3DD00ACEAC27721E2AAA83ACFDBE,43181,18,21,3,39,48,1998
48067,48067,CFB5B91AB0CD7543884ADBE535AD19D6,43021,0,6,6,16,43,843
48068,48068,CFB5B91AB0CD7543884ADBE535AD19D6,19021,7,8,1,10,45,545
48069,48069,CFB5B91AB0CD7543884ADBE535AD19D6,43021,9,23,14,16,43,843
48074,48074,58DF107986367FA88C1D627635A20D98,11861,7,8,1,32,47,1647
48075,48075,58DF107986367FA88C1D627635A20D98,11941,9,13,4,37,46,1896
48076,48076,58DF107986367FA88C1D627635A20D98,42011,14,23,9,36,46,1846
48077,48077,2881834474B021D3CB48D66D6B38B4E5,11331,0,6,6,37,48,1898
48078,48078,2881834474B021D3CB48D66D6B38B4E5,43731,7,8,1,34,47,1747
48079,48079,2881834474B021D3CB48D66D6B38B4E5,11921,10,12,2,38,48,1948
48080,48080,2881834474B021D3CB48D66D6B38B4E5,43731,15,17,2,34,47,1747
48081,48081,2881834474B021D3CB48D66D6B38B4E5,11921,21,23,2,38,48,1948
48082,48082,FB5A872D0FAE7AA0035523EB5DBD36C2,11324,0,6,6,31,46,1596
48083,48083,FB5A872D0FAE7AA0035523EB5DBD36C2,43761,7,11,4,32,47,1647
48084,48084,FB5A872D0FAE7AA0035523EB5DBD36C2,10531,12,14,2,34,46,1746
48085,48085,FB5A872D0FAE7AA0035523EB5DBD36C2,43761,14,17,3,32,47,1647
48086,48086,FB5A872D0FAE7AA0035523EB5DBD36C2,11324,22,23,1,31,46,1596
48090,48090,F4C44655D662E7B0953357C6BC0F15C4,19904,0,3,3,9,44,494
48091,48091,F4C44655D662E7B0953357C6BC0F15C4,12641,7,9,2,10,43,543
48092,48092,F4C44655D662E7B0953357C6BC0F15C4,19904,9,14,5,9,44,494
48093,48093,F4C44655D662E7B0953357C6BC0F15C4,12641,14,16,2,10,43,543
48094,48094,F4C44655D662E7B0953357C6BC0F15C4,19904,16,18,2,9,44,494
48095,48095,5FA17670CF7B34EAE6DE8FBA5C753F49,11834,0,8,8,32,45,1645
48096,48096,5FA17670CF7B34EAE6DE8FBA5C753F49,42531,12,13,1,31,45,1595
48097,48097,5FA17670CF7B34EAE6DE8FBA5C753F49,10107,14,16,2,38,49,1949
48098,48098,5FA17670CF7B34EAE6DE8FBA5C753F49,42511,17,19,2,37,47,1897
48099,48099,5FA17670CF7B34EAE6DE8FBA5C753F49,12661,20,23,3,32,45,1645
48100,48100,351FF83930454CC4BBBDA7784AA355A7,42531,4,6,2,31,45,1595
48101,48101,351FF83930454CC4BBBDA7784AA355A7,11834,7,8,1,32,45,1645
48102,48102,351FF83930454CC4BBBDA7784AA355A7,42151,9,10,1,35,45,1795
48103,48103,351FF83930454CC4BBBDA7784AA355A7,42531,11,14,3,31,45,1595
48104,48104,351FF83930454CC4BBBDA7784AA355A7,11834,15,16,1,32,45,1645
48105,48105,351FF83930454CC4BBBDA7784AA355A7,42531,18,23,5,31,45,1595
48106,48106,A0A3B0EE2DB91DACF63BD2AADD2DE687,11091,2,8,6,29,47,1497
48107,48107,A0A3B0EE2DB91DACF63BD2AADD2DE687,40331,11,16,5,30,47,1547
48108,48108,A0A3B0EE2DB91DACF63BD2AADD2DE687,11351,18,21,3,36,48,1848
48113,48113,29E682BF994B2ACA314777BEAEB90BB7,10251,0,1,1,35,47,1797
48114,48114,29E682BF994B2ACA314777BEAEB90BB7,13911,4,6,2,39,46,1996
48115,48115,29E682BF994B2ACA314777BEAEB90BB7,42231,7,20,13,37,46,1896
48116,48116,5E5B8BD5A45989C5961863EEA9C95971,15651,2,9,7,39,25,1975
48117,48117,5E5B8BD5A45989C5961863EEA9C95971,11021,12,19,7,36,49,1849
48118,48118,5E5B8BD5A45989C5961863EEA9C95971,15651,21,23,2,39,25,1975
48130,48130,B40A8C93BC170D4E6E266C926BF7EED2,13561,2,4,2,37,49,1899
48131,48131,B40A8C93BC170D4E6E266C926BF7EED2,11771,7,9,2,39,49,1999
48132,48132,B40A8C93BC170D4E6E266C926BF7EED2,12971,13,23,10,32,48,1648
48133,48133,9D0C016FAC9B03B23F695C0F283D602D,42581,3,5,2,38,48,1948
48134,48134,9D0C016FAC9B03B23F695C0F283D602D,11914,6,9,3,37,48,1898
48135,48135,9D0C016FAC9B03B23F695C0F283D602D,42581,9,11,2,38,48,1948
48136,48136,9D0C016FAC9B03B23F695C0F283D602D,11914,11,15,4,37,48,1898
48137,48137,9D0C016FAC9B03B23F695C0F283D602D,42581,15,17,2,38,48,1948
48138,48138,9D0C016FAC9B03B23F695C0F283D602D,11914,17,21,4,37,48,1898
48139,48139,20ABE85DC2C7867872C7B219F7ED7A9F,12381,10,11,1,32,48,1648
48140,48140,20ABE85DC2C7867872C7B219F7ED7A9F,42201,11,13,2,43,46,2196
48141,48141,20ABE85DC2C7867872C7B219F7ED7A9F,11201,14,18,4,35,49,1799
48142,48142,653984DE3233D4AFAF389C1902BDCACD,12221,0,6,6,43,44,2194
48143,48143,653984DE3233D4AFAF389C1902BDCACD,11834,7,8,1,32,45,1645
48144,48144,653984DE3233D4AFAF389C1902BDCACD,12221,10,21,11,43,44,2194
48145,48145,653984DE3233D4AFAF389C1902BDCACD,12561,22,23,1,45,43,2293
48146,48146,CB5C29694B25CC7F9A6250D529BD0870,10841,10,11,1,37,47,1897
48147,48147,CB5C29694B25CC7F9A6250D529BD0870,42161,12,14,2,36,47,1847
48148,48148,CB5C29694B25CC7F9A6250D529BD0870,42081,15,17,2,24,49,1249
48149,48149,CB5C29694B25CC7F9A6250D529BD0870,10841,22,23,1,37,47,1897
48154,48154,990F89A555478F97C2E0E123BB133187,49201,3,4,1,7,41,391
48155,48155,990F89A555478F97C2E0E123BB133187,12921,8,9,1,9,41,491
48156,48156,990F89A555478F97C2E0E123BB133187,49201,11,14,3,7,41,391
48157,48157,990F89A555478F97C2E0E123BB133187,19181,15,16,1,8,40,440
48158,48158,990F89A555478F97C2E0E123BB133187,49201,20,22,2,7,41,391
48159,48159,87563B55F2C858B1A30D9ECB8EED9C7F,12131,0,6,6,32,47,1647
48160,48160,87563B55F2C858B1A30D9ECB8EED9C7F,13094,17,18,1,21,42,1092
48161,48161,87563B55F2C858B1A30D9ECB8EED9C7F,12131,21,23,2,32,47,1647
48168,48168,E6D049947968658F47DDC695A59302A1,11861,0,5,5,32,47,1647
48169,48169,E6D049947968658F47DDC695A59302A1,42461,7,18,11,45,47,2297
48170,48170,E6D049947968658F47DDC695A59302A1,42321,19,20,1,43,47,2197
48171,48171,60058CA7C82E9B8D7AA25DED94DED415,13841,0,14,14,40,46,2046
48172,48172,60058CA7C82E9B8D7AA25DED94DED415,42021,14,16,2,33,47,1697
48173,48173,60058CA7C82E9B8D7AA25DED94DED415,13711,19,20,1,38,46,1946
48177,48177,B9E927B8C825AF1AC2891B310330CB7E,13121,0,6,6,38,46,1946
48178,48178,B9E927B8C825AF1AC2891B310330CB7E,42011,6,8,2,36,46,1846
48179,48179,B9E927B8C825AF1AC2891B310330CB7E,10471,10,13,3,37,48,1898
48180,48180,B9E927B8C825AF1AC2891B310330CB7E,11753,15,16,1,35,48,1798
48181,48181,B9E927B8C825AF1AC2891B310330CB7E,42011,17,23,6,36,46,1846
48182,48182,6F8E1C68808E2CD4EADC242CA851B0A2,42971,0,8,8,43,49,2199
48183,48183,6F8E1C68808E2CD4EADC242CA851B0A2,11021,10,13,3,36,49,1849
48184,48184,6F8E1C68808E2CD4EADC242CA851B0A2,42971,14,23,9,43,49,2199
48214,48214,5601C1A44CC85C7B09354B38FD0628D1,12311,0,7,7,30,44,1544
48215,48215,5601C1A44CC85C7B09354B38FD0628D1,13731,8,12,4,33,49,1699
48216,48216,5601C1A44CC85C7B09354B38FD0628D1,12311,12,15,3,30,44,1544
48217,48217,5601C1A44CC85C7B09354B38FD0628D1,13731,16,17,1,33,49,1699
48218,48218,5601C1A44CC85C7B09354B38FD0628D1,12311,20,21,1,30,44,1544
48226,48226,FE17A6569D79695D6DB996114E5DC069,10691,0,5,5,33,48,1698
48227,48227,FE17A6569D79695D6DB996114E5DC069,42491,7,8,1,32,46,1646
48228,48228,FE17A6569D79695D6DB996114E5DC069,11561,11,12,1,32,49,1649
48229,48229,FE17A6569D79695D6DB996114E5DC069,10431,16,17,1,33,49,1699
48230,48230,FE17A6569D79695D6DB996114E5DC069,10691,21,22,1,33,48,1698
48234,48234,C023F913EB9B0A9F89808DF1EFA2F477,43501,9,10,1,27,48,1398
48235,48235,C023F913EB9B0A9F89808DF1EFA2F477,10151,13,16,3,34,47,1747
48236,48236,C023F913EB9B0A9F89808DF1EFA2F477,43501,20,23,3,27,48,1398
48237,48237,ACC7AC3B8DE3474C386625E5186B4C58,42941,0,6,6,37,47,1897
48238,48238,ACC7AC3B8DE3474C386625E5186B4C58,42161,6,8,2,36,47,1847
48239,48239,ACC7AC3B8DE3474C386625E5186B4C58,10251,9,11,2,35,47,1797
48240,48240,ACC7AC3B8DE3474C386625E5186B4C58,42941,11,13,2,37,47,1897
48241,48241,ACC7AC3B8DE3474C386625E5186B4C58,11331,14,16,2,37,48,1898
48242,48242,ACC7AC3B8DE3474C386625E5186B4C58,42301,18,23,5,36,47,1847
48243,48243,177168A1104485CCD77EDFA93575365C,43311,0,10,10,31,48,1598
48244,48244,177168A1104485CCD77EDFA93575365C,11541,14,16,2,35,49,1799
48245,48245,177168A1104485CCD77EDFA93575365C,11161,16,20,4,32,48,1648
48246,48246,177168A1104485CCD77EDFA93575365C,11731,21,22,1,36,48,1848
48247,48247,15A1C2EE1FF8A17E3AE9CBDB477E44E9,12141,0,3,3,42,45,2145
48248,48248,15A1C2EE1FF8A17E3AE9CBDB477E44E9,43011,3,5,2,40,42,2042
48249,48249,15A1C2EE1FF8A17E3AE9CBDB477E44E9,12141,6,12,6,42,45,2145
48250,48250,15A1C2EE1FF8A17E3AE9CBDB477E44E9,43011,18,19,1,40,42,2042
48251,48251,15A1C2EE1FF8A17E3AE9CBDB477E44E9,12561,20,21,1,45,43,2293
48260,48260,C493E8EAD829832CA31397E82BE4990B,43021,0,5,5,16,43,843
48261,48261,C493E8EAD829832CA31397E82BE4990B,12921,6,15,9,9,41,491
48262,48262,C493E8EAD829832CA31397E82BE4990B,43021,19,23,4,16,43,843
48263,48263,9578C0DC67ACE68D6F89F515DBD5C8C2,19031,0,5,5,1,42,92
48264,48264,9578C0DC67ACE68D6F89F515DBD5C8C2,12921,7,11,4,9,41,491
48265,48265,9578C0DC67ACE68D6F89F515DBD5C8C2,19031,12,13,1,1,42,92
48266,48266,9578C0DC67ACE68D6F89F515DBD5C8C2,12921,14,20,6,9,41,491
48270,48270,358C3A01AF86C113DD19C3D12F559EF4,10251,0,15,15,35,47,1797
48271,48271,358C3A01AF86C113DD19C3D12F559EF4,40341,15,17,2,23,49,1199
48272,48272,358C3A01AF86C113DD19C3D12F559EF4,11631,18,21,3,12,49,649
48273,48273,7AA4C171F7BBE6F18406A98B9AA3AE03,43311,0,8,8,31,48,1598
48274,48274,7AA4C171F7BBE6F18406A98B9AA3AE03,40341,9,11,2,23,49,1199
48275,48275,7AA4C171F7BBE6F18406A98B9AA3AE03,12381,12,23,11,32,48,1648
48276,48276,091497AD7ED956A0C3F93F46CFB651F5,43021,0,6,6,16,43,843
48277,48277,091497AD7ED956A0C3F93F46CFB651F5,12921,6,11,5,9,41,491
48278,48278,091497AD7ED956A0C3F93F46CFB651F5,43021,12,14,2,16,43,843
48279,48279,091497AD7ED956A0C3F93F46CFB651F5,12921,16,17,1,9,41,491
48280,48280,091497AD7ED956A0C3F93F46CFB651F5,43021,17,19,2,16,43,843
48281,48281,091497AD7ED956A0C3F93F46CFB651F5,12921,22,23,1,9,41,491
48282,48282,C671A533EE3915C5115653B674CE333B,11091,0,11,11,29,47,1497
48283,48283,C671A533EE3915C5115653B674CE333B,10107,12,13,1,38,49,1949
48284,48284,C671A533EE3915C5115653B674CE333B,11091,18,23,5,29,47,1497
48292,48292,2659257975E5FF2EA56D8A9B41ADD910,10281,0,9,9,33,48,1698
48293,48293,2659257975E5FF2EA56D8A9B41ADD910,11231,10,20,10,37,49,1899
48294,48294,2659257975E5FF2EA56D8A9B41ADD910,42141,21,22,1,32,47,1647
48298,48298,7DFCA2932B390D69ABC0E415A2260097,10351,0,2,2,28,45,1445
48299,48299,7DFCA2932B390D69ABC0E415A2260097,42531,4,8,4,31,45,1595
48300,48300,7DFCA2932B390D69ABC0E415A2260097,10351,10,14,4,28,45,1445
48301,48301,7DFCA2932B390D69ABC0E415A2260097,42531,17,19,2,31,45,1595
48302,48302,7DFCA2932B390D69ABC0E415A2260097,10351,21,23,2,28,45,1445
48309,48309,2BEF2F1DF9F53E26FBA10E115C641BD7,12661,0,6,6,32,45,1645
48310,48310,2BEF2F1DF9F53E26FBA10E115C641BD7,42151,7,9,2,35,45,1795
48311,48311,2BEF2F1DF9F53E26FBA10E115C641BD7,12661,11,13,2,32,45,1645
48312,48312,2BEF2F1DF9F53E26FBA10E115C641BD7,42151,15,16,1,35,45,1795
48313,48313,2BEF2F1DF9F53E26FBA10E115C641BD7,12661,18,19,1,32,45,1645
48318,48318,BC3DA9BAF9B0A0C935A79D91ECBDA067,19441,0,3,3,8,46,446
48319,48319,BC3DA9BAF9B0A0C935A79D91ECBDA067,42151,7,16,9,35,45,1795
48320,48320,BC3DA9BAF9B0A0C935A79D91ECBDA067,19901,20,23,3,7,44,394
48321,48321,D9AF0A0BEFAFF72D2F6D04084706EE69,43051,0,5,5,46,45,2345
48322,48322,D9AF0A0BEFAFF72D2F6D04084706EE69,10381,6,18,12,31,49,1599
48323,48323,D9AF0A0BEFAFF72D2F6D04084706EE69,43051,21,23,2,46,45,2345
48324,48324,119196C18578341D0084AF6B48A62632,12641,4,7,3,10,43,543
48325,48325,119196C18578341D0084AF6B48A62632,11631,9,18,9,12,49,649
48326,48326,119196C18578341D0084AF6B48A62632,42551,21,23,2,14,48,748
48333,48333,4238B44453CFC97685E5FF7EAAC3DCF1,11074,1,9,8,37,47,1897
48334,48334,4238B44453CFC97685E5FF7EAAC3DCF1,11061,14,16,2,29,48,1498
48335,48335,4238B44453CFC97685E5FF7EAAC3DCF1,42941,18,19,1,37,47,1897
48336,48336,4238B44453CFC97685E5FF7EAAC3DCF1,11491,20,21,1,36,47,1847
48337,48337,4238B44453CFC97685E5FF7EAAC3DCF1,42941,22,23,1,37,47,1897
48338,48338,668B25EA27DB62433F6B97341A2F29D6,10251,0,8,8,35,47,1797
48339,48339,668B25EA27DB62433F6B97341A2F29D6,10731,10,12,2,33,47,1697
48340,48340,668B25EA27DB62433F6B97341A2F29D6,43731,13,14,1,34,47,1747
48341,48341,668B25EA27DB62433F6B97341A2F29D6,11875,17,18,1,30,46,1546
48342,48342,668B25EA27DB62433F6B97341A2F29D6,43731,19,20,1,34,47,1747
48343,48343,668B25EA27DB62433F6B97341A2F29D6,10251,20,21,1,35,47,1797
48347,48347,F0D6A0DD95FECBA9B8057DD90C2A5CED,10681,0,2,2,30,48,1548
48348,48348,F0D6A0DD95FECBA9B8057DD90C2A5CED,11381,2,4,2,30,47,1547
48349,48349,F0D6A0DD95FECBA9B8057DD90C2A5CED,10681,9,13,4,30,48,1548
48350,48350,F0D6A0DD95FECBA9B8057DD90C2A5CED,11381,14,17,3,30,47,1547
48351,48351,F0D6A0DD95FECBA9B8057DD90C2A5CED,10681,18,21,3,30,48,1548
48374,48374,055392723CC93B49A610878855A95D5B,19441,0,1,1,8,46,446
48375,48375,055392723CC93B49A610878855A95D5B,11471,2,4,2,12,48,648
48376,48376,055392723CC93B49A610878855A95D5B,19441,4,19,15,8,46,446
48384,48384,B2C61EE4080ED347D0314F331516889E,10292,0,10,10,30,47,1547
48385,48385,B2C61EE4080ED347D0314F331516889E,40951,12,13,1,36,49,1849
48386,48386,B2C61EE4080ED347D0314F331516889E,13651,14,18,4,30,47,1547
48387,48387,B2C61EE4080ED347D0314F331516889E,40925,20,21,1,35,49,1799
48395,48395,354BD264A9E3427AF445BDA947BFDA83,11771,9,14,5,39,49,1999
48396,48396,354BD264A9E3427AF445BDA947BFDA83,11751,14,16,2,35,48,1798
48397,48397,354BD264A9E3427AF445BDA947BFDA83,11531,18,19,1,34,49,1749
48402,48402,4D4354448E6EA09F1B4E4241448CDCDF,11381,0,13,13,30,47,1547
48403,48403,4D4354448E6EA09F1B4E4241448CDCDF,11781,15,17,2,38,49,1949
48404,48404,4D4354448E6EA09F1B4E4241448CDCDF,11381,17,23,6,30,47,1547
48405,48405,0F4042ADB59E4BF84D8E0BA1195B66BF,13511,0,8,8,34,48,1748
48406,48406,0F4042ADB59E4BF84D8E0BA1195B66BF,43451,12,14,2,37,40,1890
48407,48407,0F4042ADB59E4BF84D8E0BA1195B66BF,13511,15,23,8,34,48,1748
48408,48408,70E50AA138C0538910E5623295B506D8,42151,0,6,6,35,45,1795
48409,48409,70E50AA138C0538910E5623295B506D8,11261,10,11,1,36,46,1846
48410,48410,70E50AA138C0538910E5623295B506D8,42351,12,13,1,38,45,1945
48411,48411,70E50AA138C0538910E5623295B506D8,13231,15,16,1,39,46,1996
48412,48412,70E50AA138C0538910E5623295B506D8,42351,17,21,4,38,45,1945
48413,48413,2873DE93703B028193B7B9719DCFE691,12521,0,7,7,35,41,1791
48414,48414,2873DE93703B028193B7B9719DCFE691,43451,7,11,4,37,40,1890
48415,48415,2873DE93703B028193B7B9719DCFE691,12521,11,13,2,35,41,1791
48416,48416,2873DE93703B028193B7B9719DCFE691,43451,14,17,3,37,40,1890
48417,48417,2873DE93703B028193B7B9719DCFE691,12521,18,23,5,35,41,1791
48418,48418,B30EADCDB62CDB3A3D6B79A5D7B5BF57,11351,0,2,2,36,48,1848
48419,48419,B30EADCDB62CDB3A3D6B79A5D7B5BF57,13101,3,4,1,40,47,2047
48420,48420,B30EADCDB62CDB3A3D6B79A5D7B5BF57,10292,4,18,14,30,47,1547
48421,48421,B30EADCDB62CDB3A3D6B79A5D7B5BF57,11491,19,21,2,36,47,1847
48422,48422,4A63BD8790639E943B30CD82E5123621,11151,0,5,5,30,48,1548
48423,48423,4A63BD8790639E943B30CD82E5123621,19031,6,8,2,1,42,92
48424,48424,4A63BD8790639E943B30CD82E5123621,11151,11,16,5,30,48,1548
48425,48425,4A63BD8790639E943B30CD82E5123621,11061,19,22,3,29,48,1498
48426,48426,6B614428F8D95ECFDE2207017437E97D,19281,0,5,5,16,32,832
48427,48427,6B614428F8D95ECFDE2207017437E97D,12871,6,7,1,22,33,1133
48428,48428,6B614428F8D95ECFDE2207017437E97D,19281,9,15,6,16,32,832
48429,48429,6B614428F8D95ECFDE2207017437E97D,12871,16,23,7,22,33,1133
48430,48430,7861278735CDA91B9BABB196FBF7605C,43951,0,4,4,49,41,2491
48431,48431,7861278735CDA91B9BABB196FBF7605C,13951,12,17,5,47,45,2395
48432,48432,7861278735CDA91B9BABB196FBF7605C,43951,18,23,5,49,41,2491
48433,48433,6613AA9EB970F0E62FF5B3A108BFBF45,11331,0,6,6,37,48,1898
48434,48434,6613AA9EB970F0E62FF5B3A108BFBF45,11074,6,9,3,37,47,1897
48435,48435,6613AA9EB970F0E62FF5B3A108BFBF45,12381,10,12,2,32,48,1648
48436,48436,6613AA9EB970F0E62FF5B3A108BFBF45,10221,13,15,2,34,49,1749
48437,48437,6613AA9EB970F0E62FF5B3A108BFBF45,12381,20,23,3,32,48,1648
48438,48438,09E35A3086ED2C100882D697DC471A83,42231,0,8,8,37,46,1896
48439,48439,09E35A3086ED2C100882D697DC471A83,11861,10,18,8,32,47,1647
48440,48440,09E35A3086ED2C100882D697DC471A83,42231,20,23,3,37,46,1896
48448,48448,8216976CCAE5E4C68F70476A01BDA009,42151,8,10,2,35,45,1795
48449,48449,8216976CCAE5E4C68F70476A01BDA009,42381,10,13,3,39,41,1991
48450,48450,8216976CCAE5E4C68F70476A01BDA009,42151,14,17,3,35,45,1795
48451,48451,8216976CCAE5E4C68F70476A01BDA009,42381,22,23,1,39,41,1991
48452,48452,C2C5F3D1EDFF2B77820D06649C507C1B,12661,2,8,6,32,45,1645
48453,48453,C2C5F3D1EDFF2B77820D06649C507C1B,10821,14,18,4,40,47,2047
48454,48454,C2C5F3D1EDFF2B77820D06649C507C1B,42031,22,23,1,40,46,2046
48455,48455,A567BE5B1DACD6E00CC2FAA52D5DB6DF,40833,0,7,7,41,47,2097
48456,48456,A567BE5B1DACD6E00CC2FAA52D5DB6DF,10351,9,11,2,28,45,1445
48457,48457,A567BE5B1DACD6E00CC2FAA52D5DB6DF,10801,19,23,4,42,47,2147
48462,48462,4CFA99DC7280571751384BD81826C393,10111,0,9,9,37,47,1897
48463,48463,4CFA99DC7280571751384BD81826C393,10281,12,14,2,33,48,1698
48464,48464,4CFA99DC7280571751384BD81826C393,10341,14,16,2,31,47,1597
48465,48465,4CFA99DC7280571751384BD81826C393,10111,18,22,4,37,47,1897
48466,48466,EEC3C4501F3A29808B2227E416789416,10211,4,5,1,16,49,849
48467,48467,EEC3C4501F3A29808B2227E416789416,11631,6,16,10,12,49,649
48468,48468,EEC3C4501F3A29808B2227E416789416,40341,16,18,2,23,49,1199
48469,48469,EEC3C4501F3A29808B2227E416789416,11631,21,23,2,12,49,649
48474,48474,15AF53FBA0C13FBD61024895398ED2FD,42551,0,1,1,14,48,748
48475,48475,15AF53FBA0C13FBD61024895398ED2FD,19441,1,5,4,8,46,446
48476,48476,15AF53FBA0C13FBD61024895398ED2FD,42041,5,8,3,10,47,547
48477,48477,15AF53FBA0C13FBD61024895398ED2FD,19441,9,12,3,8,46,446
48478,48478,15AF53FBA0C13FBD61024895398ED2FD,42041,16,17,1,10,47,547
48479,48479,15AF53FBA0C13FBD61024895398ED2FD,19441,20,21,1,8,46,446
48480,48480,822C0A93592A32AB705BCCE34C567AE4,13511,0,14,14,34,48,1748
48481,48481,822C0A93592A32AB705BCCE34C567AE4,12514,16,17,1,38,47,1947
48482,48482,822C0A93592A32AB705BCCE34C567AE4,13511,21,23,2,34,48,1748
48483,48483,6AD981E757B177FB5B64F1D1D2EAA27F,11801,2,5,3,42,48,2148
48484,48484,6AD981E757B177FB5B64F1D1D2EAA27F,11701,7,8,1,43,48,2198
48485,48485,6AD981E757B177FB5B64F1D1D2EAA27F,10901,9,12,3,35,48,1798
48486,48486,6AD981E757B177FB5B64F1D1D2EAA27F,11531,17,23,6,34,49,1749
48487,48487,C69DB833C5C233DF7718BBF8E4312DAA,42021,0,9,9,33,47,1697
48488,48488,C69DB833C5C233DF7718BBF8E4312DAA,42861,10,11,1,37,44,1894
48489,48489,C69DB833C5C233DF7718BBF8E4312DAA,11875,12,18,6,30,46,1546
48490,48490,C69DB833C5C233DF7718BBF8E4312DAA,42871,20,23,3,30,45,1545
48495,48495,A3FAF330124CA173A9985CFE7EAC668F,10271,0,1,1,37,46,1896
48496,48496,A3FAF330124CA173A9985CFE7EAC668F,40124,4,5,1,38,47,1947
48497,48497,A3FAF330124CA173A9985CFE7EAC668F,11074,7,9,2,37,47,1897
48498,48498,A3FAF330124CA173A9985CFE7EAC668F,13711,12,13,1,38,46,1946
48499,48499,A3FAF330124CA173A9985CFE7EAC668F,15261,16,19,3,39,13,1963
48500,48500,9F7BBEBDE25379D4345B2CB89A6224BC,10295,0,8,8,30,47,1547
48501,48501,9F7BBEBDE25379D4345B2CB89A6224BC,11021,11,19,8,36,49,1849
48502,48502,9F7BBEBDE25379D4345B2CB89A6224BC,10292,19,23,4,30,47,1547
48503,48503,60431017DB48728DD1D9AC55BBBFB348,11161,0,17,17,32,48,1648
48504,48504,60431017DB48728DD1D9AC55BBBFB348,10721,18,19,1,31,48,1598
48505,48505,60431017DB48728DD1D9AC55BBBFB348,11781,21,23,2,38,49,1949
48509,48509,555BCDC022BA89E0AE86A41D2EE2A3C3,12641,1,2,1,10,43,543
48510,48510,555BCDC022BA89E0AE86A41D2EE2A3C3,49201,3,7,4,7,41,391
48511,48511,555BCDC022BA89E0AE86A41D2EE2A3C3,12641,8,9,1,10,43,543
48512,48512,555BCDC022BA89E0AE86A41D2EE2A3C3,49201,10,21,11,7,41,391
48513,48513,555BCDC022BA89E0AE86A41D2EE2A3C3,12641,21,23,2,10,43,543
48514,48514,DC15358175A492C6F21AAEFAD4CD0BB7,42161,0,11,11,36,47,1847
48515,48515,DC15358175A492C6F21AAEFAD4CD0BB7,11061,12,13,1,29,48,1498
48516,48516,DC15358175A492C6F21AAEFAD4CD0BB7,10121,15,17,2,36,49,1849
48517,48517,DC15358175A492C6F21AAEFAD4CD0BB7,42401,17,23,6,36,47,1847
48518,48518,44AF7E3F6FD3AFD3E254BC36398928E0,12561,1,12,11,45,43,2293
48519,48519,44AF7E3F6FD3AFD3E254BC36398928E0,43011,12,14,2,40,42,2042
48520,48520,44AF7E3F6FD3AFD3E254BC36398928E0,12561,16,19,3,45,43,2293
48521,48521,88DA908BCBBD924A23915F0C35FE7D60,13314,0,5,5,31,39,1589
48522,48522,88DA908BCBBD924A23915F0C35FE7D60,12521,5,16,11,35,41,1791
48523,48523,88DA908BCBBD924A23915F0C35FE7D60,13314,16,19,3,31,39,1589
48524,48524,F552BBAFE22D025B0F7E0055A73A2709,42321,2,5,3,43,47,2197
48525,48525,F552BBAFE22D025B0F7E0055A73A2709,10801,6,12,6,42,47,2147
48526,48526,F552BBAFE22D025B0F7E0055A73A2709,42021,17,19,2,33,47,1697
48527,48527,F552BBAFE22D025B0F7E0055A73A2709,42161,20,23,3,36,47,1847
48534,48534,30EC1F807EEC306D244EB53BC8B7C8C8,40941,0,7,7,32,48,1648
48535,48535,30EC1F807EEC306D244EB53BC8B7C8C8,12311,9,14,5,30,44,1544
48536,48536,30EC1F807EEC306D244EB53BC8B7C8C8,13961,15,16,1,42,48,2148
48537,48537,30EC1F807EEC306D244EB53BC8B7C8C8,40941,17,23,6,32,48,1648
48544,48544,56C9E3E7FB7F4770AB5F1398CDE12961,42281,0,8,8,40,48,2048
48545,48545,56C9E3E7FB7F4770AB5F1398CDE12961,10211,10,12,2,16,49,849
48546,48546,56C9E3E7FB7F4770AB5F1398CDE12961,42281,14,23,9,40,48,2048
48547,48547,58B59FD7AA0814C0C6E50CF40955E7AA,12121,3,5,2,29,47,1497
48548,48548,58B59FD7AA0814C0C6E50CF40955E7AA,12601,5,7,2,25,47,1297
48549,48549,58B59FD7AA0814C0C6E50CF40955E7AA,10634,8,14,6,27,45,1395
48550,48550,58B59FD7AA0814C0C6E50CF40955E7AA,12601,20,21,1,25,47,1297
48551,48551,58B59FD7AA0814C0C6E50CF40955E7AA,10634,22,23,1,27,45,1395
48552,48552,43D8A7ADC824CCF2C858C535E34E2FB1,15653,0,10,10,40,25,2025
48553,48553,43D8A7ADC824CCF2C858C535E34E2FB1,15651,11,12,1,39,25,1975
48554,48554,43D8A7ADC824CCF2C858C535E34E2FB1,10151,14,16,2,34,47,1747
48555,48555,43D8A7ADC824CCF2C858C535E34E2FB1,40341,17,19,2,23,49,1199
48560,48560,511248B31413344B77C12D74A5EE7CDF,40872,0,7,7,30,49,1549
48561,48561,511248B31413344B77C12D74A5EE7CDF,11151,10,12,2,30,48,1548
48562,48562,511248B31413344B77C12D74A5EE7CDF,11061,12,14,2,29,48,1498
48563,48563,511248B31413344B77C12D74A5EE7CDF,11151,14,21,7,30,48,1548
48564,48564,511248B31413344B77C12D74A5EE7CDF,43471,22,23,1,31,49,1599
48568,48568,EF5F3443D78D6F9EF11F217742BF1D2A,13651,0,8,8,30,47,1547
48569,48569,EF5F3443D78D6F9EF11F217742BF1D2A,10841,10,12,2,37,47,1897
48570,48570,EF5F3443D78D6F9EF11F217742BF1D2A,42301,12,16,4,36,47,1847
48571,48571,EF5F3443D78D6F9EF11F217742BF1D2A,10292,21,23,2,30,47,1547
48572,48572,13442D9CC8FCCC718EDB9D3EAB7825ED,11541,1,11,10,35,49,1799
48573,48573,13442D9CC8FCCC718EDB9D3EAB7825ED,40124,15,22,7,38,47,1947
48574,48574,13442D9CC8FCCC718EDB9D3EAB7825ED,13121,22,23,1,38,46,1946
48575,48575,71CDB42BF8ABF4C8B89BDC81F92C39B7,10634,0,6,6,27,45,1395
48576,48576,71CDB42BF8ABF4C8B89BDC81F92C39B7,12601,11,12,1,25,47,1297
48577,48577,71CDB42BF8ABF4C8B89BDC81F92C39B7,10634,12,14,2,27,45,1395
48578,48578,71CDB42BF8ABF4C8B89BDC81F92C39B7,12601,15,17,2,25,47,1297
48579,48579,71CDB42BF8ABF4C8B89BDC81F92C39B7,11321,17,19,2,31,46,1596
48580,48580,71CDB42BF8ABF4C8B89BDC81F92C39B7,10634,20,22,2,27,45,1395
48581,48581,6F712976E0E790786B4CAFA7504F8275,12874,0,2,2,20,34,1034
48582,48582,6F712976E0E790786B4CAFA7504F8275,19281,3,5,2,16,32,832
48583,48583,6F712976E0E790786B4CAFA7504F8275,12874,5,8,3,20,34,1034
48584,48584,6F712976E0E790786B4CAFA7504F8275,43644,12,15,3,14,38,738
48585,48585,6F712976E0E790786B4CAFA7504F8275,12921,16,17,1,9,41,491
48586,48586,6F712976E0E790786B4CAFA7504F8275,19281,20,21,1,16,32,832
48587,48587,9C211F2E07C17475B7D2343E9DD9ED0D,10721,0,7,7,31,48,1598
48588,48588,9C211F2E07C17475B7D2343E9DD9ED0D,42531,12,13,1,31,45,1595
48589,48589,9C211F2E07C17475B7D2343E9DD9ED0D,12311,14,15,1,30,44,1544
48590,48590,9C211F2E07C17475B7D2343E9DD9ED0D,12381,18,20,2,32,48,1648
48591,48591,97E4702F624CE098E267C7767A3602E0,42491,0,14,14,32,46,1646
48592,48592,97E4702F624CE098E267C7767A3602E0,11061,15,17,2,29,48,1498
48593,48593,97E4702F624CE098E267C7767A3602E0,42491,18,23,5,32,46,1646
48601,48601,0C653DC860B823A0FBD73915967D7A74,13341,2,3,1,44,45,2245
48602,48602,0C653DC860B823A0FBD73915967D7A74,43051,3,5,2,46,45,2345
48603,48603,0C653DC860B823A0FBD73915967D7A74,12221,8,10,2,43,44,2194
48604,48604,0C653DC860B823A0FBD73915967D7A74,42631,14,16,2,43,45,2195
48605,48605,0C653DC860B823A0FBD73915967D7A74,12221,17,18,1,43,44,2194
48606,48606,0C653DC860B823A0FBD73915967D7A74,43051,20,21,1,46,45,2345
48607,48607,0C653DC860B823A0FBD73915967D7A74,13341,22,23,1,44,45,2245
48608,48608,0004E9A02B9F97024FE46D8B36381EE9,12641,0,9,9,10,43,543
48609,48609,0004E9A02B9F97024FE46D8B36381EE9,42531,11,13,2,31,45,1595
48610,48610,0004E9A02B9F97024FE46D8B36381EE9,19821,17,18,1,4,46,246
48611,48611,0004E9A02B9F97024FE46D8B36381EE9,10681,20,21,1,30,48,1548
48612,48612,4A7DB4C98C495CBE39929E4AF5856114,11271,0,9,9,37,48,1898
48613,48613,4A7DB4C98C495CBE39929E4AF5856114,42381,11,14,3,39,41,1991
48614,48614,4A7DB4C98C495CBE39929E4AF5856114,13091,14,15,1,20,42,1042
48615,48615,4A7DB4C98C495CBE39929E4AF5856114,11541,18,20,2,35,49,1799
48616,48616,4A7DB4C98C495CBE39929E4AF5856114,10107,21,22,1,38,49,1949
48620,48620,FAA5294A962477DF58D88724F4B906AF,43621,1,6,5,46,48,2348
48621,48621,FAA5294A962477DF58D88724F4B906AF,10491,9,12,3,33,48,1698
48622,48622,FAA5294A962477DF58D88724F4B906AF,12651,15,22,7,43,47,2197
48638,48638,070FBAC74203F15EE9C689471AF11573,40242,0,18,18,36,49,1849
48639,48639,070FBAC74203F15EE9C689471AF11573,43391,20,21,1,29,48,1498
48640,48640,070FBAC74203F15EE9C689471AF11573,10901,21,23,2,35,48,1798
48641,48641,2FA830A3F4936C72A1774CB1227927A5,42161,0,7,7,36,47,1847
48642,48642,2FA830A3F4936C72A1774CB1227927A5,11861,10,11,1,32,47,1647
48643,48643,2FA830A3F4936C72A1774CB1227927A5,11131,12,13,1,33,48,1698
48644,48644,2FA830A3F4936C72A1774CB1227927A5,11861,14,15,1,32,47,1647
48645,48645,2FA830A3F4936C72A1774CB1227927A5,42161,18,23,5,36,47,1847
48646,48646,8C93E9687A717AEFB87364B357E16B82,42031,0,5,5,40,46,2046
48647,48647,8C93E9687A717AEFB87364B357E16B82,10331,7,16,9,39,46,1996
48648,48648,8C93E9687A717AEFB87364B357E16B82,12121,19,20,1,29,47,1497
48649,48649,8C93E9687A717AEFB87364B357E16B82,13711,21,23,2,38,46,1946
48650,48650,85E82957CCC6F500CEF85954BDFD529A,40073,6,7,1,37,48,1898
48651,48651,85E82957CCC6F500CEF85954BDFD529A,42081,10,11,1,24,49,1249
48652,48652,85E82957CCC6F500CEF85954BDFD529A,13351,13,14,1,48,48,2448
48653,48653,85E82957CCC6F500CEF85954BDFD529A,40073,17,18,1,37,48,1898
48654,48654,5C633B6A90713EC538BFB33DCFC3172F,13911,0,13,13,39,46,1996
48655,48655,5C633B6A90713EC538BFB33DCFC3172F,42351,15,17,2,38,45,1945
48656,48656,5C633B6A90713EC538BFB33DCFC3172F,42151,20,21,1,35,45,1795
48657,48657,5C633B6A90713EC538BFB33DCFC3172F,42351,22,23,1,38,45,1945
48665,48665,7300FFB733BFFEA187DB110E4D4DC3D2,49201,0,7,7,7,41,391
48666,48666,7300FFB733BFFEA187DB110E4D4DC3D2,12921,7,9,2,9,41,491
48667,48667,7300FFB733BFFEA187DB110E4D4DC3D2,49201,12,13,1,7,41,391
48668,48668,7300FFB733BFFEA187DB110E4D4DC3D2,12921,18,19,1,9,41,491
48669,48669,7300FFB733BFFEA187DB110E4D4DC3D2,49201,20,23,3,7,41,391
48670,48670,E6E1B072EE7202225510F5B63E9E6AA7,11921,0,6,6,38,48,1948
48671,48671,E6E1B072EE7202225510F5B63E9E6AA7,42121,9,18,9,26,49,1349
48672,48672,E6E1B072EE7202225510F5B63E9E6AA7,42221,19,23,4,38,48,1948
48677,48677,2D698F0A1356711606949EFF3DBD69C1,12083,2,4,2,36,49,1849
48678,48678,2D698F0A1356711606949EFF3DBD69C1,11061,4,13,9,29,48,1498
48679,48679,2D698F0A1356711606949EFF3DBD69C1,11151,16,17,1,30,48,1548
48680,48680,2D698F0A1356711606949EFF3DBD69C1,11751,18,23,5,35,48,1798
48681,48681,AB35C432DC3D59E7929F031635A675AA,12601,1,12,11,25,47,1297
48682,48682,AB35C432DC3D59E7929F031635A675AA,10501,12,13,1,22,46,1146
48683,48683,AB35C432DC3D59E7929F031635A675AA,11381,16,18,2,30,47,1547
48684,48684,AB35C432DC3D59E7929F031635A675AA,10501,22,23,1,22,46,1146
48685,48685,D4C3DE1B24B26783A6BA27C7925E5953,42271,0,17,17,40,47,2047
48686,48686,D4C3DE1B24B26783A6BA27C7925E5953,40341,18,19,1,23,49,1199
48687,48687,D4C3DE1B24B26783A6BA27C7925E5953,42271,22,23,1,40,47,2047
48688,48688,514D2E07A55C46F7A4E2E18B2E080A04,11321,0,9,9,31,46,1596
48689,48689,514D2E07A55C46F7A4E2E18B2E080A04,12601,17,18,1,25,47,1297
48690,48690,514D2E07A55C46F7A4E2E18B2E080A04,13341,19,21,2,44,45,2245
48691,48691,514D2E07A55C46F7A4E2E18B2E080A04,12561,21,22,1,45,43,2293
48695,48695,D5AD4B67900B7396AED4AEDC3733EA39,13121,1,13,12,38,46,1946
48696,48696,D5AD4B67900B7396AED4AEDC3733EA39,10881,15,17,2,34,48,1748
48697,48697,D5AD4B67900B7396AED4AEDC3733EA39,10221,19,20,1,34,49,1749
48702,48702,F8320AC02FAC6F4A311CBF8892D02227,11381,0,19,19,30,47,1547
48703,48703,F8320AC02FAC6F4A311CBF8892D02227,40341,19,20,1,23,49,1199
48704,48704,F8320AC02FAC6F4A311CBF8892D02227,11381,21,23,2,30,47,1547
48705,48705,21A180321800B594D0DD89707450AB6F,42411,0,8,8,40,49,2049
48706,48706,21A180321800B594D0DD89707450AB6F,42121,12,13,1,26,49,1349
48707,48707,21A180321800B594D0DD89707450AB6F,42583,13,18,5,40,48,2048
48708,48708,21A180321800B594D0DD89707450AB6F,10611,18,23,5,32,48,1648
48709,48709,2D3C63D05872EB19B4F311BB51B82DFD,11021,0,9,9,36,49,1849
48710,48710,2D3C63D05872EB19B4F311BB51B82DFD,11481,12,13,1,41,48,2098
48711,48711,2D3C63D05872EB19B4F311BB51B82DFD,11021,17,19,2,36,49,1849
48712,48712,F436DBA5CFEAF847870F2A6590F182A7,11381,0,7,7,30,47,1547
48713,48713,F436DBA5CFEAF847870F2A6590F182A7,42631,9,11,2,43,45,2195
48714,48714,F436DBA5CFEAF847870F2A6590F182A7,11231,12,16,4,37,49,1899
48715,48715,F436DBA5CFEAF847870F2A6590F182A7,11381,17,23,6,30,47,1547
48716,48716,F03DF83D089F92F122B731CCAAA669BB,11271,0,7,7,37,48,1898
48717,48717,F03DF83D089F92F122B731CCAAA669BB,10107,7,13,6,38,49,1949
48718,48718,F03DF83D089F92F122B731CCAAA669BB,40077,13,15,2,37,49,1899
48719,48719,F03DF83D089F92F122B731CCAAA669BB,11753,15,17,2,35,48,1798
48720,48720,F03DF83D089F92F122B731CCAAA669BB,10471,19,23,4,37,48,1898
48721,48721,87ACC15C6807737A79F94B9AB5275D80,11794,0,10,10,38,49,1949
48722,48722,87ACC15C6807737A79F94B9AB5275D80,13341,15,16,1,44,45,2245
48723,48723,87ACC15C6807737A79F94B9AB5275D80,11074,16,17,1,37,47,1897
48724,48724,87ACC15C6807737A79F94B9AB5275D80,10281,20,21,1,33,48,1698
48725,48725,87ACC15C6807737A79F94B9AB5275D80,42491,21,22,1,32,46,1646
48726,48726,4A68C1945FCC1868E3DBF0CF909E5429,40872,0,9,9,30,49,1549
48727,48727,4A68C1945FCC1868E3DBF0CF909E5429,40925,13,14,1,35,49,1799
48728,48728,4A68C1945FCC1868E3DBF0CF909E5429,10221,19,23,4,34,49,1749
48729,48729,16D740AE27D92BE968DE244652195181,13671,0,12,12,27,43,1393
48730,48730,16D740AE27D92BE968DE244652195181,12761,13,14,1,25,40,1290
48731,48731,16D740AE27D92BE968DE244652195181,13671,15,17,2,27,43,1393
48732,48732,16D740AE27D92BE968DE244652195181,12761,17,22,5,25,40,1290
48737,48737,1463E9838EB11802DBC75E65276D110F,42531,1,5,4,31,45,1595
48738,48738,1463E9838EB11802DBC75E65276D110F,12521,7,10,3,35,41,1791
48739,48739,1463E9838EB11802DBC75E65276D110F,13314,11,12,1,31,39,1589
48740,48740,1463E9838EB11802DBC75E65276D110F,12521,12,19,7,35,41,1791
48741,48741,1463E9838EB11802DBC75E65276D110F,42531,19,21,2,31,45,1595
48752,48752,A94573BDDECBBDBAA7F89BE9CE71D3CF,43581,0,9,9,33,48,1698
48753,48753,A94573BDDECBBDBAA7F89BE9CE71D3CF,12511,10,15,5,39,47,1997
48754,48754,A94573BDDECBBDBAA7F89BE9CE71D3CF,43581,19,23,4,33,48,1698
48758,48758,CD6FBF4118663ECE62CCA91FFBED80FB,13561,0,12,12,37,49,1899
48759,48759,CD6FBF4118663ECE62CCA91FFBED80FB,11751,12,14,2,35,48,1798
48760,48760,CD6FBF4118663ECE62CCA91FFBED80FB,12021,18,21,3,37,49,1899
48761,48761,CD6FBF4118663ECE62CCA91FFBED80FB,42021,22,23,1,33,47,1697
48773,48773,024AB2D90319DF57F94996854D076E3D,42471,0,12,12,35,49,1799
48774,48774,024AB2D90319DF57F94996854D076E3D,11801,16,17,1,42,48,2148
48775,48775,024AB2D90319DF57F94996854D076E3D,40833,18,23,5,41,47,2097
48779,48779,C97D1EB6332A2DCE6ADB1DE5937351DA,42971,0,13,13,43,49,2199
48780,48780,C97D1EB6332A2DCE6ADB1DE5937351DA,42151,16,19,3,35,45,1795
48781,48781,C97D1EB6332A2DCE6ADB1DE5937351DA,42971,21,23,2,43,49,2199
48782,48782,0A1386913DE713CBA72662A5149627A3,13711,0,7,7,38,46,1946
48783,48783,0A1386913DE713CBA72662A5149627A3,11941,8,11,3,37,46,1896
48784,48784,0A1386913DE713CBA72662A5149627A3,13711,13,16,3,38,46,1946
48785,48785,0A1386913DE713CBA72662A5149627A3,11941,18,19,1,37,46,1896
48786,48786,0A1386913DE713CBA72662A5149627A3,13711,21,22,1,38,46,1946
48787,48787,C7D4935453BFEC1CB164593EE1B84EA4,15391,2,7,5,35,26,1776
48788,48788,C7D4935453BFEC1CB164593EE1B84EA4,12792,10,12,2,34,30,1730
48789,48789,C7D4935453BFEC1CB164593EE1B84EA4,15391,12,20,8,35,26,1776
48793,48793,48E15F7773EDEEFF950E5A2CE7CBD12F,19114,0,14,14,7,43,393
48794,48794,48E15F7773EDEEFF950E5A2CE7CBD12F,12641,14,16,2,10,43,543
48795,48795,48E15F7773EDEEFF950E5A2CE7CBD12F,11321,20,23,3,31,46,1596
48813,48813,4A1E2DF13E9399DEAE7966E1EFE6FC6B,13271,0,4,4,41,47,2097
48814,48814,4A1E2DF13E9399DEAE7966E1EFE6FC6B,42151,6,13,7,35,45,1795
48815,48815,4A1E2DF13E9399DEAE7966E1EFE6FC6B,10631,14,19,5,28,46,1446
48816,48816,DFD8836E65E65C75E2AB8852C9883CE9,10292,1,9,8,30,47,1547
48817,48817,DFD8836E65E65C75E2AB8852C9883CE9,11061,12,15,3,29,48,1498
48818,48818,DFD8836E65E65C75E2AB8852C9883CE9,40341,15,17,2,23,49,1199
48819,48819,DFD8836E65E65C75E2AB8852C9883CE9,11061,18,20,2,29,48,1498
48820,48820,CAD1FFF41FBB07303E4F900E7ED6962A,43391,0,12,12,29,48,1498
48821,48821,CAD1FFF41FBB07303E4F900E7ED6962A,10151,13,15,2,34,47,1747
48822,48822,CAD1FFF41FBB07303E4F900E7ED6962A,43391,19,23,4,29,48,1498
48823,48823,00ED2280FB2BEC22D8FB36F8A7AFB1A5,42151,0,8,8,35,45,1795
48824,48824,00ED2280FB2BEC22D8FB36F8A7AFB1A5,13121,9,11,2,38,46,1946
48825,48825,00ED2280FB2BEC22D8FB36F8A7AFB1A5,10271,13,14,1,37,46,1896
48826,48826,00ED2280FB2BEC22D8FB36F8A7AFB1A5,13121,14,19,5,38,46,1946
48827,48827,00ED2280FB2BEC22D8FB36F8A7AFB1A5,42791,21,23,2,35,45,1795
48828,48828,1C12FD1823A36FA85667FC8316128B0A,13681,1,4,3,38,47,1947
48829,48829,1C12FD1823A36FA85667FC8316128B0A,13121,7,8,1,38,46,1946
48830,48830,1C12FD1823A36FA85667FC8316128B0A,13331,12,18,6,38,47,1947
48831,48831,1C12FD1823A36FA85667FC8316128B0A,13121,20,21,1,38,46,1946
48832,48832,1C12FD1823A36FA85667FC8316128B0A,13331,21,22,1,38,47,1947
48836,48836,8B0DA6168EF35F0A187851C6201FC197,43761,0,10,10,32,47,1647
48837,48837,8B0DA6168EF35F0A187851C6201FC197,40073,13,18,5,37,48,1898
48838,48838,8B0DA6168EF35F0A187851C6201FC197,43761,18,23,5,32,47,1647
48848,48848,6294C6841D209A4AD6799616BF189C3A,15051,0,6,6,19,4,954
48849,48849,6294C6841D209A4AD6799616BF189C3A,16211,7,10,3,4,3,203
48850,48850,6294C6841D209A4AD6799616BF189C3A,15051,11,23,12,19,4,954
48855,48855,5559FB469A4DC81853CEA806DAF57F7A,11741,3,11,8,42,49,2149
48856,48856,5559FB469A4DC81853CEA806DAF57F7A,11861,12,13,1,32,47,1647
48857,48857,5559FB469A4DC81853CEA806DAF57F7A,11031,13,17,4,42,49,2149
48858,48858,5559FB469A4DC81853CEA806DAF57F7A,42261,19,20,1,25,49,1299
48859,48859,9C17C707743AE50FBFFE4446783207FB,10381,2,12,10,31,49,1599
48860,48860,9C17C707743AE50FBFFE4446783207FB,11701,15,17,2,43,48,2198
48861,48861,9C17C707743AE50FBFFE4446783207FB,10381,18,20,2,31,49,1599
48862,48862,9C17C707743AE50FBFFE4446783207FB,11201,21,22,1,35,49,1799
48863,48863,0E15468F284D0B2CB2F3413AC7772E23,43581,0,6,6,33,48,1698
48864,48864,0E15468F284D0B2CB2F3413AC7772E23,42941,9,11,2,37,47,1897
48865,48865,0E15468F284D0B2CB2F3413AC7772E23,43731,14,15,1,34,47,1747
48866,48866,0E15468F284D0B2CB2F3413AC7772E23,10691,18,23,5,33,48,1698
48874,48874,372A21350F3884793152DCFF165CE566,13341,0,5,5,44,45,2245
48875,48875,372A21350F3884793152DCFF165CE566,12561,6,7,1,45,43,2293
48876,48876,372A21350F3884793152DCFF165CE566,13341,9,11,2,44,45,2245
48877,48877,372A21350F3884793152DCFF165CE566,12561,13,16,3,45,43,2293
48878,48878,372A21350F3884793152DCFF165CE566,13341,19,23,4,44,45,2245
48882,48882,232A65D7E72D31ED563D0041FCDF23A8,43011,0,4,4,40,42,2042
48883,48883,232A65D7E72D31ED563D0041FCDF23A8,42151,4,5,1,35,45,1795
48884,48884,232A65D7E72D31ED563D0041FCDF23A8,12491,6,14,8,36,43,1843
48885,48885,232A65D7E72D31ED563D0041FCDF23A8,42151,16,19,3,35,45,1795
48886,48886,ECE0FA03A797FCAE4E058BD1C3356073,42161,0,8,8,36,47,1847
48887,48887,ECE0FA03A797FCAE4E058BD1C3356073,10111,8,20,12,37,47,1897
48888,48888,ECE0FA03A797FCAE4E058BD1C3356073,13961,21,23,2,42,48,2148
48896,48896,02520C980C83C228272F82E550C0374E,11061,1,2,1,29,48,1498
48897,48897,02520C980C83C228272F82E550C0374E,10381,2,6,4,31,49,1599
48898,48898,02520C980C83C228272F82E550C0374E,11061,6,7,1,29,48,1498
48899,48899,02520C980C83C228272F82E550C0374E,13094,10,13,3,21,42,1092
48900,48900,02520C980C83C228272F82E550C0374E,10381,13,15,2,31,49,1599
48901,48901,02520C980C83C228272F82E550C0374E,11061,17,22,5,29,48,1498
48902,48902,92E1BAA88B052422B820ED36A9E8F107,11701,0,5,5,43,48,2198
48903,48903,92E1BAA88B052422B820ED36A9E8F107,11271,7,9,2,37,48,1898
48904,48904,92E1BAA88B052422B820ED36A9E8F107,41392,11,13,2,43,48,2198
48905,48905,92E1BAA88B052422B820ED36A9E8F107,11271,14,16,2,37,48,1898
48906,48906,92E1BAA88B052422B820ED36A9E8F107,41392,20,23,3,43,48,2198
48907,48907,ACD04627348D28EB014FAB46490D4B92,10351,1,10,9,28,45,1445
48908,48908,ACD04627348D28EB014FAB46490D4B92,12601,10,11,1,25,47,1297
48909,48909,ACD04627348D28EB014FAB46490D4B92,13771,13,14,1,21,45,1095
48910,48910,ACD04627348D28EB014FAB46490D4B92,13094,19,21,2,21,42,1092
48911,48911,ACD04627348D28EB014FAB46490D4B92,10351,22,23,1,28,45,1445
48912,48912,749B796E573CC68A347283ADE6C5408A,42341,0,8,8,43,49,2199
48913,48913,749B796E573CC68A347283ADE6C5408A,10921,11,12,1,43,48,2198
48914,48914,749B796E573CC68A347283ADE6C5408A,12021,13,14,1,37,49,1899
48915,48915,749B796E573CC68A347283ADE6C5408A,10924,15,23,8,43,49,2199
48916,48916,42C74C72D35B339ED05BC27A3DEC0690,19031,0,14,14,1,42,92
48917,48917,42C74C72D35B339ED05BC27A3DEC0690,12641,15,17,2,10,43,543
48918,48918,42C74C72D35B339ED05BC27A3DEC0690,19031,20,22,2,1,42,92
48925,48925,B8CB58C24E169269E8ABC8B36E47359B,11651,1,8,7,33,47,1697
48926,48926,B8CB58C24E169269E8ABC8B36E47359B,19114,12,13,1,7,43,393
48927,48927,B8CB58C24E169269E8ABC8B36E47359B,19021,16,19,3,10,45,545
48928,48928,B8CB58C24E169269E8ABC8B36E47359B,12641,20,21,1,10,43,543
48929,48929,444597F7EFF5A7E1907CA30A2B90B077,43761,0,4,4,32,47,1647
48930,48930,444597F7EFF5A7E1907CA30A2B90B077,42521,4,5,1,31,47,1597
48931,48931,444597F7EFF5A7E1907CA30A2B90B077,13821,8,11,3,49,45,2495
48932,48932,444597F7EFF5A7E1907CA30A2B90B077,13951,12,13,1,47,45,2395
48933,48933,444597F7EFF5A7E1907CA30A2B90B077,42521,17,18,1,31,47,1597
48934,48934,444597F7EFF5A7E1907CA30A2B90B077,40341,19,20,1,23,49,1199
48939,48939,F06696253146EEBB7842F43A19CD992F,19801,1,4,3,19,26,976
48940,48940,F06696253146EEBB7842F43A19CD992F,43121,7,9,2,25,27,1277
48941,48941,F06696253146EEBB7842F43A19CD992F,19801,9,23,14,19,26,976
48949,48949,947EE86E96DF76B9619AD7271E46BF1E,15191,0,9,9,36,27,1827
48950,48950,947EE86E96DF76B9619AD7271E46BF1E,15201,14,15,1,42,16,2116
48951,48951,947EE86E96DF76B9619AD7271E46BF1E,15191,17,23,6,36,27,1827
48955,48955,8436FA510D59B3814E50B7F18BD1D92C,43644,0,1,1,14,38,738
48956,48956,8436FA510D59B3814E50B7F18BD1D92C,19571,1,5,4,1,36,86
48957,48957,8436FA510D59B3814E50B7F18BD1D92C,12641,6,8,2,10,43,543
48958,48958,8436FA510D59B3814E50B7F18BD1D92C,43644,11,12,1,14,38,738
48959,48959,8436FA510D59B3814E50B7F18BD1D92C,19571,13,14,1,1,36,86
48960,48960,8436FA510D59B3814E50B7F18BD1D92C,12641,15,19,4,10,43,543
48961,48961,4CDC8B55805F54C701951AA286ACE261,42521,0,8,8,31,47,1597
48962,48962,4CDC8B55805F54C701951AA286ACE261,11954,12,13,1,32,49,1649
48963,48963,4CDC8B55805F54C701951AA286ACE261,42521,16,18,2,31,47,1597
48964,48964,4CDC8B55805F54C701951AA286ACE261,11751,21,22,1,35,48,1798
48968,48968,3F29D0D409D1B6D4E7D2087740FD0BBC,42401,0,2,2,36,47,1847
48969,48969,3F29D0D409D1B6D4E7D2087740FD0BBC,40673,2,3,1,36,48,1848
48970,48970,3F29D0D409D1B6D4E7D2087740FD0BBC,10251,5,13,8,35,47,1797
48971,48971,3F29D0D409D1B6D4E7D2087740FD0BBC,11074,16,17,1,37,47,1897
48972,48972,3F29D0D409D1B6D4E7D2087740FD0BBC,10251,18,23,5,35,47,1797
48973,48973,43125D201B2090874D2E0EE6E6251F06,13561,0,1,1,37,49,1899
48974,48974,43125D201B2090874D2E0EE6E6251F06,10111,1,10,9,37,47,1897
48975,48975,43125D201B2090874D2E0EE6E6251F06,10491,12,14,2,33,48,1698
48976,48976,43125D201B2090874D2E0EE6E6251F06,10191,14,16,2,40,48,2048
48977,48977,43125D201B2090874D2E0EE6E6251F06,10491,16,21,5,33,48,1698
48978,48978,DE3ACBBFFF90250B316F62451B8DF01D,10901,0,8,8,35,48,1798
48979,48979,DE3ACBBFFF90250B316F62451B8DF01D,42981,9,11,2,36,49,1849
48980,48980,DE3ACBBFFF90250B316F62451B8DF01D,10251,12,13,1,35,47,1797
48981,48981,DE3ACBBFFF90250B316F62451B8DF01D,13511,13,15,2,34,48,1748
48982,48982,DE3ACBBFFF90250B316F62451B8DF01D,11551,15,19,4,39,49,1999
48983,48983,90CAE68E57E6D6254F2E8F80F351FD91,10721,0,11,11,31,48,1598
48984,48984,90CAE68E57E6D6254F2E8F80F351FD91,11541,11,16,5,35,49,1799
48985,48985,90CAE68E57E6D6254F2E8F80F351FD91,42121,20,23,3,26,49,1349
48989,48989,827BF5EA812D262D83B15CA76EB0A042,15381,0,17,17,19,21,971
48990,48990,827BF5EA812D262D83B15CA76EB0A042,19051,17,20,3,16,23,823
48991,48991,827BF5EA812D262D83B15CA76EB0A042,15381,22,23,1,19,21,971
48995,48995,392F2B932A839BB0C6F602E5FA556570,11074,0,5,5,37,47,1897
48996,48996,392F2B932A839BB0C6F602E5FA556570,15311,8,10,2,43,25,2175
48997,48997,392F2B932A839BB0C6F602E5FA556570,11074,12,22,10,37,47,1897
48998,48998,F49EE04071D0B4FCCD4263F4C2BBEA7A,11151,0,6,6,30,48,1548
48999,48999,F49EE04071D0B4FCCD4263F4C2BBEA7A,11061,7,13,6,29,48,1498
49000,49000,F49EE04071D0B4FCCD4263F4C2BBEA7A,40691,14,16,2,42,48,2148
49001,49001,F49EE04071D0B4FCCD4263F4C2BBEA7A,11061,18,20,2,29,48,1498
49002,49002,F49EE04071D0B4FCCD4263F4C2BBEA7A,10681,20,21,1,30,48,1548
49006,49006,6E490D907A7F7D7A9707FACC4A45B418,10491,0,7,7,33,48,1698
49007,49007,6E490D907A7F7D7A9707FACC4A45B418,42231,12,18,6,37,46,1896
49008,49008,6E490D907A7F7D7A9707FACC4A45B418,10491,19,21,2,33,48,1698
49009,49009,1C0548F40841AD0870DAD8EC7BECCBC6,13314,0,7,7,31,39,1589
49010,49010,1C0548F40841AD0870DAD8EC7BECCBC6,12521,7,10,3,35,41,1791
49011,49011,1C0548F40841AD0870DAD8EC7BECCBC6,13314,11,13,2,31,39,1589
49012,49012,1C0548F40841AD0870DAD8EC7BECCBC6,12521,15,18,3,35,41,1791
49013,49013,1C0548F40841AD0870DAD8EC7BECCBC6,13314,20,23,3,31,39,1589
49017,49017,3C07D1557002BF4F1AA6A6D7A8949EF2,42523,5,6,1,31,47,1597
49018,49018,3C07D1557002BF4F1AA6A6D7A8949EF2,43761,8,9,1,32,47,1647
49019,49019,3C07D1557002BF4F1AA6A6D7A8949EF2,40951,13,15,2,36,49,1849
49020,49020,3C07D1557002BF4F1AA6A6D7A8949EF2,42523,19,21,2,31,47,1597
49021,49021,A0EE75606D6AF48009C92FBC2FC48CD7,11753,6,15,9,35,48,1798
49022,49022,A0EE75606D6AF48009C92FBC2FC48CD7,40341,16,20,4,23,49,1199
49023,49023,A0EE75606D6AF48009C92FBC2FC48CD7,11753,21,22,1,35,48,1798
49030,49030,9C0ACC78786AB3EDB58D985A680EE622,13341,3,4,1,44,45,2245
49031,49031,9C0ACC78786AB3EDB58D985A680EE622,42031,4,8,4,40,46,2046
49032,49032,9C0ACC78786AB3EDB58D985A680EE622,13341,11,19,8,44,45,2245
49033,49033,9C0ACC78786AB3EDB58D985A680EE622,42631,20,21,1,43,45,2195
49034,49034,2F66AC01887397A198C9CCA6611EA97B,12521,0,7,7,35,41,1791
49035,49035,2F66AC01887397A198C9CCA6611EA97B,13314,7,8,1,31,39,1589
49036,49036,2F66AC01887397A198C9CCA6611EA97B,12521,8,13,5,35,41,1791
49037,49037,2F66AC01887397A198C9CCA6611EA97B,13314,14,16,2,31,39,1589
49038,49038,2F66AC01887397A198C9CCA6611EA97B,12521,16,23,7,35,41,1791
49039,49039,8754D75561ECA9632B70CECEA43ED98F,11271,0,13,13,37,48,1898
49040,49040,8754D75561ECA9632B70CECEA43ED98F,11491,16,17,1,36,47,1847
49041,49041,8754D75561ECA9632B70CECEA43ED98F,19021,21,23,2,10,45,545
49042,49042,46522EFA89C36DE95E4B36441A6B7BD4,11061,5,8,3,29,48,1498
49043,49043,46522EFA89C36DE95E4B36441A6B7BD4,12601,11,12,1,25,47,1297
49044,49044,46522EFA89C36DE95E4B36441A6B7BD4,19031,17,23,6,1,42,92
49045,49045,3AB35E62E3464B5074E82DE69E9DD0D9,42501,0,7,7,28,47,1447
49046,49046,3AB35E62E3464B5074E82DE69E9DD0D9,19441,8,17,9,8,46,446
49047,49047,3AB35E62E3464B5074E82DE69E9DD0D9,42501,22,23,1,28,47,1447
49052,49052,642CD1BCB1D6034CF33B22265CC8DC30,43501,1,8,7,27,48,1398
49053,49053,642CD1BCB1D6034CF33B22265CC8DC30,11271,11,13,2,37,48,1898
49054,49054,642CD1BCB1D6034CF33B22265CC8DC30,11061,14,23,9,29,48,1498
49055,49055,9442AAEA05C831A2075E8352FC15EF6E,10191,2,9,7,40,48,2048
49056,49056,9442AAEA05C831A2075E8352FC15EF6E,11521,10,11,1,41,48,2098
49057,49057,9442AAEA05C831A2075E8352FC15EF6E,11871,13,16,3,29,46,1496
49058,49058,9442AAEA05C831A2075E8352FC15EF6E,10351,16,18,2,28,45,1445
49059,49059,9442AAEA05C831A2075E8352FC15EF6E,10191,21,23,2,40,48,2048
49060,49060,C7C431E83C90A041B3FA2A63798CE4F8,43021,0,17,17,16,43,843
49061,49061,C7C431E83C90A041B3FA2A63798CE4F8,19261,18,19,1,6,37,337
49062,49062,C7C431E83C90A041B3FA2A63798CE4F8,12921,20,21,1,9,41,491
49066,49066,9C853A4D5C7B5210EB733E5032A36376,11021,0,16,16,36,49,1849
49067,49067,9C853A4D5C7B5210EB733E5032A36376,11061,18,20,2,29,48,1498
49068,49068,9C853A4D5C7B5210EB733E5032A36376,11021,21,23,2,36,49,1849
49073,49073,9BBBC00C93BA6A3176E2B008E6F8A88E,12211,1,5,4,41,44,2094
49074,49074,9BBBC00C93BA6A3176E2B008E6F8A88E,13911,5,9,4,39,46,1996
49075,49075,9BBBC00C93BA6A3176E2B008E6F8A88E,11261,9,10,1,36,46,1846
49076,49076,9BBBC00C93BA6A3176E2B008E6F8A88E,13911,12,14,2,39,46,1996
49077,49077,9BBBC00C93BA6A3176E2B008E6F8A88E,11261,14,15,1,36,46,1846
49078,49078,9BBBC00C93BA6A3176E2B008E6F8A88E,13911,16,22,6,39,46,1996
49086,49086,CC6A63734928B4CD8F414AAB01241B9F,10611,0,10,10,32,48,1648
49087,49087,CC6A63734928B4CD8F414AAB01241B9F,43011,12,13,1,40,42,2042
49088,49088,CC6A63734928B4CD8F414AAB01241B9F,10611,14,15,1,32,48,1648
49089,49089,CC6A63734928B4CD8F414AAB01241B9F,11954,19,20,1,32,49,1649
49090,49090,CC6A63734928B4CD8F414AAB01241B9F,11021,20,23,3,36,49,1849
49094,49094,13CC40471AC83D6354BC2D2A78721A9B,10721,0,9,9,31,48,1598
49095,49095,13CC40471AC83D6354BC2D2A78721A9B,11701,12,14,2,43,48,2198
49096,49096,13CC40471AC83D6354BC2D2A78721A9B,10721,19,21,2,31,48,1598
49097,49097,A1B1493AD1E4959D25E397CB780FB65E,42531,6,7,1,31,45,1595
49098,49098,A1B1493AD1E4959D25E397CB780FB65E,12311,7,8,1,30,44,1544
49099,49099,A1B1493AD1E4959D25E397CB780FB65E,11861,8,10,2,32,47,1647
49100,49100,A1B1493AD1E4959D25E397CB780FB65E,42531,11,14,3,31,45,1595
49101,49101,A1B1493AD1E4959D25E397CB780FB65E,12311,14,17,3,30,44,1544
49102,49102,A1B1493AD1E4959D25E397CB780FB65E,42531,18,21,3,31,45,1595
49103,49103,151AF07FE1353F98EA8933566E4D900D,43021,0,1,1,16,43,843
49104,49104,151AF07FE1353F98EA8933566E4D900D,12921,3,8,5,9,41,491
49105,49105,151AF07FE1353F98EA8933566E4D900D,43021,8,13,5,16,43,843
49106,49106,151AF07FE1353F98EA8933566E4D900D,12921,17,23,6,9,41,491
49107,49107,C84A9D4D24D37197781F0B4239A0807B,42633,0,7,7,42,46,2146
49108,49108,C84A9D4D24D37197781F0B4239A0807B,43471,10,11,1,31,49,1599
49109,49109,C84A9D4D24D37197781F0B4239A0807B,42081,12,13,1,24,49,1249
49110,49110,C84A9D4D24D37197781F0B4239A0807B,43471,16,18,2,31,49,1599
49111,49111,C84A9D4D24D37197781F0B4239A0807B,42633,19,23,4,42,46,2146
49112,49112,247667C3836D06BFE77381F6E8AF78B9,43981,1,8,7,36,49,1849
49113,49113,247667C3836D06BFE77381F6E8AF78B9,41393,12,13,1,43,49,2199
49114,49114,247667C3836D06BFE77381F6E8AF78B9,10121,13,16,3,36,49,1849
49115,49115,247667C3836D06BFE77381F6E8AF78B9,11781,21,22,1,38,49,1949
49120,49120,74B27DFDFF29718AB931BE142AC67576,11571,10,11,1,13,46,696
49121,49121,74B27DFDFF29718AB931BE142AC67576,19441,13,16,3,8,46,446
49122,49122,74B27DFDFF29718AB931BE142AC67576,11201,18,20,2,35,49,1799
49126,49126,59269BD1EB55D92351CAC27C11455378,10331,0,1,1,39,46,1996
49127,49127,59269BD1EB55D92351CAC27C11455378,43341,2,6,4,41,46,2096
49128,49128,59269BD1EB55D92351CAC27C11455378,10331,7,8,1,39,46,1996
49129,49129,59269BD1EB55D92351CAC27C11455378,12601,15,16,1,25,47,1297
49130,49130,59269BD1EB55D92351CAC27C11455378,10331,17,23,6,39,46,1996
49131,49131,649CA0B4C9C73F10630BCAC6C100E533,42291,0,6,6,29,48,1498
49132,49132,649CA0B4C9C73F10630BCAC6C100E533,12311,7,12,5,30,44,1544
49133,49133,649CA0B4C9C73F10630BCAC6C100E533,42151,15,18,3,35,45,1795
49137,49137,0C67E52564A59548E0D196BFCB2BFDD6,13671,1,3,2,27,43,1393
49138,49138,0C67E52564A59548E0D196BFCB2BFDD6,12521,4,6,2,35,41,1791
49139,49139,0C67E52564A59548E0D196BFCB2BFDD6,11281,6,7,1,27,40,1390
49140,49140,0C67E52564A59548E0D196BFCB2BFDD6,13671,8,19,11,27,43,1393
49141,49141,0C67E52564A59548E0D196BFCB2BFDD6,42523,21,22,1,31,47,1597
49145,49145,9DB2D1D0B4A24CCB14E8E155246D6FB0,10111,1,7,6,37,47,1897
49146,49146,9DB2D1D0B4A24CCB14E8E155246D6FB0,11261,10,15,5,36,46,1846
49147,49147,9DB2D1D0B4A24CCB14E8E155246D6FB0,13911,16,17,1,39,46,1996
49148,49148,9DB2D1D0B4A24CCB14E8E155246D6FB0,42531,18,20,2,31,45,1595
49149,49149,DE69FEBC50432F9871EF62D07F7A5C1A,19181,0,12,12,8,40,440
49150,49150,DE69FEBC50432F9871EF62D07F7A5C1A,43021,13,14,1,16,43,843
49151,49151,DE69FEBC50432F9871EF62D07F7A5C1A,19181,15,21,6,8,40,440
49152,49152,E886E5251030835554FC7C0727BBE348,43121,6,7,1,25,27,1277
49153,49153,E886E5251030835554FC7C0727BBE348,12871,9,14,5,22,33,1133
49154,49154,E886E5251030835554FC7C0727BBE348,19801,15,17,2,19,26,976
49155,49155,E886E5251030835554FC7C0727BBE348,12871,18,20,2,22,33,1133
49156,49156,68D66AC2F31097852E1113FCAC38B096,42531,0,4,4,31,45,1595
49157,49157,68D66AC2F31097852E1113FCAC38B096,12121,5,6,1,29,47,1497
49158,49158,68D66AC2F31097852E1113FCAC38B096,42531,8,10,2,31,45,1595
49159,49159,68D66AC2F31097852E1113FCAC38B096,12311,11,17,6,30,44,1544
49160,49160,68D66AC2F31097852E1113FCAC38B096,42531,22,23,1,31,45,1595
49161,49161,D14C3775E31C254286856A2CF7979B8E,11021,0,1,1,36,49,1849
49162,49162,D14C3775E31C254286856A2CF7979B8E,11331,1,2,1,37,48,1898
49163,49163,D14C3775E31C254286856A2CF7979B8E,11021,3,8,5,36,49,1849
49164,49164,D14C3775E31C254286856A2CF7979B8E,11541,10,15,5,35,49,1799
49165,49165,D14C3775E31C254286856A2CF7979B8E,11021,19,22,3,36,49,1849
49169,49169,04D73C3CD00D40CB611F6BA5801F802C,13314,3,6,3,31,39,1589
49170,49170,04D73C3CD00D40CB611F6BA5801F802C,12521,7,9,2,35,41,1791
49171,49171,04D73C3CD00D40CB611F6BA5801F802C,13314,12,13,1,31,39,1589
49172,49172,04D73C3CD00D40CB611F6BA5801F802C,12521,13,16,3,35,41,1791
49173,49173,04D73C3CD00D40CB611F6BA5801F802C,13314,19,23,4,31,39,1589
49178,49178,D5AEB0275C07F9A43E4282B7A52A66F5,11061,0,9,9,29,48,1498
49179,49179,D5AEB0275C07F9A43E4282B7A52A66F5,40463,10,13,3,38,49,1949
49180,49180,D5AEB0275C07F9A43E4282B7A52A66F5,11061,15,23,8,29,48,1498
49181,49181,034A60A97E7096EFB0F8D8B05344F545,11941,0,6,6,37,46,1896
49182,49182,034A60A97E7096EFB0F8D8B05344F545,16016,10,13,3,4,5,205
49183,49183,034A60A97E7096EFB0F8D8B05344F545,16241,14,17,3,3,3,153
49184,49184,034A60A97E7096EFB0F8D8B05344F545,11941,22,23,1,37,46,1896
49185,49185,AE9DABC8C76DE8782FA56379E8CBF939,10544,0,8,8,28,48,1448
49186,49186,AE9DABC8C76DE8782FA56379E8CBF939,11631,9,15,6,12,49,649
49187,49187,AE9DABC8C76DE8782FA56379E8CBF939,43501,21,23,2,27,48,1398
49196,49196,7A81F5210B57E099F5123D938700B598,11381,0,7,7,30,47,1547
49197,49197,7A81F5210B57E099F5123D938700B598,11021,9,12,3,36,49,1849
49198,49198,7A81F5210B57E099F5123D938700B598,11381,15,16,1,30,47,1547
49199,49199,7A81F5210B57E099F5123D938700B598,43971,16,23,7,30,48,1548
49200,49200,C835E6210B7202CB0069BE7CD60437DC,10281,0,8,8,33,48,1698
49201,49201,C835E6210B7202CB0069BE7CD60437DC,10107,8,12,4,38,49,1949
49202,49202,C835E6210B7202CB0069BE7CD60437DC,10281,14,18,4,33,48,1698
49209,49209,AFAE133FA88B98A999C46702AA923186,42301,0,11,11,36,47,1847
49210,49210,AFAE133FA88B98A999C46702AA923186,13311,12,18,6,27,39,1389
49211,49211,AFAE133FA88B98A999C46702AA923186,40341,20,22,2,23,49,1199
49212,49212,01308B72F71E3AACC045F922DA6CAE4D,10341,10,12,2,31,47,1597
49213,49213,01308B72F71E3AACC045F922DA6CAE4D,13671,14,15,1,27,43,1393
49214,49214,01308B72F71E3AACC045F922DA6CAE4D,43761,18,19,1,32,47,1647
49215,49215,01308B72F71E3AACC045F922DA6CAE4D,42523,20,21,1,31,47,1597
49216,49216,7C715FFD8A4BAD934A322B8DA7E771CE,11481,0,2,2,41,48,2098
49217,49217,7C715FFD8A4BAD934A322B8DA7E771CE,13101,5,6,1,40,47,2047
49218,49218,7C715FFD8A4BAD934A322B8DA7E771CE,11481,6,8,2,41,48,2098
49219,49219,7C715FFD8A4BAD934A322B8DA7E771CE,13101,9,10,1,40,47,2047
49220,49220,7C715FFD8A4BAD934A322B8DA7E771CE,11001,11,12,1,42,47,2147
49221,49221,7C715FFD8A4BAD934A322B8DA7E771CE,13101,15,18,3,40,47,2047
49229,49229,9AA09FAFA3A0B94587220E28842ADF00,42961,0,3,3,35,49,1799
49230,49230,9AA09FAFA3A0B94587220E28842ADF00,42801,4,6,2,40,49,2049
49231,49231,9AA09FAFA3A0B94587220E28842ADF00,10787,10,20,10,38,46,1946
49232,49232,F2971C3C111263F217176C0D8DBD4C49,10061,7,12,5,20,46,1046
49233,49233,F2971C3C111263F217176C0D8DBD4C49,11914,14,16,2,37,48,1898
49234,49234,F2971C3C111263F217176C0D8DBD4C49,40981,18,21,3,34,47,1747
49235,49235,575F15711A212687CC424730A6AC2984,10295,0,8,8,30,47,1547
49236,49236,575F15711A212687CC424730A6AC2984,40341,10,11,1,23,49,1199
49237,49237,575F15711A212687CC424730A6AC2984,42523,13,14,1,31,47,1597
49238,49238,575F15711A212687CC424730A6AC2984,40041,18,19,1,40,49,2049
49239,49239,775CA947FF37432092AA3395F5AA137B,11171,0,8,8,33,48,1698
49240,49240,775CA947FF37432092AA3395F5AA137B,10111,11,13,2,37,47,1897
49241,49241,775CA947FF37432092AA3395F5AA137B,42161,14,23,9,36,47,1847
49242,49242,72728458BA71393F557B9B934896CD12,13011,0,8,8,39,47,1997
49243,49243,72728458BA71393F557B9B934896CD12,43451,8,10,2,37,40,1890
49244,49244,72728458BA71393F557B9B934896CD12,13011,11,18,7,39,47,1997
49245,49245,72728458BA71393F557B9B934896CD12,13331,19,22,3,38,47,1947
49246,49246,90AEBDFF2A6C58E27BB377D4DD4D3E61,10711,0,4,4,29,46,1496
49247,49247,90AEBDFF2A6C58E27BB377D4DD4D3E61,12311,5,9,4,30,44,1544
49248,49248,90AEBDFF2A6C58E27BB377D4DD4D3E61,10634,9,11,2,27,45,1395
49249,49249,90AEBDFF2A6C58E27BB377D4DD4D3E61,12311,11,13,2,30,44,1544
49250,49250,90AEBDFF2A6C58E27BB377D4DD4D3E61,10634,14,15,1,27,45,1395
49251,49251,90AEBDFF2A6C58E27BB377D4DD4D3E61,12311,15,18,3,30,44,1544
49252,49252,35DAC6756C7F4B57C2B1C6F65896CD31,10351,0,5,5,28,45,1445
49253,49253,35DAC6756C7F4B57C2B1C6F65896CD31,12601,5,7,2,25,47,1297
49254,49254,35DAC6756C7F4B57C2B1C6F65896CD31,10351,7,12,5,28,45,1445
49255,49255,35DAC6756C7F4B57C2B1C6F65896CD31,12601,13,21,8,25,47,1297
49256,49256,55960917A21F334DC0067ED5B79EFDF4,11911,0,6,6,37,48,1898
49257,49257,55960917A21F334DC0067ED5B79EFDF4,42461,7,8,1,45,47,2297
49258,49258,55960917A21F334DC0067ED5B79EFDF4,11701,10,13,3,43,48,2198
49259,49259,55960917A21F334DC0067ED5B79EFDF4,11911,18,23,5,37,48,1898
49260,49260,8FFDEB2573593D2EBFD07303D94AB87F,42321,0,17,17,43,47,2197
49261,49261,8FFDEB2573593D2EBFD07303D94AB87F,11771,19,20,1,39,49,1999
49262,49262,8FFDEB2573593D2EBFD07303D94AB87F,42321,20,23,3,43,47,2197
49269,49269,5EA4DF9236E98845ACB80913F5636AE6,11481,0,10,10,41,48,2098
49270,49270,5EA4DF9236E98845ACB80913F5636AE6,10591,12,14,2,39,48,1998
49271,49271,5EA4DF9236E98845ACB80913F5636AE6,40341,16,18,2,23,49,1199
49272,49272,5EA4DF9236E98845ACB80913F5636AE6,10591,19,21,2,39,48,1998
49273,49273,95E46EDC59FF5DC7B2780E8A91CFB9BB,19114,0,13,13,7,43,393
49274,49274,95E46EDC59FF5DC7B2780E8A91CFB9BB,12921,14,16,2,9,41,491
49275,49275,95E46EDC59FF5DC7B2780E8A91CFB9BB,19621,20,23,3,5,46,296
49276,49276,08B22EEE6E957330DAD27E7217103ACF,43011,1,8,7,40,42,2042
49277,49277,08B22EEE6E957330DAD27E7217103ACF,12514,13,20,7,38,47,1947
49278,49278,08B22EEE6E957330DAD27E7217103ACF,11914,21,22,1,37,48,1898
49279,49279,F2E0A788EC41736380A7AB3495E7AB34,42161,0,6,6,36,47,1847
49280,49280,F2E0A788EC41736380A7AB3495E7AB34,42691,10,18,8,24,48,1248
49281,49281,F2E0A788EC41736380A7AB3495E7AB34,42161,19,22,3,36,47,1847
49285,49285,D504F11B753A6CDDB38F05E0EF1C7A74,11771,0,15,15,39,49,1999
49286,49286,D504F11B753A6CDDB38F05E0EF1C7A74,43731,18,20,2,34,47,1747
49287,49287,D504F11B753A6CDDB38F05E0EF1C7A74,12401,22,23,1,39,49,1999
49288,49288,F6C54C668FECD237DA87E4FC2243153A,40171,0,1,1,38,48,1948
49289,49289,F6C54C668FECD237DA87E4FC2243153A,42321,2,7,5,43,47,2197
49290,49290,F6C54C668FECD237DA87E4FC2243153A,10691,11,15,4,33,48,1698
49291,49291,F6C54C668FECD237DA87E4FC2243153A,42321,15,17,2,43,47,2197
49292,49292,F6C54C668FECD237DA87E4FC2243153A,12401,19,20,1,39,49,1999
49293,49293,F6C54C668FECD237DA87E4FC2243153A,42321,21,23,2,43,47,2197
49297,49297,8DE4D252DA36E1365B15A8E9C0F92CC0,10544,2,3,1,28,48,1448
49298,49298,8DE4D252DA36E1365B15A8E9C0F92CC0,11151,7,8,1,30,48,1548
49299,49299,8DE4D252DA36E1365B15A8E9C0F92CC0,43391,12,13,1,29,48,1498
49300,49300,8DE4D252DA36E1365B15A8E9C0F92CC0,10107,14,17,3,38,49,1949
49301,49301,8DE4D252DA36E1365B15A8E9C0F92CC0,11151,20,22,2,30,48,1548
49306,49306,90692BFC9E8D2CC5D8B5F5F53764BF3A,11871,1,12,11,29,46,1496
49307,49307,90692BFC9E8D2CC5D8B5F5F53764BF3A,19021,13,15,2,10,45,545
49308,49308,90692BFC9E8D2CC5D8B5F5F53764BF3A,10491,18,19,1,33,48,1698
49309,49309,093DC07DC6ECFC96647B05DDE307717A,10431,0,5,5,33,49,1699
49310,49310,093DC07DC6ECFC96647B05DDE307717A,12601,10,14,4,25,47,1297
49311,49311,093DC07DC6ECFC96647B05DDE307717A,13731,18,21,3,33,49,1699
49312,49312,3AA7789035AB4DEC2E97E3010F171B32,42921,0,7,7,33,47,1697
49313,49313,3AA7789035AB4DEC2E97E3010F171B32,12311,9,11,2,30,44,1544
49314,49314,3AA7789035AB4DEC2E97E3010F171B32,42921,12,23,11,33,47,1697
49318,49318,94092014F9DD3213271810B8D19555BE,49201,0,5,5,7,41,391
49319,49319,94092014F9DD3213271810B8D19555BE,12921,5,8,3,9,41,491
49320,49320,94092014F9DD3213271810B8D19555BE,19264,9,10,1,10,36,536
49321,49321,94092014F9DD3213271810B8D19555BE,49201,11,14,3,7,41,391
49322,49322,94092014F9DD3213271810B8D19555BE,12921,14,16,2,9,41,491
49323,49323,94092014F9DD3213271810B8D19555BE,49201,20,23,3,7,41,391
49328,49328,360CAB205F052520FED1AC4C9779857A,43761,8,11,3,32,47,1647
49329,49329,360CAB205F052520FED1AC4C9779857A,10787,13,14,1,38,46,1946
49330,49330,360CAB205F052520FED1AC4C9779857A,11941,14,23,9,37,46,1896
49331,49331,DE5F96E34E99D2F6A2C0DEB645C43B1D,42581,0,6,6,38,48,1948
49332,49332,DE5F96E34E99D2F6A2C0DEB645C43B1D,42271,9,10,1,40,47,2047
49333,49333,DE5F96E34E99D2F6A2C0DEB645C43B1D,42581,11,16,5,38,48,1948
49334,49334,DE5F96E34E99D2F6A2C0DEB645C43B1D,11631,21,22,1,12,49,649
49347,49347,C844774AE11086C600CD57D2F2D30CB9,11011,1,9,8,39,49,1999
49348,49348,C844774AE11086C600CD57D2F2D30CB9,40637,16,21,5,36,47,1847
49349,49349,C844774AE11086C600CD57D2F2D30CB9,10251,21,23,2,35,47,1797
49350,49350,19783D60B70DD47851602F72E0868D88,12381,0,9,9,32,48,1648
49351,49351,19783D60B70DD47851602F72E0868D88,43311,11,12,1,31,48,1598
49352,49352,19783D60B70DD47851602F72E0868D88,42623,13,14,1,22,49,1149
49353,49353,19783D60B70DD47851602F72E0868D88,43311,14,22,8,31,48,1598
49354,49354,C62FC38C2F2714C5C61C0792BD056B84,42971,0,15,15,43,49,2199
49355,49355,C62FC38C2F2714C5C61C0792BD056B84,42623,16,17,1,22,49,1149
49356,49356,C62FC38C2F2714C5C61C0792BD056B84,42971,20,23,3,43,49,2199
49357,49357,6C476726016CF6452D61AA39F918CC14,11381,0,7,7,30,47,1547
49358,49358,6C476726016CF6452D61AA39F918CC14,11211,10,12,2,34,49,1749
49359,49359,6C476726016CF6452D61AA39F918CC14,11381,14,21,7,30,47,1547
49368,49368,09D4E4AC27B1C2BD71280354244F178D,42121,2,7,5,26,49,1349
49369,49369,09D4E4AC27B1C2BD71280354244F178D,42461,9,16,7,45,47,2297
49370,49370,09D4E4AC27B1C2BD71280354244F178D,10231,16,19,3,39,49,1999
49371,49371,09D4E4AC27B1C2BD71280354244F178D,10161,20,22,2,35,49,1799
49375,49375,E601BB19076A4C49AFE037312E310462,12511,0,1,1,39,47,1997
49376,49376,E601BB19076A4C49AFE037312E310462,40637,5,9,4,36,47,1847
49377,49377,E601BB19076A4C49AFE037312E310462,41601,12,14,2,39,49,1999
49378,49378,E601BB19076A4C49AFE037312E310462,10471,14,18,4,37,48,1898
49379,49379,E601BB19076A4C49AFE037312E310462,11741,19,22,3,42,49,2149
49387,49387,89C5F5C036761FD2C32F64BC4CDE2E5B,19441,0,14,14,8,46,446
49388,49388,89C5F5C036761FD2C32F64BC4CDE2E5B,11531,17,19,2,34,49,1749
49389,49389,89C5F5C036761FD2C32F64BC4CDE2E5B,11201,20,23,3,35,49,1799
49394,49394,6E49C6F71E5A970917CF8DD4B702C69B,11571,0,14,14,13,46,696
49395,49395,6E49C6F71E5A970917CF8DD4B702C69B,19441,17,19,2,8,46,446
49396,49396,6E49C6F71E5A970917CF8DD4B702C69B,11571,22,23,1,13,46,696
49401,49401,1D51AC4BBFB933A632C5A69F521FA887,11861,0,11,11,32,47,1647
49402,49402,1D51AC4BBFB933A632C5A69F521FA887,11271,12,14,2,37,48,1898
49403,49403,1D51AC4BBFB933A632C5A69F521FA887,11861,14,23,9,32,47,1647
49404,49404,20DC2ED3C0C9235588177641EB478B47,11521,0,8,8,41,48,2098
49405,49405,20DC2ED3C0C9235588177641EB478B47,11231,8,9,1,37,49,1899
49406,49406,20DC2ED3C0C9235588177641EB478B47,43281,14,15,1,37,48,1898
49407,49407,20DC2ED3C0C9235588177641EB478B47,11521,18,23,5,41,48,2098
49408,49408,21BFC9B680F0329C7CDCB5AE45B398FD,10111,0,18,18,37,47,1897
49409,49409,21BFC9B680F0329C7CDCB5AE45B398FD,11301,19,20,1,41,49,2099
49410,49410,21BFC9B680F0329C7CDCB5AE45B398FD,42401,22,23,1,36,47,1847
49411,49411,0CE1530259EA66797A9FEEF237D2664E,42861,0,6,6,37,44,1894
49412,49412,0CE1530259EA66797A9FEEF237D2664E,11261,6,8,2,36,46,1846
49413,49413,0CE1530259EA66797A9FEEF237D2664E,42861,12,13,1,37,44,1894
49414,49414,0CE1530259EA66797A9FEEF237D2664E,11261,16,17,1,36,46,1846
49415,49415,0CE1530259EA66797A9FEEF237D2664E,42351,19,20,1,38,45,1945
49416,49416,0CE1530259EA66797A9FEEF237D2664E,42861,22,23,1,37,44,1894
49423,49423,C1CF59B64EE7642E956AF0C2EBE03CC9,42921,0,7,7,33,47,1697
49424,49424,C1CF59B64EE7642E956AF0C2EBE03CC9,42931,11,13,2,41,49,2099
49425,49425,C1CF59B64EE7642E956AF0C2EBE03CC9,42921,15,23,8,33,47,1697
49436,49436,39AFCCA22E25B7AD5808375802A34240,10601,0,8,8,39,47,1997
49437,49437,39AFCCA22E25B7AD5808375802A34240,12601,9,13,4,25,47,1297
49438,49438,39AFCCA22E25B7AD5808375802A34240,10601,16,23,7,39,47,1997
49439,49439,E572D34D15CCFF06895D9E2C410E6273,12971,0,2,2,32,48,1648
49440,49440,E572D34D15CCFF06895D9E2C410E6273,10381,2,8,6,31,49,1599
49441,49441,E572D34D15CCFF06895D9E2C410E6273,42471,9,10,1,35,49,1799
49442,49442,E572D34D15CCFF06895D9E2C410E6273,13511,12,14,2,34,48,1748
49443,49443,E572D34D15CCFF06895D9E2C410E6273,42511,16,18,2,37,47,1897
49444,49444,E572D34D15CCFF06895D9E2C410E6273,11531,19,20,1,34,49,1749
49445,49445,E572D34D15CCFF06895D9E2C410E6273,11201,21,23,2,35,49,1799
49449,49449,588E15A77FCC47ACFBD5B3F12EED10C8,13111,0,9,9,42,46,2146
49450,49450,588E15A77FCC47ACFBD5B3F12EED10C8,11941,12,17,5,37,46,1896
49451,49451,588E15A77FCC47ACFBD5B3F12EED10C8,13111,19,23,4,42,46,2146
49452,49452,1F899C425E1D44BC86781F60DDEF728E,43021,1,8,7,16,43,843
49453,49453,1F899C425E1D44BC86781F60DDEF728E,12921,9,10,1,9,41,491
49454,49454,1F899C425E1D44BC86781F60DDEF728E,43021,13,14,1,16,43,843
49455,49455,1F899C425E1D44BC86781F60DDEF728E,12921,15,19,4,9,41,491
49456,49456,1F899C425E1D44BC86781F60DDEF728E,19741,20,21,1,5,44,294
49457,49457,F1AA6F3E940CBB9FB719C98F8431D25C,19901,0,2,2,7,44,394
49458,49458,F1AA6F3E940CBB9FB719C98F8431D25C,12641,2,4,2,10,43,543
49459,49459,F1AA6F3E940CBB9FB719C98F8431D25C,19901,5,6,1,7,44,394
49460,49460,F1AA6F3E940CBB9FB719C98F8431D25C,19114,9,10,1,7,43,393
49461,49461,F1AA6F3E940CBB9FB719C98F8431D25C,12641,11,21,10,10,43,543
49465,49465,43DBEEA61839592A95FC32BC8064AB85,43021,10,11,1,16,43,843
49466,49466,43DBEEA61839592A95FC32BC8064AB85,12921,12,15,3,9,41,491
49467,49467,43DBEEA61839592A95FC32BC8064AB85,19114,19,23,4,7,43,393
49474,49474,890E28003097AE1252F2C7F02F9B8CC8,42531,0,8,8,31,45,1595
49475,49475,890E28003097AE1252F2C7F02F9B8CC8,13911,12,20,8,39,46,1996
49476,49476,890E28003097AE1252F2C7F02F9B8CC8,13711,21,23,2,38,46,1946
49477,49477,28C2D2FE4D28624F13409918B749F4EA,42231,0,6,6,37,46,1896
49478,49478,28C2D2FE4D28624F13409918B749F4EA,13711,7,8,1,38,46,1946
49479,49479,28C2D2FE4D28624F13409918B749F4EA,10271,10,11,1,37,46,1896
49480,49480,28C2D2FE4D28624F13409918B749F4EA,13121,15,16,1,38,46,1946
49481,49481,28C2D2FE4D28624F13409918B749F4EA,11941,16,20,4,37,46,1896
49482,49482,62F6BE848412C7FADEB816AFD62C431F,15114,0,5,5,22,16,1116
49483,49483,62F6BE848412C7FADEB816AFD62C431F,15121,5,7,2,27,19,1369
49484,49484,62F6BE848412C7FADEB816AFD62C431F,16151,9,23,14,13,11,661
49485,49485,14D6FFB5534DE2FFA4F5AA3ABCE4AA3E,42581,3,5,2,38,48,1948
49486,49486,14D6FFB5534DE2FFA4F5AA3ABCE4AA3E,11381,10,11,1,30,47,1547
49487,49487,14D6FFB5534DE2FFA4F5AA3ABCE4AA3E,11914,16,21,5,37,48,1898
49494,49494,1FC4F5AE28145DF62C388FF9D126D3CA,42071,2,3,1,31,49,1599
49495,49495,1FC4F5AE28145DF62C388FF9D126D3CA,42623,11,14,3,22,49,1149
49496,49496,1FC4F5AE28145DF62C388FF9D126D3CA,42071,17,19,2,31,49,1599
49497,49497,25CC66D599A64006DB1C07E7C87CDB76,12921,0,2,2,9,41,491
49498,49498,25CC66D599A64006DB1C07E7C87CDB76,12641,2,4,2,10,43,543
49499,49499,25CC66D599A64006DB1C07E7C87CDB76,12921,5,13,8,9,41,491
49500,49500,25CC66D599A64006DB1C07E7C87CDB76,43021,13,16,3,16,43,843
49501,49501,25CC66D599A64006DB1C07E7C87CDB76,12921,16,17,1,9,41,491
49502,49502,25CC66D599A64006DB1C07E7C87CDB76,43021,20,22,2,16,43,843
49506,49506,28BD69FEDCB135AF0C9358D5472F1773,13511,0,8,8,34,48,1748
49507,49507,28BD69FEDCB135AF0C9358D5472F1773,10221,9,10,1,34,49,1749
49508,49508,28BD69FEDCB135AF0C9358D5472F1773,13481,13,14,1,26,31,1331
49509,49509,28BD69FEDCB135AF0C9358D5472F1773,10221,17,19,2,34,49,1749
49510,49510,28BD69FEDCB135AF0C9358D5472F1773,13511,20,23,3,34,48,1748
49511,49511,A3840FD6AF72D22CE7CDC01E0988FA68,42161,0,7,7,36,47,1847
49512,49512,A3840FD6AF72D22CE7CDC01E0988FA68,10951,7,12,5,29,48,1498
49513,49513,A3840FD6AF72D22CE7CDC01E0988FA68,42161,13,23,10,36,47,1847
49521,49521,3E3400E81F33727D0845365703B2CDF7,10161,1,7,6,35,49,1799
49522,49522,3E3400E81F33727D0845365703B2CDF7,10924,8,12,4,43,49,2199
49523,49523,3E3400E81F33727D0845365703B2CDF7,10161,13,23,10,35,49,1799
49524,49524,FBC4933E64B109CD26F7256A20ECD68E,12731,1,17,16,22,40,1140
49525,49525,FBC4933E64B109CD26F7256A20ECD68E,11861,19,20,1,32,47,1647
49526,49526,FBC4933E64B109CD26F7256A20ECD68E,12731,21,23,2,22,40,1140
49527,49527,3986432814A654D95A88696E983E9BD1,42141,0,15,15,32,47,1647
49528,49528,3986432814A654D95A88696E983E9BD1,11541,16,17,1,35,49,1799
49529,49529,3986432814A654D95A88696E983E9BD1,43041,19,20,1,41,46,2096
49530,49530,3986432814A654D95A88696E983E9BD1,10841,21,22,1,37,47,1897
49531,49531,2A91E3542FC9B1A56EDFF91DEB22828A,11161,0,9,9,32,48,1648
49532,49532,2A91E3542FC9B1A56EDFF91DEB22828A,42523,9,11,2,31,47,1597
49533,49533,2A91E3542FC9B1A56EDFF91DEB22828A,11161,11,12,1,32,48,1648
49534,49534,2A91E3542FC9B1A56EDFF91DEB22828A,10151,16,17,1,34,47,1747
49535,49535,2A91E3542FC9B1A56EDFF91DEB22828A,40341,21,22,1,23,49,1199
49545,49545,BFEEBB756647BD6C3046C6D70D6E025E,10544,0,7,7,28,48,1448
49546,49546,BFEEBB756647BD6C3046C6D70D6E025E,11151,8,10,2,30,48,1548
49547,49547,BFEEBB756647BD6C3046C6D70D6E025E,40094,11,12,1,29,48,1498
49548,49548,BFEEBB756647BD6C3046C6D70D6E025E,10544,14,18,4,28,48,1448
49549,49549,BFEEBB756647BD6C3046C6D70D6E025E,10951,18,19,1,29,48,1498
49550,49550,BFEEBB756647BD6C3046C6D70D6E025E,10544,20,23,3,28,48,1448
49568,49568,A81CA4BA2A5225CB3613F5F00564C0CF,42151,0,6,6,35,45,1795
49569,49569,A81CA4BA2A5225CB3613F5F00564C0CF,12491,7,8,1,36,43,1843
49570,49570,A81CA4BA2A5225CB3613F5F00564C0CF,40341,10,22,12,23,49,1199
49571,49571,A81CA4BA2A5225CB3613F5F00564C0CF,11151,22,23,1,30,48,1548
49572,49572,F7A05B3FECD253C9C578617425D22E9D,10661,0,2,2,37,49,1899
49573,49573,F7A05B3FECD253C9C578617425D22E9D,13351,3,7,4,48,48,2448
49574,49574,F7A05B3FECD253C9C578617425D22E9D,40302,7,9,2,40,49,2049
49575,49575,F7A05B3FECD253C9C578617425D22E9D,13471,11,14,3,47,49,2399
49576,49576,F7A05B3FECD253C9C578617425D22E9D,13351,19,23,4,48,48,2448
49577,49577,A68AC666238F956056505CB428B4A065,40073,0,7,7,37,48,1898
49578,49578,A68AC666238F956056505CB428B4A065,10661,8,9,1,37,49,1899
49579,49579,A68AC666238F956056505CB428B4A065,40341,10,12,2,23,49,1199
49580,49580,A68AC666238F956056505CB428B4A065,13351,12,13,1,48,48,2448
49581,49581,A68AC666238F956056505CB428B4A065,40073,16,18,2,37,48,1898
49590,49590,18B6761AED1C3C2339B4532D918A85A7,10431,5,8,3,33,49,1699
49591,49591,18B6761AED1C3C2339B4532D918A85A7,11171,10,12,2,33,48,1698
49592,49592,18B6761AED1C3C2339B4532D918A85A7,10431,12,14,2,33,49,1699
49593,49593,18B6761AED1C3C2339B4532D918A85A7,42401,14,16,2,36,47,1847
49594,49594,18B6761AED1C3C2339B4532D918A85A7,11875,16,18,2,30,46,1546
49595,49595,18B6761AED1C3C2339B4532D918A85A7,10431,22,23,1,33,49,1699
49596,49596,C99D4A1DBB517F54554FCFB20AA1ADB2,12381,0,7,7,32,48,1648
49597,49597,C99D4A1DBB517F54554FCFB20AA1ADB2,13091,12,13,1,20,42,1042
49598,49598,C99D4A1DBB517F54554FCFB20AA1ADB2,12601,16,17,1,25,47,1297
49599,49599,C99D4A1DBB517F54554FCFB20AA1ADB2,12381,21,23,2,32,48,1648
49606,49606,71216C3E1F8418C02DB017A852AAEF0E,43021,0,12,12,16,43,843
49607,49607,71216C3E1F8418C02DB017A852AAEF0E,12921,13,14,1,9,41,491
49608,49608,71216C3E1F8418C02DB017A852AAEF0E,43021,14,23,9,16,43,843
49612,49612,D8F61CF3289E3928FCE68B7F3A3EF9A7,43041,0,7,7,41,46,2096
49613,49613,D8F61CF3289E3928FCE68B7F3A3EF9A7,11074,7,18,11,37,47,1897
49614,49614,D8F61CF3289E3928FCE68B7F3A3EF9A7,43041,19,23,4,41,46,2096
49615,49615,2FCEA8AFEE1EB24BBCF386268B1232AC,11161,0,4,4,32,48,1648
49616,49616,2FCEA8AFEE1EB24BBCF386268B1232AC,43311,6,7,1,31,48,1598
49617,49617,2FCEA8AFEE1EB24BBCF386268B1232AC,11061,10,15,5,29,48,1498
49618,49618,2FCEA8AFEE1EB24BBCF386268B1232AC,11161,16,19,3,32,48,1648
49619,49619,2FCEA8AFEE1EB24BBCF386268B1232AC,11061,20,22,2,29,48,1498
49632,49632,24C52F5FD3AA43CF1A9BAB6BC0B1DF40,42161,0,5,5,36,47,1847
49633,49633,24C52F5FD3AA43CF1A9BAB6BC0B1DF40,43731,7,8,1,34,47,1747
49634,49634,24C52F5FD3AA43CF1A9BAB6BC0B1DF40,43161,10,11,1,35,47,1797
49635,49635,24C52F5FD3AA43CF1A9BAB6BC0B1DF40,42161,16,19,3,36,47,1847
49636,49636,24C52F5FD3AA43CF1A9BAB6BC0B1DF40,43731,20,21,1,34,47,1747
49637,49637,24C52F5FD3AA43CF1A9BAB6BC0B1DF40,42021,22,23,1,33,47,1697
49638,49638,AED747962C9908C00273D68EECB7FB61,11941,0,1,1,37,46,1896
49639,49639,AED747962C9908C00273D68EECB7FB61,11081,2,4,2,35,46,1796
49640,49640,AED747962C9908C00273D68EECB7FB61,42301,5,6,1,36,47,1847
49641,49641,AED747962C9908C00273D68EECB7FB61,11081,6,9,3,35,46,1796
49642,49642,AED747962C9908C00273D68EECB7FB61,40951,11,20,9,36,49,1849
49643,49643,AED747962C9908C00273D68EECB7FB61,43361,22,23,1,38,48,1948
49644,49644,B70267EAE88B62F9B87C2FB6E0BEE8BF,43621,0,9,9,46,48,2348
49645,49645,B70267EAE88B62F9B87C2FB6E0BEE8BF,13111,11,12,1,42,46,2146
49646,49646,B70267EAE88B62F9B87C2FB6E0BEE8BF,43621,16,20,4,46,48,2348
49647,49647,B70267EAE88B62F9B87C2FB6E0BEE8BF,42321,20,22,2,43,47,2197
49652,49652,503C825874017B94AAE9067BE859DEB7,19901,9,10,1,7,44,394
49653,49653,503C825874017B94AAE9067BE859DEB7,49201,11,13,2,7,41,391
49654,49654,503C825874017B94AAE9067BE859DEB7,43644,13,15,2,14,38,738
49655,49655,503C825874017B94AAE9067BE859DEB7,49201,16,23,7,7,41,391
49656,49656,9D3AFAB836497D9B20982A4423B1B10D,11381,0,12,12,30,47,1547
49657,49657,9D3AFAB836497D9B20982A4423B1B10D,40691,14,16,2,42,48,2148
49658,49658,9D3AFAB836497D9B20982A4423B1B10D,11301,17,18,1,41,49,2099
49659,49659,9D3AFAB836497D9B20982A4423B1B10D,10107,20,21,1,38,49,1949
49660,49660,9D3AFAB836497D9B20982A4423B1B10D,11151,22,23,1,30,48,1548
49661,49661,6FB118526D3E3A4C1190AF083475702A,43751,0,8,8,19,48,998
49662,49662,6FB118526D3E3A4C1190AF083475702A,10951,11,16,5,29,48,1498
49663,49663,6FB118526D3E3A4C1190AF083475702A,43751,17,19,2,19,48,998
49664,49664,6FB118526D3E3A4C1190AF083475702A,11101,21,22,1,18,48,948
49668,49668,CD5F8D7604C7020A19DDE3C48998E9F5,13314,1,5,4,31,39,1589
49669,49669,CD5F8D7604C7020A19DDE3C48998E9F5,12521,7,19,12,35,41,1791
49670,49670,CD5F8D7604C7020A19DDE3C48998E9F5,13314,19,23,4,31,39,1589
49671,49671,B058065183522F147594E81A7C362AFB,11074,0,9,9,37,47,1897
49672,49672,B058065183522F147594E81A7C362AFB,10401,10,11,1,33,49,1699
49673,49673,B058065183522F147594E81A7C362AFB,40112,13,15,2,32,48,1648
49674,49674,B058065183522F147594E81A7C362AFB,11806,16,18,2,41,48,2098
49675,49675,B058065183522F147594E81A7C362AFB,13961,19,20,1,42,48,2148
49697,49697,B3B9E7CAA281FDC11E6B1AB8159D5D86,11941,0,7,7,37,46,1896
49698,49698,B3B9E7CAA281FDC11E6B1AB8159D5D86,43751,9,16,7,19,48,998
49699,49699,B3B9E7CAA281FDC11E6B1AB8159D5D86,11941,19,23,4,37,46,1896
49704,49704,FB78D5322DE89BC4ACBA0A9E43B4FF54,19621,0,8,8,5,46,296
49705,49705,FB78D5322DE89BC4ACBA0A9E43B4FF54,43041,10,14,4,41,46,2096
49706,49706,FB78D5322DE89BC4ACBA0A9E43B4FF54,42341,17,18,1,43,49,2199
49707,49707,FB78D5322DE89BC4ACBA0A9E43B4FF54,41392,18,22,4,43,48,2198
49718,49718,05F4EA13CD8808AD114E6A2B54315506,13381,7,12,5,39,47,1997
49719,49719,05F4EA13CD8808AD114E6A2B54315506,11321,12,17,5,31,46,1596
49720,49720,05F4EA13CD8808AD114E6A2B54315506,13221,21,22,1,40,47,2047
49721,49721,1D750A272F60A85ED371A8258184C1BA,43061,0,8,8,43,46,2196
49722,49722,1D750A272F60A85ED371A8258184C1BA,43181,11,12,1,39,48,1998
49723,49723,1D750A272F60A85ED371A8258184C1BA,10841,14,23,9,37,47,1897
49724,49724,EE10AC6477FFD3D50107E111E624E05D,11161,7,11,4,32,48,1648
49725,49725,EE10AC6477FFD3D50107E111E624E05D,43481,14,16,2,39,48,1998
49726,49726,EE10AC6477FFD3D50107E111E624E05D,11271,18,20,2,37,48,1898
49727,49727,EE10AC6477FFD3D50107E111E624E05D,11461,20,21,1,37,49,1899
49728,49728,C587B8BBA49D2BF4E222CE1A0182D385,10931,0,10,10,41,48,2098
49729,49729,C587B8BBA49D2BF4E222CE1A0182D385,10151,13,16,3,34,47,1747
49730,49730,C587B8BBA49D2BF4E222CE1A0182D385,10107,18,23,5,38,49,1949
49737,49737,A0C13743AF441FE8099AA940DA71C612,42581,1,5,4,38,48,1948
49738,49738,A0C13743AF441FE8099AA940DA71C612,11914,5,11,6,37,48,1898
49739,49739,A0C13743AF441FE8099AA940DA71C612,42581,12,16,4,38,48,1948
49740,49740,A0C13743AF441FE8099AA940DA71C612,11914,16,19,3,37,48,1898
49741,49741,A0C13743AF441FE8099AA940DA71C612,42581,21,23,2,38,48,1948
49742,49742,D3440D1508561AD99BDA68DC5ADE94F2,42471,0,7,7,35,49,1799
49743,49743,D3440D1508561AD99BDA68DC5ADE94F2,10401,8,9,1,33,49,1699
49744,49744,D3440D1508561AD99BDA68DC5ADE94F2,11541,9,14,5,35,49,1799
49745,49745,D3440D1508561AD99BDA68DC5ADE94F2,42621,15,17,2,24,49,1249
49746,49746,D3440D1508561AD99BDA68DC5ADE94F2,11541,18,23,5,35,49,1799
49750,49750,1317C72E5A9622054904D4946F5A3E59,11381,0,13,13,30,47,1547
49751,49751,1317C72E5A9622054904D4946F5A3E59,10151,14,17,3,34,47,1747
49752,49752,1317C72E5A9622054904D4946F5A3E59,11201,20,23,3,35,49,1799
49753,49753,29EECA43EEFE59ADAFABFF01A5C4E8B8,11471,2,4,2,12,48,648
49754,49754,29EECA43EEFE59ADAFABFF01A5C4E8B8,42041,9,10,1,10,47,547
49755,49755,29EECA43EEFE59ADAFABFF01A5C4E8B8,19441,13,14,1,8,46,446
49756,49756,29EECA43EEFE59ADAFABFF01A5C4E8B8,42041,14,19,5,10,47,547
49757,49757,FD5EF28EAD4BB7B6215FEE28B08DAD3E,12661,0,7,7,32,45,1645
49758,49758,FD5EF28EAD4BB7B6215FEE28B08DAD3E,12311,9,11,2,30,44,1544
49759,49759,FD5EF28EAD4BB7B6215FEE28B08DAD3E,12661,12,13,1,32,45,1645
49760,49760,FD5EF28EAD4BB7B6215FEE28B08DAD3E,12311,14,16,2,30,44,1544
49761,49761,FD5EF28EAD4BB7B6215FEE28B08DAD3E,12661,21,23,2,32,45,1645
49762,49762,677855E64026BA1B968F345289D1941E,11801,10,12,2,42,48,2148
49763,49763,677855E64026BA1B968F345289D1941E,10711,14,15,1,29,46,1496
49764,49764,677855E64026BA1B968F345289D1941E,13711,17,20,3,38,46,1946
49765,49765,20EC99C79194942F90F25D8AB841D12A,40833,0,4,4,41,47,2097
49766,49766,20EC99C79194942F90F25D8AB841D12A,42151,5,16,11,35,45,1795
49767,49767,20EC99C79194942F90F25D8AB841D12A,40833,20,23,3,41,47,2097
49775,49775,76A84ED3D9838C789BD1A23EFB9BEE14,43061,0,1,1,43,46,2196
49776,49776,76A84ED3D9838C789BD1A23EFB9BEE14,13121,1,3,2,38,46,1946
49777,49777,76A84ED3D9838C789BD1A23EFB9BEE14,43061,5,10,5,43,46,2196
49778,49778,76A84ED3D9838C789BD1A23EFB9BEE14,42381,18,19,1,39,41,1991
49779,49779,76A84ED3D9838C789BD1A23EFB9BEE14,11751,19,22,3,35,48,1798
49783,49783,2867B7A134295A9C8B7C5D841BC26927,43631,0,8,8,19,43,993
49784,49784,2867B7A134295A9C8B7C5D841BC26927,13091,8,10,2,20,42,1042
49785,49785,2867B7A134295A9C8B7C5D841BC26927,43631,11,13,2,19,43,993
49786,49786,2867B7A134295A9C8B7C5D841BC26927,11061,15,17,2,29,48,1498
49787,49787,2867B7A134295A9C8B7C5D841BC26927,10681,18,20,2,30,48,1548
49788,49788,2867B7A134295A9C8B7C5D841BC26927,41101,21,23,2,32,48,1648
49789,49789,5F6D51113B1053B6AE08BE28D0536EDB,11541,1,2,1,35,49,1799
49790,49790,5F6D51113B1053B6AE08BE28D0536EDB,10901,3,14,11,35,48,1798
49791,49791,5F6D51113B1053B6AE08BE28D0536EDB,40341,17,19,2,23,49,1199
49792,49792,5F6D51113B1053B6AE08BE28D0536EDB,10901,20,22,2,35,48,1798
49800,49800,FCBAAABDE376560AD2AD02E18DC15E6D,10611,0,5,5,32,48,1648
49801,49801,FCBAAABDE376560AD2AD02E18DC15E6D,43311,5,7,2,31,48,1598
49802,49802,FCBAAABDE376560AD2AD02E18DC15E6D,42623,10,11,1,22,49,1149
49803,49803,FCBAAABDE376560AD2AD02E18DC15E6D,10841,19,20,1,37,47,1897
49813,49813,F584084BD0C4D0FD14EABE044AD44274,41392,0,13,13,43,48,2198
49814,49814,F584084BD0C4D0FD14EABE044AD44274,10107,15,16,1,38,49,1949
49815,49815,F584084BD0C4D0FD14EABE044AD44274,41392,20,23,3,43,48,2198
49816,49816,D039AE0A5B0CC36107CE1BF84EEF079A,43631,9,11,2,19,43,993
49817,49817,D039AE0A5B0CC36107CE1BF84EEF079A,43021,12,17,5,16,43,843
49818,49818,D039AE0A5B0CC36107CE1BF84EEF079A,12921,17,18,1,9,41,491
49819,49819,D039AE0A5B0CC36107CE1BF84EEF079A,19021,19,21,2,10,45,545
49820,49820,D4191700C633456D6E890AE49001CB88,10951,0,7,7,29,48,1498
49821,49821,D4191700C633456D6E890AE49001CB88,11381,7,9,2,30,47,1547
49822,49822,D4191700C633456D6E890AE49001CB88,10951,9,14,5,29,48,1498
49823,49823,D4191700C633456D6E890AE49001CB88,11381,14,16,2,30,47,1547
49824,49824,D4191700C633456D6E890AE49001CB88,10951,16,20,4,29,48,1498
49825,49825,D4191700C633456D6E890AE49001CB88,42501,20,22,2,28,47,1447
49826,49826,2141F5E5634CDA123C05577130F2BB9B,10841,0,1,1,37,47,1897
49827,49827,2141F5E5634CDA123C05577130F2BB9B,42981,2,5,3,36,49,1849
49828,49828,2141F5E5634CDA123C05577130F2BB9B,42771,10,13,3,36,47,1847
49829,49829,2141F5E5634CDA123C05577130F2BB9B,11074,14,19,5,37,47,1897
49830,49830,2141F5E5634CDA123C05577130F2BB9B,11331,19,21,2,37,48,1898
49831,49831,4EE541C2C77ED64C3476846B8EC5E510,12871,2,8,6,22,33,1133
49832,49832,4EE541C2C77ED64C3476846B8EC5E510,19431,10,11,1,8,29,429
49833,49833,4EE541C2C77ED64C3476846B8EC5E510,12871,13,16,3,22,33,1133
49834,49834,4EE541C2C77ED64C3476846B8EC5E510,19801,16,20,4,19,26,976
49841,49841,344A3CF0E215A1C44A25A9F391805F64,12921,2,8,6,9,41,491
49842,49842,344A3CF0E215A1C44A25A9F391805F64,49201,8,9,1,7,41,391
49843,49843,344A3CF0E215A1C44A25A9F391805F64,12921,10,17,7,9,41,491
49844,49844,344A3CF0E215A1C44A25A9F391805F64,11061,18,21,3,29,48,1498
49845,49845,344A3CF0E215A1C44A25A9F391805F64,10681,21,23,2,30,48,1548
49855,49855,36008D94577CF891B61F4F697BF6EF46,11074,1,2,1,37,47,1897
49856,49856,36008D94577CF891B61F4F697BF6EF46,10292,3,14,11,30,47,1547
49857,49857,36008D94577CF891B61F4F697BF6EF46,10151,15,16,1,34,47,1747
49858,49858,36008D94577CF891B61F4F697BF6EF46,42521,22,23,1,31,47,1597
49859,49859,93C7E4C23CF998D662129B494854BA6C,43311,0,6,6,31,48,1598
49860,49860,93C7E4C23CF998D662129B494854BA6C,11074,7,8,1,37,47,1897
49861,49861,93C7E4C23CF998D662129B494854BA6C,10651,13,17,4,36,49,1849
49862,49862,93C7E4C23CF998D662129B494854BA6C,11161,19,23,4,32,48,1648
49866,49866,CE28CE68699E1B9669791B701DAD9078,11861,0,18,18,32,47,1647
49867,49867,CE28CE68699E1B9669791B701DAD9078,40341,19,20,1,23,49,1199
49868,49868,CE28CE68699E1B9669791B701DAD9078,43761,21,23,2,32,47,1647
49869,49869,A2FF2B3E007AEF697BBECF6D3F01B855,43021,0,7,7,16,43,843
49870,49870,A2FF2B3E007AEF697BBECF6D3F01B855,19021,9,10,1,10,45,545
49871,49871,A2FF2B3E007AEF697BBECF6D3F01B855,43021,10,23,13,16,43,843
49872,49872,B57FA6A577B54BB28114ABA28733D834,13711,0,7,7,38,46,1946
49873,49873,B57FA6A577B54BB28114ABA28733D834,10381,7,10,3,31,49,1599
49874,49874,B57FA6A577B54BB28114ABA28733D834,13711,11,16,5,38,46,1946
49875,49875,B57FA6A577B54BB28114ABA28733D834,10841,17,19,2,37,47,1897
49876,49876,B57FA6A577B54BB28114ABA28733D834,42641,21,23,2,33,49,1699
49877,49877,D3583A14C793DCFA0A6B41790D3D6764,13651,0,17,17,30,47,1547
49878,49878,D3583A14C793DCFA0A6B41790D3D6764,11541,19,20,1,35,49,1799
49879,49879,D3583A14C793DCFA0A6B41790D3D6764,12121,20,23,3,29,47,1497
49880,49880,184C73F734C433286E1A8DF226C2E596,10111,0,18,18,37,47,1897
49881,49881,184C73F734C433286E1A8DF226C2E596,11481,18,20,2,41,48,2098
49882,49882,184C73F734C433286E1A8DF226C2E596,10111,21,22,1,37,47,1897
49883,49883,AA541C733BB5F99408992FE5EC11F72D,13461,3,4,1,39,44,1994
49884,49884,AA541C733BB5F99408992FE5EC11F72D,42861,6,19,13,37,44,1894
49885,49885,AA541C733BB5F99408992FE5EC11F72D,11261,19,22,3,36,46,1846
49892,49892,48294A0C68B957CE83E9E06712D77786,13951,9,10,1,47,45,2395
49893,49893,48294A0C68B957CE83E9E06712D77786,13821,13,17,4,49,45,2495
49894,49894,48294A0C68B957CE83E9E06712D77786,12131,18,20,2,32,47,1647
49905,49905,D89FED8D48E76D779C5E605DC68EC18A,13101,0,11,11,40,47,2047
49906,49906,D89FED8D48E76D779C5E605DC68EC18A,11481,12,14,2,41,48,2098
49907,49907,D89FED8D48E76D779C5E605DC68EC18A,40341,16,17,1,23,49,1199
49908,49908,D89FED8D48E76D779C5E605DC68EC18A,11481,22,23,1,41,48,2098
49909,49909,6D4A257D46D054E460A924C8D0D345D6,13511,0,2,2,34,48,1748
49910,49910,6D4A257D46D054E460A924C8D0D345D6,11753,2,7,5,35,48,1798
49911,49911,6D4A257D46D054E460A924C8D0D345D6,10471,9,12,3,37,48,1898
49912,49912,6D4A257D46D054E460A924C8D0D345D6,13511,14,18,4,34,48,1748
49913,49913,6D4A257D46D054E460A924C8D0D345D6,11753,20,23,3,35,48,1798
49914,49914,5CE4BD076974CDFDBB29CBFC6C974D60,12514,0,3,3,38,47,1947
49915,49915,5CE4BD076974CDFDBB29CBFC6C974D60,10841,4,7,3,37,47,1897
49916,49916,5CE4BD076974CDFDBB29CBFC6C974D60,12514,7,11,4,38,47,1947
49917,49917,5CE4BD076974CDFDBB29CBFC6C974D60,43971,12,13,1,30,48,1548
49918,49918,5CE4BD076974CDFDBB29CBFC6C974D60,12514,14,23,9,38,47,1947
49919,49919,753369D691B504B9F7186B2CDF290F06,12792,3,4,1,34,30,1730
49920,49920,753369D691B504B9F7186B2CDF290F06,15391,5,12,7,35,26,1776
49921,49921,753369D691B504B9F7186B2CDF290F06,12791,17,18,1,31,29,1579
49922,49922,753369D691B504B9F7186B2CDF290F06,15391,20,22,2,35,26,1776
49926,49926,A1182D77FBD520E2E1D818514447208A,42071,2,3,1,31,49,1599
49927,49927,A1182D77FBD520E2E1D818514447208A,42121,8,9,1,26,49,1349
49928,49928,A1182D77FBD520E2E1D818514447208A,42261,17,18,1,25,49,1299
49932,49932,EEE3AE7ABA4C03B6F4B079A7B52295B8,10731,0,12,12,33,47,1697
49933,49933,EEE3AE7ABA4C03B6F4B079A7B52295B8,10661,13,14,1,37,49,1899
49934,49934,EEE3AE7ABA4C03B6F4B079A7B52295B8,10731,15,17,2,33,47,1697
49935,49935,EEE3AE7ABA4C03B6F4B079A7B52295B8,11061,17,21,4,29,48,1498
49943,49943,8AB561279CAFD673B81CFFF6F25401C3,12221,0,10,10,43,44,2194
49944,49944,8AB561279CAFD673B81CFFF6F25401C3,43011,12,13,1,40,42,2042
49945,49945,8AB561279CAFD673B81CFFF6F25401C3,13951,14,16,2,47,45,2395
49946,49946,8AB561279CAFD673B81CFFF6F25401C3,43011,20,23,3,40,42,2042
49947,49947,41D3CEEEAB9133C2BBDECC043996A578,11011,0,1,1,39,49,1999
49948,49948,41D3CEEEAB9133C2BBDECC043996A578,43191,3,4,1,40,49,2049
49949,49949,41D3CEEEAB9133C2BBDECC043996A578,42511,13,17,4,37,47,1897
49950,49950,41D3CEEEAB9133C2BBDECC043996A578,10531,19,20,1,34,46,1746
49951,49951,41D3CEEEAB9133C2BBDECC043996A578,10111,21,22,1,37,47,1897
49952,49952,DD4D28FDBCFFE930AF28BD3956ED9308,11381,0,7,7,30,47,1547
49953,49953,DD4D28FDBCFFE930AF28BD3956ED9308,10841,8,16,8,37,47,1897
49954,49954,DD4D28FDBCFFE930AF28BD3956ED9308,11381,16,23,7,30,47,1547
49955,49955,325A357395139488DFA9EB4942638C18,42271,3,15,12,40,47,2047
49956,49956,325A357395139488DFA9EB4942638C18,11731,16,18,2,36,48,1848
49957,49957,325A357395139488DFA9EB4942638C18,10801,21,23,2,42,47,2147
49958,49958,526AA425A1743BA511A7B66EE5595BDF,11861,0,18,18,32,47,1647
49959,49959,526AA425A1743BA511A7B66EE5595BDF,11074,19,20,1,37,47,1897
49960,49960,526AA425A1743BA511A7B66EE5595BDF,11861,21,23,2,32,47,1647
49967,49967,3A1B49B490CA109FD4D5251F0C86C9CB,43581,0,9,9,33,48,1698
49968,49968,3A1B49B490CA109FD4D5251F0C86C9CB,12601,10,14,4,25,47,1297
49969,49969,3A1B49B490CA109FD4D5251F0C86C9CB,43581,15,23,8,33,48,1698
49970,49970,7B7808F449A709BA37633BF3E740E9A3,43051,0,5,5,46,45,2345
49971,49971,7B7808F449A709BA37633BF3E740E9A3,43011,7,8,1,40,42,2042
49972,49972,7B7808F449A709BA37633BF3E740E9A3,13341,12,13,1,44,45,2245
49973,49973,7B7808F449A709BA37633BF3E740E9A3,12211,16,17,1,41,44,2094
49974,49974,7B7808F449A709BA37633BF3E740E9A3,13341,17,18,1,44,45,2245
49975,49975,8FB7D1832E09933A350EF59B4AEDC842,11061,0,9,9,29,48,1498
49976,49976,8FB7D1832E09933A350EF59B4AEDC842,11794,13,20,7,38,49,1949
49977,49977,8FB7D1832E09933A350EF59B4AEDC842,11381,21,22,1,30,47,1547
49978,49978,AD64CADAFCB8FA82A8CBE0DBF54B728A,16441,0,3,3,15,17,767
49979,49979,AD64CADAFCB8FA82A8CBE0DBF54B728A,15381,8,9,1,19,21,971
49980,49980,AD64CADAFCB8FA82A8CBE0DBF54B728A,15114,13,14,1,22,16,1116
49981,49981,AD64CADAFCB8FA82A8CBE0DBF54B728A,16441,17,23,6,15,17,767
49982,49982,43E5C7BEDDD7504997DF5937C11544ED,11561,0,8,8,32,49,1649
49983,49983,43E5C7BEDDD7504997DF5937C11544ED,12514,10,12,2,38,47,1947
49984,49984,43E5C7BEDDD7504997DF5937C11544ED,11561,13,23,10,32,49,1649
49993,49993,B07D614204902BA81BDB5D8F25FA534A,19621,0,8,8,5,46,296
49994,49994,B07D614204902BA81BDB5D8F25FA534A,19111,9,14,5,9,45,495
49995,49995,B07D614204902BA81BDB5D8F25FA534A,19441,15,19,4,8,46,446
49996,49996,B07D614204902BA81BDB5D8F25FA534A,11571,20,21,1,13,46,696
49997,49997,B304D2AD98C7DE24CAE6DD0DA65095F0,10431,0,7,7,33,49,1699
49998,49998,B304D2AD98C7DE24CAE6DD0DA65095F0,11561,7,8,1,32,49,1649
49999,49999,B304D2AD98C7DE24CAE6DD0DA65095F0,10431,12,13,1,33,49,1699
50000,50000,B304D2AD98C7DE24CAE6DD0DA65095F0,43581,14,15,1,33,48,1698
50001,50001,B304D2AD98C7DE24CAE6DD0DA65095F0,10431,18,23,5,33,49,1699
50008,50008,C50F95F31F14C0EC9A55706C3B181C1C,15391,0,2,2,35,26,1776
50009,50009,C50F95F31F14C0EC9A55706C3B181C1C,12792,4,15,11,34,30,1730
50010,50010,C50F95F31F14C0EC9A55706C3B181C1C,15391,19,20,1,35,26,1776
50011,50011,C50F95F31F14C0EC9A55706C3B181C1C,12792,21,23,2,34,30,1730
50012,50012,5E7B85DDDE7C3454B02974AE7000481C,13791,1,7,6,42,47,2147
50013,50013,5E7B85DDDE7C3454B02974AE7000481C,13711,9,11,2,38,46,1946
50014,50014,5E7B85DDDE7C3454B02974AE7000481C,13791,11,16,5,42,47,2147
50015,50015,5E7B85DDDE7C3454B02974AE7000481C,13711,17,18,1,38,46,1946
50023,50023,E1CE272F4AA1E69437BEAF15C81D3269,11461,0,14,14,37,49,1899
50024,50024,E1CE272F4AA1E69437BEAF15C81D3269,40951,16,18,2,36,49,1849
50025,50025,E1CE272F4AA1E69437BEAF15C81D3269,42521,19,23,4,31,47,1597
50026,50026,CD2981128A64E64299220819619EA9CB,10381,0,8,8,31,49,1599
50027,50027,CD2981128A64E64299220819619EA9CB,12391,9,10,1,36,49,1849
50028,50028,CD2981128A64E64299220819619EA9CB,10381,14,17,3,31,49,1599
50029,50029,CD2981128A64E64299220819619EA9CB,11061,17,20,3,29,48,1498
50030,50030,CD2981128A64E64299220819619EA9CB,10381,20,23,3,31,49,1599
50031,50031,9724A261A03D6E05F4EF876D73380EA1,13511,0,16,16,34,48,1748
50032,50032,9724A261A03D6E05F4EF876D73380EA1,43451,18,19,1,37,40,1890
50033,50033,9724A261A03D6E05F4EF876D73380EA1,13511,21,23,2,34,48,1748
50034,50034,519A8FB1F2C73488A66FF4FB635E4704,10921,1,9,8,43,48,2198
50035,50035,519A8FB1F2C73488A66FF4FB635E4704,13121,11,13,2,38,46,1946
50036,50036,519A8FB1F2C73488A66FF4FB635E4704,42341,16,22,6,43,49,2199
50037,50037,39E8FB5C4AE9A0E0783441178F244CD5,10341,2,12,10,31,47,1597
50038,50038,39E8FB5C4AE9A0E0783441178F244CD5,42161,12,15,3,36,47,1847
50039,50039,39E8FB5C4AE9A0E0783441178F244CD5,10341,15,17,2,31,47,1597
50040,50040,39E8FB5C4AE9A0E0783441178F244CD5,10111,20,23,3,37,47,1897
50044,50044,948298B93A5F252BFAD57AD3A55CAD42,42071,5,16,11,31,49,1599
50045,50045,948298B93A5F252BFAD57AD3A55CAD42,42261,16,17,1,25,49,1299
50046,50046,948298B93A5F252BFAD57AD3A55CAD42,10381,18,23,5,31,49,1599
50047,50047,4CA6A551CECA6821EE81473EF1CB1088,10721,0,11,11,31,48,1598
50048,50048,4CA6A551CECA6821EE81473EF1CB1088,11521,12,13,1,41,48,2098
50049,50049,4CA6A551CECA6821EE81473EF1CB1088,10721,14,18,4,31,48,1598
50053,50053,7311C2C119D19828FE7C420000F6A917,10292,0,8,8,30,47,1547
50054,50054,7311C2C119D19828FE7C420000F6A917,40341,9,10,1,23,49,1199
50055,50055,7311C2C119D19828FE7C420000F6A917,10711,11,17,6,29,46,1496
50056,50056,7311C2C119D19828FE7C420000F6A917,10292,17,23,6,30,47,1547
50057,50057,87B1169D5A9BB025C6A10231CEED2118,19621,0,7,7,5,46,296
50058,50058,87B1169D5A9BB025C6A10231CEED2118,11261,9,13,4,36,46,1846
50059,50059,87B1169D5A9BB025C6A10231CEED2118,11861,14,21,7,32,47,1647
50063,50063,F4C8F856DD638BBA75F52C720E10C05D,12921,0,13,13,9,41,491
50064,50064,F4C8F856DD638BBA75F52C720E10C05D,19261,16,18,2,6,37,337
50065,50065,F4C8F856DD638BBA75F52C720E10C05D,12921,22,23,1,9,41,491
50069,50069,F6265BE8D5B1D90F759154EDAB63EA2C,15191,0,10,10,36,27,1827
50070,50070,F6265BE8D5B1D90F759154EDAB63EA2C,12792,10,12,2,34,30,1730
50071,50071,F6265BE8D5B1D90F759154EDAB63EA2C,15191,13,20,7,36,27,1827
50075,50075,1788FF83230593384DFEF88881720D90,13551,0,5,5,45,38,2288
50076,50076,1788FF83230593384DFEF88881720D90,43101,6,8,2,46,40,2340
50077,50077,1788FF83230593384DFEF88881720D90,13551,9,10,1,45,38,2288
50078,50078,1788FF83230593384DFEF88881720D90,43101,10,19,9,46,40,2340
50079,50079,1788FF83230593384DFEF88881720D90,13551,22,23,1,45,38,2288
50094,50094,C7A88D4B4805EF0CDB79C406D2FCDA1C,40431,0,8,8,36,47,1847
50095,50095,C7A88D4B4805EF0CDB79C406D2FCDA1C,42461,9,11,2,45,47,2297
50096,50096,C7A88D4B4805EF0CDB79C406D2FCDA1C,40431,16,17,1,36,47,1847
50097,50097,C7A88D4B4805EF0CDB79C406D2FCDA1C,10511,19,20,1,35,46,1796
50098,50098,C7A88D4B4805EF0CDB79C406D2FCDA1C,40431,20,23,3,36,47,1847
50108,50108,48D09EA1E123F030FD71CF37426D4799,43011,1,6,5,40,42,2042
50109,50109,48D09EA1E123F030FD71CF37426D4799,42151,7,9,2,35,45,1795
50110,50110,48D09EA1E123F030FD71CF37426D4799,43011,11,14,3,40,42,2042
50111,50111,48D09EA1E123F030FD71CF37426D4799,42151,17,23,6,35,45,1795
50112,50112,97EDAD74806889D7D155A673D46962C2,10221,1,7,6,34,49,1749
50113,50113,97EDAD74806889D7D155A673D46962C2,12601,8,17,9,25,47,1297
50114,50114,97EDAD74806889D7D155A673D46962C2,10221,21,23,2,34,49,1749
50119,50119,89218D7844F451E8441D19010F1C02CD,42623,3,4,1,22,49,1149
50120,50120,89218D7844F451E8441D19010F1C02CD,11381,6,10,4,30,47,1547
50121,50121,89218D7844F451E8441D19010F1C02CD,42121,11,12,1,26,49,1349
50122,50122,89218D7844F451E8441D19010F1C02CD,42623,15,20,5,22,49,1149
50127,50127,135EF939D99CED11694D71795A5772B0,19031,0,3,3,1,42,92
50128,50128,135EF939D99CED11694D71795A5772B0,19021,8,11,3,10,45,545
50129,50129,135EF939D99CED11694D71795A5772B0,12641,13,14,1,10,43,543
50130,50130,135EF939D99CED11694D71795A5772B0,19021,16,17,1,10,45,545
50131,50131,135EF939D99CED11694D71795A5772B0,43021,17,18,1,16,43,843
50132,50132,135EF939D99CED11694D71795A5772B0,12921,19,23,4,9,41,491
50141,50141,B5535942C9DF28365117F822438F7351,11753,0,16,16,35,48,1798
50142,50142,B5535942C9DF28365117F822438F7351,40341,16,20,4,23,49,1199
50143,50143,B5535942C9DF28365117F822438F7351,11753,21,22,1,35,48,1798
50144,50144,99A5D19C0E6C952CF48377C84D93300C,19954,0,6,6,2,33,133
50145,50145,99A5D19C0E6C952CF48377C84D93300C,40341,12,15,3,23,49,1199
50146,50146,99A5D19C0E6C952CF48377C84D93300C,19954,19,23,4,2,33,133
50147,50147,0EC1D2502267B7D6F36C8EA9D8EC3DDA,10171,0,8,8,26,47,1347
50148,50148,0EC1D2502267B7D6F36C8EA9D8EC3DDA,11001,15,17,2,42,47,2147
50149,50149,0EC1D2502267B7D6F36C8EA9D8EC3DDA,10171,20,22,2,26,47,1347
50167,50167,3AEA3CF422288C2FFB9C65FD7BE694C9,19931,1,3,2,7,43,393
50168,50168,3AEA3CF422288C2FFB9C65FD7BE694C9,12921,6,8,2,9,41,491
50169,50169,3AEA3CF422288C2FFB9C65FD7BE694C9,12641,8,10,2,10,43,543
50170,50170,3AEA3CF422288C2FFB9C65FD7BE694C9,12921,11,15,4,9,41,491
50171,50171,3AEA3CF422288C2FFB9C65FD7BE694C9,19931,16,21,5,7,43,393
50172,50172,D96201B04F49DA8FE5B344343C2EC845,10281,0,4,4,33,48,1698
50173,50173,D96201B04F49DA8FE5B344343C2EC845,11861,4,6,2,32,47,1647
50174,50174,D96201B04F49DA8FE5B344343C2EC845,12601,7,10,3,25,47,1297
50175,50175,D96201B04F49DA8FE5B344343C2EC845,42151,15,18,3,35,45,1795
50176,50176,D96201B04F49DA8FE5B344343C2EC845,11861,21,23,2,32,47,1647
50180,50180,3717F18D88C40095DBADE8C95C390E6F,42151,1,6,5,35,45,1795
50181,50181,3717F18D88C40095DBADE8C95C390E6F,42861,10,11,1,37,44,1894
50182,50182,3717F18D88C40095DBADE8C95C390E6F,42151,12,14,2,35,45,1795
50183,50183,3717F18D88C40095DBADE8C95C390E6F,42861,14,16,2,37,44,1894
50184,50184,3717F18D88C40095DBADE8C95C390E6F,42151,17,18,1,35,45,1795
50192,50192,D1B198FBEC3C8F15FED9970CD6DFF591,42151,0,8,8,35,45,1795
50193,50193,D1B198FBEC3C8F15FED9970CD6DFF591,43451,9,14,5,37,40,1890
50194,50194,D1B198FBEC3C8F15FED9970CD6DFF591,42381,19,22,3,39,41,1991
50195,50195,8F7D9084C99ED85E457151BF2051C64B,10351,2,3,1,28,45,1445
50196,50196,8F7D9084C99ED85E457151BF2051C64B,13341,5,10,5,44,45,2245
50197,50197,8F7D9084C99ED85E457151BF2051C64B,12021,13,14,1,37,49,1899
50198,50198,8F7D9084C99ED85E457151BF2051C64B,13341,15,19,4,44,45,2245
50202,50202,4E1126CD1AF86FC47E3B081AF053FA88,43761,0,6,6,32,47,1647
50203,50203,4E1126CD1AF86FC47E3B081AF053FA88,42523,6,9,3,31,47,1597
50204,50204,4E1126CD1AF86FC47E3B081AF053FA88,43761,9,13,4,32,47,1647
50205,50205,4E1126CD1AF86FC47E3B081AF053FA88,42523,13,16,3,31,47,1597
50206,50206,4E1126CD1AF86FC47E3B081AF053FA88,42141,19,23,4,32,47,1647
50207,50207,4DDBC8A3158AB8C770BE44DD5AC774BB,41393,0,8,8,43,49,2199
50208,50208,4DDBC8A3158AB8C770BE44DD5AC774BB,42981,9,11,2,36,49,1849
50209,50209,4DDBC8A3158AB8C770BE44DD5AC774BB,11751,12,14,2,35,48,1798
50210,50210,4DDBC8A3158AB8C770BE44DD5AC774BB,11021,15,16,1,36,49,1849
50211,50211,4DDBC8A3158AB8C770BE44DD5AC774BB,11751,18,21,3,35,48,1798
50212,50212,9E2EB523208A345DE4509D7FD0839517,13351,0,7,7,48,48,2448
50213,50213,9E2EB523208A345DE4509D7FD0839517,43621,7,8,1,46,48,2348
50214,50214,9E2EB523208A345DE4509D7FD0839517,13471,12,13,1,47,49,2399
50215,50215,9E2EB523208A345DE4509D7FD0839517,43621,15,20,5,46,48,2348
50216,50216,9E2EB523208A345DE4509D7FD0839517,11021,21,23,2,36,49,1849
50220,50220,AB6BA0FD52A84C8EBA16D1ADD62CFB83,11324,9,10,1,31,46,1596
50221,50221,AB6BA0FD52A84C8EBA16D1ADD62CFB83,11875,10,12,2,30,46,1546
50222,50222,AB6BA0FD52A84C8EBA16D1ADD62CFB83,40951,15,19,4,36,49,1849
50223,50223,AB6BA0FD52A84C8EBA16D1ADD62CFB83,11875,20,23,3,30,46,1546
50224,50224,A53DAA006542212C0F792E33874BF547,10231,0,16,16,39,49,1999
50225,50225,A53DAA006542212C0F792E33874BF547,43161,17,18,1,35,47,1797
50226,50226,A53DAA006542212C0F792E33874BF547,11661,20,23,3,40,49,2049
50230,50230,E32C26C5F7AAB132ACC9E200BFCE93F9,42541,0,5,5,25,47,1297
50231,50231,E32C26C5F7AAB132ACC9E200BFCE93F9,10716,7,9,2,30,46,1546
50232,50232,E32C26C5F7AAB132ACC9E200BFCE93F9,11021,10,20,10,36,49,1849
50233,50233,E32C26C5F7AAB132ACC9E200BFCE93F9,42471,21,23,2,35,49,1799
50234,50234,4568F4CB3839A063AA85BE5AD656F1DE,12131,9,10,1,32,47,1647
50235,50235,4568F4CB3839A063AA85BE5AD656F1DE,12161,11,12,1,32,46,1646
50236,50236,4568F4CB3839A063AA85BE5AD656F1DE,11351,14,18,4,36,48,1848
50237,50237,46624C7A7A05E81084BABC40FE8F937C,13314,0,14,14,31,39,1589
50238,50238,46624C7A7A05E81084BABC40FE8F937C,12521,17,18,1,35,41,1791
50239,50239,46624C7A7A05E81084BABC40FE8F937C,13314,20,23,3,31,39,1589
50243,50243,426336721C2D9D5E5521CCC5C2A95F16,12581,0,5,5,24,48,1248
50244,50244,426336721C2D9D5E5521CCC5C2A95F16,43751,7,17,10,19,48,998
50245,50245,426336721C2D9D5E5521CCC5C2A95F16,12581,20,21,1,24,48,1248
50246,50246,B6E06BECFD200E305BD11D4E181199C8,11794,0,1,1,38,49,1949
50247,50247,B6E06BECFD200E305BD11D4E181199C8,43471,1,11,10,31,49,1599
50248,50248,B6E06BECFD200E305BD11D4E181199C8,10401,14,16,2,33,49,1699
50249,50249,B6E06BECFD200E305BD11D4E181199C8,11201,21,23,2,35,49,1799
50257,50257,5F59FDA04080FD89C696AFDB5CAE088C,12971,1,14,13,32,48,1648
50258,50258,5F59FDA04080FD89C696AFDB5CAE088C,11301,19,20,1,41,49,2099
50259,50259,5F59FDA04080FD89C696AFDB5CAE088C,11171,22,23,1,33,48,1698
50275,50275,5A8967238CFB17CA694F7CF220BBEFA6,11541,0,11,11,35,49,1799
50276,50276,5A8967238CFB17CA694F7CF220BBEFA6,11211,12,14,2,34,49,1749
50277,50277,5A8967238CFB17CA694F7CF220BBEFA6,40341,15,17,2,23,49,1199
50278,50278,5A8967238CFB17CA694F7CF220BBEFA6,11211,18,20,2,34,49,1749
50282,50282,672E46CD1A2289C6109AAA4160C503F8,42231,8,9,1,37,46,1896
50283,50283,672E46CD1A2289C6109AAA4160C503F8,11261,10,15,5,36,46,1846
50284,50284,672E46CD1A2289C6109AAA4160C503F8,12121,16,17,1,29,47,1497
50285,50285,672E46CD1A2289C6109AAA4160C503F8,11261,19,20,1,36,46,1846
50286,50286,0601C1762592A99CA3F0778FC011A2CE,13331,0,8,8,38,47,1947
50287,50287,0601C1762592A99CA3F0778FC011A2CE,10601,10,14,4,39,47,1997
50288,50288,0601C1762592A99CA3F0778FC011A2CE,12514,15,16,1,38,47,1947
50289,50289,0601C1762592A99CA3F0778FC011A2CE,10841,16,19,3,37,47,1897
50290,50290,0601C1762592A99CA3F0778FC011A2CE,12511,21,23,2,39,47,1997
50291,50291,1FE631535FEDFBD0DC3689E2A79D0640,11201,0,12,12,35,49,1799
50292,50292,1FE631535FEDFBD0DC3689E2A79D0640,11861,13,18,5,32,47,1647
50293,50293,1FE631535FEDFBD0DC3689E2A79D0640,10341,18,20,2,31,47,1597
50294,50294,1FE631535FEDFBD0DC3689E2A79D0640,42191,21,22,1,38,49,1949
50295,50295,51E47FDE51716EB36BE96125516194AB,11021,0,11,11,36,49,1849
50296,50296,51E47FDE51716EB36BE96125516194AB,40697,11,14,3,43,48,2198
50297,50297,51E47FDE51716EB36BE96125516194AB,11021,14,23,9,36,49,1849
50307,50307,D39B974D3FC57295AC599832B8A0CE7E,19621,0,6,6,5,46,296
50308,50308,D39B974D3FC57295AC599832B8A0CE7E,12921,7,8,1,9,41,491
50309,50309,D39B974D3FC57295AC599832B8A0CE7E,19111,12,13,1,9,45,495
50310,50310,D39B974D3FC57295AC599832B8A0CE7E,12921,15,17,2,9,41,491
50311,50311,D39B974D3FC57295AC599832B8A0CE7E,19621,20,23,3,5,46,296
50316,50316,CE2F298C1C14AD427DCFEBFF75DC6584,19621,0,11,11,5,46,296
50317,50317,CE2F298C1C14AD427DCFEBFF75DC6584,11531,13,15,2,34,49,1749
50318,50318,CE2F298C1C14AD427DCFEBFF75DC6584,19621,16,21,5,5,46,296
50319,50319,454A0AB6A7ADBC9F5D76E05824AC7428,40123,4,12,8,38,47,1947
50320,50320,454A0AB6A7ADBC9F5D76E05824AC7428,12521,13,17,4,35,41,1791
50321,50321,454A0AB6A7ADBC9F5D76E05824AC7428,40123,22,23,1,38,47,1947
50322,50322,393F5524259520584332C02612814AC9,11431,0,14,14,29,47,1497
50323,50323,393F5524259520584332C02612814AC9,12561,15,16,1,45,43,2293
50324,50324,393F5524259520584332C02612814AC9,11431,21,23,2,29,47,1497
50325,50325,BF3354E7653978B437BDBF5412A04932,12871,4,5,1,22,33,1133
50326,50326,BF3354E7653978B437BDBF5412A04932,19281,8,11,3,16,32,832
50327,50327,BF3354E7653978B437BDBF5412A04932,12871,14,23,9,22,33,1133
50328,50328,062DB82DC0B3D584AB2529F1637FF6A0,40343,4,17,13,24,49,1249
50329,50329,062DB82DC0B3D584AB2529F1637FF6A0,10251,18,20,2,35,47,1797
50330,50330,062DB82DC0B3D584AB2529F1637FF6A0,11791,22,23,1,38,49,1949
50334,50334,892FEA357C3FD710139F81904CF9C65C,11324,0,10,10,31,46,1596
50335,50335,892FEA357C3FD710139F81904CF9C65C,42221,14,15,1,38,48,1948
50336,50336,892FEA357C3FD710139F81904CF9C65C,11321,17,22,5,31,46,1596
50343,50343,ACE6CA8B487669BE8A7949AA7EA2747D,10911,0,1,1,39,46,1996
50344,50344,ACE6CA8B487669BE8A7949AA7EA2747D,12381,2,12,10,32,48,1648
50345,50345,ACE6CA8B487669BE8A7949AA7EA2747D,11201,13,19,6,35,49,1799
50359,50359,E03B05F0FB01917EEB19D58711FDBCBD,13071,0,8,8,41,41,2091
50360,50360,E03B05F0FB01917EEB19D58711FDBCBD,43101,8,13,5,46,40,2340
50361,50361,E03B05F0FB01917EEB19D58711FDBCBD,13071,14,22,8,41,41,2091
50362,50362,E03B05F0FB01917EEB19D58711FDBCBD,43101,22,23,1,46,40,2340
50363,50363,C54D86E5520DA9763CF81E383AB734CE,13314,0,4,4,31,39,1589
50364,50364,C54D86E5520DA9763CF81E383AB734CE,12521,4,14,10,35,41,1791
50365,50365,C54D86E5520DA9763CF81E383AB734CE,11021,16,18,2,36,49,1849
50366,50366,8DCBE913047A4EFA5302E4AB5EEAE30F,11781,1,3,2,38,49,1949
50367,50367,8DCBE913047A4EFA5302E4AB5EEAE30F,41392,4,14,10,43,48,2198
50368,50368,8DCBE913047A4EFA5302E4AB5EEAE30F,11021,15,17,2,36,49,1849
50369,50369,8DCBE913047A4EFA5302E4AB5EEAE30F,11271,17,22,5,37,48,1898
50373,50373,29ED7585A7C0FD6B2E71E72A2B2372DE,12311,0,6,6,30,44,1544
50374,50374,29ED7585A7C0FD6B2E71E72A2B2372DE,11081,8,17,9,35,46,1796
50375,50375,29ED7585A7C0FD6B2E71E72A2B2372DE,42531,19,21,2,31,45,1595
50376,50376,57068447BEEE4D7969FF166D57966ECA,42541,0,6,6,25,47,1297
50377,50377,57068447BEEE4D7969FF166D57966ECA,11361,7,8,1,22,48,1148
50378,50378,57068447BEEE4D7969FF166D57966ECA,12051,8,9,1,20,47,1047
50379,50379,57068447BEEE4D7969FF166D57966ECA,12581,9,11,2,24,48,1248
50380,50380,57068447BEEE4D7969FF166D57966ECA,42541,12,13,1,25,47,1297
50381,50381,57068447BEEE4D7969FF166D57966ECA,11361,13,16,3,22,48,1148
50382,50382,57068447BEEE4D7969FF166D57966ECA,10171,18,19,1,26,47,1347
50383,50383,57068447BEEE4D7969FF166D57966ECA,42541,20,22,2,25,47,1297
50384,50384,78520B675436202D640A52F7BAC3D2C7,43081,0,1,1,27,28,1378
50385,50385,78520B675436202D640A52F7BAC3D2C7,15391,2,3,1,35,26,1776
50386,50386,78520B675436202D640A52F7BAC3D2C7,12792,5,10,5,34,30,1730
50387,50387,78520B675436202D640A52F7BAC3D2C7,43081,11,12,1,27,28,1378
50388,50388,78520B675436202D640A52F7BAC3D2C7,15391,15,16,1,35,26,1776
50389,50389,78520B675436202D640A52F7BAC3D2C7,43081,18,23,5,27,28,1378
50390,50390,DBE56CF804EFF98F06EBBF480586FC01,43021,2,4,2,16,43,843
50391,50391,DBE56CF804EFF98F06EBBF480586FC01,12921,6,8,2,9,41,491
50392,50392,DBE56CF804EFF98F06EBBF480586FC01,43021,12,16,4,16,43,843
50393,50393,DBE56CF804EFF98F06EBBF480586FC01,19114,21,22,1,7,43,393
50394,50394,DBE56CF804EFF98F06EBBF480586FC01,43021,22,23,1,16,43,843
50399,50399,181B5103F0FBF120AFF5BEC3A26A3DB7,43761,0,3,3,32,47,1647
50400,50400,181B5103F0FBF120AFF5BEC3A26A3DB7,42521,4,5,1,31,47,1597
50401,50401,181B5103F0FBF120AFF5BEC3A26A3DB7,12971,8,10,2,32,48,1648
50402,50402,181B5103F0FBF120AFF5BEC3A26A3DB7,10401,10,12,2,33,49,1699
50403,50403,181B5103F0FBF120AFF5BEC3A26A3DB7,40112,12,16,4,32,48,1648
50404,50404,181B5103F0FBF120AFF5BEC3A26A3DB7,43761,19,21,2,32,47,1647
50409,50409,D8645003EB503AEF89D00D98D7E87255,42141,0,1,1,32,47,1647
50410,50410,D8645003EB503AEF89D00D98D7E87255,12391,2,11,9,36,49,1849
50411,50411,D8645003EB503AEF89D00D98D7E87255,11861,14,23,9,32,47,1647
50419,50419,8EA53D8E1525E5DC764AA8B750C1926A,40124,0,10,10,38,47,1947
50420,50420,8EA53D8E1525E5DC764AA8B750C1926A,10821,12,13,1,40,47,2047
50421,50421,8EA53D8E1525E5DC764AA8B750C1926A,43951,14,22,8,49,41,2491
50425,50425,C5B8FC2C62862041C693B4E4C4C770AF,13511,9,10,1,34,48,1748
50426,50426,C5B8FC2C62862041C693B4E4C4C770AF,42851,13,15,2,35,41,1791
50427,50427,C5B8FC2C62862041C693B4E4C4C770AF,42381,17,18,1,39,41,1991
50428,50428,C5B8FC2C62862041C693B4E4C4C770AF,13314,21,23,2,31,39,1589
50429,50429,4BE03AB7B88CA8091DBCEF6257C15779,42371,0,4,4,34,46,1746
50430,50430,4BE03AB7B88CA8091DBCEF6257C15779,11161,6,7,1,32,48,1648
50431,50431,4BE03AB7B88CA8091DBCEF6257C15779,43761,7,8,1,32,47,1647
50432,50432,4BE03AB7B88CA8091DBCEF6257C15779,10721,10,11,1,31,48,1598
50433,50433,4BE03AB7B88CA8091DBCEF6257C15779,43761,12,23,11,32,47,1647
50444,50444,BC26B55CAB9087496A5FB61484951E63,10881,2,12,10,34,48,1748
50445,50445,BC26B55CAB9087496A5FB61484951E63,10221,13,15,2,34,49,1749
50446,50446,BC26B55CAB9087496A5FB61484951E63,19441,15,16,1,8,46,446
50447,50447,BC26B55CAB9087496A5FB61484951E63,11751,18,21,3,35,48,1798
50448,50448,BC26B55CAB9087496A5FB61484951E63,13511,22,23,1,34,48,1748
50463,50463,3EC01984A48FD14AA36045D09BE5811E,13711,0,6,6,38,46,1946
50464,50464,3EC01984A48FD14AA36045D09BE5811E,43281,9,11,2,37,48,1898
50465,50465,3EC01984A48FD14AA36045D09BE5811E,13711,14,15,1,38,46,1946
50466,50466,3EC01984A48FD14AA36045D09BE5811E,42231,16,17,1,37,46,1896
50467,50467,3EC01984A48FD14AA36045D09BE5811E,13711,21,23,2,38,46,1946
50479,50479,2C3F7C4E64CCDF56D823CBC357654CE4,12083,6,7,1,36,49,1849
50480,50480,2C3F7C4E64CCDF56D823CBC357654CE4,11231,8,17,9,37,49,1899
50481,50481,2C3F7C4E64CCDF56D823CBC357654CE4,10787,17,19,2,38,46,1946
50482,50482,2C3F7C4E64CCDF56D823CBC357654CE4,11631,21,23,2,12,49,649
50486,50486,03ED86F5BE3D351350BAE58E2A3698E8,13331,3,10,7,38,47,1947
50487,50487,03ED86F5BE3D351350BAE58E2A3698E8,42301,12,13,1,36,47,1847
50488,50488,03ED86F5BE3D351350BAE58E2A3698E8,10691,14,19,5,33,48,1698
50489,50489,03ED86F5BE3D351350BAE58E2A3698E8,40124,20,23,3,38,47,1947
50490,50490,BE4CDA819284119F77858D547E5A076D,11591,0,7,7,36,49,1849
50491,50491,BE4CDA819284119F77858D547E5A076D,40201,12,15,3,32,49,1649
50492,50492,BE4CDA819284119F77858D547E5A076D,11631,17,18,1,12,49,649
50493,50493,9F4FE5C66D1FE88FA924255DF3CD2B31,40171,0,8,8,38,48,1948
50494,50494,9F4FE5C66D1FE88FA924255DF3CD2B31,13651,9,10,1,30,47,1547
50495,50495,9F4FE5C66D1FE88FA924255DF3CD2B31,42521,13,15,2,31,47,1597
50496,50496,9F4FE5C66D1FE88FA924255DF3CD2B31,12021,20,21,1,37,49,1899
50497,50497,5529DD2214C36634346603006F6A0F3F,12521,0,16,16,35,41,1791
50498,50498,5529DD2214C36634346603006F6A0F3F,13041,16,17,1,30,37,1537
50499,50499,5529DD2214C36634346603006F6A0F3F,12521,19,23,4,35,41,1791
50503,50503,DF189E83BAB7254002D11C89D4F2D51F,10341,0,7,7,31,47,1597
50504,50504,DF189E83BAB7254002D11C89D4F2D51F,43151,7,8,1,40,49,2049
50505,50505,DF189E83BAB7254002D11C89D4F2D51F,10341,10,23,13,31,47,1597
50512,50512,9C52FD29B03EF1A5729C28BEF7100CC4,13314,0,8,8,31,39,1589
50513,50513,9C52FD29B03EF1A5729C28BEF7100CC4,43451,10,16,6,37,40,1890
50514,50514,9C52FD29B03EF1A5729C28BEF7100CC4,12521,16,18,2,35,41,1791
50515,50515,9C52FD29B03EF1A5729C28BEF7100CC4,13314,18,23,5,31,39,1589
50519,50519,0F1E7ADD98288D36843B90ADC158C3AC,11271,0,2,2,37,48,1898
50520,50520,0F1E7ADD98288D36843B90ADC158C3AC,11461,2,9,7,37,49,1899
50521,50521,0F1E7ADD98288D36843B90ADC158C3AC,42691,11,12,1,24,48,1248
50522,50522,0F1E7ADD98288D36843B90ADC158C3AC,11271,19,20,1,37,48,1898
50523,50523,0F1E7ADD98288D36843B90ADC158C3AC,11461,20,22,2,37,49,1899
50527,50527,D66DDB1AF696D6DDB044E124EA6B793E,13941,4,15,11,41,47,2097
50528,50528,D66DDB1AF696D6DDB044E124EA6B793E,12021,19,20,1,37,49,1899
50529,50529,D66DDB1AF696D6DDB044E124EA6B793E,10681,21,23,2,30,48,1548
50537,50537,EC861FE21AFD755213652562865FFBF9,43101,0,8,8,46,40,2340
50538,50538,EC861FE21AFD755213652562865FFBF9,13551,9,10,1,45,38,2288
50539,50539,EC861FE21AFD755213652562865FFBF9,13071,14,15,1,41,41,2091
50540,50540,EC861FE21AFD755213652562865FFBF9,43101,15,22,7,46,40,2340
50541,50541,88182B8F0A08A7B6CD3790FE87C79F47,42231,0,1,1,37,46,1896
50542,50542,88182B8F0A08A7B6CD3790FE87C79F47,42351,4,8,4,38,45,1945
50543,50543,88182B8F0A08A7B6CD3790FE87C79F47,42231,8,9,1,37,46,1896
50544,50544,88182B8F0A08A7B6CD3790FE87C79F47,42351,19,20,1,38,45,1945
50545,50545,88182B8F0A08A7B6CD3790FE87C79F47,42231,21,23,2,37,46,1896
50546,50546,3CDE88E41494ADADB515291429110B2E,43481,0,3,3,39,48,1998
50547,50547,3CDE88E41494ADADB515291429110B2E,12511,3,9,6,39,47,1997
50548,50548,3CDE88E41494ADADB515291429110B2E,12521,10,12,2,35,41,1791
50549,50549,3CDE88E41494ADADB515291429110B2E,42381,12,14,2,39,41,1991
50550,50550,3CDE88E41494ADADB515291429110B2E,12521,14,17,3,35,41,1791
50551,50551,3CDE88E41494ADADB515291429110B2E,42381,20,21,1,39,41,1991
50552,50552,3CDE88E41494ADADB515291429110B2E,43481,22,23,1,39,48,1998
50553,50553,A435E9096155E3E05704B1C1EE245191,15401,0,11,11,39,25,1975
50554,50554,A435E9096155E3E05704B1C1EE245191,42511,13,14,1,37,47,1897
50555,50555,A435E9096155E3E05704B1C1EE245191,12401,15,18,3,39,49,1999
50556,50556,A435E9096155E3E05704B1C1EE245191,11531,18,21,3,34,49,1749
50565,50565,6AF9BC3BC00A2DB4E93E7EFAFF6696BB,42523,0,1,1,31,47,1597
50566,50566,6AF9BC3BC00A2DB4E93E7EFAFF6696BB,43761,2,8,6,32,47,1647
50567,50567,6AF9BC3BC00A2DB4E93E7EFAFF6696BB,13481,12,13,1,26,31,1331
50568,50568,6AF9BC3BC00A2DB4E93E7EFAFF6696BB,43761,16,23,7,32,47,1647
50580,50580,8B6448FD7DB9F8E2F8F73AFDDD5BFD38,43021,2,3,1,16,43,843
50581,50581,8B6448FD7DB9F8E2F8F73AFDDD5BFD38,12641,7,9,2,10,43,543
50582,50582,8B6448FD7DB9F8E2F8F73AFDDD5BFD38,43021,10,18,8,16,43,843
50597,50597,E83888D24F9B489390D1BDDD69FB71BE,42861,0,6,6,37,44,1894
50598,50598,E83888D24F9B489390D1BDDD69FB71BE,11261,6,10,4,36,46,1846
50599,50599,E83888D24F9B489390D1BDDD69FB71BE,42861,12,14,2,37,44,1894
50600,50600,E83888D24F9B489390D1BDDD69FB71BE,42791,17,18,1,35,45,1795
50601,50601,E83888D24F9B489390D1BDDD69FB71BE,12661,22,23,1,32,45,1645
50602,50602,A2DD7BA75FCE1B5306A377D198F94491,12792,0,12,12,34,30,1730
50603,50603,A2DD7BA75FCE1B5306A377D198F94491,15391,13,15,2,35,26,1776
50604,50604,A2DD7BA75FCE1B5306A377D198F94491,43121,16,17,1,25,27,1277
50605,50605,A2DD7BA75FCE1B5306A377D198F94491,15391,18,20,2,35,26,1776
50606,50606,A2DD7BA75FCE1B5306A377D198F94491,12792,22,23,1,34,30,1730
50611,50611,3F0BC94142F99C8A0613C02F5CC52CE1,43281,0,7,7,37,48,1898
50612,50612,3F0BC94142F99C8A0613C02F5CC52CE1,11231,8,13,5,37,49,1899
50613,50613,3F0BC94142F99C8A0613C02F5CC52CE1,40341,14,15,1,23,49,1199
50614,50614,3F0BC94142F99C8A0613C02F5CC52CE1,11231,18,23,5,37,49,1899
50624,50624,E274FB59BFC8CCFE4F74C199808635E9,12311,0,6,6,30,44,1544
50625,50625,E274FB59BFC8CCFE4F74C199808635E9,10107,11,13,2,38,49,1949
50626,50626,E274FB59BFC8CCFE4F74C199808635E9,11321,16,17,1,31,46,1596
50627,50627,E274FB59BFC8CCFE4F74C199808635E9,12311,22,23,1,30,44,1544
50628,50628,A58F7C77A251D2337E1643D44FF96139,42321,0,12,12,43,47,2197
50629,50629,A58F7C77A251D2337E1643D44FF96139,13481,15,16,1,26,31,1331
50630,50630,A58F7C77A251D2337E1643D44FF96139,42321,20,23,3,43,47,2197
50631,50631,81B3D3DE315A50BFF7647F0A1B64DB94,19441,0,3,3,8,46,446
50632,50632,81B3D3DE315A50BFF7647F0A1B64DB94,42041,4,6,2,10,47,547
50633,50633,81B3D3DE315A50BFF7647F0A1B64DB94,19901,10,11,1,7,44,394
50634,50634,81B3D3DE315A50BFF7647F0A1B64DB94,19441,12,13,1,8,46,446
50635,50635,81B3D3DE315A50BFF7647F0A1B64DB94,42041,16,17,1,10,47,547
50636,50636,81B3D3DE315A50BFF7647F0A1B64DB94,19441,18,20,2,8,46,446
50637,50637,BB6408B6449FE57F7E33631A828BC98E,42201,0,1,1,43,46,2196
50638,50638,BB6408B6449FE57F7E33631A828BC98E,13961,3,11,8,42,48,2148
50639,50639,BB6408B6449FE57F7E33631A828BC98E,11521,11,13,2,41,48,2098
50640,50640,BB6408B6449FE57F7E33631A828BC98E,11701,17,19,2,43,48,2198
50641,50641,BB6408B6449FE57F7E33631A828BC98E,40302,19,21,2,40,49,2049
50642,50642,0A15402BF50F336CD996C3C85D01B359,10471,0,7,7,37,48,1898
50643,50643,0A15402BF50F336CD996C3C85D01B359,11811,8,13,5,38,49,1949
50644,50644,0A15402BF50F336CD996C3C85D01B359,10471,13,15,2,37,48,1898
50645,50645,0A15402BF50F336CD996C3C85D01B359,13511,15,17,2,34,48,1748
50646,50646,0A15402BF50F336CD996C3C85D01B359,10471,18,23,5,37,48,1898
50650,50650,694AE58BB8FA7D73732050F947690888,13461,0,5,5,39,44,1994
50651,50651,694AE58BB8FA7D73732050F947690888,11261,7,19,12,36,46,1846
50652,50652,694AE58BB8FA7D73732050F947690888,42151,20,22,2,35,45,1795
50653,50653,47CD03C948687C96861434761EE3E932,10621,0,6,6,41,49,2099
50654,50654,47CD03C948687C96861434761EE3E932,19024,8,17,9,9,45,495
50655,50655,47CD03C948687C96861434761EE3E932,10621,19,23,4,41,49,2099
50656,50656,4159D43B297F1C5059F36ACC8EB9CB14,42151,4,5,1,35,45,1795
50657,50657,4159D43B297F1C5059F36ACC8EB9CB14,12661,6,7,1,32,45,1645
50658,50658,4159D43B297F1C5059F36ACC8EB9CB14,12311,11,12,1,30,44,1544
50659,50659,4159D43B297F1C5059F36ACC8EB9CB14,12661,15,19,4,32,45,1645
50660,50660,2DC192DC303083B8FEFB2CD2D1161047,42201,0,12,12,43,46,2196
50661,50661,2DC192DC303083B8FEFB2CD2D1161047,13841,12,13,1,40,46,2046
50662,50662,2DC192DC303083B8FEFB2CD2D1161047,42461,16,17,1,45,47,2297
50663,50663,2DC192DC303083B8FEFB2CD2D1161047,10107,18,19,1,38,49,1949
50664,50664,2DC192DC303083B8FEFB2CD2D1161047,42461,20,23,3,45,47,2297
50665,50665,37F1D2311F2383134D9A7BD374E33133,10501,8,11,3,22,46,1146
50666,50666,37F1D2311F2383134D9A7BD374E33133,12051,12,13,1,20,47,1047
50667,50667,37F1D2311F2383134D9A7BD374E33133,43751,16,19,3,19,48,998
50668,50668,37F1D2311F2383134D9A7BD374E33133,12051,20,21,1,20,47,1047
50669,50669,9F589AB01E58B6B2CA9FB997F96CB7F3,13071,0,5,5,41,41,2091
50670,50670,9F589AB01E58B6B2CA9FB997F96CB7F3,43451,9,18,9,37,40,1890
50671,50671,9F589AB01E58B6B2CA9FB997F96CB7F3,13071,22,23,1,41,41,2091
50679,50679,D19CCADD05AE7D38BD327DD3B3A1E602,13911,0,7,7,39,46,1996
50680,50680,D19CCADD05AE7D38BD327DD3B3A1E602,42231,7,10,3,37,46,1896
50681,50681,D19CCADD05AE7D38BD327DD3B3A1E602,13911,12,14,2,39,46,1996
50682,50682,D19CCADD05AE7D38BD327DD3B3A1E602,42231,15,17,2,37,46,1896
50683,50683,D19CCADD05AE7D38BD327DD3B3A1E602,42351,20,23,3,38,45,1945
50684,50684,9CA452C61141C978511FB826791FE90D,42921,3,12,9,33,47,1697
50685,50685,9CA452C61141C978511FB826791FE90D,40341,14,17,3,23,49,1199
50686,50686,9CA452C61141C978511FB826791FE90D,13511,19,20,1,34,48,1748
50687,50687,936F3EAEFFE6D40274671E4FB3E6BD97,13711,0,1,1,38,46,1946
50688,50688,936F3EAEFFE6D40274671E4FB3E6BD97,11941,2,6,4,37,46,1896
50689,50689,936F3EAEFFE6D40274671E4FB3E6BD97,11074,8,12,4,37,47,1897
50690,50690,936F3EAEFFE6D40274671E4FB3E6BD97,42771,15,16,1,36,47,1847
50691,50691,936F3EAEFFE6D40274671E4FB3E6BD97,42231,18,20,2,37,46,1896
50692,50692,B9E52D07F5AA84B0FEC3B2146C780B6A,11231,0,16,16,37,49,1899
50693,50693,B9E52D07F5AA84B0FEC3B2146C780B6A,10281,16,17,1,33,48,1698
50694,50694,B9E52D07F5AA84B0FEC3B2146C780B6A,11231,20,22,2,37,49,1899
50698,50698,B98FAD9AB40766A1B19BC0888654B8F7,11561,0,9,9,32,49,1649
50699,50699,B98FAD9AB40766A1B19BC0888654B8F7,40341,17,20,3,23,49,1199
50700,50700,B98FAD9AB40766A1B19BC0888654B8F7,11021,21,22,1,36,49,1849
50720,50720,E675A65705B47E64E764764AA7201F3F,15411,1,2,1,44,27,2227
50721,50721,E675A65705B47E64E764764AA7201F3F,12611,6,11,5,41,29,2079
50722,50722,E675A65705B47E64E764764AA7201F3F,15411,12,13,1,44,27,2227
50723,50723,E675A65705B47E64E764764AA7201F3F,15121,15,16,1,27,19,1369
50724,50724,E675A65705B47E64E764764AA7201F3F,15561,18,19,1,32,22,1622
50725,50725,D5C98D28246C767D0FFD7F7274CFF193,13314,0,6,6,31,39,1589
50726,50726,D5C98D28246C767D0FFD7F7274CFF193,42151,7,10,3,35,45,1795
50727,50727,D5C98D28246C767D0FFD7F7274CFF193,13314,11,13,2,31,39,1589
50728,50728,D5C98D28246C767D0FFD7F7274CFF193,42151,15,18,3,35,45,1795
50729,50729,D5C98D28246C767D0FFD7F7274CFF193,13314,18,23,5,31,39,1589
50738,50738,5B84036FDCD203AB893EE6C99EA52401,42641,0,8,8,33,49,1699
50739,50739,5B84036FDCD203AB893EE6C99EA52401,42531,11,13,2,31,45,1595
50740,50740,5B84036FDCD203AB893EE6C99EA52401,10731,18,19,1,33,47,1697
50741,50741,5B84036FDCD203AB893EE6C99EA52401,42301,19,23,4,36,47,1847
50742,50742,C1489D378258BFDC5B83DAEEA6D2918E,13071,0,1,1,41,41,2091
50743,50743,C1489D378258BFDC5B83DAEEA6D2918E,13461,5,19,14,39,44,1994
50744,50744,C1489D378258BFDC5B83DAEEA6D2918E,43101,22,23,1,46,40,2340
50745,50745,1AA169564F26346ABB6AD9BF731FCA16,12031,0,6,6,33,48,1698
50746,50746,1AA169564F26346ABB6AD9BF731FCA16,42941,9,18,9,37,47,1897
50747,50747,1AA169564F26346ABB6AD9BF731FCA16,43581,19,23,4,33,48,1698
50748,50748,210582EEAC6D1F2BB5FAA5A446D73BC0,10381,0,9,9,31,49,1599
50749,50749,210582EEAC6D1F2BB5FAA5A446D73BC0,10211,10,12,2,16,49,849
50750,50750,210582EEAC6D1F2BB5FAA5A446D73BC0,10381,14,16,2,31,49,1599
50751,50751,210582EEAC6D1F2BB5FAA5A446D73BC0,10491,17,22,5,33,48,1698
50752,50752,9190C78880AEED82F13A934E18120C88,10271,3,9,6,37,46,1896
50753,50753,9190C78880AEED82F13A934E18120C88,13121,10,11,1,38,46,1946
50754,50754,9190C78880AEED82F13A934E18120C88,42511,15,16,1,37,47,1897
50755,50755,9190C78880AEED82F13A934E18120C88,11861,21,23,2,32,47,1647
50762,50762,775D2A8F104041B3D53BA2721A326EFF,42151,0,4,4,35,45,1795
50763,50763,775D2A8F104041B3D53BA2721A326EFF,13911,6,7,1,39,46,1996
50764,50764,775D2A8F104041B3D53BA2721A326EFF,42151,8,21,13,35,45,1795
50765,50765,24576DC2C63BF30A46BA06C33A71F868,13911,3,4,1,39,46,1996
50766,50766,24576DC2C63BF30A46BA06C33A71F868,11261,6,15,9,36,46,1846
50767,50767,24576DC2C63BF30A46BA06C33A71F868,12491,15,17,2,36,43,1843
50768,50768,24576DC2C63BF30A46BA06C33A71F868,11261,17,19,2,36,46,1846
50769,50769,6EB03DEC41F60785258F0AA9E4E23DB1,12761,1,7,6,25,40,1290
50770,50770,6EB03DEC41F60785258F0AA9E4E23DB1,11281,9,11,2,27,40,1390
50771,50771,6EB03DEC41F60785258F0AA9E4E23DB1,12521,11,15,4,35,41,1791
50772,50772,6EB03DEC41F60785258F0AA9E4E23DB1,13314,19,21,2,31,39,1589
50773,50773,B45D59A19F6B61302F993D2909F39450,10881,0,8,8,34,48,1748
50774,50774,B45D59A19F6B61302F993D2909F39450,11061,10,15,5,29,48,1498
50775,50775,B45D59A19F6B61302F993D2909F39450,12031,15,23,8,33,48,1698
50780,50780,B4AD19080CBD4B6E0C02277475F219B8,40441,0,6,6,30,48,1548
50781,50781,B4AD19080CBD4B6E0C02277475F219B8,11381,9,10,1,30,47,1547
50782,50782,B4AD19080CBD4B6E0C02277475F219B8,43361,12,13,1,38,48,1948
50783,50783,B4AD19080CBD4B6E0C02277475F219B8,11381,16,23,7,30,47,1547
50784,50784,2B22AD023BEE8D8F019C9832DA7799C3,10221,1,7,6,34,49,1749
50785,50785,2B22AD023BEE8D8F019C9832DA7799C3,12601,12,18,6,25,47,1297
50786,50786,2B22AD023BEE8D8F019C9832DA7799C3,10681,19,21,2,30,48,1548
50787,50787,2B22AD023BEE8D8F019C9832DA7799C3,10221,22,23,1,34,49,1749
50788,50788,A478073E2EFB76E8BCC50316A95AAC3B,19431,8,16,8,8,29,429
50789,50789,A478073E2EFB76E8BCC50316A95AAC3B,19101,16,18,2,17,29,879
50790,50790,A478073E2EFB76E8BCC50316A95AAC3B,19431,18,19,1,8,29,429
50791,50791,E090AE745FE0157CE235544725EE3E3A,11074,0,8,8,37,47,1897
50792,50792,E090AE745FE0157CE235544725EE3E3A,12514,8,10,2,38,47,1947
50793,50793,E090AE745FE0157CE235544725EE3E3A,11074,11,16,5,37,47,1897
50794,50794,E090AE745FE0157CE235544725EE3E3A,11541,18,19,1,35,49,1799
50795,50795,E090AE745FE0157CE235544725EE3E3A,12511,20,22,2,39,47,1997
50799,50799,4B427B3DF9C9275D878AB375F2616960,11806,0,17,17,41,48,2098
50800,50800,4B427B3DF9C9275D878AB375F2616960,11201,18,21,3,35,49,1799
50801,50801,4B427B3DF9C9275D878AB375F2616960,43581,21,23,2,33,48,1698
50802,50802,C14EE605AF47234DE280A3E7EB161B28,10301,0,1,1,31,45,1595
50803,50803,C14EE605AF47234DE280A3E7EB161B28,13671,2,3,1,27,43,1393
50804,50804,C14EE605AF47234DE280A3E7EB161B28,10301,3,5,2,31,45,1595
50805,50805,C14EE605AF47234DE280A3E7EB161B28,10107,14,15,1,38,49,1949
50806,50806,C14EE605AF47234DE280A3E7EB161B28,10301,17,19,2,31,45,1595
50821,50821,43729C568395995E81DB5D50B3A282EF,43021,1,5,4,16,43,843
50822,50822,43729C568395995E81DB5D50B3A282EF,19021,7,10,3,10,45,545
50823,50823,43729C568395995E81DB5D50B3A282EF,43021,12,13,1,16,43,843
50824,50824,43729C568395995E81DB5D50B3A282EF,19021,14,16,2,10,45,545
50825,50825,43729C568395995E81DB5D50B3A282EF,43021,20,23,3,16,43,843
50829,50829,AB1E27033ABBCFEAE4B83A799FB358FD,19744,0,5,5,6,43,343
50830,50830,AB1E27033ABBCFEAE4B83A799FB358FD,12311,8,19,11,30,44,1544
50831,50831,AB1E27033ABBCFEAE4B83A799FB358FD,19744,20,23,3,6,43,343
50832,50832,F276DA0C0E39AE3BAD5B91AE46CB6EA8,11231,6,17,11,37,49,1899
50833,50833,F276DA0C0E39AE3BAD5B91AE46CB6EA8,10471,18,20,2,37,48,1898
50834,50834,F276DA0C0E39AE3BAD5B91AE46CB6EA8,11231,20,21,1,37,49,1899
50835,50835,F276DA0C0E39AE3BAD5B91AE46CB6EA8,42971,22,23,1,43,49,2199
50839,50839,4B5E0C0321280E5B8F3AC9F959D808F3,11631,5,6,1,12,49,649
50840,50840,4B5E0C0321280E5B8F3AC9F959D808F3,40951,14,16,2,36,49,1849
50841,50841,4B5E0C0321280E5B8F3AC9F959D808F3,42261,21,22,1,25,49,1299
50845,50845,BBCB9918D42B41DEDF16DD7F5A9BE26F,11861,0,9,9,32,47,1647
50846,50846,BBCB9918D42B41DEDF16DD7F5A9BE26F,42161,10,12,2,36,47,1847
50847,50847,BBCB9918D42B41DEDF16DD7F5A9BE26F,11911,13,17,4,37,48,1898
50848,50848,BBCB9918D42B41DEDF16DD7F5A9BE26F,11861,17,23,6,32,47,1647
50849,50849,9871A4E75F73236F4B956DD429010B52,16311,2,3,1,2,11,111
50850,50850,9871A4E75F73236F4B956DD429010B52,16233,6,8,2,5,15,265
50851,50851,9871A4E75F73236F4B956DD429010B52,16311,11,23,12,2,11,111
50852,50852,52885050E80DA80FB3437A699501E8B9,19114,0,9,9,7,43,393
50853,50853,52885050E80DA80FB3437A699501E8B9,11171,12,13,1,33,48,1698
50854,50854,52885050E80DA80FB3437A699501E8B9,19114,14,23,9,7,43,393
50855,50855,46248CD3AE5F02514CBE5AD511617E45,43641,0,8,8,16,38,838
50856,50856,46248CD3AE5F02514CBE5AD511617E45,11281,11,12,1,27,40,1390
50857,50857,46248CD3AE5F02514CBE5AD511617E45,13671,12,13,1,27,43,1393
50858,50858,46248CD3AE5F02514CBE5AD511617E45,11281,16,18,2,27,40,1390
50859,50859,46248CD3AE5F02514CBE5AD511617E45,43641,22,23,1,16,38,838
50863,50863,BC9D09E74B1E43FA41C55E5AA40F0C9D,11061,3,14,11,29,48,1498
50864,50864,BC9D09E74B1E43FA41C55E5AA40F0C9D,40271,15,21,6,35,49,1799
50865,50865,BC9D09E74B1E43FA41C55E5AA40F0C9D,11061,21,22,1,29,48,1498
50869,50869,1331EB294578A8B5035A897C4CDC8F40,42491,0,6,6,32,46,1646
50870,50870,1331EB294578A8B5035A897C4CDC8F40,42523,7,8,1,31,47,1597
50871,50871,1331EB294578A8B5035A897C4CDC8F40,42491,11,15,4,32,46,1646
50872,50872,1331EB294578A8B5035A897C4CDC8F40,42523,15,16,1,31,47,1597
50873,50873,1331EB294578A8B5035A897C4CDC8F40,42491,16,19,3,32,46,1646
50874,50874,1331EB294578A8B5035A897C4CDC8F40,42523,20,23,3,31,47,1597
50875,50875,9770EA0FBBA8DF8F116981A2C7A68FF7,42221,0,7,7,38,48,1948
50876,50876,9770EA0FBBA8DF8F116981A2C7A68FF7,10381,7,16,9,31,49,1599
50877,50877,9770EA0FBBA8DF8F116981A2C7A68FF7,40171,18,21,3,38,48,1948
50889,50889,46E2E10251607E59BAC1F84F8487D62D,12641,0,6,6,10,43,543
50890,50890,46E2E10251607E59BAC1F84F8487D62D,19031,7,10,3,1,42,92
50891,50891,46E2E10251607E59BAC1F84F8487D62D,12641,10,15,5,10,43,543
50892,50892,46E2E10251607E59BAC1F84F8487D62D,19031,19,22,3,1,42,92
50893,50893,81565F9704E60766FEFBB47B416D00DF,12581,0,14,14,24,48,1248
50894,50894,81565F9704E60766FEFBB47B416D00DF,12051,14,18,4,20,47,1047
50895,50895,81565F9704E60766FEFBB47B416D00DF,12581,18,23,5,24,48,1248
50899,50899,809D30997DBB6653E10DF33CB05A97F7,13771,5,9,4,21,45,1095
50900,50900,809D30997DBB6653E10DF33CB05A97F7,13094,10,11,1,21,42,1092
50901,50901,809D30997DBB6653E10DF33CB05A97F7,13771,12,19,7,21,45,1095
50902,50902,809D30997DBB6653E10DF33CB05A97F7,12601,19,20,1,25,47,1297
50903,50903,809D30997DBB6653E10DF33CB05A97F7,13771,21,23,2,21,45,1095
50904,50904,391812C5DCCB1AF30A21CF756A4156CF,15191,0,4,4,36,27,1827
50905,50905,391812C5DCCB1AF30A21CF756A4156CF,15391,7,9,2,35,26,1776
50906,50906,391812C5DCCB1AF30A21CF756A4156CF,12792,9,11,2,34,30,1730
50907,50907,391812C5DCCB1AF30A21CF756A4156CF,15391,12,13,1,35,26,1776
50908,50908,391812C5DCCB1AF30A21CF756A4156CF,15191,17,18,1,36,27,1827
50909,50909,391812C5DCCB1AF30A21CF756A4156CF,12791,22,23,1,31,29,1579
50910,50910,CABDD8B2A8DF9C3C6F2F674E6DD5C884,11381,9,10,1,30,47,1547
50911,50911,CABDD8B2A8DF9C3C6F2F674E6DD5C884,10471,12,13,1,37,48,1898
50912,50912,CABDD8B2A8DF9C3C6F2F674E6DD5C884,11381,15,18,3,30,47,1547
50913,50913,CABDD8B2A8DF9C3C6F2F674E6DD5C884,11151,18,20,2,30,48,1548
50917,50917,40A368CA34750DF505DA57A322872C86,12611,2,15,13,41,29,2079
50918,50918,40A368CA34750DF505DA57A322872C86,15411,17,19,2,44,27,2227
50919,50919,40A368CA34750DF505DA57A322872C86,12611,20,22,2,41,29,2079
50920,50920,A6B86C51D1E851C8306B13F3333CE4AD,42301,0,7,7,36,47,1847
50921,50921,A6B86C51D1E851C8306B13F3333CE4AD,10911,9,10,1,39,46,1996
50922,50922,A6B86C51D1E851C8306B13F3333CE4AD,42301,14,16,2,36,47,1847
50923,50923,A6B86C51D1E851C8306B13F3333CE4AD,10381,18,19,1,31,49,1599
50924,50924,A6B86C51D1E851C8306B13F3333CE4AD,11491,22,23,1,36,47,1847
50925,50925,5D5DAEDAC2DCC0D6DCA39C4F356AD31C,11001,5,10,5,42,47,2147
50926,50926,5D5DAEDAC2DCC0D6DCA39C4F356AD31C,12021,13,14,1,37,49,1899
50927,50927,5D5DAEDAC2DCC0D6DCA39C4F356AD31C,13941,16,18,2,41,47,2097
50935,50935,34460EAE07C3CF26D59119C1F819471C,11381,0,9,9,30,47,1547
50936,50936,34460EAE07C3CF26D59119C1F819471C,42471,11,13,2,35,49,1799
50937,50937,34460EAE07C3CF26D59119C1F819471C,12131,15,16,1,32,47,1647
50938,50938,34460EAE07C3CF26D59119C1F819471C,10211,19,20,1,16,49,849
50939,50939,34460EAE07C3CF26D59119C1F819471C,12131,21,22,1,32,47,1647
50940,50940,316627655F42F54997AE20CC3444908E,43021,1,8,7,16,43,843
50941,50941,316627655F42F54997AE20CC3444908E,12921,10,11,1,9,41,491
50942,50942,316627655F42F54997AE20CC3444908E,43021,12,22,10,16,43,843
50943,50943,10C0623C858BE6D33225691C7AF5AFE1,16261,0,5,5,3,3,153
50944,50944,10C0623C858BE6D33225691C7AF5AFE1,16011,5,13,8,3,4,154
50945,50945,10C0623C858BE6D33225691C7AF5AFE1,16261,15,18,3,3,3,153
50946,50946,10C0623C858BE6D33225691C7AF5AFE1,16011,19,20,1,3,4,154
50947,50947,10C0623C858BE6D33225691C7AF5AFE1,13601,21,22,1,34,47,1747
50948,50948,842A1C1E3500FEFF04D25304E41263AF,12671,6,7,1,21,43,1093
50949,50949,842A1C1E3500FEFF04D25304E41263AF,13094,9,10,1,21,42,1092
50950,50950,842A1C1E3500FEFF04D25304E41263AF,13091,13,14,1,20,42,1042
50951,50951,842A1C1E3500FEFF04D25304E41263AF,12671,15,17,2,21,43,1093
50952,50952,842A1C1E3500FEFF04D25304E41263AF,13091,19,20,1,20,42,1042
50953,50953,842A1C1E3500FEFF04D25304E41263AF,12671,21,23,2,21,43,1093
50963,50963,18535AFB54958AC8380701DD2588A05F,11781,0,7,7,38,49,1949
50964,50964,18535AFB54958AC8380701DD2588A05F,11461,9,10,1,37,49,1899
50965,50965,18535AFB54958AC8380701DD2588A05F,10107,13,18,5,38,49,1949
50966,50966,18535AFB54958AC8380701DD2588A05F,10381,19,21,2,31,49,1599
50971,50971,15351107348D533F1A62174A9ED24724,13314,0,7,7,31,39,1589
50972,50972,15351107348D533F1A62174A9ED24724,12521,7,17,10,35,41,1791
50973,50973,15351107348D533F1A62174A9ED24724,13314,19,23,4,31,39,1589
50977,50977,81C7B7CEB06954770CA2C889DCC58FC5,11161,0,1,1,32,48,1648
50978,50978,81C7B7CEB06954770CA2C889DCC58FC5,43761,2,3,1,32,47,1647
50979,50979,81C7B7CEB06954770CA2C889DCC58FC5,10281,8,9,1,33,48,1698
50980,50980,81C7B7CEB06954770CA2C889DCC58FC5,43761,12,13,1,32,47,1647
50981,50981,81C7B7CEB06954770CA2C889DCC58FC5,10281,15,17,2,33,48,1698
50982,50982,81C7B7CEB06954770CA2C889DCC58FC5,42141,18,23,5,32,47,1647
50997,50997,1E478A5FEF40D5F63DF757696B4C9EAC,11171,0,1,1,33,48,1698
50998,50998,1E478A5FEF40D5F63DF757696B4C9EAC,42871,2,9,7,30,45,1545
50999,50999,1E478A5FEF40D5F63DF757696B4C9EAC,11061,16,17,1,29,48,1498
51000,51000,1E478A5FEF40D5F63DF757696B4C9EAC,40411,21,23,2,34,48,1748
51004,51004,1C4D9C3B4ACCE12D2B04BB20561492BF,13271,0,5,5,41,47,2097
51005,51005,1C4D9C3B4ACCE12D2B04BB20561492BF,12514,6,7,1,38,47,1947
51006,51006,1C4D9C3B4ACCE12D2B04BB20561492BF,13271,9,11,2,41,47,2097
51007,51007,1C4D9C3B4ACCE12D2B04BB20561492BF,10821,11,12,1,40,47,2047
51008,51008,1C4D9C3B4ACCE12D2B04BB20561492BF,13271,15,17,2,41,47,2097
51009,51009,1C4D9C3B4ACCE12D2B04BB20561492BF,13101,20,21,1,40,47,2047
51010,51010,1C4D9C3B4ACCE12D2B04BB20561492BF,13271,21,23,2,41,47,2097
51014,51014,90405E699C0ECBEA135FC79F2913E211,42801,0,7,7,40,49,2049
51015,51015,90405E699C0ECBEA135FC79F2913E211,10491,8,10,2,33,48,1698
51016,51016,90405E699C0ECBEA135FC79F2913E211,42801,12,20,8,40,49,2049
51017,51017,90405E699C0ECBEA135FC79F2913E211,10295,21,22,1,30,47,1547
51018,51018,60E47AB33736AC41E2674A67294A03D4,12491,0,6,6,36,43,1843
51019,51019,60E47AB33736AC41E2674A67294A03D4,11261,7,9,2,36,46,1846
51020,51020,60E47AB33736AC41E2674A67294A03D4,12491,12,13,1,36,43,1843
51021,51021,60E47AB33736AC41E2674A67294A03D4,11261,13,21,8,36,46,1846
51022,51022,60E47AB33736AC41E2674A67294A03D4,12491,22,23,1,36,43,1843
51026,51026,C44CEB439E2D40E37E5EE699A28E3428,11201,0,7,7,35,49,1799
51027,51027,C44CEB439E2D40E37E5EE699A28E3428,11211,7,13,6,34,49,1749
51028,51028,C44CEB439E2D40E37E5EE699A28E3428,13561,14,15,1,37,49,1899
51029,51029,C44CEB439E2D40E37E5EE699A28E3428,10221,18,20,2,34,49,1749
51030,51030,C44CEB439E2D40E37E5EE699A28E3428,11201,21,23,2,35,49,1799
51034,51034,0E7262AB05FEE95538206F690BF1ED85,11381,0,10,10,30,47,1547
51035,51035,0E7262AB05FEE95538206F690BF1ED85,42161,11,13,2,36,47,1847
51036,51036,0E7262AB05FEE95538206F690BF1ED85,11381,14,17,3,30,47,1547
51037,51037,0E7262AB05FEE95538206F690BF1ED85,42161,21,23,2,36,47,1847
51038,51038,7AEC9C7CCBAB2805F6D8B21C69CF29C4,10681,0,5,5,30,48,1548
51039,51039,7AEC9C7CCBAB2805F6D8B21C69CF29C4,10381,9,11,2,31,49,1599
51040,51040,7AEC9C7CCBAB2805F6D8B21C69CF29C4,10544,11,14,3,28,48,1448
51041,51041,7AEC9C7CCBAB2805F6D8B21C69CF29C4,10381,14,16,2,31,49,1599
51042,51042,7AEC9C7CCBAB2805F6D8B21C69CF29C4,10681,19,23,4,30,48,1548
51049,51049,A84C2A4DE68F652CB50B47C74C4873D0,10901,3,14,11,35,48,1798
51050,51050,A84C2A4DE68F652CB50B47C74C4873D0,11061,15,16,1,29,48,1498
51051,51051,A84C2A4DE68F652CB50B47C74C4873D0,10901,17,23,6,35,48,1798
51052,51052,A21C93D72B5558DF6DC8038ACDBFD759,43061,4,6,2,43,46,2196
51053,51053,A21C93D72B5558DF6DC8038ACDBFD759,43051,7,10,3,46,45,2345
51054,51054,A21C93D72B5558DF6DC8038ACDBFD759,13951,14,19,5,47,45,2395
51058,51058,7308A861032DD6CDA204025A180927B9,19114,0,5,5,7,43,393
51059,51059,7308A861032DD6CDA204025A180927B9,12641,8,10,2,10,43,543
51060,51060,7308A861032DD6CDA204025A180927B9,19114,12,14,2,7,43,393
51061,51061,7308A861032DD6CDA204025A180927B9,12641,15,19,4,10,43,543
51062,51062,7308A861032DD6CDA204025A180927B9,19114,19,22,3,7,43,393
51063,51063,F657EC858DEE55710BAB423B4CC1978D,43061,0,7,7,43,46,2196
51064,51064,F657EC858DEE55710BAB423B4CC1978D,12211,11,15,4,41,44,2094
51065,51065,F657EC858DEE55710BAB423B4CC1978D,42351,15,16,1,38,45,1945
51066,51066,F657EC858DEE55710BAB423B4CC1978D,12211,17,18,1,41,44,2094
51070,51070,41DD0A6027648481BFEC7812042262C9,42231,0,5,5,37,46,1896
51071,51071,41DD0A6027648481BFEC7812042262C9,42091,9,10,1,43,46,2196
51072,51072,41DD0A6027648481BFEC7812042262C9,13911,12,13,1,39,46,1996
51073,51073,41DD0A6027648481BFEC7812042262C9,42231,20,21,1,37,46,1896
51074,51074,41DD0A6027648481BFEC7812042262C9,13911,22,23,1,39,46,1996
51086,51086,08B6161A63F0BFCCF67BFC0EA5B81E44,42621,0,6,6,24,49,1249
51087,51087,08B6161A63F0BFCCF67BFC0EA5B81E44,40341,7,10,3,23,49,1199
51088,51088,08B6161A63F0BFCCF67BFC0EA5B81E44,42621,12,13,1,24,49,1249
51089,51089,08B6161A63F0BFCCF67BFC0EA5B81E44,40341,14,18,4,23,49,1199
51090,51090,08B6161A63F0BFCCF67BFC0EA5B81E44,42621,18,23,5,24,49,1249
51091,51091,B5F39D13F6C5569149EE5FC76B988FFF,12401,1,7,6,39,49,1999
51092,51092,B5F39D13F6C5569149EE5FC76B988FFF,10191,12,15,3,40,48,2048
51093,51093,B5F39D13F6C5569149EE5FC76B988FFF,13121,16,17,1,38,46,1946
51094,51094,B5F39D13F6C5569149EE5FC76B988FFF,10531,19,22,3,34,46,1746
51098,51098,44EC2A66EBE0C9567CD0A8FB0875C2DE,11151,1,9,8,30,48,1548
51099,51099,44EC2A66EBE0C9567CD0A8FB0875C2DE,42081,12,13,1,24,49,1249
51100,51100,44EC2A66EBE0C9567CD0A8FB0875C2DE,43391,14,18,4,29,48,1498
51101,51101,1F5D2ACA0CE29B2E7B0AD1FCCA63E3CB,10471,0,8,8,37,48,1898
51102,51102,1F5D2ACA0CE29B2E7B0AD1FCCA63E3CB,11231,8,10,2,37,49,1899
51103,51103,1F5D2ACA0CE29B2E7B0AD1FCCA63E3CB,42921,17,19,2,33,47,1697
51104,51104,F599BD40004701EFC1748D458DE1C7F2,43161,8,12,4,35,47,1797
51105,51105,F599BD40004701EFC1748D458DE1C7F2,42801,15,16,1,40,49,2049
51106,51106,F599BD40004701EFC1748D458DE1C7F2,11201,18,19,1,35,49,1799
51107,51107,F599BD40004701EFC1748D458DE1C7F2,10731,21,23,2,33,47,1697
51108,51108,CEF1E24EB6DE8D3601A93286A0518B66,11301,0,8,8,41,49,2099
51109,51109,CEF1E24EB6DE8D3601A93286A0518B66,13481,12,13,1,26,31,1331
51110,51110,CEF1E24EB6DE8D3601A93286A0518B66,11351,17,20,3,36,48,1848
51111,51111,CEF1E24EB6DE8D3601A93286A0518B66,10901,22,23,1,35,48,1798
51116,51116,CB51EA3DFBAD71C46F446085843381F3,15391,1,6,5,35,26,1776
51117,51117,CB51EA3DFBAD71C46F446085843381F3,43121,7,13,6,25,27,1277
51118,51118,CB51EA3DFBAD71C46F446085843381F3,15091,14,15,1,35,26,1776
51119,51119,CB51EA3DFBAD71C46F446085843381F3,12792,16,19,3,34,30,1730
51120,51120,CB51EA3DFBAD71C46F446085843381F3,15091,20,23,3,35,26,1776
51121,51121,DD0DDE62019DBDC86E7016216D82713F,10151,0,9,9,34,47,1747
51122,51122,DD0DDE62019DBDC86E7016216D82713F,10971,12,16,4,35,47,1797
51123,51123,DD0DDE62019DBDC86E7016216D82713F,43061,17,18,1,43,46,2196
51124,51124,DD0DDE62019DBDC86E7016216D82713F,42461,22,23,1,45,47,2297
51131,51131,FCE20E2B8F81E094609EF23CE6476C3B,42521,10,11,1,31,47,1597
51132,51132,FCE20E2B8F81E094609EF23CE6476C3B,40951,13,15,2,36,49,1849
51133,51133,FCE20E2B8F81E094609EF23CE6476C3B,42521,15,16,1,31,47,1597
51134,51134,FCE20E2B8F81E094609EF23CE6476C3B,11201,18,22,4,35,49,1799
51147,51147,566D9528D5B3FB3D4A89D1A13CEFDDC5,42601,0,4,4,44,48,2248
51148,51148,566D9528D5B3FB3D4A89D1A13CEFDDC5,13471,5,8,3,47,49,2399
51149,51149,566D9528D5B3FB3D4A89D1A13CEFDDC5,42581,9,16,7,38,48,1948
51150,51150,566D9528D5B3FB3D4A89D1A13CEFDDC5,11794,20,22,2,38,49,1949
51151,51151,CDD868B7CD2EE63A11365508386D7821,42371,1,7,6,34,46,1746
51152,51152,CDD868B7CD2EE63A11365508386D7821,12511,7,9,2,39,47,1997
51153,51153,CDD868B7CD2EE63A11365508386D7821,42371,12,14,2,34,46,1746
51154,51154,CDD868B7CD2EE63A11365508386D7821,11261,15,18,3,36,46,1846
51155,51155,CDD868B7CD2EE63A11365508386D7821,42371,19,21,2,34,46,1746
51159,51159,B1B15E298D4FC7776BC307436F04587A,15653,2,6,4,40,25,2025
51160,51160,B1B15E298D4FC7776BC307436F04587A,15651,6,7,1,39,25,1975
51161,51161,B1B15E298D4FC7776BC307436F04587A,15653,8,9,1,40,25,2025
51162,51162,B1B15E298D4FC7776BC307436F04587A,10151,15,16,1,34,47,1747
51163,51163,B1B15E298D4FC7776BC307436F04587A,42621,17,19,2,24,49,1249
51164,51164,B1B15E298D4FC7776BC307436F04587A,10721,19,21,2,31,48,1598
51169,51169,DC066CD0495E31C3328CCF0DC4172A03,13314,0,5,5,31,39,1589
51170,51170,DC066CD0495E31C3328CCF0DC4172A03,12521,5,13,8,35,41,1791
51171,51171,DC066CD0495E31C3328CCF0DC4172A03,13314,14,23,9,31,39,1589
51175,51175,345D4029BCC33DBFE6D7841DB885E7B2,42491,0,10,10,32,46,1646
51176,51176,345D4029BCC33DBFE6D7841DB885E7B2,42864,11,14,3,38,44,1944
51177,51177,345D4029BCC33DBFE6D7841DB885E7B2,42491,18,23,5,32,46,1646
51178,51178,FF8B7B7C81257B77BA17A83D7D213D72,10381,0,8,8,31,49,1599
51179,51179,FF8B7B7C81257B77BA17A83D7D213D72,40951,12,14,2,36,49,1849
51180,51180,FF8B7B7C81257B77BA17A83D7D213D72,10381,14,17,3,31,49,1599
51181,51181,FF8B7B7C81257B77BA17A83D7D213D72,11061,17,18,1,29,48,1498
51182,51182,FF8B7B7C81257B77BA17A83D7D213D72,42071,21,23,2,31,49,1599
51183,51183,E528C1BCF7730647027A4A7EFB058975,42631,0,6,6,43,45,2195
51184,51184,E528C1BCF7730647027A4A7EFB058975,13341,8,11,3,44,45,2245
51185,51185,E528C1BCF7730647027A4A7EFB058975,43061,11,13,2,43,46,2196
51186,51186,E528C1BCF7730647027A4A7EFB058975,13341,13,18,5,44,45,2245
51187,51187,E528C1BCF7730647027A4A7EFB058975,42631,22,23,1,43,45,2195
51188,51188,079D8B606B741550F5C3182CF58367EA,10221,0,3,3,34,49,1749
51189,51189,079D8B606B741550F5C3182CF58367EA,11061,5,17,12,29,48,1498
51190,51190,079D8B606B741550F5C3182CF58367EA,10681,17,19,2,30,48,1548
51191,51191,079D8B606B741550F5C3182CF58367EA,40271,21,23,2,35,49,1799
51198,51198,453CF8B71EBFA2B26AAAC1B1A809BFF0,11381,0,15,15,30,47,1547
51199,51199,453CF8B71EBFA2B26AAAC1B1A809BFF0,40341,17,19,2,23,49,1199
51200,51200,453CF8B71EBFA2B26AAAC1B1A809BFF0,11381,21,23,2,30,47,1547
51201,51201,725C9E186274CB269D9417316DD7C7A3,12401,0,9,9,39,49,1999
51202,51202,725C9E186274CB269D9417316DD7C7A3,11701,12,13,1,43,48,2198
51203,51203,725C9E186274CB269D9417316DD7C7A3,13731,19,20,1,33,49,1699
51204,51204,725C9E186274CB269D9417316DD7C7A3,11751,21,23,2,35,48,1798
51205,51205,38EAD9C71E0631172BE43F523D61F0B8,42971,0,6,6,43,49,2199
51206,51206,38EAD9C71E0631172BE43F523D61F0B8,11381,8,9,1,30,47,1547
51207,51207,38EAD9C71E0631172BE43F523D61F0B8,42971,10,16,6,43,49,2199
51208,51208,38EAD9C71E0631172BE43F523D61F0B8,11381,16,18,2,30,47,1547
51209,51209,38EAD9C71E0631172BE43F523D61F0B8,42971,21,23,2,43,49,2199
51213,51213,026400BF77ED9426898CFF8EBE921A19,43021,0,6,6,16,43,843
51214,51214,026400BF77ED9426898CFF8EBE921A19,12921,7,11,4,9,41,491
51215,51215,026400BF77ED9426898CFF8EBE921A19,43021,11,13,2,16,43,843
51216,51216,026400BF77ED9426898CFF8EBE921A19,10211,17,19,2,16,49,849
51217,51217,026400BF77ED9426898CFF8EBE921A19,43021,21,22,1,16,43,843
51218,51218,35217EACD99DFE586FDD79C48317E8FE,13314,0,9,9,31,39,1589
51219,51219,35217EACD99DFE586FDD79C48317E8FE,12521,12,17,5,35,41,1791
51220,51220,35217EACD99DFE586FDD79C48317E8FE,13314,20,22,2,31,39,1589
51233,51233,1188BB4C68E4ABBC087CBDE7DEC98871,10221,0,18,18,34,49,1749
51234,51234,1188BB4C68E4ABBC087CBDE7DEC98871,41393,18,19,1,43,49,2199
51235,51235,1188BB4C68E4ABBC087CBDE7DEC98871,10221,22,23,1,34,49,1749
51236,51236,007883C4896DAF2F56308DBC4E144D6F,42921,0,8,8,33,47,1697
51237,51237,007883C4896DAF2F56308DBC4E144D6F,10721,8,9,1,31,48,1598
51238,51238,007883C4896DAF2F56308DBC4E144D6F,40034,14,16,2,32,48,1648
51239,51239,007883C4896DAF2F56308DBC4E144D6F,42921,17,19,2,33,47,1697
51240,51240,007883C4896DAF2F56308DBC4E144D6F,40034,19,22,3,32,48,1648
51249,51249,EF70B819C0B2D97BD4189E099D0FE5A9,11861,0,14,14,32,47,1647
51250,51250,EF70B819C0B2D97BD4189E099D0FE5A9,43234,15,17,2,37,49,1899
51251,51251,EF70B819C0B2D97BD4189E099D0FE5A9,10651,18,19,1,36,49,1849
51252,51252,EF70B819C0B2D97BD4189E099D0FE5A9,11861,21,23,2,32,47,1647
51253,51253,C3C0D597EC37E3F55C321A79DFAD37C3,42321,4,5,1,43,47,2197
51254,51254,C3C0D597EC37E3F55C321A79DFAD37C3,11001,5,8,3,42,47,2147
51255,51255,C3C0D597EC37E3F55C321A79DFAD37C3,42321,8,10,2,43,47,2197
51256,51256,C3C0D597EC37E3F55C321A79DFAD37C3,40951,12,14,2,36,49,1849
51257,51257,C3C0D597EC37E3F55C321A79DFAD37C3,11001,14,23,9,42,47,2147
51261,51261,C8236143E8B93D5FDE499177CF2B28F7,11381,0,5,5,30,47,1547
51262,51262,C8236143E8B93D5FDE499177CF2B28F7,42301,8,15,7,36,47,1847
51263,51263,C8236143E8B93D5FDE499177CF2B28F7,11381,19,23,4,30,47,1547
51264,51264,E4A99F1C3E7ED34FBD67066F6ADB6F92,12311,0,13,13,30,44,1544
51265,51265,E4A99F1C3E7ED34FBD67066F6ADB6F92,11321,14,17,3,31,46,1596
51266,51266,E4A99F1C3E7ED34FBD67066F6ADB6F92,12311,17,19,2,30,44,1544
51267,51267,E4A99F1C3E7ED34FBD67066F6ADB6F92,10301,19,20,1,31,45,1595
51268,51268,E4A99F1C3E7ED34FBD67066F6ADB6F92,12311,20,22,2,30,44,1544
51269,51269,414AA00EC00DAA3D830C87A4F3E4DD09,11301,0,1,1,41,49,2099
51270,51270,414AA00EC00DAA3D830C87A4F3E4DD09,10801,3,5,2,42,47,2147
51271,51271,414AA00EC00DAA3D830C87A4F3E4DD09,10121,6,21,15,36,49,1849
51272,51272,EAEFCB977DEDF23C1346736B36A6F67B,42231,10,12,2,37,46,1896
51273,51273,EAEFCB977DEDF23C1346736B36A6F67B,13911,12,14,2,39,46,1996
51274,51274,EAEFCB977DEDF23C1346736B36A6F67B,11261,14,16,2,36,46,1846
51275,51275,EAEFCB977DEDF23C1346736B36A6F67B,13911,17,19,2,39,46,1996
51276,51276,EAEFCB977DEDF23C1346736B36A6F67B,42231,19,21,2,37,46,1896
51280,51280,DEF2119ECB90D4385AD1A45A0B2C7A35,43761,4,5,1,32,47,1647
51281,51281,DEF2119ECB90D4385AD1A45A0B2C7A35,42523,6,8,2,31,47,1597
51282,51282,DEF2119ECB90D4385AD1A45A0B2C7A35,43761,9,14,5,32,47,1647
51283,51283,DEF2119ECB90D4385AD1A45A0B2C7A35,42523,14,16,2,31,47,1597
51284,51284,DEF2119ECB90D4385AD1A45A0B2C7A35,43761,20,21,1,32,47,1647
51285,51285,0A501EA010779C8F9EB8C2F8834C3F4F,10301,0,6,6,31,45,1595
51286,51286,0A501EA010779C8F9EB8C2F8834C3F4F,10351,7,11,4,28,45,1445
51287,51287,0A501EA010779C8F9EB8C2F8834C3F4F,10301,12,14,2,31,45,1595
51288,51288,0A501EA010779C8F9EB8C2F8834C3F4F,10351,14,16,2,28,45,1445
51289,51289,0A501EA010779C8F9EB8C2F8834C3F4F,10301,17,18,1,31,45,1595
51290,51290,0A501EA010779C8F9EB8C2F8834C3F4F,10351,21,22,1,28,45,1445
51294,51294,AF5A01CC6810A302A5F3ABA8915E6058,43011,0,12,12,40,42,2042
51295,51295,AF5A01CC6810A302A5F3ABA8915E6058,42381,13,14,1,39,41,1991
51296,51296,AF5A01CC6810A302A5F3ABA8915E6058,40341,16,18,2,23,49,1199
51297,51297,FADBD24FB94D9388BE2E59D5F595D57D,10781,0,11,11,35,47,1797
51298,51298,FADBD24FB94D9388BE2E59D5F595D57D,42461,15,17,2,45,47,2297
51299,51299,FADBD24FB94D9388BE2E59D5F595D57D,11481,17,19,2,41,48,2098
51300,51300,A0A00D4FFCF39B121347488247DF3626,12311,0,1,1,30,44,1544
51301,51301,A0A00D4FFCF39B121347488247DF3626,10301,2,5,3,31,45,1595
51302,51302,A0A00D4FFCF39B121347488247DF3626,12311,5,9,4,30,44,1544
51303,51303,A0A00D4FFCF39B121347488247DF3626,10531,13,14,1,34,46,1746
51304,51304,A0A00D4FFCF39B121347488247DF3626,11875,15,20,5,30,46,1546
51305,51305,B7C01AFA6392259D8F950CD5BD5A252C,43751,4,10,6,19,48,998
51306,51306,B7C01AFA6392259D8F950CD5BD5A252C,11361,12,14,2,22,48,1148
51307,51307,B7C01AFA6392259D8F950CD5BD5A252C,12581,14,15,1,24,48,1248
51308,51308,B7C01AFA6392259D8F950CD5BD5A252C,11361,15,17,2,22,48,1148
51309,51309,B7C01AFA6392259D8F950CD5BD5A252C,43751,19,21,2,19,48,998
51310,51310,59553EDCBC9A31B6DCDB9C78911399CE,10251,0,9,9,35,47,1797
51311,51311,59553EDCBC9A31B6DCDB9C78911399CE,11381,11,19,8,30,47,1547
51312,51312,59553EDCBC9A31B6DCDB9C78911399CE,10251,19,23,4,35,47,1797
51328,51328,4003E07D2A4AF66E84145561FFA003F3,10341,0,6,6,31,47,1597
51329,51329,4003E07D2A4AF66E84145561FFA003F3,11781,7,11,4,38,49,1949
51330,51330,4003E07D2A4AF66E84145561FFA003F3,10341,12,14,2,31,47,1597
51331,51331,4003E07D2A4AF66E84145561FFA003F3,11794,15,18,3,38,49,1949
51332,51332,4003E07D2A4AF66E84145561FFA003F3,10341,21,23,2,31,47,1597
51333,51333,AF77E83C33BBDAC9BE49E19DF29439BD,42871,0,8,8,30,45,1545
51334,51334,AF77E83C33BBDAC9BE49E19DF29439BD,10121,11,13,2,36,49,1849
51335,51335,AF77E83C33BBDAC9BE49E19DF29439BD,42871,14,17,3,30,45,1545
51336,51336,AF77E83C33BBDAC9BE49E19DF29439BD,11491,19,23,4,36,47,1847
51337,51337,59462C07A8E74ECD5E413125FEE703DF,43671,0,2,2,35,48,1798
51338,51338,59462C07A8E74ECD5E413125FEE703DF,11914,2,14,12,37,48,1898
51339,51339,59462C07A8E74ECD5E413125FEE703DF,40341,15,17,2,23,49,1199
51340,51340,59462C07A8E74ECD5E413125FEE703DF,11914,17,20,3,37,48,1898
51344,51344,2089CCBC2F855C8416A68A67F03D7345,11954,1,7,6,32,49,1649
51345,51345,2089CCBC2F855C8416A68A67F03D7345,40733,8,12,4,32,48,1648
51346,51346,2089CCBC2F855C8416A68A67F03D7345,10401,12,15,3,33,49,1699
51347,51347,2089CCBC2F855C8416A68A67F03D7345,13511,15,19,4,34,48,1748
51348,51348,2089CCBC2F855C8416A68A67F03D7345,40733,19,22,3,32,48,1648
51349,51349,3935D539A580B2666AC76F323CCD607F,12651,2,4,2,43,47,2197
51350,51350,3935D539A580B2666AC76F323CCD607F,11801,4,9,5,42,48,2148
51351,51351,3935D539A580B2666AC76F323CCD607F,10107,11,13,2,38,49,1949
51352,51352,3935D539A580B2666AC76F323CCD607F,10111,13,23,10,37,47,1897
51353,51353,A584DB5FF6EE02AE16BAE873BBEDDAA1,12921,0,8,8,9,41,491
51354,51354,A584DB5FF6EE02AE16BAE873BBEDDAA1,12641,10,11,1,10,43,543
51355,51355,A584DB5FF6EE02AE16BAE873BBEDDAA1,12921,12,16,4,9,41,491
51356,51356,A584DB5FF6EE02AE16BAE873BBEDDAA1,49201,19,21,2,7,41,391
51357,51357,A584DB5FF6EE02AE16BAE873BBEDDAA1,12921,22,23,1,9,41,491
51373,51373,EA462975F784E1573B5FADD38783B549,10771,0,7,7,41,46,2096
51374,51374,EA462975F784E1573B5FADD38783B549,42471,8,9,1,35,49,1799
51375,51375,EA462975F784E1573B5FADD38783B549,40322,12,14,2,38,46,1946
51376,51376,EA462975F784E1573B5FADD38783B549,11481,18,20,2,41,48,2098
51381,51381,35B7E72942C4FC8B9E6675E01B3D7631,42871,4,5,1,30,45,1545
51382,51382,35B7E72942C4FC8B9E6675E01B3D7631,10351,8,10,2,28,45,1445
51383,51383,35B7E72942C4FC8B9E6675E01B3D7631,42871,11,12,1,30,45,1545
51384,51384,35B7E72942C4FC8B9E6675E01B3D7631,10351,14,18,4,28,45,1445
51385,51385,35B7E72942C4FC8B9E6675E01B3D7631,12121,20,23,3,29,47,1497
51386,51386,8F410D7763E688944D9255634F34E13A,11641,2,8,6,22,49,1149
51387,51387,8F410D7763E688944D9255634F34E13A,11151,17,19,2,30,48,1548
51388,51388,8F410D7763E688944D9255634F34E13A,42623,19,20,1,22,49,1149
51389,51389,3C5BF8354C7B22C00BFA5438C070BC0F,13711,1,9,8,38,46,1946
51390,51390,3C5BF8354C7B22C00BFA5438C070BC0F,43241,9,12,3,36,46,1846
51391,51391,3C5BF8354C7B22C00BFA5438C070BC0F,13711,12,14,2,38,46,1946
51392,51392,3C5BF8354C7B22C00BFA5438C070BC0F,43241,14,16,2,36,46,1846
51393,51393,3C5BF8354C7B22C00BFA5438C070BC0F,13711,16,20,4,38,46,1946
51406,51406,FDA9D6C3558498784AFFBE22F15784BA,12031,0,7,7,33,48,1698
51407,51407,FDA9D6C3558498784AFFBE22F15784BA,42461,11,13,2,45,47,2297
51408,51408,FDA9D6C3558498784AFFBE22F15784BA,43061,14,15,1,43,46,2196
51409,51409,FDA9D6C3558498784AFFBE22F15784BA,10491,18,23,5,33,48,1698
51416,51416,58160F8286644CCBCCC72FA14DAD9C05,19114,0,6,6,7,43,393
51417,51417,58160F8286644CCBCCC72FA14DAD9C05,12641,6,8,2,10,43,543
51418,51418,58160F8286644CCBCCC72FA14DAD9C05,19114,8,10,2,7,43,393
51419,51419,58160F8286644CCBCCC72FA14DAD9C05,12641,11,15,4,10,43,543
51420,51420,58160F8286644CCBCCC72FA14DAD9C05,19114,19,23,4,7,43,393
51421,51421,DC84219A18D205A834F01D7743EEEE79,42021,3,6,3,33,47,1697
51422,51422,DC84219A18D205A834F01D7743EEEE79,11231,11,14,3,37,49,1899
51423,51423,DC84219A18D205A834F01D7743EEEE79,10471,15,18,3,37,48,1898
51424,51424,DC84219A18D205A834F01D7743EEEE79,42021,19,21,2,33,47,1697
51425,51425,3C02B5838EDEAB0B15A337805B269A42,13011,0,5,5,39,47,1997
51426,51426,3C02B5838EDEAB0B15A337805B269A42,42321,7,9,2,43,47,2197
51427,51427,3C02B5838EDEAB0B15A337805B269A42,43621,12,14,2,46,48,2348
51428,51428,3C02B5838EDEAB0B15A337805B269A42,42601,14,17,3,44,48,2248
51429,51429,3C02B5838EDEAB0B15A337805B269A42,13011,21,23,2,39,47,1997
51437,51437,D0B254D7FF04227921A82D21D4F3ADC9,43761,1,8,7,32,47,1647
51438,51438,D0B254D7FF04227921A82D21D4F3ADC9,42623,9,10,1,22,49,1149
51439,51439,D0B254D7FF04227921A82D21D4F3ADC9,11861,17,21,4,32,47,1647
51440,51440,EDBEDCDD3729803D79956D4495DD48D8,11261,5,6,1,36,46,1846
51441,51441,EDBEDCDD3729803D79956D4495DD48D8,42864,8,10,2,38,44,1944
51442,51442,EDBEDCDD3729803D79956D4495DD48D8,11261,11,14,3,36,46,1846
51443,51443,EDBEDCDD3729803D79956D4495DD48D8,42864,14,16,2,38,44,1944
51444,51444,EDBEDCDD3729803D79956D4495DD48D8,42861,17,18,1,37,44,1894
51445,51445,EDBEDCDD3729803D79956D4495DD48D8,11261,22,23,1,36,46,1846
51446,51446,946768BFA72752D5660750415178C67F,42161,0,6,6,36,47,1847
51447,51447,946768BFA72752D5660750415178C67F,10511,9,17,8,35,46,1796
51448,51448,946768BFA72752D5660750415178C67F,43731,19,21,2,34,47,1747
51449,51449,946768BFA72752D5660750415178C67F,41101,22,23,1,32,48,1648
51466,51466,91128F0B7E1DD854B9F41D220D1F9DDF,13101,1,15,14,40,47,2047
51467,51467,91128F0B7E1DD854B9F41D220D1F9DDF,11481,15,18,3,41,48,2098
51468,51468,91128F0B7E1DD854B9F41D220D1F9DDF,11201,19,21,2,35,49,1799
51472,51472,2436A9228D45FC2908C701E0F7243928,12651,0,4,4,43,47,2197
51473,51473,2436A9228D45FC2908C701E0F7243928,42601,5,6,1,44,48,2248
51474,51474,2436A9228D45FC2908C701E0F7243928,42091,6,9,3,43,46,2196
51475,51475,2436A9228D45FC2908C701E0F7243928,12651,10,12,2,43,47,2197
51476,51476,2436A9228D45FC2908C701E0F7243928,42091,12,19,7,43,46,2196
51477,51477,2436A9228D45FC2908C701E0F7243928,12651,21,23,2,43,47,2197
51478,51478,639EA486291B8A87A84D90343A87732A,10451,0,6,6,25,48,1298
51479,51479,639EA486291B8A87A84D90343A87732A,10661,11,13,2,37,49,1899
51480,51480,639EA486291B8A87A84D90343A87732A,15311,15,16,1,43,25,2175
51481,51481,639EA486291B8A87A84D90343A87732A,10451,19,23,4,25,48,1298
51482,51482,176F4E967E986DAF00C74DDD3BF2A8FE,11806,1,9,8,41,48,2098
51483,51483,176F4E967E986DAF00C74DDD3BF2A8FE,13331,12,18,6,38,47,1947
51484,51484,176F4E967E986DAF00C74DDD3BF2A8FE,13121,19,20,1,38,46,1946
51485,51485,03375E96342D409BE36FF0E089B8E122,10211,0,2,2,16,49,849
51486,51486,03375E96342D409BE36FF0E089B8E122,19441,4,6,2,8,46,446
51487,51487,03375E96342D409BE36FF0E089B8E122,10211,7,9,2,16,49,849
51488,51488,03375E96342D409BE36FF0E089B8E122,19441,12,23,11,8,46,446
51502,51502,964156E683797EC321E31C806CD19178,11914,0,5,5,37,48,1898
51503,51503,964156E683797EC321E31C806CD19178,10221,6,10,4,34,49,1749
51504,51504,964156E683797EC321E31C806CD19178,11914,12,14,2,37,48,1898
51505,51505,964156E683797EC321E31C806CD19178,42581,19,20,1,38,48,1948
51506,51506,964156E683797EC321E31C806CD19178,11914,22,23,1,37,48,1898
51514,51514,292AD485DA7AE4FB3CFCA1190DC036DF,42151,0,10,10,35,45,1795
51515,51515,292AD485DA7AE4FB3CFCA1190DC036DF,12311,13,19,6,30,44,1544
51516,51516,292AD485DA7AE4FB3CFCA1190DC036DF,42151,19,23,4,35,45,1795
51517,51517,48E848BEC812456E7DD8396BAFEE6761,10421,0,8,8,41,48,2098
51518,51518,48E848BEC812456E7DD8396BAFEE6761,10841,11,13,2,37,47,1897
51519,51519,48E848BEC812456E7DD8396BAFEE6761,42801,15,18,3,40,49,2049
51520,51520,F1089F554EDD989C3763AB8DD5D7CDEF,12921,2,3,1,9,41,491
51521,51521,F1089F554EDD989C3763AB8DD5D7CDEF,12641,6,20,14,10,43,543
51522,51522,F1089F554EDD989C3763AB8DD5D7CDEF,19021,21,22,1,10,45,545
51529,51529,C8E1F9FF4BDCF5DC404825DE8B951E8C,43761,0,6,6,32,47,1647
51530,51530,C8E1F9FF4BDCF5DC404825DE8B951E8C,42961,8,12,4,35,49,1799
51531,51531,C8E1F9FF4BDCF5DC404825DE8B951E8C,11271,15,16,1,37,48,1898
51532,51532,C8E1F9FF4BDCF5DC404825DE8B951E8C,43761,17,22,5,32,47,1647
51533,51533,7DEB53A4993B41126407300DE16CC673,11171,0,15,15,33,48,1698
51534,51534,7DEB53A4993B41126407300DE16CC673,40171,16,17,1,38,48,1948
51535,51535,7DEB53A4993B41126407300DE16CC673,11171,20,23,3,33,48,1698
51546,51546,71AB304A084EB4095E1F705C48CB0E23,11901,0,7,7,42,49,2149
51547,51547,71AB304A084EB4095E1F705C48CB0E23,11914,12,17,5,37,48,1898
51548,51548,71AB304A084EB4095E1F705C48CB0E23,11901,19,23,4,42,49,2149
51556,51556,AA51DE94270AE4663B2578A38D4EECC9,13961,0,7,7,42,48,2148
51557,51557,AA51DE94270AE4663B2578A38D4EECC9,11914,9,11,2,37,48,1898
51558,51558,AA51DE94270AE4663B2578A38D4EECC9,13961,12,13,1,42,48,2148
51559,51559,AA51DE94270AE4663B2578A38D4EECC9,11914,14,15,1,37,48,1898
51560,51560,AA51DE94270AE4663B2578A38D4EECC9,13961,18,23,5,42,48,2148
51594,51594,5A136F6B72A92895FAEED5900AD9C82B,11111,0,14,14,26,48,1348
51595,51595,5A136F6B72A92895FAEED5900AD9C82B,42541,14,16,2,25,47,1297
51596,51596,5A136F6B72A92895FAEED5900AD9C82B,40951,19,20,1,36,49,1849
51597,51597,5A136F6B72A92895FAEED5900AD9C82B,42461,21,23,2,45,47,2297
51598,51598,F4EE372BA019175C25249C887C1C24C1,40277,0,8,8,35,49,1799
51599,51599,F4EE372BA019175C25249C887C1C24C1,11461,11,14,3,37,49,1899
51600,51600,F4EE372BA019175C25249C887C1C24C1,13121,18,19,1,38,46,1946
51601,51601,F4EE372BA019175C25249C887C1C24C1,40277,21,23,2,35,49,1799
51605,51605,5601C1A44CC85C7B09354B38FD0628D1,12311,0,13,13,30,44,1544
51606,51606,5601C1A44CC85C7B09354B38FD0628D1,13731,14,16,2,33,49,1699
51607,51607,5601C1A44CC85C7B09354B38FD0628D1,12311,20,23,3,30,44,1544
51608,51608,545F2E4E95EA840FE3D40F4E20170AA4,10841,0,8,8,37,47,1897
51609,51609,545F2E4E95EA840FE3D40F4E20170AA4,11531,9,10,1,34,49,1749
51610,51610,545F2E4E95EA840FE3D40F4E20170AA4,40341,15,16,1,23,49,1199
51611,51611,545F2E4E95EA840FE3D40F4E20170AA4,10841,21,23,2,37,47,1897
51612,51612,17D90E764FEB264827519C543FC27A49,43081,0,2,2,27,28,1378
51613,51613,17D90E764FEB264827519C543FC27A49,43121,2,8,6,25,27,1277
51614,51614,17D90E764FEB264827519C543FC27A49,15321,9,10,1,29,26,1476
51615,51615,17D90E764FEB264827519C543FC27A49,43121,15,17,2,25,27,1277
51616,51616,17D90E764FEB264827519C543FC27A49,19801,18,19,1,19,26,976
51617,51617,17D90E764FEB264827519C543FC27A49,43121,20,22,2,25,27,1277
51618,51618,83D4CEED38BB3CF6CFCB6A83B566A9F4,13411,0,1,1,49,42,2492
51619,51619,83D4CEED38BB3CF6CFCB6A83B566A9F4,10751,3,5,2,47,43,2393
51620,51620,83D4CEED38BB3CF6CFCB6A83B566A9F4,12561,6,7,1,45,43,2293
51621,51621,83D4CEED38BB3CF6CFCB6A83B566A9F4,13411,8,9,1,49,42,2492
51622,51622,83D4CEED38BB3CF6CFCB6A83B566A9F4,43951,13,15,2,49,41,2491
51623,51623,83D4CEED38BB3CF6CFCB6A83B566A9F4,13411,16,18,2,49,42,2492
51624,51624,83D4CEED38BB3CF6CFCB6A83B566A9F4,43951,19,21,2,49,41,2491
51631,51631,0EA80F49CAFA9BFC58CF0D20F7967BFF,42871,0,5,5,30,45,1545
51632,51632,0EA80F49CAFA9BFC58CF0D20F7967BFF,12311,7,10,3,30,44,1544
51633,51633,0EA80F49CAFA9BFC58CF0D20F7967BFF,42871,11,20,9,30,45,1545
51634,51634,0EA80F49CAFA9BFC58CF0D20F7967BFF,19441,20,22,2,8,46,446
51635,51635,F75226334F4DDE1D433311F65C34BFC9,42121,1,7,6,26,49,1349
51636,51636,F75226334F4DDE1D433311F65C34BFC9,12391,9,11,2,36,49,1849
51637,51637,F75226334F4DDE1D433311F65C34BFC9,13561,16,17,1,37,49,1899
51638,51638,F75226334F4DDE1D433311F65C34BFC9,11061,20,22,2,29,48,1498
51639,51639,4A64F91296EF8C1DAA19E0A02FF0729A,11151,0,8,8,30,48,1548
51640,51640,4A64F91296EF8C1DAA19E0A02FF0729A,10231,9,17,8,39,49,1999
51641,51641,4A64F91296EF8C1DAA19E0A02FF0729A,42321,19,21,2,43,47,2197
51642,51642,4A64F91296EF8C1DAA19E0A02FF0729A,11011,22,23,1,39,49,1999
51646,51646,6EF69708DD923556D4EF232AA0406F1C,11941,0,6,6,37,46,1896
51647,51647,6EF69708DD923556D4EF232AA0406F1C,42351,10,11,1,38,45,1945
51648,51648,6EF69708DD923556D4EF232AA0406F1C,11941,12,13,1,37,46,1896
51649,51649,6EF69708DD923556D4EF232AA0406F1C,42351,15,17,2,38,45,1945
51650,51650,6EF69708DD923556D4EF232AA0406F1C,11941,21,23,2,37,46,1896
51657,51657,C493E8EAD829832CA31397E82BE4990B,43021,0,6,6,16,43,843
51658,51658,C493E8EAD829832CA31397E82BE4990B,12921,6,8,2,9,41,491
51659,51659,C493E8EAD829832CA31397E82BE4990B,43021,10,22,12,16,43,843
51660,51660,9578C0DC67ACE68D6F89F515DBD5C8C2,19031,0,4,4,1,42,92
51661,51661,9578C0DC67ACE68D6F89F515DBD5C8C2,12921,7,18,11,9,41,491
51662,51662,9578C0DC67ACE68D6F89F515DBD5C8C2,19031,22,23,1,1,42,92
51667,51667,23F8F9B0AC0C62AC07DD5CA5BCEDE820,43101,1,5,4,46,40,2340
51668,51668,23F8F9B0AC0C62AC07DD5CA5BCEDE820,13551,6,9,3,45,38,2288
51669,51669,23F8F9B0AC0C62AC07DD5CA5BCEDE820,43101,9,13,4,46,40,2340
51670,51670,23F8F9B0AC0C62AC07DD5CA5BCEDE820,13551,14,16,2,45,38,2288
51671,51671,23F8F9B0AC0C62AC07DD5CA5BCEDE820,43101,16,18,2,46,40,2340
51672,51672,23F8F9B0AC0C62AC07DD5CA5BCEDE820,13551,18,20,2,45,38,2288
51673,51673,23F8F9B0AC0C62AC07DD5CA5BCEDE820,43101,20,21,1,46,40,2340
51674,51674,8488B5FD6EEE6D77327A7352AE326044,10271,0,8,8,37,46,1896
51675,51675,8488B5FD6EEE6D77327A7352AE326044,12131,10,13,3,32,47,1647
51676,51676,8488B5FD6EEE6D77327A7352AE326044,13121,19,20,1,38,46,1946
51677,51677,BF29A9480BAB7B58A18F76AD129514BD,10111,0,7,7,37,47,1897
51678,51678,BF29A9480BAB7B58A18F76AD129514BD,42521,8,10,2,31,47,1597
51679,51679,BF29A9480BAB7B58A18F76AD129514BD,10111,13,23,10,37,47,1897
51684,51684,8DB618DDA1266709AAF971BEF0B00244,10151,0,8,8,34,47,1747
51685,51685,8DB618DDA1266709AAF971BEF0B00244,10971,12,13,1,35,47,1797
51686,51686,8DB618DDA1266709AAF971BEF0B00244,43731,14,16,2,34,47,1747
51687,51687,8DB618DDA1266709AAF971BEF0B00244,10191,19,21,2,40,48,2048
51688,51688,D9AF0A0BEFAFF72D2F6D04084706EE69,43051,0,5,5,46,45,2345
51689,51689,D9AF0A0BEFAFF72D2F6D04084706EE69,10381,7,17,10,31,49,1599
51690,51690,D9AF0A0BEFAFF72D2F6D04084706EE69,43051,20,23,3,46,45,2345
51691,51691,8022990AE31C9584DEB8AC231685A64C,10341,0,1,1,31,47,1597
51692,51692,8022990AE31C9584DEB8AC231685A64C,42491,3,6,3,32,46,1646
51693,51693,8022990AE31C9584DEB8AC231685A64C,10341,10,14,4,31,47,1597
51694,51694,8022990AE31C9584DEB8AC231685A64C,10292,14,15,1,30,47,1547
51695,51695,8022990AE31C9584DEB8AC231685A64C,42523,18,22,4,31,47,1597
51696,51696,F7752CA1B73DF28C3ED02C34596B4599,10451,0,8,8,25,48,1298
51697,51697,F7752CA1B73DF28C3ED02C34596B4599,40431,11,12,1,36,47,1847
51698,51698,F7752CA1B73DF28C3ED02C34596B4599,10251,13,14,1,35,47,1797
51699,51699,F7752CA1B73DF28C3ED02C34596B4599,11491,15,19,4,36,47,1847
51700,51700,F7752CA1B73DF28C3ED02C34596B4599,10451,20,22,2,25,48,1298
51704,51704,220BB9CC5F3F3413B665192BBE457CBF,11874,0,15,15,29,46,1496
51705,51705,220BB9CC5F3F3413B665192BBE457CBF,43581,16,18,2,33,48,1698
51706,51706,220BB9CC5F3F3413B665192BBE457CBF,11874,19,23,4,29,46,1496
51710,51710,B1891B03CB53C325B13F0CF9131A1E17,12921,0,2,2,9,41,491
51711,51711,B1891B03CB53C325B13F0CF9131A1E17,12641,5,6,1,10,43,543
51712,51712,B1891B03CB53C325B13F0CF9131A1E17,12921,7,9,2,9,41,491
51713,51713,B1891B03CB53C325B13F0CF9131A1E17,12641,9,12,3,10,43,543
51714,51714,B1891B03CB53C325B13F0CF9131A1E17,12921,15,23,8,9,41,491
51715,51715,DEE4493A8D978CF636AED3AFAE90639D,42741,0,7,7,43,48,2198
51716,51716,DEE4493A8D978CF636AED3AFAE90639D,10401,8,9,1,33,49,1699
51717,51717,DEE4493A8D978CF636AED3AFAE90639D,11701,14,23,9,43,48,2198
51728,51728,50AD8ACDABF8BBC007C0D64420D91B51,11861,0,8,8,32,47,1647
51729,51729,50AD8ACDABF8BBC007C0D64420D91B51,12381,8,10,2,32,48,1648
51730,51730,50AD8ACDABF8BBC007C0D64420D91B51,11861,12,13,1,32,47,1647
51731,51731,50AD8ACDABF8BBC007C0D64420D91B51,12381,14,18,4,32,48,1648
51732,51732,50AD8ACDABF8BBC007C0D64420D91B51,11861,20,23,3,32,47,1647
51742,51742,25F1B1F901DD17A5CCAEC6EC47760B2D,11541,0,6,6,35,49,1799
51743,51743,25F1B1F901DD17A5CCAEC6EC47760B2D,11861,7,8,1,32,47,1647
51744,51744,25F1B1F901DD17A5CCAEC6EC47760B2D,11021,9,10,1,36,49,1849
51745,51745,25F1B1F901DD17A5CCAEC6EC47760B2D,13561,14,17,3,37,49,1899
51746,51746,25F1B1F901DD17A5CCAEC6EC47760B2D,10411,20,22,2,36,48,1848
51758,51758,2873DE93703B028193B7B9719DCFE691,12521,0,7,7,35,41,1791
51759,51759,2873DE93703B028193B7B9719DCFE691,43451,7,11,4,37,40,1890
51760,51760,2873DE93703B028193B7B9719DCFE691,12521,11,14,3,35,41,1791
51761,51761,2873DE93703B028193B7B9719DCFE691,43451,14,17,3,37,40,1890
51762,51762,2873DE93703B028193B7B9719DCFE691,12521,18,23,5,35,41,1791
51763,51763,28F1AB85A750275EF5C579DACEDC349F,15391,8,9,1,35,26,1776
51764,51764,28F1AB85A750275EF5C579DACEDC349F,12792,13,14,1,34,30,1730
51765,51765,28F1AB85A750275EF5C579DACEDC349F,15391,15,17,2,35,26,1776
51766,51766,28F1AB85A750275EF5C579DACEDC349F,12792,20,22,2,34,30,1730
51767,51767,CB8AB4679DC32DD6A932DF956F8FA480,19821,0,5,5,4,46,246
51768,51768,CB8AB4679DC32DD6A932DF956F8FA480,19021,7,14,7,10,45,545
51769,51769,CB8AB4679DC32DD6A932DF956F8FA480,43021,14,19,5,16,43,843
51770,51770,CB8AB4679DC32DD6A932DF956F8FA480,19021,19,23,4,10,45,545
51771,51771,F8A2EC8C9348BFB1362087B807B825C5,43971,1,7,6,30,48,1548
51772,51772,F8A2EC8C9348BFB1362087B807B825C5,11541,8,16,8,35,49,1799
51773,51773,F8A2EC8C9348BFB1362087B807B825C5,43761,19,21,2,32,47,1647
51774,51774,7861278735CDA91B9BABB196FBF7605C,43951,3,6,3,49,41,2491
51775,51775,7861278735CDA91B9BABB196FBF7605C,13951,13,17,4,47,45,2395
51776,51776,7861278735CDA91B9BABB196FBF7605C,43951,19,23,4,49,41,2491
51777,51777,09E35A3086ED2C100882D697DC471A83,42231,0,9,9,37,46,1896
51778,51778,09E35A3086ED2C100882D697DC471A83,11861,10,16,6,32,47,1647
51779,51779,09E35A3086ED2C100882D697DC471A83,42521,16,18,2,31,47,1597
51780,51780,09E35A3086ED2C100882D697DC471A83,42231,19,23,4,37,46,1896
51787,51787,6BF85B7300ADAE0F83C20B2AF5821019,11021,4,5,1,36,49,1849
51788,51788,6BF85B7300ADAE0F83C20B2AF5821019,11381,6,19,13,30,47,1547
51789,51789,6BF85B7300ADAE0F83C20B2AF5821019,11021,20,22,2,36,49,1849
51793,51793,A7889E15E0F93853EAB5CF324793B9C0,15411,0,2,2,44,27,2227
51794,51794,A7889E15E0F93853EAB5CF324793B9C0,12792,6,8,2,34,30,1730
51795,51795,A7889E15E0F93853EAB5CF324793B9C0,12611,9,20,11,41,29,2079
51802,51802,F552BBAFE22D025B0F7E0055A73A2709,42321,0,15,15,43,47,2197
51803,51803,F552BBAFE22D025B0F7E0055A73A2709,42021,17,19,2,33,47,1697
51804,51804,F552BBAFE22D025B0F7E0055A73A2709,42321,22,23,1,43,47,2197
51808,51808,C84B7C38DACE5AC2A5E08B2774373378,11861,0,2,2,32,47,1647
51809,51809,C84B7C38DACE5AC2A5E08B2774373378,42021,3,4,1,33,47,1697
51810,51810,C84B7C38DACE5AC2A5E08B2774373378,43761,7,16,9,32,47,1647
51811,51811,C84B7C38DACE5AC2A5E08B2774373378,12514,19,23,4,38,47,1947
51825,51825,0B302A96FA0DFDEB2B3F6999345F0CFE,10661,0,1,1,37,49,1899
51826,51826,0B302A96FA0DFDEB2B3F6999345F0CFE,10351,12,13,1,28,45,1445
51827,51827,0B302A96FA0DFDEB2B3F6999345F0CFE,12661,14,15,1,32,45,1645
51828,51828,0B302A96FA0DFDEB2B3F6999345F0CFE,12311,18,19,1,30,44,1544
51832,51832,A7D9C28461137D2FC40006F87C9506F9,42531,0,2,2,31,45,1595
51833,51833,A7D9C28461137D2FC40006F87C9506F9,12311,2,7,5,30,44,1544
51834,51834,A7D9C28461137D2FC40006F87C9506F9,13671,9,11,2,27,43,1393
51835,51835,A7D9C28461137D2FC40006F87C9506F9,12311,15,16,1,30,44,1544
51836,51836,A7D9C28461137D2FC40006F87C9506F9,42531,18,19,1,31,45,1595
51841,51841,32DCF9B9C7944C965DC3FD9593FC89B0,12381,0,15,15,32,48,1648
51842,51842,32DCF9B9C7944C965DC3FD9593FC89B0,11331,15,19,4,37,48,1898
51843,51843,32DCF9B9C7944C965DC3FD9593FC89B0,12381,19,23,4,32,48,1648
51847,51847,580384722AC773BEB22F8D45FD82A53A,43971,0,7,7,30,48,1548
51848,51848,580384722AC773BEB22F8D45FD82A53A,11541,8,13,5,35,49,1799
51849,51849,580384722AC773BEB22F8D45FD82A53A,11021,15,17,2,36,49,1849
51850,51850,580384722AC773BEB22F8D45FD82A53A,42521,20,21,1,31,47,1597
51858,51858,6F4E8464FE990D86D6465E6B128A5DC9,10107,0,5,5,38,49,1949
51859,51859,6F4E8464FE990D86D6465E6B128A5DC9,13121,6,9,3,38,46,1946
51860,51860,6F4E8464FE990D86D6465E6B128A5DC9,42231,10,11,1,37,46,1896
51861,51861,6F4E8464FE990D86D6465E6B128A5DC9,12021,13,14,1,37,49,1899
51862,51862,6F4E8464FE990D86D6465E6B128A5DC9,10107,15,23,8,38,49,1949
51863,51863,D1B681929BD44A1A7918A0268A3E43F0,43644,8,9,1,14,38,738
51864,51864,D1B681929BD44A1A7918A0268A3E43F0,43021,10,15,5,16,43,843
51865,51865,D1B681929BD44A1A7918A0268A3E43F0,12921,18,21,3,9,41,491
51872,51872,DF6451E86EE4B7B98BCA60FC558F51EE,11151,0,7,7,30,48,1548
51873,51873,DF6451E86EE4B7B98BCA60FC558F51EE,11061,11,14,3,29,48,1498
51874,51874,DF6451E86EE4B7B98BCA60FC558F51EE,10107,17,18,1,38,49,1949
51875,51875,DF6451E86EE4B7B98BCA60FC558F51EE,12121,20,21,1,29,47,1497
51876,51876,DF6451E86EE4B7B98BCA60FC558F51EE,11061,22,23,1,29,48,1498
51886,51886,EB3039C415C508F2A2DCF6403E75C42C,12921,0,1,1,9,41,491
51887,51887,EB3039C415C508F2A2DCF6403E75C42C,43021,2,3,1,16,43,843
51888,51888,EB3039C415C508F2A2DCF6403E75C42C,12921,5,19,14,9,41,491
51896,51896,28EBB6D57CDF154CAAA637D0ED8F305E,11091,0,9,9,29,47,1497
51897,51897,28EBB6D57CDF154CAAA637D0ED8F305E,10191,10,12,2,40,48,2048
51898,51898,28EBB6D57CDF154CAAA637D0ED8F305E,11091,13,23,10,29,47,1497
51899,51899,7A04A13186C46A4BE6B54AB67E18C35D,10711,0,8,8,29,46,1496
51900,51900,7A04A13186C46A4BE6B54AB67E18C35D,10251,12,18,6,35,47,1797
51901,51901,7A04A13186C46A4BE6B54AB67E18C35D,41382,19,21,2,38,49,1949
51902,51902,7A04A13186C46A4BE6B54AB67E18C35D,10711,22,23,1,29,46,1496
51903,51903,39BBEF64C110B28293452839586DC4E1,10151,0,9,9,34,47,1747
51904,51904,39BBEF64C110B28293452839586DC4E1,12651,12,13,1,43,47,2197
51905,51905,39BBEF64C110B28293452839586DC4E1,10971,14,23,9,35,47,1797
51906,51906,1F949A970A3E8661837D63293CE7BC6E,11381,1,7,6,30,47,1547
51907,51907,1F949A970A3E8661837D63293CE7BC6E,10951,10,12,2,29,48,1498
51908,51908,1F949A970A3E8661837D63293CE7BC6E,11381,14,17,3,30,47,1547
51909,51909,1F949A970A3E8661837D63293CE7BC6E,10951,18,19,1,29,48,1498
51910,51910,1F949A970A3E8661837D63293CE7BC6E,11381,20,22,2,30,47,1547
51911,51911,01BB57E0BBF62CECCF856EA7530FA9E6,11381,0,13,13,30,47,1547
51912,51912,01BB57E0BBF62CECCF856EA7530FA9E6,11211,15,16,1,34,49,1749
51913,51913,01BB57E0BBF62CECCF856EA7530FA9E6,11381,18,23,5,30,47,1547
51914,51914,B2CA6B7E0BCD008B324984A2D3F8C3D1,10381,0,2,2,31,49,1599
51915,51915,B2CA6B7E0BCD008B324984A2D3F8C3D1,42623,2,5,3,22,49,1149
51916,51916,B2CA6B7E0BCD008B324984A2D3F8C3D1,10381,10,11,1,31,49,1599
51917,51917,B2CA6B7E0BCD008B324984A2D3F8C3D1,10681,12,13,1,30,48,1548
51918,51918,B2CA6B7E0BCD008B324984A2D3F8C3D1,42261,14,18,4,25,49,1299
51935,51935,17B310C5C0CD98D91D2EAE008E1E6775,42491,0,8,8,32,46,1646
51936,51936,17B310C5C0CD98D91D2EAE008E1E6775,13511,8,13,5,34,48,1748
51937,51937,17B310C5C0CD98D91D2EAE008E1E6775,42491,14,16,2,32,46,1646
51938,51938,17B310C5C0CD98D91D2EAE008E1E6775,40951,21,23,2,36,49,1849
51939,51939,E4F338B84B3349686A0D17B79D7187EC,43391,0,10,10,29,48,1498
51940,51940,E4F338B84B3349686A0D17B79D7187EC,42261,16,18,2,25,49,1299
51941,51941,E4F338B84B3349686A0D17B79D7187EC,11061,19,20,1,29,48,1498
51942,51942,096291A7826A281BB9AE079B593A0255,42691,0,8,8,24,48,1248
51943,51943,096291A7826A281BB9AE079B593A0255,11361,9,11,2,22,48,1148
51944,51944,096291A7826A281BB9AE079B593A0255,42691,14,15,1,24,48,1248
51945,51945,096291A7826A281BB9AE079B593A0255,11361,16,17,1,22,48,1148
51946,51946,096291A7826A281BB9AE079B593A0255,43751,21,23,2,19,48,998
51947,51947,DAE197CEBF1E1EC8C00EDC17E5E96BDF,10381,1,9,8,31,49,1599
51948,51948,DAE197CEBF1E1EC8C00EDC17E5E96BDF,19441,12,14,2,8,46,446
51949,51949,DAE197CEBF1E1EC8C00EDC17E5E96BDF,19021,16,17,1,10,45,545
51950,51950,DAE197CEBF1E1EC8C00EDC17E5E96BDF,40101,20,23,3,34,49,1749
51958,51958,73F5D46A0AB49D3D1FF3EBE9DD0774B5,42864,3,5,2,38,44,1944
51959,51959,73F5D46A0AB49D3D1FF3EBE9DD0774B5,11261,9,11,2,36,46,1846
51960,51960,73F5D46A0AB49D3D1FF3EBE9DD0774B5,42864,11,14,3,38,44,1944
51961,51961,73F5D46A0AB49D3D1FF3EBE9DD0774B5,11261,14,21,7,36,46,1846
51962,51962,73F5D46A0AB49D3D1FF3EBE9DD0774B5,13711,21,23,2,38,46,1946
51963,51963,8C93E9687A717AEFB87364B357E16B82,10771,3,12,9,41,46,2096
51964,51964,8C93E9687A717AEFB87364B357E16B82,42031,13,17,4,40,46,2046
51965,51965,8C93E9687A717AEFB87364B357E16B82,12121,19,21,2,29,47,1497
51966,51966,CA5A17D561EB9E25269F629C4481540B,19441,0,3,3,8,46,446
51967,51967,CA5A17D561EB9E25269F629C4481540B,11851,4,5,1,13,47,697
51968,51968,CA5A17D561EB9E25269F629C4481540B,19441,9,22,13,8,46,446
51977,51977,5FF9CE460A753808614E5114D88F66EB,40801,0,8,8,43,46,2196
51978,51978,5FF9CE460A753808614E5114D88F66EB,12511,9,10,1,39,47,1997
51979,51979,5FF9CE460A753808614E5114D88F66EB,40801,15,21,6,43,46,2196
51980,51980,5FF9CE460A753808614E5114D88F66EB,13111,21,23,2,42,46,2146
51988,51988,27F132E818644D3933B7D51A13F3BE57,15561,2,5,3,32,22,1622
51989,51989,27F132E818644D3933B7D51A13F3BE57,15411,6,15,9,44,27,2227
51990,51990,27F132E818644D3933B7D51A13F3BE57,12611,19,21,2,41,29,2079
51991,51991,8B240577C4A0D036E2A4638BD31BE4F4,10471,0,8,8,37,48,1898
51992,51992,8B240577C4A0D036E2A4638BD31BE4F4,43761,12,13,1,32,47,1647
51993,51993,8B240577C4A0D036E2A4638BD31BE4F4,43281,18,19,1,37,48,1898
51998,51998,53173294ED5BF12AABAED82F9B761816,10161,0,7,7,35,49,1799
51999,51999,53173294ED5BF12AABAED82F9B761816,42801,9,10,1,40,49,2049
52000,52000,53173294ED5BF12AABAED82F9B761816,10161,15,23,8,35,49,1799
52001,52001,7CFAECF5A2F1F9BFEFF6C033052830B4,19901,0,6,6,7,44,394
52002,52002,7CFAECF5A2F1F9BFEFF6C033052830B4,12921,7,9,2,9,41,491
52003,52003,7CFAECF5A2F1F9BFEFF6C033052830B4,19904,12,13,1,9,44,494
52004,52004,7CFAECF5A2F1F9BFEFF6C033052830B4,12641,13,18,5,10,43,543
52005,52005,1FA24F76587DEEEE9ED93C46D3D68950,42371,0,2,2,34,46,1746
52006,52006,1FA24F76587DEEEE9ED93C46D3D68950,12491,3,8,5,36,43,1843
52007,52007,1FA24F76587DEEEE9ED93C46D3D68950,42371,10,22,12,34,46,1746
52008,52008,88E74CFA5533F81EA31BBF365BBFF625,10451,0,3,3,25,48,1298
52009,52009,88E74CFA5533F81EA31BBF365BBFF625,42121,3,4,1,26,49,1349
52010,52010,88E74CFA5533F81EA31BBF365BBFF625,10451,5,6,1,25,48,1298
52011,52011,88E74CFA5533F81EA31BBF365BBFF625,13094,9,11,2,21,42,1092
52012,52012,88E74CFA5533F81EA31BBF365BBFF625,10451,13,23,10,25,48,1298
52013,52013,D5AD4B67900B7396AED4AEDC3733EA39,40341,10,11,1,23,49,1199
52014,52014,D5AD4B67900B7396AED4AEDC3733EA39,13121,14,15,1,38,46,1946
52015,52015,D5AD4B67900B7396AED4AEDC3733EA39,10841,18,23,5,37,47,1897
52016,52016,E131C5415CA4464B2E2B8BBC4B15D17C,43761,0,7,7,32,47,1647
52017,52017,E131C5415CA4464B2E2B8BBC4B15D17C,10221,10,15,5,34,49,1749
52018,52018,E131C5415CA4464B2E2B8BBC4B15D17C,11541,20,21,1,35,49,1799
52022,52022,A349D8C83E1914464A7CDA23A563E70B,42523,10,11,1,31,47,1597
52023,52023,A349D8C83E1914464A7CDA23A563E70B,40951,13,14,1,36,49,1849
52024,52024,A349D8C83E1914464A7CDA23A563E70B,42523,16,23,7,31,47,1597
52025,52025,967E72F56ED0F6187421670106E81599,10716,0,9,9,30,46,1546
52026,52026,967E72F56ED0F6187421670106E81599,10711,10,20,10,29,46,1496
52027,52027,967E72F56ED0F6187421670106E81599,10841,21,23,2,37,47,1897
52028,52028,A4FB037706170157DA9B94939FEE9474,11001,0,7,7,42,47,2147
52029,52029,A4FB037706170157DA9B94939FEE9474,10841,10,12,2,37,47,1897
52030,52030,A4FB037706170157DA9B94939FEE9474,12514,14,16,2,38,47,1947
52031,52031,A4FB037706170157DA9B94939FEE9474,10841,17,18,1,37,47,1897
52032,52032,A4FB037706170157DA9B94939FEE9474,10601,18,21,3,39,47,1997
52033,52033,62680DC1DD364698E0339E53A261CB1F,11271,0,6,6,37,48,1898
52034,52034,62680DC1DD364698E0339E53A261CB1F,12601,9,14,5,25,47,1297
52035,52035,62680DC1DD364698E0339E53A261CB1F,11271,17,23,6,37,48,1898
52043,52043,1463E9838EB11802DBC75E65276D110F,42531,1,5,4,31,45,1595
52044,52044,1463E9838EB11802DBC75E65276D110F,12521,9,16,7,35,41,1791
52045,52045,1463E9838EB11802DBC75E65276D110F,42531,20,21,1,31,45,1595
52053,52053,A94573BDDECBBDBAA7F89BE9CE71D3CF,43581,0,6,6,33,48,1698
52054,52054,A94573BDDECBBDBAA7F89BE9CE71D3CF,43481,8,9,1,39,48,1998
52055,52055,A94573BDDECBBDBAA7F89BE9CE71D3CF,11074,12,13,1,37,47,1897
52056,52056,A94573BDDECBBDBAA7F89BE9CE71D3CF,43481,13,14,1,39,48,1998
52057,52057,A94573BDDECBBDBAA7F89BE9CE71D3CF,43581,19,23,4,33,48,1698
52061,52061,024AB2D90319DF57F94996854D076E3D,40833,0,7,7,41,47,2097
52062,52062,024AB2D90319DF57F94996854D076E3D,11531,9,11,2,34,49,1749
52063,52063,024AB2D90319DF57F94996854D076E3D,40271,11,17,6,35,49,1799
52064,52064,024AB2D90319DF57F94996854D076E3D,10721,21,22,1,31,48,1598
52068,52068,D9FB9F3F4820A4EF951566780A770C45,11261,0,7,7,36,46,1846
52069,52069,D9FB9F3F4820A4EF951566780A770C45,13911,7,8,1,39,46,1996
52070,52070,D9FB9F3F4820A4EF951566780A770C45,11261,11,12,1,36,46,1846
52071,52071,D9FB9F3F4820A4EF951566780A770C45,13911,17,18,1,39,46,1996
52072,52072,D9FB9F3F4820A4EF951566780A770C45,42231,19,20,1,37,46,1896
52093,52093,82B9DE1C452C89862B559CE0DF4F04BF,15051,0,7,7,19,4,954
52094,52094,82B9DE1C452C89862B559CE0DF4F04BF,16281,8,12,4,11,4,554
52095,52095,82B9DE1C452C89862B559CE0DF4F04BF,15051,12,22,10,19,4,954
52099,52099,B7832DB383CB1E7DD6C87A81AAE89D66,42221,0,3,3,38,48,1948
52100,52100,B7832DB383CB1E7DD6C87A81AAE89D66,11914,3,7,4,37,48,1898
52101,52101,B7832DB383CB1E7DD6C87A81AAE89D66,11074,7,8,1,37,47,1897
52102,52102,B7832DB383CB1E7DD6C87A81AAE89D66,42221,11,14,3,38,48,1948
52103,52103,B7832DB383CB1E7DD6C87A81AAE89D66,11074,18,19,1,37,47,1897
52107,52107,1C12FD1823A36FA85667FC8316128B0A,13681,1,2,1,38,47,1947
52108,52108,1C12FD1823A36FA85667FC8316128B0A,42301,2,4,2,36,47,1847
52109,52109,1C12FD1823A36FA85667FC8316128B0A,13331,6,7,1,38,47,1947
52110,52110,1C12FD1823A36FA85667FC8316128B0A,42511,13,14,1,37,47,1897
52111,52111,1C12FD1823A36FA85667FC8316128B0A,13121,15,16,1,38,46,1946
52112,52112,1C12FD1823A36FA85667FC8316128B0A,42511,16,18,2,37,47,1897
52119,52119,A922D7161F816C1FD25F52BCCB616DFE,40673,0,9,9,36,48,1848
52120,52120,A922D7161F816C1FD25F52BCCB616DFE,10251,9,12,3,35,47,1797
52121,52121,A922D7161F816C1FD25F52BCCB616DFE,40673,13,15,2,36,48,1848
52122,52122,A922D7161F816C1FD25F52BCCB616DFE,10251,18,19,1,35,47,1797
52123,52123,A922D7161F816C1FD25F52BCCB616DFE,40673,22,23,1,36,48,1848
52124,52124,A98EFFE1F83A80D81FB02056DDB7FB66,42351,0,11,11,38,45,1945
52125,52125,A98EFFE1F83A80D81FB02056DDB7FB66,13711,12,13,1,38,46,1946
52126,52126,A98EFFE1F83A80D81FB02056DDB7FB66,42351,13,16,3,38,45,1945
52127,52127,A98EFFE1F83A80D81FB02056DDB7FB66,43731,19,21,2,34,47,1747
52128,52128,5D8FA5419FA0CA7A8C3CA55000085D74,11021,2,9,7,36,49,1849
52129,52129,5D8FA5419FA0CA7A8C3CA55000085D74,12571,12,14,2,48,39,2439
52130,52130,5D8FA5419FA0CA7A8C3CA55000085D74,11021,16,23,7,36,49,1849
52131,52131,5559FB469A4DC81853CEA806DAF57F7A,11031,0,12,12,42,49,2149
52132,52132,5559FB469A4DC81853CEA806DAF57F7A,11861,13,14,1,32,47,1647
52133,52133,5559FB469A4DC81853CEA806DAF57F7A,11031,15,23,8,42,49,2149
52134,52134,76221A532C247573D805D9122E04FE39,11801,0,8,8,42,48,2148
52135,52135,76221A532C247573D805D9122E04FE39,13271,9,11,2,41,47,2097
52136,52136,76221A532C247573D805D9122E04FE39,13101,12,13,1,40,47,2047
52137,52137,76221A532C247573D805D9122E04FE39,13271,14,16,2,41,47,2097
52138,52138,76221A532C247573D805D9122E04FE39,13101,17,21,4,40,47,2047
52139,52139,76221A532C247573D805D9122E04FE39,40361,22,23,1,42,48,2148
52140,52140,9646DACA260879D32095F9107B2CAA8C,11074,0,13,13,37,47,1897
52141,52141,9646DACA260879D32095F9107B2CAA8C,11061,14,19,5,29,48,1498
52142,52142,9646DACA260879D32095F9107B2CAA8C,11074,22,23,1,37,47,1897
52143,52143,8921D19B3E6D3ABF76D7D418BD57EBCC,11521,0,8,8,41,48,2098
52144,52144,8921D19B3E6D3ABF76D7D418BD57EBCC,41601,9,16,7,39,49,1999
52145,52145,8921D19B3E6D3ABF76D7D418BD57EBCC,12083,19,23,4,36,49,1849
52146,52146,BEE853049D28B67DAA1CF8A47B438594,12921,1,7,6,9,41,491
52147,52147,BEE853049D28B67DAA1CF8A47B438594,19261,10,12,2,6,37,337
52148,52148,BEE853049D28B67DAA1CF8A47B438594,43644,14,15,1,14,38,738
52149,52149,BEE853049D28B67DAA1CF8A47B438594,12921,16,23,7,9,41,491
52153,52153,ED54D9A6448FF51B585DC3225EB6058D,19181,2,17,15,8,40,440
52154,52154,ED54D9A6448FF51B585DC3225EB6058D,43644,17,18,1,14,38,738
52155,52155,ED54D9A6448FF51B585DC3225EB6058D,19181,20,21,1,8,40,440
52156,52156,ED54D9A6448FF51B585DC3225EB6058D,12921,22,23,1,9,41,491
52157,52157,D570B4D48387176D4477A1F66EC489C7,11351,0,5,5,36,48,1848
52158,52158,D570B4D48387176D4477A1F66EC489C7,42161,8,10,2,36,47,1847
52159,52159,D570B4D48387176D4477A1F66EC489C7,10971,15,16,1,35,47,1797
52160,52160,D570B4D48387176D4477A1F66EC489C7,12121,17,19,2,29,47,1497
52161,52161,D570B4D48387176D4477A1F66EC489C7,43731,20,22,2,34,47,1747
52162,52162,70001957DCF2B9125DCB996733DDF49B,11381,0,10,10,30,47,1547
52163,52163,70001957DCF2B9125DCB996733DDF49B,11061,12,13,1,29,48,1498
52164,52164,70001957DCF2B9125DCB996733DDF49B,11381,14,16,2,30,47,1547
52165,52165,70001957DCF2B9125DCB996733DDF49B,42291,16,17,1,29,48,1498
52166,52166,70001957DCF2B9125DCB996733DDF49B,11381,18,22,4,30,47,1547
52167,52167,D7349708A10855AEF98FEB8D22C33E59,40833,0,7,7,41,47,2097
52168,52168,D7349708A10855AEF98FEB8D22C33E59,11231,9,16,7,37,49,1899
52169,52169,D7349708A10855AEF98FEB8D22C33E59,13271,19,23,4,41,47,2097
52170,52170,372A21350F3884793152DCFF165CE566,13341,0,6,6,44,45,2245
52171,52171,372A21350F3884793152DCFF165CE566,12561,8,9,1,45,43,2293
52172,52172,372A21350F3884793152DCFF165CE566,13341,12,17,5,44,45,2245
52173,52173,372A21350F3884793152DCFF165CE566,12561,18,20,2,45,43,2293
52174,52174,372A21350F3884793152DCFF165CE566,13341,21,23,2,44,45,2245
52175,52175,5AF85D9ED958D0E5348613692DAC5B4D,43581,0,2,2,33,48,1698
52176,52176,5AF85D9ED958D0E5348613692DAC5B4D,10431,2,4,2,33,49,1699
52177,52177,5AF85D9ED958D0E5348613692DAC5B4D,11431,4,16,12,29,47,1497
52178,52178,5AF85D9ED958D0E5348613692DAC5B4D,42141,21,22,1,32,47,1647
52179,52179,525655B30753832E11A6455806FEB5D9,40094,0,7,7,29,48,1498
52180,52180,525655B30753832E11A6455806FEB5D9,13711,7,15,8,38,46,1946
52181,52181,525655B30753832E11A6455806FEB5D9,11941,16,17,1,37,46,1896
52182,52182,525655B30753832E11A6455806FEB5D9,40094,22,23,1,29,48,1498
52183,52183,6E393276634E5B0B2A68B7AC0F0F48CF,10491,0,6,6,33,48,1698
52184,52184,6E393276634E5B0B2A68B7AC0F0F48CF,11861,7,9,2,32,47,1647
52185,52185,6E393276634E5B0B2A68B7AC0F0F48CF,10491,12,13,1,33,48,1698
52186,52186,6E393276634E5B0B2A68B7AC0F0F48CF,43661,13,18,5,33,47,1697
52187,52187,6E393276634E5B0B2A68B7AC0F0F48CF,10491,20,23,3,33,48,1698
52191,52191,9D14274002F2A355CCDB0E87AFF875A7,15191,3,5,2,36,27,1827
52192,52192,9D14274002F2A355CCDB0E87AFF875A7,43081,5,9,4,27,28,1378
52193,52193,9D14274002F2A355CCDB0E87AFF875A7,15191,9,10,1,36,27,1827
52194,52194,9D14274002F2A355CCDB0E87AFF875A7,43081,11,12,1,27,28,1378
52195,52195,9D14274002F2A355CCDB0E87AFF875A7,15191,12,22,10,36,27,1827
52200,52200,D7B4DEFCB86C55D027A1210EEC02063B,11231,0,4,4,37,49,1899
52201,52201,D7B4DEFCB86C55D027A1210EEC02063B,11591,4,15,11,36,49,1849
52202,52202,D7B4DEFCB86C55D027A1210EEC02063B,42961,16,17,1,35,49,1799
52203,52203,D7B4DEFCB86C55D027A1210EEC02063B,11591,18,19,1,36,49,1849
52204,52204,D7B4DEFCB86C55D027A1210EEC02063B,11231,19,23,4,37,49,1899
52212,52212,9D25C8999E418D8C72AB77E479B8A009,10634,0,2,2,27,45,1395
52213,52213,9D25C8999E418D8C72AB77E479B8A009,11321,3,13,10,31,46,1596
52214,52214,9D25C8999E418D8C72AB77E479B8A009,12311,14,15,1,30,44,1544
52215,52215,9D25C8999E418D8C72AB77E479B8A009,11321,18,23,5,31,46,1596
52220,52220,FB55907415A7C0538398712A9BE0B78E,12311,5,7,2,30,44,1544
52221,52221,FB55907415A7C0538398712A9BE0B78E,42151,8,9,1,35,45,1795
52222,52222,FB55907415A7C0538398712A9BE0B78E,12661,12,13,1,32,45,1645
52223,52223,FB55907415A7C0538398712A9BE0B78E,42151,17,18,1,35,45,1795
52231,52231,8436FA510D59B3814E50B7F18BD1D92C,19571,0,5,5,1,36,86
52232,52232,8436FA510D59B3814E50B7F18BD1D92C,12641,6,17,11,10,43,543
52233,52233,8436FA510D59B3814E50B7F18BD1D92C,43644,20,22,2,14,38,738
52246,52246,830067E97972F27E1AE4923131398E88,42491,2,3,1,32,46,1646
52247,52247,830067E97972F27E1AE4923131398E88,10341,7,8,1,31,47,1597
52248,52248,830067E97972F27E1AE4923131398E88,42491,9,11,2,32,46,1646
52249,52249,830067E97972F27E1AE4923131398E88,42523,15,16,1,31,47,1597
52250,52250,830067E97972F27E1AE4923131398E88,42491,17,20,3,32,46,1646
52255,52255,9080DF503ACF0ABF3EAE58FF37C4563F,11061,3,8,5,29,48,1498
52256,52256,9080DF503ACF0ABF3EAE58FF37C4563F,10681,10,18,8,30,48,1548
52257,52257,9080DF503ACF0ABF3EAE58FF37C4563F,11061,21,22,1,29,48,1498
52258,52258,9080DF503ACF0ABF3EAE58FF37C4563F,11361,22,23,1,22,48,1148
52259,52259,30AB292EA71BCCA29EAC6C791311F4E2,43011,0,1,1,40,42,2042
52260,52260,30AB292EA71BCCA29EAC6C791311F4E2,12761,5,7,2,25,40,1290
52261,52261,30AB292EA71BCCA29EAC6C791311F4E2,13671,11,12,1,27,43,1393
52262,52262,30AB292EA71BCCA29EAC6C791311F4E2,11921,16,19,3,38,48,1948
52263,52263,30AB292EA71BCCA29EAC6C791311F4E2,11074,19,20,1,37,47,1897
52264,52264,30AB292EA71BCCA29EAC6C791311F4E2,11921,21,23,2,38,48,1948
52265,52265,6122DA1E164F2C003F86ED3AD26C044C,43951,0,1,1,49,41,2491
52266,52266,6122DA1E164F2C003F86ED3AD26C044C,12561,1,2,1,45,43,2293
52267,52267,6122DA1E164F2C003F86ED3AD26C044C,43951,2,23,21,49,41,2491
52268,52268,082B69FE27233ED93EF55B765B884E7B,10634,1,7,6,27,45,1395
52269,52269,082B69FE27233ED93EF55B765B884E7B,12521,8,9,1,35,41,1791
52270,52270,082B69FE27233ED93EF55B765B884E7B,11481,10,17,7,41,48,2098
52271,52271,082B69FE27233ED93EF55B765B884E7B,11875,20,21,1,30,46,1546
52272,52272,F49EE04071D0B4FCCD4263F4C2BBEA7A,11151,0,6,6,30,48,1548
52273,52273,F49EE04071D0B4FCCD4263F4C2BBEA7A,11061,7,8,1,29,48,1498
52274,52274,F49EE04071D0B4FCCD4263F4C2BBEA7A,43761,11,14,3,32,47,1647
52275,52275,F49EE04071D0B4FCCD4263F4C2BBEA7A,11061,15,16,1,29,48,1498
52276,52276,F49EE04071D0B4FCCD4263F4C2BBEA7A,42521,16,18,2,31,47,1597
52277,52277,F49EE04071D0B4FCCD4263F4C2BBEA7A,11061,19,23,4,29,48,1498
52278,52278,26B9AAC369331C3B7CCBFCA623526739,13341,3,4,1,44,45,2245
52279,52279,26B9AAC369331C3B7CCBFCA623526739,42201,5,6,1,43,46,2196
52280,52280,26B9AAC369331C3B7CCBFCA623526739,13461,8,13,5,39,44,1994
52281,52281,26B9AAC369331C3B7CCBFCA623526739,12521,19,21,2,35,41,1791
52282,52282,26B9AAC369331C3B7CCBFCA623526739,43341,21,22,1,41,46,2096
52283,52283,1C0548F40841AD0870DAD8EC7BECCBC6,13314,0,6,6,31,39,1589
52284,52284,1C0548F40841AD0870DAD8EC7BECCBC6,12521,7,9,2,35,41,1791
52285,52285,1C0548F40841AD0870DAD8EC7BECCBC6,13314,10,13,3,31,39,1589
52286,52286,1C0548F40841AD0870DAD8EC7BECCBC6,12521,13,19,6,35,41,1791
52287,52287,1C0548F40841AD0870DAD8EC7BECCBC6,13314,19,23,4,31,39,1589
52288,52288,2E529D3231B9931142907BBC57A6A51B,43451,0,2,2,37,40,1890
52289,52289,2E529D3231B9931142907BBC57A6A51B,13071,3,15,12,41,41,2091
52290,52290,2E529D3231B9931142907BBC57A6A51B,43451,18,19,1,37,40,1890
52291,52291,E648A6F090A3BE85617E0ED54A73B4F0,12601,0,4,4,25,47,1297
52292,52292,E648A6F090A3BE85617E0ED54A73B4F0,12671,4,6,2,21,43,1093
52293,52293,E648A6F090A3BE85617E0ED54A73B4F0,12601,8,23,15,25,47,1297
52294,52294,3C07D1557002BF4F1AA6A6D7A8949EF2,43761,0,4,4,32,47,1647
52295,52295,3C07D1557002BF4F1AA6A6D7A8949EF2,12601,8,16,8,25,47,1297
52296,52296,3C07D1557002BF4F1AA6A6D7A8949EF2,43761,17,23,6,32,47,1647
52303,52303,2F66AC01887397A198C9CCA6611EA97B,12521,0,7,7,35,41,1791
52304,52304,2F66AC01887397A198C9CCA6611EA97B,13314,7,10,3,31,39,1589
52305,52305,2F66AC01887397A198C9CCA6611EA97B,12521,11,23,12,35,41,1791
52306,52306,A534FD7E51A551BE3196665029DD0400,19931,0,5,5,7,43,393
52307,52307,A534FD7E51A551BE3196665029DD0400,19031,8,16,8,1,42,92
52308,52308,A534FD7E51A551BE3196665029DD0400,12641,20,21,1,10,43,543
52309,52309,290CF9B7E8E39B2A6D619522168B66C7,19621,0,7,7,5,46,296
52310,52310,290CF9B7E8E39B2A6D619522168B66C7,10221,8,14,6,34,49,1749
52311,52311,290CF9B7E8E39B2A6D619522168B66C7,40124,15,17,2,38,47,1947
52312,52312,290CF9B7E8E39B2A6D619522168B66C7,19441,18,23,5,8,46,446
52313,52313,3AB35E62E3464B5074E82DE69E9DD0D9,42501,0,7,7,28,47,1447
52314,52314,3AB35E62E3464B5074E82DE69E9DD0D9,19441,9,15,6,8,46,446
52315,52315,3AB35E62E3464B5074E82DE69E9DD0D9,42501,18,23,5,28,47,1447
52320,52320,9442AAEA05C831A2075E8352FC15EF6E,10191,0,7,7,40,48,2048
52321,52321,9442AAEA05C831A2075E8352FC15EF6E,10351,8,14,6,28,45,1445
52322,52322,9442AAEA05C831A2075E8352FC15EF6E,10921,18,20,2,43,48,2198
52323,52323,9442AAEA05C831A2075E8352FC15EF6E,10191,21,23,2,40,48,2048
52331,52331,9BBBC00C93BA6A3176E2B008E6F8A88E,13911,0,3,3,39,46,1996
52332,52332,9BBBC00C93BA6A3176E2B008E6F8A88E,11261,5,10,5,36,46,1846
52333,52333,9BBBC00C93BA6A3176E2B008E6F8A88E,42351,11,12,1,38,45,1945
52334,52334,9BBBC00C93BA6A3176E2B008E6F8A88E,13911,14,16,2,39,46,1996
52335,52335,9BBBC00C93BA6A3176E2B008E6F8A88E,11261,18,19,1,36,46,1846
52336,52336,9BBBC00C93BA6A3176E2B008E6F8A88E,13911,19,22,3,39,46,1996
52337,52337,698D330828DDD2FCACF2F1C2224B1477,10811,0,7,7,38,46,1946
52338,52338,698D330828DDD2FCACF2F1C2224B1477,12601,8,12,4,25,47,1297
52339,52339,698D330828DDD2FCACF2F1C2224B1477,10811,13,16,3,38,46,1946
52340,52340,698D330828DDD2FCACF2F1C2224B1477,12601,17,19,2,25,47,1297
52341,52341,698D330828DDD2FCACF2F1C2224B1477,10811,20,23,3,38,46,1946
52342,52342,7AFA6B5935635DA314D6F6C88A3C68D4,10731,0,8,8,33,47,1697
52343,52343,7AFA6B5935635DA314D6F6C88A3C68D4,41621,8,11,3,38,49,1949
52344,52344,7AFA6B5935635DA314D6F6C88A3C68D4,10731,12,14,2,33,47,1697
52345,52345,7AFA6B5935635DA314D6F6C88A3C68D4,11531,18,20,2,34,49,1749
52346,52346,7AFA6B5935635DA314D6F6C88A3C68D4,10731,21,23,2,33,47,1697
52347,52347,4AE93F20F703B65B87F8746D93A2B5AE,11701,10,15,5,43,48,2198
52348,52348,4AE93F20F703B65B87F8746D93A2B5AE,42961,18,19,1,35,49,1799
52349,52349,4AE93F20F703B65B87F8746D93A2B5AE,11531,20,21,1,34,49,1749
52350,52350,5DC656AE1F755A21D4CE0049D29039D4,12491,0,7,7,36,43,1843
52351,52351,5DC656AE1F755A21D4CE0049D29039D4,11261,9,10,1,36,46,1846
52352,52352,5DC656AE1F755A21D4CE0049D29039D4,12491,12,17,5,36,43,1843
52353,52353,5DC656AE1F755A21D4CE0049D29039D4,11261,19,20,1,36,46,1846
52354,52354,5DC656AE1F755A21D4CE0049D29039D4,12491,22,23,1,36,43,1843
52358,52358,0AC9ACC82EDADEC2B3583D25F9FB3BD5,42041,3,5,2,10,47,547
52359,52359,0AC9ACC82EDADEC2B3583D25F9FB3BD5,19441,6,7,1,8,46,446
52360,52360,0AC9ACC82EDADEC2B3583D25F9FB3BD5,42041,8,13,5,10,47,547
52361,52361,0AC9ACC82EDADEC2B3583D25F9FB3BD5,19441,13,15,2,8,46,446
52362,52362,0AC9ACC82EDADEC2B3583D25F9FB3BD5,42041,17,19,2,10,47,547
52363,52363,3F0EDFFC6E18B4A03094543F5DAD11AE,42521,1,8,7,31,47,1597
52364,52364,3F0EDFFC6E18B4A03094543F5DAD11AE,43761,10,13,3,32,47,1647
52365,52365,3F0EDFFC6E18B4A03094543F5DAD11AE,42521,14,15,1,31,47,1597
52366,52366,3F0EDFFC6E18B4A03094543F5DAD11AE,42141,19,20,1,32,47,1647
52367,52367,3F0EDFFC6E18B4A03094543F5DAD11AE,42521,21,22,1,31,47,1597
52372,52372,59269BD1EB55D92351CAC27C11455378,10331,0,6,6,39,46,1996
52373,52373,59269BD1EB55D92351CAC27C11455378,12601,11,16,5,25,47,1297
52374,52374,59269BD1EB55D92351CAC27C11455378,10901,19,21,2,35,48,1798
52375,52375,76DA946F4DC1318DD46A32E1D303D6B7,12521,0,7,7,35,41,1791
52376,52376,76DA946F4DC1318DD46A32E1D303D6B7,13314,8,10,2,31,39,1589
52377,52377,76DA946F4DC1318DD46A32E1D303D6B7,12521,11,13,2,35,41,1791
52378,52378,76DA946F4DC1318DD46A32E1D303D6B7,13314,14,21,7,31,39,1589
52379,52379,76DA946F4DC1318DD46A32E1D303D6B7,12521,21,23,2,35,41,1791
52380,52380,9508FAE0B774FCD97D7CFB3C4BD72215,42401,0,1,1,36,47,1847
52381,52381,9508FAE0B774FCD97D7CFB3C4BD72215,10251,3,4,1,35,47,1797
52382,52382,9508FAE0B774FCD97D7CFB3C4BD72215,42401,6,8,2,36,47,1847
52383,52383,9508FAE0B774FCD97D7CFB3C4BD72215,13911,9,10,1,39,46,1996
52384,52384,9508FAE0B774FCD97D7CFB3C4BD72215,10111,11,17,6,37,47,1897
52385,52385,9508FAE0B774FCD97D7CFB3C4BD72215,12121,19,21,2,29,47,1497
52386,52386,58F6E25953C69E323B3541601DBC4000,12601,0,9,9,25,47,1297
52387,52387,58F6E25953C69E323B3541601DBC4000,11861,12,13,1,32,47,1647
52388,52388,58F6E25953C69E323B3541601DBC4000,10431,14,16,2,33,49,1699
52389,52389,58F6E25953C69E323B3541601DBC4000,12601,17,23,6,25,47,1297
52393,52393,458EBC255B183BF22B23CE89879E2CC9,13471,1,11,10,47,49,2399
52394,52394,458EBC255B183BF22B23CE89879E2CC9,40691,12,18,6,42,48,2148
52395,52395,458EBC255B183BF22B23CE89879E2CC9,13471,18,21,3,47,49,2399
52396,52396,E08A998E96875BC2FB605F71696F898C,11151,0,10,10,30,48,1548
52397,52397,E08A998E96875BC2FB605F71696F898C,11381,10,11,1,30,47,1547
52398,52398,E08A998E96875BC2FB605F71696F898C,11061,12,13,1,29,48,1498
52399,52399,E08A998E96875BC2FB605F71696F898C,11381,16,18,2,30,47,1547
52400,52400,E08A998E96875BC2FB605F71696F898C,11061,19,22,3,29,48,1498
52405,52405,DE2CF7635A4FCEF13695C4816E23FB11,10491,0,7,7,33,48,1698
52406,52406,DE2CF7635A4FCEF13695C4816E23FB11,10951,10,11,1,29,48,1498
52407,52407,DE2CF7635A4FCEF13695C4816E23FB11,11811,12,13,1,38,49,1949
52408,52408,DE2CF7635A4FCEF13695C4816E23FB11,10491,14,19,5,33,48,1698
52409,52409,DE2CF7635A4FCEF13695C4816E23FB11,40951,21,22,1,36,49,1849
52410,52410,F5BC1F3CE8793A57EF8A6B392B091737,43021,5,13,8,16,43,843
52411,52411,F5BC1F3CE8793A57EF8A6B392B091737,19111,17,18,1,9,45,495
52412,52412,F5BC1F3CE8793A57EF8A6B392B091737,43021,20,21,1,16,43,843
52413,52413,F5BC1F3CE8793A57EF8A6B392B091737,12921,22,23,1,9,41,491
52414,52414,0DD51EE42A065AE9C7264B2B66A89D4A,12921,0,6,6,9,41,491
52415,52415,0DD51EE42A065AE9C7264B2B66A89D4A,12641,6,14,8,10,43,543
52416,52416,0DD51EE42A065AE9C7264B2B66A89D4A,19021,18,23,5,10,45,545
52421,52421,04D73C3CD00D40CB611F6BA5801F802C,13314,0,13,13,31,39,1589
52422,52422,04D73C3CD00D40CB611F6BA5801F802C,12521,15,17,2,35,41,1791
52423,52423,04D73C3CD00D40CB611F6BA5801F802C,13314,20,23,3,31,39,1589
52424,52424,A2322C7E82C506086C86C7A37D702773,12381,0,14,14,32,48,1648
52425,52425,A2322C7E82C506086C86C7A37D702773,11291,14,16,2,40,49,2049
52426,52426,A2322C7E82C506086C86C7A37D702773,12381,19,23,4,32,48,1648
52441,52441,331C93B6083F5634586EEDFC958D0A76,42351,0,7,7,38,45,1945
52442,52442,331C93B6083F5634586EEDFC958D0A76,42961,10,11,1,35,49,1799
52443,52443,331C93B6083F5634586EEDFC958D0A76,42351,13,15,2,38,45,1945
52444,52444,331C93B6083F5634586EEDFC958D0A76,42161,16,17,1,36,47,1847
52445,52445,331C93B6083F5634586EEDFC958D0A76,42231,19,23,4,37,46,1896
52446,52446,11C1E1E71B6DE725F234833E4DE3B8BD,13271,0,7,7,41,47,2097
52447,52447,11C1E1E71B6DE725F234833E4DE3B8BD,11914,8,10,2,37,48,1898
52448,52448,11C1E1E71B6DE725F234833E4DE3B8BD,13271,12,23,11,41,47,2097
52449,52449,8D86E284D185DE22084CD86C6BFE1A08,11875,0,6,6,30,46,1546
52450,52450,8D86E284D185DE22084CD86C6BFE1A08,12311,7,8,1,30,44,1544
52451,52451,8D86E284D185DE22084CD86C6BFE1A08,11875,12,13,1,30,46,1546
52452,52452,8D86E284D185DE22084CD86C6BFE1A08,12311,14,16,2,30,44,1544
52453,52453,8D86E284D185DE22084CD86C6BFE1A08,11875,19,23,4,30,46,1546
52454,52454,B65986D45181EA9BD7712A84F575953B,15121,7,10,3,27,19,1369
52455,52455,B65986D45181EA9BD7712A84F575953B,19051,11,12,1,16,23,823
52456,52456,B65986D45181EA9BD7712A84F575953B,15121,15,17,2,27,19,1369
52457,52457,B65986D45181EA9BD7712A84F575953B,19801,22,23,1,19,26,976
52462,52462,D6B662C0D72BBB94314A69A6BE13D66E,43761,0,3,3,32,47,1647
52463,52463,D6B662C0D72BBB94314A69A6BE13D66E,42523,4,7,3,31,47,1597
52464,52464,D6B662C0D72BBB94314A69A6BE13D66E,11431,9,10,1,29,47,1497
52465,52465,D6B662C0D72BBB94314A69A6BE13D66E,42941,18,20,2,37,47,1897
52466,52466,EDE883FB8F7143F6A524E702EC8BEA86,40833,0,5,5,41,47,2097
52467,52467,EDE883FB8F7143F6A524E702EC8BEA86,10351,6,11,5,28,45,1445
52468,52468,EDE883FB8F7143F6A524E702EC8BEA86,10634,11,12,1,27,45,1395
52469,52469,EDE883FB8F7143F6A524E702EC8BEA86,10351,13,16,3,28,45,1445
52470,52470,EDE883FB8F7143F6A524E702EC8BEA86,10634,16,17,1,27,45,1395
52471,52471,EDE883FB8F7143F6A524E702EC8BEA86,10351,19,20,1,28,45,1445
52472,52472,EDE883FB8F7143F6A524E702EC8BEA86,13271,21,22,1,41,47,2097
52473,52473,DE315A9B98B8B286B43F502CB8D73C57,43191,0,6,6,40,49,2049
52474,52474,DE315A9B98B8B286B43F502CB8D73C57,11731,19,20,1,36,48,1848
52475,52475,DE315A9B98B8B286B43F502CB8D73C57,12971,21,22,1,32,48,1648
52479,52479,39E9477CFB7A739ED25E5621F7D2A965,10821,0,11,11,40,47,2047
52480,52480,39E9477CFB7A739ED25E5621F7D2A965,12571,14,19,5,48,39,2439
52481,52481,39E9477CFB7A739ED25E5621F7D2A965,42301,21,23,2,36,47,1847
52482,52482,2D9F8EEE0946858BEC66856CB73B8335,43021,0,5,5,16,43,843
52483,52483,2D9F8EEE0946858BEC66856CB73B8335,12921,6,9,3,9,41,491
52484,52484,2D9F8EEE0946858BEC66856CB73B8335,43021,11,22,11,16,43,843
52485,52485,C51E252CF4E3CCE91DAD548C30F00035,42021,0,7,7,33,47,1697
52486,52486,C51E252CF4E3CCE91DAD548C30F00035,43451,10,11,1,37,40,1890
52487,52487,C51E252CF4E3CCE91DAD548C30F00035,10281,12,14,2,33,48,1698
52488,52488,C51E252CF4E3CCE91DAD548C30F00035,42021,17,23,6,33,47,1697
52489,52489,90AEBDFF2A6C58E27BB377D4DD4D3E61,12311,7,10,3,30,44,1544
52490,52490,90AEBDFF2A6C58E27BB377D4DD4D3E61,10634,12,13,1,27,45,1395
52491,52491,90AEBDFF2A6C58E27BB377D4DD4D3E61,12311,13,15,2,30,44,1544
52492,52492,90AEBDFF2A6C58E27BB377D4DD4D3E61,10711,15,16,1,29,46,1496
52493,52493,90AEBDFF2A6C58E27BB377D4DD4D3E61,10634,20,22,2,27,45,1395
52494,52494,170A0AC014DC9BA930EAA0E56A2C9D03,42321,0,6,6,43,47,2197
52495,52495,170A0AC014DC9BA930EAA0E56A2C9D03,11701,9,12,3,43,48,2198
52496,52496,170A0AC014DC9BA930EAA0E56A2C9D03,42601,12,13,1,44,48,2248
52497,52497,170A0AC014DC9BA930EAA0E56A2C9D03,11701,15,20,5,43,48,2198
52498,52498,170A0AC014DC9BA930EAA0E56A2C9D03,11001,22,23,1,42,47,2147
52506,52506,0F46DC97ADBFE439A39C7E4B11BD9162,42201,0,3,3,43,46,2196
52507,52507,0F46DC97ADBFE439A39C7E4B11BD9162,13341,3,10,7,44,45,2245
52508,52508,0F46DC97ADBFE439A39C7E4B11BD9162,42201,11,12,1,43,46,2196
52509,52509,0F46DC97ADBFE439A39C7E4B11BD9162,13341,13,15,2,44,45,2245
52510,52510,0F46DC97ADBFE439A39C7E4B11BD9162,42201,20,21,1,43,46,2196
52511,52511,394FCA5F3AB676CBAB996A49070239BB,10721,0,7,7,31,48,1598
52512,52512,394FCA5F3AB676CBAB996A49070239BB,11231,11,14,3,37,49,1899
52513,52513,394FCA5F3AB676CBAB996A49070239BB,11074,18,20,2,37,47,1897
52514,52514,394FCA5F3AB676CBAB996A49070239BB,10721,22,23,1,31,48,1598
52518,52518,08B22EEE6E957330DAD27E7217103ACF,43011,0,6,6,40,42,2042
52519,52519,08B22EEE6E957330DAD27E7217103ACF,42381,7,9,2,39,41,1991
52520,52520,08B22EEE6E957330DAD27E7217103ACF,10107,11,12,1,38,49,1949
52521,52521,08B22EEE6E957330DAD27E7217103ACF,42581,13,18,5,38,48,1948
52539,52539,2770DAF26F856B8C604C0FF1601A7902,43644,0,3,3,14,38,738
52540,52540,2770DAF26F856B8C604C0FF1601A7902,19031,4,6,2,1,42,92
52541,52541,2770DAF26F856B8C604C0FF1601A7902,12921,7,14,7,9,41,491
52542,52542,2770DAF26F856B8C604C0FF1601A7902,19181,15,20,5,8,40,440
52543,52543,51ED40A82E9C1A94F7286865C3CA897F,11021,0,1,1,36,49,1849
52544,52544,51ED40A82E9C1A94F7286865C3CA897F,13941,3,14,11,41,47,2097
52545,52545,51ED40A82E9C1A94F7286865C3CA897F,11591,14,23,9,36,49,1849
52546,52546,B6B0375BFA2C1ACA985FC18F0886DD84,10491,2,9,7,33,48,1698
52547,52547,B6B0375BFA2C1ACA985FC18F0886DD84,13741,11,17,6,37,49,1899
52548,52548,B6B0375BFA2C1ACA985FC18F0886DD84,43061,19,20,1,43,46,2196
52562,52562,DA8EF7789DD15D64E4CB91A60A838933,43731,0,8,8,34,47,1747
52563,52563,DA8EF7789DD15D64E4CB91A60A838933,42921,10,11,1,33,47,1697
52564,52564,DA8EF7789DD15D64E4CB91A60A838933,43731,11,12,1,34,47,1747
52565,52565,DA8EF7789DD15D64E4CB91A60A838933,42921,16,17,1,33,47,1697
52566,52566,DA8EF7789DD15D64E4CB91A60A838933,43731,19,20,1,34,47,1747
52567,52567,FE4547C9BDE2F0CE3554897F6352AE34,10811,0,7,7,38,46,1946
52568,52568,FE4547C9BDE2F0CE3554897F6352AE34,43451,9,15,6,37,40,1890
52569,52569,FE4547C9BDE2F0CE3554897F6352AE34,43011,19,22,3,40,42,2042
52570,52570,21CAF4F5B17C418623F51F25C8C984C0,13651,0,6,6,30,47,1547
52571,52571,21CAF4F5B17C418623F51F25C8C984C0,11271,9,15,6,37,48,1898
52572,52572,21CAF4F5B17C418623F51F25C8C984C0,40951,19,20,1,36,49,1849
52573,52573,21CAF4F5B17C418623F51F25C8C984C0,11271,22,23,1,37,48,1898
52580,52580,9C2C2A9A5923C3E8476FE17BB2B155DD,19114,0,2,2,7,43,393
52581,52581,9C2C2A9A5923C3E8476FE17BB2B155DD,43021,3,4,1,16,43,843
52582,52582,9C2C2A9A5923C3E8476FE17BB2B155DD,12641,5,8,3,10,43,543
52583,52583,9C2C2A9A5923C3E8476FE17BB2B155DD,19114,8,13,5,7,43,393
52584,52584,9C2C2A9A5923C3E8476FE17BB2B155DD,12641,14,16,2,10,43,543
52585,52585,9C2C2A9A5923C3E8476FE17BB2B155DD,11381,19,21,2,30,47,1547
52589,52589,5820CC6FC4348E018115CFA2871713F1,13271,1,7,6,41,47,2097
52590,52590,5820CC6FC4348E018115CFA2871713F1,11381,9,11,2,30,47,1547
52591,52591,5820CC6FC4348E018115CFA2871713F1,11481,13,21,8,41,48,2098
52592,52592,5820CC6FC4348E018115CFA2871713F1,13271,21,23,2,41,47,2097
52597,52597,2F1F755AD0C3D64033AC7CD812D0FE51,42931,0,1,1,41,49,2099
52598,52598,2F1F755AD0C3D64033AC7CD812D0FE51,10421,1,9,8,41,48,2098
52599,52599,2F1F755AD0C3D64033AC7CD812D0FE51,42051,13,15,2,42,48,2148
52600,52600,2F1F755AD0C3D64033AC7CD812D0FE51,10251,16,17,1,35,47,1797
52601,52601,2F1F755AD0C3D64033AC7CD812D0FE51,40691,19,22,3,42,48,2148
52611,52611,C1CF59B64EE7642E956AF0C2EBE03CC9,42921,0,7,7,33,47,1697
52612,52612,C1CF59B64EE7642E956AF0C2EBE03CC9,11291,9,11,2,40,49,2049
52613,52613,C1CF59B64EE7642E956AF0C2EBE03CC9,42931,13,18,5,41,49,2099
52617,52617,583602182C31C8E2D985404EA5592339,12921,6,7,1,9,41,491
52618,52618,583602182C31C8E2D985404EA5592339,19181,7,9,2,8,40,440
52619,52619,583602182C31C8E2D985404EA5592339,12641,11,17,6,10,43,543
52620,52620,583602182C31C8E2D985404EA5592339,12921,17,19,2,9,41,491
52621,52621,583602182C31C8E2D985404EA5592339,12641,21,23,2,10,43,543
52630,52630,A9C7C982C0FE909A6964C3A66CB3BD62,13671,1,6,5,27,43,1393
52631,52631,A9C7C982C0FE909A6964C3A66CB3BD62,10151,11,12,1,34,47,1747
52632,52632,A9C7C982C0FE909A6964C3A66CB3BD62,13671,13,20,7,27,43,1393
52636,52636,1F899C425E1D44BC86781F60DDEF728E,43021,0,7,7,16,43,843
52637,52637,1F899C425E1D44BC86781F60DDEF728E,12921,8,10,2,9,41,491
52638,52638,1F899C425E1D44BC86781F60DDEF728E,43021,11,14,3,16,43,843
52639,52639,1F899C425E1D44BC86781F60DDEF728E,12921,15,20,5,9,41,491
52643,52643,C0D3D746EE362DF9092390E1B22CCC4A,11061,6,7,1,29,48,1498
52644,52644,C0D3D746EE362DF9092390E1B22CCC4A,12311,8,19,11,30,44,1544
52645,52645,C0D3D746EE362DF9092390E1B22CCC4A,40445,21,23,2,30,48,1548
52657,52657,9B3D4DB494E6B8E7329532A1BECC6FF1,43021,0,5,5,16,43,843
52658,52658,9B3D4DB494E6B8E7329532A1BECC6FF1,12921,10,11,1,9,41,491
52659,52659,9B3D4DB494E6B8E7329532A1BECC6FF1,43021,11,23,12,16,43,843
52668,52668,14D6FFB5534DE2FFA4F5AA3ABCE4AA3E,42581,4,6,2,38,48,1948
52669,52669,14D6FFB5534DE2FFA4F5AA3ABCE4AA3E,11914,8,10,2,37,48,1898
52670,52670,14D6FFB5534DE2FFA4F5AA3ABCE4AA3E,42581,12,13,1,38,48,1948
52671,52671,14D6FFB5534DE2FFA4F5AA3ABCE4AA3E,11914,15,17,2,37,48,1898
52672,52672,14D6FFB5534DE2FFA4F5AA3ABCE4AA3E,42581,17,20,3,38,48,1948
52673,52673,14D6FFB5534DE2FFA4F5AA3ABCE4AA3E,11914,20,21,1,37,48,1898
52674,52674,14D6FFB5534DE2FFA4F5AA3ABCE4AA3E,42581,21,22,1,38,48,1948
52695,52695,7F82F3275A2E6482306D0350FA3CE8F1,10151,0,13,13,34,47,1747
52696,52696,7F82F3275A2E6482306D0350FA3CE8F1,11801,15,16,1,42,48,2148
52697,52697,7F82F3275A2E6482306D0350FA3CE8F1,40623,20,23,3,34,46,1746
52698,52698,FF3E223EC645685F23BE28ABAEB636E3,12391,0,9,9,36,49,1849
52699,52699,FF3E223EC645685F23BE28ABAEB636E3,11061,13,16,3,29,48,1498
52700,52700,FF3E223EC645685F23BE28ABAEB636E3,12391,18,20,2,36,49,1849
52704,52704,35FE39B951D37418385844C98A76F454,15401,0,6,6,39,25,1975
52705,52705,35FE39B951D37418385844C98A76F454,13251,7,13,6,48,28,2428
52706,52706,35FE39B951D37418385844C98A76F454,15411,15,16,1,44,27,2227
52707,52707,35FE39B951D37418385844C98A76F454,15401,19,23,4,39,25,1975
52714,52714,4C8E92DBB85921608C1C92929A7A8C92,42521,0,6,6,31,47,1597
52715,52715,4C8E92DBB85921608C1C92929A7A8C92,11381,8,10,2,30,47,1547
52716,52716,4C8E92DBB85921608C1C92929A7A8C92,42521,12,13,1,31,47,1597
52717,52717,4C8E92DBB85921608C1C92929A7A8C92,13651,16,17,1,30,47,1547
52718,52718,4C8E92DBB85921608C1C92929A7A8C92,42521,18,23,5,31,47,1597
52719,52719,79B5036BB9CF220CB8BEA84901C93E8A,42541,0,6,6,25,47,1297
52720,52720,79B5036BB9CF220CB8BEA84901C93E8A,42523,8,12,4,31,47,1597
52721,52721,79B5036BB9CF220CB8BEA84901C93E8A,41392,15,17,2,43,48,2198
52722,52722,79B5036BB9CF220CB8BEA84901C93E8A,10171,21,23,2,26,47,1347
52723,52723,6A0394A16431C3763362EDB77E0D6861,10544,0,6,6,28,48,1448
52724,52724,6A0394A16431C3763362EDB77E0D6861,42071,7,8,1,31,49,1599
52725,52725,6A0394A16431C3763362EDB77E0D6861,10544,10,11,1,28,48,1448
52726,52726,6A0394A16431C3763362EDB77E0D6861,42071,12,18,6,31,49,1599
52727,52727,6A0394A16431C3763362EDB77E0D6861,10544,18,20,2,28,48,1448
52728,52728,6A0394A16431C3763362EDB77E0D6861,42071,20,21,1,31,49,1599
52729,52729,6A0394A16431C3763362EDB77E0D6861,10544,22,23,1,28,48,1448
52733,52733,7B34C273E34CE1CA5EC462EE747405EC,42031,0,7,7,40,46,2046
52734,52734,7B34C273E34CE1CA5EC462EE747405EC,12921,12,13,1,9,41,491
52735,52735,7B34C273E34CE1CA5EC462EE747405EC,49201,13,14,1,7,41,391
52736,52736,7B34C273E34CE1CA5EC462EE747405EC,42031,17,21,4,40,46,2046
52737,52737,D8F61CF3289E3928FCE68B7F3A3EF9A7,12141,1,5,4,42,45,2145
52738,52738,D8F61CF3289E3928FCE68B7F3A3EF9A7,43041,6,7,1,41,46,2096
52739,52739,D8F61CF3289E3928FCE68B7F3A3EF9A7,11074,9,15,6,37,47,1897
52740,52740,D8F61CF3289E3928FCE68B7F3A3EF9A7,43041,18,20,2,41,46,2096
52741,52741,2BCAA9FC5A08C7161A5671AB8925F53A,11061,7,8,1,29,48,1498
52742,52742,2BCAA9FC5A08C7161A5671AB8925F53A,11151,9,10,1,30,48,1548
52743,52743,2BCAA9FC5A08C7161A5671AB8925F53A,13651,11,13,2,30,47,1547
52744,52744,2BCAA9FC5A08C7161A5671AB8925F53A,11151,15,18,3,30,48,1548
52745,52745,2BCAA9FC5A08C7161A5671AB8925F53A,11061,18,19,1,29,48,1498
52746,52746,2BCAA9FC5A08C7161A5671AB8925F53A,10381,22,23,1,31,49,1599
52759,52759,AB6EA8E0EB921375D4ACF50883707DA2,43061,2,3,1,43,46,2196
52760,52760,AB6EA8E0EB921375D4ACF50883707DA2,10681,3,15,12,30,48,1548
52761,52761,AB6EA8E0EB921375D4ACF50883707DA2,10401,18,23,5,33,49,1699
52762,52762,E83EEC0EDEADBA548B114EA601516E47,10341,0,2,2,31,47,1597
52763,52763,E83EEC0EDEADBA548B114EA601516E47,42471,2,8,6,35,49,1799
52764,52764,E83EEC0EDEADBA548B114EA601516E47,10221,9,22,13,34,49,1749
52765,52765,CC04DF57CD476D56A9C2711AACC54374,11261,0,1,1,36,46,1846
52766,52766,CC04DF57CD476D56A9C2711AACC54374,42861,3,10,7,37,44,1894
52767,52767,CC04DF57CD476D56A9C2711AACC54374,11261,12,16,4,36,46,1846
52768,52768,CC04DF57CD476D56A9C2711AACC54374,42861,16,18,2,37,44,1894
52769,52769,CC04DF57CD476D56A9C2711AACC54374,11261,20,21,1,36,46,1846
52770,52770,CC04DF57CD476D56A9C2711AACC54374,42861,22,23,1,37,44,1894
52771,52771,B70267EAE88B62F9B87C2FB6E0BEE8BF,43621,0,1,1,46,48,2348
52772,52772,B70267EAE88B62F9B87C2FB6E0BEE8BF,11701,1,7,6,43,48,2198
52773,52773,B70267EAE88B62F9B87C2FB6E0BEE8BF,43621,9,13,4,46,48,2348
52774,52774,B70267EAE88B62F9B87C2FB6E0BEE8BF,42321,17,19,2,43,47,2197
52775,52775,B70267EAE88B62F9B87C2FB6E0BEE8BF,43621,21,23,2,46,48,2348
52788,52788,1DD07CF7FD5B3CCCB4E85025836774E4,11074,0,7,7,37,47,1897
52789,52789,1DD07CF7FD5B3CCCB4E85025836774E4,11231,7,11,4,37,49,1899
52790,52790,1DD07CF7FD5B3CCCB4E85025836774E4,13601,11,13,2,34,47,1747
52791,52791,1DD07CF7FD5B3CCCB4E85025836774E4,10371,14,18,4,37,49,1899
52792,52792,1DD07CF7FD5B3CCCB4E85025836774E4,12841,21,22,1,37,47,1897
52793,52793,05286C4B5017A260B39768783F7D4555,42581,0,6,6,38,48,1948
52794,52794,05286C4B5017A260B39768783F7D4555,11914,6,7,1,37,48,1898
52795,52795,05286C4B5017A260B39768783F7D4555,40171,7,9,2,38,48,1948
52796,52796,05286C4B5017A260B39768783F7D4555,10471,13,16,3,37,48,1898
52797,52797,05286C4B5017A260B39768783F7D4555,42581,20,23,3,38,48,1948
52798,52798,019D93C0A7ED6989263F01FBD77C6C01,11324,0,6,6,31,46,1596
52799,52799,019D93C0A7ED6989263F01FBD77C6C01,10292,6,9,3,30,47,1547
52800,52800,019D93C0A7ED6989263F01FBD77C6C01,42511,11,13,2,37,47,1897
52801,52801,019D93C0A7ED6989263F01FBD77C6C01,10292,13,15,2,30,47,1547
52802,52802,019D93C0A7ED6989263F01FBD77C6C01,11061,18,19,1,29,48,1498
52806,52806,30592914C185E63F68BFD67F61AF39C2,43971,0,7,7,30,48,1548
52807,52807,30592914C185E63F68BFD67F61AF39C2,19021,11,12,1,10,45,545
52808,52808,30592914C185E63F68BFD67F61AF39C2,43501,14,17,3,27,48,1398
52809,52809,30592914C185E63F68BFD67F61AF39C2,10107,19,21,2,38,49,1949
52810,52810,30592914C185E63F68BFD67F61AF39C2,43971,22,23,1,30,48,1548
52811,52811,40384EEDFB9B633788A349C42AF5750D,10281,0,7,7,33,48,1698
52812,52812,40384EEDFB9B633788A349C42AF5750D,43731,9,10,1,34,47,1747
52813,52813,40384EEDFB9B633788A349C42AF5750D,10491,12,14,2,33,48,1698
52814,52814,40384EEDFB9B633788A349C42AF5750D,43731,15,17,2,34,47,1747
52815,52815,40384EEDFB9B633788A349C42AF5750D,42141,18,20,2,32,47,1647
52816,52816,40384EEDFB9B633788A349C42AF5750D,10281,21,22,1,33,48,1698
52830,52830,34A2ED3F6CE4956A8316F02589C4654D,13681,2,4,2,38,47,1947
52831,52831,34A2ED3F6CE4956A8316F02589C4654D,13371,4,8,4,41,47,2097
52832,52832,34A2ED3F6CE4956A8316F02589C4654D,12561,9,10,1,45,43,2293
52833,52833,34A2ED3F6CE4956A8316F02589C4654D,13371,11,23,12,41,47,2097
52834,52834,D3F6CC79419CB8E677F2F17C3DF072CD,13121,0,6,6,38,46,1946
52835,52835,D3F6CC79419CB8E677F2F17C3DF072CD,10911,7,8,1,39,46,1996
52836,52836,D3F6CC79419CB8E677F2F17C3DF072CD,11941,10,11,1,37,46,1896
52837,52837,D3F6CC79419CB8E677F2F17C3DF072CD,42331,13,15,2,39,46,1996
52838,52838,D3F6CC79419CB8E677F2F17C3DF072CD,13121,19,23,4,38,46,1946
52839,52839,287727E498B23742BB1DDAEB97CEA9E0,13371,0,3,3,41,47,2097
52840,52840,287727E498B23742BB1DDAEB97CEA9E0,13111,3,6,3,42,46,2146
52841,52841,287727E498B23742BB1DDAEB97CEA9E0,13341,7,8,1,44,45,2245
52842,52842,287727E498B23742BB1DDAEB97CEA9E0,13111,12,13,1,42,46,2146
52843,52843,287727E498B23742BB1DDAEB97CEA9E0,11481,14,15,1,41,48,2098
52844,52844,287727E498B23742BB1DDAEB97CEA9E0,13111,15,23,8,42,46,2146
52845,52845,58FF60972C1637520443DC5766A2AB67,13411,0,4,4,49,42,2492
52846,52846,58FF60972C1637520443DC5766A2AB67,43951,7,9,2,49,41,2491
52847,52847,58FF60972C1637520443DC5766A2AB67,13411,10,13,3,49,42,2492
52848,52848,58FF60972C1637520443DC5766A2AB67,43951,15,16,1,49,41,2491
52849,52849,58FF60972C1637520443DC5766A2AB67,13411,18,22,4,49,42,2492
52862,52862,914FCCE81925BD3B7C09A01C1E108BA6,11001,0,8,8,42,47,2147
52863,52863,914FCCE81925BD3B7C09A01C1E108BA6,42091,8,11,3,43,46,2196
52864,52864,914FCCE81925BD3B7C09A01C1E108BA6,43621,14,16,2,46,48,2348
52865,52865,914FCCE81925BD3B7C09A01C1E108BA6,42461,17,18,1,45,47,2297
52866,52866,914FCCE81925BD3B7C09A01C1E108BA6,11001,19,21,2,42,47,2147
52874,52874,FA6CCE3A730CC8E18E9737EFB112C34F,11921,9,10,1,38,48,1948
52875,52875,FA6CCE3A730CC8E18E9737EFB112C34F,13121,14,16,2,38,46,1946
52876,52876,FA6CCE3A730CC8E18E9737EFB112C34F,10531,18,20,2,34,46,1746
52877,52877,2506E93F1473AB5227728C7B0A12E7AF,11861,0,7,7,32,47,1647
52878,52878,2506E93F1473AB5227728C7B0A12E7AF,11261,10,11,1,36,46,1846
52879,52879,2506E93F1473AB5227728C7B0A12E7AF,42861,12,14,2,37,44,1894
52880,52880,2506E93F1473AB5227728C7B0A12E7AF,42864,14,18,4,38,44,1944
52881,52881,2506E93F1473AB5227728C7B0A12E7AF,10281,21,23,2,33,48,1698
52892,52892,8EB0EA8A0FB0C9F044024C5DB3D8B52C,19021,1,4,3,10,45,545
52893,52893,8EB0EA8A0FB0C9F044024C5DB3D8B52C,19024,7,9,2,9,45,495
52894,52894,8EB0EA8A0FB0C9F044024C5DB3D8B52C,19021,11,15,4,10,45,545
52895,52895,8EB0EA8A0FB0C9F044024C5DB3D8B52C,19024,17,18,1,9,45,495
52896,52896,8EB0EA8A0FB0C9F044024C5DB3D8B52C,19021,22,23,1,10,45,545
52897,52897,CF045BB51AB834592F0FA9268C200D5E,11491,0,8,8,36,47,1847
52898,52898,CF045BB51AB834592F0FA9268C200D5E,40673,11,12,1,36,48,1848
52899,52899,CF045BB51AB834592F0FA9268C200D5E,10781,13,14,1,35,47,1797
52900,52900,CF045BB51AB834592F0FA9268C200D5E,13791,15,21,6,42,47,2147
52904,52904,4FA7E2AF35091649A8D61648BF92F5C0,42581,0,7,7,38,48,1948
52905,52905,4FA7E2AF35091649A8D61648BF92F5C0,10471,7,11,4,37,48,1898
52906,52906,4FA7E2AF35091649A8D61648BF92F5C0,42581,12,14,2,38,48,1948
52907,52907,4FA7E2AF35091649A8D61648BF92F5C0,10471,14,18,4,37,48,1898
52908,52908,4FA7E2AF35091649A8D61648BF92F5C0,11801,20,22,2,42,48,2148
52912,52912,7EA63201A47B68AA085BD7B8AF1F7767,10721,0,8,8,31,48,1598
52913,52913,7EA63201A47B68AA085BD7B8AF1F7767,11231,9,10,1,37,49,1899
52914,52914,7EA63201A47B68AA085BD7B8AF1F7767,12083,11,12,1,36,49,1849
52915,52915,7EA63201A47B68AA085BD7B8AF1F7767,11231,13,16,3,37,49,1899
52916,52916,7EA63201A47B68AA085BD7B8AF1F7767,12083,17,18,1,36,49,1849
52917,52917,7EA63201A47B68AA085BD7B8AF1F7767,11074,18,20,2,37,47,1897
52918,52918,7EA63201A47B68AA085BD7B8AF1F7767,10721,21,23,2,31,48,1598
52925,52925,EDD72D29B8CAB7737CF6608FA3F3E204,11471,0,6,6,12,48,648
52926,52926,EDD72D29B8CAB7737CF6608FA3F3E204,19441,8,9,1,8,46,446
52927,52927,EDD72D29B8CAB7737CF6608FA3F3E204,11471,11,14,3,12,48,648
52928,52928,EDD72D29B8CAB7737CF6608FA3F3E204,19441,15,16,1,8,46,446
52929,52929,EDD72D29B8CAB7737CF6608FA3F3E204,11471,21,23,2,12,48,648
52930,52930,2FC158799FF19F821FBD3DC4EFE863DB,13551,0,5,5,45,38,2288
52931,52931,2FC158799FF19F821FBD3DC4EFE863DB,43101,7,10,3,46,40,2340
52932,52932,2FC158799FF19F821FBD3DC4EFE863DB,13551,11,14,3,45,38,2288
52933,52933,2FC158799FF19F821FBD3DC4EFE863DB,43101,14,18,4,46,40,2340
52934,52934,2FC158799FF19F821FBD3DC4EFE863DB,13551,20,21,1,45,38,2288
52935,52935,95954D33643718A90AEF4D14409F8C12,42151,10,11,1,35,45,1795
52936,52936,95954D33643718A90AEF4D14409F8C12,13671,15,19,4,27,43,1393
52937,52937,95954D33643718A90AEF4D14409F8C12,12661,21,22,1,32,45,1645
52942,52942,A4CBFA774BBCB1E081978588796288CA,10681,0,7,7,30,48,1548
52943,52943,A4CBFA774BBCB1E081978588796288CA,11231,8,11,3,37,49,1899
52944,52944,A4CBFA774BBCB1E081978588796288CA,10901,12,13,1,35,48,1798
52945,52945,A4CBFA774BBCB1E081978588796288CA,11231,14,18,4,37,49,1899
52946,52946,A4CBFA774BBCB1E081978588796288CA,10681,18,23,5,30,48,1548
52947,52947,C274E980163D9B5AB7EB2F3B2E54C4BC,12311,0,1,1,30,44,1544
52948,52948,C274E980163D9B5AB7EB2F3B2E54C4BC,42151,2,17,15,35,45,1795
52949,52949,C274E980163D9B5AB7EB2F3B2E54C4BC,12311,21,23,2,30,44,1544
52950,52950,E798B778C510EAE2B47A353D8CC843E2,40961,0,1,1,35,47,1797
52951,52951,E798B778C510EAE2B47A353D8CC843E2,42161,2,9,7,36,47,1847
52952,52952,E798B778C510EAE2B47A353D8CC843E2,40961,12,13,1,35,47,1797
52953,52953,E798B778C510EAE2B47A353D8CC843E2,40951,15,16,1,36,49,1849
52954,52954,E798B778C510EAE2B47A353D8CC843E2,42021,19,21,2,33,47,1697
52955,52955,E798B778C510EAE2B47A353D8CC843E2,40234,22,23,1,35,49,1799
52956,52956,31C7D6EBBE109EA14915A4B3065924CF,11701,0,8,8,43,48,2198
52957,52957,31C7D6EBBE109EA14915A4B3065924CF,42601,11,18,7,44,48,2248
52958,52958,31C7D6EBBE109EA14915A4B3065924CF,40261,20,21,1,35,49,1799
52959,52959,FCBAAABDE376560AD2AD02E18DC15E6D,42623,8,13,5,22,49,1149
52960,52960,FCBAAABDE376560AD2AD02E18DC15E6D,10107,14,16,2,38,49,1949
52961,52961,FCBAAABDE376560AD2AD02E18DC15E6D,11631,18,19,1,12,49,649
52962,52962,9BDEF7E996FCADF7343CAA88AABEA361,43161,0,7,7,35,47,1797
52963,52963,9BDEF7E996FCADF7343CAA88AABEA361,15041,11,13,2,36,9,1809
52964,52964,9BDEF7E996FCADF7343CAA88AABEA361,11491,16,23,7,36,47,1847
52972,52972,B7A4A949989D03A31EAB941B263777B0,12521,1,5,4,35,41,1791
52973,52973,B7A4A949989D03A31EAB941B263777B0,13094,9,10,1,21,42,1092
52974,52974,B7A4A949989D03A31EAB941B263777B0,12521,15,22,7,35,41,1791
52982,52982,2F10F53FB454EDF61D07114FBAD3CEA6,10751,0,6,6,47,43,2393
52983,52983,2F10F53FB454EDF61D07114FBAD3CEA6,13941,11,12,1,41,47,2097
52984,52984,2F10F53FB454EDF61D07114FBAD3CEA6,10751,14,23,9,47,43,2393
52985,52985,4B5119258FB3482B746B53277561992F,12051,3,4,1,20,47,1047
52986,52986,4B5119258FB3482B746B53277561992F,12581,5,7,2,24,48,1248
52987,52987,4B5119258FB3482B746B53277561992F,12601,9,12,3,25,47,1297
52988,52988,4B5119258FB3482B746B53277561992F,10501,13,14,1,22,46,1146
52989,52989,4B5119258FB3482B746B53277561992F,12601,15,19,4,25,47,1297
52990,52990,4B5119258FB3482B746B53277561992F,12581,19,20,1,24,48,1248
52998,52998,E6C0B95DF19745278BB8C4C83FE2A959,12401,0,6,6,39,49,1999
52999,52999,E6C0B95DF19745278BB8C4C83FE2A959,11201,7,9,2,35,49,1799
53000,53000,E6C0B95DF19745278BB8C4C83FE2A959,13951,16,17,1,47,45,2395
53001,53001,E6C0B95DF19745278BB8C4C83FE2A959,12401,20,23,3,39,49,1999
53008,53008,198F13224A4C889E12ED1D538BD7168E,15391,0,6,6,35,26,1776
53009,53009,198F13224A4C889E12ED1D538BD7168E,43121,10,11,1,25,27,1277
53010,53010,198F13224A4C889E12ED1D538BD7168E,15391,13,23,10,35,26,1776
53039,53039,284847A3C6721710FAF6E0CFEF216C5D,42521,0,7,7,31,47,1597
53040,53040,284847A3C6721710FAF6E0CFEF216C5D,12083,8,9,1,36,49,1849
53041,53041,284847A3C6721710FAF6E0CFEF216C5D,42521,10,21,11,31,47,1597
53045,53045,72272CDC285000236363EA14A7DE70DE,42401,0,7,7,36,47,1847
53046,53046,72272CDC285000236363EA14A7DE70DE,11521,10,11,1,41,48,2098
53047,53047,72272CDC285000236363EA14A7DE70DE,42401,13,23,10,36,47,1847
53051,53051,C4D6D6893D15A40EF6C21B7CBC7CED3E,11861,0,5,5,32,47,1647
53052,53052,C4D6D6893D15A40EF6C21B7CBC7CED3E,42021,5,7,2,33,47,1697
53053,53053,C4D6D6893D15A40EF6C21B7CBC7CED3E,11541,8,17,9,35,49,1799
53054,53054,C4D6D6893D15A40EF6C21B7CBC7CED3E,11861,18,23,5,32,47,1647
53055,53055,5ED8949BAC5CDF05EDA1019FB7CA4B17,40171,0,6,6,38,48,1948
53056,53056,5ED8949BAC5CDF05EDA1019FB7CA4B17,42191,7,8,1,38,49,1949
53057,53057,5ED8949BAC5CDF05EDA1019FB7CA4B17,40171,12,17,5,38,48,1948
53058,53058,5ED8949BAC5CDF05EDA1019FB7CA4B17,10471,18,21,3,37,48,1898
53059,53059,5ED8949BAC5CDF05EDA1019FB7CA4B17,42401,22,23,1,36,47,1847
53060,53060,8AB561279CAFD673B81CFFF6F25401C3,12221,0,11,11,43,44,2194
53061,53061,8AB561279CAFD673B81CFFF6F25401C3,43011,11,13,2,40,42,2042
53062,53062,8AB561279CAFD673B81CFFF6F25401C3,12221,13,18,5,43,44,2194
53063,53063,8AB561279CAFD673B81CFFF6F25401C3,43011,20,23,3,40,42,2042
53064,53064,E25E1285A7A60234C9FCE15CA921BDB1,43391,0,12,12,29,48,1498
53065,53065,E25E1285A7A60234C9FCE15CA921BDB1,40951,15,18,3,36,49,1849
53066,53066,E25E1285A7A60234C9FCE15CA921BDB1,11061,20,21,1,29,48,1498
53083,53083,42B28AE3CCE12BA9A899758E7A189C34,10121,8,12,4,36,49,1849
53084,53084,42B28AE3CCE12BA9A899758E7A189C34,11806,13,15,2,41,48,2098
53085,53085,42B28AE3CCE12BA9A899758E7A189C34,10121,15,17,2,36,49,1849
53086,53086,42B28AE3CCE12BA9A899758E7A189C34,42271,18,19,1,40,47,2047
53087,53087,3A1B49B490CA109FD4D5251F0C86C9CB,43581,0,7,7,33,48,1698
53088,53088,3A1B49B490CA109FD4D5251F0C86C9CB,12601,9,18,9,25,47,1297
53089,53089,3A1B49B490CA109FD4D5251F0C86C9CB,43581,18,23,5,33,48,1698
53090,53090,FDEBDED0DFB744B954CD43B345635AE9,12083,0,7,7,36,49,1849
53091,53091,FDEBDED0DFB744B954CD43B345635AE9,10271,9,11,2,37,46,1896
53092,53092,FDEBDED0DFB744B954CD43B345635AE9,11351,12,14,2,36,48,1848
53093,53093,FDEBDED0DFB744B954CD43B345635AE9,13121,15,17,2,38,46,1946
53094,53094,FDEBDED0DFB744B954CD43B345635AE9,40505,19,23,4,36,48,1848
53095,53095,1B550A18B0397F926248F9A2C7B0A9DE,42341,0,8,8,43,49,2199
53096,53096,1B550A18B0397F926248F9A2C7B0A9DE,11731,17,18,1,36,48,1848
53097,53097,1B550A18B0397F926248F9A2C7B0A9DE,10591,19,20,1,39,48,1998
53098,53098,1B550A18B0397F926248F9A2C7B0A9DE,42341,21,23,2,43,49,2199
53099,53099,B407E10E40F14F417BB48241B7C62C97,40833,0,7,7,41,47,2097
53100,53100,B407E10E40F14F417BB48241B7C62C97,42583,12,14,2,40,48,2048
53101,53101,B407E10E40F14F417BB48241B7C62C97,12481,14,16,2,37,49,1899
53102,53102,B407E10E40F14F417BB48241B7C62C97,40833,21,23,2,41,47,2097
53109,53109,AD64CADAFCB8FA82A8CBE0DBF54B728A,16441,0,1,1,15,17,767
53110,53110,AD64CADAFCB8FA82A8CBE0DBF54B728A,15114,2,17,15,22,16,1116
53111,53111,AD64CADAFCB8FA82A8CBE0DBF54B728A,16441,21,23,2,15,17,767
53112,53112,06D652EF408EA49AF708C13110A4AC4E,12601,0,5,5,25,47,1297
53113,53113,06D652EF408EA49AF708C13110A4AC4E,13771,7,9,2,21,45,1095
53114,53114,06D652EF408EA49AF708C13110A4AC4E,12601,12,20,8,25,47,1297
53118,53118,D9975475DD1C8B9140C693F00E204385,12792,0,2,2,34,30,1730
53119,53119,D9975475DD1C8B9140C693F00E204385,12611,3,5,2,41,29,2079
53120,53120,D9975475DD1C8B9140C693F00E204385,12792,6,8,2,34,30,1730
53121,53121,D9975475DD1C8B9140C693F00E204385,12611,9,13,4,41,29,2079
53122,53122,D9975475DD1C8B9140C693F00E204385,15411,15,16,1,44,27,2227
53123,53123,D9975475DD1C8B9140C693F00E204385,12611,17,21,4,41,29,2079
53128,53128,34FB5BF239A7B5016E3CA81F47968839,42161,0,6,6,36,47,1847
53129,53129,34FB5BF239A7B5016E3CA81F47968839,40961,7,8,1,35,47,1797
53130,53130,34FB5BF239A7B5016E3CA81F47968839,42161,8,9,1,36,47,1847
53131,53131,34FB5BF239A7B5016E3CA81F47968839,40961,13,18,5,35,47,1797
53132,53132,34FB5BF239A7B5016E3CA81F47968839,10161,19,23,4,35,49,1799
53133,53133,8D8E9039F0B9A1657D1F9D7D1E057C89,11151,0,1,1,30,48,1548
53134,53134,8D8E9039F0B9A1657D1F9D7D1E057C89,10107,6,17,11,38,49,1949
53135,53135,8D8E9039F0B9A1657D1F9D7D1E057C89,12021,21,22,1,37,49,1899
53143,53143,2875CB8181B2E2AB572B9786BCA6523C,10841,0,8,8,37,47,1897
53144,53144,2875CB8181B2E2AB572B9786BCA6523C,12311,10,17,7,30,44,1544
53145,53145,2875CB8181B2E2AB572B9786BCA6523C,42581,19,21,2,38,48,1948
53146,53146,2875CB8181B2E2AB572B9786BCA6523C,43241,22,23,1,36,46,1846
53147,53147,835E4AB3BB8C4699720E70AB108BA996,12491,0,5,5,36,43,1843
53148,53148,835E4AB3BB8C4699720E70AB108BA996,19441,6,9,3,8,46,446
53149,53149,835E4AB3BB8C4699720E70AB108BA996,42041,11,12,1,10,47,547
53150,53150,835E4AB3BB8C4699720E70AB108BA996,19021,14,15,1,10,45,545
53151,53151,835E4AB3BB8C4699720E70AB108BA996,19441,17,18,1,8,46,446
53152,53152,835E4AB3BB8C4699720E70AB108BA996,11571,19,20,1,13,46,696
53153,53153,D1B4AA6A94ED1D7F85825323A47A25CE,40637,5,7,2,36,47,1847
53154,53154,D1B4AA6A94ED1D7F85825323A47A25CE,11231,9,10,1,37,49,1899
53155,53155,D1B4AA6A94ED1D7F85825323A47A25CE,11061,12,13,1,29,48,1498
53156,53156,D1B4AA6A94ED1D7F85825323A47A25CE,11231,15,17,2,37,49,1899
53157,53157,D1B4AA6A94ED1D7F85825323A47A25CE,11731,21,22,1,36,48,1848
53168,53168,73AC3CBDB2A277CF5F45112FEF564EF8,13121,1,15,14,38,46,1946
53169,53169,73AC3CBDB2A277CF5F45112FEF564EF8,42321,17,18,1,43,47,2197
53170,53170,73AC3CBDB2A277CF5F45112FEF564EF8,13121,18,23,5,38,46,1946
53171,53171,39E8FB5C4AE9A0E0783441178F244CD5,10341,0,8,8,31,47,1597
53172,53172,39E8FB5C4AE9A0E0783441178F244CD5,10221,9,12,3,34,49,1749
53173,53173,39E8FB5C4AE9A0E0783441178F244CD5,10341,12,16,4,31,47,1597
53174,53174,39E8FB5C4AE9A0E0783441178F244CD5,10281,19,21,2,33,48,1698
53175,53175,C27CAD921E0A90627C5337FD9A33D6C8,11151,1,6,5,30,48,1548
53176,53176,C27CAD921E0A90627C5337FD9A33D6C8,11875,9,14,5,30,46,1546
53177,53177,C27CAD921E0A90627C5337FD9A33D6C8,11861,16,18,2,32,47,1647
53178,53178,C27CAD921E0A90627C5337FD9A33D6C8,10281,18,19,1,33,48,1698
53179,53179,C27CAD921E0A90627C5337FD9A33D6C8,11861,19,22,3,32,47,1647
53180,53180,89A29DA093E55F037F89890FCC2F6E32,43101,0,7,7,46,40,2340
53181,53181,89A29DA093E55F037F89890FCC2F6E32,13071,8,9,1,41,41,2091
53182,53182,89A29DA093E55F037F89890FCC2F6E32,43101,10,22,12,46,40,2340
53186,53186,2FCC231DE348255A3F9CDA8D77EEA7DC,12581,0,5,5,24,48,1248
53187,53187,2FCC231DE348255A3F9CDA8D77EEA7DC,12051,7,10,3,20,47,1047
53188,53188,2FCC231DE348255A3F9CDA8D77EEA7DC,12581,11,23,12,24,48,1248
53195,53195,505FF343C6E446E7F99CFC0B5C13724B,13341,0,7,7,44,45,2245
53196,53196,505FF343C6E446E7F99CFC0B5C13724B,42631,18,19,1,43,45,2195
53197,53197,505FF343C6E446E7F99CFC0B5C13724B,12021,21,22,1,37,49,1899
53201,53201,FB1CE27AAAC41FCB201610DB3007AF46,43391,0,10,10,29,48,1498
53202,53202,FB1CE27AAAC41FCB201610DB3007AF46,42261,16,18,2,25,49,1299
53203,53203,FB1CE27AAAC41FCB201610DB3007AF46,11061,20,22,2,29,48,1498
53204,53204,BD7F8AE2121E328FD649FC14D4784D1F,11281,0,2,2,27,40,1390
53205,53205,BD7F8AE2121E328FD649FC14D4784D1F,13671,4,6,2,27,43,1393
53206,53206,BD7F8AE2121E328FD649FC14D4784D1F,11281,8,10,2,27,40,1390
53207,53207,BD7F8AE2121E328FD649FC14D4784D1F,13671,10,15,5,27,43,1393
53208,53208,BD7F8AE2121E328FD649FC14D4784D1F,10951,16,18,2,29,48,1498
53209,53209,BD7F8AE2121E328FD649FC14D4784D1F,13671,21,23,2,27,43,1393
53213,53213,D3870A8F0725CD9DDC6F7F06DC3D6803,11491,0,9,9,36,47,1847
53214,53214,D3870A8F0725CD9DDC6F7F06DC3D6803,11061,11,12,1,29,48,1498
53215,53215,D3870A8F0725CD9DDC6F7F06DC3D6803,41061,21,23,2,34,49,1749
53222,53222,C328A2915A4792A71AC58E7C60675781,42581,1,10,9,38,48,1948
53223,53223,C328A2915A4792A71AC58E7C60675781,11914,14,15,1,37,48,1898
53224,53224,C328A2915A4792A71AC58E7C60675781,11631,19,23,4,12,49,649
53225,53225,3E351ABACF5670F218BE0092A1FF748D,40343,0,6,6,24,49,1249
53226,53226,3E351ABACF5670F218BE0092A1FF748D,43761,8,16,8,32,47,1647
53227,53227,3E351ABACF5670F218BE0092A1FF748D,40343,18,21,3,24,49,1249
53234,53234,E9C5D67F82A2CCBA27E905D3F4A2B0C8,10221,0,6,6,34,49,1749
53235,53235,E9C5D67F82A2CCBA27E905D3F4A2B0C8,43751,8,12,4,19,48,998
53236,53236,E9C5D67F82A2CCBA27E905D3F4A2B0C8,11291,13,17,4,40,49,2049
53237,53237,E9C5D67F82A2CCBA27E905D3F4A2B0C8,10221,17,20,3,34,49,1749
53238,53238,E9C5D67F82A2CCBA27E905D3F4A2B0C8,11551,21,22,1,39,49,1999
53239,53239,51591F8EA07D8177C3E0ABFE6A0BF706,42623,0,6,6,22,49,1149
53240,53240,51591F8EA07D8177C3E0ABFE6A0BF706,13731,8,17,9,33,49,1699
53241,53241,51591F8EA07D8177C3E0ABFE6A0BF706,42623,20,22,2,22,49,1149
53242,53242,996E78B516B54BE4ADEF09770F316D9D,13341,0,5,5,44,45,2245
53243,53243,996E78B516B54BE4ADEF09770F316D9D,12131,6,10,4,32,47,1647
53244,53244,996E78B516B54BE4ADEF09770F316D9D,11651,13,19,6,33,47,1697
53245,53245,996E78B516B54BE4ADEF09770F316D9D,12211,21,22,1,41,44,2094
53249,53249,0EC1D2502267B7D6F36C8EA9D8EC3DDA,10171,0,7,7,26,47,1347
53250,53250,0EC1D2502267B7D6F36C8EA9D8EC3DDA,10801,9,16,7,42,47,2147
53251,53251,0EC1D2502267B7D6F36C8EA9D8EC3DDA,10171,20,23,3,26,47,1347
53252,53252,9064AE1672F230DAC98780150BF94BAB,19061,10,11,1,3,43,193
53253,53253,9064AE1672F230DAC98780150BF94BAB,42121,13,14,1,26,49,1349
53254,53254,9064AE1672F230DAC98780150BF94BAB,13911,14,19,5,39,46,1996
53255,53255,9064AE1672F230DAC98780150BF94BAB,13341,22,23,1,44,45,2245
53260,53260,47C1473BA4462B22BD05E79B53CFA190,11471,0,1,1,12,48,648
53261,53261,47C1473BA4462B22BD05E79B53CFA190,19441,4,11,7,8,46,446
53262,53262,47C1473BA4462B22BD05E79B53CFA190,42041,11,20,9,10,47,547
53263,53263,47C1473BA4462B22BD05E79B53CFA190,11471,21,23,2,12,48,648
53268,53268,D96201B04F49DA8FE5B344343C2EC845,11861,0,6,6,32,47,1647
53269,53269,D96201B04F49DA8FE5B344343C2EC845,42151,7,17,10,35,45,1795
53270,53270,D96201B04F49DA8FE5B344343C2EC845,11861,20,23,3,32,47,1647
53271,53271,90FC0DFD90F0AA1C5BDFA158F5CAEFF9,11061,1,3,2,29,48,1498
53272,53272,90FC0DFD90F0AA1C5BDFA158F5CAEFF9,42071,4,6,2,31,49,1599
53273,53273,90FC0DFD90F0AA1C5BDFA158F5CAEFF9,43391,6,14,8,29,48,1498
53274,53274,90FC0DFD90F0AA1C5BDFA158F5CAEFF9,10381,16,21,5,31,49,1599
53275,53275,90FC0DFD90F0AA1C5BDFA158F5CAEFF9,43391,22,23,1,29,48,1498
53276,53276,217E729CA9C44A54A34509CCC5DC082B,42501,2,4,2,28,47,1447
53277,53277,217E729CA9C44A54A34509CCC5DC082B,11431,4,6,2,29,47,1497
53278,53278,217E729CA9C44A54A34509CCC5DC082B,10716,9,16,7,30,46,1546
53279,53279,217E729CA9C44A54A34509CCC5DC082B,40341,18,19,1,23,49,1199
53280,53280,217E729CA9C44A54A34509CCC5DC082B,11061,20,21,1,29,48,1498
53281,53281,217E729CA9C44A54A34509CCC5DC082B,10716,21,23,2,30,46,1546
53282,53282,1F7E3B73F55DCB1AC09B01FCC7E9DC4C,43761,0,6,6,32,47,1647
53283,53283,1F7E3B73F55DCB1AC09B01FCC7E9DC4C,11061,7,9,2,29,48,1498
53284,53284,1F7E3B73F55DCB1AC09B01FCC7E9DC4C,10721,9,10,1,31,48,1598
53285,53285,1F7E3B73F55DCB1AC09B01FCC7E9DC4C,11201,11,13,2,35,49,1799
53286,53286,1F7E3B73F55DCB1AC09B01FCC7E9DC4C,11061,17,23,6,29,48,1498
53291,53291,9397083C419903E30A62F5C06D299D5C,13071,0,4,4,41,41,2091
53292,53292,9397083C419903E30A62F5C06D299D5C,43451,6,18,12,37,40,1890
53293,53293,9397083C419903E30A62F5C06D299D5C,13071,19,21,2,41,41,2091
53294,53294,9397083C419903E30A62F5C06D299D5C,42381,22,23,1,39,41,1991
53302,53302,942A242C54C5AF79C66351D8C7F17676,10451,1,7,6,25,48,1298
53303,53303,942A242C54C5AF79C66351D8C7F17676,43161,11,16,5,35,47,1797
53304,53304,942A242C54C5AF79C66351D8C7F17676,42691,19,23,4,24,48,1248
53305,53305,BCCA36AC6DE92B5D284204C1D312B82A,43161,0,6,6,35,47,1797
53306,53306,BCCA36AC6DE92B5D284204C1D312B82A,11291,8,16,8,40,49,2049
53307,53307,BCCA36AC6DE92B5D284204C1D312B82A,43161,18,23,5,35,47,1797
53312,53312,E32C26C5F7AAB132ACC9E200BFCE93F9,42471,0,6,6,35,49,1799
53313,53313,E32C26C5F7AAB132ACC9E200BFCE93F9,11531,7,8,1,34,49,1749
53314,53314,E32C26C5F7AAB132ACC9E200BFCE93F9,42471,8,16,8,35,49,1799
53315,53315,E32C26C5F7AAB132ACC9E200BFCE93F9,10841,18,20,2,37,47,1897
53316,53316,E32C26C5F7AAB132ACC9E200BFCE93F9,10401,21,22,1,33,49,1699
53317,53317,46624C7A7A05E81084BABC40FE8F937C,13314,0,7,7,31,39,1589
53318,53318,46624C7A7A05E81084BABC40FE8F937C,12521,7,14,7,35,41,1791
53319,53319,46624C7A7A05E81084BABC40FE8F937C,13314,14,23,9,31,39,1589
53320,53320,B7F8AF2F8E9E3B41152CE69E5C52A422,42231,5,12,7,37,46,1896
53321,53321,B7F8AF2F8E9E3B41152CE69E5C52A422,13911,15,16,1,39,46,1996
53322,53322,B7F8AF2F8E9E3B41152CE69E5C52A422,11481,18,21,3,41,48,2098
53323,53323,B6E06BECFD200E305BD11D4E181199C8,43471,1,8,7,31,49,1599
53324,53324,B6E06BECFD200E305BD11D4E181199C8,10431,12,13,1,33,49,1699
53325,53325,B6E06BECFD200E305BD11D4E181199C8,43161,16,17,1,35,47,1797
53326,53326,B6E06BECFD200E305BD11D4E181199C8,10221,17,19,2,34,49,1749
53327,53327,B6E06BECFD200E305BD11D4E181199C8,11951,20,23,3,31,49,1599
53339,53339,4885452BEE981BCA0AB52A94FFD49D7E,10921,0,6,6,43,48,2198
53340,53340,4885452BEE981BCA0AB52A94FFD49D7E,13681,8,15,7,38,47,1947
53341,53341,4885452BEE981BCA0AB52A94FFD49D7E,10921,21,23,2,43,48,2198
53348,53348,69601DFFFCF880DD8BF9BB911205AC6A,10281,2,5,3,33,48,1698
53349,53349,69601DFFFCF880DD8BF9BB911205AC6A,42141,6,7,1,32,47,1647
53350,53350,69601DFFFCF880DD8BF9BB911205AC6A,13651,8,13,5,30,47,1547
53351,53351,69601DFFFCF880DD8BF9BB911205AC6A,10281,13,14,1,33,48,1698
53352,53352,69601DFFFCF880DD8BF9BB911205AC6A,13651,14,18,4,30,47,1547
53353,53353,69601DFFFCF880DD8BF9BB911205AC6A,10281,19,20,1,33,48,1698
53354,53354,69601DFFFCF880DD8BF9BB911205AC6A,11161,20,21,1,32,48,1648
53355,53355,17F74F7C67C7FD1D103490BCC9C98680,10301,0,5,5,31,45,1595
53356,53356,17F74F7C67C7FD1D103490BCC9C98680,42871,6,10,4,30,45,1545
53357,53357,17F74F7C67C7FD1D103490BCC9C98680,40341,13,18,5,23,49,1199
53358,53358,17F74F7C67C7FD1D103490BCC9C98680,10951,19,20,1,29,48,1498
53359,53359,17F74F7C67C7FD1D103490BCC9C98680,10301,21,23,2,31,45,1595
53360,53360,5ABC7476B829907717164C7F4D7F76B4,11431,1,3,2,29,47,1497
53361,53361,5ABC7476B829907717164C7F4D7F76B4,11381,3,9,6,30,47,1547
53362,53362,5ABC7476B829907717164C7F4D7F76B4,11061,12,13,1,29,48,1498
53363,53363,5ABC7476B829907717164C7F4D7F76B4,43971,13,14,1,30,48,1548
53364,53364,5ABC7476B829907717164C7F4D7F76B4,11061,15,18,3,29,48,1498
53365,53365,51E47FDE51716EB36BE96125516194AB,11021,0,11,11,36,49,1849
53366,53366,51E47FDE51716EB36BE96125516194AB,40697,12,14,2,43,48,2198
53367,53367,51E47FDE51716EB36BE96125516194AB,11021,15,17,2,36,49,1849
53368,53368,51E47FDE51716EB36BE96125516194AB,40697,17,21,4,43,48,2198
53369,53369,51E47FDE51716EB36BE96125516194AB,11591,21,23,2,36,49,1849
53370,53370,718F9C02C6A67F792D4A34A4E958BCFE,10221,0,4,4,34,49,1749
53371,53371,718F9C02C6A67F792D4A34A4E958BCFE,13381,6,8,2,39,47,1997
53372,53372,718F9C02C6A67F792D4A34A4E958BCFE,43671,21,23,2,35,48,1798
53377,53377,91BDEDAC648767D3A83A88B3F0D48C25,13081,0,6,6,41,35,2085
53378,53378,91BDEDAC648767D3A83A88B3F0D48C25,42151,9,14,5,35,45,1795
53379,53379,91BDEDAC648767D3A83A88B3F0D48C25,11491,16,17,1,36,47,1847
53380,53380,91BDEDAC648767D3A83A88B3F0D48C25,13231,21,23,2,39,46,1996
53393,53393,0161781F72F04358B8C36BF7C396B645,43061,4,5,1,43,46,2196
53394,53394,0161781F72F04358B8C36BF7C396B645,41271,8,18,10,38,48,1948
53395,53395,0161781F72F04358B8C36BF7C396B645,13341,19,21,2,44,45,2245
53396,53396,3D0E1B656C5536FA930B97A859157563,40673,0,7,7,36,48,1848
53397,53397,3D0E1B656C5536FA930B97A859157563,12601,11,15,4,25,47,1297
53398,53398,3D0E1B656C5536FA930B97A859157563,10107,17,20,3,38,49,1949
53399,53399,3D0E1B656C5536FA930B97A859157563,10411,21,23,2,36,48,1848
53400,53400,BF3354E7653978B437BDBF5412A04932,12871,0,6,6,22,33,1133
53401,53401,BF3354E7653978B437BDBF5412A04932,19281,6,7,1,16,32,832
53402,53402,BF3354E7653978B437BDBF5412A04932,12871,7,21,14,22,33,1133
53403,53403,DB3C92167D7C02EAB46060E4569D1D1B,11701,0,6,6,43,48,2198
53404,53404,DB3C92167D7C02EAB46060E4569D1D1B,10121,9,10,1,36,49,1849
53405,53405,DB3C92167D7C02EAB46060E4569D1D1B,10901,12,13,1,35,48,1798
53406,53406,DB3C92167D7C02EAB46060E4569D1D1B,11231,17,18,1,37,49,1899
53407,53407,DB3C92167D7C02EAB46060E4569D1D1B,12651,22,23,1,43,47,2197
53412,53412,974F76AAA3E21167ABAC6BE6648ADEC3,11921,9,11,2,38,48,1948
53413,53413,974F76AAA3E21167ABAC6BE6648ADEC3,10411,13,15,2,36,48,1848
53414,53414,974F76AAA3E21167ABAC6BE6648ADEC3,43341,17,22,5,41,46,2096
53415,53415,062DB82DC0B3D584AB2529F1637FF6A0,41121,1,14,13,25,49,1299
53416,53416,062DB82DC0B3D584AB2529F1637FF6A0,10721,15,17,2,31,48,1598
53417,53417,062DB82DC0B3D584AB2529F1637FF6A0,11201,19,20,1,35,49,1799
53418,53418,A720B83BAF2234FB4246021D7E73EF96,13511,0,9,9,34,48,1748
53419,53419,A720B83BAF2234FB4246021D7E73EF96,40302,12,14,2,40,49,2049
53420,53420,A720B83BAF2234FB4246021D7E73EF96,10841,16,18,2,37,47,1897
53427,53427,167F0AD4C372262B104F1E644C482559,43731,0,8,8,34,47,1747
53428,53428,167F0AD4C372262B104F1E644C482559,13121,12,13,1,38,46,1946
53429,53429,167F0AD4C372262B104F1E644C482559,43281,21,23,2,37,48,1898
53430,53430,E03B05F0FB01917EEB19D58711FDBCBD,13071,0,7,7,41,41,2091
53431,53431,E03B05F0FB01917EEB19D58711FDBCBD,43101,7,9,2,46,40,2340
53432,53432,E03B05F0FB01917EEB19D58711FDBCBD,13551,10,11,1,45,38,2288
53433,53433,E03B05F0FB01917EEB19D58711FDBCBD,43101,11,20,9,46,40,2340
53434,53434,E03B05F0FB01917EEB19D58711FDBCBD,13071,20,21,1,41,41,2091
53435,53435,CC7C043FFC6EDBA54A459773B754F7C8,11331,0,1,1,37,48,1898
53436,53436,CC7C043FFC6EDBA54A459773B754F7C8,11301,12,18,6,41,49,2099
53437,53437,CC7C043FFC6EDBA54A459773B754F7C8,11751,18,21,3,35,48,1798
53438,53438,36659C41C142F8291CFDC8E8E276C630,19441,0,6,6,8,46,446
53439,53439,36659C41C142F8291CFDC8E8E276C630,12581,10,13,3,24,48,1248
53440,53440,36659C41C142F8291CFDC8E8E276C630,19441,17,18,1,8,46,446
53444,53444,29ED7585A7C0FD6B2E71E72A2B2372DE,42531,0,7,7,31,45,1595
53445,53445,29ED7585A7C0FD6B2E71E72A2B2372DE,42781,8,18,10,36,46,1846
53446,53446,29ED7585A7C0FD6B2E71E72A2B2372DE,42531,19,20,1,31,45,1595
53451,53451,478B9944D2B8B9E1604E005C1CE79375,10061,2,6,4,20,46,1046
53452,53452,478B9944D2B8B9E1604E005C1CE79375,12601,8,19,11,25,47,1297
53453,53453,478B9944D2B8B9E1604E005C1CE79375,10821,22,23,1,40,47,2047
53454,53454,1EB1C74741BE7C0B5E86F19E48D30409,42531,0,4,4,31,45,1595
53455,53455,1EB1C74741BE7C0B5E86F19E48D30409,12311,5,9,4,30,44,1544
53456,53456,1EB1C74741BE7C0B5E86F19E48D30409,42531,10,14,4,31,45,1595
53457,53457,1EB1C74741BE7C0B5E86F19E48D30409,12311,15,17,2,30,44,1544
53458,53458,1EB1C74741BE7C0B5E86F19E48D30409,42531,18,23,5,31,45,1595
53459,53459,D683E908E6DBF3266A1233277D799423,11381,0,17,17,30,47,1547
53460,53460,D683E908E6DBF3266A1233277D799423,42621,17,19,2,24,49,1249
53461,53461,D683E908E6DBF3266A1233277D799423,40341,20,22,2,23,49,1199
53466,53466,8D6D823064688A853913E29A2D4620F5,13331,0,8,8,38,47,1947
53467,53467,8D6D823064688A853913E29A2D4620F5,10841,8,10,2,37,47,1897
53468,53468,8D6D823064688A853913E29A2D4620F5,13121,10,14,4,38,46,1946
53469,53469,8D6D823064688A853913E29A2D4620F5,10841,14,15,1,37,47,1897
53470,53470,8D6D823064688A853913E29A2D4620F5,13121,15,17,2,38,46,1946
53471,53471,8D6D823064688A853913E29A2D4620F5,42511,18,20,2,37,47,1897
53472,53472,8D6D823064688A853913E29A2D4620F5,13121,20,21,1,38,46,1946
53473,53473,84E097DF782FE990259E1DE5027828BD,11481,0,5,5,41,48,2098
53474,53474,84E097DF782FE990259E1DE5027828BD,40201,8,14,6,32,49,1649
53475,53475,84E097DF782FE990259E1DE5027828BD,13371,18,23,5,41,47,2097
53479,53479,88357D5C1894ED6E374F77C7F4C36E9E,10951,0,8,8,29,48,1498
53480,53480,88357D5C1894ED6E374F77C7F4C36E9E,13741,13,14,1,37,49,1899
53481,53481,88357D5C1894ED6E374F77C7F4C36E9E,43731,15,17,2,34,47,1747
53482,53482,88357D5C1894ED6E374F77C7F4C36E9E,10471,19,20,1,37,48,1898
53483,53483,88357D5C1894ED6E374F77C7F4C36E9E,10951,22,23,1,29,48,1498
53490,53490,6657340E3E8EAFBE8630D734C7DFAA0A,19741,0,1,1,5,44,294
53491,53491,6657340E3E8EAFBE8630D734C7DFAA0A,12921,2,3,1,9,41,491
53492,53492,6657340E3E8EAFBE8630D734C7DFAA0A,19031,3,10,7,1,42,92
53493,53493,6657340E3E8EAFBE8630D734C7DFAA0A,19021,15,17,2,10,45,545
53494,53494,6657340E3E8EAFBE8630D734C7DFAA0A,12921,21,23,2,9,41,491
53495,53495,95A081EF19AE4127ED436AE554340BCB,12581,0,11,11,24,48,1248
53496,53496,95A081EF19AE4127ED436AE554340BCB,12051,15,16,1,20,47,1047
53497,53497,95A081EF19AE4127ED436AE554340BCB,12581,19,23,4,24,48,1248
53507,53507,8D42F7A960FB88E9FFF2D5AE3D7495A7,43751,0,6,6,19,48,998
53508,53508,8D42F7A960FB88E9FFF2D5AE3D7495A7,12581,8,11,3,24,48,1248
53509,53509,8D42F7A960FB88E9FFF2D5AE3D7495A7,43751,11,23,12,19,48,998
53510,53510,93789CDBB122DA3904CEB9B349C66F76,42491,0,7,7,32,46,1646
53511,53511,93789CDBB122DA3904CEB9B349C66F76,11201,9,17,8,35,49,1799
53512,53512,93789CDBB122DA3904CEB9B349C66F76,42491,18,19,1,32,46,1646
53521,53521,EF7514710FBC0170481D904B9EC7BBD4,16211,6,9,3,4,3,203
53522,53522,EF7514710FBC0170481D904B9EC7BBD4,15391,13,15,2,35,26,1776
53523,53523,EF7514710FBC0170481D904B9EC7BBD4,16211,20,23,3,4,3,203
53527,53527,13FE336F780D5F9F83776798BCE67144,42351,4,6,2,38,45,1945
53528,53528,13FE336F780D5F9F83776798BCE67144,11261,9,13,4,36,46,1846
53529,53529,13FE336F780D5F9F83776798BCE67144,42351,14,16,2,38,45,1945
53530,53530,13FE336F780D5F9F83776798BCE67144,11261,16,17,1,36,46,1846
53531,53531,13FE336F780D5F9F83776798BCE67144,42864,19,20,1,38,44,1944
53532,53532,13FE336F780D5F9F83776798BCE67144,11261,20,22,2,36,46,1846
53533,53533,1439D71C3B1C0FF45CC1AED4C666D5BA,13071,0,12,12,41,41,2091
53534,53534,1439D71C3B1C0FF45CC1AED4C666D5BA,43101,12,17,5,46,40,2340
53535,53535,1439D71C3B1C0FF45CC1AED4C666D5BA,13071,19,23,4,41,41,2091
53544,53544,706D3686B63F45412BBEC0FD26A6D729,11381,4,7,3,30,47,1547
53545,53545,706D3686B63F45412BBEC0FD26A6D729,10901,8,19,11,35,48,1798
53546,53546,706D3686B63F45412BBEC0FD26A6D729,11381,19,23,4,30,47,1547
53554,53554,441E401293D6FFC8E080552D376784E1,42581,6,7,1,38,48,1948
53555,53555,441E401293D6FFC8E080552D376784E1,11914,9,11,2,37,48,1898
53556,53556,441E401293D6FFC8E080552D376784E1,42581,12,13,1,38,48,1948
53557,53557,441E401293D6FFC8E080552D376784E1,11914,17,18,1,37,48,1898
53558,53558,441E401293D6FFC8E080552D376784E1,42581,19,22,3,38,48,1948
53559,53559,1F9F1C83F1B526750C2575DE062BE373,10295,2,8,6,30,47,1547
53560,53560,1F9F1C83F1B526750C2575DE062BE373,10401,9,12,3,33,49,1699
53561,53561,1F9F1C83F1B526750C2575DE062BE373,11201,12,13,1,35,49,1799
53562,53562,1F9F1C83F1B526750C2575DE062BE373,10401,14,15,1,33,49,1699
53563,53563,1F9F1C83F1B526750C2575DE062BE373,11211,17,18,1,34,49,1749
53564,53564,1F9F1C83F1B526750C2575DE062BE373,42523,19,22,3,31,47,1597
53571,53571,66406F61A064DD27494E549BBEBC7026,12661,0,6,6,32,45,1645
53572,53572,66406F61A064DD27494E549BBEBC7026,12641,7,16,9,10,43,543
53573,53573,66406F61A064DD27494E549BBEBC7026,19114,19,23,4,7,43,393
53580,53580,0C6F299849FC2AE726FA95F83B756CC5,11875,1,6,5,30,46,1546
53581,53581,0C6F299849FC2AE726FA95F83B756CC5,11871,10,11,1,29,46,1496
53582,53582,0C6F299849FC2AE726FA95F83B756CC5,12311,13,15,2,30,44,1544
53583,53583,0C6F299849FC2AE726FA95F83B756CC5,11875,16,17,1,30,46,1546
53584,53584,0C6F299849FC2AE726FA95F83B756CC5,12311,21,22,1,30,44,1544
53585,53585,CA7675D4504FF649E5D3C79C1D770D57,10901,0,5,5,35,48,1798
53586,53586,CA7675D4504FF649E5D3C79C1D770D57,11151,10,14,4,30,48,1548
53587,53587,CA7675D4504FF649E5D3C79C1D770D57,10161,19,23,4,35,49,1799
53591,53591,9D476BE978438113AAFAB8D8B93DB733,42231,0,6,6,37,46,1896
53592,53592,9D476BE978438113AAFAB8D8B93DB733,13671,8,16,8,27,43,1393
53593,53593,9D476BE978438113AAFAB8D8B93DB733,42231,19,23,4,37,46,1896
53598,53598,AD318EF32C0809165B01885B23F1F0E6,43981,2,3,1,36,49,1849
53599,53599,AD318EF32C0809165B01885B23F1F0E6,11231,5,8,3,37,49,1899
53600,53600,AD318EF32C0809165B01885B23F1F0E6,10121,8,15,7,36,49,1849
53601,53601,AD318EF32C0809165B01885B23F1F0E6,42471,17,21,4,35,49,1799
53602,53602,AD318EF32C0809165B01885B23F1F0E6,13561,21,23,2,37,49,1899
53603,53603,800FED50F2F7737DBE05BF1B7626336F,13651,0,10,10,30,47,1547
53604,53604,800FED50F2F7737DBE05BF1B7626336F,12481,13,15,2,37,49,1899
53605,53605,800FED50F2F7737DBE05BF1B7626336F,10151,16,18,2,34,47,1747
53606,53606,800FED50F2F7737DBE05BF1B7626336F,11531,20,22,2,34,49,1749
53611,53611,D051A53A52187B78CF6DA99F6B3FF9C4,40637,0,9,9,36,47,1847
53612,53612,D051A53A52187B78CF6DA99F6B3FF9C4,10251,9,11,2,35,47,1797
53613,53613,D051A53A52187B78CF6DA99F6B3FF9C4,10111,12,13,1,37,47,1897
53614,53614,D051A53A52187B78CF6DA99F6B3FF9C4,10251,13,15,2,35,47,1797
53615,53615,D051A53A52187B78CF6DA99F6B3FF9C4,42401,15,16,1,36,47,1847
53616,53616,D051A53A52187B78CF6DA99F6B3FF9C4,40673,20,23,3,36,48,1848
53620,53620,217B6E37D3C0BE99E8A3385BE36B0EBD,19031,0,6,6,1,42,92
53621,53621,217B6E37D3C0BE99E8A3385BE36B0EBD,12921,7,8,1,9,41,491
53622,53622,217B6E37D3C0BE99E8A3385BE36B0EBD,12641,8,19,11,10,43,543
53623,53623,E262F366757F1506354A3105F4ECFC3B,11701,0,7,7,43,48,2198
53624,53624,E262F366757F1506354A3105F4ECFC3B,11231,7,18,11,37,49,1899
53625,53625,E262F366757F1506354A3105F4ECFC3B,11701,19,23,4,43,48,2198
53626,53626,56898660E89F3DF6DEA862B2F624AA81,42523,2,4,2,31,47,1597
53627,53627,56898660E89F3DF6DEA862B2F624AA81,12601,8,10,2,25,47,1297
53628,53628,56898660E89F3DF6DEA862B2F624AA81,42523,14,15,1,31,47,1597
53629,53629,56898660E89F3DF6DEA862B2F624AA81,40341,18,20,2,23,49,1199
53637,53637,6AF9BC3BC00A2DB4E93E7EFAFF6696BB,43761,0,7,7,32,47,1647
53638,53638,6AF9BC3BC00A2DB4E93E7EFAFF6696BB,40203,8,9,1,33,49,1699
53639,53639,6AF9BC3BC00A2DB4E93E7EFAFF6696BB,43761,14,16,2,32,47,1647
53640,53640,6AF9BC3BC00A2DB4E93E7EFAFF6696BB,42523,16,17,1,31,47,1597
53641,53641,6AF9BC3BC00A2DB4E93E7EFAFF6696BB,43761,18,19,1,32,47,1647
53642,53642,6AF9BC3BC00A2DB4E93E7EFAFF6696BB,42523,21,22,1,31,47,1597
53650,53650,EC1AA26E7BF96EA1B93BCEB52269CDDD,42271,0,9,9,40,47,2047
53651,53651,EC1AA26E7BF96EA1B93BCEB52269CDDD,11806,9,15,6,41,48,2098
53652,53652,EC1AA26E7BF96EA1B93BCEB52269CDDD,40341,16,19,3,23,49,1199
53653,53653,EC1AA26E7BF96EA1B93BCEB52269CDDD,13101,20,22,2,40,47,2047
53654,53654,A2DD7BA75FCE1B5306A377D198F94491,12792,0,4,4,34,30,1730
53655,53655,A2DD7BA75FCE1B5306A377D198F94491,15391,7,8,1,35,26,1776
53656,53656,A2DD7BA75FCE1B5306A377D198F94491,43121,9,10,1,25,27,1277
53657,53657,A2DD7BA75FCE1B5306A377D198F94491,15391,14,21,7,35,26,1776
53658,53658,CE29EB37C112E7F535813A697DFC251A,43751,0,13,13,19,48,998
53659,53659,CE29EB37C112E7F535813A697DFC251A,42681,14,15,1,24,48,1248
53660,53660,CE29EB37C112E7F535813A697DFC251A,43751,19,23,4,19,48,998
53661,53661,E89C7657A21278EA8E51337529892FD6,10691,0,6,6,33,48,1698
53662,53662,E89C7657A21278EA8E51337529892FD6,42491,7,10,3,32,46,1646
53663,53663,E89C7657A21278EA8E51337529892FD6,10431,11,12,1,33,49,1699
53664,53664,E89C7657A21278EA8E51337529892FD6,42021,17,18,1,33,47,1697
53665,53665,E89C7657A21278EA8E51337529892FD6,10691,18,20,2,33,48,1698
53670,53670,A845F5E6E274947D69D978D433D48E69,11914,0,7,7,37,48,1898
53671,53671,A845F5E6E274947D69D978D433D48E69,12601,8,11,3,25,47,1297
53672,53672,A845F5E6E274947D69D978D433D48E69,10501,13,14,1,22,46,1146
53673,53673,A845F5E6E274947D69D978D433D48E69,10661,19,22,3,37,49,1899
53674,53674,6FA03E45FDFEF0856B140ADCF54DC363,42623,0,10,10,22,49,1149
53675,53675,6FA03E45FDFEF0856B140ADCF54DC363,11211,11,12,1,34,49,1749
53676,53676,6FA03E45FDFEF0856B140ADCF54DC363,42623,13,19,6,22,49,1149
53677,53677,1E4ADDBFBD1C3EEA7DB4E1CBF005793C,11061,0,6,6,29,48,1498
53678,53678,1E4ADDBFBD1C3EEA7DB4E1CBF005793C,42541,7,8,1,25,47,1297
53679,53679,1E4ADDBFBD1C3EEA7DB4E1CBF005793C,11061,12,14,2,29,48,1498
53680,53680,1E4ADDBFBD1C3EEA7DB4E1CBF005793C,11111,18,20,2,26,48,1348
53681,53681,1E4ADDBFBD1C3EEA7DB4E1CBF005793C,40445,20,23,3,30,48,1548
53682,53682,E5C174D2FF195FD116006ADE577A953D,11061,0,1,1,29,48,1498
53683,53683,E5C174D2FF195FD116006ADE577A953D,11381,1,6,5,30,47,1547
53684,53684,E5C174D2FF195FD116006ADE577A953D,11151,8,9,1,30,48,1548
53685,53685,E5C174D2FF195FD116006ADE577A953D,11061,10,12,2,29,48,1498
53686,53686,E5C174D2FF195FD116006ADE577A953D,11151,14,20,6,30,48,1548
53690,53690,40A3F567657A043546A2ED7A5DC91A85,12792,3,6,3,34,30,1730
53691,53691,40A3F567657A043546A2ED7A5DC91A85,15331,6,11,5,38,24,1924
53692,53692,40A3F567657A043546A2ED7A5DC91A85,12792,12,23,11,34,30,1730
53700,53700,BB6408B6449FE57F7E33631A828BC98E,11701,0,3,3,43,48,2198
53701,53701,BB6408B6449FE57F7E33631A828BC98E,15041,8,9,1,36,9,1809
53702,53702,BB6408B6449FE57F7E33631A828BC98E,15561,11,13,2,32,22,1622
53703,53703,BB6408B6449FE57F7E33631A828BC98E,13961,14,15,1,42,48,2148
53704,53704,BB6408B6449FE57F7E33631A828BC98E,11301,20,23,3,41,49,2099
53708,53708,8B7C73BA6B2D95910FBCFDF137038C2A,19114,0,5,5,7,43,393
53709,53709,8B7C73BA6B2D95910FBCFDF137038C2A,12641,7,10,3,10,43,543
53710,53710,8B7C73BA6B2D95910FBCFDF137038C2A,19114,10,17,7,7,43,393
53711,53711,8B7C73BA6B2D95910FBCFDF137038C2A,19111,18,20,2,9,45,495
53712,53712,8B7C73BA6B2D95910FBCFDF137038C2A,19114,21,22,1,7,43,393
53713,53713,AB57CFBC7FBBD1B4F46C04046F726522,15171,0,4,4,42,21,2121
53714,53714,AB57CFBC7FBBD1B4F46C04046F726522,15021,6,7,1,46,18,2318
53715,53715,AB57CFBC7FBBD1B4F46C04046F726522,12881,7,9,2,47,22,2372
53716,53716,AB57CFBC7FBBD1B4F46C04046F726522,15171,9,11,2,42,21,2121
53717,53717,AB57CFBC7FBBD1B4F46C04046F726522,15021,15,16,1,46,18,2318
53718,53718,AB57CFBC7FBBD1B4F46C04046F726522,15171,20,21,1,42,21,2121
53719,53719,AB57CFBC7FBBD1B4F46C04046F726522,12881,21,22,1,47,22,2372
53720,53720,1EE93E8FFF74D270AB00DC1FFEF6860E,15021,0,1,1,46,18,2318
53721,53721,1EE93E8FFF74D270AB00DC1FFEF6860E,15441,3,7,4,44,20,2220
53722,53722,1EE93E8FFF74D270AB00DC1FFEF6860E,15021,7,8,1,46,18,2318
53723,53723,1EE93E8FFF74D270AB00DC1FFEF6860E,12881,12,14,2,47,22,2372
53724,53724,1EE93E8FFF74D270AB00DC1FFEF6860E,15021,14,17,3,46,18,2318
53725,53725,1EE93E8FFF74D270AB00DC1FFEF6860E,12881,22,23,1,47,22,2372
53726,53726,7CDAB588EA65BCF95FE0652A61C14CC7,12581,0,13,13,24,48,1248
53727,53727,7CDAB588EA65BCF95FE0652A61C14CC7,11361,14,15,1,22,48,1148
53728,53728,7CDAB588EA65BCF95FE0652A61C14CC7,43751,20,21,1,19,48,998
53729,53729,9F589AB01E58B6B2CA9FB997F96CB7F3,13071,0,6,6,41,41,2091
53730,53730,9F589AB01E58B6B2CA9FB997F96CB7F3,43451,7,8,1,37,40,1890
53731,53731,9F589AB01E58B6B2CA9FB997F96CB7F3,13071,11,23,12,41,41,2091
53739,53739,936F3EAEFFE6D40274671E4FB3E6BD97,11941,1,5,4,37,46,1896
53740,53740,936F3EAEFFE6D40274671E4FB3E6BD97,10111,7,8,1,37,47,1897
53741,53741,936F3EAEFFE6D40274671E4FB3E6BD97,11941,8,17,9,37,46,1896
53742,53742,936F3EAEFFE6D40274671E4FB3E6BD97,13911,18,19,1,39,46,1996
53743,53743,936F3EAEFFE6D40274671E4FB3E6BD97,42231,20,22,2,37,46,1896
53744,53744,859846C23309918FCF7E37DF9FD45D9F,13911,1,7,6,39,46,1996
53745,53745,859846C23309918FCF7E37DF9FD45D9F,42231,7,10,3,37,46,1896
53746,53746,859846C23309918FCF7E37DF9FD45D9F,42351,11,14,3,38,45,1945
53747,53747,859846C23309918FCF7E37DF9FD45D9F,42231,15,17,2,37,46,1896
53748,53748,859846C23309918FCF7E37DF9FD45D9F,13911,20,21,1,39,46,1996
53752,53752,D7D53B57483FC76EE9BE7304C6EB5CA5,11074,0,5,5,37,47,1897
53753,53753,D7D53B57483FC76EE9BE7304C6EB5CA5,42541,9,14,5,25,47,1297
53754,53754,D7D53B57483FC76EE9BE7304C6EB5CA5,11074,18,20,2,37,47,1897
53755,53755,5117C51B1073385BE9CAD291C267C88C,10351,1,7,6,28,45,1445
53756,53756,5117C51B1073385BE9CAD291C267C88C,13911,8,15,7,39,46,1996
53757,53757,5117C51B1073385BE9CAD291C267C88C,42231,18,19,1,37,46,1896
53758,53758,5117C51B1073385BE9CAD291C267C88C,10351,19,23,4,28,45,1445
53759,53759,235C15EE336FD644D7DF598E25164C0E,40637,3,8,5,36,47,1847
53760,53760,235C15EE336FD644D7DF598E25164C0E,13351,10,11,1,48,48,2448
53761,53761,235C15EE336FD644D7DF598E25164C0E,10251,18,21,3,35,47,1797
53762,53762,C4A46EA5408AA16A0ED0D09924B79885,11701,1,7,6,43,48,2198
53763,53763,C4A46EA5408AA16A0ED0D09924B79885,42641,9,19,10,33,49,1699
53764,53764,C4A46EA5408AA16A0ED0D09924B79885,11701,20,21,1,43,48,2198
53768,53768,D3D891501F7527BC175379F737060A6D,10281,0,6,6,33,48,1698
53769,53769,D3D891501F7527BC175379F737060A6D,11861,8,10,2,32,47,1647
53770,53770,D3D891501F7527BC175379F737060A6D,11651,12,13,1,33,47,1697
53771,53771,D3D891501F7527BC175379F737060A6D,11861,16,17,1,32,47,1647
53772,53772,D3D891501F7527BC175379F737060A6D,10281,17,23,6,33,48,1698
53773,53773,59644621240D60A0095CD2C9DBFE93CE,12731,0,5,5,22,40,1140
53774,53774,59644621240D60A0095CD2C9DBFE93CE,19801,9,10,1,19,26,976
53775,53775,59644621240D60A0095CD2C9DBFE93CE,12871,10,18,8,22,33,1133
53776,53776,59644621240D60A0095CD2C9DBFE93CE,19801,18,19,1,19,26,976
53777,53777,59644621240D60A0095CD2C9DBFE93CE,13481,21,23,2,26,31,1331
53778,53778,D5C98D28246C767D0FFD7F7274CFF193,13314,0,6,6,31,39,1589
53779,53779,D5C98D28246C767D0FFD7F7274CFF193,12491,7,8,1,36,43,1843
53780,53780,D5C98D28246C767D0FFD7F7274CFF193,42151,9,10,1,35,45,1795
53781,53781,D5C98D28246C767D0FFD7F7274CFF193,13314,11,14,3,31,39,1589
53782,53782,D5C98D28246C767D0FFD7F7274CFF193,42151,14,15,1,35,45,1795
53783,53783,D5C98D28246C767D0FFD7F7274CFF193,13314,18,23,5,31,39,1589
53787,53787,0D8B65538247AAF24C9243214566763E,11631,2,3,1,12,49,649
53788,53788,0D8B65538247AAF24C9243214566763E,11381,8,14,6,30,47,1547
53789,53789,0D8B65538247AAF24C9243214566763E,11061,19,20,1,29,48,1498
53790,53790,0D8B65538247AAF24C9243214566763E,11381,22,23,1,30,47,1547
53791,53791,F5B51F953CD3F7A1DB23953A4B9121A3,12871,0,4,4,22,33,1133
53792,53792,F5B51F953CD3F7A1DB23953A4B9121A3,19281,7,21,14,16,32,832
53793,53793,F5B51F953CD3F7A1DB23953A4B9121A3,19531,22,23,1,17,30,880
53794,53794,5A02A0783A87EA433648AFD73A3E8C60,19111,0,8,8,9,45,495
53795,53795,5A02A0783A87EA433648AFD73A3E8C60,10171,10,11,1,26,47,1347
53796,53796,5A02A0783A87EA433648AFD73A3E8C60,10471,11,19,8,37,48,1898
53797,53797,5A02A0783A87EA433648AFD73A3E8C60,19111,21,23,2,9,45,495
53808,53808,CF52C4A5E53CE2A3284129EF146031F9,11291,0,7,7,40,49,2049
53809,53809,CF52C4A5E53CE2A3284129EF146031F9,19111,11,12,1,9,45,495
53810,53810,CF52C4A5E53CE2A3284129EF146031F9,11291,15,23,8,40,49,2049
53811,53811,FB816AB41A0BC3877E7A8672FD97CA1F,10681,0,9,9,30,48,1548
53812,53812,FB816AB41A0BC3877E7A8672FD97CA1F,11061,9,10,1,29,48,1498
53813,53813,FB816AB41A0BC3877E7A8672FD97CA1F,11381,13,14,1,30,47,1547
53814,53814,FB816AB41A0BC3877E7A8672FD97CA1F,11061,14,16,2,29,48,1498
53815,53815,FB816AB41A0BC3877E7A8672FD97CA1F,11381,16,18,2,30,47,1547
53816,53816,FB816AB41A0BC3877E7A8672FD97CA1F,11061,18,19,1,29,48,1498
53817,53817,FB816AB41A0BC3877E7A8672FD97CA1F,10681,21,23,2,30,48,1548
53821,53821,6EB03DEC41F60785258F0AA9E4E23DB1,12761,0,7,7,25,40,1290
53822,53822,6EB03DEC41F60785258F0AA9E4E23DB1,11281,8,12,4,27,40,1390
53823,53823,6EB03DEC41F60785258F0AA9E4E23DB1,12521,15,23,8,35,41,1791
53827,53827,F86245840859ECAC4FECC44520BE08E0,42031,5,15,10,40,46,2046
53828,53828,F86245840859ECAC4FECC44520BE08E0,11231,15,17,2,37,49,1899
53829,53829,F86245840859ECAC4FECC44520BE08E0,42031,19,20,1,40,46,2046
53830,53830,565AA720CA7330F672E181815A5D2DB6,10801,0,6,6,42,47,2147
53831,53831,565AA720CA7330F672E181815A5D2DB6,11131,9,10,1,33,48,1698
53832,53832,565AA720CA7330F672E181815A5D2DB6,12511,13,14,1,39,47,1997
53833,53833,565AA720CA7330F672E181815A5D2DB6,10801,17,23,6,42,47,2147
53844,53844,F90313BC40FFD1908C2B8D9FAFC50C6B,11261,2,6,4,36,46,1846
53845,53845,F90313BC40FFD1908C2B8D9FAFC50C6B,12601,10,17,7,25,47,1297
53846,53846,F90313BC40FFD1908C2B8D9FAFC50C6B,11261,21,23,2,36,46,1846
53847,53847,D0819644627AC00B1760F57708B6F7FF,41393,0,7,7,43,49,2199
53848,53848,D0819644627AC00B1760F57708B6F7FF,43621,9,10,1,46,48,2348
53849,53849,D0819644627AC00B1760F57708B6F7FF,41393,11,13,2,43,49,2199
53850,53850,D0819644627AC00B1760F57708B6F7FF,43621,13,14,1,46,48,2348
53851,53851,D0819644627AC00B1760F57708B6F7FF,41393,17,19,2,43,49,2199
53855,53855,E369C95477F5936C2B249F0A605C63A6,12514,0,12,12,38,47,1947
53856,53856,E369C95477F5936C2B249F0A605C63A6,42221,12,13,1,38,48,1948
53857,53857,E369C95477F5936C2B249F0A605C63A6,12514,14,16,2,38,47,1947
53858,53858,E369C95477F5936C2B249F0A605C63A6,12391,18,19,1,36,49,1849
53859,53859,E369C95477F5936C2B249F0A605C63A6,12514,22,23,1,38,47,1947
53860,53860,09C2A5500F5ABAEEAC932C07F5628EC4,11021,0,8,8,36,49,1849
53861,53861,09C2A5500F5ABAEEAC932C07F5628EC4,43161,9,11,2,35,47,1797
53862,53862,09C2A5500F5ABAEEAC932C07F5628EC4,11021,13,14,1,36,49,1849
53863,53863,09C2A5500F5ABAEEAC932C07F5628EC4,42161,14,19,5,36,47,1847
53864,53864,09C2A5500F5ABAEEAC932C07F5628EC4,11021,21,23,2,36,49,1849
53865,53865,F276DA0C0E39AE3BAD5B91AE46CB6EA8,42971,0,5,5,43,49,2199
53866,53866,F276DA0C0E39AE3BAD5B91AE46CB6EA8,11231,6,9,3,37,49,1899
53867,53867,F276DA0C0E39AE3BAD5B91AE46CB6EA8,10471,9,11,2,37,48,1898
53868,53868,F276DA0C0E39AE3BAD5B91AE46CB6EA8,11231,11,18,7,37,49,1899
53869,53869,F276DA0C0E39AE3BAD5B91AE46CB6EA8,10471,18,20,2,37,48,1898
53870,53870,F276DA0C0E39AE3BAD5B91AE46CB6EA8,11231,20,22,2,37,49,1899
53875,53875,7555BE56ECBD7A21A433BB338C4AD042,19114,0,7,7,7,43,393
53876,53876,7555BE56ECBD7A21A433BB338C4AD042,12641,8,9,1,10,43,543
53877,53877,7555BE56ECBD7A21A433BB338C4AD042,19114,10,13,3,7,43,393
53878,53878,7555BE56ECBD7A21A433BB338C4AD042,12641,15,17,2,10,43,543
53879,53879,7555BE56ECBD7A21A433BB338C4AD042,19114,19,22,3,7,43,393
53880,53880,7555BE56ECBD7A21A433BB338C4AD042,12641,22,23,1,10,43,543
53881,53881,BBCB9918D42B41DEDF16DD7F5A9BE26F,10111,10,12,2,37,47,1897
53882,53882,BBCB9918D42B41DEDF16DD7F5A9BE26F,11911,12,16,4,37,48,1898
53883,53883,BBCB9918D42B41DEDF16DD7F5A9BE26F,11861,17,23,6,32,47,1647
53884,53884,04895415E76D1FFF866D6B8869FD01BC,40637,0,10,10,36,47,1847
53885,53885,04895415E76D1FFF866D6B8869FD01BC,13341,14,15,1,44,45,2245
53886,53886,04895415E76D1FFF866D6B8869FD01BC,40637,16,23,7,36,47,1847
53887,53887,69C834810CF6013D091E0B9EA99E4EF4,40637,0,8,8,36,47,1847
53888,53888,69C834810CF6013D091E0B9EA99E4EF4,42551,9,13,4,14,48,748
53889,53889,69C834810CF6013D091E0B9EA99E4EF4,12641,15,16,1,10,43,543
53890,53890,69C834810CF6013D091E0B9EA99E4EF4,40637,18,23,5,36,47,1847
53891,53891,105A3B72395833D152D1F67AE98737D7,19031,10,11,1,1,42,92
53892,53892,105A3B72395833D152D1F67AE98737D7,12921,15,17,2,9,41,491
53893,53893,105A3B72395833D152D1F67AE98737D7,49201,20,22,2,7,41,391
53894,53894,CE42FB703E5A8466F11E1B10B1063DB7,42271,0,9,9,40,47,2047
53895,53895,CE42FB703E5A8466F11E1B10B1063DB7,42281,9,14,5,40,48,2048
53896,53896,CE42FB703E5A8466F11E1B10B1063DB7,40341,16,19,3,23,49,1199
53897,53897,CE42FB703E5A8466F11E1B10B1063DB7,11481,20,22,2,41,48,2098
53905,53905,CABDD8B2A8DF9C3C6F2F674E6DD5C884,11381,0,1,1,30,47,1547
53906,53906,CABDD8B2A8DF9C3C6F2F674E6DD5C884,11061,2,10,8,29,48,1498
53907,53907,CABDD8B2A8DF9C3C6F2F674E6DD5C884,11381,11,16,5,30,47,1547
53908,53908,CABDD8B2A8DF9C3C6F2F674E6DD5C884,42511,18,20,2,37,47,1897
53913,53913,7D60ECAFAB6564C82BC23FBB9D5A6910,42071,1,6,5,31,49,1599
53914,53914,7D60ECAFAB6564C82BC23FBB9D5A6910,11061,7,9,2,29,48,1498
53915,53915,7D60ECAFAB6564C82BC23FBB9D5A6910,40951,12,13,1,36,49,1849
53916,53916,7D60ECAFAB6564C82BC23FBB9D5A6910,42071,14,23,9,31,49,1599
53917,53917,40A368CA34750DF505DA57A322872C86,12611,10,14,4,41,29,2079
53918,53918,40A368CA34750DF505DA57A322872C86,15411,15,17,2,44,27,2227
53919,53919,40A368CA34750DF505DA57A322872C86,12611,18,19,1,41,29,2079
53920,53920,40A368CA34750DF505DA57A322872C86,15411,21,22,1,44,27,2227
53931,53931,04FDCC702F37E16DD9968ED131B1ACEB,13911,0,6,6,39,46,1996
53932,53932,04FDCC702F37E16DD9968ED131B1ACEB,11531,16,18,2,34,49,1749
53933,53933,04FDCC702F37E16DD9968ED131B1ACEB,13911,22,23,1,39,46,1996
53934,53934,10C0623C858BE6D33225691C7AF5AFE1,10231,3,4,1,39,49,1999
53935,53935,10C0623C858BE6D33225691C7AF5AFE1,42141,5,11,6,32,47,1647
53936,53936,10C0623C858BE6D33225691C7AF5AFE1,10841,12,13,1,37,47,1897
53937,53937,10C0623C858BE6D33225691C7AF5AFE1,16321,19,21,2,8,7,407
53938,53938,10C0623C858BE6D33225691C7AF5AFE1,16041,22,23,1,1,5,55
53939,53939,E183AEA1AD541C6BB144A110AC32B30F,12641,0,2,2,10,43,543
53940,53940,E183AEA1AD541C6BB144A110AC32B30F,19931,2,4,2,7,43,393
53941,53941,E183AEA1AD541C6BB144A110AC32B30F,12641,8,9,1,10,43,543
53942,53942,E183AEA1AD541C6BB144A110AC32B30F,19931,10,11,1,7,43,393
53943,53943,E183AEA1AD541C6BB144A110AC32B30F,12641,16,23,7,10,43,543
53944,53944,B4CA25FEDAA2DF56BCFB18223F3F5EC1,42231,0,8,8,37,46,1896
53945,53945,B4CA25FEDAA2DF56BCFB18223F3F5EC1,11061,12,14,2,29,48,1498
53946,53946,B4CA25FEDAA2DF56BCFB18223F3F5EC1,11074,21,22,1,37,47,1897
53947,53947,F7065DEB6EFDA3755D41B0E87F33EEEE,13911,0,12,12,39,46,1996
53948,53948,F7065DEB6EFDA3755D41B0E87F33EEEE,43011,15,16,1,40,42,2042
53949,53949,F7065DEB6EFDA3755D41B0E87F33EEEE,11261,18,22,4,36,46,1846
53950,53950,140E448FCB247E6D4CCE70CB52F04843,10711,0,7,7,29,46,1496
53951,53951,140E448FCB247E6D4CCE70CB52F04843,12311,11,15,4,30,44,1544
53952,53952,140E448FCB247E6D4CCE70CB52F04843,11651,19,21,2,33,47,1697
53965,53965,68A24D68E1EE6F85D7484BA18462FF82,11875,3,7,4,30,46,1546
53966,53966,68A24D68E1EE6F85D7484BA18462FF82,42523,7,9,2,31,47,1597
53967,53967,68A24D68E1EE6F85D7484BA18462FF82,42461,10,11,1,45,47,2297
53968,53968,68A24D68E1EE6F85D7484BA18462FF82,10292,17,19,2,30,47,1547
53969,53969,68A24D68E1EE6F85D7484BA18462FF82,10724,22,23,1,32,48,1648
53976,53976,5E3A9775EC6F71047834877FE6191C63,12121,0,7,7,29,47,1497
53977,53977,5E3A9775EC6F71047834877FE6191C63,13791,13,16,3,42,47,2147
53978,53978,5E3A9775EC6F71047834877FE6191C63,12121,17,23,6,29,47,1497
53986,53986,220A83B4C0760D0CE7D499DE7174338C,11324,0,7,7,31,46,1596
53987,53987,220A83B4C0760D0CE7D499DE7174338C,10111,8,19,11,37,47,1897
53988,53988,220A83B4C0760D0CE7D499DE7174338C,11324,19,23,4,31,46,1596
53995,53995,9F22CEAACF5F9765BA896D571A934437,43021,3,4,1,16,43,843
53996,53996,9F22CEAACF5F9765BA896D571A934437,12121,6,7,1,29,47,1497
53997,53997,9F22CEAACF5F9765BA896D571A934437,12921,8,22,14,9,41,491
54014,54014,F657EC858DEE55710BAB423B4CC1978D,42633,0,8,8,42,46,2146
54015,54015,F657EC858DEE55710BAB423B4CC1978D,10811,9,16,7,38,46,1946
54016,54016,F657EC858DEE55710BAB423B4CC1978D,12211,18,19,1,41,44,2094
54017,54017,F657EC858DEE55710BAB423B4CC1978D,42981,20,21,1,36,49,1849
54025,54025,0A06E26D4B63B311703019BBFB7FEF42,10471,0,8,8,37,48,1898
54026,54026,0A06E26D4B63B311703019BBFB7FEF42,42471,9,11,2,35,49,1799
54027,54027,0A06E26D4B63B311703019BBFB7FEF42,11591,14,15,1,36,49,1849
54028,54028,0A06E26D4B63B311703019BBFB7FEF42,12381,19,22,3,32,48,1648
54029,54029,08B6161A63F0BFCCF67BFC0EA5B81E44,42621,0,6,6,24,49,1249
54030,54030,08B6161A63F0BFCCF67BFC0EA5B81E44,40341,6,10,4,23,49,1199
54031,54031,08B6161A63F0BFCCF67BFC0EA5B81E44,42081,11,14,3,24,49,1249
54032,54032,08B6161A63F0BFCCF67BFC0EA5B81E44,40341,14,15,1,23,49,1199
54033,54033,08B6161A63F0BFCCF67BFC0EA5B81E44,42621,16,21,5,24,49,1249
54034,54034,08B6161A63F0BFCCF67BFC0EA5B81E44,42623,21,23,2,22,49,1149
54035,54035,346BF3F539A4C5C04EF0491F7207CF76,19931,0,8,8,7,43,393
54036,54036,346BF3F539A4C5C04EF0491F7207CF76,12641,9,10,1,10,43,543
54037,54037,346BF3F539A4C5C04EF0491F7207CF76,43021,12,13,1,16,43,843
54038,54038,346BF3F539A4C5C04EF0491F7207CF76,12641,14,19,5,10,43,543
54039,54039,346BF3F539A4C5C04EF0491F7207CF76,19931,20,23,3,7,43,393
54043,54043,E051F3A68F183E58DAB85439F9F9C3B1,11954,0,5,5,32,49,1649
54044,54044,E051F3A68F183E58DAB85439F9F9C3B1,13731,8,11,3,33,49,1699
54045,54045,E051F3A68F183E58DAB85439F9F9C3B1,11951,11,12,1,31,49,1599
54046,54046,E051F3A68F183E58DAB85439F9F9C3B1,13731,16,17,1,33,49,1699
54047,54047,E051F3A68F183E58DAB85439F9F9C3B1,11951,19,23,4,31,49,1599
54054,54054,1AF3413905A2A8813EEB1CD65CEC34FB,10531,1,9,8,34,46,1746
54055,54055,1AF3413905A2A8813EEB1CD65CEC34FB,10151,12,17,5,34,47,1747
54056,54056,1AF3413905A2A8813EEB1CD65CEC34FB,13221,21,22,1,40,47,2047
54060,54060,CB51EA3DFBAD71C46F446085843381F3,12792,2,6,4,34,30,1730
54061,54061,CB51EA3DFBAD71C46F446085843381F3,43121,7,8,1,25,27,1277
54062,54062,CB51EA3DFBAD71C46F446085843381F3,15091,9,10,1,35,26,1776
54063,54063,CB51EA3DFBAD71C46F446085843381F3,43121,10,14,4,25,27,1277
54064,54064,CB51EA3DFBAD71C46F446085843381F3,15091,16,17,1,35,26,1776
54065,54065,CB51EA3DFBAD71C46F446085843381F3,43121,18,20,2,25,27,1277
54066,54066,CB51EA3DFBAD71C46F446085843381F3,15091,20,23,3,35,26,1776
54074,54074,49237ECED003BFEF5E21C688FECB20EC,19061,0,8,8,3,43,193
54075,54075,49237ECED003BFEF5E21C688FECB20EC,11061,11,13,2,29,48,1498
54076,54076,49237ECED003BFEF5E21C688FECB20EC,19061,17,20,3,3,43,193
54077,54077,22B226B098E21E8EFBF1D1AD480D8C9E,13371,0,7,7,41,47,2097
54078,54078,22B226B098E21E8EFBF1D1AD480D8C9E,12391,8,13,5,36,49,1849
54079,54079,22B226B098E21E8EFBF1D1AD480D8C9E,11171,15,16,1,33,48,1698
54080,54080,22B226B098E21E8EFBF1D1AD480D8C9E,42961,17,18,1,35,49,1799
54081,54081,22B226B098E21E8EFBF1D1AD480D8C9E,13371,20,23,3,41,47,2097
54091,54091,5540EC4B9A79A2803AEA3D2399D9018F,11261,1,8,7,36,46,1846
54092,54092,5540EC4B9A79A2803AEA3D2399D9018F,13461,8,11,3,39,44,1994
54093,54093,5540EC4B9A79A2803AEA3D2399D9018F,11261,20,23,3,36,46,1846
54094,54094,CDD868B7CD2EE63A11365508386D7821,42371,0,13,13,34,46,1746
54095,54095,CDD868B7CD2EE63A11365508386D7821,13841,15,17,2,40,46,2046
54096,54096,CDD868B7CD2EE63A11365508386D7821,13911,18,22,4,39,46,1996
54097,54097,7FAB6549398D07D9151B1565A993173F,43761,0,7,7,32,47,1647
54098,54098,7FAB6549398D07D9151B1565A993173F,40341,9,10,1,23,49,1199
54099,54099,7FAB6549398D07D9151B1565A993173F,42021,16,20,4,33,47,1697
54100,54100,765113C0EC03D9C2E8837F99909100D7,40637,0,7,7,36,47,1847
54101,54101,765113C0EC03D9C2E8837F99909100D7,10681,10,12,2,30,48,1548
54102,54102,765113C0EC03D9C2E8837F99909100D7,40637,15,16,1,36,47,1847
54103,54103,765113C0EC03D9C2E8837F99909100D7,10681,17,19,2,30,48,1548
54104,54104,EC8D784C19C185B8F2C30A9ECA831652,12211,0,2,2,41,44,2094
54105,54105,EC8D784C19C185B8F2C30A9ECA831652,13911,3,5,2,39,46,1996
54106,54106,EC8D784C19C185B8F2C30A9ECA831652,11261,8,10,2,36,46,1846
54107,54107,EC8D784C19C185B8F2C30A9ECA831652,13911,12,16,4,39,46,1996
54108,54108,EC8D784C19C185B8F2C30A9ECA831652,11261,20,21,1,36,46,1846
54109,54109,6587B781598530C86F6C53CA6F1512D2,10431,0,7,7,33,49,1699
54110,54110,6587B781598530C86F6C53CA6F1512D2,10351,8,10,2,28,45,1445
54111,54111,6587B781598530C86F6C53CA6F1512D2,10431,12,14,2,33,49,1699
54112,54112,6587B781598530C86F6C53CA6F1512D2,10351,15,18,3,28,45,1445
54113,54113,6587B781598530C86F6C53CA6F1512D2,10431,19,23,4,33,49,1699
54114,54114,0EF5CC18E50533A99D4FFAAC4B40B0EA,43761,0,14,14,32,47,1647
54115,54115,0EF5CC18E50533A99D4FFAAC4B40B0EA,11021,16,18,2,36,49,1849
54116,54116,0EF5CC18E50533A99D4FFAAC4B40B0EA,43761,22,23,1,32,47,1647
54123,54123,6F2B87364A5FB9C5DFEF11838C9DD6DB,13671,2,3,1,27,43,1393
54124,54124,6F2B87364A5FB9C5DFEF11838C9DD6DB,42861,4,6,2,37,44,1894
54125,54125,6F2B87364A5FB9C5DFEF11838C9DD6DB,42151,9,12,3,35,45,1795
54126,54126,6F2B87364A5FB9C5DFEF11838C9DD6DB,42861,12,14,2,37,44,1894
54127,54127,6F2B87364A5FB9C5DFEF11838C9DD6DB,42151,17,18,1,35,45,1795
54128,54128,6F2B87364A5FB9C5DFEF11838C9DD6DB,42861,21,22,1,37,44,1894
54129,54129,079D8B606B741550F5C3182CF58367EA,11201,0,2,2,35,49,1799
54130,54130,079D8B606B741550F5C3182CF58367EA,40101,2,3,1,34,49,1749
54131,54131,079D8B606B741550F5C3182CF58367EA,11061,4,21,17,29,48,1498
54132,54132,9410BE71939CF3988D6550B9FE96B941,19744,0,13,13,6,43,343
54133,54133,9410BE71939CF3988D6550B9FE96B941,42801,15,17,2,40,49,2049
54134,54134,9410BE71939CF3988D6550B9FE96B941,10107,18,19,1,38,49,1949
54135,54135,9410BE71939CF3988D6550B9FE96B941,40341,20,22,2,23,49,1199
54136,54136,38EAD9C71E0631172BE43F523D61F0B8,42971,0,6,6,43,49,2199
54137,54137,38EAD9C71E0631172BE43F523D61F0B8,11381,7,9,2,30,47,1547
54138,54138,38EAD9C71E0631172BE43F523D61F0B8,42971,12,15,3,43,49,2199
54139,54139,38EAD9C71E0631172BE43F523D61F0B8,11381,16,18,2,30,47,1547
54140,54140,38EAD9C71E0631172BE43F523D61F0B8,42971,20,23,3,43,49,2199
54141,54141,026400BF77ED9426898CFF8EBE921A19,43021,0,16,16,16,43,843
54142,54142,026400BF77ED9426898CFF8EBE921A19,19621,18,19,1,5,46,296
54143,54143,026400BF77ED9426898CFF8EBE921A19,43021,21,23,2,16,43,843
54153,54153,AC5FFFC9828085332F197D373119C99F,42151,0,1,1,35,45,1795
54154,54154,AC5FFFC9828085332F197D373119C99F,42531,1,4,3,31,45,1595
54155,54155,AC5FFFC9828085332F197D373119C99F,12121,5,7,2,29,47,1497
54156,54156,AC5FFFC9828085332F197D373119C99F,12311,7,8,1,30,44,1544
54157,54157,AC5FFFC9828085332F197D373119C99F,42151,16,17,1,35,45,1795
54158,54158,AC5FFFC9828085332F197D373119C99F,42531,18,22,4,31,45,1595
54159,54159,1C60CB0F57E29CF26D99169B6CE00B11,11381,0,8,8,30,47,1547
54160,54160,1C60CB0F57E29CF26D99169B6CE00B11,10971,9,18,9,35,47,1797
54161,54161,1C60CB0F57E29CF26D99169B6CE00B11,11381,22,23,1,30,47,1547
54168,54168,C8236143E8B93D5FDE499177CF2B28F7,11381,0,5,5,30,47,1547
54169,54169,C8236143E8B93D5FDE499177CF2B28F7,12661,6,10,4,32,45,1645
54170,54170,C8236143E8B93D5FDE499177CF2B28F7,42861,12,14,2,37,44,1894
54171,54171,C8236143E8B93D5FDE499177CF2B28F7,11381,19,23,4,30,47,1547
54172,54172,7C975D0C88EA67D672EB56E3A3056887,13314,0,7,7,31,39,1589
54173,54173,7C975D0C88EA67D672EB56E3A3056887,13671,8,9,1,27,43,1393
54174,54174,7C975D0C88EA67D672EB56E3A3056887,13314,10,15,5,31,39,1589
54175,54175,7C975D0C88EA67D672EB56E3A3056887,13671,16,23,7,27,43,1393
54176,54176,079E309E76444CFA74DEE7817C8EB0DE,10521,0,6,6,41,47,2097
54177,54177,079E309E76444CFA74DEE7817C8EB0DE,42201,7,8,1,43,46,2196
54178,54178,079E309E76444CFA74DEE7817C8EB0DE,13341,8,11,3,44,45,2245
54179,54179,079E309E76444CFA74DEE7817C8EB0DE,10521,11,23,12,41,47,2097
54187,54187,00942A0487CC876B15BCB14B1A4E4E53,10841,2,16,14,37,47,1897
54188,54188,00942A0487CC876B15BCB14B1A4E4E53,15051,18,20,2,19,4,954
54189,54189,00942A0487CC876B15BCB14B1A4E4E53,16281,20,21,1,11,4,554
54190,54190,00942A0487CC876B15BCB14B1A4E4E53,15051,21,23,2,19,4,954
54191,54191,5ADA9660158083BA681D3EABE7C6BBBF,42864,0,4,4,38,44,1944
54192,54192,5ADA9660158083BA681D3EABE7C6BBBF,11381,8,10,2,30,47,1547
54193,54193,5ADA9660158083BA681D3EABE7C6BBBF,10601,14,16,2,39,47,1997
54194,54194,5ADA9660158083BA681D3EABE7C6BBBF,42864,17,18,1,38,44,1944
54195,54195,5ADA9660158083BA681D3EABE7C6BBBF,11261,19,22,3,36,46,1846
54196,54196,0A501EA010779C8F9EB8C2F8834C3F4F,10634,0,6,6,27,45,1395
54197,54197,0A501EA010779C8F9EB8C2F8834C3F4F,10301,9,10,1,31,45,1595
54198,54198,0A501EA010779C8F9EB8C2F8834C3F4F,10351,11,19,8,28,45,1445
54199,54199,0A501EA010779C8F9EB8C2F8834C3F4F,10301,19,21,2,31,45,1595
54200,54200,0A501EA010779C8F9EB8C2F8834C3F4F,10351,21,23,2,28,45,1445
54201,54201,108C83CF620370F6C02EF9A05DD6BE64,10161,0,7,7,35,49,1799
54202,54202,108C83CF620370F6C02EF9A05DD6BE64,12971,11,14,3,32,48,1648
54203,54203,108C83CF620370F6C02EF9A05DD6BE64,11861,15,18,3,32,47,1647
54204,54204,108C83CF620370F6C02EF9A05DD6BE64,42523,18,19,1,31,47,1597
54215,54215,8E7E1D3BA1392AF853A6068E181E9940,12971,0,8,8,32,48,1648
54216,54216,8E7E1D3BA1392AF853A6068E181E9940,10107,10,14,4,38,49,1949
54217,54217,8E7E1D3BA1392AF853A6068E181E9940,11201,19,20,1,35,49,1799
54221,54221,D5A1F589AD5A8A456E0D23A90489837D,43761,0,7,7,32,47,1647
54222,54222,D5A1F589AD5A8A456E0D23A90489837D,11231,10,18,8,37,49,1899
54223,54223,D5A1F589AD5A8A456E0D23A90489837D,10611,19,21,2,32,48,1648
54235,54235,1034142F75291CE14678BFA41218477C,11021,0,2,2,36,49,1849
54236,54236,1034142F75291CE14678BFA41218477C,40261,2,6,4,35,49,1799
54237,54237,1034142F75291CE14678BFA41218477C,13821,8,13,5,49,45,2495
54238,54238,1034142F75291CE14678BFA41218477C,11231,15,23,8,37,49,1899
54239,54239,3DE4A793313E3991BF5DCB3E800E4DF3,40637,0,7,7,36,47,1847
54240,54240,3DE4A793313E3991BF5DCB3E800E4DF3,11701,7,16,9,43,48,2198
54241,54241,3DE4A793313E3991BF5DCB3E800E4DF3,10841,19,20,1,37,47,1897
54242,54242,3DE4A793313E3991BF5DCB3E800E4DF3,10191,21,23,2,40,48,2048
54243,54243,F4465124506363C0A3C08E1CA11D8A74,11291,1,7,6,40,49,2049
54244,54244,F4465124506363C0A3C08E1CA11D8A74,13094,9,14,5,21,42,1092
54245,54245,F4465124506363C0A3C08E1CA11D8A74,11291,19,23,4,40,49,2049
54252,54252,14C205DF57BD0AA586E26BE4ED695846,42581,0,5,5,38,48,1948
54253,54253,14C205DF57BD0AA586E26BE4ED695846,11914,8,10,2,37,48,1898
54254,54254,14C205DF57BD0AA586E26BE4ED695846,42581,11,14,3,38,48,1948
54255,54255,14C205DF57BD0AA586E26BE4ED695846,11914,15,16,1,37,48,1898
54256,54256,14C205DF57BD0AA586E26BE4ED695846,42581,17,19,2,38,48,1948
54257,54257,D05F590EB3E7C6577AC4A27CE20A42C3,42581,0,8,8,38,48,1948
54258,54258,D05F590EB3E7C6577AC4A27CE20A42C3,11061,10,14,4,29,48,1498
54259,54259,D05F590EB3E7C6577AC4A27CE20A42C3,11381,16,18,2,30,47,1547
54260,54260,D05F590EB3E7C6577AC4A27CE20A42C3,42221,20,23,3,38,48,1948
54261,54261,247BAFEF3667203D5C3609ED1200A56F,11261,0,10,10,36,46,1846
54262,54262,247BAFEF3667203D5C3609ED1200A56F,10107,11,12,1,38,49,1949
54263,54263,247BAFEF3667203D5C3609ED1200A56F,11261,13,20,7,36,46,1846
54273,54273,FF54487E0B5C80FA4088AB1638FB8194,42581,1,8,7,38,48,1948
54274,54274,FF54487E0B5C80FA4088AB1638FB8194,11914,8,10,2,37,48,1898
54275,54275,FF54487E0B5C80FA4088AB1638FB8194,42581,12,13,1,38,48,1948
54276,54276,FF54487E0B5C80FA4088AB1638FB8194,11914,14,19,5,37,48,1898
54277,54277,FF54487E0B5C80FA4088AB1638FB8194,42581,21,22,1,38,48,1948
54278,54278,3C7D0C8254812826AB2314972D41B659,10251,1,9,8,35,47,1797
54279,54279,3C7D0C8254812826AB2314972D41B659,11875,14,15,1,30,46,1546
54280,54280,3C7D0C8254812826AB2314972D41B659,10251,18,22,4,35,47,1797
54281,54281,E748F2254AC2A75A1317C0ED54387A7E,42831,0,7,7,27,48,1398
54282,54282,E748F2254AC2A75A1317C0ED54387A7E,10381,8,11,3,31,49,1599
54283,54283,E748F2254AC2A75A1317C0ED54387A7E,11381,12,15,3,30,47,1547
54284,54284,E748F2254AC2A75A1317C0ED54387A7E,42831,16,23,7,27,48,1398
54291,54291,D96C351A2D3BF2CB9C84E8F01C9997B6,12641,0,1,1,10,43,543
54292,54292,D96C351A2D3BF2CB9C84E8F01C9997B6,19904,2,5,3,9,44,494
54293,54293,D96C351A2D3BF2CB9C84E8F01C9997B6,12641,6,11,5,10,43,543
54294,54294,D96C351A2D3BF2CB9C84E8F01C9997B6,19904,16,18,2,9,44,494
54295,54295,D96C351A2D3BF2CB9C84E8F01C9997B6,12641,21,22,1,10,43,543
54299,54299,3C02B5838EDEAB0B15A337805B269A42,10821,0,6,6,40,47,2047
54300,54300,3C02B5838EDEAB0B15A337805B269A42,42321,8,17,9,43,47,2197
54301,54301,3C02B5838EDEAB0B15A337805B269A42,43621,17,19,2,46,48,2348
54302,54302,3C02B5838EDEAB0B15A337805B269A42,13011,19,23,4,39,47,1997
54303,54303,359B9EE25E5F4F6D8F1DEACDAFD76D8C,19441,0,5,5,8,46,446
54304,54304,359B9EE25E5F4F6D8F1DEACDAFD76D8C,11171,9,10,1,33,48,1698
54305,54305,359B9EE25E5F4F6D8F1DEACDAFD76D8C,42041,13,23,10,10,47,547
54313,54313,09F64A9A641B3F2B92615DE97B925264,10351,0,7,7,28,45,1445
54314,54314,09F64A9A641B3F2B92615DE97B925264,10634,11,12,1,27,45,1395
54315,54315,09F64A9A641B3F2B92615DE97B925264,10351,15,17,2,28,45,1445
54316,54316,09F64A9A641B3F2B92615DE97B925264,10634,17,20,3,27,45,1395
54317,54317,09F64A9A641B3F2B92615DE97B925264,10351,20,21,1,28,45,1445
54318,54318,6C0E943C8B3CE3071E466B3888DE833C,12311,5,9,4,30,44,1544
54319,54319,6C0E943C8B3CE3071E466B3888DE833C,42531,9,17,8,31,45,1595
54320,54320,6C0E943C8B3CE3071E466B3888DE833C,19744,19,21,2,6,43,343
54321,54321,CB9FC3FE9195AF3F0A6A77B7B82B22F1,11591,0,7,7,36,49,1849
54322,54322,CB9FC3FE9195AF3F0A6A77B7B82B22F1,42471,9,10,1,35,49,1799
54323,54323,CB9FC3FE9195AF3F0A6A77B7B82B22F1,11591,12,15,3,36,49,1849
54324,54324,CB9FC3FE9195AF3F0A6A77B7B82B22F1,42471,18,20,2,35,49,1799
54325,54325,CB9FC3FE9195AF3F0A6A77B7B82B22F1,11591,20,23,3,36,49,1849
54326,54326,715F7A42E71CC3B03C35CCDCAA47978E,12641,6,9,3,10,43,543
54327,54327,715F7A42E71CC3B03C35CCDCAA47978E,12921,13,15,2,9,41,491
54328,54328,715F7A42E71CC3B03C35CCDCAA47978E,12641,17,19,2,10,43,543
54329,54329,715F7A42E71CC3B03C35CCDCAA47978E,19181,22,23,1,8,40,440
54333,54333,6C9433A56AF3E50117A8E10CA0F90994,11381,0,12,12,30,47,1547
54334,54334,6C9433A56AF3E50117A8E10CA0F90994,11061,15,19,4,29,48,1498
54335,54335,6C9433A56AF3E50117A8E10CA0F90994,40341,20,21,1,23,49,1199
54336,54336,6C9433A56AF3E50117A8E10CA0F90994,11061,22,23,1,29,48,1498
54337,54337,1BCF540AA9D716B57BD43D4508FAF0FE,42351,0,12,12,38,45,1945
54338,54338,1BCF540AA9D716B57BD43D4508FAF0FE,13911,13,17,4,39,46,1996
54339,54339,1BCF540AA9D716B57BD43D4508FAF0FE,43451,22,23,1,37,40,1890
54340,54340,59C9891991D18AB42F5CA2A676EAFEE0,42501,0,7,7,28,47,1447
54341,54341,59C9891991D18AB42F5CA2A676EAFEE0,19441,11,15,4,8,46,446
54342,54342,59C9891991D18AB42F5CA2A676EAFEE0,42501,20,22,2,28,47,1447
54343,54343,CFB5B91AB0CD7543884ADBE535AD19D6,43021,0,5,5,16,43,843
54344,54344,CFB5B91AB0CD7543884ADBE535AD19D6,12641,6,10,4,10,43,543
54345,54345,CFB5B91AB0CD7543884ADBE535AD19D6,43021,11,13,2,16,43,843
54346,54346,CFB5B91AB0CD7543884ADBE535AD19D6,12641,14,18,4,10,43,543
54347,54347,CFB5B91AB0CD7543884ADBE535AD19D6,12921,20,21,1,9,41,491
54348,54348,8E68BC970616C42168E33D01D32AB535,11074,2,3,1,37,47,1897
54349,54349,8E68BC970616C42168E33D01D32AB535,12514,5,8,3,38,47,1947
54350,54350,8E68BC970616C42168E33D01D32AB535,11074,8,9,1,37,47,1897
54351,54351,8E68BC970616C42168E33D01D32AB535,12514,12,13,1,38,47,1947
54352,54352,8E68BC970616C42168E33D01D32AB535,11074,17,23,6,37,47,1897
54363,54363,1B79EB886A5576DB94A20A87F2358771,43751,0,13,13,19,48,998
54364,54364,1B79EB886A5576DB94A20A87F2358771,42681,13,17,4,24,48,1248
54365,54365,1B79EB886A5576DB94A20A87F2358771,43751,18,23,5,19,48,998
54366,54366,C602CD62AD90C67588ABA5BE92DCA60E,11861,0,13,13,32,47,1647
54367,54367,C602CD62AD90C67588ABA5BE92DCA60E,10111,14,15,1,37,47,1897
54368,54368,C602CD62AD90C67588ABA5BE92DCA60E,10281,17,23,6,33,48,1698
54369,54369,EDA91A918395841EFF8489C3D0297A7E,10431,0,11,11,33,49,1699
54370,54370,EDA91A918395841EFF8489C3D0297A7E,11151,11,12,1,30,48,1548
54371,54371,EDA91A918395841EFF8489C3D0297A7E,10381,12,13,1,31,49,1599
54372,54372,EDA91A918395841EFF8489C3D0297A7E,40203,13,16,3,33,49,1699
54373,54373,EDA91A918395841EFF8489C3D0297A7E,12971,20,23,3,32,48,1648
54377,54377,7ECA73FB8DEF7DF78220D3155339952E,13961,0,6,6,42,48,2148
54378,54378,7ECA73FB8DEF7DF78220D3155339952E,43361,13,18,5,38,48,1948
54379,54379,7ECA73FB8DEF7DF78220D3155339952E,10107,19,20,1,38,49,1949
54380,54380,615EDF25A924323AEF1D5C61D1C3550F,11701,1,9,8,43,48,2198
54381,54381,615EDF25A924323AEF1D5C61D1C3550F,42161,10,14,4,36,47,1847
54382,54382,615EDF25A924323AEF1D5C61D1C3550F,42371,15,16,1,34,46,1746
54383,54383,615EDF25A924323AEF1D5C61D1C3550F,41393,20,23,3,43,49,2199
54384,54384,C1896697E8F9082F3C179E6CB902F84B,13141,0,5,5,23,30,1180
54385,54385,C1896697E8F9082F3C179E6CB902F84B,19101,6,7,1,17,29,879
54386,54386,C1896697E8F9082F3C179E6CB902F84B,49181,8,11,3,21,31,1081
54387,54387,C1896697E8F9082F3C179E6CB902F84B,12871,11,13,2,22,33,1133
54388,54388,C1896697E8F9082F3C179E6CB902F84B,49181,14,23,9,21,31,1081
54392,54392,292AD485DA7AE4FB3CFCA1190DC036DF,42151,0,4,4,35,45,1795
54393,54393,292AD485DA7AE4FB3CFCA1190DC036DF,12311,6,9,3,30,44,1544
54394,54394,292AD485DA7AE4FB3CFCA1190DC036DF,42151,10,14,4,35,45,1795
54395,54395,292AD485DA7AE4FB3CFCA1190DC036DF,12311,14,19,5,30,44,1544
54396,54396,292AD485DA7AE4FB3CFCA1190DC036DF,42151,21,23,2,35,45,1795
54404,54404,635A80E3E6F4F5FEBA564806AD979721,13221,1,10,9,40,47,2047
54405,54405,635A80E3E6F4F5FEBA564806AD979721,40951,12,17,5,36,49,1849
54406,54406,635A80E3E6F4F5FEBA564806AD979721,13091,19,21,2,20,42,1042
54407,54407,932F28ED1E9BB2590B7B80D830179638,12651,0,9,9,43,47,2197
54408,54408,932F28ED1E9BB2590B7B80D830179638,12083,14,15,1,36,49,1849
54409,54409,932F28ED1E9BB2590B7B80D830179638,12651,19,23,4,43,47,2197
54410,54410,C21368AEF2B1627E369E83844CDD61BF,42931,4,6,2,41,49,2099
54411,54411,C21368AEF2B1627E369E83844CDD61BF,42051,6,13,7,42,48,2148
54412,54412,C21368AEF2B1627E369E83844CDD61BF,10221,14,16,2,34,49,1749
54413,54413,C21368AEF2B1627E369E83844CDD61BF,10161,16,18,2,35,49,1799
54414,54414,C21368AEF2B1627E369E83844CDD61BF,10221,18,21,3,34,49,1749
54415,54415,0AA5586D6B12F9AD29AA699D8536DBEA,11231,0,8,8,37,49,1899
54416,54416,0AA5586D6B12F9AD29AA699D8536DBEA,41271,8,11,3,38,48,1948
54417,54417,0AA5586D6B12F9AD29AA699D8536DBEA,11231,12,14,2,37,49,1899
54418,54418,0AA5586D6B12F9AD29AA699D8536DBEA,11271,17,18,1,37,48,1898
54419,54419,0AA5586D6B12F9AD29AA699D8536DBEA,11231,19,23,4,37,49,1899
54423,54423,7158BB5FE54F024DF86B9682428D7D80,42581,0,4,4,38,48,1948
54424,54424,7158BB5FE54F024DF86B9682428D7D80,10471,4,7,3,37,48,1898
54425,54425,7158BB5FE54F024DF86B9682428D7D80,12514,10,12,2,38,47,1947
54426,54426,7158BB5FE54F024DF86B9682428D7D80,42581,12,15,3,38,48,1948
54427,54427,7158BB5FE54F024DF86B9682428D7D80,10471,18,19,1,37,48,1898
54428,54428,7158BB5FE54F024DF86B9682428D7D80,11811,19,21,2,38,49,1949
54429,54429,FB55B20B748C0A1CF26B4BE2B509424A,12761,0,6,6,25,40,1290
54430,54430,FB55B20B748C0A1CF26B4BE2B509424A,13671,8,17,9,27,43,1393
54431,54431,FB55B20B748C0A1CF26B4BE2B509424A,12731,22,23,1,22,40,1140
54435,54435,7DEB53A4993B41126407300DE16CC673,10491,0,13,13,33,48,1698
54436,54436,7DEB53A4993B41126407300DE16CC673,11231,13,15,2,37,49,1899
54437,54437,7DEB53A4993B41126407300DE16CC673,10491,16,23,7,33,48,1698
54441,54441,DBD9D6D8C3DE0DFB84D711D4984DE08F,42161,1,9,8,36,47,1847
54442,54442,DBD9D6D8C3DE0DFB84D711D4984DE08F,13511,11,13,2,34,48,1748
54443,54443,DBD9D6D8C3DE0DFB84D711D4984DE08F,42161,14,16,2,36,47,1847
54444,54444,DBD9D6D8C3DE0DFB84D711D4984DE08F,43731,17,21,4,34,47,1747
54445,54445,DBD9D6D8C3DE0DFB84D711D4984DE08F,42161,22,23,1,36,47,1847
54446,54446,19A29A27E6506D34C07A04E6E9F52A03,12491,1,3,2,36,43,1843
54447,54447,19A29A27E6506D34C07A04E6E9F52A03,42151,5,10,5,35,45,1795
54448,54448,19A29A27E6506D34C07A04E6E9F52A03,12491,10,12,2,36,43,1843
54449,54449,19A29A27E6506D34C07A04E6E9F52A03,42151,12,16,4,35,45,1795
54450,54450,19A29A27E6506D34C07A04E6E9F52A03,12491,18,20,2,36,43,1843
54451,54451,19A29A27E6506D34C07A04E6E9F52A03,42151,20,22,2,35,45,1795
54452,54452,BEE4B7ECEAE25C94FE4223BC44E1414A,42231,0,5,5,37,46,1896
54453,54453,BEE4B7ECEAE25C94FE4223BC44E1414A,13121,6,7,1,38,46,1946
54454,54454,BEE4B7ECEAE25C94FE4223BC44E1414A,42031,11,12,1,40,46,2046
54455,54455,BEE4B7ECEAE25C94FE4223BC44E1414A,10107,13,15,2,38,49,1949
54456,54456,BEE4B7ECEAE25C94FE4223BC44E1414A,13121,17,20,3,38,46,1946
54457,54457,BEE4B7ECEAE25C94FE4223BC44E1414A,42231,21,23,2,37,46,1896
54458,54458,69C05FC9345A5ACAE130EA88D72FC30C,13911,4,7,3,39,46,1996
54459,54459,69C05FC9345A5ACAE130EA88D72FC30C,42231,10,13,3,37,46,1896
54460,54460,69C05FC9345A5ACAE130EA88D72FC30C,11061,15,18,3,29,48,1498
54461,54461,440A5BC995406F5A39B97937FE6675EC,12641,0,1,1,10,43,543
54462,54462,440A5BC995406F5A39B97937FE6675EC,19744,1,3,2,6,43,343
54463,54463,440A5BC995406F5A39B97937FE6675EC,12641,4,5,1,10,43,543
54464,54464,440A5BC995406F5A39B97937FE6675EC,12921,6,17,11,9,41,491
54465,54465,440A5BC995406F5A39B97937FE6675EC,12641,21,22,1,10,43,543
54476,54476,D623986D271452579D7B3AD2B1D662DE,42281,3,4,1,40,48,2048
54477,54477,D623986D271452579D7B3AD2B1D662DE,42271,4,6,2,40,47,2047
54478,54478,D623986D271452579D7B3AD2B1D662DE,11806,6,7,1,41,48,2098
54479,54479,D623986D271452579D7B3AD2B1D662DE,13101,9,12,3,40,47,2047
54480,54480,D623986D271452579D7B3AD2B1D662DE,40833,15,17,2,41,47,2097
54481,54481,D623986D271452579D7B3AD2B1D662DE,13101,18,19,1,40,47,2047
54482,54482,71AB304A084EB4095E1F705C48CB0E23,11901,0,6,6,42,49,2149
54483,54483,71AB304A084EB4095E1F705C48CB0E23,11914,8,12,4,37,48,1898
54484,54484,71AB304A084EB4095E1F705C48CB0E23,42581,12,14,2,38,48,1948
54485,54485,71AB304A084EB4095E1F705C48CB0E23,11914,16,18,2,37,48,1898
54486,54486,71AB304A084EB4095E1F705C48CB0E23,11901,19,23,4,42,49,2149
54499,54499,4CA7727345FE5410FF8669E86CE37E32,19441,0,6,6,8,46,446
54500,54500,4CA7727345FE5410FF8669E86CE37E32,19024,8,9,1,9,45,495
54501,54501,4CA7727345FE5410FF8669E86CE37E32,12641,11,17,6,10,43,543
54502,54502,4CA7727345FE5410FF8669E86CE37E32,19021,19,21,2,10,45,545
54503,54503,B48BDBC51C417FE07973DBD16B1A4284,13314,0,8,8,31,39,1589
54504,54504,B48BDBC51C417FE07973DBD16B1A4284,13671,12,15,3,27,43,1393
54505,54505,B48BDBC51C417FE07973DBD16B1A4284,10711,16,19,3,29,46,1496
54522,54522,84BFDA5775B1A36CF113618F1669E73C,42521,0,6,6,31,47,1597
54523,54523,84BFDA5775B1A36CF113618F1669E73C,13651,8,9,1,30,47,1547
54524,54524,84BFDA5775B1A36CF113618F1669E73C,42521,11,14,3,31,47,1597
54525,54525,84BFDA5775B1A36CF113618F1669E73C,13651,15,18,3,30,47,1547
54526,54526,84BFDA5775B1A36CF113618F1669E73C,42521,19,23,4,31,47,1597
54537,54537,0576900C4D0FA559C4C3ACF6E9F4048D,43341,0,8,8,41,46,2096
54538,54538,0576900C4D0FA559C4C3ACF6E9F4048D,11811,9,10,1,38,49,1949
54539,54539,0576900C4D0FA559C4C3ACF6E9F4048D,12971,13,14,1,32,48,1648
54540,54540,0576900C4D0FA559C4C3ACF6E9F4048D,10401,15,17,2,33,49,1699
54541,54541,0576900C4D0FA559C4C3ACF6E9F4048D,43341,19,23,4,41,46,2096
54542,54542,05D9180EFEA6CBCA13C8D69235681D5B,42861,0,8,8,37,44,1894
54543,54543,05D9180EFEA6CBCA13C8D69235681D5B,12661,8,10,2,32,45,1645
54544,54544,05D9180EFEA6CBCA13C8D69235681D5B,42861,11,21,10,37,44,1894
54548,54548,ECBC886277109C0582E65AB313F27C1C,13314,0,7,7,31,39,1589
54549,54549,ECBC886277109C0582E65AB313F27C1C,12521,8,9,1,35,41,1791
54550,54550,ECBC886277109C0582E65AB313F27C1C,43451,10,11,1,37,40,1890
54551,54551,ECBC886277109C0582E65AB313F27C1C,12521,14,18,4,35,41,1791
54552,54552,ECBC886277109C0582E65AB313F27C1C,13314,19,23,4,31,39,1589
54553,54553,59843945AAE93CCE82D76071D50875F9,10634,0,4,4,27,45,1395
54554,54554,59843945AAE93CCE82D76071D50875F9,10351,4,5,1,28,45,1445
54555,54555,59843945AAE93CCE82D76071D50875F9,12661,7,9,2,32,45,1645
54556,54556,59843945AAE93CCE82D76071D50875F9,10634,12,13,1,27,45,1395
54557,54557,59843945AAE93CCE82D76071D50875F9,10351,17,19,2,28,45,1445
54558,54558,59843945AAE93CCE82D76071D50875F9,10634,21,23,2,27,45,1395
54563,54563,9578C0DC67ACE68D6F89F515DBD5C8C2,19031,0,4,4,1,42,92
54564,54564,9578C0DC67ACE68D6F89F515DBD5C8C2,12921,7,16,9,9,41,491
54565,54565,9578C0DC67ACE68D6F89F515DBD5C8C2,12641,16,17,1,10,43,543
54566,54566,9578C0DC67ACE68D6F89F515DBD5C8C2,12921,17,19,2,9,41,491
54567,54567,6164F469738A30A14CD373EB73D02471,11801,0,7,7,42,48,2148
54568,54568,6164F469738A30A14CD373EB73D02471,10401,8,10,2,33,49,1699
54569,54569,6164F469738A30A14CD373EB73D02471,11801,12,14,2,42,48,2148
54570,54570,6164F469738A30A14CD373EB73D02471,11211,14,18,4,34,49,1749
54571,54571,6164F469738A30A14CD373EB73D02471,10251,19,20,1,35,47,1797
54572,54572,6164F469738A30A14CD373EB73D02471,11801,22,23,1,42,48,2148
54573,54573,09F2470CEFA01CDC0086E19DB18E565B,43191,0,7,7,40,49,2049
54574,54574,09F2470CEFA01CDC0086E19DB18E565B,11381,12,13,1,30,47,1547
54575,54575,09F2470CEFA01CDC0086E19DB18E565B,43171,16,23,7,39,49,1999
54579,54579,BAC914D7581D8FE45C271EB14E4D335D,40445,0,6,6,30,48,1548
54580,54580,BAC914D7581D8FE45C271EB14E4D335D,11011,8,9,1,39,49,1999
54581,54581,BAC914D7581D8FE45C271EB14E4D335D,40445,11,13,2,30,48,1548
54582,54582,BAC914D7581D8FE45C271EB14E4D335D,10151,16,23,7,34,47,1747
54587,54587,BC3DA9BAF9B0A0C935A79D91ECBDA067,42381,1,2,1,39,41,1991
54588,54588,BC3DA9BAF9B0A0C935A79D91ECBDA067,43011,3,4,1,40,42,2042
54589,54589,BC3DA9BAF9B0A0C935A79D91ECBDA067,42151,6,11,5,35,45,1795
54590,54590,BC3DA9BAF9B0A0C935A79D91ECBDA067,11834,14,16,2,32,45,1645
54591,54591,BC3DA9BAF9B0A0C935A79D91ECBDA067,12491,18,19,1,36,43,1843
54592,54592,D9AF0A0BEFAFF72D2F6D04084706EE69,43051,0,5,5,46,45,2345
54593,54593,D9AF0A0BEFAFF72D2F6D04084706EE69,42071,6,10,4,31,49,1599
54594,54594,D9AF0A0BEFAFF72D2F6D04084706EE69,11151,10,11,1,30,48,1548
54595,54595,D9AF0A0BEFAFF72D2F6D04084706EE69,42071,14,17,3,31,49,1599
54596,54596,D9AF0A0BEFAFF72D2F6D04084706EE69,43051,19,23,4,46,45,2345
54600,54600,B880CF0C1C9F371F509CB9621D83EABA,11701,5,12,7,43,48,2198
54601,54601,B880CF0C1C9F371F509CB9621D83EABA,42971,13,15,2,43,49,2199
54602,54602,B880CF0C1C9F371F509CB9621D83EABA,10811,19,22,3,38,46,1946
54610,54610,0B308F8177D01C3A8D264E73918BD4FC,42321,1,13,12,43,47,2197
54611,54611,0B308F8177D01C3A8D264E73918BD4FC,11871,14,16,2,29,46,1496
54612,54612,0B308F8177D01C3A8D264E73918BD4FC,10801,17,23,6,42,47,2147
54613,54613,7B1EA863DBE8105F483F45D1E7AF50FA,11321,4,14,10,31,46,1596
54614,54614,7B1EA863DBE8105F483F45D1E7AF50FA,13771,18,19,1,21,45,1095
54615,54615,7B1EA863DBE8105F483F45D1E7AF50FA,12601,19,20,1,25,47,1297
54616,54616,26DECA4A496D5594EA57F7546CECA764,11021,0,1,1,36,49,1849
54617,54617,26DECA4A496D5594EA57F7546CECA764,10921,1,6,5,43,48,2198
54618,54618,26DECA4A496D5594EA57F7546CECA764,13351,7,19,12,48,48,2448
54619,54619,26DECA4A496D5594EA57F7546CECA764,11021,21,23,2,36,49,1849
54620,54620,CAF83309DC5164BDCFC4AF3B395E1D5C,10841,0,11,11,37,47,1897
54621,54621,CAF83309DC5164BDCFC4AF3B395E1D5C,11861,12,15,3,32,47,1647
54622,54622,CAF83309DC5164BDCFC4AF3B395E1D5C,11231,15,18,3,37,49,1899
54623,54623,CAF83309DC5164BDCFC4AF3B395E1D5C,10161,18,22,4,35,49,1799
54624,54624,4560AA6E9FF5488D13E472C26129D09F,42511,1,6,5,37,47,1897
54625,54625,4560AA6E9FF5488D13E472C26129D09F,12514,6,9,3,38,47,1947
54626,54626,4560AA6E9FF5488D13E472C26129D09F,42511,11,12,1,37,47,1897
54627,54627,4560AA6E9FF5488D13E472C26129D09F,12514,12,13,1,38,47,1947
54628,54628,4560AA6E9FF5488D13E472C26129D09F,10841,15,17,2,37,47,1897
54629,54629,4560AA6E9FF5488D13E472C26129D09F,12514,19,23,4,38,47,1947
54630,54630,7B7D796FA1F0073F7A8599ACB1FB2CF7,42623,0,2,2,22,49,1149
54631,54631,7B7D796FA1F0073F7A8599ACB1FB2CF7,42071,2,5,3,31,49,1599
54632,54632,7B7D796FA1F0073F7A8599ACB1FB2CF7,42121,20,21,1,26,49,1349
54633,54633,7B7D796FA1F0073F7A8599ACB1FB2CF7,42071,21,22,1,31,49,1599
54634,54634,A96E2E9F5CBC6618C051218D31E72217,10281,2,13,11,33,48,1698
54635,54635,A96E2E9F5CBC6618C051218D31E72217,19111,15,16,1,9,45,495
54636,54636,A96E2E9F5CBC6618C051218D31E72217,41591,17,18,1,34,49,1749
54649,54649,43AA632E12ABCA3F01D2033AFFAEDEF3,10151,0,7,7,34,47,1747
54650,54650,43AA632E12ABCA3F01D2033AFFAEDEF3,19744,9,11,2,6,43,343
54651,54651,43AA632E12ABCA3F01D2033AFFAEDEF3,10151,14,20,6,34,47,1747
54652,54652,F8A2EC8C9348BFB1362087B807B825C5,43971,0,7,7,30,48,1548
54653,54653,F8A2EC8C9348BFB1362087B807B825C5,10161,8,17,9,35,49,1799
54654,54654,F8A2EC8C9348BFB1362087B807B825C5,11061,19,20,1,29,48,1498
54658,54658,666C6474C859B034AE49BB5E91C01140,42633,0,7,7,42,46,2146
54659,54659,666C6474C859B034AE49BB5E91C01140,11771,8,15,7,39,49,1999
54660,54660,666C6474C859B034AE49BB5E91C01140,42633,19,23,4,42,46,2146
54661,54661,2E8B764495F8C75B1A6E74CD6E6D7095,42921,0,5,5,33,47,1697
54662,54662,2E8B764495F8C75B1A6E74CD6E6D7095,10292,10,11,1,30,47,1547
54663,54663,2E8B764495F8C75B1A6E74CD6E6D7095,42021,13,15,2,33,47,1697
54664,54664,2E8B764495F8C75B1A6E74CD6E6D7095,10292,15,16,1,30,47,1547
54665,54665,2E8B764495F8C75B1A6E74CD6E6D7095,42921,19,22,3,33,47,1697
54666,54666,B3EEDE261EE827DE5387BEC8B8493800,42541,0,1,1,25,47,1297
54667,54667,B3EEDE261EE827DE5387BEC8B8493800,11111,3,4,1,26,48,1348
54668,54668,B3EEDE261EE827DE5387BEC8B8493800,42541,5,6,1,25,47,1297
54669,54669,B3EEDE261EE827DE5387BEC8B8493800,11361,7,9,2,22,48,1148
54670,54670,B3EEDE261EE827DE5387BEC8B8493800,42541,12,13,1,25,47,1297
54671,54671,B3EEDE261EE827DE5387BEC8B8493800,11361,14,16,2,22,48,1148
54672,54672,B3EEDE261EE827DE5387BEC8B8493800,10171,19,21,2,26,47,1347
54673,54673,B62D1AC2C3A5BB577273E69E5CC84118,41721,1,9,8,39,48,1998
54674,54674,B62D1AC2C3A5BB577273E69E5CC84118,43281,13,14,1,37,48,1898
54675,54675,B62D1AC2C3A5BB577273E69E5CC84118,12971,16,17,1,32,48,1648
54676,54676,B62D1AC2C3A5BB577273E69E5CC84118,11701,21,22,1,43,48,2198
54680,54680,5449CBB6DC35AD4CB937DE3654BC5A77,10161,0,16,16,35,49,1799
54681,54681,5449CBB6DC35AD4CB937DE3654BC5A77,40331,16,17,1,30,47,1547
54682,54682,5449CBB6DC35AD4CB937DE3654BC5A77,11861,20,23,3,32,47,1647
54683,54683,F3AB0FBBFC4C22E22895C854430E62BC,42351,0,7,7,38,45,1945
54684,54684,F3AB0FBBFC4C22E22895C854430E62BC,11261,9,10,1,36,46,1846
54685,54685,F3AB0FBBFC4C22E22895C854430E62BC,42351,12,13,1,38,45,1945
54686,54686,F3AB0FBBFC4C22E22895C854430E62BC,43341,14,15,1,41,46,2096
54687,54687,F3AB0FBBFC4C22E22895C854430E62BC,42351,19,23,4,38,45,1945
54694,54694,6AD981E757B177FB5B64F1D1D2EAA27F,13511,0,2,2,34,48,1748
54695,54695,6AD981E757B177FB5B64F1D1D2EAA27F,12651,3,7,4,43,47,2197
54696,54696,6AD981E757B177FB5B64F1D1D2EAA27F,42961,10,12,2,35,49,1799
54697,54697,6AD981E757B177FB5B64F1D1D2EAA27F,10901,14,16,2,35,48,1798
54698,54698,6AD981E757B177FB5B64F1D1D2EAA27F,11201,17,18,1,35,49,1799
54699,54699,6AD981E757B177FB5B64F1D1D2EAA27F,11875,22,23,1,30,46,1546
54700,54700,C69DB833C5C233DF7718BBF8E4312DAA,42871,1,4,3,30,45,1545
54701,54701,C69DB833C5C233DF7718BBF8E4312DAA,42021,5,8,3,33,47,1697
54702,54702,C69DB833C5C233DF7718BBF8E4312DAA,11875,11,12,1,30,46,1546
54703,54703,C69DB833C5C233DF7718BBF8E4312DAA,10301,13,14,1,31,45,1595
54704,54704,C69DB833C5C233DF7718BBF8E4312DAA,11875,15,22,7,30,46,1546
54705,54705,27E500FC51F8345CCFF064DE58D1388B,12521,0,14,14,35,41,1791
54706,54706,27E500FC51F8345CCFF064DE58D1388B,10601,15,18,3,39,47,1997
54707,54707,27E500FC51F8345CCFF064DE58D1388B,11481,18,20,2,41,48,2098
54708,54708,27E500FC51F8345CCFF064DE58D1388B,13011,22,23,1,39,47,1997
54713,54713,7F683BD350227B09C7ECC1328A0C4739,10271,2,5,3,37,46,1896
54714,54714,7F683BD350227B09C7ECC1328A0C4739,13711,6,8,2,38,46,1946
54715,54715,7F683BD350227B09C7ECC1328A0C4739,42011,10,13,3,36,46,1846
54716,54716,7F683BD350227B09C7ECC1328A0C4739,10271,16,17,1,37,46,1896
54717,54717,7F683BD350227B09C7ECC1328A0C4739,13711,20,22,2,38,46,1946
54721,54721,29A3C9E428978BBE2ECF8EB615AF2DD1,10924,0,6,6,43,49,2199
54722,54722,29A3C9E428978BBE2ECF8EB615AF2DD1,40381,8,12,4,32,46,1646
54723,54723,29A3C9E428978BBE2ECF8EB615AF2DD1,11831,15,20,5,32,45,1645
54724,54724,29A3C9E428978BBE2ECF8EB615AF2DD1,40381,21,22,1,32,46,1646
54725,54725,2772001BC3F7379DE82D552064F2ABBB,12871,0,7,7,22,33,1133
54726,54726,2772001BC3F7379DE82D552064F2ABBB,19281,8,19,11,16,32,832
54727,54727,2772001BC3F7379DE82D552064F2ABBB,12874,21,22,1,20,34,1034
54728,54728,494B444F0049F1B11EE9933CF89C0C3A,42161,3,7,4,36,47,1847
54729,54729,494B444F0049F1B11EE9933CF89C0C3A,13341,10,18,8,44,45,2245
54730,54730,494B444F0049F1B11EE9933CF89C0C3A,11231,20,21,1,37,49,1899
54735,54735,91284BBE72A4661BF1E53E3FAFD2E3D8,10292,0,9,9,30,47,1547
54736,54736,91284BBE72A4661BF1E53E3FAFD2E3D8,42523,10,11,1,31,47,1597
54737,54737,91284BBE72A4661BF1E53E3FAFD2E3D8,43761,13,14,1,32,47,1647
54738,54738,91284BBE72A4661BF1E53E3FAFD2E3D8,13651,18,21,3,30,47,1547
54739,54739,91284BBE72A4661BF1E53E3FAFD2E3D8,42523,22,23,1,31,47,1597
54740,54740,966592CD48E24DD17B5B9C8B94D59F8F,11954,0,6,6,32,49,1649
54741,54741,966592CD48E24DD17B5B9C8B94D59F8F,42623,7,8,1,22,49,1149
54742,54742,966592CD48E24DD17B5B9C8B94D59F8F,19741,14,16,2,5,44,294
54743,54743,966592CD48E24DD17B5B9C8B94D59F8F,12381,18,23,5,32,48,1648
54744,54744,8671664FCEA72D44791A077CF27C82B3,12921,4,6,2,9,41,491
54745,54745,8671664FCEA72D44791A077CF27C82B3,12641,6,7,1,10,43,543
54746,54746,8671664FCEA72D44791A077CF27C82B3,12921,7,17,10,9,41,491
54747,54747,8671664FCEA72D44791A077CF27C82B3,12641,17,18,1,10,43,543
54748,54748,8671664FCEA72D44791A077CF27C82B3,12921,18,23,5,9,41,491
54749,54749,AF57FD742700B6DD506E3D60F4DB6DD5,11631,0,8,8,12,49,649
54750,54750,AF57FD742700B6DD506E3D60F4DB6DD5,11481,9,11,2,41,48,2098
54751,54751,AF57FD742700B6DD506E3D60F4DB6DD5,13471,12,14,2,47,49,2399
54752,54752,AF57FD742700B6DD506E3D60F4DB6DD5,11481,15,17,2,41,48,2098
54753,54753,AF57FD742700B6DD506E3D60F4DB6DD5,11471,19,21,2,12,48,648
54757,54757,64670A0AA34CA99040A17830BE4514C3,10951,0,11,11,29,48,1498
54758,54758,64670A0AA34CA99040A17830BE4514C3,11261,14,15,1,36,46,1846
54759,54759,64670A0AA34CA99040A17830BE4514C3,11381,18,20,2,30,47,1547
54760,54760,58B59FD7AA0814C0C6E50CF40955E7AA,10634,1,3,2,27,45,1395
54761,54761,58B59FD7AA0814C0C6E50CF40955E7AA,12601,6,9,3,25,47,1297
54762,54762,58B59FD7AA0814C0C6E50CF40955E7AA,10634,13,15,2,27,45,1395
54763,54763,58B59FD7AA0814C0C6E50CF40955E7AA,12601,18,20,2,25,47,1297
54764,54764,58B59FD7AA0814C0C6E50CF40955E7AA,10634,21,22,1,27,45,1395
54765,54765,400659CE2E6F8BFF6D95D6F52F73DF5B,42921,0,5,5,33,47,1697
54766,54766,400659CE2E6F8BFF6D95D6F52F73DF5B,11861,6,11,5,32,47,1647
54767,54767,400659CE2E6F8BFF6D95D6F52F73DF5B,42921,12,13,1,33,47,1697
54768,54768,400659CE2E6F8BFF6D95D6F52F73DF5B,11861,13,19,6,32,47,1647
54769,54769,400659CE2E6F8BFF6D95D6F52F73DF5B,42921,19,20,1,33,47,1697
54770,54770,5D3AB87CDE152EA5E956E4DDC06AC59B,40171,0,1,1,38,48,1948
54771,54771,5D3AB87CDE152EA5E956E4DDC06AC59B,11811,3,4,1,38,49,1949
54772,54772,5D3AB87CDE152EA5E956E4DDC06AC59B,40171,4,12,8,38,48,1948
54773,54773,5D3AB87CDE152EA5E956E4DDC06AC59B,10471,12,13,1,37,48,1898
54774,54774,5D3AB87CDE152EA5E956E4DDC06AC59B,42581,13,16,3,38,48,1948
54775,54775,5D3AB87CDE152EA5E956E4DDC06AC59B,10471,16,19,3,37,48,1898
54776,54776,8AC8B1E6CB950C4620C9ADD9BF2E2AE1,42071,0,1,1,31,49,1599
54777,54777,8AC8B1E6CB950C4620C9ADD9BF2E2AE1,42121,5,8,3,26,49,1349
54778,54778,8AC8B1E6CB950C4620C9ADD9BF2E2AE1,42071,9,13,4,31,49,1599
54779,54779,8AC8B1E6CB950C4620C9ADD9BF2E2AE1,10451,18,19,1,25,48,1298
54780,54780,8AC8B1E6CB950C4620C9ADD9BF2E2AE1,42071,22,23,1,31,49,1599
54784,54784,C35D795DA33BE0311413852FD4760F3A,11261,2,4,2,36,46,1846
54785,54785,C35D795DA33BE0311413852FD4760F3A,42861,8,9,1,37,44,1894
54786,54786,C35D795DA33BE0311413852FD4760F3A,11261,10,17,7,36,46,1846
54787,54787,C35D795DA33BE0311413852FD4760F3A,10531,19,20,1,34,46,1746
54788,54788,C35D795DA33BE0311413852FD4760F3A,11261,21,23,2,36,46,1846
54799,54799,01BC501351E3F1FC7B6E95606FC74A3B,40343,0,14,14,24,49,1249
54800,54800,01BC501351E3F1FC7B6E95606FC74A3B,13841,15,16,1,40,46,2046
54801,54801,01BC501351E3F1FC7B6E95606FC74A3B,40343,21,23,2,24,49,1249
54802,54802,FD87D699F0A11DF69DB30F8CF7FCD560,43234,0,2,2,37,49,1899
54803,54803,FD87D699F0A11DF69DB30F8CF7FCD560,10591,3,7,4,39,48,1998
54804,54804,FD87D699F0A11DF69DB30F8CF7FCD560,11074,7,13,6,37,47,1897
54805,54805,FD87D699F0A11DF69DB30F8CF7FCD560,42221,14,16,2,38,48,1948
54806,54806,FD87D699F0A11DF69DB30F8CF7FCD560,11074,17,23,6,37,47,1897
54807,54807,DFBD81ACA1F50E6A22C2192D17AE2751,13314,0,8,8,31,39,1589
54808,54808,DFBD81ACA1F50E6A22C2192D17AE2751,12521,12,13,1,35,41,1791
54809,54809,DFBD81ACA1F50E6A22C2192D17AE2751,42511,18,20,2,37,47,1897
54810,54810,ACC988BC7C7C8AB1A0A907CFDFB620E6,10451,0,14,14,25,48,1298
54811,54811,ACC988BC7C7C8AB1A0A907CFDFB620E6,43181,14,15,1,39,48,1998
54812,54812,ACC988BC7C7C8AB1A0A907CFDFB620E6,10221,18,20,2,34,49,1749
54816,54816,C0C88AF8BA6186FF52C981D818FF206C,10721,0,13,13,31,48,1598
54817,54817,C0C88AF8BA6186FF52C981D818FF206C,42461,13,16,3,45,47,2297
54818,54818,C0C88AF8BA6186FF52C981D818FF206C,10721,20,23,3,31,48,1598
54819,54819,10D0530C7CD39976124A84C803ED4BB8,11231,0,8,8,37,49,1899
54820,54820,10D0530C7CD39976124A84C803ED4BB8,42381,11,12,1,39,41,1991
54821,54821,10D0530C7CD39976124A84C803ED4BB8,12083,17,18,1,36,49,1849
54826,54826,17B310C5C0CD98D91D2EAE008E1E6775,42491,0,12,12,32,46,1646
54827,54827,17B310C5C0CD98D91D2EAE008E1E6775,11753,13,15,2,35,48,1798
54828,54828,17B310C5C0CD98D91D2EAE008E1E6775,42491,15,19,4,32,46,1646
54832,54832,1A71FA18AA428C4DDAD1FCB8BD6DCCEA,42281,0,7,7,40,48,2048
54833,54833,1A71FA18AA428C4DDAD1FCB8BD6DCCEA,43581,8,9,1,33,48,1698
54834,54834,1A71FA18AA428C4DDAD1FCB8BD6DCCEA,10401,13,14,1,33,49,1699
54835,54835,1A71FA18AA428C4DDAD1FCB8BD6DCCEA,11211,15,16,1,34,49,1749
54836,54836,1A71FA18AA428C4DDAD1FCB8BD6DCCEA,10471,20,21,1,37,48,1898
54837,54837,1A71FA18AA428C4DDAD1FCB8BD6DCCEA,42281,21,23,2,40,48,2048
54842,54842,EF7A20DA8B1B5B9AEB04342FCDE03590,42271,0,2,2,40,47,2047
54843,54843,EF7A20DA8B1B5B9AEB04342FCDE03590,11806,3,4,1,41,48,2098
54844,54844,EF7A20DA8B1B5B9AEB04342FCDE03590,42271,5,15,10,40,47,2047
54845,54845,EF7A20DA8B1B5B9AEB04342FCDE03590,12514,15,16,1,38,47,1947
54846,54846,EF7A20DA8B1B5B9AEB04342FCDE03590,42271,17,19,2,40,47,2047
54847,54847,25C8E48F46CE3AC7F14FD7208B98656B,13651,1,6,5,30,47,1547
54848,54848,25C8E48F46CE3AC7F14FD7208B98656B,12601,10,11,1,25,47,1297
54849,54849,25C8E48F46CE3AC7F14FD7208B98656B,13651,13,14,1,30,47,1547
54850,54850,25C8E48F46CE3AC7F14FD7208B98656B,12121,15,21,6,29,47,1497
54851,54851,25C8E48F46CE3AC7F14FD7208B98656B,13651,21,22,1,30,47,1547
54855,54855,76A50127C9E8E4C112EB1B61B027BCBF,11631,2,4,2,12,49,649
54856,54856,76A50127C9E8E4C112EB1B61B027BCBF,19441,5,9,4,8,46,446
54857,54857,76A50127C9E8E4C112EB1B61B027BCBF,11631,12,21,9,12,49,649
54858,54858,BF2293DC6BB562420437DEEB375D8B3A,43361,0,1,1,38,48,1948
54859,54859,BF2293DC6BB562420437DEEB375D8B3A,10191,1,7,6,40,48,2048
54860,54860,BF2293DC6BB562420437DEEB375D8B3A,10221,8,15,7,34,49,1749
54861,54861,BF2293DC6BB562420437DEEB375D8B3A,12401,20,23,3,39,49,1999
54872,54872,4D51687D61553B1D3F4518B02D97DABB,12514,1,2,1,38,47,1947
54873,54873,4D51687D61553B1D3F4518B02D97DABB,10601,4,6,2,39,47,1997
54874,54874,4D51687D61553B1D3F4518B02D97DABB,12514,6,8,2,38,47,1947
54875,54875,4D51687D61553B1D3F4518B02D97DABB,42511,10,19,9,37,47,1897
54876,54876,4D51687D61553B1D3F4518B02D97DABB,42471,21,23,2,35,49,1799
54880,54880,8C93E9687A717AEFB87364B357E16B82,10811,1,8,7,38,46,1946
54881,54881,8C93E9687A717AEFB87364B357E16B82,12121,9,17,8,29,47,1497
54882,54882,8C93E9687A717AEFB87364B357E16B82,10331,18,19,1,39,46,1996
54883,54883,DAD4C4CCB9D717CA848AB20853599079,11101,9,15,6,18,48,948
54884,54884,DAD4C4CCB9D717CA848AB20853599079,12581,19,21,2,24,48,1248
54885,54885,DAD4C4CCB9D717CA848AB20853599079,42521,22,23,1,31,47,1597
54898,54898,E6E1B072EE7202225510F5B63E9E6AA7,42221,0,5,5,38,48,1948
54899,54899,E6E1B072EE7202225510F5B63E9E6AA7,42121,8,17,9,26,49,1349
54900,54900,E6E1B072EE7202225510F5B63E9E6AA7,11921,19,21,2,38,48,1948
54901,54901,582FCEF67ED9C80E5B2E8667690F61FB,42221,0,2,2,38,48,1948
54902,54902,582FCEF67ED9C80E5B2E8667690F61FB,13101,3,6,3,40,47,2047
54903,54903,582FCEF67ED9C80E5B2E8667690F61FB,42401,7,12,5,36,47,1847
54904,54904,582FCEF67ED9C80E5B2E8667690F61FB,42221,12,16,4,38,48,1948
54905,54905,582FCEF67ED9C80E5B2E8667690F61FB,42401,17,22,5,36,47,1847
54909,54909,BB84F849A5F794F98ED9E8F635142ED5,11914,2,3,1,37,48,1898
54910,54910,BB84F849A5F794F98ED9E8F635142ED5,43181,3,4,1,39,48,1998
54911,54911,BB84F849A5F794F98ED9E8F635142ED5,10471,7,12,5,37,48,1898
54912,54912,BB84F849A5F794F98ED9E8F635142ED5,40171,15,16,1,38,48,1948
54913,54913,BB84F849A5F794F98ED9E8F635142ED5,11914,19,22,3,37,48,1898
54918,54918,42BD94BB5A98349E1FD0E20EE8F9EC76,13911,0,10,10,39,46,1996
54919,54919,42BD94BB5A98349E1FD0E20EE8F9EC76,42231,10,12,2,37,46,1896
54920,54920,42BD94BB5A98349E1FD0E20EE8F9EC76,11061,15,18,3,29,48,1498
54925,54925,59005BB79B2E7B70648A241EC3A9AAB6,12661,0,7,7,32,45,1645
54926,54926,59005BB79B2E7B70648A241EC3A9AAB6,13671,8,10,2,27,43,1393
54927,54927,59005BB79B2E7B70648A241EC3A9AAB6,12731,11,13,2,22,40,1140
54928,54928,59005BB79B2E7B70648A241EC3A9AAB6,42151,14,16,2,35,45,1795
54929,54929,59005BB79B2E7B70648A241EC3A9AAB6,11151,18,20,2,30,48,1548
54930,54930,59005BB79B2E7B70648A241EC3A9AAB6,40925,22,23,1,35,49,1799
54931,54931,2C3E302154C3535ED9B8593F94CE546C,16251,0,1,1,15,13,763
54932,54932,2C3E302154C3535ED9B8593F94CE546C,15145,2,21,19,22,9,1109
54933,54933,2C3E302154C3535ED9B8593F94CE546C,16251,22,23,1,15,13,763
54952,54952,16D740AE27D92BE968DE244652195181,13671,0,1,1,27,43,1393
54953,54953,16D740AE27D92BE968DE244652195181,12761,2,3,1,25,40,1290
54954,54954,16D740AE27D92BE968DE244652195181,13671,6,13,7,27,43,1393
54955,54955,16D740AE27D92BE968DE244652195181,12731,14,15,1,22,40,1140
54956,54956,16D740AE27D92BE968DE244652195181,13671,16,19,3,27,43,1393
54957,54957,DC9866094212A637CCAC17CF01FE4B5F,42861,0,5,5,37,44,1894
54958,54958,DC9866094212A637CCAC17CF01FE4B5F,11261,6,11,5,36,46,1846
54959,54959,DC9866094212A637CCAC17CF01FE4B5F,13231,12,13,1,39,46,1996
54960,54960,DC9866094212A637CCAC17CF01FE4B5F,11261,13,17,4,36,46,1846
54961,54961,DC9866094212A637CCAC17CF01FE4B5F,42861,19,23,4,37,44,1894
54962,54962,A06465C33822DBAACCFCA67CF792360D,10295,1,4,3,30,47,1547
54963,54963,A06465C33822DBAACCFCA67CF792360D,42523,6,7,1,31,47,1597
54964,54964,A06465C33822DBAACCFCA67CF792360D,10295,8,10,2,30,47,1547
54965,54965,A06465C33822DBAACCFCA67CF792360D,42523,15,16,1,31,47,1597
54966,54966,A06465C33822DBAACCFCA67CF792360D,10295,21,23,2,30,47,1547
54967,54967,48F3F63855BA656832E98E96D77F712D,10731,0,7,7,33,47,1697
54968,54968,48F3F63855BA656832E98E96D77F712D,10281,8,10,2,33,48,1698
54969,54969,48F3F63855BA656832E98E96D77F712D,40833,13,15,2,41,47,2097
54970,54970,48F3F63855BA656832E98E96D77F712D,10731,17,23,6,33,47,1697
54971,54971,1D8BB04BA223F58C0F7219E50B383AFD,11061,0,6,6,29,48,1498
54972,54972,1D8BB04BA223F58C0F7219E50B383AFD,40441,6,10,4,30,48,1548
54973,54973,1D8BB04BA223F58C0F7219E50B383AFD,11794,12,17,5,38,49,1949
54974,54974,1D8BB04BA223F58C0F7219E50B383AFD,11061,18,22,4,29,48,1498
54978,54978,46BE31A2AEB2FC2C2298BE3144942D7D,11861,0,6,6,32,47,1647
54979,54979,46BE31A2AEB2FC2C2298BE3144942D7D,10161,8,18,10,35,49,1799
54980,54980,46BE31A2AEB2FC2C2298BE3144942D7D,11861,18,23,5,32,47,1647
54981,54981,024AB2D90319DF57F94996854D076E3D,13271,0,8,8,41,47,2097
54982,54982,024AB2D90319DF57F94996854D076E3D,10161,8,14,6,35,49,1799
54983,54983,024AB2D90319DF57F94996854D076E3D,13561,16,18,2,37,49,1899
54984,54984,024AB2D90319DF57F94996854D076E3D,13271,21,23,2,41,47,2097
54988,54988,9111D45CF0ACFF1F78F6B2A96D11CE9D,43361,0,2,2,38,48,1948
54989,54989,9111D45CF0ACFF1F78F6B2A96D11CE9D,10661,12,13,1,37,49,1899
54990,54990,9111D45CF0ACFF1F78F6B2A96D11CE9D,43361,19,20,1,38,48,1948
54991,54991,9111D45CF0ACFF1F78F6B2A96D11CE9D,11211,22,23,1,34,49,1749
54992,54992,03D70F9FF806551B6E0567FCC1F6C737,43061,0,6,6,43,46,2196
54993,54993,03D70F9FF806551B6E0567FCC1F6C737,10191,7,8,1,40,48,2048
54994,54994,03D70F9FF806551B6E0567FCC1F6C737,13941,11,16,5,41,47,2097
54995,54995,03D70F9FF806551B6E0567FCC1F6C737,11001,16,18,2,42,47,2147
54996,54996,FDF489E266E934E624378B703D9C646F,12083,0,8,8,36,49,1849
54997,54997,FDF489E266E934E624378B703D9C646F,42381,11,12,1,39,41,1991
54998,54998,FDF489E266E934E624378B703D9C646F,11351,15,23,8,36,48,1848
54999,54999,4E4FA3262DF5F7B6F1852C92067A0539,11875,0,6,6,30,46,1546
55000,55000,4E4FA3262DF5F7B6F1852C92067A0539,12311,8,9,1,30,44,1544
55001,55001,4E4FA3262DF5F7B6F1852C92067A0539,11875,12,13,1,30,46,1546
55002,55002,4E4FA3262DF5F7B6F1852C92067A0539,12311,14,15,1,30,44,1544
55003,55003,4E4FA3262DF5F7B6F1852C92067A0539,11875,19,23,4,30,46,1546
55004,55004,294FB4B8E5D6BF128BF9CA2E5243FA86,10161,0,7,7,35,49,1799
55005,55005,294FB4B8E5D6BF128BF9CA2E5243FA86,11021,9,10,1,36,49,1849
55006,55006,294FB4B8E5D6BF128BF9CA2E5243FA86,11211,10,12,2,34,49,1749
55007,55007,294FB4B8E5D6BF128BF9CA2E5243FA86,11021,13,14,1,36,49,1849
55008,55008,294FB4B8E5D6BF128BF9CA2E5243FA86,10161,18,22,4,35,49,1799
55009,55009,C8D89F699172ABABF4DD3B2925BC4A8C,42071,0,7,7,31,49,1599
55010,55010,C8D89F699172ABABF4DD3B2925BC4A8C,11061,8,9,1,29,48,1498
55011,55011,C8D89F699172ABABF4DD3B2925BC4A8C,42071,12,13,1,31,49,1599
55012,55012,C8D89F699172ABABF4DD3B2925BC4A8C,42261,15,16,1,25,49,1299
55013,55013,C8D89F699172ABABF4DD3B2925BC4A8C,42071,16,22,6,31,49,1599
55021,55021,7179E8D23C9EF0FE56A034B0F52DF3EB,42623,2,7,5,22,49,1149
55022,55022,7179E8D23C9EF0FE56A034B0F52DF3EB,10951,8,13,5,29,48,1498
55023,55023,7179E8D23C9EF0FE56A034B0F52DF3EB,42071,15,16,1,31,49,1599
55024,55024,7179E8D23C9EF0FE56A034B0F52DF3EB,42623,21,22,1,22,49,1149
55037,55037,7B7EC78C492826B1A2F98257774A5C01,11061,3,9,6,29,48,1498
55038,55038,7B7EC78C492826B1A2F98257774A5C01,40171,12,13,1,38,48,1948
55039,55039,7B7EC78C492826B1A2F98257774A5C01,12481,14,23,9,37,49,1899
55040,55040,3D82C8ACD484F134DA9EE33AF86E65F6,15021,1,13,12,46,18,2318
55041,55041,3D82C8ACD484F134DA9EE33AF86E65F6,12881,14,15,1,47,22,2372
55042,55042,3D82C8ACD484F134DA9EE33AF86E65F6,15021,16,18,2,46,18,2318
55043,55043,3D82C8ACD484F134DA9EE33AF86E65F6,12881,19,21,2,47,22,2372
55044,55044,F9B50F8C0BC548F341BD45D3142A9731,42471,0,3,3,35,49,1799
55045,55045,F9B50F8C0BC548F341BD45D3142A9731,43671,5,9,4,35,48,1798
55046,55046,F9B50F8C0BC548F341BD45D3142A9731,43361,11,13,2,38,48,1948
55047,55047,F9B50F8C0BC548F341BD45D3142A9731,11751,13,16,3,35,48,1798
55048,55048,F9B50F8C0BC548F341BD45D3142A9731,40171,16,18,2,38,48,1948
55049,55049,F9B50F8C0BC548F341BD45D3142A9731,42961,18,19,1,35,49,1799
55050,55050,F9B50F8C0BC548F341BD45D3142A9731,12381,21,22,1,32,48,1648
55051,55051,47844E829FCB05D6E87386BF9A1380C3,13711,1,8,7,38,46,1946
55052,55052,47844E829FCB05D6E87386BF9A1380C3,11021,8,10,2,36,49,1849
55053,55053,47844E829FCB05D6E87386BF9A1380C3,42011,12,13,1,36,46,1846
55054,55054,47844E829FCB05D6E87386BF9A1380C3,10121,14,15,1,36,49,1849
55055,55055,47844E829FCB05D6E87386BF9A1380C3,42011,18,23,5,36,46,1846
55059,55059,ABA306CA497592C3E24A3217BA4072DF,43041,3,6,3,41,46,2096
55060,55060,ABA306CA497592C3E24A3217BA4072DF,42221,8,13,5,38,48,1948
55061,55061,ABA306CA497592C3E24A3217BA4072DF,43041,18,23,5,41,46,2096
55062,55062,ED54D9A6448FF51B585DC3225EB6058D,12921,0,8,8,9,41,491
55063,55063,ED54D9A6448FF51B585DC3225EB6058D,43644,12,13,1,14,38,738
55064,55064,ED54D9A6448FF51B585DC3225EB6058D,19181,16,17,1,8,40,440
55065,55065,ED54D9A6448FF51B585DC3225EB6058D,12921,19,21,2,9,41,491
55066,55066,D570B4D48387176D4477A1F66EC489C7,43731,0,6,6,34,47,1747
55067,55067,D570B4D48387176D4477A1F66EC489C7,42161,9,11,2,36,47,1847
55068,55068,D570B4D48387176D4477A1F66EC489C7,10251,13,15,2,35,47,1797
55069,55069,D570B4D48387176D4477A1F66EC489C7,11651,18,20,2,33,47,1697
55070,55070,D570B4D48387176D4477A1F66EC489C7,10251,21,23,2,35,47,1797
55074,55074,EA84EDCB7C9475F6273168934FDD6476,19441,1,8,7,8,46,446
55075,55075,EA84EDCB7C9475F6273168934FDD6476,11571,8,10,2,13,46,696
55076,55076,EA84EDCB7C9475F6273168934FDD6476,19441,12,14,2,8,46,446
55077,55077,EA84EDCB7C9475F6273168934FDD6476,11571,16,18,2,13,46,696
55078,55078,EA84EDCB7C9475F6273168934FDD6476,19021,18,19,1,10,45,545
55079,55079,EA84EDCB7C9475F6273168934FDD6476,19441,21,22,1,8,46,446
55080,55080,D7349708A10855AEF98FEB8D22C33E59,13271,0,7,7,41,47,2097
55081,55081,D7349708A10855AEF98FEB8D22C33E59,12083,10,11,1,36,49,1849
55082,55082,D7349708A10855AEF98FEB8D22C33E59,11231,12,18,6,37,49,1899
55083,55083,D7349708A10855AEF98FEB8D22C33E59,13271,19,23,4,41,47,2097
55087,55087,525655B30753832E11A6455806FEB5D9,40094,0,7,7,29,48,1498
55088,55088,525655B30753832E11A6455806FEB5D9,13711,7,18,11,38,46,1946
55089,55089,525655B30753832E11A6455806FEB5D9,40094,18,19,1,29,48,1498
55094,55094,D2447B00F936825DB3923827FC212A13,10221,9,10,1,34,49,1749
55095,55095,D2447B00F936825DB3923827FC212A13,10471,11,15,4,37,48,1898
55096,55096,D2447B00F936825DB3923827FC212A13,10841,20,22,2,37,47,1897
55103,55103,92E1BAA88B052422B820ED36A9E8F107,41392,0,6,6,43,48,2198
55104,55104,92E1BAA88B052422B820ED36A9E8F107,11271,7,8,1,37,48,1898
55105,55105,92E1BAA88B052422B820ED36A9E8F107,41392,12,23,11,43,48,2198
55106,55106,2917A11EB625CB868E9962150273A0D4,42871,0,7,7,30,45,1545
55107,55107,2917A11EB625CB868E9962150273A0D4,10431,7,16,9,33,49,1699
55108,55108,2917A11EB625CB868E9962150273A0D4,10107,18,21,3,38,49,1949
55109,55109,D9B0439F3B0C81F4C0A4571FAB2A3A71,42021,7,9,2,33,47,1697
55110,55110,D9B0439F3B0C81F4C0A4571FAB2A3A71,11481,9,11,2,41,48,2098
55111,55111,D9B0439F3B0C81F4C0A4571FAB2A3A71,10151,12,17,5,34,47,1747
55112,55112,D9B0439F3B0C81F4C0A4571FAB2A3A71,42021,18,20,2,33,47,1697
55113,55113,ACD04627348D28EB014FAB46490D4B92,10351,0,8,8,28,45,1445
55114,55114,ACD04627348D28EB014FAB46490D4B92,12601,9,11,2,25,47,1297
55115,55115,ACD04627348D28EB014FAB46490D4B92,10351,12,13,1,28,45,1445
55116,55116,ACD04627348D28EB014FAB46490D4B92,13771,14,18,4,21,45,1095
55117,55117,558A6887C0D5899B43E75BBD844A7C64,42461,0,6,6,45,47,2297
55118,55118,558A6887C0D5899B43E75BBD844A7C64,42321,8,9,1,43,47,2197
55119,55119,558A6887C0D5899B43E75BBD844A7C64,42201,10,11,1,43,46,2196
55120,55120,558A6887C0D5899B43E75BBD844A7C64,42321,13,14,1,43,47,2197
55121,55121,558A6887C0D5899B43E75BBD844A7C64,42461,18,21,3,45,47,2297
55122,55122,D7B4DEFCB86C55D027A1210EEC02063B,11231,0,1,1,37,49,1899
55123,55123,D7B4DEFCB86C55D027A1210EEC02063B,10341,2,9,7,31,47,1597
55124,55124,D7B4DEFCB86C55D027A1210EEC02063B,11021,11,16,5,36,49,1849
55125,55125,D7B4DEFCB86C55D027A1210EEC02063B,11231,20,22,2,37,49,1899
55126,55126,AC61F27331632CA9F29911286368B95F,42623,1,6,5,22,49,1149
55127,55127,AC61F27331632CA9F29911286368B95F,11381,9,10,1,30,47,1547
55128,55128,AC61F27331632CA9F29911286368B95F,42623,16,22,6,22,49,1149
55135,55135,8436FA510D59B3814E50B7F18BD1D92C,19571,3,5,2,1,36,86
55136,55136,8436FA510D59B3814E50B7F18BD1D92C,12641,6,8,2,10,43,543
55137,55137,8436FA510D59B3814E50B7F18BD1D92C,43644,11,12,1,14,38,738
55138,55138,8436FA510D59B3814E50B7F18BD1D92C,12641,15,18,3,10,43,543
55139,55139,8436FA510D59B3814E50B7F18BD1D92C,43644,18,20,2,14,38,738
55140,55140,8436FA510D59B3814E50B7F18BD1D92C,19571,21,23,2,1,36,86
55144,55144,BF5EFB3BDBF5437ACD467C87E9038A8B,12921,10,12,2,9,41,491
55145,55145,BF5EFB3BDBF5437ACD467C87E9038A8B,43021,12,18,6,16,43,843
55146,55146,BF5EFB3BDBF5437ACD467C87E9038A8B,12921,22,23,1,9,41,491
55150,55150,830067E97972F27E1AE4923131398E88,42491,0,7,7,32,46,1646
55151,55151,830067E97972F27E1AE4923131398E88,42523,7,8,1,31,47,1597
55152,55152,830067E97972F27E1AE4923131398E88,10351,11,13,2,28,45,1445
55153,55153,830067E97972F27E1AE4923131398E88,42523,13,18,5,31,47,1597
55154,55154,830067E97972F27E1AE4923131398E88,13651,18,23,5,30,47,1547
55159,55159,F48A53EEDFFA8DE67536F9062139AC78,43051,3,4,1,46,45,2345
55160,55160,F48A53EEDFFA8DE67536F9062139AC78,13341,6,10,4,44,45,2245
55161,55161,F48A53EEDFFA8DE67536F9062139AC78,12211,12,23,11,41,44,2094
55169,55169,1C0548F40841AD0870DAD8EC7BECCBC6,13314,0,13,13,31,39,1589
55170,55170,1C0548F40841AD0870DAD8EC7BECCBC6,12521,13,18,5,35,41,1791
55171,55171,1C0548F40841AD0870DAD8EC7BECCBC6,13314,19,23,4,31,39,1589
55172,55172,FD112B5156FECF6460254CADD94A5EF4,12641,0,4,4,10,43,543
55173,55173,FD112B5156FECF6460254CADD94A5EF4,10921,6,15,9,43,48,2198
55174,55174,FD112B5156FECF6460254CADD94A5EF4,19031,16,17,1,1,42,92
55175,55175,FD112B5156FECF6460254CADD94A5EF4,12641,17,22,5,10,43,543
55179,55179,E648A6F090A3BE85617E0ED54A73B4F0,12601,0,3,3,25,47,1297
55180,55180,E648A6F090A3BE85617E0ED54A73B4F0,13091,5,8,3,20,42,1042
55181,55181,E648A6F090A3BE85617E0ED54A73B4F0,12601,10,23,13,25,47,1297
55182,55182,2E9DA8BFC00288392B827149BB3FB265,43021,2,4,2,16,43,843
55183,55183,2E9DA8BFC00288392B827149BB3FB265,12641,4,8,4,10,43,543
55184,55184,2E9DA8BFC00288392B827149BB3FB265,43021,12,14,2,16,43,843
55185,55185,2E9DA8BFC00288392B827149BB3FB265,12641,15,16,1,10,43,543
55186,55186,2E9DA8BFC00288392B827149BB3FB265,43021,16,17,1,16,43,843
55187,55187,2E9DA8BFC00288392B827149BB3FB265,12921,18,20,2,9,41,491
55195,55195,3C07D1557002BF4F1AA6A6D7A8949EF2,42523,1,4,3,31,47,1597
55196,55196,3C07D1557002BF4F1AA6A6D7A8949EF2,43761,4,5,1,32,47,1647
55197,55197,3C07D1557002BF4F1AA6A6D7A8949EF2,12601,8,17,9,25,47,1297
55198,55198,3C07D1557002BF4F1AA6A6D7A8949EF2,42523,18,22,4,31,47,1597
55199,55199,3C07D1557002BF4F1AA6A6D7A8949EF2,43761,22,23,1,32,47,1647
55203,55203,6B8EFEBEF5489C021016731A730F97CB,42371,0,1,1,34,46,1746
55204,55204,6B8EFEBEF5489C021016731A730F97CB,10271,2,3,1,37,46,1896
55205,55205,6B8EFEBEF5489C021016731A730F97CB,42371,3,5,2,34,46,1746
55206,55206,6B8EFEBEF5489C021016731A730F97CB,42511,11,13,2,37,47,1897
55207,55207,6B8EFEBEF5489C021016731A730F97CB,13121,15,17,2,38,46,1946
55208,55208,6B8EFEBEF5489C021016731A730F97CB,42371,20,23,3,34,46,1746
55212,55212,28D864A9653A5DF59FCBAC3D2F34AE0A,10292,0,12,12,30,47,1547
55213,55213,28D864A9653A5DF59FCBAC3D2F34AE0A,10634,13,14,1,27,45,1395
55214,55214,28D864A9653A5DF59FCBAC3D2F34AE0A,10292,14,18,4,30,47,1547
55215,55215,2F66AC01887397A198C9CCA6611EA97B,12521,0,13,13,35,41,1791
55216,55216,2F66AC01887397A198C9CCA6611EA97B,13314,13,15,2,31,39,1589
55217,55217,2F66AC01887397A198C9CCA6611EA97B,12521,18,23,5,35,41,1791
55221,55221,A534FD7E51A551BE3196665029DD0400,19931,0,6,6,7,43,393
55222,55222,A534FD7E51A551BE3196665029DD0400,19031,8,17,9,1,42,92
55223,55223,A534FD7E51A551BE3196665029DD0400,19931,20,22,2,7,43,393
55232,55232,C7C431E83C90A041B3FA2A63798CE4F8,43021,3,13,10,16,43,843
55233,55233,C7C431E83C90A041B3FA2A63798CE4F8,43644,14,16,2,14,38,738
55234,55234,C7C431E83C90A041B3FA2A63798CE4F8,43021,16,21,5,16,43,843
55241,55241,B3B5E7D27E233A4AC0448858D629F977,10251,1,9,8,35,47,1797
55242,55242,B3B5E7D27E233A4AC0448858D629F977,40341,11,13,2,23,49,1199
55243,55243,B3B5E7D27E233A4AC0448858D629F977,42401,16,18,2,36,47,1847
55244,55244,B3B5E7D27E233A4AC0448858D629F977,10251,19,23,4,35,47,1797
55245,55245,CC6A63734928B4CD8F414AAB01241B9F,10611,0,17,17,32,48,1648
55246,55246,CC6A63734928B4CD8F414AAB01241B9F,42511,18,19,1,37,47,1897
55247,55247,CC6A63734928B4CD8F414AAB01241B9F,12381,21,23,2,32,48,1648
55248,55248,4AE93F20F703B65B87F8746D93A2B5AE,42601,8,14,6,44,48,2248
55249,55249,4AE93F20F703B65B87F8746D93A2B5AE,11661,15,16,1,40,49,2049
55250,55250,4AE93F20F703B65B87F8746D93A2B5AE,43181,18,20,2,39,48,1998
55251,55251,4AE93F20F703B65B87F8746D93A2B5AE,43061,21,23,2,43,46,2196
55252,55252,05C3A7EB5EF4E026B421540B8AC90475,12311,6,9,3,30,44,1544
55253,55253,05C3A7EB5EF4E026B421540B8AC90475,42151,14,18,4,35,45,1795
55254,55254,05C3A7EB5EF4E026B421540B8AC90475,42531,21,22,1,31,45,1595
55255,55255,A1B1493AD1E4959D25E397CB780FB65E,42531,0,7,7,31,45,1595
55256,55256,A1B1493AD1E4959D25E397CB780FB65E,12311,9,10,1,30,44,1544
55257,55257,A1B1493AD1E4959D25E397CB780FB65E,42531,13,14,1,31,45,1595
55258,55258,A1B1493AD1E4959D25E397CB780FB65E,12311,14,16,2,30,44,1544
55259,55259,A1B1493AD1E4959D25E397CB780FB65E,42531,18,22,4,31,45,1595
55260,55260,1D8839791A73BFDDCCEC7690B9BAEEB8,11631,0,4,4,12,49,649
55261,55261,1D8839791A73BFDDCCEC7690B9BAEEB8,19441,7,8,1,8,46,446
55262,55262,1D8839791A73BFDDCCEC7690B9BAEEB8,11631,12,13,1,12,49,649
55263,55263,1D8839791A73BFDDCCEC7690B9BAEEB8,19441,14,23,9,8,46,446
55267,55267,151AF07FE1353F98EA8933566E4D900D,12921,1,9,8,9,41,491
55268,55268,151AF07FE1353F98EA8933566E4D900D,43021,14,15,1,16,43,843
55269,55269,151AF07FE1353F98EA8933566E4D900D,12921,17,20,3,9,41,491
55270,55270,3F7BFF26419AB43EAAC9D4DF4B7C2705,42301,0,6,6,36,47,1847
55271,55271,3F7BFF26419AB43EAAC9D4DF4B7C2705,42151,9,11,2,35,45,1795
55272,55272,3F7BFF26419AB43EAAC9D4DF4B7C2705,12311,12,13,1,30,44,1544
55273,55273,3F7BFF26419AB43EAAC9D4DF4B7C2705,42151,13,18,5,35,45,1795
55274,55274,3F7BFF26419AB43EAAC9D4DF4B7C2705,42301,19,23,4,36,47,1847
55275,55275,0AC9ACC82EDADEC2B3583D25F9FB3BD5,42041,0,2,2,10,47,547
55276,55276,0AC9ACC82EDADEC2B3583D25F9FB3BD5,19441,3,16,13,8,46,446
55277,55277,0AC9ACC82EDADEC2B3583D25F9FB3BD5,42041,16,17,1,10,47,547
55278,55278,0AC9ACC82EDADEC2B3583D25F9FB3BD5,19441,19,20,1,8,46,446
55279,55279,0AC9ACC82EDADEC2B3583D25F9FB3BD5,42041,21,22,1,10,47,547
55280,55280,3F0EDFFC6E18B4A03094543F5DAD11AE,42521,0,7,7,31,47,1597
55281,55281,3F0EDFFC6E18B4A03094543F5DAD11AE,11731,9,10,1,36,48,1848
55282,55282,3F0EDFFC6E18B4A03094543F5DAD11AE,43761,13,23,10,32,47,1647
55286,55286,76DA946F4DC1318DD46A32E1D303D6B7,12521,0,7,7,35,41,1791
55287,55287,76DA946F4DC1318DD46A32E1D303D6B7,13314,7,9,2,31,39,1589
55288,55288,76DA946F4DC1318DD46A32E1D303D6B7,12521,11,23,12,35,41,1791
55289,55289,95FC3EEFE9009049D8D7E1D215D8781A,11091,1,9,8,29,47,1497
55290,55290,95FC3EEFE9009049D8D7E1D215D8781A,10351,13,15,2,28,45,1445
55291,55291,95FC3EEFE9009049D8D7E1D215D8781A,10301,16,18,2,31,45,1595
55292,55292,95FC3EEFE9009049D8D7E1D215D8781A,42071,19,20,1,31,49,1599
55293,55293,95FC3EEFE9009049D8D7E1D215D8781A,11091,21,23,2,29,47,1497
55294,55294,4D997D0D011B0603E422EF7A1E4B5546,15081,0,10,10,27,1,1351
55295,55295,4D997D0D011B0603E422EF7A1E4B5546,16281,15,17,2,11,4,554
55296,55296,4D997D0D011B0603E422EF7A1E4B5546,15081,19,23,4,27,1,1351
55297,55297,DE69FEBC50432F9871EF62D07F7A5C1A,19181,0,8,8,8,40,440
55298,55298,DE69FEBC50432F9871EF62D07F7A5C1A,43644,8,9,1,14,38,738
55299,55299,DE69FEBC50432F9871EF62D07F7A5C1A,19181,11,20,9,8,40,440
55300,55300,6268A79D87E3CFA4E65FA8A748F9969C,11481,0,7,7,41,48,2098
55301,55301,6268A79D87E3CFA4E65FA8A748F9969C,13271,10,14,4,41,47,2097
55302,55302,6268A79D87E3CFA4E65FA8A748F9969C,11481,18,19,1,41,48,2098
55303,55303,6268A79D87E3CFA4E65FA8A748F9969C,13271,19,21,2,41,47,2097
55304,55304,6268A79D87E3CFA4E65FA8A748F9969C,13101,22,23,1,40,47,2047
55305,55305,E886E5251030835554FC7C0727BBE348,43081,0,2,2,27,28,1378
55306,55306,E886E5251030835554FC7C0727BBE348,12871,3,5,2,22,33,1133
55307,55307,E886E5251030835554FC7C0727BBE348,19801,9,22,13,19,26,976
55308,55308,68D66AC2F31097852E1113FCAC38B096,12311,0,5,5,30,44,1544
55309,55309,68D66AC2F31097852E1113FCAC38B096,12121,6,7,1,29,47,1497
55310,55310,68D66AC2F31097852E1113FCAC38B096,42531,10,11,1,31,45,1595
55311,55311,68D66AC2F31097852E1113FCAC38B096,12311,11,16,5,30,44,1544
55312,55312,68D66AC2F31097852E1113FCAC38B096,42531,16,18,2,31,45,1595
55313,55313,04D73C3CD00D40CB611F6BA5801F802C,13314,0,13,13,31,39,1589
55314,55314,04D73C3CD00D40CB611F6BA5801F802C,12521,13,15,2,35,41,1791
55315,55315,04D73C3CD00D40CB611F6BA5801F802C,13314,15,23,8,31,39,1589
55323,55323,6FD561F01C19F901ECB84425772743A9,10821,4,9,5,40,47,2047
55324,55324,6FD561F01C19F901ECB84425772743A9,42461,14,17,3,45,47,2297
55325,55325,6FD561F01C19F901ECB84425772743A9,10821,20,23,3,40,47,2047
55329,55329,CF7DA1891D00F069E0E0214450037183,11381,3,6,3,30,47,1547
55330,55330,CF7DA1891D00F069E0E0214450037183,11061,8,9,1,29,48,1498
55331,55331,CF7DA1891D00F069E0E0214450037183,11381,13,14,1,30,47,1547
55332,55332,CF7DA1891D00F069E0E0214450037183,11061,16,17,1,29,48,1498
55333,55333,CF7DA1891D00F069E0E0214450037183,11381,19,23,4,30,47,1547
55334,55334,AFAE133FA88B98A999C46702AA923186,10841,0,14,14,37,47,1897
55335,55335,AFAE133FA88B98A999C46702AA923186,10431,14,15,1,33,49,1699
55336,55336,AFAE133FA88B98A999C46702AA923186,42511,20,23,3,37,47,1897
55345,55345,17AF8B762960909CC09886DC1DB986F8,10531,0,8,8,34,46,1746
55346,55346,17AF8B762960909CC09886DC1DB986F8,42161,12,14,2,36,47,1847
55347,55347,17AF8B762960909CC09886DC1DB986F8,10601,16,18,2,39,47,1997
55348,55348,17AF8B762960909CC09886DC1DB986F8,42161,18,23,5,36,47,1847
55360,55360,F31D0F539D88D5B0186A35E4CAC0C2D1,10681,0,16,16,30,48,1548
55361,55361,F31D0F539D88D5B0186A35E4CAC0C2D1,11061,16,17,1,29,48,1498
55362,55362,F31D0F539D88D5B0186A35E4CAC0C2D1,10634,18,19,1,27,45,1395
55367,55367,B130271C77C2D323EEE368196126E69E,12561,0,14,14,45,43,2293
55368,55368,B130271C77C2D323EEE368196126E69E,43951,17,19,2,49,41,2491
55369,55369,B130271C77C2D323EEE368196126E69E,12561,21,23,2,45,43,2293
55373,55373,394FCA5F3AB676CBAB996A49070239BB,10721,0,8,8,31,48,1598
55374,55374,394FCA5F3AB676CBAB996A49070239BB,11231,11,13,2,37,49,1899
55375,55375,394FCA5F3AB676CBAB996A49070239BB,12083,14,15,1,36,49,1849
55376,55376,394FCA5F3AB676CBAB996A49070239BB,11921,19,23,4,38,48,1948
55377,55377,95E46EDC59FF5DC7B2780E8A91CFB9BB,19021,0,13,13,10,45,545
55378,55378,95E46EDC59FF5DC7B2780E8A91CFB9BB,12921,15,16,1,9,41,491
55379,55379,95E46EDC59FF5DC7B2780E8A91CFB9BB,19021,19,23,4,10,45,545
55380,55380,EFBB325901A77CC80B4A6113783C819C,10971,3,5,2,35,47,1797
55381,55381,EFBB325901A77CC80B4A6113783C819C,11061,8,16,8,29,48,1498
55382,55382,EFBB325901A77CC80B4A6113783C819C,42021,19,20,1,33,47,1697
55383,55383,08B22EEE6E957330DAD27E7217103ACF,43011,0,5,5,40,42,2042
55384,55384,08B22EEE6E957330DAD27E7217103ACF,12514,7,13,6,38,47,1947
55385,55385,08B22EEE6E957330DAD27E7217103ACF,11914,16,23,7,37,48,1898
55386,55386,F2E0A788EC41736380A7AB3495E7AB34,42161,0,6,6,36,47,1847
55387,55387,F2E0A788EC41736380A7AB3495E7AB34,12051,9,18,9,20,47,1047
55388,55388,F2E0A788EC41736380A7AB3495E7AB34,42161,19,23,4,36,47,1847
55392,55392,8DE4D252DA36E1365B15A8E9C0F92CC0,10544,1,4,3,28,48,1448
55393,55393,8DE4D252DA36E1365B15A8E9C0F92CC0,11151,7,9,2,30,48,1548
55394,55394,8DE4D252DA36E1365B15A8E9C0F92CC0,10107,12,14,2,38,49,1949
55395,55395,8DE4D252DA36E1365B15A8E9C0F92CC0,11151,15,18,3,30,48,1548
55396,55396,3AA7789035AB4DEC2E97E3010F171B32,42921,0,7,7,33,47,1697
55397,55397,3AA7789035AB4DEC2E97E3010F171B32,10351,7,8,1,28,45,1445
55398,55398,3AA7789035AB4DEC2E97E3010F171B32,42921,11,23,12,33,47,1697
55399,55399,2770DAF26F856B8C604C0FF1601A7902,19181,0,3,3,8,40,440
55400,55400,2770DAF26F856B8C604C0FF1601A7902,12921,7,13,6,9,41,491
55401,55401,2770DAF26F856B8C604C0FF1601A7902,19031,15,16,1,1,42,92
55402,55402,2770DAF26F856B8C604C0FF1601A7902,12921,18,23,5,9,41,491
55410,55410,F90823F8A5F35E0487A2C04C1AD1B462,43021,0,2,2,16,43,843
55411,55411,F90823F8A5F35E0487A2C04C1AD1B462,12641,2,14,12,10,43,543
55412,55412,F90823F8A5F35E0487A2C04C1AD1B462,19441,18,23,5,8,46,446
55416,55416,656752102BA99654C7060CE5B2133D72,49201,0,5,5,7,41,391
55417,55417,656752102BA99654C7060CE5B2133D72,12921,9,17,8,9,41,491
55418,55418,656752102BA99654C7060CE5B2133D72,12641,19,20,1,10,43,543
55419,55419,DEE027FFD9413EDED2CD41DE3E5573B0,11781,0,7,7,38,49,1949
55420,55420,DEE027FFD9413EDED2CD41DE3E5573B0,11481,11,14,3,41,48,2098
55421,55421,DEE027FFD9413EDED2CD41DE3E5573B0,40341,16,20,4,23,49,1199
55422,55422,DEE027FFD9413EDED2CD41DE3E5573B0,11781,21,23,2,38,49,1949
55423,55423,E3F6BEAC53881C33A9632EFCBC166461,13511,6,8,2,34,48,1748
55424,55424,E3F6BEAC53881C33A9632EFCBC166461,42161,9,11,2,36,47,1847
55425,55425,E3F6BEAC53881C33A9632EFCBC166461,11201,16,19,3,35,49,1799
55426,55426,E3F6BEAC53881C33A9632EFCBC166461,11801,20,22,2,42,48,2148
55427,55427,F82C1457F592D769C7F58A453A34A2D5,10171,1,4,3,26,47,1347
55428,55428,F82C1457F592D769C7F58A453A34A2D5,12921,7,8,1,9,41,491
55429,55429,F82C1457F592D769C7F58A453A34A2D5,49201,12,13,1,7,41,391
55430,55430,F82C1457F592D769C7F58A453A34A2D5,12921,14,15,1,9,41,491
55431,55431,F82C1457F592D769C7F58A453A34A2D5,49201,16,17,1,7,41,391
55432,55432,F82C1457F592D769C7F58A453A34A2D5,42541,19,22,3,25,47,1297
55433,55433,D3B7E592123DB083081A1FE3F2020361,19741,1,5,4,5,44,294
55434,55434,D3B7E592123DB083081A1FE3F2020361,12921,6,7,1,9,41,491
55435,55435,D3B7E592123DB083081A1FE3F2020361,12641,7,11,4,10,43,543
55436,55436,D3B7E592123DB083081A1FE3F2020361,19114,12,13,1,7,43,393
55437,55437,D3B7E592123DB083081A1FE3F2020361,12921,14,15,1,9,41,491
55438,55438,D3B7E592123DB083081A1FE3F2020361,49201,15,18,3,7,41,391
55439,55439,D3B7E592123DB083081A1FE3F2020361,19744,21,23,2,6,43,343
55444,55444,6EA83A9329F5D86E7E7F9B8351352891,11021,8,15,7,36,49,1849
55445,55445,6EA83A9329F5D86E7E7F9B8351352891,11751,15,18,3,35,48,1798
55446,55446,6EA83A9329F5D86E7E7F9B8351352891,10921,19,22,3,43,48,2198
55447,55447,01D2D04262CD32386D8DEB064F2BA928,12561,0,7,7,45,43,2293
55448,55448,01D2D04262CD32386D8DEB064F2BA928,43011,8,9,1,40,42,2042
55449,55449,01D2D04262CD32386D8DEB064F2BA928,12221,19,21,2,43,44,2194
55453,55453,DD530826CCBDF00DB7DA4C7B02E02C48,12521,0,8,8,35,41,1791
55454,55454,DD530826CCBDF00DB7DA4C7B02E02C48,11201,15,16,1,35,49,1799
55455,55455,DD530826CCBDF00DB7DA4C7B02E02C48,12521,18,22,4,35,41,1791
55456,55456,B9E127195A4DFA1F988A0F90827556AB,43051,0,5,5,46,45,2345
55457,55457,B9E127195A4DFA1F988A0F90827556AB,13951,7,8,1,47,45,2395
55458,55458,B9E127195A4DFA1F988A0F90827556AB,43051,12,14,2,46,45,2345
55459,55459,B9E127195A4DFA1F988A0F90827556AB,13821,16,17,1,49,45,2495
55460,55460,B9E127195A4DFA1F988A0F90827556AB,13711,19,20,1,38,46,1946
55461,55461,1F899C425E1D44BC86781F60DDEF728E,43021,0,7,7,16,43,843
55462,55462,1F899C425E1D44BC86781F60DDEF728E,12921,8,9,1,9,41,491
55463,55463,1F899C425E1D44BC86781F60DDEF728E,43021,13,16,3,16,43,843
55464,55464,1F899C425E1D44BC86781F60DDEF728E,12921,16,18,2,9,41,491
55465,55465,D29AED97AE2D8761B58AD6ADEDA31157,10711,0,4,4,29,46,1496
55466,55466,D29AED97AE2D8761B58AD6ADEDA31157,12311,4,6,2,30,44,1544
55467,55467,D29AED97AE2D8761B58AD6ADEDA31157,42531,10,11,1,31,45,1595
55468,55468,D29AED97AE2D8761B58AD6ADEDA31157,12311,18,21,3,30,44,1544
55469,55469,D29AED97AE2D8761B58AD6ADEDA31157,10711,22,23,1,29,46,1496
55470,55470,B36C8579A2DBF718933C4838B2421A42,42511,1,9,8,37,47,1897
55471,55471,B36C8579A2DBF718933C4838B2421A42,13681,9,10,1,38,47,1947
55472,55472,B36C8579A2DBF718933C4838B2421A42,13121,12,13,1,38,46,1946
55473,55473,B36C8579A2DBF718933C4838B2421A42,40124,14,16,2,38,47,1947
55474,55474,B36C8579A2DBF718933C4838B2421A42,13121,17,19,2,38,46,1946
55475,55475,B36C8579A2DBF718933C4838B2421A42,42511,20,22,2,37,47,1897
55476,55476,9B3D4DB494E6B8E7329532A1BECC6FF1,43021,0,6,6,16,43,843
55477,55477,9B3D4DB494E6B8E7329532A1BECC6FF1,12641,7,8,1,10,43,543
55478,55478,9B3D4DB494E6B8E7329532A1BECC6FF1,12921,9,10,1,9,41,491
55479,55479,9B3D4DB494E6B8E7329532A1BECC6FF1,43021,12,22,10,16,43,843
55483,55483,818EA1C09E6B17ADD6C05A401C8F5FE5,11061,0,11,11,29,48,1498
55484,55484,818EA1C09E6B17ADD6C05A401C8F5FE5,40951,14,16,2,36,49,1849
55485,55485,818EA1C09E6B17ADD6C05A401C8F5FE5,11061,18,23,5,29,48,1498
55490,55490,0BDBFF54E9941A2354CBA907886DEDD4,43501,2,7,5,27,48,1398
55491,55491,0BDBFF54E9941A2354CBA907886DEDD4,10951,9,10,1,29,48,1498
55492,55492,0BDBFF54E9941A2354CBA907886DEDD4,11541,14,16,2,35,49,1799
55493,55493,0BDBFF54E9941A2354CBA907886DEDD4,11061,19,22,3,29,48,1498
55497,55497,4BC9A8E125012809EEFE0C403F4B72EB,10381,0,1,1,31,49,1599
55498,55498,4BC9A8E125012809EEFE0C403F4B72EB,10771,2,15,13,41,46,2096
55499,55499,4BC9A8E125012809EEFE0C403F4B72EB,40341,16,20,4,23,49,1199
55500,55500,81DDAE7BB9B21EE23D4D27A04DA468B5,42981,0,8,8,36,49,1849
55501,55501,81DDAE7BB9B21EE23D4D27A04DA468B5,10251,9,10,1,35,47,1797
55502,55502,81DDAE7BB9B21EE23D4D27A04DA468B5,11021,14,15,1,36,49,1849
55503,55503,81DDAE7BB9B21EE23D4D27A04DA468B5,10841,18,20,2,37,47,1897
55504,55504,81DDAE7BB9B21EE23D4D27A04DA468B5,42981,21,23,2,36,49,1849
55505,55505,0E40901167898EDFDA9B65FF7D65C295,11851,8,10,2,13,47,697
55506,55506,0E40901167898EDFDA9B65FF7D65C295,19441,11,12,1,8,46,446
55507,55507,0E40901167898EDFDA9B65FF7D65C295,11851,16,18,2,13,47,697
55508,55508,8F0F9FD615E5CF54612AE31BD94EEC63,11431,1,2,1,29,47,1497
55509,55509,8F0F9FD615E5CF54612AE31BD94EEC63,10951,5,6,1,29,48,1498
55510,55510,8F0F9FD615E5CF54612AE31BD94EEC63,11381,6,8,2,30,47,1547
55511,55511,8F0F9FD615E5CF54612AE31BD94EEC63,11431,10,11,1,29,47,1497
55512,55512,8F0F9FD615E5CF54612AE31BD94EEC63,10107,13,16,3,38,49,1949
55513,55513,8F0F9FD615E5CF54612AE31BD94EEC63,11431,18,21,3,29,47,1497
55514,55514,E0C08AAB95A92B3E23EDC19C502B25AA,10431,0,6,6,33,49,1699
55515,55515,E0C08AAB95A92B3E23EDC19C502B25AA,11561,7,9,2,32,49,1649
55516,55516,E0C08AAB95A92B3E23EDC19C502B25AA,11161,13,14,1,32,48,1648
55517,55517,E0C08AAB95A92B3E23EDC19C502B25AA,43761,14,16,2,32,47,1647
55518,55518,E0C08AAB95A92B3E23EDC19C502B25AA,10281,16,18,2,33,48,1698
55519,55519,E0C08AAB95A92B3E23EDC19C502B25AA,11561,21,23,2,32,49,1649
55523,55523,F7A05B3FECD253C9C578617425D22E9D,13351,0,6,6,48,48,2448
55524,55524,F7A05B3FECD253C9C578617425D22E9D,40302,8,9,1,40,49,2049
55525,55525,F7A05B3FECD253C9C578617425D22E9D,19114,12,15,3,7,43,393
55526,55526,F7A05B3FECD253C9C578617425D22E9D,13271,18,19,1,41,47,2097
55527,55527,F7A05B3FECD253C9C578617425D22E9D,40691,20,22,2,42,48,2148
55528,55528,4DA21EF09DE00955AFF28F16D2698178,15391,0,1,1,35,26,1776
55529,55529,4DA21EF09DE00955AFF28F16D2698178,12792,1,3,2,34,30,1730
55530,55530,4DA21EF09DE00955AFF28F16D2698178,15391,4,23,19,35,26,1776
55543,55543,732CCF1BC496C93C41B70E7FF8357762,10634,1,7,6,27,45,1395
55544,55544,732CCF1BC496C93C41B70E7FF8357762,42501,8,11,3,28,47,1447
55545,55545,732CCF1BC496C93C41B70E7FF8357762,10634,12,14,2,27,45,1395
55546,55546,732CCF1BC496C93C41B70E7FF8357762,42501,14,15,1,28,47,1447
55547,55547,732CCF1BC496C93C41B70E7FF8357762,10634,16,17,1,27,45,1395
55548,55548,732CCF1BC496C93C41B70E7FF8357762,12311,17,19,2,30,44,1544
55549,55549,D8F61CF3289E3928FCE68B7F3A3EF9A7,43041,4,6,2,41,46,2096
55550,55550,D8F61CF3289E3928FCE68B7F3A3EF9A7,10841,7,16,9,37,47,1897
55551,55551,D8F61CF3289E3928FCE68B7F3A3EF9A7,43041,19,23,4,41,46,2096
55558,55558,B4C2ED2A52F8EA1C7B22A4B386DE0051,15241,0,13,13,33,2,1652
55559,55559,B4C2ED2A52F8EA1C7B22A4B386DE0051,11491,15,16,1,36,47,1847
55560,55560,B4C2ED2A52F8EA1C7B22A4B386DE0051,11351,19,23,4,36,48,1848
55564,55564,D256AE34DD31744D7365602849D9C40A,42491,2,6,4,32,46,1646
55565,55565,D256AE34DD31744D7365602849D9C40A,12601,9,17,8,25,47,1297
55566,55566,D256AE34DD31744D7365602849D9C40A,42491,19,23,4,32,46,1646
55567,55567,09757EDFE7795D1E67DCE5C4439A4727,12521,0,18,18,35,41,1791
55568,55568,09757EDFE7795D1E67DCE5C4439A4727,13314,18,19,1,31,39,1589
55569,55569,09757EDFE7795D1E67DCE5C4439A4727,12521,21,23,2,35,41,1791
55574,55574,59E8BD2B3B6F40BDD7AA0B26E7BC6262,13351,0,6,6,48,48,2448
55575,55575,59E8BD2B3B6F40BDD7AA0B26E7BC6262,42601,7,8,1,44,48,2248
55576,55576,59E8BD2B3B6F40BDD7AA0B26E7BC6262,13471,12,15,3,47,49,2399
55577,55577,59E8BD2B3B6F40BDD7AA0B26E7BC6262,11701,20,21,1,43,48,2198
55578,55578,1DD07CF7FD5B3CCCB4E85025836774E4,11074,0,7,7,37,47,1897
55579,55579,1DD07CF7FD5B3CCCB4E85025836774E4,12083,7,9,2,36,49,1849
55580,55580,1DD07CF7FD5B3CCCB4E85025836774E4,12131,9,11,2,32,47,1647
55581,55581,1DD07CF7FD5B3CCCB4E85025836774E4,13601,12,13,1,34,47,1747
55582,55582,1DD07CF7FD5B3CCCB4E85025836774E4,12381,16,22,6,32,48,1648
55583,55583,3C9F3A08BD8927B63D6BEA19D21199ED,42491,7,8,1,32,46,1646
55584,55584,3C9F3A08BD8927B63D6BEA19D21199ED,42523,9,11,2,31,47,1597
55585,55585,3C9F3A08BD8927B63D6BEA19D21199ED,42491,12,17,5,32,46,1646
55586,55586,3C9F3A08BD8927B63D6BEA19D21199ED,42523,17,18,1,31,47,1597
55587,55587,3C9F3A08BD8927B63D6BEA19D21199ED,42491,18,23,5,32,46,1646
55595,55595,E2F2F4143F844EB76521711717E3F1F1,12731,0,6,6,22,40,1140
55596,55596,E2F2F4143F844EB76521711717E3F1F1,12641,8,10,2,10,43,543
55597,55597,E2F2F4143F844EB76521711717E3F1F1,19261,12,13,1,6,37,337
55598,55598,E2F2F4143F844EB76521711717E3F1F1,12641,17,22,5,10,43,543
55606,55606,5EAAFAC3ED008D6394DF94C4111C8AD6,11381,0,10,10,30,47,1547
55607,55607,5EAAFAC3ED008D6394DF94C4111C8AD6,10221,13,14,1,34,49,1749
55608,55608,5EAAFAC3ED008D6394DF94C4111C8AD6,11381,16,23,7,30,47,1547
55609,55609,7A7AEC35AE07D4110F6099DB218EF80C,10211,3,5,2,16,49,849
55610,55610,7A7AEC35AE07D4110F6099DB218EF80C,19441,6,7,1,8,46,446
55611,55611,7A7AEC35AE07D4110F6099DB218EF80C,11851,7,10,3,13,47,697
55612,55612,7A7AEC35AE07D4110F6099DB218EF80C,19021,11,12,1,10,45,545
55613,55613,7A7AEC35AE07D4110F6099DB218EF80C,11851,12,14,2,13,47,697
55614,55614,7A7AEC35AE07D4110F6099DB218EF80C,19021,18,19,1,10,45,545
55615,55615,7A7AEC35AE07D4110F6099DB218EF80C,19441,19,21,2,8,46,446
55616,55616,7A7AEC35AE07D4110F6099DB218EF80C,19021,22,23,1,10,45,545
55617,55617,58FF60972C1637520443DC5766A2AB67,13411,3,6,3,49,42,2492
55618,55618,58FF60972C1637520443DC5766A2AB67,43951,6,10,4,49,41,2491
55619,55619,58FF60972C1637520443DC5766A2AB67,13411,10,12,2,49,42,2492
55620,55620,58FF60972C1637520443DC5766A2AB67,43951,13,14,1,49,41,2491
55621,55621,58FF60972C1637520443DC5766A2AB67,13411,15,23,8,49,42,2492
55631,55631,AE2EE7EDDD9663E9E1ACEFDB8D3CFC78,43451,0,5,5,37,40,1890
55632,55632,AE2EE7EDDD9663E9E1ACEFDB8D3CFC78,12521,6,11,5,35,41,1791
55633,55633,AE2EE7EDDD9663E9E1ACEFDB8D3CFC78,43451,12,13,1,37,40,1890
55634,55634,AE2EE7EDDD9663E9E1ACEFDB8D3CFC78,12521,15,17,2,35,41,1791
55635,55635,AE2EE7EDDD9663E9E1ACEFDB8D3CFC78,43451,20,21,1,37,40,1890
55636,55636,44456DB2F546B5FE9E15EA75927471A8,42521,7,8,1,31,47,1597
55637,55637,44456DB2F546B5FE9E15EA75927471A8,10351,8,10,2,28,45,1445
55638,55638,44456DB2F546B5FE9E15EA75927471A8,42521,10,13,3,31,47,1597
55639,55639,44456DB2F546B5FE9E15EA75927471A8,10351,14,15,1,28,45,1445
55640,55640,44456DB2F546B5FE9E15EA75927471A8,42521,17,23,6,31,47,1597
55644,55644,A573FF285872EC96818445928AD4461A,13671,0,3,3,27,43,1393
55645,55645,A573FF285872EC96818445928AD4461A,13094,3,5,2,21,42,1092
55646,55646,A573FF285872EC96818445928AD4461A,13671,5,6,1,27,43,1393
55647,55647,A573FF285872EC96818445928AD4461A,13094,7,8,1,21,42,1092
55648,55648,A573FF285872EC96818445928AD4461A,13671,10,12,2,27,43,1393
55649,55649,A573FF285872EC96818445928AD4461A,13094,13,14,1,21,42,1092
55650,55650,A573FF285872EC96818445928AD4461A,13671,17,22,5,27,43,1393
55651,55651,80A82BF5E27BBEC497DE7B21F3ABF3D7,42581,0,4,4,38,48,1948
55652,55652,80A82BF5E27BBEC497DE7B21F3ABF3D7,42623,8,9,1,22,49,1149
55653,55653,80A82BF5E27BBEC497DE7B21F3ABF3D7,42081,10,11,1,24,49,1249
55654,55654,80A82BF5E27BBEC497DE7B21F3ABF3D7,42581,19,23,4,38,48,1948
55661,55661,638AA3988D7A34CE04641BD9AD472949,42281,0,12,12,40,48,2048
55662,55662,638AA3988D7A34CE04641BD9AD472949,13941,12,15,3,41,47,2097
55663,55663,638AA3988D7A34CE04641BD9AD472949,42281,17,19,2,40,48,2048
55664,55664,638AA3988D7A34CE04641BD9AD472949,42271,20,21,1,40,47,2047
55665,55665,638AA3988D7A34CE04641BD9AD472949,42281,21,23,2,40,48,2048
55666,55666,B377B1A009BB64894719A8DF0AC3F76E,10821,2,10,8,40,47,2047
55667,55667,B377B1A009BB64894719A8DF0AC3F76E,10771,11,15,4,41,46,2096
55668,55668,B377B1A009BB64894719A8DF0AC3F76E,11231,18,23,5,37,49,1899
55675,55675,4FA7E2AF35091649A8D61648BF92F5C0,42581,0,7,7,38,48,1948
55676,55676,4FA7E2AF35091649A8D61648BF92F5C0,10471,7,11,4,37,48,1898
55677,55677,4FA7E2AF35091649A8D61648BF92F5C0,42581,12,14,2,38,48,1948
55678,55678,4FA7E2AF35091649A8D61648BF92F5C0,10471,16,17,1,37,48,1898
55679,55679,4FA7E2AF35091649A8D61648BF92F5C0,42581,20,21,1,38,48,1948
55680,55680,23A21A73FEBD9CCFAF6CD9924910EBC0,10901,0,6,6,35,48,1798
55681,55681,23A21A73FEBD9CCFAF6CD9924910EBC0,10971,8,11,3,35,47,1797
55682,55682,23A21A73FEBD9CCFAF6CD9924910EBC0,10901,12,13,1,35,48,1798
55683,55683,23A21A73FEBD9CCFAF6CD9924910EBC0,10251,14,16,2,35,47,1797
55684,55684,23A21A73FEBD9CCFAF6CD9924910EBC0,10471,19,21,2,37,48,1898
55685,55685,802D06E8811CDC65FDAB61E1A1D233B3,12601,0,6,6,25,47,1297
55686,55686,802D06E8811CDC65FDAB61E1A1D233B3,11211,10,11,1,34,49,1749
55687,55687,802D06E8811CDC65FDAB61E1A1D233B3,10691,13,19,6,33,48,1698
55692,55692,7EA63201A47B68AA085BD7B8AF1F7767,10721,0,7,7,31,48,1598
55693,55693,7EA63201A47B68AA085BD7B8AF1F7767,11231,8,16,8,37,49,1899
55694,55694,7EA63201A47B68AA085BD7B8AF1F7767,10721,19,23,4,31,48,1598
55695,55695,110EB8ED5B33FF374638B480C238C00D,10271,1,6,5,37,46,1896
55696,55696,110EB8ED5B33FF374638B480C238C00D,19744,10,17,7,6,43,343
55697,55697,110EB8ED5B33FF374638B480C238C00D,10271,20,21,1,37,46,1896
55698,55698,EDD72D29B8CAB7737CF6608FA3F3E204,11471,0,6,6,12,48,648
55699,55699,EDD72D29B8CAB7737CF6608FA3F3E204,19441,8,10,2,8,46,446
55700,55700,EDD72D29B8CAB7737CF6608FA3F3E204,11471,12,16,4,12,48,648
55701,55701,EDD72D29B8CAB7737CF6608FA3F3E204,19441,17,19,2,8,46,446
55702,55702,EDD72D29B8CAB7737CF6608FA3F3E204,11471,21,23,2,12,48,648
55716,55716,A4CBFA774BBCB1E081978588796288CA,10681,0,7,7,30,48,1548
55717,55717,A4CBFA774BBCB1E081978588796288CA,11231,11,17,6,37,49,1899
55718,55718,A4CBFA774BBCB1E081978588796288CA,10681,18,23,5,30,48,1548
55719,55719,0760067EA204421AC12ED2100EDD32E4,10841,0,9,9,37,47,1897
55720,55720,0760067EA204421AC12ED2100EDD32E4,43581,14,15,1,33,48,1698
55721,55721,0760067EA204421AC12ED2100EDD32E4,10841,16,22,6,37,47,1897
55722,55722,F0D3121715E704CF95B4298CEC7107EE,10251,2,10,8,35,47,1797
55723,55723,F0D3121715E704CF95B4298CEC7107EE,40341,11,13,2,23,49,1199
55724,55724,F0D3121715E704CF95B4298CEC7107EE,10251,17,20,3,35,47,1797
55728,55728,F584084BD0C4D0FD14EABE044AD44274,41392,0,6,6,43,48,2198
55729,55729,F584084BD0C4D0FD14EABE044AD44274,10295,8,17,9,30,47,1547
55730,55730,F584084BD0C4D0FD14EABE044AD44274,41392,21,23,2,43,48,2198
55731,55731,A71EF9A0EB3A6A8BE1B86F7EE106BE44,11074,1,13,12,37,47,1897
55732,55732,A71EF9A0EB3A6A8BE1B86F7EE106BE44,40062,15,16,1,32,49,1649
55733,55733,A71EF9A0EB3A6A8BE1B86F7EE106BE44,11231,17,19,2,37,49,1899
55734,55734,A71EF9A0EB3A6A8BE1B86F7EE106BE44,13511,20,22,2,34,48,1748
55739,55739,64125BF70ADD2A9D2C91BE766AA2E78E,13911,0,5,5,39,46,1996
55740,55740,64125BF70ADD2A9D2C91BE766AA2E78E,11261,7,9,2,36,46,1846
55741,55741,64125BF70ADD2A9D2C91BE766AA2E78E,43501,10,13,3,27,48,1398
55742,55742,64125BF70ADD2A9D2C91BE766AA2E78E,11261,17,19,2,36,46,1846
55753,55753,BA68D19087DD7682E8C396165511A278,11381,0,6,6,30,47,1547
55754,55754,BA68D19087DD7682E8C396165511A278,12083,9,10,1,36,49,1849
55755,55755,BA68D19087DD7682E8C396165511A278,11061,12,23,11,29,48,1498
55756,55756,CC942D0DF2AC341810018AA4F0BAC79C,42623,1,5,4,22,49,1149
55757,55757,CC942D0DF2AC341810018AA4F0BAC79C,42071,6,7,1,31,49,1599
55758,55758,CC942D0DF2AC341810018AA4F0BAC79C,42623,10,23,13,22,49,1149
55770,55770,9E06344DB1D7894D017F75BE5D6105CC,42041,1,5,4,10,47,547
55771,55771,9E06344DB1D7894D017F75BE5D6105CC,19441,6,7,1,8,46,446
55772,55772,9E06344DB1D7894D017F75BE5D6105CC,42041,7,9,2,10,47,547
55773,55773,9E06344DB1D7894D017F75BE5D6105CC,19441,9,13,4,8,46,446
55774,55774,9E06344DB1D7894D017F75BE5D6105CC,42041,14,17,3,10,47,547
55775,55775,9E06344DB1D7894D017F75BE5D6105CC,19441,17,23,6,8,46,446
55776,55776,4B18376F646A8C5898CD3325A7616D50,43971,0,5,5,30,48,1548
55777,55777,4B18376F646A8C5898CD3325A7616D50,43761,9,10,1,32,47,1647
55778,55778,4B18376F646A8C5898CD3325A7616D50,43971,11,13,2,30,48,1548
55779,55779,4B18376F646A8C5898CD3325A7616D50,11161,19,20,1,32,48,1648
55780,55780,4B18376F646A8C5898CD3325A7616D50,43971,22,23,1,30,48,1548
55784,55784,457B6E4F438CC31549766262E68E0A83,13071,0,5,5,41,41,2091
55785,55785,457B6E4F438CC31549766262E68E0A83,13941,7,14,7,41,47,2097
55786,55786,457B6E4F438CC31549766262E68E0A83,40341,15,18,3,23,49,1199
55787,55787,457B6E4F438CC31549766262E68E0A83,13371,19,23,4,41,47,2097
55788,55788,A2FF2B3E007AEF697BBECF6D3F01B855,12641,1,3,2,10,43,543
55789,55789,A2FF2B3E007AEF697BBECF6D3F01B855,43021,5,7,2,16,43,843
55790,55790,A2FF2B3E007AEF697BBECF6D3F01B855,19021,7,8,1,10,45,545
55791,55791,A2FF2B3E007AEF697BBECF6D3F01B855,43021,11,14,3,16,43,843
55792,55792,A2FF2B3E007AEF697BBECF6D3F01B855,19021,15,18,3,10,45,545
55793,55793,CE46A02CA196948C3D07DA5CEEB7BE83,43101,0,5,5,46,40,2340
55794,55794,CE46A02CA196948C3D07DA5CEEB7BE83,13551,8,10,2,45,38,2288
55795,55795,CE46A02CA196948C3D07DA5CEEB7BE83,43101,13,14,1,46,40,2340
55796,55796,CE46A02CA196948C3D07DA5CEEB7BE83,13551,15,21,6,45,38,2288
55797,55797,CE46A02CA196948C3D07DA5CEEB7BE83,43101,22,23,1,46,40,2340
55807,55807,198F13224A4C889E12ED1D538BD7168E,15391,0,5,5,35,26,1776
55808,55808,198F13224A4C889E12ED1D538BD7168E,43121,6,12,6,25,27,1277
55809,55809,198F13224A4C889E12ED1D538BD7168E,15391,13,22,9,35,26,1776
55810,55810,E93D8B02977789FF5BDAF0EE317471D5,10451,0,7,7,25,48,1298
55811,55811,E93D8B02977789FF5BDAF0EE317471D5,12311,8,14,6,30,44,1544
55812,55812,E93D8B02977789FF5BDAF0EE317471D5,10451,17,19,2,25,48,1298
55813,55813,EB358EEF59CEDE6739172ECE8D2827BD,42371,1,14,13,34,46,1746
55814,55814,EB358EEF59CEDE6739172ECE8D2827BD,41681,14,17,3,39,46,1996
55815,55815,EB358EEF59CEDE6739172ECE8D2827BD,11074,20,23,3,37,47,1897
55816,55816,753369D691B504B9F7186B2CDF290F06,12791,4,5,1,31,29,1579
55817,55817,753369D691B504B9F7186B2CDF290F06,15391,6,8,2,35,26,1776
55818,55818,753369D691B504B9F7186B2CDF290F06,12792,10,11,1,34,30,1730
55819,55819,753369D691B504B9F7186B2CDF290F06,15091,12,23,11,35,26,1776
55820,55820,9C353448BE5136C24DE05834483871D1,13671,0,7,7,27,43,1393
55821,55821,9C353448BE5136C24DE05834483871D1,19441,9,16,7,8,46,446
55822,55822,9C353448BE5136C24DE05834483871D1,13671,19,23,4,27,43,1393
55823,55823,6CC3FE89A8F1A15E71D203BFCADF8D3A,11701,0,10,10,43,48,2198
55824,55824,6CC3FE89A8F1A15E71D203BFCADF8D3A,10251,14,19,5,35,47,1797
55825,55825,6CC3FE89A8F1A15E71D203BFCADF8D3A,11701,20,23,3,43,48,2198
55836,55836,8AB561279CAFD673B81CFFF6F25401C3,12221,0,9,9,43,44,2194
55837,55837,8AB561279CAFD673B81CFFF6F25401C3,13951,12,14,2,47,45,2395
55838,55838,8AB561279CAFD673B81CFFF6F25401C3,43011,17,23,6,40,42,2042
55839,55839,073EBE93660DAEAA6A02C36811E4AA2E,12381,0,9,9,32,48,1648
55840,55840,073EBE93660DAEAA6A02C36811E4AA2E,10471,10,16,6,37,48,1898
55841,55841,073EBE93660DAEAA6A02C36811E4AA2E,12381,17,23,6,32,48,1648
55842,55842,A6FB8806348882E3287150AAB70E5425,42141,0,7,7,32,47,1647
55843,55843,A6FB8806348882E3287150AAB70E5425,42523,7,10,3,31,47,1597
55844,55844,A6FB8806348882E3287150AAB70E5425,43761,10,15,5,32,47,1647
55845,55845,A6FB8806348882E3287150AAB70E5425,42523,15,16,1,31,47,1597
55846,55846,A6FB8806348882E3287150AAB70E5425,43761,17,23,6,32,47,1647
55847,55847,14032B8270EF22C1D4A35716559793F7,41392,0,6,6,43,48,2198
55848,55848,14032B8270EF22C1D4A35716559793F7,11531,7,8,1,34,49,1749
55849,55849,14032B8270EF22C1D4A35716559793F7,11201,13,14,1,35,49,1799
55850,55850,14032B8270EF22C1D4A35716559793F7,42111,15,16,1,44,46,2246
55851,55851,14032B8270EF22C1D4A35716559793F7,42971,17,18,1,43,49,2199
55852,55852,14032B8270EF22C1D4A35716559793F7,11531,19,21,2,34,49,1749
55853,55853,14032B8270EF22C1D4A35716559793F7,41392,22,23,1,43,48,2198
55861,55861,9C75D6BB1B395C3B21D5737D9FBE0FC2,19021,0,4,4,10,45,545
55862,55862,9C75D6BB1B395C3B21D5737D9FBE0FC2,12311,5,15,10,30,44,1544
55863,55863,9C75D6BB1B395C3B21D5737D9FBE0FC2,42531,15,17,2,31,45,1595
55864,55864,9C75D6BB1B395C3B21D5737D9FBE0FC2,19021,19,22,3,10,45,545
55868,55868,000D77C2A9F62BEDA00737D781A7BB24,11861,0,7,7,32,47,1647
55869,55869,000D77C2A9F62BEDA00737D781A7BB24,13951,18,19,1,47,45,2395
55870,55870,000D77C2A9F62BEDA00737D781A7BB24,40691,21,22,1,42,48,2148
55875,55875,4D92520D1E60176F5F81838CD0F00070,10681,0,7,7,30,48,1548
55876,55876,4D92520D1E60176F5F81838CD0F00070,11021,8,12,4,36,49,1849
55877,55877,4D92520D1E60176F5F81838CD0F00070,10681,13,21,8,30,48,1548
55878,55878,9E8650B76E9047B63AD694EBC9D1BFBC,42321,1,3,2,43,47,2197
55879,55879,9E8650B76E9047B63AD694EBC9D1BFBC,11381,5,17,12,30,47,1547
55880,55880,9E8650B76E9047B63AD694EBC9D1BFBC,11875,18,19,1,30,46,1546
55888,55888,C50F95F31F14C0EC9A55706C3B181C1C,12792,2,6,4,34,30,1730
55889,55889,C50F95F31F14C0EC9A55706C3B181C1C,15091,9,11,2,35,26,1776
55890,55890,C50F95F31F14C0EC9A55706C3B181C1C,12792,16,18,2,34,30,1730
55891,55891,C50F95F31F14C0EC9A55706C3B181C1C,15391,18,20,2,35,26,1776
55892,55892,D5D027DEC2E15CD439B6E37A42DFD8C1,12921,1,5,4,9,41,491
55893,55893,D5D027DEC2E15CD439B6E37A42DFD8C1,43021,9,16,7,16,43,843
55894,55894,D5D027DEC2E15CD439B6E37A42DFD8C1,12921,16,18,2,9,41,491
55895,55895,F674F1B1DDC0504AEB66BE4E53444BCD,12661,0,1,1,32,45,1645
55896,55896,F674F1B1DDC0504AEB66BE4E53444BCD,10634,3,7,4,27,45,1395
55897,55897,F674F1B1DDC0504AEB66BE4E53444BCD,10301,11,12,1,31,45,1595
55898,55898,F674F1B1DDC0504AEB66BE4E53444BCD,10351,14,15,1,28,45,1445
55899,55899,F674F1B1DDC0504AEB66BE4E53444BCD,10301,16,21,5,31,45,1595
55900,55900,5AF60AEC73FB2864229FDD9D1D02814C,19441,0,12,12,8,46,446
55901,55901,5AF60AEC73FB2864229FDD9D1D02814C,11571,15,16,1,13,46,696
55902,55902,5AF60AEC73FB2864229FDD9D1D02814C,19441,16,23,7,8,46,446
55912,55912,9F08D51AB5A713D9DA81349F9F08E5F1,42461,3,15,12,45,47,2297
55913,55913,9F08D51AB5A713D9DA81349F9F08E5F1,10251,16,17,1,35,47,1797
55914,55914,9F08D51AB5A713D9DA81349F9F08E5F1,42461,20,23,3,45,47,2297
55923,55923,F4C8F856DD638BBA75F52C720E10C05D,10921,0,7,7,43,48,2198
55924,55924,F4C8F856DD638BBA75F52C720E10C05D,12641,9,14,5,10,43,543
55925,55925,F4C8F856DD638BBA75F52C720E10C05D,12921,18,21,3,9,41,491
55929,55929,6274E9CC7D59011B35AFD50F03FD1063,11806,2,3,1,41,48,2098
55930,55930,6274E9CC7D59011B35AFD50F03FD1063,42271,5,7,2,40,47,2047
55931,55931,6274E9CC7D59011B35AFD50F03FD1063,11806,7,9,2,41,48,2098
55932,55932,6274E9CC7D59011B35AFD50F03FD1063,42271,10,16,6,40,47,2047
55933,55933,6274E9CC7D59011B35AFD50F03FD1063,11806,18,21,3,41,48,2098
55937,55937,04360B963F976E50E0DAE03979A51033,40891,0,3,3,37,47,1897
55938,55938,04360B963F976E50E0DAE03979A51033,10271,4,6,2,37,46,1896
55939,55939,04360B963F976E50E0DAE03979A51033,12491,8,10,2,36,43,1843
55940,55940,04360B963F976E50E0DAE03979A51033,13911,13,14,1,39,46,1996
55941,55941,04360B963F976E50E0DAE03979A51033,42231,14,18,4,37,46,1896
55942,55942,04360B963F976E50E0DAE03979A51033,12491,22,23,1,36,43,1843
55943,55943,5CDABD3BF6CDECFBE7EFDD89B2CF1639,42071,0,9,9,31,49,1599
55944,55944,5CDABD3BF6CDECFBE7EFDD89B2CF1639,42081,10,11,1,24,49,1249
55945,55945,5CDABD3BF6CDECFBE7EFDD89B2CF1639,42071,12,23,11,31,49,1599
55946,55946,1878A28A4958FD17FABB07AB93005B57,12841,0,7,7,37,47,1897
55947,55947,1878A28A4958FD17FABB07AB93005B57,13671,8,17,9,27,43,1393
55948,55948,1878A28A4958FD17FABB07AB93005B57,12841,22,23,1,37,47,1897
55955,55955,0DFD98C5BF618352145AEF64606DF221,42401,0,5,5,36,47,1847
55956,55956,0DFD98C5BF618352145AEF64606DF221,10251,5,6,1,35,47,1797
55957,55957,0DFD98C5BF618352145AEF64606DF221,40637,7,17,10,36,47,1847
55958,55958,0DFD98C5BF618352145AEF64606DF221,10251,19,21,2,35,47,1797
55959,55959,0DFD98C5BF618352145AEF64606DF221,42161,21,23,2,36,47,1847
55964,55964,51591F8EA07D8177C3E0ABFE6A0BF706,42623,0,5,5,22,49,1149
55965,55965,51591F8EA07D8177C3E0ABFE6A0BF706,13731,9,17,8,33,49,1699
55966,55966,51591F8EA07D8177C3E0ABFE6A0BF706,42623,22,23,1,22,49,1149
55967,55967,CA61A9493C86A7D75976E3E9D412B440,11861,0,7,7,32,47,1647
55968,55968,CA61A9493C86A7D75976E3E9D412B440,11651,8,9,1,33,47,1697
55969,55969,CA61A9493C86A7D75976E3E9D412B440,11481,11,12,1,41,48,2098
55970,55970,CA61A9493C86A7D75976E3E9D412B440,13101,13,14,1,40,47,2047
55971,55971,CA61A9493C86A7D75976E3E9D412B440,11861,15,17,2,32,47,1647
55972,55972,CA61A9493C86A7D75976E3E9D412B440,10731,18,23,5,33,47,1697
55986,55986,5423F91F30C84585D05D4EBF276E73FE,13371,0,8,8,41,47,2097
55987,55987,5423F91F30C84585D05D4EBF276E73FE,13101,8,11,3,40,47,2047
55988,55988,5423F91F30C84585D05D4EBF276E73FE,13371,12,17,5,41,47,2097
55989,55989,5423F91F30C84585D05D4EBF276E73FE,43161,18,19,1,35,47,1797
55990,55990,5423F91F30C84585D05D4EBF276E73FE,13941,21,22,1,41,47,2097
56001,56001,9397083C419903E30A62F5C06D299D5C,13071,1,5,4,41,41,2091
56002,56002,9397083C419903E30A62F5C06D299D5C,43451,7,8,1,37,40,1890
56003,56003,9397083C419903E30A62F5C06D299D5C,10601,12,13,1,39,47,1997
56004,56004,9397083C419903E30A62F5C06D299D5C,40341,14,16,2,23,49,1199
56005,56005,9397083C419903E30A62F5C06D299D5C,42381,18,19,1,39,41,1991
56006,56006,AAC98D8EB5664A9B5DE56F266CB31991,16281,0,12,12,11,4,554
56007,56007,AAC98D8EB5664A9B5DE56F266CB31991,15143,12,17,5,18,7,907
56008,56008,AAC98D8EB5664A9B5DE56F266CB31991,15281,17,18,1,25,3,1253
56018,56018,E6369493E83514E066C954A2C01DFAE8,19741,0,8,8,5,44,294
56019,56019,E6369493E83514E066C954A2C01DFAE8,49201,10,12,2,7,41,391
56020,56020,E6369493E83514E066C954A2C01DFAE8,43321,13,15,2,36,49,1849
56021,56021,E6369493E83514E066C954A2C01DFAE8,19741,19,23,4,5,44,294
56025,56025,4BEB96C1A6F8B99181CDADEF48D75275,42501,0,5,5,28,47,1447
56026,56026,4BEB96C1A6F8B99181CDADEF48D75275,42081,7,18,11,24,49,1249
56027,56027,4BEB96C1A6F8B99181CDADEF48D75275,42501,19,23,4,28,47,1447
56031,56031,BCCA36AC6DE92B5D284204C1D312B82A,43161,0,7,7,35,47,1797
56032,56032,BCCA36AC6DE92B5D284204C1D312B82A,42801,11,15,4,40,49,2049
56033,56033,BCCA36AC6DE92B5D284204C1D312B82A,42161,16,23,7,36,47,1847
56034,56034,9FE6C74E96160A0B443DF5E3D0C3817D,13671,1,2,1,27,43,1393
56035,56035,9FE6C74E96160A0B443DF5E3D0C3817D,42791,3,6,3,35,45,1795
56036,56036,9FE6C74E96160A0B443DF5E3D0C3817D,13671,6,7,1,27,43,1393
56037,56037,9FE6C74E96160A0B443DF5E3D0C3817D,12311,8,9,1,30,44,1544
56038,56038,9FE6C74E96160A0B443DF5E3D0C3817D,13671,14,15,1,27,43,1393
56039,56039,9FE6C74E96160A0B443DF5E3D0C3817D,42531,17,18,1,31,45,1595
56051,56051,73118727834AEF72D14D5BE83EC91BD1,11001,0,6,6,42,47,2147
56052,56052,73118727834AEF72D14D5BE83EC91BD1,11074,7,15,8,37,47,1897
56053,56053,73118727834AEF72D14D5BE83EC91BD1,13941,18,22,4,41,47,2097
56054,56054,DFE0075BA441F09CC854C6FA18C2E9B5,43971,0,12,12,30,48,1548
56055,56055,DFE0075BA441F09CC854C6FA18C2E9B5,11541,14,18,4,35,49,1799
56056,56056,DFE0075BA441F09CC854C6FA18C2E9B5,11531,19,23,4,34,49,1749
56066,56066,69601DFFFCF880DD8BF9BB911205AC6A,13651,1,2,1,30,47,1547
56067,56067,69601DFFFCF880DD8BF9BB911205AC6A,10281,3,6,3,33,48,1698
56068,56068,69601DFFFCF880DD8BF9BB911205AC6A,13651,9,11,2,30,47,1547
56069,56069,69601DFFFCF880DD8BF9BB911205AC6A,10281,12,14,2,33,48,1698
56070,56070,69601DFFFCF880DD8BF9BB911205AC6A,40331,16,23,7,30,47,1547
56080,56080,51E47FDE51716EB36BE96125516194AB,11021,0,11,11,36,49,1849
56081,56081,51E47FDE51716EB36BE96125516194AB,40697,12,14,2,43,48,2198
56082,56082,51E47FDE51716EB36BE96125516194AB,11021,14,17,3,36,49,1849
56083,56083,51E47FDE51716EB36BE96125516194AB,40697,18,21,3,43,48,2198
56084,56084,51E47FDE51716EB36BE96125516194AB,11021,21,23,2,36,49,1849
56085,56085,718F9C02C6A67F792D4A34A4E958BCFE,11751,0,3,3,35,48,1798
56086,56086,718F9C02C6A67F792D4A34A4E958BCFE,13011,3,7,4,39,47,1997
56087,56087,718F9C02C6A67F792D4A34A4E958BCFE,10901,18,20,2,35,48,1798
56088,56088,718F9C02C6A67F792D4A34A4E958BCFE,40951,20,22,2,36,49,1849
56101,56101,F292E588F5B97B789B94F3BB973BBEB5,10281,1,7,6,33,48,1698
56102,56102,F292E588F5B97B789B94F3BB973BBEB5,11861,10,13,3,32,47,1647
56103,56103,F292E588F5B97B789B94F3BB973BBEB5,42081,17,19,2,24,49,1249
56104,56104,F292E588F5B97B789B94F3BB973BBEB5,10731,21,22,1,33,47,1697
56108,56108,D39B974D3FC57295AC599832B8A0CE7E,19111,1,6,5,9,45,495
56109,56109,D39B974D3FC57295AC599832B8A0CE7E,12921,7,8,1,9,41,491
56110,56110,D39B974D3FC57295AC599832B8A0CE7E,19031,9,16,7,1,42,92
56111,56111,D39B974D3FC57295AC599832B8A0CE7E,19621,19,23,4,5,46,296
56112,56112,33DCEB99733F5490EC3E4641096F98E9,42271,1,6,5,40,47,2047
56113,56113,33DCEB99733F5490EC3E4641096F98E9,42861,8,14,6,37,44,1894
56114,56114,33DCEB99733F5490EC3E4641096F98E9,42151,15,17,2,35,45,1795
56115,56115,33DCEB99733F5490EC3E4641096F98E9,13491,20,23,3,48,39,2439
56116,56116,4E11BF8BE5D9968272F10199F7ACA9E8,11531,0,7,7,34,49,1749
56117,56117,4E11BF8BE5D9968272F10199F7ACA9E8,12131,10,11,1,32,47,1647
56118,56118,4E11BF8BE5D9968272F10199F7ACA9E8,10281,12,16,4,33,48,1698
56119,56119,4E11BF8BE5D9968272F10199F7ACA9E8,16181,19,23,4,4,2,202
56120,56120,1F1CFFA83535112571EB4490E214516F,11331,1,2,1,37,48,1898
56121,56121,1F1CFFA83535112571EB4490E214516F,43481,4,5,1,39,48,1998
56122,56122,1F1CFFA83535112571EB4490E214516F,11331,7,8,1,37,48,1898
56123,56123,1F1CFFA83535112571EB4490E214516F,42221,11,12,1,38,48,1948
56124,56124,1F1CFFA83535112571EB4490E214516F,11331,16,23,7,37,48,1898
56125,56125,19DD9EA3315ECB699A68A051C9281E6B,10471,1,8,7,37,48,1898
56126,56126,19DD9EA3315ECB699A68A051C9281E6B,13121,10,11,1,38,46,1946
56127,56127,19DD9EA3315ECB699A68A051C9281E6B,40171,12,16,4,38,48,1948
56128,56128,19DD9EA3315ECB699A68A051C9281E6B,13121,16,17,1,38,46,1946
56129,56129,19DD9EA3315ECB699A68A051C9281E6B,10471,19,20,1,37,48,1898
56130,56130,19DD9EA3315ECB699A68A051C9281E6B,11491,21,22,1,36,47,1847
56131,56131,ACF091EB1E15063CE70493C1F0B4FB69,19441,0,6,6,8,46,446
56132,56132,ACF091EB1E15063CE70493C1F0B4FB69,11571,6,8,2,13,46,696
56133,56133,ACF091EB1E15063CE70493C1F0B4FB69,19441,12,23,11,8,46,446
56143,56143,826B40817E61853148AFBFECB1C48C70,11261,3,4,1,36,46,1846
56144,56144,826B40817E61853148AFBFECB1C48C70,42861,7,17,10,37,44,1894
56145,56145,826B40817E61853148AFBFECB1C48C70,11261,18,19,1,36,46,1846
56146,56146,826B40817E61853148AFBFECB1C48C70,42864,19,22,3,38,44,1944
56147,56147,826B40817E61853148AFBFECB1C48C70,11261,22,23,1,36,46,1846
56148,56148,EF81D5350C78C47D74F1239C7A88A260,11201,2,3,1,35,49,1799
56149,56149,EF81D5350C78C47D74F1239C7A88A260,11381,7,18,11,30,47,1547
56150,56150,EF81D5350C78C47D74F1239C7A88A260,11201,21,23,2,35,49,1799
56151,56151,C7DA09D84BB6D5A3ABEAD976C8C0731E,42861,0,5,5,37,44,1894
56152,56152,C7DA09D84BB6D5A3ABEAD976C8C0731E,11261,6,7,1,36,46,1846
56153,56153,C7DA09D84BB6D5A3ABEAD976C8C0731E,42861,10,13,3,37,44,1894
56154,56154,C7DA09D84BB6D5A3ABEAD976C8C0731E,11261,14,16,2,36,46,1846
56155,56155,C7DA09D84BB6D5A3ABEAD976C8C0731E,42861,19,23,4,37,44,1894
56166,56166,92E340B82C56A45F91D53CD2B709557E,42581,3,8,5,38,48,1948
56167,56167,92E340B82C56A45F91D53CD2B709557E,11914,9,10,1,37,48,1898
56168,56168,92E340B82C56A45F91D53CD2B709557E,42581,11,12,1,38,48,1948
56169,56169,92E340B82C56A45F91D53CD2B709557E,11914,16,18,2,37,48,1898
56170,56170,92E340B82C56A45F91D53CD2B709557E,42581,18,21,3,38,48,1948
56171,56171,167F0AD4C372262B104F1E644C482559,43281,0,7,7,37,48,1898
56172,56172,167F0AD4C372262B104F1E644C482559,13121,8,11,3,38,46,1946
56173,56173,167F0AD4C372262B104F1E644C482559,11751,12,13,1,35,48,1798
56174,56174,167F0AD4C372262B104F1E644C482559,13121,14,15,1,38,46,1946
56175,56175,167F0AD4C372262B104F1E644C482559,10731,16,23,7,33,47,1697
56185,56185,64A2E9501F429B6DEC66E8EE627CCABA,11061,0,6,6,29,48,1498
56186,56186,64A2E9501F429B6DEC66E8EE627CCABA,10301,9,18,9,31,45,1595
56187,56187,64A2E9501F429B6DEC66E8EE627CCABA,11261,21,22,1,36,46,1846
56199,56199,49849F61A5AEA70CF53208520D85BDBC,12921,7,9,2,9,41,491
56200,56200,49849F61A5AEA70CF53208520D85BDBC,19031,13,14,1,1,42,92
56201,56201,49849F61A5AEA70CF53208520D85BDBC,12921,14,17,3,9,41,491
56202,56202,49849F61A5AEA70CF53208520D85BDBC,19031,21,23,2,1,42,92
56203,56203,E5492E07A4862AD700B0EAC8DC132879,42121,7,9,2,26,49,1349
56204,56204,E5492E07A4862AD700B0EAC8DC132879,42071,10,11,1,31,49,1599
56205,56205,E5492E07A4862AD700B0EAC8DC132879,11151,13,17,4,30,48,1548
56206,56206,E5492E07A4862AD700B0EAC8DC132879,42071,21,23,2,31,49,1599
56217,56217,2C3A1C890B30FB06A95DD4A9EF742265,19801,0,5,5,19,26,976
56218,56218,2C3A1C890B30FB06A95DD4A9EF742265,43121,5,7,2,25,27,1277
56219,56219,2C3A1C890B30FB06A95DD4A9EF742265,19801,8,9,1,19,26,976
56220,56220,2C3A1C890B30FB06A95DD4A9EF742265,43121,13,22,9,25,27,1277
56224,56224,57068447BEEE4D7969FF166D57966ECA,42541,0,5,5,25,47,1297
56225,56225,57068447BEEE4D7969FF166D57966ECA,11361,6,8,2,22,48,1148
56226,56226,57068447BEEE4D7969FF166D57966ECA,42541,12,13,1,25,47,1297
56227,56227,57068447BEEE4D7969FF166D57966ECA,11361,13,18,5,22,48,1148
56228,56228,57068447BEEE4D7969FF166D57966ECA,42541,21,23,2,25,47,1297
56229,56229,78520B675436202D640A52F7BAC3D2C7,15391,2,7,5,35,26,1776
56230,56230,78520B675436202D640A52F7BAC3D2C7,12792,9,10,1,34,30,1730
56231,56231,78520B675436202D640A52F7BAC3D2C7,43081,12,16,4,27,28,1378
56232,56232,78520B675436202D640A52F7BAC3D2C7,15391,17,22,5,35,26,1776
56233,56233,DBE56CF804EFF98F06EBBF480586FC01,12921,6,11,5,9,41,491
56234,56234,DBE56CF804EFF98F06EBBF480586FC01,43021,13,15,2,16,43,843
56235,56235,DBE56CF804EFF98F06EBBF480586FC01,12921,15,22,7,9,41,491
56255,56255,A0281A3586AC38676D52E3E8F717115A,10107,1,3,2,38,49,1949
56256,56256,A0281A3586AC38676D52E3E8F717115A,42491,3,19,16,32,46,1646
56257,56257,A0281A3586AC38676D52E3E8F717115A,11861,20,22,2,32,47,1647
56261,56261,E311A49FD79CE1E67702DBA9B7887B92,12641,1,5,4,10,43,543
56262,56262,E311A49FD79CE1E67702DBA9B7887B92,19021,6,10,4,10,45,545
56263,56263,E311A49FD79CE1E67702DBA9B7887B92,12641,12,14,2,10,43,543
56264,56264,E311A49FD79CE1E67702DBA9B7887B92,19021,14,19,5,10,45,545
56265,56265,E311A49FD79CE1E67702DBA9B7887B92,12641,19,23,4,10,43,543
56266,56266,55533B9612A041F560AB09E0A0C2A735,10251,0,9,9,35,47,1797
56267,56267,55533B9612A041F560AB09E0A0C2A735,41601,13,15,2,39,49,1999
56268,56268,55533B9612A041F560AB09E0A0C2A735,43731,18,19,1,34,47,1747
56269,56269,55533B9612A041F560AB09E0A0C2A735,10251,21,23,2,35,47,1797
56270,56270,A25A833341BE3939DF5ACF6F00A1B542,10621,0,6,6,41,49,2099
56271,56271,A25A833341BE3939DF5ACF6F00A1B542,42971,6,7,1,43,49,2199
56272,56272,A25A833341BE3939DF5ACF6F00A1B542,11731,12,13,1,36,48,1848
56273,56273,A25A833341BE3939DF5ACF6F00A1B542,10621,19,23,4,41,49,2099
56280,56280,ED569151E6A8C0A86F789287FFBD4CE0,42021,0,5,5,33,47,1697
56281,56281,ED569151E6A8C0A86F789287FFBD4CE0,10921,8,14,6,43,48,2198
56282,56282,ED569151E6A8C0A86F789287FFBD4CE0,11861,18,23,5,32,47,1647
56286,56286,ABB6F382C5C4E9BFCDB8D523D5E35622,42971,0,5,5,43,49,2199
56287,56287,ABB6F382C5C4E9BFCDB8D523D5E35622,10221,6,10,4,34,49,1749
56288,56288,ABB6F382C5C4E9BFCDB8D523D5E35622,11201,11,17,6,35,49,1799
56289,56289,ABB6F382C5C4E9BFCDB8D523D5E35622,42971,21,23,2,43,49,2199
56307,56307,441E401293D6FFC8E080552D376784E1,42581,1,5,4,38,48,1948
56308,56308,441E401293D6FFC8E080552D376784E1,11914,5,9,4,37,48,1898
56309,56309,441E401293D6FFC8E080552D376784E1,42581,10,13,3,38,48,1948
56310,56310,441E401293D6FFC8E080552D376784E1,11914,13,15,2,37,48,1898
56311,56311,441E401293D6FFC8E080552D376784E1,42581,15,21,6,38,48,1948
56315,56315,5408DC5B0AFBD23C3FA2E4CCFD3A9C81,42633,0,3,3,42,46,2146
56316,56316,5408DC5B0AFBD23C3FA2E4CCFD3A9C81,42351,3,6,3,38,45,1945
56317,56317,5408DC5B0AFBD23C3FA2E4CCFD3A9C81,11261,6,8,2,36,46,1846
56318,56318,5408DC5B0AFBD23C3FA2E4CCFD3A9C81,42633,12,23,11,42,46,2146
56319,56319,B2E1A9593E19D988BDD0EE32D9CE9188,11281,0,8,8,27,40,1390
56320,56320,B2E1A9593E19D988BDD0EE32D9CE9188,12601,12,15,3,25,47,1297
56321,56321,B2E1A9593E19D988BDD0EE32D9CE9188,11281,16,18,2,27,40,1390
56322,56322,B2E1A9593E19D988BDD0EE32D9CE9188,12761,21,22,1,25,40,1290
56323,56323,4668498322059FDBAD6E4D56B28B3D41,42461,0,1,1,45,47,2297
56324,56324,4668498322059FDBAD6E4D56B28B3D41,43061,1,3,2,43,46,2196
56325,56325,4668498322059FDBAD6E4D56B28B3D41,13341,7,8,1,44,45,2245
56326,56326,4668498322059FDBAD6E4D56B28B3D41,12211,10,17,7,41,44,2094
56327,56327,4668498322059FDBAD6E4D56B28B3D41,43061,20,22,2,43,46,2196
56331,56331,81AF7988BF559FB27BEA65660F2240E0,42523,1,11,10,31,47,1597
56332,56332,81AF7988BF559FB27BEA65660F2240E0,11324,12,15,3,31,46,1596
56333,56333,81AF7988BF559FB27BEA65660F2240E0,42151,18,21,3,35,45,1795
56334,56334,370E88FABA2CD17C386F5D9F3F1CE63A,42501,0,6,6,28,47,1447
56335,56335,370E88FABA2CD17C386F5D9F3F1CE63A,42161,13,18,5,36,47,1847
56336,56336,370E88FABA2CD17C386F5D9F3F1CE63A,42501,19,22,3,28,47,1447
56337,56337,6D62BE8B751688E1124EF442CD693D0D,19901,0,5,5,7,44,394
56338,56338,6D62BE8B751688E1124EF442CD693D0D,19021,9,10,1,10,45,545
56339,56339,6D62BE8B751688E1124EF442CD693D0D,12641,11,13,2,10,43,543
56340,56340,6D62BE8B751688E1124EF442CD693D0D,19021,15,17,2,10,45,545
56341,56341,6D62BE8B751688E1124EF442CD693D0D,12641,17,23,6,10,43,543
56345,56345,C6FF0C0C1DEE38711679574CEC9C3876,11431,1,2,1,29,47,1497
56346,56346,C6FF0C0C1DEE38711679574CEC9C3876,42501,3,4,1,28,47,1447
56347,56347,C6FF0C0C1DEE38711679574CEC9C3876,11431,4,5,1,29,47,1497
56348,56348,C6FF0C0C1DEE38711679574CEC9C3876,42501,6,8,2,28,47,1447
56349,56349,C6FF0C0C1DEE38711679574CEC9C3876,10351,15,17,2,28,45,1445
56350,56350,C6FF0C0C1DEE38711679574CEC9C3876,42501,19,23,4,28,47,1447
56354,56354,FBFB039BFE202B4D733B8197A5DE9AA1,43751,0,5,5,19,48,998
56355,56355,FBFB039BFE202B4D733B8197A5DE9AA1,12581,6,18,12,24,48,1248
56356,56356,FBFB039BFE202B4D733B8197A5DE9AA1,43751,18,19,1,19,48,998
56366,56366,CFF4943452741BA085C68AD1AAC66347,10331,0,7,7,39,46,1996
56367,56367,CFF4943452741BA085C68AD1AAC66347,13101,9,12,3,40,47,2047
56368,56368,CFF4943452741BA085C68AD1AAC66347,10331,12,13,1,39,46,1996
56369,56369,CFF4943452741BA085C68AD1AAC66347,10511,16,18,2,35,46,1796
56370,56370,CFF4943452741BA085C68AD1AAC66347,10331,19,23,4,39,46,1996
56381,56381,95426015650BC53898B8F1908C1F7E01,12121,0,5,5,29,47,1497
56382,56382,95426015650BC53898B8F1908C1F7E01,10451,6,8,2,25,48,1298
56383,56383,95426015650BC53898B8F1908C1F7E01,10401,11,12,1,33,49,1699
56384,56384,95426015650BC53898B8F1908C1F7E01,11111,15,18,3,26,48,1348
56391,56391,A9FAA4B4C51A5D14416D1899F40B6E9A,19801,0,5,5,19,26,976
56392,56392,A9FAA4B4C51A5D14416D1899F40B6E9A,13481,5,7,2,26,31,1331
56393,56393,A9FAA4B4C51A5D14416D1899F40B6E9A,19101,9,11,2,17,29,879
56394,56394,A9FAA4B4C51A5D14416D1899F40B6E9A,19801,11,21,10,19,26,976
56395,56395,AE5EC73B53E9C3CD1EC48FB8238BD121,10221,0,8,8,34,49,1749
56396,56396,AE5EC73B53E9C3CD1EC48FB8238BD121,11831,10,11,1,32,45,1645
56397,56397,AE5EC73B53E9C3CD1EC48FB8238BD121,10221,12,14,2,34,49,1749
56398,56398,AE5EC73B53E9C3CD1EC48FB8238BD121,40381,15,16,1,32,46,1646
56399,56399,AE5EC73B53E9C3CD1EC48FB8238BD121,10411,20,21,1,36,48,1848
56400,56400,AE5EC73B53E9C3CD1EC48FB8238BD121,40171,21,23,2,38,48,1948
56401,56401,494D4CE05480984DBEB3A2073E0D7F93,10191,0,8,8,40,48,2048
56402,56402,494D4CE05480984DBEB3A2073E0D7F93,12381,8,12,4,32,48,1648
56403,56403,494D4CE05480984DBEB3A2073E0D7F93,11751,16,17,1,35,48,1798
56404,56404,494D4CE05480984DBEB3A2073E0D7F93,12381,18,19,1,32,48,1648
56405,56405,494D4CE05480984DBEB3A2073E0D7F93,13511,19,20,1,34,48,1748
56406,56406,494D4CE05480984DBEB3A2073E0D7F93,42411,21,23,2,40,49,2049
56420,56420,69E733DE4C2A7A294CFA07F4F32678A0,42231,6,14,8,37,46,1896
56421,56421,69E733DE4C2A7A294CFA07F4F32678A0,13911,18,19,1,39,46,1996
56422,56422,69E733DE4C2A7A294CFA07F4F32678A0,11791,21,22,1,38,49,1949
56423,56423,69E733DE4C2A7A294CFA07F4F32678A0,11481,22,23,1,41,48,2098
56424,56424,A2DD7BA75FCE1B5306A377D198F94491,15391,0,1,1,35,26,1776
56425,56425,A2DD7BA75FCE1B5306A377D198F94491,12792,2,3,1,34,30,1730
56426,56426,A2DD7BA75FCE1B5306A377D198F94491,15391,6,23,17,35,26,1776
56427,56427,6BC25D943F92E8D81D0DD10A27C42A3A,11381,0,6,6,30,47,1547
56428,56428,6BC25D943F92E8D81D0DD10A27C42A3A,11061,10,11,1,29,48,1498
56429,56429,6BC25D943F92E8D81D0DD10A27C42A3A,11381,12,15,3,30,47,1547
56430,56430,6BC25D943F92E8D81D0DD10A27C42A3A,42291,16,17,1,29,48,1498
56431,56431,6BC25D943F92E8D81D0DD10A27C42A3A,11381,22,23,1,30,47,1547
56432,56432,DED4C247C56D64ACDBD92A58D85076C0,11061,1,6,5,29,48,1498
56433,56433,DED4C247C56D64ACDBD92A58D85076C0,12121,10,11,1,29,47,1497
56434,56434,DED4C247C56D64ACDBD92A58D85076C0,13121,13,17,4,38,46,1946
56435,56435,DED4C247C56D64ACDBD92A58D85076C0,11074,19,21,2,37,47,1897
56436,56436,97EED02186157B67ACCA35C5CC13851D,10251,0,9,9,35,47,1797
56437,56437,97EED02186157B67ACCA35C5CC13851D,11875,12,18,6,30,46,1546
56438,56438,97EED02186157B67ACCA35C5CC13851D,10531,22,23,1,34,46,1746
56446,56446,1EAE8E0D28D79DCFE0DA0CD7004A4A71,19441,0,4,4,8,46,446
56447,56447,1EAE8E0D28D79DCFE0DA0CD7004A4A71,11571,4,6,2,13,46,696
56448,56448,1EAE8E0D28D79DCFE0DA0CD7004A4A71,19441,6,7,1,8,46,446
56449,56449,1EAE8E0D28D79DCFE0DA0CD7004A4A71,19901,8,9,1,7,44,394
56450,56450,1EAE8E0D28D79DCFE0DA0CD7004A4A71,19441,10,22,12,8,46,446
56455,56455,BB6408B6449FE57F7E33631A828BC98E,11301,0,1,1,41,49,2099
56456,56456,BB6408B6449FE57F7E33631A828BC98E,11521,1,3,2,41,48,2098
56457,56457,BB6408B6449FE57F7E33631A828BC98E,11701,4,8,4,43,48,2198
56458,56458,BB6408B6449FE57F7E33631A828BC98E,10421,11,13,2,41,48,2098
56459,56459,BB6408B6449FE57F7E33631A828BC98E,42601,17,18,1,44,48,2248
56460,56460,BB6408B6449FE57F7E33631A828BC98E,40697,21,23,2,43,48,2198
56461,56461,8B7C73BA6B2D95910FBCFDF137038C2A,19114,0,5,5,7,43,393
56462,56462,8B7C73BA6B2D95910FBCFDF137038C2A,12641,6,9,3,10,43,543
56463,56463,8B7C73BA6B2D95910FBCFDF137038C2A,19021,9,11,2,10,45,545
56464,56464,8B7C73BA6B2D95910FBCFDF137038C2A,19114,11,12,1,7,43,393
56465,56465,8B7C73BA6B2D95910FBCFDF137038C2A,19111,13,14,1,9,45,495
56466,56466,8B7C73BA6B2D95910FBCFDF137038C2A,19031,17,18,1,1,42,92
56467,56467,8B7C73BA6B2D95910FBCFDF137038C2A,19114,19,23,4,7,43,393
56472,56472,1DD1A250791E8DE9D0B949B1DAE230C8,11861,0,4,4,32,47,1647
56473,56473,1DD1A250791E8DE9D0B949B1DAE230C8,10281,5,6,1,33,48,1698
56474,56474,1DD1A250791E8DE9D0B949B1DAE230C8,11861,6,13,7,32,47,1647
56475,56475,1DD1A250791E8DE9D0B949B1DAE230C8,10281,13,20,7,33,48,1698
56476,56476,1DD1A250791E8DE9D0B949B1DAE230C8,11861,22,23,1,32,47,1647
56477,56477,AB57CFBC7FBBD1B4F46C04046F726522,15021,6,8,2,46,18,2318
56478,56478,AB57CFBC7FBBD1B4F46C04046F726522,12881,9,10,1,47,22,2372
56479,56479,AB57CFBC7FBBD1B4F46C04046F726522,15021,14,17,3,46,18,2318
56480,56480,AB57CFBC7FBBD1B4F46C04046F726522,15171,19,22,3,42,21,2121
56481,56481,15903F2996F483F19DF9C809F94C3A96,12161,0,1,1,32,46,1646
56482,56482,15903F2996F483F19DF9C809F94C3A96,42151,1,7,6,35,45,1795
56483,56483,15903F2996F483F19DF9C809F94C3A96,12161,7,12,5,32,46,1646
56484,56484,15903F2996F483F19DF9C809F94C3A96,11381,14,20,6,30,47,1547
56485,56485,15903F2996F483F19DF9C809F94C3A96,12161,21,23,2,32,46,1646
56493,56493,DF67F45D6C04AA09AB09A1673F49E479,42121,5,6,1,26,49,1349
56494,56494,DF67F45D6C04AA09AB09A1673F49E479,42071,10,14,4,31,49,1599
56495,56495,DF67F45D6C04AA09AB09A1673F49E479,42623,18,19,1,22,49,1149
56496,56496,DF67F45D6C04AA09AB09A1673F49E479,42071,20,21,1,31,49,1599
56497,56497,4CEF2D9D71549E955305B2DC8309A78D,12641,0,5,5,10,43,543
56498,56498,4CEF2D9D71549E955305B2DC8309A78D,12921,5,18,13,9,41,491
56499,56499,4CEF2D9D71549E955305B2DC8309A78D,43021,21,23,2,16,43,843
56500,56500,5117C51B1073385BE9CAD291C267C88C,10351,0,13,13,28,45,1445
56501,56501,5117C51B1073385BE9CAD291C267C88C,42231,14,17,3,37,46,1896
56502,56502,5117C51B1073385BE9CAD291C267C88C,10351,18,22,4,28,45,1445
56506,56506,F3B16B9F2FE5D66DD896BE8E61C1FA80,12311,0,5,5,30,44,1544
56507,56507,F3B16B9F2FE5D66DD896BE8E61C1FA80,10301,7,8,1,31,45,1595
56508,56508,F3B16B9F2FE5D66DD896BE8E61C1FA80,10351,9,15,6,28,45,1445
56509,56509,F3B16B9F2FE5D66DD896BE8E61C1FA80,10301,15,18,3,31,45,1595
56510,56510,F3B16B9F2FE5D66DD896BE8E61C1FA80,10351,21,23,2,28,45,1445
56517,56517,3DABBE7AD4BBA6D6461EC91F04F7CCEC,42461,0,6,6,45,47,2297
56518,56518,3DABBE7AD4BBA6D6461EC91F04F7CCEC,43621,8,9,1,46,48,2348
56519,56519,3DABBE7AD4BBA6D6461EC91F04F7CCEC,11701,10,11,1,43,48,2198
56520,56520,3DABBE7AD4BBA6D6461EC91F04F7CCEC,42321,14,16,2,43,47,2197
56521,56521,3DABBE7AD4BBA6D6461EC91F04F7CCEC,42461,18,23,5,45,47,2297
56526,56526,D3D891501F7527BC175379F737060A6D,10281,0,6,6,33,48,1698
56527,56527,D3D891501F7527BC175379F737060A6D,11861,10,11,1,32,47,1647
56528,56528,D3D891501F7527BC175379F737060A6D,11651,11,13,2,33,47,1697
56529,56529,D3D891501F7527BC175379F737060A6D,11861,14,15,1,32,47,1647
56530,56530,D3D891501F7527BC175379F737060A6D,10281,16,23,7,33,48,1698
56531,56531,F5B51F953CD3F7A1DB23953A4B9121A3,12874,0,6,6,20,34,1034
56532,56532,F5B51F953CD3F7A1DB23953A4B9121A3,12871,11,18,7,22,33,1133
56533,56533,F5B51F953CD3F7A1DB23953A4B9121A3,19281,18,23,5,16,32,832
56538,56538,16749067CE77BA3D2815FAA26257799E,19114,1,5,4,7,43,393
56539,56539,16749067CE77BA3D2815FAA26257799E,12921,7,9,2,9,41,491
56540,56540,16749067CE77BA3D2815FAA26257799E,19114,11,13,2,7,43,393
56541,56541,16749067CE77BA3D2815FAA26257799E,12641,16,17,1,10,43,543
56542,56542,16749067CE77BA3D2815FAA26257799E,19114,18,23,5,7,43,393
56546,56546,2D5ACE6BA72F8DBBD03A3E1708CA962A,13511,0,7,7,34,48,1748
56547,56547,2D5ACE6BA72F8DBBD03A3E1708CA962A,13121,8,11,3,38,46,1946
56548,56548,2D5ACE6BA72F8DBBD03A3E1708CA962A,13511,13,14,1,34,48,1748
56549,56549,2D5ACE6BA72F8DBBD03A3E1708CA962A,42231,15,16,1,37,46,1896
56550,56550,2D5ACE6BA72F8DBBD03A3E1708CA962A,13511,19,21,2,34,48,1748
56551,56551,65B48EE5ED2247ED53156166DD958197,13071,0,8,8,41,41,2091
56552,56552,65B48EE5ED2247ED53156166DD958197,11731,10,17,7,36,48,1848
56553,56553,65B48EE5ED2247ED53156166DD958197,13551,21,23,2,45,38,2288
56554,56554,64196B92113804613202929DA5CA5A6A,10711,0,13,13,29,46,1496
56555,56555,64196B92113804613202929DA5CA5A6A,12514,13,16,3,38,47,1947
56556,56556,64196B92113804613202929DA5CA5A6A,10711,19,23,4,29,46,1496
56557,56557,5232A1F9DD43FADD1ACE9CE9BD82FED1,43581,0,11,11,33,48,1698
56558,56558,5232A1F9DD43FADD1ACE9CE9BD82FED1,19111,16,17,1,9,45,495
56559,56559,5232A1F9DD43FADD1ACE9CE9BD82FED1,43581,19,22,3,33,48,1698
56563,56563,91564295887E224AC65F70C3E07BB220,12311,0,7,7,30,44,1544
56564,56564,91564295887E224AC65F70C3E07BB220,43761,9,11,2,32,47,1647
56565,56565,91564295887E224AC65F70C3E07BB220,10716,12,19,7,30,46,1546
56566,56566,92D731B11080166AE9677089A81E2175,10491,0,8,8,33,48,1698
56567,56567,92D731B11080166AE9677089A81E2175,11771,10,11,1,39,49,1999
56568,56568,92D731B11080166AE9677089A81E2175,10491,12,15,3,33,48,1698
56569,56569,92D731B11080166AE9677089A81E2175,43181,16,17,1,39,48,1998
56570,56570,92D731B11080166AE9677089A81E2175,10491,17,23,6,33,48,1698
56577,56577,AF03CB6E19CFE236682919AFB51A6FD2,11861,0,7,7,32,47,1647
56578,56578,AF03CB6E19CFE236682919AFB51A6FD2,12381,7,9,2,32,48,1648
56579,56579,AF03CB6E19CFE236682919AFB51A6FD2,10781,11,14,3,35,47,1797
56580,56580,AF03CB6E19CFE236682919AFB51A6FD2,13121,17,19,2,38,46,1946
56581,56581,AF03CB6E19CFE236682919AFB51A6FD2,11861,20,23,3,32,47,1647
56597,56597,3726F794FF4D69661B99C05A8EBB68A3,42521,7,8,1,31,47,1597
56598,56598,3726F794FF4D69661B99C05A8EBB68A3,43971,11,12,1,30,48,1548
56599,56599,3726F794FF4D69661B99C05A8EBB68A3,42521,13,18,5,31,47,1597
56600,56600,3726F794FF4D69661B99C05A8EBB68A3,11381,19,21,2,30,47,1547
56601,56601,3726F794FF4D69661B99C05A8EBB68A3,42521,22,23,1,31,47,1597
56605,56605,83324CA5FAD335C37A1D2CE62BC04E32,13471,0,1,1,47,49,2399
56606,56606,83324CA5FAD335C37A1D2CE62BC04E32,42971,2,10,8,43,49,2199
56607,56607,83324CA5FAD335C37A1D2CE62BC04E32,42051,15,17,2,42,48,2148
56608,56608,83324CA5FAD335C37A1D2CE62BC04E32,13471,21,23,2,47,49,2399
56609,56609,E7F0BEFEB527574747952B709C847F2A,15051,0,10,10,19,4,954
56610,56610,E7F0BEFEB527574747952B709C847F2A,16281,12,16,4,11,4,554
56611,56611,E7F0BEFEB527574747952B709C847F2A,15051,16,21,5,19,4,954
56612,56612,E7F0BEFEB527574747952B709C847F2A,16281,22,23,1,11,4,554
56613,56613,A0B44EDE0A0A4605549206EBBBA0709D,10211,0,6,6,16,49,849
56614,56614,A0B44EDE0A0A4605549206EBBBA0709D,42861,8,14,6,37,44,1894
56615,56615,A0B44EDE0A0A4605549206EBBBA0709D,10211,18,23,5,16,49,849
56623,56623,F276DA0C0E39AE3BAD5B91AE46CB6EA8,42971,0,5,5,43,49,2199
56624,56624,F276DA0C0E39AE3BAD5B91AE46CB6EA8,10471,6,7,1,37,48,1898
56625,56625,F276DA0C0E39AE3BAD5B91AE46CB6EA8,11231,8,18,10,37,49,1899
56626,56626,F276DA0C0E39AE3BAD5B91AE46CB6EA8,42971,21,22,1,43,49,2199
56627,56627,A4F01C7564D93754BD15B45D204857A9,10651,1,2,1,36,49,1849
56628,56628,A4F01C7564D93754BD15B45D204857A9,13561,2,4,2,37,49,1899
56629,56629,A4F01C7564D93754BD15B45D204857A9,11021,4,8,4,36,49,1849
56630,56630,A4F01C7564D93754BD15B45D204857A9,19031,16,17,1,1,42,92
56631,56631,A4F01C7564D93754BD15B45D204857A9,10651,22,23,1,36,49,1849
56632,56632,4F985171E935EB3DC7536EAA1C4743E5,11641,0,12,12,22,49,1149
56633,56633,4F985171E935EB3DC7536EAA1C4743E5,42071,13,14,1,31,49,1599
56634,56634,4F985171E935EB3DC7536EAA1C4743E5,42623,15,23,8,22,49,1149
56638,56638,BBCB9918D42B41DEDF16DD7F5A9BE26F,11861,0,10,10,32,47,1647
56639,56639,BBCB9918D42B41DEDF16DD7F5A9BE26F,42161,11,14,3,36,47,1847
56640,56640,BBCB9918D42B41DEDF16DD7F5A9BE26F,11911,15,17,2,37,48,1898
56641,56641,BBCB9918D42B41DEDF16DD7F5A9BE26F,11861,17,23,6,32,47,1647
56642,56642,D6E0D47A6811EABBFDD09BA210C09402,10611,0,7,7,32,48,1648
56643,56643,D6E0D47A6811EABBFDD09BA210C09402,42141,10,13,3,32,47,1647
56644,56644,D6E0D47A6811EABBFDD09BA210C09402,42921,14,15,1,33,47,1697
56645,56645,D6E0D47A6811EABBFDD09BA210C09402,11794,16,19,3,38,49,1949
56646,56646,D6E0D47A6811EABBFDD09BA210C09402,10611,22,23,1,32,48,1648
56650,56650,778FCC24D7E33BA6E0BE6A312CE18590,10431,0,6,6,33,49,1699
56651,56651,778FCC24D7E33BA6E0BE6A312CE18590,10881,7,8,1,34,48,1748
56652,56652,778FCC24D7E33BA6E0BE6A312CE18590,42161,8,23,15,36,47,1847
56656,56656,1D5FEB85097765A4DAC299D8A4D17B3D,10951,0,6,6,29,48,1498
56657,56657,1D5FEB85097765A4DAC299D8A4D17B3D,12381,7,13,6,32,48,1648
56658,56658,1D5FEB85097765A4DAC299D8A4D17B3D,13561,14,15,1,37,49,1899
56659,56659,1D5FEB85097765A4DAC299D8A4D17B3D,10951,18,23,5,29,48,1498
56664,56664,7B2A043D515CB61698DD480E69194AE5,19621,0,5,5,5,46,296
56665,56665,7B2A043D515CB61698DD480E69194AE5,12641,7,9,2,10,43,543
56666,56666,7B2A043D515CB61698DD480E69194AE5,19621,13,23,10,5,46,296
56667,56667,105A3B72395833D152D1F67AE98737D7,19031,8,10,2,1,42,92
56668,56668,105A3B72395833D152D1F67AE98737D7,49201,12,14,2,7,41,391
56669,56669,105A3B72395833D152D1F67AE98737D7,19111,18,19,1,9,45,495
56670,56670,D5408D65A6C1F04926B75EB0D14C16C4,42971,0,6,6,43,49,2199
56671,56671,D5408D65A6C1F04926B75EB0D14C16C4,13841,14,15,1,40,46,2046
56672,56672,D5408D65A6C1F04926B75EB0D14C16C4,42341,17,23,6,43,49,2199
56682,56682,809D30997DBB6653E10DF33CB05A97F7,13771,0,10,10,21,45,1095
56683,56683,809D30997DBB6653E10DF33CB05A97F7,12601,13,14,1,25,47,1297
56684,56684,809D30997DBB6653E10DF33CB05A97F7,13771,19,22,3,21,45,1095
56685,56685,EE6B8585E25BB845D2DA0A95F88FAB79,42231,10,11,1,37,46,1896
56686,56686,EE6B8585E25BB845D2DA0A95F88FAB79,42351,14,16,2,38,45,1945
56687,56687,EE6B8585E25BB845D2DA0A95F88FAB79,11261,16,17,1,36,46,1846
56688,56688,EE6B8585E25BB845D2DA0A95F88FAB79,42231,17,19,2,37,46,1896
56689,56689,EE6B8585E25BB845D2DA0A95F88FAB79,42351,21,23,2,38,45,1945
56690,56690,6684687C9F1041794E8237CE4D241C6F,42081,0,4,4,24,49,1249
56691,56691,6684687C9F1041794E8237CE4D241C6F,10381,4,6,2,31,49,1599
56692,56692,6684687C9F1041794E8237CE4D241C6F,42081,6,7,1,24,49,1249
56693,56693,6684687C9F1041794E8237CE4D241C6F,10381,11,13,2,31,49,1599
56694,56694,6684687C9F1041794E8237CE4D241C6F,42081,13,14,1,24,49,1249
56695,56695,6684687C9F1041794E8237CE4D241C6F,10381,18,23,5,31,49,1599
56700,56700,DDC302F1F99EDC922514CC6D6B327E3E,43101,1,3,2,46,40,2340
56701,56701,DDC302F1F99EDC922514CC6D6B327E3E,13551,3,4,1,45,38,2288
56702,56702,DDC302F1F99EDC922514CC6D6B327E3E,12211,5,11,6,41,44,2094
56703,56703,DDC302F1F99EDC922514CC6D6B327E3E,43051,12,15,3,46,45,2345
56704,56704,DDC302F1F99EDC922514CC6D6B327E3E,12211,16,20,4,41,44,2094
56705,56705,DDC302F1F99EDC922514CC6D6B327E3E,43051,20,23,3,46,45,2345
56706,56706,FC32FCDE5EA162E6A3931CE10EF22190,11021,1,5,4,36,49,1849
56707,56707,FC32FCDE5EA162E6A3931CE10EF22190,11231,7,10,3,37,49,1899
56708,56708,FC32FCDE5EA162E6A3931CE10EF22190,11021,12,13,1,36,49,1849
56709,56709,FC32FCDE5EA162E6A3931CE10EF22190,11231,13,15,2,37,49,1899
56710,56710,FC32FCDE5EA162E6A3931CE10EF22190,11771,16,17,1,39,49,1999
56711,56711,FC32FCDE5EA162E6A3931CE10EF22190,11781,18,20,2,38,49,1949
56725,56725,8631F5DFCE39718648FAD1AB435C0892,12521,0,13,13,35,41,1791
56726,56726,8631F5DFCE39718648FAD1AB435C0892,13314,15,17,2,31,39,1589
56727,56727,8631F5DFCE39718648FAD1AB435C0892,12521,18,23,5,35,41,1791
56728,56728,842A1C1E3500FEFF04D25304E41263AF,13094,0,1,1,21,42,1092
56729,56729,842A1C1E3500FEFF04D25304E41263AF,13671,3,4,1,27,43,1393
56730,56730,842A1C1E3500FEFF04D25304E41263AF,12671,7,8,1,21,43,1093
56731,56731,842A1C1E3500FEFF04D25304E41263AF,13094,12,13,1,21,42,1092
56732,56732,842A1C1E3500FEFF04D25304E41263AF,10634,14,16,2,27,45,1395
56733,56733,842A1C1E3500FEFF04D25304E41263AF,12671,16,18,2,21,43,1093
56734,56734,842A1C1E3500FEFF04D25304E41263AF,13091,18,20,2,20,42,1042
56735,56735,842A1C1E3500FEFF04D25304E41263AF,12671,20,22,2,21,43,1093
56736,56736,4D9FAA243198ABD2878F91DE0173DAC7,42091,0,9,9,43,46,2196
56737,56737,4D9FAA243198ABD2878F91DE0173DAC7,42461,9,11,2,45,47,2297
56738,56738,4D9FAA243198ABD2878F91DE0173DAC7,10471,14,18,4,37,48,1898
56739,56739,4D9FAA243198ABD2878F91DE0173DAC7,42091,19,22,3,43,46,2196
56744,56744,FDF3A555382668B3FCFD730AFF8664D2,10411,0,7,7,36,48,1848
56745,56745,FDF3A555382668B3FCFD730AFF8664D2,10471,8,12,4,37,48,1898
56746,56746,FDF3A555382668B3FCFD730AFF8664D2,10411,12,14,2,36,48,1848
56747,56747,FDF3A555382668B3FCFD730AFF8664D2,11231,16,18,2,37,49,1899
56748,56748,FDF3A555382668B3FCFD730AFF8664D2,10411,21,23,2,36,48,1848
56756,56756,D3CDDFB071F66B902BF2188353AC6543,42331,0,6,6,39,46,1996
56757,56757,D3CDDFB071F66B902BF2188353AC6543,13121,6,8,2,38,46,1946
56758,56758,D3CDDFB071F66B902BF2188353AC6543,42331,10,12,2,39,46,1996
56759,56759,D3CDDFB071F66B902BF2188353AC6543,11794,13,16,3,38,49,1949
56760,56760,D3CDDFB071F66B902BF2188353AC6543,42331,18,20,2,39,46,1996
56761,56761,E7A499EFF2705CCA8F4C4AD8B684EDF4,11201,0,7,7,35,49,1799
56762,56762,E7A499EFF2705CCA8F4C4AD8B684EDF4,43761,8,10,2,32,47,1647
56763,56763,E7A499EFF2705CCA8F4C4AD8B684EDF4,12381,11,12,1,32,48,1648
56764,56764,E7A499EFF2705CCA8F4C4AD8B684EDF4,43761,15,17,2,32,47,1647
56765,56765,E7A499EFF2705CCA8F4C4AD8B684EDF4,11201,18,23,5,35,49,1799
56766,56766,F587555054424F7ED0D63829AAEB0C06,42271,0,2,2,40,47,2047
56767,56767,F587555054424F7ED0D63829AAEB0C06,11806,5,7,2,41,48,2098
56768,56768,F587555054424F7ED0D63829AAEB0C06,42271,10,11,1,40,47,2047
56769,56769,F587555054424F7ED0D63829AAEB0C06,11806,12,14,2,41,48,2098
56770,56770,F587555054424F7ED0D63829AAEB0C06,42271,14,16,2,40,47,2047
56771,56771,F587555054424F7ED0D63829AAEB0C06,11806,16,17,1,41,48,2098
56772,56772,F587555054424F7ED0D63829AAEB0C06,42271,19,22,3,40,47,2047
56773,56773,C5A50E1899339B932C05DE4F41561134,10107,0,6,6,38,49,1949
56774,56774,C5A50E1899339B932C05DE4F41561134,13121,7,11,4,38,46,1946
56775,56775,C5A50E1899339B932C05DE4F41561134,11461,11,13,2,37,49,1899
56776,56776,C5A50E1899339B932C05DE4F41561134,10107,13,18,5,38,49,1949
56777,56777,C5A50E1899339B932C05DE4F41561134,10661,19,21,2,37,49,1899
56778,56778,C5A50E1899339B932C05DE4F41561134,10107,21,23,2,38,49,1949
56779,56779,7AEC9C7CCBAB2805F6D8B21C69CF29C4,10681,0,5,5,30,48,1548
56780,56780,7AEC9C7CCBAB2805F6D8B21C69CF29C4,42071,7,9,2,31,49,1599
56781,56781,7AEC9C7CCBAB2805F6D8B21C69CF29C4,10681,11,13,2,30,48,1548
56782,56782,7AEC9C7CCBAB2805F6D8B21C69CF29C4,10381,17,18,1,31,49,1599
56783,56783,7AEC9C7CCBAB2805F6D8B21C69CF29C4,10681,19,23,4,30,48,1548
56794,56794,B33429D7A00DB66721EA07FF9AC9AB45,11861,0,9,9,32,47,1647
56795,56795,B33429D7A00DB66721EA07FF9AC9AB45,11231,10,22,12,37,49,1899
56796,56796,B33429D7A00DB66721EA07FF9AC9AB45,11861,22,23,1,32,47,1647
56797,56797,346BF3F539A4C5C04EF0491F7207CF76,19931,0,5,5,7,43,393
56798,56798,346BF3F539A4C5C04EF0491F7207CF76,12641,5,9,4,10,43,543
56799,56799,346BF3F539A4C5C04EF0491F7207CF76,19021,10,11,1,10,45,545
56800,56800,346BF3F539A4C5C04EF0491F7207CF76,12641,13,19,6,10,43,543
56801,56801,346BF3F539A4C5C04EF0491F7207CF76,19114,21,23,2,7,43,393
56802,56802,C604563143FE635BC3702ED9AD23A48A,19741,0,6,6,5,44,294
56803,56803,C604563143FE635BC3702ED9AD23A48A,19901,7,8,1,7,44,394
56804,56804,C604563143FE635BC3702ED9AD23A48A,12921,11,18,7,9,41,491
56805,56805,C604563143FE635BC3702ED9AD23A48A,19741,19,21,2,5,44,294
56806,56806,C604563143FE635BC3702ED9AD23A48A,19901,21,22,1,7,44,394
56810,56810,3B41A0EAD8F1C9D6A50E8875E4AEBCF3,10811,0,8,8,38,46,1946
56811,56811,3B41A0EAD8F1C9D6A50E8875E4AEBCF3,12601,12,15,3,25,47,1297
56812,56812,3B41A0EAD8F1C9D6A50E8875E4AEBCF3,10107,18,22,4,38,49,1949
56820,56820,49237ECED003BFEF5E21C688FECB20EC,19061,0,8,8,3,43,193
56821,56821,49237ECED003BFEF5E21C688FECB20EC,11061,11,13,2,29,48,1498
56822,56822,49237ECED003BFEF5E21C688FECB20EC,11151,13,14,1,30,48,1548
56823,56823,49237ECED003BFEF5E21C688FECB20EC,11061,14,16,2,29,48,1498
56824,56824,49237ECED003BFEF5E21C688FECB20EC,19061,18,23,5,3,43,193
56828,56828,CDD868B7CD2EE63A11365508386D7821,42371,0,6,6,34,46,1746
56829,56829,CDD868B7CD2EE63A11365508386D7821,42861,7,8,1,37,44,1894
56830,56830,CDD868B7CD2EE63A11365508386D7821,11261,9,10,1,36,46,1846
56831,56831,CDD868B7CD2EE63A11365508386D7821,42371,12,23,11,34,46,1746
56832,56832,765113C0EC03D9C2E8837F99909100D7,42401,0,6,6,36,47,1847
56833,56833,765113C0EC03D9C2E8837F99909100D7,10681,11,19,8,30,48,1548
56834,56834,765113C0EC03D9C2E8837F99909100D7,40637,20,22,2,36,47,1847
56841,56841,38EAD9C71E0631172BE43F523D61F0B8,42971,0,6,6,43,49,2199
56842,56842,38EAD9C71E0631172BE43F523D61F0B8,11381,7,9,2,30,47,1547
56843,56843,38EAD9C71E0631172BE43F523D61F0B8,42971,12,13,1,43,49,2199
56844,56844,38EAD9C71E0631172BE43F523D61F0B8,11381,16,18,2,30,47,1547
56845,56845,38EAD9C71E0631172BE43F523D61F0B8,42971,19,22,3,43,49,2199
56858,56858,BED9F796D66FF583DC7D48C0BD982207,10401,0,8,8,33,49,1699
56859,56859,BED9F796D66FF583DC7D48C0BD982207,19111,12,13,1,9,45,495
56860,56860,BED9F796D66FF583DC7D48C0BD982207,10401,15,21,6,33,49,1699
56861,56861,93DD2C863C5AA53C83002ED6F1D5AEBB,12641,1,4,3,10,43,543
56862,56862,93DD2C863C5AA53C83002ED6F1D5AEBB,19031,4,7,3,1,42,92
56863,56863,93DD2C863C5AA53C83002ED6F1D5AEBB,12921,7,10,3,9,41,491
56864,56864,93DD2C863C5AA53C83002ED6F1D5AEBB,19181,10,18,8,8,40,440
56865,56865,93DD2C863C5AA53C83002ED6F1D5AEBB,12641,21,23,2,10,43,543
56866,56866,769A4B655A8791659E24591F7D0C9788,11781,3,9,6,38,49,1949
56867,56867,769A4B655A8791659E24591F7D0C9788,11481,12,14,2,41,48,2098
56868,56868,769A4B655A8791659E24591F7D0C9788,40341,15,20,5,23,49,1199
56869,56869,5F14E1A15EFA1C13F8B10CBC543F107C,11521,0,1,1,41,48,2098
56870,56870,5F14E1A15EFA1C13F8B10CBC543F107C,10191,2,8,6,40,48,2048
56871,56871,5F14E1A15EFA1C13F8B10CBC543F107C,12581,11,15,4,24,48,1248
56872,56872,5F14E1A15EFA1C13F8B10CBC543F107C,11531,20,21,1,34,49,1749
56873,56873,5F14E1A15EFA1C13F8B10CBC543F107C,43361,22,23,1,38,48,1948
56874,56874,CA9F3291ABF3939E405884AD2ABE2445,11651,0,7,7,33,47,1697
56875,56875,CA9F3291ABF3939E405884AD2ABE2445,10281,9,10,1,33,48,1698
56876,56876,CA9F3291ABF3939E405884AD2ABE2445,43471,15,16,1,31,49,1599
56877,56877,CA9F3291ABF3939E405884AD2ABE2445,11151,16,18,2,30,48,1548
56878,56878,CA9F3291ABF3939E405884AD2ABE2445,11651,19,23,4,33,47,1697
56879,56879,414AA00EC00DAA3D830C87A4F3E4DD09,43981,0,3,3,36,49,1849
56880,56880,414AA00EC00DAA3D830C87A4F3E4DD09,11861,4,9,5,32,47,1647
56881,56881,414AA00EC00DAA3D830C87A4F3E4DD09,10731,9,11,2,33,47,1697
56882,56882,414AA00EC00DAA3D830C87A4F3E4DD09,10121,12,15,3,36,49,1849
56883,56883,414AA00EC00DAA3D830C87A4F3E4DD09,10731,18,19,1,33,47,1697
56884,56884,414AA00EC00DAA3D830C87A4F3E4DD09,10121,20,22,2,36,49,1849
56888,56888,EAEFCB977DEDF23C1346736B36A6F67B,13911,3,7,4,39,46,1996
56889,56889,EAEFCB977DEDF23C1346736B36A6F67B,42231,11,13,2,37,46,1896
56890,56890,EAEFCB977DEDF23C1346736B36A6F67B,13911,13,14,1,39,46,1996
56891,56891,EAEFCB977DEDF23C1346736B36A6F67B,42351,14,15,1,38,45,1945
56892,56892,EAEFCB977DEDF23C1346736B36A6F67B,11261,16,17,1,36,46,1846
56893,56893,EAEFCB977DEDF23C1346736B36A6F67B,42231,18,21,3,37,46,1896
56904,56904,7E361CF03F197FC1628B1CC780E8D87B,42071,1,2,1,31,49,1599
56905,56905,7E361CF03F197FC1628B1CC780E8D87B,42623,6,7,1,22,49,1149
56906,56906,7E361CF03F197FC1628B1CC780E8D87B,42071,8,21,13,31,49,1599
56907,56907,89EC37A7B83D9B7D194154C37975BD9C,42371,0,6,6,34,46,1746
56908,56908,89EC37A7B83D9B7D194154C37975BD9C,11061,7,13,6,29,48,1498
56909,56909,89EC37A7B83D9B7D194154C37975BD9C,43311,14,17,3,31,48,1598
56910,56910,89EC37A7B83D9B7D194154C37975BD9C,11061,20,22,2,29,48,1498
56911,56911,92AA74C025DCC8E1B6F69E40B85D2713,43971,0,7,7,30,48,1548
56912,56912,92AA74C025DCC8E1B6F69E40B85D2713,11074,8,14,6,37,47,1897
56913,56913,92AA74C025DCC8E1B6F69E40B85D2713,11061,17,19,2,29,48,1498
56914,56914,92AA74C025DCC8E1B6F69E40B85D2713,43971,22,23,1,30,48,1548
56918,56918,A86E5237C695D92EFD4F5A2CE0F53B38,13511,0,8,8,34,48,1748
56919,56919,A86E5237C695D92EFD4F5A2CE0F53B38,13094,9,11,2,21,42,1092
56920,56920,A86E5237C695D92EFD4F5A2CE0F53B38,13511,14,23,9,34,48,1748
56924,56924,8E7E1D3BA1392AF853A6068E181E9940,12971,0,8,8,32,48,1648
56925,56925,8E7E1D3BA1392AF853A6068E181E9940,10191,12,17,5,40,48,2048
56926,56926,8E7E1D3BA1392AF853A6068E181E9940,12971,19,22,3,32,48,1648
56931,56931,D5A1F589AD5A8A456E0D23A90489837D,43761,0,2,2,32,47,1647
56932,56932,D5A1F589AD5A8A456E0D23A90489837D,42523,3,4,1,31,47,1597
56933,56933,D5A1F589AD5A8A456E0D23A90489837D,43761,6,8,2,32,47,1647
56934,56934,D5A1F589AD5A8A456E0D23A90489837D,11231,8,17,9,37,49,1899
56935,56935,D5A1F589AD5A8A456E0D23A90489837D,43761,20,22,2,32,47,1647
56936,56936,4003E07D2A4AF66E84145561FFA003F3,10341,0,7,7,31,47,1597
56937,56937,4003E07D2A4AF66E84145561FFA003F3,10107,10,11,1,38,49,1949
56938,56938,4003E07D2A4AF66E84145561FFA003F3,10341,12,23,11,31,47,1597
56939,56939,8B3D2561F13388CB90E1E1F238F66E64,11521,2,4,2,41,48,2098
56940,56940,8B3D2561F13388CB90E1E1F238F66E64,11301,6,7,1,41,49,2099
56941,56941,8B3D2561F13388CB90E1E1F238F66E64,11521,8,13,5,41,48,2098
56942,56942,8B3D2561F13388CB90E1E1F238F66E64,11301,17,19,2,41,49,2099
56943,56943,8B3D2561F13388CB90E1E1F238F66E64,11521,19,23,4,41,48,2098
56944,56944,AF77E83C33BBDAC9BE49E19DF29439BD,13271,0,8,8,41,47,2097
56945,56945,AF77E83C33BBDAC9BE49E19DF29439BD,12083,8,9,1,36,49,1849
56946,56946,AF77E83C33BBDAC9BE49E19DF29439BD,10781,17,23,6,35,47,1797
56947,56947,A4265DF36EC4D506C1C8CDDE0D5AE15F,42351,5,6,1,38,45,1945
56948,56948,A4265DF36EC4D506C1C8CDDE0D5AE15F,19101,7,10,3,17,29,879
56949,56949,A4265DF36EC4D506C1C8CDDE0D5AE15F,49181,14,16,2,21,31,1081
56950,56950,A4265DF36EC4D506C1C8CDDE0D5AE15F,19101,17,18,1,17,29,879
56959,56959,3F201DBE531BBC02882A7373B189E19E,13601,1,9,8,34,47,1747
56960,56960,3F201DBE531BBC02882A7373B189E19E,49181,13,14,1,21,31,1081
56961,56961,3F201DBE531BBC02882A7373B189E19E,11151,16,18,2,30,48,1548
56962,56962,3DE4A793313E3991BF5DCB3E800E4DF3,11731,3,7,4,36,48,1848
56963,56963,3DE4A793313E3991BF5DCB3E800E4DF3,11701,10,12,2,43,48,2198
56964,56964,3DE4A793313E3991BF5DCB3E800E4DF3,40637,13,14,1,36,47,1847
56965,56965,3DE4A793313E3991BF5DCB3E800E4DF3,10491,16,18,2,33,48,1698
56969,56969,7EFD3351175BC84F17F315D53935E0ED,43581,0,8,8,33,48,1698
56970,56970,7EFD3351175BC84F17F315D53935E0ED,42401,9,12,3,36,47,1847
56971,56971,7EFD3351175BC84F17F315D53935E0ED,43581,13,14,1,33,48,1698
56972,56972,7EFD3351175BC84F17F315D53935E0ED,11324,15,16,1,31,46,1596
56973,56973,7EFD3351175BC84F17F315D53935E0ED,43581,19,23,4,33,48,1698
56974,56974,60EA8BA3C68F73C05BC0A731CC76BB3C,11231,9,11,2,37,49,1899
56975,56975,60EA8BA3C68F73C05BC0A731CC76BB3C,11481,12,14,2,41,48,2098
56976,56976,60EA8BA3C68F73C05BC0A731CC76BB3C,13271,19,23,4,41,47,2097
56977,56977,9A1CB6044954B6099E36F60F8EE95A99,11381,0,5,5,30,47,1547
56978,56978,9A1CB6044954B6099E36F60F8EE95A99,10951,9,10,1,29,48,1498
56979,56979,9A1CB6044954B6099E36F60F8EE95A99,11381,11,12,1,30,47,1547
56980,56980,9A1CB6044954B6099E36F60F8EE95A99,10951,15,17,2,29,48,1498
56981,56981,9A1CB6044954B6099E36F60F8EE95A99,11381,19,23,4,30,47,1547
56982,56982,EA462975F784E1573B5FADD38783B549,10771,0,7,7,41,46,2096
56983,56983,EA462975F784E1573B5FADD38783B549,11021,10,12,2,36,49,1849
56984,56984,EA462975F784E1573B5FADD38783B549,42471,14,15,1,35,49,1799
56985,56985,EA462975F784E1573B5FADD38783B549,11491,18,20,2,36,47,1847
56994,56994,15BA009B68D87958E0A9656ADB01E7D6,42461,0,3,3,45,47,2297
56995,56995,15BA009B68D87958E0A9656ADB01E7D6,42371,4,9,5,34,46,1746
56996,56996,15BA009B68D87958E0A9656ADB01E7D6,43001,13,22,9,47,47,2397
57000,57000,DAFE070AC8164EB683B9455E05DD84E1,13101,0,7,7,40,47,2047
57001,57001,DAFE070AC8164EB683B9455E05DD84E1,11481,10,12,2,41,48,2098
57002,57002,DAFE070AC8164EB683B9455E05DD84E1,40833,13,14,1,41,47,2097
57003,57003,DAFE070AC8164EB683B9455E05DD84E1,13101,14,15,1,40,47,2047
57004,57004,DAFE070AC8164EB683B9455E05DD84E1,11481,17,18,1,41,48,2098
57012,57012,FF54487E0B5C80FA4088AB1638FB8194,42581,3,9,6,38,48,1948
57013,57013,FF54487E0B5C80FA4088AB1638FB8194,11914,9,10,1,37,48,1898
57014,57014,FF54487E0B5C80FA4088AB1638FB8194,42581,11,14,3,38,48,1948
57015,57015,FF54487E0B5C80FA4088AB1638FB8194,11914,15,18,3,37,48,1898
57016,57016,FF54487E0B5C80FA4088AB1638FB8194,42581,18,19,1,38,48,1948
57017,57017,7B4C2325CA33D34061FB6C939C48DC6E,10292,0,17,17,30,47,1547
57018,57018,7B4C2325CA33D34061FB6C939C48DC6E,40341,18,21,3,23,49,1199
57019,57019,7B4C2325CA33D34061FB6C939C48DC6E,10292,22,23,1,30,47,1547
57034,57034,17A1A172CE7931359CB14ED91CF67C74,42921,0,3,3,33,47,1697
57035,57035,17A1A172CE7931359CB14ED91CF67C74,43731,4,7,3,34,47,1747
57036,57036,17A1A172CE7931359CB14ED91CF67C74,42921,11,12,1,33,47,1697
57037,57037,17A1A172CE7931359CB14ED91CF67C74,10971,15,17,2,35,47,1797
57038,57038,17A1A172CE7931359CB14ED91CF67C74,43731,17,20,3,34,47,1747
57051,57051,BF505F49996D253526DD5C9F172FD43D,42541,0,11,11,25,47,1297
57052,57052,BF505F49996D253526DD5C9F172FD43D,40951,12,15,3,36,49,1849
57053,57053,BF505F49996D253526DD5C9F172FD43D,42541,16,23,7,25,47,1297
57062,57062,19CB58B83E0268F55819CA90B47E2835,13094,0,16,16,21,42,1092
57063,57063,19CB58B83E0268F55819CA90B47E2835,13731,17,19,2,33,49,1699
57064,57064,19CB58B83E0268F55819CA90B47E2835,13094,22,23,1,21,42,1092
57065,57065,6C0E943C8B3CE3071E466B3888DE833C,42531,6,11,5,31,45,1595
57066,57066,6C0E943C8B3CE3071E466B3888DE833C,12311,11,12,1,30,44,1544
57067,57067,6C0E943C8B3CE3071E466B3888DE833C,42531,13,17,4,31,45,1595
57068,57068,6C0E943C8B3CE3071E466B3888DE833C,19744,18,21,3,6,43,343
57075,57075,EDBEDCDD3729803D79956D4495DD48D8,42864,1,9,8,38,44,1944
57076,57076,EDBEDCDD3729803D79956D4495DD48D8,42861,9,10,1,37,44,1894
57077,57077,EDBEDCDD3729803D79956D4495DD48D8,42351,12,13,1,38,45,1945
57078,57078,EDBEDCDD3729803D79956D4495DD48D8,42864,16,18,2,38,44,1944
57079,57079,EDBEDCDD3729803D79956D4495DD48D8,13231,19,21,2,39,46,1996
57089,57089,715F7A42E71CC3B03C35CCDCAA47978E,19181,0,5,5,8,40,440
57090,57090,715F7A42E71CC3B03C35CCDCAA47978E,12641,6,8,2,10,43,543
57091,57091,715F7A42E71CC3B03C35CCDCAA47978E,19031,11,13,2,1,42,92
57092,57092,715F7A42E71CC3B03C35CCDCAA47978E,19181,17,21,4,8,40,440
57093,57093,7AC35691CEC972E8C6B9D3B917FB9E44,13111,0,3,3,42,46,2146
57094,57094,7AC35691CEC972E8C6B9D3B917FB9E44,43061,4,15,11,43,46,2196
57095,57095,7AC35691CEC972E8C6B9D3B917FB9E44,10921,19,20,1,43,48,2198
57096,57096,7AC35691CEC972E8C6B9D3B917FB9E44,11074,20,22,2,37,47,1897
57101,57101,59C9891991D18AB42F5CA2A676EAFEE0,42501,0,7,7,28,47,1447
57102,57102,59C9891991D18AB42F5CA2A676EAFEE0,19441,11,16,5,8,46,446
57103,57103,59C9891991D18AB42F5CA2A676EAFEE0,42501,19,23,4,28,47,1447
57104,57104,BA6D45213D52989026A398B5D7995374,12641,1,4,3,10,43,543
57105,57105,BA6D45213D52989026A398B5D7995374,43021,6,16,10,16,43,843
57106,57106,BA6D45213D52989026A398B5D7995374,19181,18,19,1,8,40,440
57107,57107,BA6D45213D52989026A398B5D7995374,43644,20,21,1,14,38,738
57111,57111,37BD03DA3640C8FC43CC9AEC3929D65F,12792,3,5,2,34,30,1730
57112,57112,37BD03DA3640C8FC43CC9AEC3929D65F,15391,8,12,4,35,26,1776
57113,57113,37BD03DA3640C8FC43CC9AEC3929D65F,12792,17,19,2,34,30,1730
57114,57114,37BD03DA3640C8FC43CC9AEC3929D65F,15091,21,22,1,35,26,1776
57115,57115,AF45D7FF91ADC8A42EE1BE638B4AB9CE,13271,0,1,1,41,47,2097
57116,57116,AF45D7FF91ADC8A42EE1BE638B4AB9CE,41392,2,7,5,43,48,2198
57117,57117,AF45D7FF91ADC8A42EE1BE638B4AB9CE,11481,8,9,1,41,48,2098
57118,57118,AF45D7FF91ADC8A42EE1BE638B4AB9CE,13271,13,16,3,41,47,2097
57119,57119,AF45D7FF91ADC8A42EE1BE638B4AB9CE,10924,19,23,4,43,49,2199
57124,57124,A5A342C5B79B8AEE00BA80AE678B8EC5,10331,0,7,7,39,46,1996
57125,57125,A5A342C5B79B8AEE00BA80AE678B8EC5,11151,8,10,2,30,48,1548
57126,57126,A5A342C5B79B8AEE00BA80AE678B8EC5,10331,12,23,11,39,46,1996
57127,57127,C94109F455448027CE60D8FE61F82261,10681,9,11,2,30,48,1548
57128,57128,C94109F455448027CE60D8FE61F82261,42623,14,18,4,22,49,1149
57129,57129,C94109F455448027CE60D8FE61F82261,42071,19,20,1,31,49,1599
57130,57130,C94109F455448027CE60D8FE61F82261,42623,22,23,1,22,49,1149
57134,57134,1B79EB886A5576DB94A20A87F2358771,43751,0,7,7,19,48,998
57135,57135,1B79EB886A5576DB94A20A87F2358771,42681,7,8,1,24,48,1248
57136,57136,1B79EB886A5576DB94A20A87F2358771,43751,11,23,12,19,48,998
57146,57146,292AD485DA7AE4FB3CFCA1190DC036DF,42151,0,5,5,35,45,1795
57147,57147,292AD485DA7AE4FB3CFCA1190DC036DF,12311,5,9,4,30,44,1544
57148,57148,292AD485DA7AE4FB3CFCA1190DC036DF,42151,11,12,1,35,45,1795
57149,57149,292AD485DA7AE4FB3CFCA1190DC036DF,10811,13,18,5,38,46,1946
57150,57150,292AD485DA7AE4FB3CFCA1190DC036DF,42151,20,23,3,35,45,1795
57161,57161,5E5B8BD5A45989C5961863EEA9C95971,11261,0,1,1,36,46,1846
57162,57162,5E5B8BD5A45989C5961863EEA9C95971,15651,2,9,7,39,25,1975
57163,57163,5E5B8BD5A45989C5961863EEA9C95971,11021,12,18,6,36,49,1849
57164,57164,5E5B8BD5A45989C5961863EEA9C95971,15651,20,23,3,39,25,1975
57169,57169,47C439CCDB64ED25CC847E4AB6F5434E,13341,0,12,12,44,45,2245
57170,57170,47C439CCDB64ED25CC847E4AB6F5434E,13221,13,15,2,40,47,2047
57171,57171,47C439CCDB64ED25CC847E4AB6F5434E,13341,17,19,2,44,45,2245
57172,57172,47C439CCDB64ED25CC847E4AB6F5434E,42201,19,20,1,43,46,2196
57173,57173,47C439CCDB64ED25CC847E4AB6F5434E,13341,21,22,1,44,45,2245
57174,57174,B40A8C93BC170D4E6E266C926BF7EED2,12971,0,19,19,32,48,1648
57175,57175,B40A8C93BC170D4E6E266C926BF7EED2,11021,19,21,2,36,49,1849
57176,57176,B40A8C93BC170D4E6E266C926BF7EED2,12971,21,23,2,32,48,1648
57180,57180,5F17942389EDB952EA52D3EC24EE812F,10341,0,7,7,31,47,1597
57181,57181,5F17942389EDB952EA52D3EC24EE812F,10841,7,13,6,37,47,1897
57182,57182,5F17942389EDB952EA52D3EC24EE812F,10341,14,23,9,31,47,1597
57183,57183,3877B8E5CE9312BFA7CD973C0152DE3C,10841,1,7,6,37,47,1897
57184,57184,3877B8E5CE9312BFA7CD973C0152DE3C,40055,11,14,3,31,49,1599
57185,57185,3877B8E5CE9312BFA7CD973C0152DE3C,11521,15,17,2,41,48,2098
57186,57186,3877B8E5CE9312BFA7CD973C0152DE3C,12514,20,23,3,38,47,1947
57187,57187,162D30EFD5CA4325D477F0E2F771C8CB,42801,0,2,2,40,49,2049
57188,57188,162D30EFD5CA4325D477F0E2F771C8CB,40361,2,3,1,42,48,2148
57189,57189,162D30EFD5CA4325D477F0E2F771C8CB,11481,4,6,2,41,48,2098
57190,57190,162D30EFD5CA4325D477F0E2F771C8CB,13101,7,8,1,40,47,2047
57191,57191,162D30EFD5CA4325D477F0E2F771C8CB,40361,13,20,7,42,48,2148
57206,57206,440A5BC995406F5A39B97937FE6675EC,12641,2,6,4,10,43,543
57207,57207,440A5BC995406F5A39B97937FE6675EC,12921,6,8,2,9,41,491
57208,57208,440A5BC995406F5A39B97937FE6675EC,12641,8,10,2,10,43,543
57209,57209,440A5BC995406F5A39B97937FE6675EC,19114,15,17,2,7,43,393
57210,57210,440A5BC995406F5A39B97937FE6675EC,12641,18,23,5,10,43,543
57215,57215,71AB304A084EB4095E1F705C48CB0E23,11901,0,7,7,42,49,2149
57216,57216,71AB304A084EB4095E1F705C48CB0E23,11914,9,18,9,37,48,1898
57217,57217,71AB304A084EB4095E1F705C48CB0E23,11901,21,22,1,42,49,2149
57221,57221,660D2150C1391153938CD9B90E2CE919,43021,0,5,5,16,43,843
57222,57222,660D2150C1391153938CD9B90E2CE919,19021,6,20,14,10,45,545
57223,57223,660D2150C1391153938CD9B90E2CE919,43021,21,23,2,16,43,843
57224,57224,CC542EA3A72441C176DD8B2A582775E3,40637,0,8,8,36,47,1847
57225,57225,CC542EA3A72441C176DD8B2A582775E3,12141,9,10,1,42,45,2145
57226,57226,CC542EA3A72441C176DD8B2A582775E3,11001,12,15,3,42,47,2147
57227,57227,CC542EA3A72441C176DD8B2A582775E3,10371,16,21,5,37,49,1899
57234,57234,AD3EDA3142ED65E7DCEA2ECC9D2EC5AC,11631,0,6,6,12,49,649
57235,57235,AD3EDA3142ED65E7DCEA2ECC9D2EC5AC,42041,6,7,1,10,47,547
57236,57236,AD3EDA3142ED65E7DCEA2ECC9D2EC5AC,12921,8,10,2,9,41,491
57237,57237,AD3EDA3142ED65E7DCEA2ECC9D2EC5AC,19021,17,20,3,10,45,545
57238,57238,AD3EDA3142ED65E7DCEA2ECC9D2EC5AC,11631,21,23,2,12,49,649
57239,57239,E07DFD25EAC694A41002C6648E3A4E3C,42021,0,7,7,33,47,1697
57240,57240,E07DFD25EAC694A41002C6648E3A4E3C,42771,13,14,1,36,47,1847
57241,57241,E07DFD25EAC694A41002C6648E3A4E3C,11921,15,23,8,38,48,1948
57246,57246,AA8CC60B06B8E7A334E7FA04353D8EED,42864,2,10,8,38,44,1944
57247,57247,AA8CC60B06B8E7A334E7FA04353D8EED,42351,12,15,3,38,45,1945
57248,57248,AA8CC60B06B8E7A334E7FA04353D8EED,11261,17,18,1,36,46,1846
57249,57249,AA8CC60B06B8E7A334E7FA04353D8EED,10171,19,20,1,26,47,1347
57253,57253,9B628FEA6BCA8EB97BB3F7B5F63CD306,13911,0,6,6,39,46,1996
57254,57254,9B628FEA6BCA8EB97BB3F7B5F63CD306,43761,7,19,12,32,47,1647
57255,57255,9B628FEA6BCA8EB97BB3F7B5F63CD306,13911,22,23,1,39,46,1996
57259,57259,5A136F6B72A92895FAEED5900AD9C82B,11111,0,5,5,26,48,1348
57260,57260,5A136F6B72A92895FAEED5900AD9C82B,42461,6,8,2,45,47,2297
57261,57261,5A136F6B72A92895FAEED5900AD9C82B,11111,13,23,10,26,48,1348
57281,57281,A9293E19E3F8F241225FE195687A6529,11521,0,14,14,41,48,2098
57282,57282,A9293E19E3F8F241225FE195687A6529,42801,15,17,2,40,49,2049
57283,57283,A9293E19E3F8F241225FE195687A6529,11061,18,19,1,29,48,1498
57284,57284,A9293E19E3F8F241225FE195687A6529,10681,19,21,2,30,48,1548
57285,57285,6224797A94401F7316FE4DF239A66FE7,43234,0,1,1,37,49,1899
57286,57286,6224797A94401F7316FE4DF239A66FE7,12561,3,20,17,45,43,2293
57287,57287,6224797A94401F7316FE4DF239A66FE7,13741,22,23,1,37,49,1899
57294,57294,A0E829F4319BFCF37BA7414AFCB09FF1,42221,1,7,6,38,48,1948
57295,57295,A0E829F4319BFCF37BA7414AFCB09FF1,11074,7,8,1,37,47,1897
57296,57296,A0E829F4319BFCF37BA7414AFCB09FF1,42221,11,15,4,38,48,1948
57297,57297,A0E829F4319BFCF37BA7414AFCB09FF1,11074,19,21,2,37,47,1897
57298,57298,A0E829F4319BFCF37BA7414AFCB09FF1,42221,21,22,1,38,48,1948
57303,57303,ECBC886277109C0582E65AB313F27C1C,13314,0,5,5,31,39,1589
57304,57304,ECBC886277109C0582E65AB313F27C1C,12521,8,20,12,35,41,1791
57305,57305,ECBC886277109C0582E65AB313F27C1C,13314,22,23,1,31,39,1589
57316,57316,C493E8EAD829832CA31397E82BE4990B,43021,0,5,5,16,43,843
57317,57317,C493E8EAD829832CA31397E82BE4990B,12921,6,7,1,9,41,491
57318,57318,C493E8EAD829832CA31397E82BE4990B,43021,11,13,2,16,43,843
57319,57319,C493E8EAD829832CA31397E82BE4990B,12641,14,16,2,10,43,543
57320,57320,C493E8EAD829832CA31397E82BE4990B,43021,17,23,6,16,43,843
57328,57328,091497AD7ED956A0C3F93F46CFB651F5,43021,0,5,5,16,43,843
57329,57329,091497AD7ED956A0C3F93F46CFB651F5,12921,7,9,2,9,41,491
57330,57330,091497AD7ED956A0C3F93F46CFB651F5,43021,11,23,12,16,43,843
57344,57344,20DF900F635B4BA066D178290261D490,10351,0,8,8,28,45,1445
57345,57345,20DF900F635B4BA066D178290261D490,10107,10,14,4,38,49,1949
57346,57346,20DF900F635B4BA066D178290261D490,12601,18,20,2,25,47,1297
57358,57358,DC108CA51A8D783261AB9156C36F59F1,12601,6,15,9,25,47,1297
57359,57359,DC108CA51A8D783261AB9156C36F59F1,13771,19,21,2,21,45,1095
57360,57360,DC108CA51A8D783261AB9156C36F59F1,12601,21,23,2,25,47,1297
57361,57361,8DB618DDA1266709AAF971BEF0B00244,43731,0,7,7,34,47,1747
57362,57362,8DB618DDA1266709AAF971BEF0B00244,10041,9,13,4,39,49,1999
57363,57363,8DB618DDA1266709AAF971BEF0B00244,43731,16,17,1,34,47,1747
57364,57364,8DB618DDA1266709AAF971BEF0B00244,11751,18,20,2,35,48,1798
57368,57368,43C939482399D8B1D73F2A9222B5E5D5,12381,2,8,6,32,48,1648
57369,57369,43C939482399D8B1D73F2A9222B5E5D5,43361,19,21,2,38,48,1948
57370,57370,43C939482399D8B1D73F2A9222B5E5D5,10491,21,23,2,33,48,1698
57371,57371,C187943D20D187183526E0228C45660E,11021,0,12,12,36,49,1849
57372,57372,C187943D20D187183526E0228C45660E,12381,13,18,5,32,48,1648
57373,57373,C187943D20D187183526E0228C45660E,11021,19,23,4,36,49,1849
57374,57374,67E463A97F2732907F7B14F7E69E6FDD,11861,0,8,8,32,47,1647
57375,57375,67E463A97F2732907F7B14F7E69E6FDD,13491,13,14,1,48,39,2439
57376,57376,67E463A97F2732907F7B14F7E69E6FDD,11001,16,18,2,42,47,2147
57377,57377,67E463A97F2732907F7B14F7E69E6FDD,40637,18,20,2,36,47,1847
57378,57378,67E463A97F2732907F7B14F7E69E6FDD,11861,20,23,3,32,47,1647
57385,57385,58DF9134CE7D050646261F7665F2B298,42921,0,15,15,33,47,1697
57386,57386,58DF9134CE7D050646261F7665F2B298,11861,16,18,2,32,47,1647
57387,57387,58DF9134CE7D050646261F7665F2B298,40341,19,20,1,23,49,1199
57391,57391,8592E1C985A759FC3B42CBBCB4596B63,10841,0,10,10,37,47,1897
57392,57392,8592E1C985A759FC3B42CBBCB4596B63,15114,12,13,1,22,16,1116
57393,57393,8592E1C985A759FC3B42CBBCB4596B63,16441,13,17,4,15,17,767
57394,57394,8592E1C985A759FC3B42CBBCB4596B63,10841,20,23,3,37,47,1897
57395,57395,F4A5CE128B0276BA64A57CF9F5D60F74,42831,0,14,14,27,48,1398
57396,57396,F4A5CE128B0276BA64A57CF9F5D60F74,11201,17,20,3,35,49,1799
57397,57397,F4A5CE128B0276BA64A57CF9F5D60F74,42831,22,23,1,27,48,1398
57405,57405,E806AC20159D095165198DB5812DB77E,11031,0,7,7,42,49,2149
57406,57406,E806AC20159D095165198DB5812DB77E,40951,12,14,2,36,49,1849
57407,57407,E806AC20159D095165198DB5812DB77E,12521,15,23,8,35,41,1791
57411,57411,055392723CC93B49A610878855A95D5B,11471,0,7,7,12,48,648
57412,57412,055392723CC93B49A610878855A95D5B,11381,10,12,2,30,47,1547
57413,57413,055392723CC93B49A610878855A95D5B,19901,14,15,1,7,44,394
57414,57414,055392723CC93B49A610878855A95D5B,19441,19,21,2,8,46,446
57428,57428,9063D9BC124B90056525B5B4C08304A4,13111,1,3,2,42,46,2146
57429,57429,9063D9BC124B90056525B5B4C08304A4,42461,4,6,2,45,47,2297
57430,57430,9063D9BC124B90056525B5B4C08304A4,13111,7,16,9,42,46,2146
57431,57431,9063D9BC124B90056525B5B4C08304A4,42461,18,19,1,45,47,2297
57432,57432,9063D9BC124B90056525B5B4C08304A4,13111,20,21,1,42,46,2146
57436,57436,4D4354448E6EA09F1B4E4241448CDCDF,11381,0,16,16,30,47,1547
57437,57437,4D4354448E6EA09F1B4E4241448CDCDF,10107,19,21,2,38,49,1949
57438,57438,4D4354448E6EA09F1B4E4241448CDCDF,13651,21,22,1,30,47,1547
57445,57445,2873DE93703B028193B7B9719DCFE691,12521,0,6,6,35,41,1791
57446,57446,2873DE93703B028193B7B9719DCFE691,43451,7,10,3,37,40,1890
57447,57447,2873DE93703B028193B7B9719DCFE691,12521,11,13,2,35,41,1791
57448,57448,2873DE93703B028193B7B9719DCFE691,43451,14,17,3,37,40,1890
57449,57449,2873DE93703B028193B7B9719DCFE691,12521,17,23,6,35,41,1791
57450,57450,784B731FB48DA266D31BFD4ACBDB8A39,11021,0,8,8,36,49,1849
57451,57451,784B731FB48DA266D31BFD4ACBDB8A39,11211,9,10,1,34,49,1749
57452,57452,784B731FB48DA266D31BFD4ACBDB8A39,11021,13,15,2,36,49,1849
57453,57453,784B731FB48DA266D31BFD4ACBDB8A39,11521,16,18,2,41,48,2098
57454,57454,784B731FB48DA266D31BFD4ACBDB8A39,11021,19,23,4,36,49,1849
57455,57455,6B614428F8D95ECFDE2207017437E97D,12871,2,3,1,22,33,1133
57456,57456,6B614428F8D95ECFDE2207017437E97D,19281,4,6,2,16,32,832
57457,57457,6B614428F8D95ECFDE2207017437E97D,12871,6,11,5,22,33,1133
57458,57458,6B614428F8D95ECFDE2207017437E97D,19281,11,13,2,16,32,832
57459,57459,6B614428F8D95ECFDE2207017437E97D,12871,14,15,1,22,33,1133
57460,57460,6B614428F8D95ECFDE2207017437E97D,19281,16,17,1,16,32,832
57461,57461,6B614428F8D95ECFDE2207017437E97D,12871,21,22,1,22,33,1133
57462,57462,2D473AEE4EAA77528353079765891883,13371,0,7,7,41,47,2097
57463,57463,2D473AEE4EAA77528353079765891883,13411,12,13,1,49,42,2492
57464,57464,2D473AEE4EAA77528353079765891883,13121,17,18,1,38,46,1946
57465,57465,2D473AEE4EAA77528353079765891883,13371,19,23,4,41,47,2097
57466,57466,53D8E731DA65650E5B825C52CF592433,10221,0,2,2,34,49,1749
57467,57467,53D8E731DA65650E5B825C52CF592433,11261,4,17,13,36,46,1846
57468,57468,53D8E731DA65650E5B825C52CF592433,11201,22,23,1,35,49,1799
57480,57480,B6E9309FA7D43AFD3A7CFE461464285B,12521,0,13,13,35,41,1791
57481,57481,B6E9309FA7D43AFD3A7CFE461464285B,11074,17,18,1,37,47,1897
57482,57482,B6E9309FA7D43AFD3A7CFE461464285B,12521,20,23,3,35,41,1791
57483,57483,7DD9E91F4EBA77140FFEB3FB0235C15D,42523,3,7,4,31,47,1597
57484,57484,7DD9E91F4EBA77140FFEB3FB0235C15D,42491,8,9,1,32,46,1646
57485,57485,7DD9E91F4EBA77140FFEB3FB0235C15D,10292,12,13,1,30,47,1547
57486,57486,7DD9E91F4EBA77140FFEB3FB0235C15D,42523,17,18,1,31,47,1597
57487,57487,7DD9E91F4EBA77140FFEB3FB0235C15D,10292,22,23,1,30,47,1547
57488,57488,15AF53FBA0C13FBD61024895398ED2FD,19441,0,15,15,8,46,446
57489,57489,15AF53FBA0C13FBD61024895398ED2FD,11471,16,17,1,12,48,648
57490,57490,15AF53FBA0C13FBD61024895398ED2FD,42041,18,19,1,10,47,547
57491,57491,15AF53FBA0C13FBD61024895398ED2FD,19441,21,22,1,8,46,446
57492,57492,6BF85B7300ADAE0F83C20B2AF5821019,12083,0,2,2,36,49,1849
57493,57493,6BF85B7300ADAE0F83C20B2AF5821019,11231,2,5,3,37,49,1899
57494,57494,6BF85B7300ADAE0F83C20B2AF5821019,11381,6,17,11,30,47,1547
57495,57495,6BF85B7300ADAE0F83C20B2AF5821019,12391,20,22,2,36,49,1849
57496,57496,6AD981E757B177FB5B64F1D1D2EAA27F,11875,0,8,8,30,46,1546
57497,57497,6AD981E757B177FB5B64F1D1D2EAA27F,10401,11,14,3,33,49,1699
57498,57498,6AD981E757B177FB5B64F1D1D2EAA27F,10221,17,19,2,34,49,1749
57499,57499,474A8DACA51CB40E50178AB2BE706270,11806,1,7,6,41,48,2098
57500,57500,474A8DACA51CB40E50178AB2BE706270,11074,12,13,1,37,47,1897
57501,57501,474A8DACA51CB40E50178AB2BE706270,11806,22,23,1,41,48,2098
57511,57511,A7889E15E0F93853EAB5CF324793B9C0,15411,0,2,2,44,27,2227
57512,57512,A7889E15E0F93853EAB5CF324793B9C0,12611,5,11,6,41,29,2079
57513,57513,A7889E15E0F93853EAB5CF324793B9C0,15411,14,18,4,44,27,2227
57514,57514,A7889E15E0F93853EAB5CF324793B9C0,12611,19,20,1,41,29,2079
57518,57518,6F317B69EA801FB687874B22E0146514,10431,1,12,11,33,49,1699
57519,57519,6F317B69EA801FB687874B22E0146514,40951,13,14,1,36,49,1849
57520,57520,6F317B69EA801FB687874B22E0146514,40341,18,21,3,23,49,1199
57521,57521,DC15358175A492C6F21AAEFAD4CD0BB7,42401,0,11,11,36,47,1847
57522,57522,DC15358175A492C6F21AAEFAD4CD0BB7,10681,13,14,1,30,48,1548
57523,57523,DC15358175A492C6F21AAEFAD4CD0BB7,11061,15,21,6,29,48,1498
57527,57527,F552BBAFE22D025B0F7E0055A73A2709,42511,2,11,9,37,47,1897
57528,57528,F552BBAFE22D025B0F7E0055A73A2709,42321,13,14,1,43,47,2197
57529,57529,F552BBAFE22D025B0F7E0055A73A2709,10731,17,19,2,33,47,1697
57530,57530,F552BBAFE22D025B0F7E0055A73A2709,42161,21,22,1,36,47,1847
57531,57531,13CD2CA805383E5350152A018CBC81B2,43041,0,15,15,41,46,2096
57532,57532,13CD2CA805383E5350152A018CBC81B2,42381,19,20,1,39,41,1991
57533,57533,13CD2CA805383E5350152A018CBC81B2,43341,21,23,2,41,46,2096
57534,57534,A6FD529C3EA66C1845775EA07FC46A8F,12601,0,13,13,25,47,1297
57535,57535,A6FD529C3EA66C1845775EA07FC46A8F,12051,14,16,2,20,47,1047
57536,57536,A6FD529C3EA66C1845775EA07FC46A8F,12601,17,23,6,25,47,1297
57537,57537,096FC9A1279CCD25D0E8126298EE77CC,12401,0,8,8,39,49,1999
57538,57538,096FC9A1279CCD25D0E8126298EE77CC,19114,11,12,1,7,43,393
57539,57539,096FC9A1279CCD25D0E8126298EE77CC,12381,14,23,9,32,48,1648
57540,57540,F626495227975BB47CEFB095B49D9899,42191,0,2,2,38,49,1949
57541,57541,F626495227975BB47CEFB095B49D9899,10931,2,7,5,41,48,2098
57542,57542,F626495227975BB47CEFB095B49D9899,40951,10,11,1,36,49,1849
57543,57543,F626495227975BB47CEFB095B49D9899,13561,13,17,4,37,49,1899
57544,57544,F626495227975BB47CEFB095B49D9899,43281,21,23,2,37,48,1898
57545,57545,AA9DDBAE747C0C61A76E689DD898E315,42301,0,6,6,36,47,1847
57546,57546,AA9DDBAE747C0C61A76E689DD898E315,12311,7,11,4,30,44,1544
57547,57547,AA9DDBAE747C0C61A76E689DD898E315,42871,14,16,2,30,45,1545
57548,57548,AA9DDBAE747C0C61A76E689DD898E315,42301,18,23,5,36,47,1847
57549,57549,32DCF9B9C7944C965DC3FD9593FC89B0,12381,0,8,8,32,48,1648
57550,57550,32DCF9B9C7944C965DC3FD9593FC89B0,11074,10,12,2,37,47,1897
57551,57551,32DCF9B9C7944C965DC3FD9593FC89B0,12381,17,23,6,32,48,1648
57555,57555,34C2C19E72E3A8BD954F8F220235C379,10211,0,16,16,16,49,849
57556,57556,34C2C19E72E3A8BD954F8F220235C379,10731,17,20,3,33,47,1697
57557,57557,34C2C19E72E3A8BD954F8F220235C379,10211,21,23,2,16,49,849
57564,57564,1D97C2B8AE25FD6D750E89FD17CF4C90,42011,0,7,7,36,46,1846
57565,57565,1D97C2B8AE25FD6D750E89FD17CF4C90,10271,8,9,1,37,46,1896
57566,57566,1D97C2B8AE25FD6D750E89FD17CF4C90,40341,12,18,6,23,49,1199
57567,57567,CCE6FF71F1C58ADC8D7C29AFD1955DDD,12601,0,6,6,25,47,1297
57568,57568,CCE6FF71F1C58ADC8D7C29AFD1955DDD,10634,10,18,8,27,45,1395
57569,57569,CCE6FF71F1C58ADC8D7C29AFD1955DDD,12311,21,22,1,30,44,1544
57570,57570,400659CE2E6F8BFF6D95D6F52F73DF5B,42921,0,6,6,33,47,1697
57571,57571,400659CE2E6F8BFF6D95D6F52F73DF5B,11861,6,11,5,32,47,1647
57572,57572,400659CE2E6F8BFF6D95D6F52F73DF5B,42921,12,13,1,33,47,1697
57573,57573,400659CE2E6F8BFF6D95D6F52F73DF5B,11861,14,19,5,32,47,1647
57574,57574,400659CE2E6F8BFF6D95D6F52F73DF5B,42921,21,22,1,33,47,1697
57578,57578,44A4FB529FCBB8DDAABFBF11E33C0885,10901,0,12,12,35,48,1798
57579,57579,44A4FB529FCBB8DDAABFBF11E33C0885,42981,15,16,1,36,49,1849
57580,57580,44A4FB529FCBB8DDAABFBF11E33C0885,42523,19,20,1,31,47,1597
57581,57581,71406CAB7DAA1D3016D1EDF130C6F573,10491,0,6,6,33,48,1698
57582,57582,71406CAB7DAA1D3016D1EDF130C6F573,10431,11,12,1,33,49,1699
57583,57583,71406CAB7DAA1D3016D1EDF130C6F573,10691,14,15,1,33,48,1698
57584,57584,71406CAB7DAA1D3016D1EDF130C6F573,10431,16,17,1,33,49,1699
57585,57585,71406CAB7DAA1D3016D1EDF130C6F573,10491,18,23,5,33,48,1698
57603,57603,29CCFF89800AD184CF93EA13427035C5,42321,0,8,8,43,47,2197
57604,57604,29CCFF89800AD184CF93EA13427035C5,12481,13,16,3,37,49,1899
57605,57605,29CCFF89800AD184CF93EA13427035C5,43621,20,23,3,46,48,2348
57606,57606,6328F7CDE1FD4A3418797D65E47142EC,12051,9,17,8,20,47,1047
57607,57607,6328F7CDE1FD4A3418797D65E47142EC,10381,17,19,2,31,49,1599
57608,57608,6328F7CDE1FD4A3418797D65E47142EC,11151,20,23,3,30,48,1548
57609,57609,F475546FA2D112D7D0EDED3FAB477F8E,40801,0,14,14,43,46,2196
57610,57610,F475546FA2D112D7D0EDED3FAB477F8E,10251,15,18,3,35,47,1797
57611,57611,F475546FA2D112D7D0EDED3FAB477F8E,40801,21,23,2,43,46,2196
57621,57621,35399B0228CBBED01E96558B12371010,41601,0,13,13,39,49,1999
57622,57622,35399B0228CBBED01E96558B12371010,10061,15,16,1,20,46,1046
57623,57623,35399B0228CBBED01E96558B12371010,11771,18,23,5,39,49,1999
57631,57631,1A71FA18AA428C4DDAD1FCB8BD6DCCEA,42281,0,6,6,40,48,2048
57632,57632,1A71FA18AA428C4DDAD1FCB8BD6DCCEA,10401,7,8,1,33,49,1699
57633,57633,1A71FA18AA428C4DDAD1FCB8BD6DCCEA,43731,9,10,1,34,47,1747
57634,57634,1A71FA18AA428C4DDAD1FCB8BD6DCCEA,10401,10,15,5,33,49,1699
57635,57635,1A71FA18AA428C4DDAD1FCB8BD6DCCEA,43581,16,18,2,33,48,1698
57636,57636,1A71FA18AA428C4DDAD1FCB8BD6DCCEA,42281,20,23,3,40,48,2048
57647,57647,13D5A740D06FDF47CE4C2F348851D93D,13071,0,8,8,41,41,2091
57648,57648,13D5A740D06FDF47CE4C2F348851D93D,43101,9,11,2,46,40,2340
57649,57649,13D5A740D06FDF47CE4C2F348851D93D,13071,11,14,3,41,41,2091
57650,57650,13D5A740D06FDF47CE4C2F348851D93D,43101,15,17,2,46,40,2340
57651,57651,13D5A740D06FDF47CE4C2F348851D93D,13071,18,22,4,41,41,2091
57652,57652,4FB7544A1E67AE742452DB3735E5F7CF,11001,0,3,3,42,47,2147
57653,57653,4FB7544A1E67AE742452DB3735E5F7CF,10771,4,6,2,41,46,2096
57654,57654,4FB7544A1E67AE742452DB3735E5F7CF,43951,9,11,2,49,41,2491
57655,57655,4FB7544A1E67AE742452DB3735E5F7CF,12561,11,13,2,45,43,2293
57656,57656,4FB7544A1E67AE742452DB3735E5F7CF,43951,14,15,1,49,41,2491
57657,57657,4FB7544A1E67AE742452DB3735E5F7CF,13111,19,21,2,42,46,2146
57658,57658,5F068FFF5DB78DAEC6DA0E87FB2125BF,11871,9,16,7,29,46,1496
57659,57659,5F068FFF5DB78DAEC6DA0E87FB2125BF,12581,19,20,1,24,48,1248
57660,57660,5F068FFF5DB78DAEC6DA0E87FB2125BF,12051,21,23,2,20,47,1047
57670,57670,12CD49247659842CCDEA8C017DBD960B,43621,5,10,5,46,48,2348
57671,57671,12CD49247659842CCDEA8C017DBD960B,11701,14,15,1,43,48,2198
57672,57672,12CD49247659842CCDEA8C017DBD960B,10421,20,22,2,41,48,2098
57673,57673,8C93E9687A717AEFB87364B357E16B82,42311,1,6,5,41,46,2096
57674,57674,8C93E9687A717AEFB87364B357E16B82,10951,7,8,1,29,48,1498
57675,57675,8C93E9687A717AEFB87364B357E16B82,42521,9,10,1,31,47,1597
57676,57676,8C93E9687A717AEFB87364B357E16B82,10951,10,17,7,29,48,1498
57677,57677,8C93E9687A717AEFB87364B357E16B82,10911,18,21,3,39,46,1996
57682,57682,9A888F290C3F1BBBAF655900CCF20968,11001,0,7,7,42,47,2147
57683,57683,9A888F290C3F1BBBAF655900CCF20968,10841,11,12,1,37,47,1897
57684,57684,9A888F290C3F1BBBAF655900CCF20968,12514,15,16,1,38,47,1947
57685,57685,9A888F290C3F1BBBAF655900CCF20968,11001,18,23,5,42,47,2147
57686,57686,645397740D4815EDE2A5EDF27AA479B7,12083,1,15,14,36,49,1849
57687,57687,645397740D4815EDE2A5EDF27AA479B7,11461,16,18,2,37,49,1899
57688,57688,645397740D4815EDE2A5EDF27AA479B7,11701,21,22,1,43,48,2198
57689,57689,60916A568D4A4F0F73D5E4D0F0467072,11471,0,6,6,12,48,648
57690,57690,60916A568D4A4F0F73D5E4D0F0467072,19111,10,11,1,9,45,495
57691,57691,60916A568D4A4F0F73D5E4D0F0467072,42041,12,16,4,10,47,547
57692,57692,60916A568D4A4F0F73D5E4D0F0467072,19441,17,18,1,8,46,446
57693,57693,0FFA2B76C33E86D096275A1457C5D54A,10411,0,6,6,36,48,1848
57694,57694,0FFA2B76C33E86D096275A1457C5D54A,42151,8,10,2,35,45,1795
57695,57695,0FFA2B76C33E86D096275A1457C5D54A,10411,12,16,4,36,48,1848
57696,57696,0FFA2B76C33E86D096275A1457C5D54A,11074,18,20,2,37,47,1897
57697,57697,0FFA2B76C33E86D096275A1457C5D54A,10411,20,22,2,36,48,1848
57698,57698,EE011155820C4CF0BA812B7959F3205A,15671,0,5,5,37,26,1876
57699,57699,EE011155820C4CF0BA812B7959F3205A,10231,7,16,9,39,49,1999
57700,57700,EE011155820C4CF0BA812B7959F3205A,12611,19,20,1,41,29,2079
57701,57701,EE011155820C4CF0BA812B7959F3205A,15411,21,23,2,44,27,2227
57702,57702,EA872C49B5D6367AB3D350D463F5E573,10721,0,7,7,31,48,1598
57703,57703,EA872C49B5D6367AB3D350D463F5E573,11081,12,13,1,35,46,1796
57704,57704,EA872C49B5D6367AB3D350D463F5E573,10721,14,19,5,31,48,1598
57705,57705,EA872C49B5D6367AB3D350D463F5E573,40951,19,20,1,36,49,1849
57712,57712,BA6468A84C81B4949B332F392AF7BE2D,40833,0,8,8,41,47,2097
57713,57713,BA6468A84C81B4949B332F392AF7BE2D,12311,10,14,4,30,44,1544
57714,57714,BA6468A84C81B4949B332F392AF7BE2D,13101,16,18,2,40,47,2047
57715,57715,6428FC1D2F17D8BB440D0F9FCA04C935,12491,0,3,3,36,43,1843
57716,57716,6428FC1D2F17D8BB440D0F9FCA04C935,13911,3,6,3,39,46,1996
57717,57717,6428FC1D2F17D8BB440D0F9FCA04C935,42351,7,8,1,38,45,1945
57718,57718,6428FC1D2F17D8BB440D0F9FCA04C935,13911,12,23,11,39,46,1996
57719,57719,6F8D4273DA73FC458044224EFE18704E,43671,0,8,8,35,48,1798
57720,57720,6F8D4273DA73FC458044224EFE18704E,10971,9,11,2,35,47,1797
57721,57721,6F8D4273DA73FC458044224EFE18704E,43671,12,13,1,35,48,1798
57722,57722,6F8D4273DA73FC458044224EFE18704E,10971,14,16,2,35,47,1797
57723,57723,6F8D4273DA73FC458044224EFE18704E,12514,18,20,2,38,47,1947
57724,57724,6F8D4273DA73FC458044224EFE18704E,43671,22,23,1,35,48,1798
57725,57725,5D9A09786F570CED3C296C81274238B5,12521,10,19,9,35,41,1791
57726,57726,5D9A09786F570CED3C296C81274238B5,13314,20,21,1,31,39,1589
57727,57727,5D9A09786F570CED3C296C81274238B5,12521,21,23,2,35,41,1791
57737,57737,6BE3EFECAC9275607487DDDF0C1C8884,11021,5,6,1,36,49,1849
57738,57738,6BE3EFECAC9275607487DDDF0C1C8884,40341,18,19,1,23,49,1199
57739,57739,6BE3EFECAC9275607487DDDF0C1C8884,11021,21,23,2,36,49,1849
57740,57740,9437129F84751E1C2490DB0BBAFB8B36,15051,6,7,1,19,4,954
57741,57741,9437129F84751E1C2490DB0BBAFB8B36,16281,8,19,11,11,4,554
57742,57742,9437129F84751E1C2490DB0BBAFB8B36,15051,19,22,3,19,4,954
57761,57761,7179E8D23C9EF0FE56A034B0F52DF3EB,42623,6,8,2,22,49,1149
57762,57762,7179E8D23C9EF0FE56A034B0F52DF3EB,42071,11,13,2,31,49,1599
57763,57763,7179E8D23C9EF0FE56A034B0F52DF3EB,42623,18,19,1,22,49,1149
57770,57770,B7832DB383CB1E7DD6C87A81AAE89D66,42221,1,7,6,38,48,1948
57771,57771,B7832DB383CB1E7DD6C87A81AAE89D66,11074,8,10,2,37,47,1897
57772,57772,B7832DB383CB1E7DD6C87A81AAE89D66,11914,11,13,2,37,48,1898
57773,57773,B7832DB383CB1E7DD6C87A81AAE89D66,42221,13,14,1,38,48,1948
57774,57774,B7832DB383CB1E7DD6C87A81AAE89D66,11074,16,17,1,37,47,1897
57775,57775,B7832DB383CB1E7DD6C87A81AAE89D66,42221,19,21,2,38,48,1948
57776,57776,C96AF7724AE07D1D1BE56C246C9FE7FC,13341,1,9,8,44,45,2245
57777,57777,C96AF7724AE07D1D1BE56C246C9FE7FC,42461,13,14,1,45,47,2297
57778,57778,C96AF7724AE07D1D1BE56C246C9FE7FC,40341,16,19,3,23,49,1199
57779,57779,E43A1713BA9589398F5DEA7CD1BD08F1,43061,0,7,7,43,46,2196
57780,57780,E43A1713BA9589398F5DEA7CD1BD08F1,11841,8,16,8,33,46,1696
57781,57781,E43A1713BA9589398F5DEA7CD1BD08F1,11751,17,18,1,35,48,1798
57782,57782,E43A1713BA9589398F5DEA7CD1BD08F1,43061,21,23,2,43,46,2196
57794,57794,ED54D9A6448FF51B585DC3225EB6058D,12921,0,6,6,9,41,491
57795,57795,ED54D9A6448FF51B585DC3225EB6058D,19181,9,10,1,8,40,440
57796,57796,ED54D9A6448FF51B585DC3225EB6058D,43644,11,13,2,14,38,738
57797,57797,ED54D9A6448FF51B585DC3225EB6058D,19181,17,20,3,8,40,440
57798,57798,0BA223770DB2B15C67AC6CF1BF06CF96,10231,0,7,7,39,49,1999
57799,57799,0BA223770DB2B15C67AC6CF1BF06CF96,10251,9,13,4,35,47,1797
57800,57800,0BA223770DB2B15C67AC6CF1BF06CF96,11011,13,23,10,39,49,1999
57801,57801,D7349708A10855AEF98FEB8D22C33E59,40833,0,8,8,41,47,2097
57802,57802,D7349708A10855AEF98FEB8D22C33E59,11231,9,18,9,37,49,1899
57803,57803,D7349708A10855AEF98FEB8D22C33E59,10601,19,23,4,39,47,1997
57807,57807,47F9E34921354A3158F5C4CF69DA9A45,42771,0,1,1,36,47,1847
57808,57808,47F9E34921354A3158F5C4CF69DA9A45,11271,2,12,10,37,48,1898
57809,57809,47F9E34921354A3158F5C4CF69DA9A45,10721,12,17,5,31,48,1598
57810,57810,47F9E34921354A3158F5C4CF69DA9A45,10371,18,19,1,37,49,1899
57811,57811,47F9E34921354A3158F5C4CF69DA9A45,42921,21,22,1,33,47,1697
57816,57816,3071798D2DADC21CBA6B7F8634B62995,19061,0,10,10,3,43,193
57817,57817,3071798D2DADC21CBA6B7F8634B62995,42231,13,22,9,37,46,1896
57818,57818,3071798D2DADC21CBA6B7F8634B62995,13911,22,23,1,39,46,1996
57819,57819,C7859131FC5613A278444EF81B856AED,13711,2,11,9,38,46,1946
57820,57820,C7859131FC5613A278444EF81B856AED,40951,13,14,1,36,49,1849
57821,57821,C7859131FC5613A278444EF81B856AED,11751,15,17,2,35,48,1798
57822,57822,C7859131FC5613A278444EF81B856AED,12514,17,19,2,38,47,1947
57826,57826,558A6887C0D5899B43E75BBD844A7C64,42461,0,5,5,45,47,2297
57827,57827,558A6887C0D5899B43E75BBD844A7C64,43051,7,9,2,46,45,2345
57828,57828,558A6887C0D5899B43E75BBD844A7C64,42321,11,14,3,43,47,2197
57829,57829,558A6887C0D5899B43E75BBD844A7C64,42461,19,20,1,45,47,2297
57830,57830,558A6887C0D5899B43E75BBD844A7C64,42321,21,22,1,43,47,2197
57831,57831,3D2BDD74577C3FC02D2B34FCE9FAFF7E,10061,0,10,10,20,46,1046
57832,57832,3D2BDD74577C3FC02D2B34FCE9FAFF7E,12581,13,15,2,24,48,1248
57833,57833,3D2BDD74577C3FC02D2B34FCE9FAFF7E,12601,18,20,2,25,47,1297
57840,57840,E45B0EC44E00842EDD865C65A561543D,11791,1,7,6,38,49,1949
57841,57841,E45B0EC44E00842EDD865C65A561543D,10471,8,12,4,37,48,1898
57842,57842,E45B0EC44E00842EDD865C65A561543D,11231,15,16,1,37,49,1899
57843,57843,E45B0EC44E00842EDD865C65A561543D,42581,19,20,1,38,48,1948
57844,57844,E45B0EC44E00842EDD865C65A561543D,11791,21,23,2,38,49,1949
57845,57845,F87C006906FC5F5270405EDAA1B0E6A3,10841,0,2,2,37,47,1897
57846,57846,F87C006906FC5F5270405EDAA1B0E6A3,42221,3,4,1,38,48,1948
57847,57847,F87C006906FC5F5270405EDAA1B0E6A3,11201,8,10,2,35,49,1799
57848,57848,F87C006906FC5F5270405EDAA1B0E6A3,12514,15,18,3,38,47,1947
57849,57849,F87C006906FC5F5270405EDAA1B0E6A3,10841,18,19,1,37,47,1897
57850,57850,F87C006906FC5F5270405EDAA1B0E6A3,12514,21,22,1,38,47,1947
57854,57854,E962C3D0A8FC163364DD770DFBF0ADE9,13651,0,8,8,30,47,1547
57855,57855,E962C3D0A8FC163364DD770DFBF0ADE9,41591,9,17,8,34,49,1749
57856,57856,E962C3D0A8FC163364DD770DFBF0ADE9,13651,18,23,5,30,47,1547
57857,57857,F004825C5EEC7F8B7A184D4985895C55,13341,0,6,6,44,45,2245
57858,57858,F004825C5EEC7F8B7A184D4985895C55,42631,7,8,1,43,45,2195
57859,57859,F004825C5EEC7F8B7A184D4985895C55,13341,11,13,2,44,45,2245
57860,57860,F004825C5EEC7F8B7A184D4985895C55,42631,14,15,1,43,45,2195
57861,57861,F004825C5EEC7F8B7A184D4985895C55,13341,19,20,1,44,45,2245
57862,57862,F004825C5EEC7F8B7A184D4985895C55,13221,21,22,1,40,47,2047
57863,57863,8436FA510D59B3814E50B7F18BD1D92C,19571,0,5,5,1,36,86
57864,57864,8436FA510D59B3814E50B7F18BD1D92C,12641,8,15,7,10,43,543
57865,57865,8436FA510D59B3814E50B7F18BD1D92C,19031,16,18,2,1,42,92
57866,57866,8436FA510D59B3814E50B7F18BD1D92C,43644,19,22,3,14,38,738
57867,57867,B587C9E11BF2CDFAA894E59FA9E36E12,42531,2,3,1,31,45,1595
57868,57868,B587C9E11BF2CDFAA894E59FA9E36E12,42151,4,8,4,35,45,1795
57869,57869,B587C9E11BF2CDFAA894E59FA9E36E12,12311,12,14,2,30,44,1544
57870,57870,B587C9E11BF2CDFAA894E59FA9E36E12,42151,14,16,2,35,45,1795
57871,57871,B587C9E11BF2CDFAA894E59FA9E36E12,12311,17,23,6,30,44,1544
57875,57875,90CAE68E57E6D6254F2E8F80F351FD91,12381,0,9,9,32,48,1648
57876,57876,90CAE68E57E6D6254F2E8F80F351FD91,42121,20,21,1,26,49,1349
57877,57877,90CAE68E57E6D6254F2E8F80F351FD91,11531,21,22,1,34,49,1749
57878,57878,F49EE04071D0B4FCCD4263F4C2BBEA7A,10681,0,7,7,30,48,1548
57879,57879,F49EE04071D0B4FCCD4263F4C2BBEA7A,42521,10,12,2,31,47,1597
57880,57880,F49EE04071D0B4FCCD4263F4C2BBEA7A,11061,14,15,1,29,48,1498
57881,57881,F49EE04071D0B4FCCD4263F4C2BBEA7A,42521,17,19,2,31,47,1597
57882,57882,F49EE04071D0B4FCCD4263F4C2BBEA7A,10681,22,23,1,30,48,1548
57883,57883,1C0548F40841AD0870DAD8EC7BECCBC6,13314,0,7,7,31,39,1589
57884,57884,1C0548F40841AD0870DAD8EC7BECCBC6,12521,7,10,3,35,41,1791
57885,57885,1C0548F40841AD0870DAD8EC7BECCBC6,13314,12,13,1,31,39,1589
57886,57886,1C0548F40841AD0870DAD8EC7BECCBC6,12521,15,19,4,35,41,1791
57887,57887,1C0548F40841AD0870DAD8EC7BECCBC6,13314,19,23,4,31,39,1589
57888,57888,FD112B5156FECF6460254CADD94A5EF4,12641,0,9,9,10,43,543
57889,57889,FD112B5156FECF6460254CADD94A5EF4,19031,9,11,2,1,42,92
57890,57890,FD112B5156FECF6460254CADD94A5EF4,12641,11,18,7,10,43,543
57891,57891,FD112B5156FECF6460254CADD94A5EF4,19031,19,20,1,1,42,92
57892,57892,FD112B5156FECF6460254CADD94A5EF4,19114,21,23,2,7,43,393
57893,57893,26B9AAC369331C3B7CCBFCA623526739,42861,2,5,3,37,44,1894
57894,57894,26B9AAC369331C3B7CCBFCA623526739,12491,6,9,3,36,43,1843
57895,57895,26B9AAC369331C3B7CCBFCA623526739,13461,10,12,2,39,44,1994
57896,57896,26B9AAC369331C3B7CCBFCA623526739,13101,13,17,4,40,47,2047
57897,57897,26B9AAC369331C3B7CCBFCA623526739,43011,18,20,2,40,42,2042
57898,57898,26B9AAC369331C3B7CCBFCA623526739,10811,21,23,2,38,46,1946
57899,57899,E648A6F090A3BE85617E0ED54A73B4F0,12601,0,3,3,25,47,1297
57900,57900,E648A6F090A3BE85617E0ED54A73B4F0,13771,4,6,2,21,45,1095
57901,57901,E648A6F090A3BE85617E0ED54A73B4F0,12671,8,12,4,21,43,1093
57902,57902,E648A6F090A3BE85617E0ED54A73B4F0,13771,13,14,1,21,45,1095
57903,57903,E648A6F090A3BE85617E0ED54A73B4F0,12601,15,22,7,25,47,1297
57911,57911,9C0ACC78786AB3EDB58D985A680EE622,42031,1,3,2,40,46,2046
57912,57912,9C0ACC78786AB3EDB58D985A680EE622,43281,5,6,1,37,48,1898
57913,57913,9C0ACC78786AB3EDB58D985A680EE622,11301,7,8,1,41,49,2099
57914,57914,9C0ACC78786AB3EDB58D985A680EE622,13341,8,23,15,44,45,2245
57915,57915,2F66AC01887397A198C9CCA6611EA97B,12521,0,6,6,35,41,1791
57916,57916,2F66AC01887397A198C9CCA6611EA97B,13314,7,8,1,31,39,1589
57917,57917,2F66AC01887397A198C9CCA6611EA97B,12521,8,14,6,35,41,1791
57918,57918,2F66AC01887397A198C9CCA6611EA97B,13314,14,16,2,31,39,1589
57919,57919,2F66AC01887397A198C9CCA6611EA97B,12521,16,23,7,35,41,1791
57920,57920,9C686B624E1F19B96755FA9920EEF4B6,10111,0,7,7,37,47,1897
57921,57921,9C686B624E1F19B96755FA9920EEF4B6,13911,8,9,1,39,46,1996
57922,57922,9C686B624E1F19B96755FA9920EEF4B6,42921,10,14,4,33,47,1697
57923,57923,9C686B624E1F19B96755FA9920EEF4B6,13601,19,20,1,34,47,1747
57924,57924,9C686B624E1F19B96755FA9920EEF4B6,42401,20,22,2,36,47,1847
57925,57925,A534FD7E51A551BE3196665029DD0400,19931,0,6,6,7,43,393
57926,57926,A534FD7E51A551BE3196665029DD0400,19031,9,18,9,1,42,92
57927,57927,A534FD7E51A551BE3196665029DD0400,19931,19,20,1,7,43,393
57928,57928,6CA320FFF385B278278CAF7895A6704A,42921,2,10,8,33,47,1697
57929,57929,6CA320FFF385B278278CAF7895A6704A,11861,12,13,1,32,47,1647
57930,57930,6CA320FFF385B278278CAF7895A6704A,42921,14,15,1,33,47,1697
57931,57931,6CA320FFF385B278278CAF7895A6704A,11861,17,19,2,32,47,1647
57932,57932,6CA320FFF385B278278CAF7895A6704A,42921,19,21,2,33,47,1697
57933,57933,62A4DF59E8BCEC0DCF6C971E2D9209AC,13711,3,5,2,38,46,1946
57934,57934,62A4DF59E8BCEC0DCF6C971E2D9209AC,11021,9,17,8,36,49,1849
57935,57935,62A4DF59E8BCEC0DCF6C971E2D9209AC,10271,20,22,2,37,46,1896
57936,57936,290CF9B7E8E39B2A6D619522168B66C7,19621,0,7,7,5,46,296
57937,57937,290CF9B7E8E39B2A6D619522168B66C7,11201,9,14,5,35,49,1799
57938,57938,290CF9B7E8E39B2A6D619522168B66C7,19441,18,23,5,8,46,446
57942,57942,3AB35E62E3464B5074E82DE69E9DD0D9,42501,0,7,7,28,47,1447
57943,57943,3AB35E62E3464B5074E82DE69E9DD0D9,19441,12,16,4,8,46,446
57944,57944,3AB35E62E3464B5074E82DE69E9DD0D9,42501,19,23,4,28,47,1447
57948,57948,9BBBC00C93BA6A3176E2B008E6F8A88E,13911,0,6,6,39,46,1996
57949,57949,9BBBC00C93BA6A3176E2B008E6F8A88E,11261,6,9,3,36,46,1846
57950,57950,9BBBC00C93BA6A3176E2B008E6F8A88E,13911,11,13,2,39,46,1996
57951,57951,9BBBC00C93BA6A3176E2B008E6F8A88E,11261,14,18,4,36,46,1846
57952,57952,9BBBC00C93BA6A3176E2B008E6F8A88E,13911,18,20,2,39,46,1996
57953,57953,9BBBC00C93BA6A3176E2B008E6F8A88E,11261,20,22,2,36,46,1846
57954,57954,01067BD464140B42D6F1D4D82F8B8EE7,43481,1,8,7,39,48,1998
57955,57955,01067BD464140B42D6F1D4D82F8B8EE7,42801,9,12,3,40,49,2049
57956,57956,01067BD464140B42D6F1D4D82F8B8EE7,43481,13,14,1,39,48,1998
57957,57957,01067BD464140B42D6F1D4D82F8B8EE7,42801,18,21,3,40,49,2049
57958,57958,01067BD464140B42D6F1D4D82F8B8EE7,43481,22,23,1,39,48,1998
57968,57968,5CB395EE61B203CDEC22915C029A400C,10911,0,15,15,39,46,1996
57969,57969,5CB395EE61B203CDEC22915C029A400C,10531,17,18,1,34,46,1746
57970,57970,5CB395EE61B203CDEC22915C029A400C,10911,19,23,4,39,46,1996
57981,57981,791B4DBE4CE3168C2D60D0F2D51833C1,40171,0,8,8,38,48,1948
57982,57982,791B4DBE4CE3168C2D60D0F2D51833C1,11231,9,12,3,37,49,1899
57983,57983,791B4DBE4CE3168C2D60D0F2D51833C1,40171,12,14,2,38,48,1948
57984,57984,791B4DBE4CE3168C2D60D0F2D51833C1,11231,14,17,3,37,49,1899
57985,57985,791B4DBE4CE3168C2D60D0F2D51833C1,40171,21,23,2,38,48,1948
57986,57986,649CA0B4C9C73F10630BCAC6C100E533,42151,0,13,13,35,45,1795
57987,57987,649CA0B4C9C73F10630BCAC6C100E533,12311,13,17,4,30,44,1544
57988,57988,649CA0B4C9C73F10630BCAC6C100E533,42151,19,21,2,35,45,1795
57989,57989,76DA946F4DC1318DD46A32E1D303D6B7,12521,0,9,9,35,41,1791
57990,57990,76DA946F4DC1318DD46A32E1D303D6B7,13314,9,11,2,31,39,1589
57991,57991,76DA946F4DC1318DD46A32E1D303D6B7,12521,12,23,11,35,41,1791
57995,57995,0BF9081B921E7C1EC68F2248D31F0D32,16281,0,4,4,11,4,554
57996,57996,0BF9081B921E7C1EC68F2248D31F0D32,15143,4,10,6,18,7,907
57997,57997,0BF9081B921E7C1EC68F2248D31F0D32,16281,10,12,2,11,4,554
57998,57998,0BF9081B921E7C1EC68F2248D31F0D32,15143,13,19,6,18,7,907
57999,57999,0BF9081B921E7C1EC68F2248D31F0D32,16281,22,23,1,11,4,554
58000,58000,9C017418D67328D93FD696E6655B46ED,11211,0,8,8,34,49,1749
58001,58001,9C017418D67328D93FD696E6655B46ED,41101,8,9,1,32,48,1648
58002,58002,9C017418D67328D93FD696E6655B46ED,11541,10,15,5,35,49,1799
58003,58003,9C017418D67328D93FD696E6655B46ED,11211,18,20,2,34,49,1749
58004,58004,9C017418D67328D93FD696E6655B46ED,11541,22,23,1,35,49,1799
58015,58015,E08A998E96875BC2FB605F71696F898C,11061,0,8,8,29,48,1498
58016,58016,E08A998E96875BC2FB605F71696F898C,11381,8,9,1,30,47,1547
58017,58017,E08A998E96875BC2FB605F71696F898C,11061,13,14,1,29,48,1498
58018,58018,E08A998E96875BC2FB605F71696F898C,11381,14,20,6,30,47,1547
58019,58019,E08A998E96875BC2FB605F71696F898C,11061,20,23,3,29,48,1498
58020,58020,DE69FEBC50432F9871EF62D07F7A5C1A,13094,1,2,1,21,42,1092
58021,58021,DE69FEBC50432F9871EF62D07F7A5C1A,49201,3,5,2,7,41,391
58022,58022,DE69FEBC50432F9871EF62D07F7A5C1A,19181,5,23,18,8,40,440
58026,58026,E886E5251030835554FC7C0727BBE348,12871,0,6,6,22,33,1133
58027,58027,E886E5251030835554FC7C0727BBE348,43121,9,17,8,25,27,1277
58028,58028,E886E5251030835554FC7C0727BBE348,12871,18,23,5,22,33,1133
58029,58029,5F09B173620062093E73818D879CF79B,43021,0,5,5,16,43,843
58030,58030,5F09B173620062093E73818D879CF79B,12121,6,7,1,29,47,1497
58031,58031,5F09B173620062093E73818D879CF79B,19261,10,11,1,6,37,337
58032,58032,5F09B173620062093E73818D879CF79B,43021,13,15,2,16,43,843
58033,58033,5F09B173620062093E73818D879CF79B,12921,19,21,2,9,41,491
58034,58034,5F09B173620062093E73818D879CF79B,43021,21,23,2,16,43,843
58035,58035,034A60A97E7096EFB0F8D8B05344F545,11941,0,8,8,37,46,1896
58036,58036,034A60A97E7096EFB0F8D8B05344F545,10511,11,13,2,35,46,1796
58037,58037,034A60A97E7096EFB0F8D8B05344F545,43751,16,18,2,19,48,998
58038,58038,034A60A97E7096EFB0F8D8B05344F545,11941,19,22,3,37,46,1896
58042,58042,0F2E7737761FB5772278335D9DA9FBBB,43121,8,9,1,25,27,1277
58043,58043,0F2E7737761FB5772278335D9DA9FBBB,15321,10,14,4,29,26,1476
58044,58044,0F2E7737761FB5772278335D9DA9FBBB,43121,16,20,4,25,27,1277
58052,58052,22300DEAB3F7A20A2F8DD7892A11C5B7,13271,0,2,2,41,47,2097
58053,58053,22300DEAB3F7A20A2F8DD7892A11C5B7,13101,2,3,1,40,47,2047
58054,58054,22300DEAB3F7A20A2F8DD7892A11C5B7,13271,3,4,1,41,47,2097
58055,58055,22300DEAB3F7A20A2F8DD7892A11C5B7,11806,8,9,1,41,48,2098
58056,58056,22300DEAB3F7A20A2F8DD7892A11C5B7,13271,13,20,7,41,47,2097
58057,58057,331C93B6083F5634586EEDFC958D0A76,13911,0,6,6,39,46,1996
58058,58058,331C93B6083F5634586EEDFC958D0A76,13711,11,15,4,38,46,1946
58059,58059,331C93B6083F5634586EEDFC958D0A76,12971,16,17,1,32,48,1648
58060,58060,331C93B6083F5634586EEDFC958D0A76,42583,19,20,1,40,48,2048
58061,58061,331C93B6083F5634586EEDFC958D0A76,42231,21,23,2,37,46,1896
58062,58062,FB28ACB51C29D05828E62EE995A23AE2,11111,7,9,2,26,48,1348
58063,58063,FB28ACB51C29D05828E62EE995A23AE2,19021,13,15,2,10,45,545
58064,58064,FB28ACB51C29D05828E62EE995A23AE2,42461,17,19,2,45,47,2297
58065,58065,68A1105E45875228253ACCFACF581238,15143,1,4,3,18,7,907
58066,58066,68A1105E45875228253ACCFACF581238,15051,4,6,2,19,4,954
58067,58067,68A1105E45875228253ACCFACF581238,15143,7,8,1,18,7,907
58068,58068,68A1105E45875228253ACCFACF581238,16281,13,14,1,11,4,554
58069,58069,68A1105E45875228253ACCFACF581238,15143,17,22,5,18,7,907
58070,58070,B65986D45181EA9BD7712A84F575953B,19071,2,3,1,7,29,379
58071,58071,B65986D45181EA9BD7712A84F575953B,15121,7,18,11,27,19,1369
58072,58072,B65986D45181EA9BD7712A84F575953B,19051,18,23,5,16,23,823
58077,58077,083E6F45CD758E55D59CE683A8831561,43011,1,6,5,40,42,2042
58078,58078,083E6F45CD758E55D59CE683A8831561,42381,6,12,6,39,41,1991
58079,58079,083E6F45CD758E55D59CE683A8831561,43451,14,15,1,37,40,1890
58080,58080,083E6F45CD758E55D59CE683A8831561,13071,15,18,3,41,41,2091
58081,58081,84C94B2F533ED609B0C2666E73EA3142,13271,0,8,8,41,47,2097
58082,58082,84C94B2F533ED609B0C2666E73EA3142,11481,9,11,2,41,48,2098
58083,58083,84C94B2F533ED609B0C2666E73EA3142,40833,12,13,1,41,47,2097
58084,58084,84C94B2F533ED609B0C2666E73EA3142,13101,17,19,2,40,47,2047
58085,58085,84C94B2F533ED609B0C2666E73EA3142,11481,19,23,4,41,48,2098
58086,58086,1B1AA14FCBEAAD141CA6FAC7B338917E,11261,0,1,1,36,46,1846
58087,58087,1B1AA14FCBEAAD141CA6FAC7B338917E,42864,2,5,3,38,44,1944
58088,58088,1B1AA14FCBEAAD141CA6FAC7B338917E,42861,6,9,3,37,44,1894
58089,58089,1B1AA14FCBEAAD141CA6FAC7B338917E,42864,12,13,1,38,44,1944
58090,58090,1B1AA14FCBEAAD141CA6FAC7B338917E,42861,14,16,2,37,44,1894
58091,58091,1B1AA14FCBEAAD141CA6FAC7B338917E,11261,19,21,2,36,46,1846
58095,58095,F27E1DF7321CA41140E87F34902262C9,10651,0,6,6,36,49,1849
58096,58096,F27E1DF7321CA41140E87F34902262C9,11061,6,8,2,29,48,1498
58097,58097,F27E1DF7321CA41140E87F34902262C9,10531,12,16,4,34,46,1746
58098,58098,F27E1DF7321CA41140E87F34902262C9,10231,17,20,3,39,49,1999
58099,58099,50CCAF8374278F69B5D27E6BC1773F79,11951,0,8,8,31,49,1599
58100,58100,50CCAF8374278F69B5D27E6BC1773F79,13351,16,17,1,48,48,2448
58101,58101,50CCAF8374278F69B5D27E6BC1773F79,11521,20,21,1,41,48,2098
58106,58106,F2971C3C111263F217176C0D8DBD4C49,40981,0,4,4,34,47,1747
58107,58107,F2971C3C111263F217176C0D8DBD4C49,11104,8,9,1,17,47,897
58108,58108,F2971C3C111263F217176C0D8DBD4C49,10061,12,15,3,20,46,1046
58109,58109,F2971C3C111263F217176C0D8DBD4C49,40981,17,23,6,34,47,1747
58110,58110,E5F35E9A8E7D375E3C2447F3147B8E3F,42523,1,15,14,31,47,1597
58111,58111,E5F35E9A8E7D375E3C2447F3147B8E3F,42541,15,16,1,25,47,1297
58112,58112,E5F35E9A8E7D375E3C2447F3147B8E3F,11481,18,21,3,41,48,2098
58113,58113,E5F35E9A8E7D375E3C2447F3147B8E3F,13221,22,23,1,40,47,2047
58124,58124,4EBB382643C7FAC868385593D235FA2B,13094,4,6,2,21,42,1092
58125,58125,4EBB382643C7FAC868385593D235FA2B,12601,7,10,3,25,47,1297
58126,58126,4EBB382643C7FAC868385593D235FA2B,12671,13,16,3,21,43,1093
58127,58127,4EBB382643C7FAC868385593D235FA2B,12601,18,23,5,25,47,1297
58131,58131,945EE41711AF43A0485A81C45A7AB685,11061,0,7,7,29,48,1498
58132,58132,945EE41711AF43A0485A81C45A7AB685,11381,9,16,7,30,47,1547
58133,58133,945EE41711AF43A0485A81C45A7AB685,11631,21,23,2,12,49,649
58140,58140,0E91A13D0E931F32EE1FFD96FA252798,42381,0,2,2,39,41,1991
58141,58141,0E91A13D0E931F32EE1FFD96FA252798,42151,7,11,4,35,45,1795
58142,58142,0E91A13D0E931F32EE1FFD96FA252798,42381,12,14,2,39,41,1991
58143,58143,0E91A13D0E931F32EE1FFD96FA252798,13071,14,15,1,41,41,2091
58144,58144,0E91A13D0E931F32EE1FFD96FA252798,43451,16,17,1,37,40,1890
58145,58145,0E91A13D0E931F32EE1FFD96FA252798,13071,18,19,1,41,41,2091
58146,58146,887265AB63D94AE4D6404DF5CC47C328,10471,0,8,8,37,48,1898
58147,58147,887265AB63D94AE4D6404DF5CC47C328,10381,9,10,1,31,49,1599
58148,58148,887265AB63D94AE4D6404DF5CC47C328,41271,13,21,8,38,48,1948
58160,58160,08B22EEE6E957330DAD27E7217103ACF,43011,1,6,5,40,42,2042
58161,58161,08B22EEE6E957330DAD27E7217103ACF,10151,11,12,1,34,47,1747
58162,58162,08B22EEE6E957330DAD27E7217103ACF,12514,17,21,4,38,47,1947
58163,58163,08B22EEE6E957330DAD27E7217103ACF,11914,21,23,2,37,48,1898
58167,58167,A82EF90EFC2E4C8E36D65CBF0ADF5C03,10781,0,8,8,35,47,1797
58168,58168,A82EF90EFC2E4C8E36D65CBF0ADF5C03,13341,10,12,2,44,45,2245
58169,58169,A82EF90EFC2E4C8E36D65CBF0ADF5C03,43061,15,18,3,43,46,2196
58170,58170,A82EF90EFC2E4C8E36D65CBF0ADF5C03,13341,19,21,2,44,45,2245
58171,58171,06CD0D9A51BF6B03AA66A2A0C792CAB3,10971,0,3,3,35,47,1797
58172,58172,06CD0D9A51BF6B03AA66A2A0C792CAB3,10731,3,5,2,33,47,1697
58173,58173,06CD0D9A51BF6B03AA66A2A0C792CAB3,11861,7,8,1,32,47,1647
58174,58174,06CD0D9A51BF6B03AA66A2A0C792CAB3,42021,11,12,1,33,47,1697
58175,58175,06CD0D9A51BF6B03AA66A2A0C792CAB3,11301,18,20,2,41,49,2099
58176,58176,06CD0D9A51BF6B03AA66A2A0C792CAB3,10731,20,22,2,33,47,1697
58177,58177,7D8BB90B66B5BB302B836A7DB354A71B,11701,0,6,6,43,48,2198
58178,58178,7D8BB90B66B5BB302B836A7DB354A71B,42601,11,14,3,44,48,2248
58179,58179,7D8BB90B66B5BB302B836A7DB354A71B,11701,15,16,1,43,48,2198
58180,58180,7D8BB90B66B5BB302B836A7DB354A71B,42601,18,19,1,44,48,2248
58181,58181,7D8BB90B66B5BB302B836A7DB354A71B,11701,20,22,2,43,48,2198
58185,58185,360CAB205F052520FED1AC4C9779857A,11941,1,3,2,37,46,1896
58186,58186,360CAB205F052520FED1AC4C9779857A,13711,3,9,6,38,46,1946
58187,58187,360CAB205F052520FED1AC4C9779857A,11941,9,15,6,37,46,1896
58188,58188,360CAB205F052520FED1AC4C9779857A,13711,15,16,1,38,46,1946
58189,58189,360CAB205F052520FED1AC4C9779857A,11941,18,21,3,37,46,1896
58190,58190,360CAB205F052520FED1AC4C9779857A,13711,21,22,1,38,46,1946
58191,58191,6D52C793EB371471F35F7C1C2F1CBCD2,12381,0,7,7,32,48,1648
58192,58192,6D52C793EB371471F35F7C1C2F1CBCD2,11801,20,21,1,42,48,2148
58193,58193,6D52C793EB371471F35F7C1C2F1CBCD2,10721,22,23,1,31,48,1598
58198,58198,4675C8D710D5EDCBB642FE322F526AC8,13121,1,2,1,38,46,1946
58199,58199,4675C8D710D5EDCBB642FE322F526AC8,42351,2,8,6,38,45,1945
58200,58200,4675C8D710D5EDCBB642FE322F526AC8,10271,12,16,4,37,46,1896
58201,58201,4675C8D710D5EDCBB642FE322F526AC8,13121,17,20,3,38,46,1946
58202,58202,4675C8D710D5EDCBB642FE322F526AC8,12021,21,22,1,37,49,1899
58207,58207,9D2F8B673CF5A851F245B3DD21FD08F4,42161,0,7,7,36,47,1847
58208,58208,9D2F8B673CF5A851F245B3DD21FD08F4,10111,11,13,2,37,47,1897
58209,58209,9D2F8B673CF5A851F245B3DD21FD08F4,10251,13,16,3,35,47,1797
58210,58210,9D2F8B673CF5A851F245B3DD21FD08F4,10111,16,20,4,37,47,1897
58211,58211,9D2F8B673CF5A851F245B3DD21FD08F4,42161,21,22,1,36,47,1847
58212,58212,831CEF471029417D091D2BE9F78234DD,10911,0,1,1,39,46,1996
58213,58213,831CEF471029417D091D2BE9F78234DD,10801,2,8,6,42,47,2147
58214,58214,831CEF471029417D091D2BE9F78234DD,10661,12,18,6,37,49,1899
58215,58215,831CEF471029417D091D2BE9F78234DD,43281,22,23,1,37,48,1898
58216,58216,5EA5BD42925C3BCF47C8B51F957488EC,10691,0,9,9,33,48,1698
58217,58217,5EA5BD42925C3BCF47C8B51F957488EC,10841,9,14,5,37,47,1897
58218,58218,5EA5BD42925C3BCF47C8B51F957488EC,10691,16,19,3,33,48,1698
58219,58219,5EA5BD42925C3BCF47C8B51F957488EC,11861,20,21,1,32,47,1647
58224,58224,D6932FB45D03368B8FD3FCD5E6F4054F,11481,0,7,7,41,48,2098
58225,58225,D6932FB45D03368B8FD3FCD5E6F4054F,40637,8,9,1,36,47,1847
58226,58226,D6932FB45D03368B8FD3FCD5E6F4054F,11541,11,13,2,35,49,1799
58227,58227,D6932FB45D03368B8FD3FCD5E6F4054F,41601,17,18,1,39,49,1999
58228,58228,D6932FB45D03368B8FD3FCD5E6F4054F,42281,19,23,4,40,48,2048
58229,58229,A30C524CE1CE6CCC97F57F505F7BFDED,11701,0,10,10,43,48,2198
58230,58230,A30C524CE1CE6CCC97F57F505F7BFDED,11021,10,11,1,36,49,1849
58231,58231,A30C524CE1CE6CCC97F57F505F7BFDED,41591,12,15,3,34,49,1749
58232,58232,A30C524CE1CE6CCC97F57F505F7BFDED,11541,16,18,2,35,49,1799
58233,58233,A30C524CE1CE6CCC97F57F505F7BFDED,11701,20,22,2,43,48,2198
58234,58234,60DD6DD8666616ED1B5BCBF2A3A6C1E1,19441,2,14,12,8,46,446
58235,58235,60DD6DD8666616ED1B5BCBF2A3A6C1E1,11571,15,16,1,13,46,696
58236,58236,60DD6DD8666616ED1B5BCBF2A3A6C1E1,19901,20,23,3,7,44,394
58237,58237,C679B78CC6D72C84BDF54659808494C3,10301,1,7,6,31,45,1595
58238,58238,C679B78CC6D72C84BDF54659808494C3,43011,8,9,1,40,42,2042
58239,58239,C679B78CC6D72C84BDF54659808494C3,15241,14,18,4,33,2,1652
58240,58240,C679B78CC6D72C84BDF54659808494C3,15051,19,20,1,19,4,954
58241,58241,C679B78CC6D72C84BDF54659808494C3,16181,22,23,1,4,2,202
58251,58251,6EA83A9329F5D86E7E7F9B8351352891,42471,8,13,5,35,49,1799
58252,58252,6EA83A9329F5D86E7E7F9B8351352891,42481,14,16,2,22,49,1149
58253,58253,6EA83A9329F5D86E7E7F9B8351352891,11531,18,19,1,34,49,1749
58254,58254,62A2F5272230052AEB85DFD96BD0E354,10501,5,7,2,22,46,1146
58255,58255,62A2F5272230052AEB85DFD96BD0E354,42541,11,17,6,25,47,1297
58256,58256,62A2F5272230052AEB85DFD96BD0E354,13601,19,20,1,34,47,1747
58257,58257,62A2F5272230052AEB85DFD96BD0E354,12601,21,22,1,25,47,1297
58258,58258,3CF7B0916CDE9473EE3871FE908999F3,12921,0,5,5,9,41,491
58259,58259,3CF7B0916CDE9473EE3871FE908999F3,19114,8,18,10,7,43,393
58260,58260,3CF7B0916CDE9473EE3871FE908999F3,19901,19,23,4,7,44,394
58261,58261,E25A441BFE002F6E7C90E85196797C5A,10251,1,4,3,35,47,1797
58262,58262,E25A441BFE002F6E7C90E85196797C5A,40891,4,7,3,37,47,1897
58263,58263,E25A441BFE002F6E7C90E85196797C5A,42231,10,11,1,37,46,1896
58264,58264,E25A441BFE002F6E7C90E85196797C5A,10841,12,14,2,37,47,1897
58265,58265,E25A441BFE002F6E7C90E85196797C5A,10251,14,16,2,35,47,1797
58266,58266,E25A441BFE002F6E7C90E85196797C5A,42231,18,19,1,37,46,1896
58267,58267,499426AABDFB3A48AD7C69EA8E2B51C2,19621,0,7,7,5,46,296
58268,58268,499426AABDFB3A48AD7C69EA8E2B51C2,10151,8,10,2,34,47,1747
58269,58269,499426AABDFB3A48AD7C69EA8E2B51C2,19621,13,23,10,5,46,296
58273,58273,478F01BCCD8ECC2639B5EA3CD060CD5E,13511,0,13,13,34,48,1748
58274,58274,478F01BCCD8ECC2639B5EA3CD060CD5E,10161,15,20,5,35,49,1799
58275,58275,478F01BCCD8ECC2639B5EA3CD060CD5E,11521,21,22,1,41,48,2098
58290,58290,7E2B090073D5B7202042DFCA26CF9DE6,11861,1,2,1,32,47,1647
58291,58291,7E2B090073D5B7202042DFCA26CF9DE6,10661,3,7,4,37,49,1899
58292,58292,7E2B090073D5B7202042DFCA26CF9DE6,42501,9,16,7,28,47,1447
58293,58293,7E2B090073D5B7202042DFCA26CF9DE6,11091,20,21,1,29,47,1497
58294,58294,BA8D425E7E16BEEA8A3B61907D0E5597,42521,0,5,5,31,47,1597
58295,58295,BA8D425E7E16BEEA8A3B61907D0E5597,40341,6,9,3,23,49,1199
58296,58296,BA8D425E7E16BEEA8A3B61907D0E5597,11571,11,15,4,13,46,696
58297,58297,BA8D425E7E16BEEA8A3B61907D0E5597,10151,17,20,3,34,47,1747
58298,58298,BA8D425E7E16BEEA8A3B61907D0E5597,42521,20,23,3,31,47,1597
58302,58302,1A439866C72DC101B5B9389EACAD1E10,10681,0,9,9,30,48,1548
58303,58303,1A439866C72DC101B5B9389EACAD1E10,11061,9,10,1,29,48,1498
58304,58304,1A439866C72DC101B5B9389EACAD1E10,11481,13,15,2,41,48,2098
58305,58305,1A439866C72DC101B5B9389EACAD1E10,10681,17,23,6,30,48,1548
58306,58306,89E5A7FBADD8F5F593AB966798D6300A,13121,0,17,17,38,46,1946
58307,58307,89E5A7FBADD8F5F593AB966798D6300A,10301,19,20,1,31,45,1595
58308,58308,89E5A7FBADD8F5F593AB966798D6300A,13121,21,23,2,38,46,1946
58312,58312,C77F23D19DAEA5BB8ADE1BB3D3C261B4,13671,0,6,6,27,43,1393
58313,58313,C77F23D19DAEA5BB8ADE1BB3D3C261B4,13911,7,17,10,39,46,1996
58314,58314,C77F23D19DAEA5BB8ADE1BB3D3C261B4,42531,18,20,2,31,45,1595
58319,58319,41879CA19179F22FC1452A3273394F32,12521,0,12,12,35,41,1791
58320,58320,41879CA19179F22FC1452A3273394F32,42131,13,14,1,44,48,2248
58321,58321,41879CA19179F22FC1452A3273394F32,12521,14,19,5,35,41,1791
58332,58332,7DE99E8F8162DDF98496EB01772EFB54,11211,0,8,8,34,49,1749
58333,58333,7DE99E8F8162DDF98496EB01772EFB54,11541,8,9,1,35,49,1799
58334,58334,7DE99E8F8162DDF98496EB01772EFB54,11211,10,12,2,34,49,1749
58335,58335,7DE99E8F8162DDF98496EB01772EFB54,12311,22,23,1,30,44,1544
58336,58336,3986432814A654D95A88696E983E9BD1,10281,0,14,14,33,48,1698
58337,58337,3986432814A654D95A88696E983E9BD1,13951,18,19,1,47,45,2395
58338,58338,3986432814A654D95A88696E983E9BD1,42141,22,23,1,32,47,1647
58339,58339,43E514FE946CFCE5D2368859DDE1C55E,43761,7,11,4,32,47,1647
58340,58340,43E514FE946CFCE5D2368859DDE1C55E,11331,16,18,2,37,48,1898
58341,58341,43E514FE946CFCE5D2368859DDE1C55E,11921,19,22,3,38,48,1948
58346,58346,69ABCA2D51D3A0B9DCF00AF47801F189,15401,0,7,7,39,25,1975
58347,58347,69ABCA2D51D3A0B9DCF00AF47801F189,11381,9,15,6,30,47,1547
58348,58348,69ABCA2D51D3A0B9DCF00AF47801F189,15401,17,23,6,39,25,1975
58349,58349,F0C7EDE2A4789958616B0A004CA8540F,40833,0,4,4,41,47,2097
58350,58350,F0C7EDE2A4789958616B0A004CA8540F,43761,4,15,11,32,47,1647
58351,58351,F0C7EDE2A4789958616B0A004CA8540F,40833,15,23,8,41,47,2097
58352,58352,C67AD33695FBB59FE91EDDED93659237,10544,0,1,1,28,48,1448
58353,58353,C67AD33695FBB59FE91EDDED93659237,11151,1,6,5,30,48,1548
58354,58354,C67AD33695FBB59FE91EDDED93659237,11331,8,15,7,37,48,1898
58355,58355,C67AD33695FBB59FE91EDDED93659237,43391,20,22,2,29,48,1498
58356,58356,C67AD33695FBB59FE91EDDED93659237,10544,22,23,1,28,48,1448
58357,58357,3A92EC07C00F64C7BEBBE43FF8657600,12971,10,13,3,32,48,1648
58358,58358,3A92EC07C00F64C7BEBBE43FF8657600,10471,14,17,3,37,48,1898
58359,58359,3A92EC07C00F64C7BEBBE43FF8657600,10221,18,20,2,34,49,1749
58363,58363,B92EE1CFB5315952BB3C56E741E539F9,10901,0,8,8,35,48,1798
58364,58364,B92EE1CFB5315952BB3C56E741E539F9,12401,9,10,1,39,49,1999
58365,58365,B92EE1CFB5315952BB3C56E741E539F9,10901,12,14,2,35,48,1798
58366,58366,B92EE1CFB5315952BB3C56E741E539F9,42301,18,23,5,36,47,1847
58367,58367,B046A650BE0C1BBB3512CD7DA14AD148,13941,0,7,7,41,47,2097
58368,58368,B046A650BE0C1BBB3512CD7DA14AD148,13651,8,16,8,30,47,1547
58369,58369,B046A650BE0C1BBB3512CD7DA14AD148,40833,18,23,5,41,47,2097
58377,58377,C919A8058ECB429BE0036BE26BF6A160,10251,0,15,15,35,47,1797
58378,58378,C919A8058ECB429BE0036BE26BF6A160,11201,16,17,1,35,49,1799
58379,58379,C919A8058ECB429BE0036BE26BF6A160,10107,21,22,1,38,49,1949
58384,58384,87A579BD8EB5C5CE5240DDB8F2C166E2,13671,0,6,6,27,43,1393
58385,58385,87A579BD8EB5C5CE5240DDB8F2C166E2,12521,8,17,9,35,41,1791
58386,58386,87A579BD8EB5C5CE5240DDB8F2C166E2,13671,19,21,2,27,43,1393
58387,58387,87A579BD8EB5C5CE5240DDB8F2C166E2,13314,22,23,1,31,39,1589
58394,58394,FFE45FF713783B2C4B67D66C554FD1D4,40123,0,7,7,38,47,1947
58395,58395,FFE45FF713783B2C4B67D66C554FD1D4,43311,19,21,2,31,48,1598
58396,58396,FFE45FF713783B2C4B67D66C554FD1D4,10841,22,23,1,37,47,1897
58400,58400,CC63EA7467D4A1FC7EF1BC76C9DAF092,11261,0,2,2,36,46,1846
58401,58401,CC63EA7467D4A1FC7EF1BC76C9DAF092,43011,3,4,1,40,42,2042
58402,58402,CC63EA7467D4A1FC7EF1BC76C9DAF092,11261,6,21,15,36,46,1846
58403,58403,AE6EAB520A807E656142D463E66EF4F6,11231,0,6,6,37,49,1899
58404,58404,AE6EAB520A807E656142D463E66EF4F6,11481,8,10,2,41,48,2098
58405,58405,AE6EAB520A807E656142D463E66EF4F6,11231,12,15,3,37,49,1899
58406,58406,AE6EAB520A807E656142D463E66EF4F6,12391,15,16,1,36,49,1849
58407,58407,AE6EAB520A807E656142D463E66EF4F6,40341,17,19,2,23,49,1199
58408,58408,AE6EAB520A807E656142D463E66EF4F6,12083,22,23,1,36,49,1849
58409,58409,D8F61CF3289E3928FCE68B7F3A3EF9A7,43041,0,4,4,41,46,2096
58410,58410,D8F61CF3289E3928FCE68B7F3A3EF9A7,11074,7,14,7,37,47,1897
58411,58411,D8F61CF3289E3928FCE68B7F3A3EF9A7,43041,17,22,5,41,46,2096
58412,58412,34D0F1740730A8549938BF81A7322203,41271,8,17,9,38,48,1948
58413,58413,34D0F1740730A8549938BF81A7322203,12141,18,19,1,42,45,2145
58414,58414,34D0F1740730A8549938BF81A7322203,11021,19,21,2,36,49,1849
58418,58418,11B7F7677A0CABD0DA5C6CA237E025AC,10431,0,8,8,33,49,1699
58419,58419,11B7F7677A0CABD0DA5C6CA237E025AC,42411,9,10,1,40,49,2049
58420,58420,11B7F7677A0CABD0DA5C6CA237E025AC,42321,12,15,3,43,47,2197
58421,58421,11B7F7677A0CABD0DA5C6CA237E025AC,11521,15,17,2,41,48,2098
58422,58422,11B7F7677A0CABD0DA5C6CA237E025AC,43361,21,22,1,38,48,1948
58430,58430,6F60DF43E72A344D99FCB3944A72DCC7,10716,0,5,5,30,46,1546
58431,58431,6F60DF43E72A344D99FCB3944A72DCC7,42871,5,13,8,30,45,1545
58432,58432,6F60DF43E72A344D99FCB3944A72DCC7,12601,18,23,5,25,47,1297
58436,58436,D256AE34DD31744D7365602849D9C40A,42491,0,8,8,32,46,1646
58437,58437,D256AE34DD31744D7365602849D9C40A,10351,11,12,1,28,45,1445
58438,58438,D256AE34DD31744D7365602849D9C40A,42161,14,16,2,36,47,1847
58439,58439,D256AE34DD31744D7365602849D9C40A,42491,19,23,4,32,46,1646
58447,58447,16B390B832AB5B215AEBCE3943DDFC81,10251,3,5,2,35,47,1797
58448,58448,16B390B832AB5B215AEBCE3943DDFC81,11753,6,14,8,35,48,1798
58449,58449,16B390B832AB5B215AEBCE3943DDFC81,11131,16,17,1,33,48,1698
58450,58450,16B390B832AB5B215AEBCE3943DDFC81,42511,19,20,1,37,47,1897
58451,58451,16B390B832AB5B215AEBCE3943DDFC81,40636,21,23,2,35,48,1798
58458,58458,3C9F3A08BD8927B63D6BEA19D21199ED,42523,7,8,1,31,47,1597
58459,58459,3C9F3A08BD8927B63D6BEA19D21199ED,42491,8,11,3,32,46,1646
58460,58460,3C9F3A08BD8927B63D6BEA19D21199ED,42523,11,13,2,31,47,1597
58461,58461,3C9F3A08BD8927B63D6BEA19D21199ED,42491,13,16,3,32,46,1646
58462,58462,3C9F3A08BD8927B63D6BEA19D21199ED,42523,16,19,3,31,47,1597
58463,58463,3C9F3A08BD8927B63D6BEA19D21199ED,42491,20,22,2,32,46,1646
58467,58467,CD5F8D7604C7020A19DDE3C48998E9F5,13314,0,5,5,31,39,1589
58468,58468,CD5F8D7604C7020A19DDE3C48998E9F5,12521,6,9,3,35,41,1791
58469,58469,CD5F8D7604C7020A19DDE3C48998E9F5,13314,12,13,1,31,39,1589
58470,58470,CD5F8D7604C7020A19DDE3C48998E9F5,12521,14,16,2,35,41,1791
58471,58471,CD5F8D7604C7020A19DDE3C48998E9F5,13314,20,23,3,31,39,1589
58472,58472,E2F2F4143F844EB76521711717E3F1F1,12921,9,11,2,9,41,491
58473,58473,E2F2F4143F844EB76521711717E3F1F1,19261,12,13,1,6,37,337
58474,58474,E2F2F4143F844EB76521711717E3F1F1,12921,14,19,5,9,41,491
58475,58475,E2F2F4143F844EB76521711717E3F1F1,19261,20,22,2,6,37,337
58476,58476,DF06841B02D44DBD49EB5CEF0093BB66,11771,0,7,7,39,49,1999
58477,58477,DF06841B02D44DBD49EB5CEF0093BB66,40341,9,10,1,23,49,1199
58478,58478,DF06841B02D44DBD49EB5CEF0093BB66,11771,12,15,3,39,49,1999
58479,58479,DF06841B02D44DBD49EB5CEF0093BB66,11781,17,19,2,38,49,1949
58480,58480,B1C1FDAEE61465671D918557FD194833,10821,0,6,6,40,47,2047
58481,58481,B1C1FDAEE61465671D918557FD194833,12641,8,9,1,10,43,543
58482,58482,B1C1FDAEE61465671D918557FD194833,10821,13,22,9,40,47,2047
58497,58497,D3F6CC79419CB8E677F2F17C3DF072CD,13121,0,5,5,38,46,1946
58498,58498,D3F6CC79419CB8E677F2F17C3DF072CD,42301,8,9,1,36,47,1847
58499,58499,D3F6CC79419CB8E677F2F17C3DF072CD,13121,12,13,1,38,46,1946
58500,58500,D3F6CC79419CB8E677F2F17C3DF072CD,10911,13,16,3,39,46,1996
58501,58501,D3F6CC79419CB8E677F2F17C3DF072CD,13121,20,21,1,38,46,1946
58506,58506,70B4F53922DA53D577B4D93A29FCCCC0,19111,0,7,7,9,45,495
58507,58507,70B4F53922DA53D577B4D93A29FCCCC0,12921,9,12,3,9,41,491
58508,58508,70B4F53922DA53D577B4D93A29FCCCC0,19111,13,16,3,9,45,495
58509,58509,70B4F53922DA53D577B4D93A29FCCCC0,40341,17,22,5,23,49,1199
58510,58510,A5E3B472F5617B83F802942E9572716D,13681,0,15,15,38,47,1947
58511,58511,A5E3B472F5617B83F802942E9572716D,13121,15,19,4,38,46,1946
58512,58512,A5E3B472F5617B83F802942E9572716D,42471,21,23,2,35,49,1799
58516,58516,FB78D5322DE89BC4ACBA0A9E43B4FF54,41392,0,6,6,43,48,2198
58517,58517,FB78D5322DE89BC4ACBA0A9E43B4FF54,11491,7,11,4,36,47,1847
58518,58518,FB78D5322DE89BC4ACBA0A9E43B4FF54,43341,12,13,1,41,46,2096
58519,58519,FB78D5322DE89BC4ACBA0A9E43B4FF54,11491,15,16,1,36,47,1847
58520,58520,FB78D5322DE89BC4ACBA0A9E43B4FF54,10771,18,20,2,41,46,2096
58521,58521,FB78D5322DE89BC4ACBA0A9E43B4FF54,41392,20,23,3,43,48,2198
58522,58522,AE2EE7EDDD9663E9E1ACEFDB8D3CFC78,12521,0,7,7,35,41,1791
58523,58523,AE2EE7EDDD9663E9E1ACEFDB8D3CFC78,41007,9,10,1,37,47,1897
58524,58524,AE2EE7EDDD9663E9E1ACEFDB8D3CFC78,43451,12,14,2,37,40,1890
58525,58525,AE2EE7EDDD9663E9E1ACEFDB8D3CFC78,12521,18,23,5,35,41,1791
58526,58526,22DF08AB8625FB5CE36A655BC50A3649,40271,2,11,9,35,49,1799
58527,58527,22DF08AB8625FB5CE36A655BC50A3649,11741,13,14,1,42,49,2149
58528,58528,22DF08AB8625FB5CE36A655BC50A3649,11201,15,18,3,35,49,1799
58529,58529,A573FF285872EC96818445928AD4461A,13314,0,1,1,31,39,1589
58530,58530,A573FF285872EC96818445928AD4461A,13671,3,5,2,27,43,1393
58531,58531,A573FF285872EC96818445928AD4461A,13094,6,8,2,21,42,1092
58532,58532,A573FF285872EC96818445928AD4461A,13671,9,22,13,27,43,1393
58533,58533,28AE6FF44E8686DC354D2E3DF7700FCC,42461,0,6,6,45,47,2297
58534,58534,28AE6FF44E8686DC354D2E3DF7700FCC,42321,7,9,2,43,47,2197
58535,58535,28AE6FF44E8686DC354D2E3DF7700FCC,42461,12,14,2,45,47,2297
58536,58536,28AE6FF44E8686DC354D2E3DF7700FCC,42321,14,17,3,43,47,2197
58537,58537,28AE6FF44E8686DC354D2E3DF7700FCC,42461,21,23,2,45,47,2297
58547,58547,9C35C609BEEB7023F559DA7824DEFA84,11061,0,11,11,29,48,1498
58548,58548,9C35C609BEEB7023F559DA7824DEFA84,40951,14,15,1,36,49,1849
58549,58549,9C35C609BEEB7023F559DA7824DEFA84,10381,17,19,2,31,49,1599
58550,58550,4FA7E2AF35091649A8D61648BF92F5C0,42581,0,7,7,38,48,1948
58551,58551,4FA7E2AF35091649A8D61648BF92F5C0,10471,8,11,3,37,48,1898
58552,58552,4FA7E2AF35091649A8D61648BF92F5C0,42581,12,14,2,38,48,1948
58553,58553,4FA7E2AF35091649A8D61648BF92F5C0,10471,14,18,4,37,48,1898
58554,58554,4FA7E2AF35091649A8D61648BF92F5C0,42581,21,23,2,38,48,1948
58558,58558,D88BBA8AE803BA5C6A4EE38B5ABC4788,11074,1,10,9,37,47,1897
58559,58559,D88BBA8AE803BA5C6A4EE38B5ABC4788,12514,12,13,1,38,47,1947
58560,58560,D88BBA8AE803BA5C6A4EE38B5ABC4788,10781,14,15,1,35,47,1797
58561,58561,D88BBA8AE803BA5C6A4EE38B5ABC4788,13651,17,18,1,30,47,1547
58562,58562,D88BBA8AE803BA5C6A4EE38B5ABC4788,11751,19,20,1,35,48,1798
58563,58563,3FFAC3F99B451D0208FE1C282ECAF5E9,12651,0,7,7,43,47,2197
58564,58564,3FFAC3F99B451D0208FE1C282ECAF5E9,11231,12,14,2,37,49,1899
58565,58565,3FFAC3F99B451D0208FE1C282ECAF5E9,12651,14,18,4,43,47,2197
58570,58570,7EA63201A47B68AA085BD7B8AF1F7767,10721,0,7,7,31,48,1598
58571,58571,7EA63201A47B68AA085BD7B8AF1F7767,11231,8,19,11,37,49,1899
58572,58572,7EA63201A47B68AA085BD7B8AF1F7767,11591,19,21,2,36,49,1849
58573,58573,7EA63201A47B68AA085BD7B8AF1F7767,42471,21,22,1,35,49,1799
58581,58581,A8DFAF39A5A26AE1BCD9E9DE060BB315,11091,0,6,6,29,47,1497
58582,58582,A8DFAF39A5A26AE1BCD9E9DE060BB315,13651,7,11,4,30,47,1547
58583,58583,A8DFAF39A5A26AE1BCD9E9DE060BB315,11091,12,13,1,29,47,1497
58584,58584,A8DFAF39A5A26AE1BCD9E9DE060BB315,13651,14,17,3,30,47,1547
58585,58585,A8DFAF39A5A26AE1BCD9E9DE060BB315,11091,18,23,5,29,47,1497
58586,58586,598ED3D4C11C951B514B62B01BE1A106,13371,0,8,8,41,47,2097
58587,58587,598ED3D4C11C951B514B62B01BE1A106,15091,12,13,1,35,26,1776
58588,58588,598ED3D4C11C951B514B62B01BE1A106,13371,18,19,1,41,47,2097
58589,58589,09E76C7E5F88F1AE9CA216C706232DAD,43761,0,8,8,32,47,1647
58590,58590,09E76C7E5F88F1AE9CA216C706232DAD,42523,9,10,1,31,47,1597
58591,58591,09E76C7E5F88F1AE9CA216C706232DAD,43761,11,12,1,32,47,1647
58592,58592,09E76C7E5F88F1AE9CA216C706232DAD,42523,13,15,2,31,47,1597
58593,58593,09E76C7E5F88F1AE9CA216C706232DAD,43761,15,23,8,32,47,1647
58597,58597,6ED5244AA9CC2E572FA693058B662BE8,11381,0,9,9,30,47,1547
58598,58598,6ED5244AA9CC2E572FA693058B662BE8,12121,9,11,2,29,47,1497
58599,58599,6ED5244AA9CC2E572FA693058B662BE8,11381,14,16,2,30,47,1547
58600,58600,6ED5244AA9CC2E572FA693058B662BE8,12121,17,20,3,29,47,1497
58601,58601,6ED5244AA9CC2E572FA693058B662BE8,11381,20,22,2,30,47,1547
58602,58602,BF1A27B54E6EB94CFDAD91B30193CA52,11481,0,1,1,41,48,2098
58603,58603,BF1A27B54E6EB94CFDAD91B30193CA52,13101,4,5,1,40,47,2047
58604,58604,BF1A27B54E6EB94CFDAD91B30193CA52,40882,13,16,3,34,49,1749
58605,58605,BF1A27B54E6EB94CFDAD91B30193CA52,42021,19,21,2,33,47,1697
58606,58606,A4CBFA774BBCB1E081978588796288CA,10681,0,8,8,30,48,1548
58607,58607,A4CBFA774BBCB1E081978588796288CA,11231,10,17,7,37,49,1899
58608,58608,A4CBFA774BBCB1E081978588796288CA,10901,17,18,1,35,48,1798
58609,58609,A4CBFA774BBCB1E081978588796288CA,10681,21,23,2,30,48,1548
58610,58610,FCF6425DA3F542476DF1F93935C075D8,42581,0,9,9,38,48,1948
58611,58611,FCF6425DA3F542476DF1F93935C075D8,11914,9,11,2,37,48,1898
58612,58612,FCF6425DA3F542476DF1F93935C075D8,42581,12,14,2,38,48,1948
58613,58613,FCF6425DA3F542476DF1F93935C075D8,11914,14,19,5,37,48,1898
58614,58614,FCF6425DA3F542476DF1F93935C075D8,42581,19,23,4,38,48,1948
58618,58618,4EE541C2C77ED64C3476846B8EC5E510,12731,0,5,5,22,40,1140
58619,58619,4EE541C2C77ED64C3476846B8EC5E510,19801,5,8,3,19,26,976
58620,58620,4EE541C2C77ED64C3476846B8EC5E510,12871,9,11,2,22,33,1133
58621,58621,4EE541C2C77ED64C3476846B8EC5E510,19801,12,16,4,19,26,976
58622,58622,4EE541C2C77ED64C3476846B8EC5E510,19431,18,20,2,8,29,429
58623,58623,4EE541C2C77ED64C3476846B8EC5E510,43081,22,23,1,27,28,1378
58624,58624,EA1FD587726044750D83B82036123867,10191,0,8,8,40,48,2048
58625,58625,EA1FD587726044750D83B82036123867,10971,16,17,1,35,47,1797
58626,58626,EA1FD587726044750D83B82036123867,10191,20,23,3,40,48,2048
58637,58637,E191A4A4FB39AEE62DAC5F9CA16A7F16,10721,0,12,12,31,48,1598
58638,58638,E191A4A4FB39AEE62DAC5F9CA16A7F16,42151,13,14,1,35,45,1795
58639,58639,E191A4A4FB39AEE62DAC5F9CA16A7F16,10721,14,21,7,31,48,1598
58640,58640,4B5119258FB3482B746B53277561992F,12601,2,3,1,25,47,1297
58641,58641,4B5119258FB3482B746B53277561992F,12581,4,5,1,24,48,1248
58642,58642,4B5119258FB3482B746B53277561992F,12601,7,8,1,25,47,1297
58643,58643,4B5119258FB3482B746B53277561992F,10501,13,15,2,22,46,1146
58644,58644,4B5119258FB3482B746B53277561992F,12051,16,22,6,20,47,1047
58651,58651,6E802E6EED0751631BE3E26AAC23D1D7,19744,1,3,2,6,43,343
58652,58652,6E802E6EED0751631BE3E26AAC23D1D7,19114,4,5,1,7,43,393
58653,58653,6E802E6EED0751631BE3E26AAC23D1D7,12921,7,8,1,9,41,491
58654,58654,6E802E6EED0751631BE3E26AAC23D1D7,19114,11,22,11,7,43,393
58658,58658,787E2D15898542A785C91CF72E674285,13911,7,13,6,39,46,1996
58659,58659,787E2D15898542A785C91CF72E674285,11261,13,14,1,36,46,1846
58660,58660,787E2D15898542A785C91CF72E674285,13911,19,20,1,39,46,1996
58661,58661,787E2D15898542A785C91CF72E674285,42231,20,21,1,37,46,1896
58662,58662,787E2D15898542A785C91CF72E674285,13911,22,23,1,39,46,1996
58663,58663,E93D8B02977789FF5BDAF0EE317471D5,10451,0,7,7,25,48,1298
58664,58664,E93D8B02977789FF5BDAF0EE317471D5,12311,9,10,1,30,44,1544
58665,58665,E93D8B02977789FF5BDAF0EE317471D5,10451,15,23,8,25,48,1298
58666,58666,7F73A642AA11134206C46BA15C785E40,42491,0,7,7,32,46,1646
58667,58667,7F73A642AA11134206C46BA15C785E40,13651,9,12,3,30,47,1547
58668,58668,7F73A642AA11134206C46BA15C785E40,42521,12,15,3,31,47,1597
58669,58669,7F73A642AA11134206C46BA15C785E40,42491,16,18,2,32,46,1646
58670,58670,7F73A642AA11134206C46BA15C785E40,13651,20,23,3,30,47,1547
58671,58671,753369D691B504B9F7186B2CDF290F06,15391,9,11,2,35,26,1776
58672,58672,753369D691B504B9F7186B2CDF290F06,12792,13,18,5,34,30,1730
58673,58673,753369D691B504B9F7186B2CDF290F06,15391,18,23,5,35,26,1776
58677,58677,6CC3FE89A8F1A15E71D203BFCADF8D3A,11701,0,7,7,43,48,2198
58678,58678,6CC3FE89A8F1A15E71D203BFCADF8D3A,10251,8,17,9,35,47,1797
58679,58679,6CC3FE89A8F1A15E71D203BFCADF8D3A,42161,17,18,1,36,47,1847
58680,58680,6CC3FE89A8F1A15E71D203BFCADF8D3A,11701,20,23,3,43,48,2198
58681,58681,A1F76E9AE160B1A2577BA1E3948B2B29,42864,0,6,6,38,44,1944
58682,58682,A1F76E9AE160B1A2577BA1E3948B2B29,11261,6,8,2,36,46,1846
58683,58683,A1F76E9AE160B1A2577BA1E3948B2B29,42864,12,13,1,38,44,1944
58684,58684,A1F76E9AE160B1A2577BA1E3948B2B29,42861,14,16,2,37,44,1894
58685,58685,A1F76E9AE160B1A2577BA1E3948B2B29,11261,16,18,2,36,46,1846
58689,58689,72272CDC285000236363EA14A7DE70DE,12514,0,1,1,38,47,1947
58690,58690,72272CDC285000236363EA14A7DE70DE,42301,1,8,7,36,47,1847
58691,58691,72272CDC285000236363EA14A7DE70DE,11521,8,11,3,41,48,2098
58692,58692,72272CDC285000236363EA14A7DE70DE,42301,12,13,1,36,47,1847
58693,58693,72272CDC285000236363EA14A7DE70DE,43081,14,17,3,27,28,1378
58694,58694,72272CDC285000236363EA14A7DE70DE,13141,17,18,1,23,30,1180
58695,58695,72272CDC285000236363EA14A7DE70DE,42301,20,22,2,36,47,1847
58696,58696,F3B474CDCD415AC2258B7CBD95BD7C95,10351,2,11,9,28,45,1445
58697,58697,F3B474CDCD415AC2258B7CBD95BD7C95,42531,12,14,2,31,45,1595
58698,58698,F3B474CDCD415AC2258B7CBD95BD7C95,42791,16,18,2,35,45,1795
58699,58699,F3B474CDCD415AC2258B7CBD95BD7C95,12481,21,23,2,37,49,1899
58700,58700,C4D6D6893D15A40EF6C21B7CBC7CED3E,42021,3,5,2,33,47,1697
58701,58701,C4D6D6893D15A40EF6C21B7CBC7CED3E,11861,6,8,2,32,47,1647
58702,58702,C4D6D6893D15A40EF6C21B7CBC7CED3E,11541,8,14,6,35,49,1799
58703,58703,C4D6D6893D15A40EF6C21B7CBC7CED3E,40882,14,16,2,34,49,1749
58704,58704,C4D6D6893D15A40EF6C21B7CBC7CED3E,11861,19,23,4,32,47,1647
58708,58708,54E9147B0F88496112EA8083546467E6,42531,0,1,1,31,45,1595
58709,58709,54E9147B0F88496112EA8083546467E6,12661,1,7,6,32,45,1645
58710,58710,54E9147B0F88496112EA8083546467E6,12311,10,12,2,30,44,1544
58711,58711,54E9147B0F88496112EA8083546467E6,12661,13,19,6,32,45,1645
58712,58712,54E9147B0F88496112EA8083546467E6,40381,20,21,1,32,46,1646
58713,58713,073EBE93660DAEAA6A02C36811E4AA2E,12381,0,9,9,32,48,1648
58714,58714,073EBE93660DAEAA6A02C36811E4AA2E,10471,10,17,7,37,48,1898
58715,58715,073EBE93660DAEAA6A02C36811E4AA2E,12381,17,23,6,32,48,1648
58716,58716,14032B8270EF22C1D4A35716559793F7,41392,0,6,6,43,48,2198
58717,58717,14032B8270EF22C1D4A35716559793F7,11531,7,8,1,34,49,1749
58718,58718,14032B8270EF22C1D4A35716559793F7,41392,12,15,3,43,48,2198
58719,58719,14032B8270EF22C1D4A35716559793F7,11531,18,21,3,34,49,1749
58720,58720,14032B8270EF22C1D4A35716559793F7,10924,22,23,1,43,49,2199
58725,58725,42B28AE3CCE12BA9A899758E7A189C34,11806,1,7,6,41,48,2098
58726,58726,42B28AE3CCE12BA9A899758E7A189C34,10121,9,11,2,36,49,1849
58727,58727,42B28AE3CCE12BA9A899758E7A189C34,11806,13,14,1,41,48,2098
58728,58728,42B28AE3CCE12BA9A899758E7A189C34,10121,15,17,2,36,49,1849
58729,58729,42B28AE3CCE12BA9A899758E7A189C34,11806,17,19,2,41,48,2098
58730,58730,08A52BC8363090C351FBB56D380273C7,12511,0,11,11,39,47,1997
58731,58731,08A52BC8363090C351FBB56D380273C7,43761,13,19,6,32,47,1647
58732,58732,08A52BC8363090C351FBB56D380273C7,10281,21,23,2,33,48,1698
58733,58733,1B550A18B0397F926248F9A2C7B0A9DE,42341,0,8,8,43,49,2199
58734,58734,1B550A18B0397F926248F9A2C7B0A9DE,10161,12,16,4,35,49,1799
58735,58735,1B550A18B0397F926248F9A2C7B0A9DE,10591,18,20,2,39,48,1998
58736,58736,1B550A18B0397F926248F9A2C7B0A9DE,42341,21,23,2,43,49,2199
58746,58746,53493041487B5321836147FAAD536213,13101,1,2,1,40,47,2047
58747,58747,53493041487B5321836147FAAD536213,40833,4,5,1,41,47,2097
58748,58748,53493041487B5321836147FAAD536213,13101,5,6,1,40,47,2047
58749,58749,53493041487B5321836147FAAD536213,40833,8,10,2,41,47,2097
58750,58750,53493041487B5321836147FAAD536213,13101,11,17,6,40,47,2047
58751,58751,53493041487B5321836147FAAD536213,13941,20,21,1,41,47,2097
58752,58752,9EEC615F3153881C2B8DA063F5396AA6,11871,0,14,14,29,46,1496
58753,58753,9EEC615F3153881C2B8DA063F5396AA6,40951,15,17,2,36,49,1849
58754,58754,9EEC615F3153881C2B8DA063F5396AA6,11871,21,23,2,29,46,1496
58755,58755,5AF7A250F769DD424B6F153B49B360AA,11731,0,7,7,36,48,1848
58756,58756,5AF7A250F769DD424B6F153B49B360AA,12601,10,14,4,25,47,1297
58757,58757,5AF7A250F769DD424B6F153B49B360AA,10901,17,23,6,35,48,1798
58758,58758,B304D2AD98C7DE24CAE6DD0DA65095F0,10431,0,6,6,33,49,1699
58759,58759,B304D2AD98C7DE24CAE6DD0DA65095F0,11561,8,9,1,32,49,1649
58760,58760,B304D2AD98C7DE24CAE6DD0DA65095F0,43581,9,10,1,33,48,1698
58761,58761,B304D2AD98C7DE24CAE6DD0DA65095F0,10431,12,13,1,33,49,1699
58762,58762,B304D2AD98C7DE24CAE6DD0DA65095F0,11171,19,20,1,33,48,1698
58763,58763,B304D2AD98C7DE24CAE6DD0DA65095F0,10431,20,21,1,33,49,1699
58764,58764,B304D2AD98C7DE24CAE6DD0DA65095F0,10691,22,23,1,33,48,1698
58765,58765,F3EBB1CFE722422C83EBDE4383206F43,10351,10,12,2,28,45,1445
58766,58766,F3EBB1CFE722422C83EBDE4383206F43,19021,13,15,2,10,45,545
58767,58767,F3EBB1CFE722422C83EBDE4383206F43,43311,16,19,3,31,48,1598
58771,58771,5A5B2CBA296E90D3798147AFE5312824,13561,0,7,7,37,49,1899
58772,58772,5A5B2CBA296E90D3798147AFE5312824,40637,8,12,4,36,47,1847
58773,58773,5A5B2CBA296E90D3798147AFE5312824,13561,12,14,2,37,49,1899
58774,58774,5A5B2CBA296E90D3798147AFE5312824,40637,15,18,3,36,47,1847
58775,58775,5A5B2CBA296E90D3798147AFE5312824,13561,18,19,1,37,49,1899
58776,58776,5A5B2CBA296E90D3798147AFE5312824,43361,21,22,1,38,48,1948
58780,58780,8204652A3D7742C9538642482E893AC3,12641,9,11,2,10,43,543
58781,58781,8204652A3D7742C9538642482E893AC3,49201,15,17,2,7,41,391
58782,58782,8204652A3D7742C9538642482E893AC3,12641,18,20,2,10,43,543
58789,58789,32DBF03BCA351819622E1D7D83BAE631,10301,4,9,5,31,45,1595
58790,58790,32DBF03BCA351819622E1D7D83BAE631,12311,10,12,2,30,44,1544
58791,58791,32DBF03BCA351819622E1D7D83BAE631,10301,14,15,1,31,45,1595
58792,58792,32DBF03BCA351819622E1D7D83BAE631,11261,17,22,5,36,46,1846
58793,58793,D5D027DEC2E15CD439B6E37A42DFD8C1,43021,1,2,1,16,43,843
58794,58794,D5D027DEC2E15CD439B6E37A42DFD8C1,12921,2,7,5,9,41,491
58795,58795,D5D027DEC2E15CD439B6E37A42DFD8C1,43021,7,21,14,16,43,843
58796,58796,3473FA09F0017B3BD24476C962AE1520,13314,0,6,6,31,39,1589
58797,58797,3473FA09F0017B3BD24476C962AE1520,12521,11,20,9,35,41,1791
58798,58798,3473FA09F0017B3BD24476C962AE1520,13314,21,22,1,31,39,1589
58803,58803,AEE701715FEFA9408B3EA20922F57230,11731,0,8,8,36,48,1848
58804,58804,AEE701715FEFA9408B3EA20922F57230,11111,15,16,1,26,48,1348
58805,58805,AEE701715FEFA9408B3EA20922F57230,42261,19,20,1,25,49,1299
58806,58806,AEE701715FEFA9408B3EA20922F57230,11351,20,23,3,36,48,1848
58818,58818,82F8C7A7BE49F804F1905B7958B09F69,10731,0,11,11,33,47,1697
58819,58819,82F8C7A7BE49F804F1905B7958B09F69,19401,13,15,2,7,30,380
58820,58820,82F8C7A7BE49F804F1905B7958B09F69,42921,19,21,2,33,47,1697
58821,58821,9533D2CC0C11B6D7CF3A0282A578096C,10431,0,11,11,33,49,1699
58822,58822,9533D2CC0C11B6D7CF3A0282A578096C,10221,14,17,3,34,49,1749
58823,58823,9533D2CC0C11B6D7CF3A0282A578096C,10841,19,22,3,37,47,1897
58824,58824,2FCC231DE348255A3F9CDA8D77EEA7DC,12581,0,5,5,24,48,1248
58825,58825,2FCC231DE348255A3F9CDA8D77EEA7DC,12051,6,8,2,20,47,1047
58826,58826,2FCC231DE348255A3F9CDA8D77EEA7DC,12581,8,10,2,24,48,1248
58827,58827,2FCC231DE348255A3F9CDA8D77EEA7DC,12051,11,12,1,20,47,1047
58828,58828,2FCC231DE348255A3F9CDA8D77EEA7DC,12581,13,23,10,24,48,1248
58829,58829,87B1169D5A9BB025C6A10231CEED2118,19621,0,7,7,5,46,296
58830,58830,87B1169D5A9BB025C6A10231CEED2118,10841,11,14,3,37,47,1897
58831,58831,87B1169D5A9BB025C6A10231CEED2118,11861,17,21,4,32,47,1647
58832,58832,86877F32D6D32D1728C272FD8E7855F4,10281,0,7,7,33,48,1698
58833,58833,86877F32D6D32D1728C272FD8E7855F4,11861,8,10,2,32,47,1647
58834,58834,86877F32D6D32D1728C272FD8E7855F4,10281,11,15,4,33,48,1698
58835,58835,86877F32D6D32D1728C272FD8E7855F4,11861,15,18,3,32,47,1647
58836,58836,86877F32D6D32D1728C272FD8E7855F4,10281,18,23,5,33,48,1698
58837,58837,F6265BE8D5B1D90F759154EDAB63EA2C,15191,0,7,7,36,27,1827
58838,58838,F6265BE8D5B1D90F759154EDAB63EA2C,12792,10,11,1,34,30,1730
58839,58839,F6265BE8D5B1D90F759154EDAB63EA2C,15191,12,20,8,36,27,1827
58840,58840,F6265BE8D5B1D90F759154EDAB63EA2C,12792,21,22,1,34,30,1730
58841,58841,145E734E186950C5FCF9FF61BBA7968A,13221,0,10,10,40,47,2047
58842,58842,145E734E186950C5FCF9FF61BBA7968A,12161,12,14,2,32,46,1646
58843,58843,145E734E186950C5FCF9FF61BBA7968A,42401,15,20,5,36,47,1847
58844,58844,145E734E186950C5FCF9FF61BBA7968A,12161,21,23,2,32,46,1646
58845,58845,1788FF83230593384DFEF88881720D90,13551,0,7,7,45,38,2288
58846,58846,1788FF83230593384DFEF88881720D90,43101,7,10,3,46,40,2340
58847,58847,1788FF83230593384DFEF88881720D90,13551,13,16,3,45,38,2288
58848,58848,1788FF83230593384DFEF88881720D90,43101,17,19,2,46,40,2340
58849,58849,1788FF83230593384DFEF88881720D90,13551,20,22,2,45,38,2288
58850,58850,11C5ACA60B0246DE7069023057E8285F,11381,0,1,1,30,47,1547
58851,58851,11C5ACA60B0246DE7069023057E8285F,11061,1,6,5,29,48,1498
58852,58852,11C5ACA60B0246DE7069023057E8285F,11381,7,9,2,30,47,1547
58853,58853,11C5ACA60B0246DE7069023057E8285F,11061,12,13,1,29,48,1498
58854,58854,11C5ACA60B0246DE7069023057E8285F,11381,13,22,9,30,47,1547
58858,58858,3E351ABACF5670F218BE0092A1FF748D,40343,0,7,7,24,49,1249
58859,58859,3E351ABACF5670F218BE0092A1FF748D,42521,8,9,1,31,47,1597
58860,58860,3E351ABACF5670F218BE0092A1FF748D,43761,11,17,6,32,47,1647
58861,58861,3E351ABACF5670F218BE0092A1FF748D,40343,17,23,6,24,49,1249
58862,58862,51591F8EA07D8177C3E0ABFE6A0BF706,42623,5,6,1,22,49,1149
58863,58863,51591F8EA07D8177C3E0ABFE6A0BF706,13731,6,8,2,33,49,1699
58864,58864,51591F8EA07D8177C3E0ABFE6A0BF706,42623,21,22,1,22,49,1149
58865,58865,888A2C5F207F461633FB094806383657,42401,0,8,8,36,47,1847
58866,58866,888A2C5F207F461633FB094806383657,41601,11,12,1,39,49,1999
58867,58867,888A2C5F207F461633FB094806383657,10251,14,16,2,35,47,1797
58868,58868,888A2C5F207F461633FB094806383657,10111,16,18,2,37,47,1897
58876,58876,2830B08072552E656B4BCB2D696CDD6F,11061,3,12,9,29,48,1498
58877,58877,2830B08072552E656B4BCB2D696CDD6F,10121,14,17,3,36,49,1849
58878,58878,2830B08072552E656B4BCB2D696CDD6F,10292,17,20,3,30,47,1547
58879,58879,2830B08072552E656B4BCB2D696CDD6F,10661,20,22,2,37,49,1899
58880,58880,1A9C89736228FB9A13C0A496A9A8997A,40051,3,8,5,32,49,1649
58881,58881,1A9C89736228FB9A13C0A496A9A8997A,10381,9,17,8,31,49,1599
58882,58882,1A9C89736228FB9A13C0A496A9A8997A,40341,18,20,2,23,49,1199
58883,58883,3AEA3CF422288C2FFB9C65FD7BE694C9,12921,0,2,2,9,41,491
58884,58884,3AEA3CF422288C2FFB9C65FD7BE694C9,19931,3,5,2,7,43,393
58885,58885,3AEA3CF422288C2FFB9C65FD7BE694C9,12921,5,6,1,9,41,491
58886,58886,3AEA3CF422288C2FFB9C65FD7BE694C9,19931,7,10,3,7,43,393
58887,58887,3AEA3CF422288C2FFB9C65FD7BE694C9,12921,12,15,3,9,41,491
58888,58888,3AEA3CF422288C2FFB9C65FD7BE694C9,19931,15,19,4,7,43,393
58889,58889,3AEA3CF422288C2FFB9C65FD7BE694C9,12921,20,23,3,9,41,491
58890,58890,D96201B04F49DA8FE5B344343C2EC845,11861,0,6,6,32,47,1647
58891,58891,D96201B04F49DA8FE5B344343C2EC845,42151,8,15,7,35,45,1795
58892,58892,D96201B04F49DA8FE5B344343C2EC845,11861,20,23,3,32,47,1647
58908,58908,8F2DCDB1E6ACA3D4E7FFFCA1E99BF72D,42491,1,9,8,32,46,1646
58909,58909,8F2DCDB1E6ACA3D4E7FFFCA1E99BF72D,42021,9,11,2,33,47,1697
58910,58910,8F2DCDB1E6ACA3D4E7FFFCA1E99BF72D,43161,11,17,6,35,47,1797
58911,58911,8F2DCDB1E6ACA3D4E7FFFCA1E99BF72D,11841,19,20,1,33,46,1696
58912,58912,8F2DCDB1E6ACA3D4E7FFFCA1E99BF72D,10292,21,23,2,30,47,1547
58913,58913,4BEB96C1A6F8B99181CDADEF48D75275,42501,0,6,6,28,47,1447
58914,58914,4BEB96C1A6F8B99181CDADEF48D75275,42081,6,19,13,24,49,1249
58915,58915,4BEB96C1A6F8B99181CDADEF48D75275,42501,20,23,3,28,47,1447
58916,58916,A61D0F5D6E4730E77483BB5A83F54B2C,42401,0,8,8,36,47,1847
58917,58917,A61D0F5D6E4730E77483BB5A83F54B2C,10841,9,16,7,37,47,1897
58918,58918,A61D0F5D6E4730E77483BB5A83F54B2C,40697,21,22,1,43,48,2198
58926,58926,5F59FDA04080FD89C696AFDB5CAE088C,11171,0,3,3,33,48,1698
58927,58927,5F59FDA04080FD89C696AFDB5CAE088C,10431,4,5,1,33,49,1699
58928,58928,5F59FDA04080FD89C696AFDB5CAE088C,10921,15,16,1,43,48,2198
58929,58929,5F59FDA04080FD89C696AFDB5CAE088C,10221,16,19,3,34,49,1749
58930,58930,5F59FDA04080FD89C696AFDB5CAE088C,11021,21,23,2,36,49,1849
58937,58937,180C57D9A40178E5B15186C701804F1B,42931,3,6,3,41,49,2099
58938,58938,180C57D9A40178E5B15186C701804F1B,11741,9,13,4,42,49,2149
58939,58939,180C57D9A40178E5B15186C701804F1B,42971,14,15,1,43,49,2199
58940,58940,180C57D9A40178E5B15186C701804F1B,42931,17,20,3,41,49,2099
58941,58941,180C57D9A40178E5B15186C701804F1B,10421,22,23,1,41,48,2098
58942,58942,FEA371B99B04FC8CCEB8F07D4D5C7BA2,11301,0,1,1,41,49,2099
58943,58943,FEA371B99B04FC8CCEB8F07D4D5C7BA2,42511,1,2,1,37,47,1897
58944,58944,FEA371B99B04FC8CCEB8F07D4D5C7BA2,11491,3,7,4,36,47,1847
58945,58945,FEA371B99B04FC8CCEB8F07D4D5C7BA2,10151,7,8,1,34,47,1747
58946,58946,FEA371B99B04FC8CCEB8F07D4D5C7BA2,10292,8,11,3,30,47,1547
58947,58947,FEA371B99B04FC8CCEB8F07D4D5C7BA2,43161,13,14,1,35,47,1797
58948,58948,FEA371B99B04FC8CCEB8F07D4D5C7BA2,10292,16,17,1,30,47,1547
58949,58949,FEA371B99B04FC8CCEB8F07D4D5C7BA2,10151,18,21,3,34,47,1747
58950,58950,8F8549676AA02CCA4DCBC20D23BE9129,10151,0,7,7,34,47,1747
58951,58951,8F8549676AA02CCA4DCBC20D23BE9129,40611,8,10,2,35,47,1797
58952,58952,8F8549676AA02CCA4DCBC20D23BE9129,10151,12,18,6,34,47,1747
58953,58953,8F8549676AA02CCA4DCBC20D23BE9129,13711,22,23,1,38,46,1946
58963,58963,C242AD7A1BE8FEA8853CCDF59C1941FF,42511,2,8,6,37,47,1897
58964,58964,C242AD7A1BE8FEA8853CCDF59C1941FF,11021,8,13,5,36,49,1849
58965,58965,C242AD7A1BE8FEA8853CCDF59C1941FF,11541,14,17,3,35,49,1799
58966,58966,C242AD7A1BE8FEA8853CCDF59C1941FF,12151,21,22,1,41,33,2083
58967,58967,5E3291503FC27DAA0248AA453FC4D60A,19441,0,8,8,8,46,446
58968,58968,5E3291503FC27DAA0248AA453FC4D60A,11571,9,11,2,13,46,696
58969,58969,5E3291503FC27DAA0248AA453FC4D60A,19441,13,23,10,8,46,446
58980,58980,BF3354E7653978B437BDBF5412A04932,19281,0,8,8,16,32,832
58981,58981,BF3354E7653978B437BDBF5412A04932,12871,8,15,7,22,33,1133
58982,58982,BF3354E7653978B437BDBF5412A04932,19281,16,18,2,16,32,832
58983,58983,BF3354E7653978B437BDBF5412A04932,12871,22,23,1,22,33,1133
58984,58984,48DEBEEBA385EC83C5B9D50CF0F9D25A,42623,4,5,1,22,49,1149
58985,58985,48DEBEEBA385EC83C5B9D50CF0F9D25A,42121,5,6,1,26,49,1349
58986,58986,48DEBEEBA385EC83C5B9D50CF0F9D25A,42071,8,11,3,31,49,1599
58987,58987,48DEBEEBA385EC83C5B9D50CF0F9D25A,42081,11,13,2,24,49,1249
58988,58988,48DEBEEBA385EC83C5B9D50CF0F9D25A,42071,14,23,9,31,49,1599
58989,58989,F452501C7D59C983A6C3AFA992EA5B5D,42501,0,6,6,28,47,1447
58990,58990,F452501C7D59C983A6C3AFA992EA5B5D,11091,7,8,1,29,47,1497
58991,58991,F452501C7D59C983A6C3AFA992EA5B5D,42501,10,11,1,28,47,1447
58992,58992,F452501C7D59C983A6C3AFA992EA5B5D,43161,12,13,1,35,47,1797
58993,58993,F452501C7D59C983A6C3AFA992EA5B5D,42501,16,23,7,28,47,1447
58994,58994,53B9F7992DB29A9E3000FDBC39A3F0DF,11074,1,4,3,37,47,1897
58995,58995,53B9F7992DB29A9E3000FDBC39A3F0DF,10301,7,10,3,31,45,1595
58996,58996,53B9F7992DB29A9E3000FDBC39A3F0DF,11074,13,20,7,37,47,1897
59000,59000,DB3C92167D7C02EAB46060E4569D1D1B,12651,0,7,7,43,47,2197
59001,59001,DB3C92167D7C02EAB46060E4569D1D1B,10901,12,13,1,35,48,1798
59002,59002,DB3C92167D7C02EAB46060E4569D1D1B,12083,14,17,3,36,49,1849
59003,59003,DB3C92167D7C02EAB46060E4569D1D1B,11701,19,20,1,43,48,2198
59004,59004,DB3C92167D7C02EAB46060E4569D1D1B,12651,20,22,2,43,47,2197
59005,59005,F93D646A1BCE1AFF390EB78A01863C9E,10471,0,2,2,37,48,1898
59006,59006,F93D646A1BCE1AFF390EB78A01863C9E,40171,2,3,1,38,48,1948
59007,59007,F93D646A1BCE1AFF390EB78A01863C9E,10471,6,8,2,37,48,1898
59008,59008,F93D646A1BCE1AFF390EB78A01863C9E,40171,11,13,2,38,48,1948
59009,59009,F93D646A1BCE1AFF390EB78A01863C9E,10471,14,22,8,37,48,1898
59022,59022,6CBBEE1C450344F3879ED38C16F213C4,43751,9,11,2,19,48,998
59023,59023,6CBBEE1C450344F3879ED38C16F213C4,12051,12,13,1,20,47,1047
59024,59024,6CBBEE1C450344F3879ED38C16F213C4,12581,16,18,2,24,48,1248
59025,59025,6CBBEE1C450344F3879ED38C16F213C4,12051,21,23,2,20,47,1047
59029,59029,AD6F9A14008422C5A94CD73490322DA1,13821,0,11,11,49,45,2495
59030,59030,AD6F9A14008422C5A94CD73490322DA1,11481,11,14,3,41,48,2098
59031,59031,AD6F9A14008422C5A94CD73490322DA1,11291,16,21,5,40,49,2049
59032,59032,44EC2B0D5EE5BD6B35ABC292F1B0BE4A,19181,0,2,2,8,40,440
59033,59033,44EC2B0D5EE5BD6B35ABC292F1B0BE4A,12641,5,7,2,10,43,543
59034,59034,44EC2B0D5EE5BD6B35ABC292F1B0BE4A,12921,7,9,2,9,41,491
59035,59035,44EC2B0D5EE5BD6B35ABC292F1B0BE4A,12641,14,16,2,10,43,543
59036,59036,44EC2B0D5EE5BD6B35ABC292F1B0BE4A,19181,16,17,1,8,40,440
59037,59037,44EC2B0D5EE5BD6B35ABC292F1B0BE4A,49201,20,21,1,7,41,391
59038,59038,B07F9654999A27B565B093B7A4D6A968,11661,0,6,6,40,49,2049
59039,59039,B07F9654999A27B565B093B7A4D6A968,11481,9,11,2,41,48,2098
59040,59040,B07F9654999A27B565B093B7A4D6A968,11021,13,17,4,36,49,1849
59041,59041,B07F9654999A27B565B093B7A4D6A968,43391,19,20,1,29,48,1498
59055,59055,57068447BEEE4D7969FF166D57966ECA,42541,0,6,6,25,47,1297
59056,59056,57068447BEEE4D7969FF166D57966ECA,11361,6,10,4,22,48,1148
59057,59057,57068447BEEE4D7969FF166D57966ECA,42541,12,13,1,25,47,1297
59058,59058,57068447BEEE4D7969FF166D57966ECA,11361,13,15,2,22,48,1148
59059,59059,57068447BEEE4D7969FF166D57966ECA,12581,15,17,2,24,48,1248
59060,59060,57068447BEEE4D7969FF166D57966ECA,42541,20,23,3,25,47,1297
59061,59061,29ED7585A7C0FD6B2E71E72A2B2372DE,12311,0,7,7,30,44,1544
59062,59062,29ED7585A7C0FD6B2E71E72A2B2372DE,42781,11,18,7,36,46,1846
59063,59063,29ED7585A7C0FD6B2E71E72A2B2372DE,12311,20,22,2,30,44,1544
59067,59067,7C6533C0224770EA8D8739703C562233,42471,0,8,8,35,49,1799
59068,59068,7C6533C0224770EA8D8739703C562233,10292,9,18,9,30,47,1547
59069,59069,7C6533C0224770EA8D8739703C562233,42471,20,22,2,35,49,1799
59073,59073,E1C859FD8CC74565ED07635B54DBAB6A,43761,0,6,6,32,47,1647
59074,59074,E1C859FD8CC74565ED07635B54DBAB6A,12601,8,10,2,25,47,1297
59075,59075,E1C859FD8CC74565ED07635B54DBAB6A,11061,12,17,5,29,48,1498
59076,59076,E1C859FD8CC74565ED07635B54DBAB6A,43761,20,22,2,32,47,1647
59084,59084,6FD0A6F8A40C4655F4AA9AE9A6F213BC,42981,0,7,7,36,49,1849
59085,59085,6FD0A6F8A40C4655F4AA9AE9A6F213BC,15641,9,11,2,9,21,471
59086,59086,6FD0A6F8A40C4655F4AA9AE9A6F213BC,12731,11,12,1,22,40,1140
59087,59087,6FD0A6F8A40C4655F4AA9AE9A6F213BC,12083,14,17,3,36,49,1849
59088,59088,6FD0A6F8A40C4655F4AA9AE9A6F213BC,11751,19,20,1,35,48,1798
59089,59089,6FD0A6F8A40C4655F4AA9AE9A6F213BC,11021,20,22,2,36,49,1849
59100,59100,83F0AC74871DF8476C7F29B2735E6CC0,10691,0,1,1,33,48,1698
59101,59101,83F0AC74871DF8476C7F29B2735E6CC0,10811,2,17,15,38,46,1946
59102,59102,83F0AC74871DF8476C7F29B2735E6CC0,10111,19,23,4,37,47,1897
59103,59103,39FE202DD8E1237CB5119DC2A5DD1945,13791,0,8,8,42,47,2147
59104,59104,39FE202DD8E1237CB5119DC2A5DD1945,42461,9,11,2,45,47,2297
59105,59105,39FE202DD8E1237CB5119DC2A5DD1945,13791,13,16,3,42,47,2147
59106,59106,39FE202DD8E1237CB5119DC2A5DD1945,10421,17,18,1,41,48,2098
59107,59107,39FE202DD8E1237CB5119DC2A5DD1945,10491,19,21,2,33,48,1698
59118,59118,4BCE8F3D44B6D775FF828315B62C8CD6,13371,0,8,8,41,47,2097
59119,59119,4BCE8F3D44B6D775FF828315B62C8CD6,11781,9,17,8,38,49,1949
59120,59120,4BCE8F3D44B6D775FF828315B62C8CD6,13371,18,22,4,41,47,2097
59121,59121,6A033A0EADDB46E67519B419B27B2B4B,12031,0,6,6,33,48,1698
59122,59122,6A033A0EADDB46E67519B419B27B2B4B,11641,8,15,7,22,49,1149
59123,59123,6A033A0EADDB46E67519B419B27B2B4B,10491,19,23,4,33,48,1698
59131,59131,884D0F3F0399E45AD292FC787967C25B,11875,1,6,5,30,46,1546
59132,59132,884D0F3F0399E45AD292FC787967C25B,10061,8,9,1,20,46,1046
59133,59133,884D0F3F0399E45AD292FC787967C25B,11875,12,23,11,30,46,1546
59134,59134,C23C395E1758AD19CFCD20328E385B2B,40637,0,7,7,36,47,1847
59135,59135,C23C395E1758AD19CFCD20328E385B2B,10531,9,10,1,34,46,1746
59136,59136,C23C395E1758AD19CFCD20328E385B2B,11806,11,14,3,41,48,2098
59137,59137,C23C395E1758AD19CFCD20328E385B2B,40637,19,23,4,36,47,1847
59138,59138,ED14F75680A1780D0C6AF7290516296F,10281,0,7,7,33,48,1698
59139,59139,ED14F75680A1780D0C6AF7290516296F,43731,7,9,2,34,47,1747
59140,59140,ED14F75680A1780D0C6AF7290516296F,43661,12,13,1,33,47,1697
59141,59141,ED14F75680A1780D0C6AF7290516296F,10971,13,15,2,35,47,1797
59142,59142,ED14F75680A1780D0C6AF7290516296F,43731,15,16,1,34,47,1747
59143,59143,ED14F75680A1780D0C6AF7290516296F,10281,18,23,5,33,48,1698
59148,59148,9EC16DD8D58D40C2355CD3D8751C16A6,42623,2,5,3,22,49,1149
59149,59149,9EC16DD8D58D40C2355CD3D8751C16A6,42261,10,12,2,25,49,1299
59150,59150,9EC16DD8D58D40C2355CD3D8751C16A6,42071,17,19,2,31,49,1599
59151,59151,1C04D8021AA3D6ACE9D6057D8C5BDA46,43011,7,8,1,40,42,2042
59152,59152,1C04D8021AA3D6ACE9D6057D8C5BDA46,12211,8,9,1,41,44,2094
59153,59153,1C04D8021AA3D6ACE9D6057D8C5BDA46,10751,12,13,1,47,43,2393
59154,59154,1C04D8021AA3D6ACE9D6057D8C5BDA46,43011,17,18,1,40,42,2042
59158,59158,8B162D826614AE6B0D3DB5A304485836,11771,0,7,7,39,49,1999
59159,59159,8B162D826614AE6B0D3DB5A304485836,11914,8,10,2,37,48,1898
59160,59160,8B162D826614AE6B0D3DB5A304485836,42581,11,12,1,38,48,1948
59161,59161,8B162D826614AE6B0D3DB5A304485836,11914,13,19,6,37,48,1898
59162,59162,8B162D826614AE6B0D3DB5A304485836,10191,20,22,2,40,48,2048
59163,59163,A99DE7D86F2D30649282D24CB5ECED25,42301,0,6,6,36,47,1847
59164,59164,A99DE7D86F2D30649282D24CB5ECED25,11331,8,10,2,37,48,1898
59165,59165,A99DE7D86F2D30649282D24CB5ECED25,42941,12,13,1,37,47,1897
59166,59166,A99DE7D86F2D30649282D24CB5ECED25,42301,14,16,2,36,47,1847
59167,59167,A99DE7D86F2D30649282D24CB5ECED25,42941,18,23,5,37,47,1897
59171,59171,5F1CDF83601012544D7C0296F1D917AC,13651,0,16,16,30,47,1547
59172,59172,5F1CDF83601012544D7C0296F1D917AC,13091,17,18,1,20,42,1042
59173,59173,5F1CDF83601012544D7C0296F1D917AC,13651,20,22,2,30,47,1547
59191,59191,2F9DD2103B445395E7BF01F65CA38D58,11061,0,13,13,29,48,1498
59192,59192,2F9DD2103B445395E7BF01F65CA38D58,10295,13,16,3,30,47,1547
59193,59193,2F9DD2103B445395E7BF01F65CA38D58,11061,17,19,2,29,48,1498
59194,59194,2F9DD2103B445395E7BF01F65CA38D58,10381,19,20,1,31,49,1599
59195,59195,2F9DD2103B445395E7BF01F65CA38D58,11061,21,23,2,29,48,1498
59199,59199,2C38A109406D979957BFC7615FC6F054,12083,10,11,1,36,49,1849
59200,59200,2C38A109406D979957BFC7615FC6F054,11201,15,16,1,35,49,1799
59201,59201,2C38A109406D979957BFC7615FC6F054,10061,20,21,1,20,46,1046
59202,59202,20538B8C1777892DA77867D1D04B5D49,43761,0,2,2,32,47,1647
59203,59203,20538B8C1777892DA77867D1D04B5D49,11161,3,8,5,32,48,1648
59204,59204,20538B8C1777892DA77867D1D04B5D49,43761,9,11,2,32,47,1647
59205,59205,20538B8C1777892DA77867D1D04B5D49,11161,17,19,2,32,48,1648
59206,59206,20538B8C1777892DA77867D1D04B5D49,43761,21,23,2,32,47,1647
59207,59207,F270E2429049EC12B817A3B7398AF53A,10111,0,11,11,37,47,1897
59208,59208,F270E2429049EC12B817A3B7398AF53A,11211,12,14,2,34,49,1749
59209,59209,F270E2429049EC12B817A3B7398AF53A,10111,15,23,8,37,47,1897
59210,59210,EC971BEA56DBA93E199ED44EE6EDF346,11861,0,8,8,32,47,1647
59211,59211,EC971BEA56DBA93E199ED44EE6EDF346,42961,11,12,1,35,49,1799
59212,59212,EC971BEA56DBA93E199ED44EE6EDF346,11861,12,14,2,32,47,1647
59213,59213,EC971BEA56DBA93E199ED44EE6EDF346,42471,15,16,1,35,49,1799
59214,59214,EC971BEA56DBA93E199ED44EE6EDF346,11861,19,23,4,32,47,1647
59215,59215,A0726C803D54356D79A20E6BD9BC86DB,42161,2,8,6,36,47,1847
59216,59216,A0726C803D54356D79A20E6BD9BC86DB,10771,8,15,7,41,46,2096
59217,59217,A0726C803D54356D79A20E6BD9BC86DB,41591,18,20,2,34,49,1749
59218,59218,A0726C803D54356D79A20E6BD9BC86DB,10251,21,23,2,35,47,1797
59222,59222,1392C8E19F85085262C8C4C5B019D410,11074,0,14,14,37,47,1897
59223,59223,1392C8E19F85085262C8C4C5B019D410,42261,15,17,2,25,49,1299
59224,59224,1392C8E19F85085262C8C4C5B019D410,12391,18,23,5,36,49,1849
59225,59225,1425A0F2912750FA0EF5B4ADBC6542C9,40271,0,17,17,35,49,1799
59226,59226,1425A0F2912750FA0EF5B4ADBC6542C9,13911,17,19,2,39,46,1996
59227,59227,1425A0F2912750FA0EF5B4ADBC6542C9,40271,20,23,3,35,49,1799
59231,59231,746F9DB3F3845FA01FE3E393E29078E3,12841,0,9,9,37,47,1897
59232,59232,746F9DB3F3845FA01FE3E393E29078E3,11271,11,12,1,37,48,1898
59233,59233,746F9DB3F3845FA01FE3E393E29078E3,10781,14,18,4,35,47,1797
59234,59234,746F9DB3F3845FA01FE3E393E29078E3,11541,19,20,1,35,49,1799
59235,59235,746F9DB3F3845FA01FE3E393E29078E3,12841,22,23,1,37,47,1897
59239,59239,CFF4943452741BA085C68AD1AAC66347,10331,0,7,7,39,46,1996
59240,59240,CFF4943452741BA085C68AD1AAC66347,13101,11,12,1,40,47,2047
59241,59241,CFF4943452741BA085C68AD1AAC66347,10331,12,14,2,39,46,1996
59242,59242,CFF4943452741BA085C68AD1AAC66347,11806,15,18,3,41,48,2098
59243,59243,CFF4943452741BA085C68AD1AAC66347,10331,19,22,3,39,46,1996
59244,59244,3C38CE41549C3832858DD70917A3704F,43361,0,8,8,38,48,1948
59245,59245,3C38CE41549C3832858DD70917A3704F,11831,10,11,1,32,45,1645
59246,59246,3C38CE41549C3832858DD70917A3704F,43361,12,16,4,38,48,1948
59247,59247,3C38CE41549C3832858DD70917A3704F,10431,18,20,2,33,49,1699
59248,59248,3C38CE41549C3832858DD70917A3704F,43361,22,23,1,38,48,1948
59256,59256,A9FAA4B4C51A5D14416D1899F40B6E9A,13481,0,4,4,26,31,1331
59257,59257,A9FAA4B4C51A5D14416D1899F40B6E9A,12871,4,7,3,22,33,1133
59258,59258,A9FAA4B4C51A5D14416D1899F40B6E9A,19801,7,8,1,19,26,976
59259,59259,A9FAA4B4C51A5D14416D1899F40B6E9A,40341,12,16,4,23,49,1199
59260,59260,A9FAA4B4C51A5D14416D1899F40B6E9A,19801,17,23,6,19,26,976
59261,59261,AE5EC73B53E9C3CD1EC48FB8238BD121,10221,1,13,12,34,49,1749
59262,59262,AE5EC73B53E9C3CD1EC48FB8238BD121,40381,14,15,1,32,46,1646
59263,59263,AE5EC73B53E9C3CD1EC48FB8238BD121,10221,20,23,3,34,49,1749
59268,59268,342CC9D4491699129B7192D0E2F535DF,19931,0,5,5,7,43,393
59269,59269,342CC9D4491699129B7192D0E2F535DF,12641,8,10,2,10,43,543
59270,59270,342CC9D4491699129B7192D0E2F535DF,19931,11,12,1,7,43,393
59271,59271,342CC9D4491699129B7192D0E2F535DF,12641,14,15,1,10,43,543
59272,59272,342CC9D4491699129B7192D0E2F535DF,19931,18,23,5,7,43,393
59273,59273,963EE041DECC24D8840EC7491E56EF2D,11381,0,17,17,30,47,1547
59274,59274,963EE041DECC24D8840EC7491E56EF2D,12021,19,21,2,37,49,1899
59275,59275,963EE041DECC24D8840EC7491E56EF2D,11381,22,23,1,30,47,1547
59276,59276,89E9D5A5271FF46B57D9025356B7D83E,10251,2,11,9,35,47,1797
59277,59277,89E9D5A5271FF46B57D9025356B7D83E,11201,16,17,1,35,49,1799
59278,59278,89E9D5A5271FF46B57D9025356B7D83E,10107,20,22,2,38,49,1949
59279,59279,C5BE39F043AAB34786E4C31AB48CACA0,43751,0,2,2,19,48,998
59280,59280,C5BE39F043AAB34786E4C31AB48CACA0,12051,2,6,4,20,47,1047
59281,59281,C5BE39F043AAB34786E4C31AB48CACA0,42691,6,19,13,24,48,1248
59282,59282,56547DCD12E76D718E2E60F15A40B9D5,43761,0,7,7,32,47,1647
59283,59283,56547DCD12E76D718E2E60F15A40B9D5,10781,10,18,8,35,47,1797
59284,59284,56547DCD12E76D718E2E60F15A40B9D5,10111,19,23,4,37,47,1897
59288,59288,521AFAC783F6AE564AB1A82096DD5FBF,42623,0,14,14,22,49,1149
59289,59289,521AFAC783F6AE564AB1A82096DD5FBF,11074,18,19,1,37,47,1897
59290,59290,521AFAC783F6AE564AB1A82096DD5FBF,42623,21,23,2,22,49,1149
59294,59294,A2DD7BA75FCE1B5306A377D198F94491,15391,3,12,9,35,26,1776
59295,59295,A2DD7BA75FCE1B5306A377D198F94491,12792,16,18,2,34,30,1730
59296,59296,A2DD7BA75FCE1B5306A377D198F94491,15391,20,22,2,35,26,1776
59297,59297,62E083FD6CCFD94FFA49C92986AAE56D,10281,0,6,6,33,48,1698
59298,59298,62E083FD6CCFD94FFA49C92986AAE56D,43761,9,10,1,32,47,1647
59299,59299,62E083FD6CCFD94FFA49C92986AAE56D,10281,11,12,1,33,48,1698
59300,59300,62E083FD6CCFD94FFA49C92986AAE56D,43761,14,16,2,32,47,1647
59301,59301,62E083FD6CCFD94FFA49C92986AAE56D,10281,20,21,1,33,48,1698
59302,59302,10F263436D1CF020ECB2683CEE4C6509,42523,7,8,1,31,47,1597
59303,59303,10F263436D1CF020ECB2683CEE4C6509,12971,9,10,1,32,48,1648
59304,59304,10F263436D1CF020ECB2683CEE4C6509,42471,20,21,1,35,49,1799
59308,59308,40A3F567657A043546A2ED7A5DC91A85,12792,0,5,5,34,30,1730
59309,59309,40A3F567657A043546A2ED7A5DC91A85,15331,5,9,4,38,24,1924
59310,59310,40A3F567657A043546A2ED7A5DC91A85,12792,13,22,9,34,30,1730
59311,59311,E5C174D2FF195FD116006ADE577A953D,11061,0,6,6,29,48,1498
59312,59312,E5C174D2FF195FD116006ADE577A953D,11151,7,12,5,30,48,1548
59313,59313,E5C174D2FF195FD116006ADE577A953D,43281,13,15,2,37,48,1898
59314,59314,E5C174D2FF195FD116006ADE577A953D,11151,18,20,2,30,48,1548
59321,59321,EC1722613FE796BEC32CA3A55D02E02D,13941,0,6,6,41,47,2097
59322,59322,EC1722613FE796BEC32CA3A55D02E02D,10531,7,18,11,34,46,1746
59323,59323,EC1722613FE796BEC32CA3A55D02E02D,11201,21,22,1,35,49,1799
59324,59324,BB6408B6449FE57F7E33631A828BC98E,40697,0,2,2,43,48,2198
59325,59325,BB6408B6449FE57F7E33631A828BC98E,11521,3,8,5,41,48,2098
59326,59326,BB6408B6449FE57F7E33631A828BC98E,13961,9,11,2,42,48,2148
59327,59327,BB6408B6449FE57F7E33631A828BC98E,11701,13,14,1,43,48,2198
59328,59328,BB6408B6449FE57F7E33631A828BC98E,11301,17,19,2,41,49,2099
59329,59329,BB6408B6449FE57F7E33631A828BC98E,11701,20,22,2,43,48,2198
59333,59333,0A15402BF50F336CD996C3C85D01B359,10471,0,7,7,37,48,1898
59334,59334,0A15402BF50F336CD996C3C85D01B359,13511,7,10,3,34,48,1748
59335,59335,0A15402BF50F336CD996C3C85D01B359,10471,11,14,3,37,48,1898
59336,59336,0A15402BF50F336CD996C3C85D01B359,41621,16,17,1,38,49,1949
59337,59337,0A15402BF50F336CD996C3C85D01B359,10471,22,23,1,37,48,1898
59338,59338,AB57CFBC7FBBD1B4F46C04046F726522,15171,0,5,5,42,21,2121
59339,59339,AB57CFBC7FBBD1B4F46C04046F726522,15021,6,17,11,46,18,2318
59340,59340,AB57CFBC7FBBD1B4F46C04046F726522,12881,19,21,2,47,22,2372
59341,59341,CA1B9ACB7CDB4B3F62D420FC7FF69763,12311,0,16,16,30,44,1544
59342,59342,CA1B9ACB7CDB4B3F62D420FC7FF69763,11151,17,19,2,30,48,1548
59343,59343,CA1B9ACB7CDB4B3F62D420FC7FF69763,11061,19,20,1,29,48,1498
59344,59344,37F1D2311F2383134D9A7BD374E33133,12051,0,4,4,20,47,1047
59345,59345,37F1D2311F2383134D9A7BD374E33133,42691,5,7,2,24,48,1248
59346,59346,37F1D2311F2383134D9A7BD374E33133,10501,11,19,8,22,46,1146
59350,59350,9F589AB01E58B6B2CA9FB997F96CB7F3,13071,0,6,6,41,41,2091
59351,59351,9F589AB01E58B6B2CA9FB997F96CB7F3,43451,8,20,12,37,40,1890
59352,59352,9F589AB01E58B6B2CA9FB997F96CB7F3,13071,21,23,2,41,41,2091
59356,59356,D19CCADD05AE7D38BD327DD3B3A1E602,42351,0,7,7,38,45,1945
59357,59357,D19CCADD05AE7D38BD327DD3B3A1E602,42231,8,9,1,37,46,1896
59358,59358,D19CCADD05AE7D38BD327DD3B3A1E602,42351,12,13,1,38,45,1945
59359,59359,D19CCADD05AE7D38BD327DD3B3A1E602,42231,16,17,1,37,46,1896
59360,59360,D19CCADD05AE7D38BD327DD3B3A1E602,42351,19,23,4,38,45,1945
59364,59364,3A0EE9386BA4FE78C3588E05656D5E25,13371,0,18,18,41,47,2097
59365,59365,3A0EE9386BA4FE78C3588E05656D5E25,11061,19,20,1,29,48,1498
59366,59366,3A0EE9386BA4FE78C3588E05656D5E25,13371,21,23,2,41,47,2097
59367,59367,4CEF2D9D71549E955305B2DC8309A78D,43021,0,5,5,16,43,843
59368,59368,4CEF2D9D71549E955305B2DC8309A78D,12921,5,11,6,9,41,491
59369,59369,4CEF2D9D71549E955305B2DC8309A78D,43021,12,13,1,16,43,843
59370,59370,4CEF2D9D71549E955305B2DC8309A78D,12921,14,18,4,9,41,491
59371,59371,4CEF2D9D71549E955305B2DC8309A78D,43021,22,23,1,16,43,843
59372,59372,8FFFB1045B67B7DEF96CD971C93188B0,11954,0,2,2,32,49,1649
59373,59373,8FFFB1045B67B7DEF96CD971C93188B0,42071,3,5,2,31,49,1599
59374,59374,8FFFB1045B67B7DEF96CD971C93188B0,13731,7,9,2,33,49,1699
59375,59375,8FFFB1045B67B7DEF96CD971C93188B0,11211,19,21,2,34,49,1749
59376,59376,8FFFB1045B67B7DEF96CD971C93188B0,13731,21,22,1,33,49,1699
59377,59377,427F3BA7DB39CFE7889ED0D15B16FAB9,13121,0,6,6,38,46,1946
59378,59378,427F3BA7DB39CFE7889ED0D15B16FAB9,42511,7,11,4,37,47,1897
59379,59379,427F3BA7DB39CFE7889ED0D15B16FAB9,13121,14,16,2,38,46,1946
59380,59380,427F3BA7DB39CFE7889ED0D15B16FAB9,10331,19,20,1,39,46,1996
59381,59381,427F3BA7DB39CFE7889ED0D15B16FAB9,13121,21,23,2,38,46,1946
59382,59382,36E4D456967ADF7C503C23EAE8460AAD,42523,0,1,1,31,47,1597
59383,59383,36E4D456967ADF7C503C23EAE8460AAD,13651,2,14,12,30,47,1547
59384,59384,36E4D456967ADF7C503C23EAE8460AAD,42523,16,17,1,31,47,1597
59385,59385,36E4D456967ADF7C503C23EAE8460AAD,13371,19,21,2,41,47,2097
59389,59389,59644621240D60A0095CD2C9DBFE93CE,12874,1,5,4,20,34,1034
59390,59390,59644621240D60A0095CD2C9DBFE93CE,19801,6,7,1,19,26,976
59391,59391,59644621240D60A0095CD2C9DBFE93CE,12871,8,15,7,22,33,1133
59392,59392,59644621240D60A0095CD2C9DBFE93CE,19801,16,18,2,19,26,976
59393,59393,59644621240D60A0095CD2C9DBFE93CE,13481,22,23,1,26,31,1331
59394,59394,3B1652323581ED0C73DAFA8FB6CC2552,12641,0,1,1,10,43,543
59395,59395,3B1652323581ED0C73DAFA8FB6CC2552,43021,2,3,1,16,43,843
59396,59396,3B1652323581ED0C73DAFA8FB6CC2552,12641,4,5,1,10,43,543
59397,59397,3B1652323581ED0C73DAFA8FB6CC2552,12921,6,8,2,9,41,491
59398,59398,3B1652323581ED0C73DAFA8FB6CC2552,43021,13,15,2,16,43,843
59399,59399,3B1652323581ED0C73DAFA8FB6CC2552,12921,19,20,1,9,41,491
59400,59400,0D8B65538247AAF24C9243214566763E,11381,0,16,16,30,47,1547
59401,59401,0D8B65538247AAF24C9243214566763E,11061,16,17,1,29,48,1498
59402,59402,0D8B65538247AAF24C9243214566763E,11381,19,20,1,30,47,1547
59403,59403,0D8B65538247AAF24C9243214566763E,11631,21,23,2,12,49,649
59407,59407,4D239E998445105BB1DB28C4CB8040D2,11914,10,11,1,37,48,1898
59408,59408,4D239E998445105BB1DB28C4CB8040D2,42581,15,16,1,38,48,1948
59409,59409,4D239E998445105BB1DB28C4CB8040D2,11914,17,18,1,37,48,1898
59410,59410,4D239E998445105BB1DB28C4CB8040D2,11771,20,21,1,39,49,1999
59411,59411,4D239E998445105BB1DB28C4CB8040D2,42581,22,23,1,38,48,1948
59418,59418,0A27EAE690B1EA20001899CE496B6598,19744,0,4,4,6,43,343
59419,59419,0A27EAE690B1EA20001899CE496B6598,12921,6,11,5,9,41,491
59420,59420,0A27EAE690B1EA20001899CE496B6598,19744,11,18,7,6,43,343
59432,59432,8AAC9B0360B400B1E5D90FCE943FCB69,42971,1,8,7,43,49,2199
59433,59433,8AAC9B0360B400B1E5D90FCE943FCB69,10841,11,12,1,37,47,1897
59434,59434,8AAC9B0360B400B1E5D90FCE943FCB69,12391,22,23,1,36,49,1849
59435,59435,84D5DD5743261CBA6220A6F1E627F47F,11061,0,2,2,29,48,1498
59436,59436,84D5DD5743261CBA6220A6F1E627F47F,11151,2,5,3,30,48,1548
59437,59437,84D5DD5743261CBA6220A6F1E627F47F,11061,8,15,7,29,48,1498
59438,59438,84D5DD5743261CBA6220A6F1E627F47F,12521,17,22,5,35,41,1791
59439,59439,333A8A11E915F2E19F0494EB62C5C06D,11151,3,5,2,30,48,1548
59440,59440,333A8A11E915F2E19F0494EB62C5C06D,10381,9,11,2,31,49,1599
59441,59441,333A8A11E915F2E19F0494EB62C5C06D,11061,15,16,1,29,48,1498
59442,59442,333A8A11E915F2E19F0494EB62C5C06D,10381,16,18,2,31,49,1599
59443,59443,333A8A11E915F2E19F0494EB62C5C06D,11061,21,22,1,29,48,1498
59455,59455,1FF80D2D93D85E7E7CD7674A4424222F,43501,0,8,8,27,48,1398
59456,59456,1FF80D2D93D85E7E7CD7674A4424222F,49201,10,13,3,7,41,391
59457,59457,1FF80D2D93D85E7E7CD7674A4424222F,19901,13,15,2,7,44,394
59458,59458,1FF80D2D93D85E7E7CD7674A4424222F,12921,15,16,1,9,41,491
59459,59459,1FF80D2D93D85E7E7CD7674A4424222F,43501,17,19,2,27,48,1398
59466,59466,83324CA5FAD335C37A1D2CE62BC04E32,13471,1,14,13,47,49,2399
59467,59467,83324CA5FAD335C37A1D2CE62BC04E32,42051,15,16,1,42,48,2148
59468,59468,83324CA5FAD335C37A1D2CE62BC04E32,41393,18,22,4,43,49,2199
59469,59469,2B174A2FF1063311A281D3E6DB697BD8,11231,0,9,9,37,49,1899
59470,59470,2B174A2FF1063311A281D3E6DB697BD8,13951,10,14,4,47,45,2395
59471,59471,2B174A2FF1063311A281D3E6DB697BD8,42201,16,18,2,43,46,2196
59472,59472,2B174A2FF1063311A281D3E6DB697BD8,11231,19,23,4,37,49,1899
59476,59476,C46CDF3840B783157CCBA7C0D999F0A9,10292,0,8,8,30,47,1547
59477,59477,C46CDF3840B783157CCBA7C0D999F0A9,42491,10,12,2,32,46,1646
59478,59478,C46CDF3840B783157CCBA7C0D999F0A9,10292,16,17,1,30,47,1547
59479,59479,C46CDF3840B783157CCBA7C0D999F0A9,42491,18,19,1,32,46,1646
59480,59480,C46CDF3840B783157CCBA7C0D999F0A9,10292,20,22,2,30,47,1547
59481,59481,E7F0BEFEB527574747952B709C847F2A,15051,1,14,13,19,4,954
59482,59482,E7F0BEFEB527574747952B709C847F2A,16281,15,16,1,11,4,554
59483,59483,E7F0BEFEB527574747952B709C847F2A,15051,20,21,1,19,4,954
59487,59487,83DDDB2A2DBBCCAE17311FDB8B95E64A,41004,0,7,7,37,47,1897
59488,59488,83DDDB2A2DBBCCAE17311FDB8B95E64A,12083,7,9,2,36,49,1849
59489,59489,83DDDB2A2DBBCCAE17311FDB8B95E64A,41004,10,13,3,37,47,1897
59490,59490,83DDDB2A2DBBCCAE17311FDB8B95E64A,11231,14,16,2,37,49,1899
59491,59491,83DDDB2A2DBBCCAE17311FDB8B95E64A,11211,18,20,2,34,49,1749
59492,59492,83DDDB2A2DBBCCAE17311FDB8B95E64A,41004,21,23,2,37,47,1897
59497,59497,F276DA0C0E39AE3BAD5B91AE46CB6EA8,42971,0,5,5,43,49,2199
59498,59498,F276DA0C0E39AE3BAD5B91AE46CB6EA8,10471,8,12,4,37,48,1898
59499,59499,F276DA0C0E39AE3BAD5B91AE46CB6EA8,11231,13,15,2,37,49,1899
59500,59500,F276DA0C0E39AE3BAD5B91AE46CB6EA8,10471,18,20,2,37,48,1898
59504,59504,665D84DE00719CFBCFE85E60D38EDE84,12514,2,11,9,38,47,1947
59505,59505,665D84DE00719CFBCFE85E60D38EDE84,12511,13,16,3,39,47,1997
59506,59506,665D84DE00719CFBCFE85E60D38EDE84,11201,19,23,4,35,49,1799
59510,59510,58248472739B462ECE2ED62B9B35F4B0,42921,2,10,8,33,47,1697
59511,59511,58248472739B462ECE2ED62B9B35F4B0,11861,12,13,1,32,47,1647
59512,59512,58248472739B462ECE2ED62B9B35F4B0,42921,14,16,2,33,47,1697
59513,59513,58248472739B462ECE2ED62B9B35F4B0,11861,17,19,2,32,47,1647
59514,59514,58248472739B462ECE2ED62B9B35F4B0,42921,20,23,3,33,47,1697
59515,59515,188BEFAC54548292E9330D4E5259794C,43751,1,12,11,19,48,998
59516,59516,188BEFAC54548292E9330D4E5259794C,40341,13,19,6,23,49,1199
59517,59517,188BEFAC54548292E9330D4E5259794C,43751,19,23,4,19,48,998
59518,59518,81565F9704E60766FEFBB47B416D00DF,12581,0,5,5,24,48,1248
59519,59519,81565F9704E60766FEFBB47B416D00DF,12051,7,9,2,20,47,1047
59520,59520,81565F9704E60766FEFBB47B416D00DF,12581,10,23,13,24,48,1248
59527,59527,CE42FB703E5A8466F11E1B10B1063DB7,42271,1,6,5,40,47,2047
59528,59528,CE42FB703E5A8466F11E1B10B1063DB7,42281,11,15,4,40,48,2048
59529,59529,CE42FB703E5A8466F11E1B10B1063DB7,41007,17,18,1,37,47,1897
59530,59530,CE42FB703E5A8466F11E1B10B1063DB7,11631,22,23,1,12,49,649
59531,59531,46E2E10251607E59BAC1F84F8487D62D,19031,1,3,2,1,42,92
59532,59532,46E2E10251607E59BAC1F84F8487D62D,12641,4,6,2,10,43,543
59533,59533,46E2E10251607E59BAC1F84F8487D62D,19061,7,8,1,3,43,193
59534,59534,46E2E10251607E59BAC1F84F8487D62D,19031,11,18,7,1,42,92
59535,59535,46E2E10251607E59BAC1F84F8487D62D,12671,22,23,1,21,43,1093
59536,59536,AD235EE6A83CA7956AB86E8BC887D3C7,11541,0,6,6,35,49,1799
59537,59537,AD235EE6A83CA7956AB86E8BC887D3C7,11021,6,8,2,36,49,1849
59538,59538,AD235EE6A83CA7956AB86E8BC887D3C7,13561,8,9,1,37,49,1899
59539,59539,AD235EE6A83CA7956AB86E8BC887D3C7,11021,13,17,4,36,49,1849
59540,59540,AD235EE6A83CA7956AB86E8BC887D3C7,11541,19,23,4,35,49,1799
59541,59541,809D30997DBB6653E10DF33CB05A97F7,13771,0,9,9,21,45,1095
59542,59542,809D30997DBB6653E10DF33CB05A97F7,12121,11,13,2,29,47,1497
59543,59543,809D30997DBB6653E10DF33CB05A97F7,13771,16,18,2,21,45,1095
59544,59544,809D30997DBB6653E10DF33CB05A97F7,12601,19,23,4,25,47,1297
59545,59545,6EB93CCAB2222C7D454DB87232E2BFCB,11381,0,1,1,30,47,1547
59546,59546,6EB93CCAB2222C7D454DB87232E2BFCB,10951,2,3,1,29,48,1498
59547,59547,6EB93CCAB2222C7D454DB87232E2BFCB,42623,6,21,15,22,49,1149
59548,59548,6EB93CCAB2222C7D454DB87232E2BFCB,42071,22,23,1,31,49,1599
59549,59549,2FA6B0403E72F0FA91FFC7A71FC53030,11201,0,7,7,35,49,1799
59550,59550,2FA6B0403E72F0FA91FFC7A71FC53030,10221,10,18,8,34,49,1749
59551,59551,2FA6B0403E72F0FA91FFC7A71FC53030,42801,20,21,1,40,49,2049
59556,59556,59949D96528A73ED4D3093F9761FCE85,11324,0,8,8,31,46,1596
59557,59557,59949D96528A73ED4D3093F9761FCE85,42221,14,16,2,38,48,1948
59558,59558,59949D96528A73ED4D3093F9761FCE85,11324,17,22,5,31,46,1596
59559,59559,40A368CA34750DF505DA57A322872C86,12611,0,7,7,41,29,2079
59560,59560,40A368CA34750DF505DA57A322872C86,15411,7,10,3,44,27,2227
59561,59561,40A368CA34750DF505DA57A322872C86,12611,12,14,2,41,29,2079
59562,59562,40A368CA34750DF505DA57A322872C86,15411,15,22,7,44,27,2227
59563,59563,A6B86C51D1E851C8306B13F3333CE4AD,42301,0,9,9,36,47,1847
59564,59564,A6B86C51D1E851C8306B13F3333CE4AD,42051,10,11,1,42,48,2148
59565,59565,A6B86C51D1E851C8306B13F3333CE4AD,11381,16,17,1,30,47,1547
59566,59566,A6B86C51D1E851C8306B13F3333CE4AD,42021,18,20,2,33,47,1697
59567,59567,A6B86C51D1E851C8306B13F3333CE4AD,42301,20,22,2,36,47,1847
59571,59571,8631F5DFCE39718648FAD1AB435C0892,12521,0,16,16,35,41,1791
59572,59572,8631F5DFCE39718648FAD1AB435C0892,13314,16,17,1,31,39,1589
59573,59573,8631F5DFCE39718648FAD1AB435C0892,12521,19,23,4,35,41,1791
59593,59593,37588B339BC778CEABB33EFAA57F9DC6,42261,0,1,1,25,49,1299
59594,59594,37588B339BC778CEABB33EFAA57F9DC6,42071,1,3,2,31,49,1599
59595,59595,37588B339BC778CEABB33EFAA57F9DC6,42261,4,12,8,25,49,1299
59596,59596,37588B339BC778CEABB33EFAA57F9DC6,42071,12,16,4,31,49,1599
59597,59597,37588B339BC778CEABB33EFAA57F9DC6,42261,16,23,7,25,49,1299
59601,59601,CEB438666719FF78831F75A6CA75D9E9,42981,0,6,6,36,49,1849
59602,59602,CEB438666719FF78831F75A6CA75D9E9,42531,7,9,2,31,45,1595
59603,59603,CEB438666719FF78831F75A6CA75D9E9,12311,9,10,1,30,44,1544
59604,59604,CEB438666719FF78831F75A6CA75D9E9,42531,11,17,6,31,45,1595
59605,59605,CEB438666719FF78831F75A6CA75D9E9,11021,21,22,1,36,49,1849
59609,59609,E92442C28CB44C67B1AFA3BE5AC81485,19024,0,8,8,9,45,495
59610,59610,E92442C28CB44C67B1AFA3BE5AC81485,10251,12,14,2,35,47,1797
59611,59611,E92442C28CB44C67B1AFA3BE5AC81485,12131,18,20,2,32,47,1647
59612,59612,4F8B7BBA258CD1F67D426A660E7D36AD,11381,0,12,12,30,47,1547
59613,59613,4F8B7BBA258CD1F67D426A660E7D36AD,43971,12,14,2,30,48,1548
59614,59614,4F8B7BBA258CD1F67D426A660E7D36AD,11061,16,17,1,29,48,1498
59615,59615,4F8B7BBA258CD1F67D426A660E7D36AD,11771,20,22,2,39,49,1999
59629,59629,9F22CEAACF5F9765BA896D571A934437,43021,0,5,5,16,43,843
59630,59630,9F22CEAACF5F9765BA896D571A934437,12921,8,20,12,9,41,491
59631,59631,9F22CEAACF5F9765BA896D571A934437,43021,21,23,2,16,43,843
59645,59645,B33429D7A00DB66721EA07FF9AC9AB45,11861,0,9,9,32,47,1647
59646,59646,B33429D7A00DB66721EA07FF9AC9AB45,11461,9,22,13,37,49,1899
59647,59647,B33429D7A00DB66721EA07FF9AC9AB45,11861,22,23,1,32,47,1647
59648,59648,0D04AEE5D0D9747786113FB147421EF2,13371,0,6,6,41,47,2097
59649,59649,0D04AEE5D0D9747786113FB147421EF2,12874,8,10,2,20,34,1034
59650,59650,0D04AEE5D0D9747786113FB147421EF2,43721,12,15,3,32,34,1634
59651,59651,0D04AEE5D0D9747786113FB147421EF2,12921,18,20,2,9,41,491
59652,59652,0D04AEE5D0D9747786113FB147421EF2,12641,22,23,1,10,43,543
59657,59657,5B009341D59B6503373635BF5936335C,42091,9,10,1,43,46,2196
59658,59658,5B009341D59B6503373635BF5936335C,42021,12,14,2,33,47,1697
59659,59659,5B009341D59B6503373635BF5936335C,11201,14,16,2,35,49,1799
59660,59660,5B009341D59B6503373635BF5936335C,10731,20,21,1,33,47,1697
59661,59661,B5A22283E415C26A6779B5D39A1FD38F,11271,0,3,3,37,48,1898
59662,59662,B5A22283E415C26A6779B5D39A1FD38F,13671,7,8,1,27,43,1393
59663,59663,B5A22283E415C26A6779B5D39A1FD38F,11281,11,12,1,27,40,1390
59664,59664,B5A22283E415C26A6779B5D39A1FD38F,12121,16,17,1,29,47,1497
59665,59665,B5A22283E415C26A6779B5D39A1FD38F,10901,20,22,2,35,48,1798
59666,59666,FF0C11254BA355CCA708C36EE5C4353D,11381,0,6,6,30,47,1547
59667,59667,FF0C11254BA355CCA708C36EE5C4353D,42351,10,11,1,38,45,1945
59668,59668,FF0C11254BA355CCA708C36EE5C4353D,11381,12,15,3,30,47,1547
59669,59669,FF0C11254BA355CCA708C36EE5C4353D,10121,16,18,2,36,49,1849
59670,59670,FF0C11254BA355CCA708C36EE5C4353D,11381,18,23,5,30,47,1547
59674,59674,8CD005640158EAB1EDDF5134C7064620,11861,0,6,6,32,47,1647
59675,59675,8CD005640158EAB1EDDF5134C7064620,42871,8,9,1,30,45,1545
59676,59676,8CD005640158EAB1EDDF5134C7064620,13671,14,15,1,27,43,1393
59677,59677,8CD005640158EAB1EDDF5134C7064620,10716,19,23,4,30,46,1546
59678,59678,22B226B098E21E8EFBF1D1AD480D8C9E,13371,0,8,8,41,47,2097
59679,59679,22B226B098E21E8EFBF1D1AD480D8C9E,12391,9,11,2,36,49,1849
59680,59680,22B226B098E21E8EFBF1D1AD480D8C9E,42961,11,13,2,35,49,1799
59681,59681,22B226B098E21E8EFBF1D1AD480D8C9E,12391,16,17,1,36,49,1849
59682,59682,22B226B098E21E8EFBF1D1AD480D8C9E,11074,18,19,1,37,47,1897
59686,59686,39AC07E35C9C929E0D6FB0AB415EDA84,43171,0,8,8,39,49,1999
59687,59687,39AC07E35C9C929E0D6FB0AB415EDA84,10971,9,10,1,35,47,1797
59688,59688,39AC07E35C9C929E0D6FB0AB415EDA84,43731,10,17,7,34,47,1747
59689,59689,39AC07E35C9C929E0D6FB0AB415EDA84,10971,19,20,1,35,47,1797
59690,59690,39AC07E35C9C929E0D6FB0AB415EDA84,43171,21,23,2,39,49,1999
59697,59697,AD97209355D9021D25EC3A88C035644F,11351,1,2,1,36,48,1848
59698,59698,AD97209355D9021D25EC3A88C035644F,11231,2,3,1,37,49,1899
59699,59699,AD97209355D9021D25EC3A88C035644F,40502,4,6,2,36,48,1848
59700,59700,AD97209355D9021D25EC3A88C035644F,43731,13,15,2,34,47,1747
59701,59701,AD97209355D9021D25EC3A88C035644F,42511,18,19,1,37,47,1897
59702,59702,C1D79A070CFCF442F4B341637205D8DD,12561,0,7,7,45,43,2293
59703,59703,C1D79A070CFCF442F4B341637205D8DD,12211,8,10,2,41,44,2094
59704,59704,C1D79A070CFCF442F4B341637205D8DD,12561,12,13,1,45,43,2293
59705,59705,C1D79A070CFCF442F4B341637205D8DD,12211,14,15,1,41,44,2094
59706,59706,C1D79A070CFCF442F4B341637205D8DD,12561,16,17,1,45,43,2293
59707,59707,C1D79A070CFCF442F4B341637205D8DD,13341,20,22,2,44,45,2245
59708,59708,6587B781598530C86F6C53CA6F1512D2,10431,0,9,9,33,49,1699
59709,59709,6587B781598530C86F6C53CA6F1512D2,10351,10,11,1,28,45,1445
59710,59710,6587B781598530C86F6C53CA6F1512D2,10431,11,13,2,33,49,1699
59711,59711,6587B781598530C86F6C53CA6F1512D2,11875,14,15,1,30,46,1546
59712,59712,6587B781598530C86F6C53CA6F1512D2,10431,17,19,2,33,49,1699
59713,59713,6587B781598530C86F6C53CA6F1512D2,10634,21,22,1,27,45,1395
59721,59721,079D8B606B741550F5C3182CF58367EA,40101,0,2,2,34,49,1749
59722,59722,079D8B606B741550F5C3182CF58367EA,11061,4,18,14,29,48,1498
59723,59723,079D8B606B741550F5C3182CF58367EA,40341,18,21,3,23,49,1199
59724,59724,079D8B606B741550F5C3182CF58367EA,11061,22,23,1,29,48,1498
59725,59725,04FC279D8763FD0D52EBF8F599CB8F45,10121,0,17,17,36,49,1849
59726,59726,04FC279D8763FD0D52EBF8F599CB8F45,40341,17,18,1,23,49,1199
59727,59727,04FC279D8763FD0D52EBF8F599CB8F45,10121,20,23,3,36,49,1849
59731,59731,38EAD9C71E0631172BE43F523D61F0B8,42971,0,6,6,43,49,2199
59732,59732,38EAD9C71E0631172BE43F523D61F0B8,12121,7,9,2,29,47,1497
59733,59733,38EAD9C71E0631172BE43F523D61F0B8,42521,9,10,1,31,47,1597
59734,59734,38EAD9C71E0631172BE43F523D61F0B8,42971,12,23,11,43,49,2199
59742,59742,320F0142A6A8D98142B47BD5D35CD593,43761,0,7,7,32,47,1647
59743,59743,320F0142A6A8D98142B47BD5D35CD593,10111,9,11,2,37,47,1897
59744,59744,320F0142A6A8D98142B47BD5D35CD593,42301,13,16,3,36,47,1847
59745,59745,320F0142A6A8D98142B47BD5D35CD593,10411,19,20,1,36,48,1848
59758,59758,538F90B2CC3C634AB532E22F4202476F,43761,0,5,5,32,47,1647
59759,59759,538F90B2CC3C634AB532E22F4202476F,12391,8,9,1,36,49,1849
59760,59760,538F90B2CC3C634AB532E22F4202476F,13121,11,13,2,38,46,1946
59761,59761,538F90B2CC3C634AB532E22F4202476F,12391,14,16,2,36,49,1849
59762,59762,538F90B2CC3C634AB532E22F4202476F,43761,19,23,4,32,47,1647
59763,59763,BC5925B06F2DF0A4E50FC387D64A4A61,42861,4,5,1,37,44,1894
59764,59764,BC5925B06F2DF0A4E50FC387D64A4A61,42151,7,12,5,35,45,1795
59765,59765,BC5925B06F2DF0A4E50FC387D64A4A61,10151,17,19,2,34,47,1747
59766,59766,BC5925B06F2DF0A4E50FC387D64A4A61,41591,20,21,1,34,49,1749
59771,59771,CA9F3291ABF3939E405884AD2ABE2445,11651,0,7,7,33,47,1697
59772,59772,CA9F3291ABF3939E405884AD2ABE2445,42121,18,20,2,26,49,1349
59773,59773,CA9F3291ABF3939E405884AD2ABE2445,11651,21,23,2,33,47,1697
59778,59778,0ABF15EDFCAA333ABA775777DB9BDACA,43981,0,2,2,36,49,1849
59779,59779,0ABF15EDFCAA333ABA775777DB9BDACA,11954,2,10,8,32,49,1649
59780,59780,0ABF15EDFCAA333ABA775777DB9BDACA,10721,14,16,2,31,48,1598
59781,59781,0ABF15EDFCAA333ABA775777DB9BDACA,11074,18,19,1,37,47,1897
59782,59782,0ABF15EDFCAA333ABA775777DB9BDACA,11541,19,21,2,35,49,1799
59783,59783,0ABF15EDFCAA333ABA775777DB9BDACA,43981,22,23,1,36,49,1849
59794,59794,09E512EB609D0F9D1406B325A74DF7F8,11351,2,9,7,36,48,1848
59795,59795,09E512EB609D0F9D1406B325A74DF7F8,19021,12,14,2,10,45,545
59796,59796,09E512EB609D0F9D1406B325A74DF7F8,43021,14,17,3,16,43,843
59797,59797,09E512EB609D0F9D1406B325A74DF7F8,19021,19,20,1,10,45,545
59798,59798,E63857A2CCFA107EF2437B9DB5F3581D,10411,0,6,6,36,48,1848
59799,59799,E63857A2CCFA107EF2437B9DB5F3581D,13771,9,11,2,21,45,1095
59800,59800,E63857A2CCFA107EF2437B9DB5F3581D,12601,11,14,3,25,47,1297
59801,59801,E63857A2CCFA107EF2437B9DB5F3581D,10411,16,23,7,36,48,1848
59806,59806,89EC37A7B83D9B7D194154C37975BD9C,42521,2,6,4,31,47,1597
59807,59807,89EC37A7B83D9B7D194154C37975BD9C,43311,8,10,2,31,48,1598
59808,59808,89EC37A7B83D9B7D194154C37975BD9C,11061,11,12,1,29,48,1498
59809,59809,89EC37A7B83D9B7D194154C37975BD9C,43311,15,17,2,31,48,1598
59810,59810,89EC37A7B83D9B7D194154C37975BD9C,42371,21,22,1,34,46,1746
59811,59811,92AA74C025DCC8E1B6F69E40B85D2713,42521,0,7,7,31,47,1597
59812,59812,92AA74C025DCC8E1B6F69E40B85D2713,11074,10,14,4,37,47,1897
59813,59813,92AA74C025DCC8E1B6F69E40B85D2713,43971,16,23,7,30,48,1548
59818,59818,F410F9904FD94EFD0B3E11C9C6E71ABD,12491,0,8,8,36,43,1843
59819,59819,F410F9904FD94EFD0B3E11C9C6E71ABD,42151,12,13,1,35,45,1795
59820,59820,F410F9904FD94EFD0B3E11C9C6E71ABD,12491,13,15,2,36,43,1843
59821,59821,F410F9904FD94EFD0B3E11C9C6E71ABD,42151,17,20,3,35,45,1795
59822,59822,F410F9904FD94EFD0B3E11C9C6E71ABD,12491,21,23,2,36,43,1843
59823,59823,8E7E1D3BA1392AF853A6068E181E9940,12971,0,8,8,32,48,1648
59824,59824,8E7E1D3BA1392AF853A6068E181E9940,10191,11,13,2,40,48,2048
59825,59825,8E7E1D3BA1392AF853A6068E181E9940,12971,18,20,2,32,48,1648
59826,59826,8E7E1D3BA1392AF853A6068E181E9940,10191,21,23,2,40,48,2048
59830,59830,4003E07D2A4AF66E84145561FFA003F3,10341,0,7,7,31,47,1597
59831,59831,4003E07D2A4AF66E84145561FFA003F3,42161,8,10,2,36,47,1847
59832,59832,4003E07D2A4AF66E84145561FFA003F3,10341,11,23,12,31,47,1597
59833,59833,D5A1F589AD5A8A456E0D23A90489837D,43761,0,7,7,32,47,1647
59834,59834,D5A1F589AD5A8A456E0D23A90489837D,11231,10,18,8,37,49,1899
59835,59835,D5A1F589AD5A8A456E0D23A90489837D,43761,20,23,3,32,47,1647
59839,59839,0D9AA89290D1F445356B85B4B256A343,11001,0,13,13,42,47,2147
59840,59840,0D9AA89290D1F445356B85B4B256A343,10811,15,17,2,38,46,1946
59841,59841,0D9AA89290D1F445356B85B4B256A343,11001,19,21,2,42,47,2147
59842,59842,B041461E36B355457CA97CA2324D4DB7,12792,0,1,1,34,30,1730
59843,59843,B041461E36B355457CA97CA2324D4DB7,15411,1,4,3,44,27,2227
59844,59844,B041461E36B355457CA97CA2324D4DB7,12792,4,10,6,34,30,1730
59845,59845,B041461E36B355457CA97CA2324D4DB7,15411,12,20,8,44,27,2227
59856,59856,3C5BF8354C7B22C00BFA5438C070BC0F,13711,0,17,17,38,46,1946
59857,59857,3C5BF8354C7B22C00BFA5438C070BC0F,43241,17,18,1,36,46,1846
59858,59858,3C5BF8354C7B22C00BFA5438C070BC0F,10271,18,19,1,37,46,1896
59859,59859,3C5BF8354C7B22C00BFA5438C070BC0F,11531,20,23,3,34,49,1749
59870,59870,AF3BB2EB266D8BDC31553ED7C05B56FE,12731,2,3,1,22,40,1140
59871,59871,AF3BB2EB266D8BDC31553ED7C05B56FE,13671,5,18,13,27,43,1393
59872,59872,AF3BB2EB266D8BDC31553ED7C05B56FE,42621,20,21,1,24,49,1249
59877,59877,0E002027D741B8AED4EE58E469659344,10501,0,2,2,22,46,1146
59878,59878,0E002027D741B8AED4EE58E469659344,10061,2,4,2,20,46,1046
59879,59879,0E002027D741B8AED4EE58E469659344,12601,5,7,2,25,47,1297
59880,59880,0E002027D741B8AED4EE58E469659344,10951,16,17,1,29,48,1498
59881,59881,0E002027D741B8AED4EE58E469659344,12601,22,23,1,25,47,1297
59885,59885,72AFA3CA2A415DCB4F9A7425EF31F08E,10471,0,16,16,37,48,1898
59886,59886,72AFA3CA2A415DCB4F9A7425EF31F08E,40341,17,19,2,23,49,1199
59887,59887,72AFA3CA2A415DCB4F9A7425EF31F08E,10471,20,23,3,37,48,1898
59894,59894,A4E401AD660AFE224AC7625C8D3FB39A,11061,0,2,2,29,48,1498
59895,59895,A4E401AD660AFE224AC7625C8D3FB39A,10681,2,7,5,30,48,1548
59896,59896,A4E401AD660AFE224AC7625C8D3FB39A,11061,7,15,8,29,48,1498
59897,59897,A4E401AD660AFE224AC7625C8D3FB39A,10681,15,17,2,30,48,1548
59898,59898,A4E401AD660AFE224AC7625C8D3FB39A,11061,17,19,2,29,48,1498
59899,59899,A4E401AD660AFE224AC7625C8D3FB39A,10681,20,21,1,30,48,1548
59906,59906,D675E01FF639BA40FCD221FF271007A2,43311,0,16,16,31,48,1598
59907,59907,D675E01FF639BA40FCD221FF271007A2,42623,17,20,3,22,49,1149
59908,59908,D675E01FF639BA40FCD221FF271007A2,10491,21,23,2,33,48,1698
59913,59913,660D2150C1391153938CD9B90E2CE919,12641,0,5,5,10,43,543
59914,59914,660D2150C1391153938CD9B90E2CE919,19021,7,17,10,10,45,545
59915,59915,660D2150C1391153938CD9B90E2CE919,19441,18,19,1,8,46,446
59916,59916,660D2150C1391153938CD9B90E2CE919,12641,19,23,4,10,43,543
59917,59917,4CA7727345FE5410FF8669E86CE37E32,19441,4,5,1,8,46,446
59918,59918,4CA7727345FE5410FF8669E86CE37E32,12641,7,16,9,10,43,543
59919,59919,4CA7727345FE5410FF8669E86CE37E32,19024,19,21,2,9,45,495
59920,59920,3C20A4FB5A5B0FD7EA7A50D0F5C8CA66,43021,0,2,2,16,43,843
59921,59921,3C20A4FB5A5B0FD7EA7A50D0F5C8CA66,12641,3,5,2,10,43,543
59922,59922,3C20A4FB5A5B0FD7EA7A50D0F5C8CA66,12921,5,22,17,9,41,491
59923,59923,720B1030F9AA451F5DB7F94C393FD381,11811,0,1,1,38,49,1949
59924,59924,720B1030F9AA451F5DB7F94C393FD381,11541,2,7,5,35,49,1799
59925,59925,720B1030F9AA451F5DB7F94C393FD381,12651,8,21,13,43,47,2197
59926,59926,6EF69708DD923556D4EF232AA0406F1C,11941,0,6,6,37,46,1896
59927,59927,6EF69708DD923556D4EF232AA0406F1C,42351,8,15,7,38,45,1945
59928,59928,6EF69708DD923556D4EF232AA0406F1C,42231,16,19,3,37,46,1896
59929,59929,6EF69708DD923556D4EF232AA0406F1C,40341,19,20,1,23,49,1199
59934,59934,C493E8EAD829832CA31397E82BE4990B,43021,0,6,6,16,43,843
59935,59935,C493E8EAD829832CA31397E82BE4990B,12921,6,17,11,9,41,491
59936,59936,C493E8EAD829832CA31397E82BE4990B,43021,22,23,1,16,43,843
59937,59937,091497AD7ED956A0C3F93F46CFB651F5,43021,3,15,12,16,43,843
59938,59938,091497AD7ED956A0C3F93F46CFB651F5,43644,19,20,1,14,38,738
59939,59939,091497AD7ED956A0C3F93F46CFB651F5,43021,21,23,2,16,43,843
59946,59946,2FC430E1448F290A8E229F5C2301E320,12641,4,6,2,10,43,543
59947,59947,2FC430E1448F290A8E229F5C2301E320,12921,8,19,11,9,41,491
59948,59948,2FC430E1448F290A8E229F5C2301E320,49201,20,22,2,7,41,391
59962,59962,E02F64059E677B81EAF8B96D760DDB0F,15143,2,5,3,18,7,907
59963,59963,E02F64059E677B81EAF8B96D760DDB0F,16281,6,20,14,11,4,554
59964,59964,E02F64059E677B81EAF8B96D760DDB0F,15143,21,23,2,18,7,907
59968,59968,28EBDF129D422CC62555B67FAF051D3A,43761,0,7,7,32,47,1647
59969,59969,28EBDF129D422CC62555B67FAF051D3A,11231,8,15,7,37,49,1899
59970,59970,28EBDF129D422CC62555B67FAF051D3A,42523,19,20,1,31,47,1597
59971,59971,28EBDF129D422CC62555B67FAF051D3A,13371,22,23,1,41,47,2097
59972,59972,4CA1188698B5DD1E66E2EDCA80216CDE,12571,0,7,7,48,39,2439
59973,59973,4CA1188698B5DD1E66E2EDCA80216CDE,13071,8,15,7,41,41,2091
59974,59974,4CA1188698B5DD1E66E2EDCA80216CDE,13371,18,20,2,41,47,2097
59985,59985,6AD981E757B177FB5B64F1D1D2EAA27F,12651,1,2,1,43,47,2197
59986,59986,6AD981E757B177FB5B64F1D1D2EAA27F,11701,2,6,4,43,48,2198
59987,59987,6AD981E757B177FB5B64F1D1D2EAA27F,12651,6,7,1,43,47,2197
59988,59988,6AD981E757B177FB5B64F1D1D2EAA27F,10901,15,16,1,35,48,1798
59989,59989,6AD981E757B177FB5B64F1D1D2EAA27F,10971,18,20,2,35,47,1797
59993,59993,3BAE48A8F70735F990595FB028A6F4D8,42071,1,3,2,31,49,1599
59994,59994,3BAE48A8F70735F990595FB028A6F4D8,42081,5,16,11,24,49,1249
59995,59995,3BAE48A8F70735F990595FB028A6F4D8,42071,16,19,3,31,49,1599
59996,59996,4E1126CD1AF86FC47E3B081AF053FA88,43761,0,15,15,32,47,1647
59997,59997,4E1126CD1AF86FC47E3B081AF053FA88,40341,16,18,2,23,49,1199
59998,59998,4E1126CD1AF86FC47E3B081AF053FA88,43761,20,22,2,32,47,1647
60003,60003,32E1A48D5570C3C14CE76F18A00606C7,42231,0,18,18,37,46,1896
60004,60004,32E1A48D5570C3C14CE76F18A00606C7,13731,18,20,2,33,49,1699
60005,60005,32E1A48D5570C3C14CE76F18A00606C7,42231,20,23,3,37,46,1896
60009,60009,C35D795DA33BE0311413852FD4760F3A,11261,0,16,16,36,46,1846
60010,60010,C35D795DA33BE0311413852FD4760F3A,12211,16,19,3,41,44,2094
60011,60011,C35D795DA33BE0311413852FD4760F3A,11261,21,23,2,36,46,1846
60027,60027,DFB39D9C16979A7A210D773BBB4B6305,42351,0,7,7,38,45,1945
60028,60028,DFB39D9C16979A7A210D773BBB4B6305,11261,8,15,7,36,46,1846
60029,60029,DFB39D9C16979A7A210D773BBB4B6305,11231,20,23,3,37,49,1899
60030,60030,19DD9EA3315ECB699A68A051C9281E6B,10471,2,15,13,37,48,1898
60031,60031,19DD9EA3315ECB699A68A051C9281E6B,11701,16,17,1,43,48,2198
60032,60032,19DD9EA3315ECB699A68A051C9281E6B,10161,20,22,2,35,49,1799
60039,60039,45F7BED1A33423D605A441382F01DFAF,19031,2,3,1,1,42,92
60040,60040,45F7BED1A33423D605A441382F01DFAF,12641,8,18,10,10,43,543
60041,60041,45F7BED1A33423D605A441382F01DFAF,12921,19,21,2,9,41,491
60051,60051,5C633B6A90713EC538BFB33DCFC3172F,13911,0,15,15,39,46,1996
60052,60052,5C633B6A90713EC538BFB33DCFC3172F,42151,15,16,1,35,45,1795
60053,60053,5C633B6A90713EC538BFB33DCFC3172F,13911,16,21,5,39,46,1996
60060,60060,6CBBEE1C450344F3879ED38C16F213C4,12051,0,5,5,20,47,1047
60061,60061,6CBBEE1C450344F3879ED38C16F213C4,12581,7,16,9,24,48,1248
60062,60062,6CBBEE1C450344F3879ED38C16F213C4,43751,20,23,3,19,48,998
60063,60063,E6E1B072EE7202225510F5B63E9E6AA7,42221,2,6,4,38,48,1948
60064,60064,E6E1B072EE7202225510F5B63E9E6AA7,42121,8,17,9,26,49,1349
60065,60065,E6E1B072EE7202225510F5B63E9E6AA7,12514,20,21,1,38,47,1947
60066,60066,E6E1B072EE7202225510F5B63E9E6AA7,42221,22,23,1,38,48,1948
60067,60067,27F132E818644D3933B7D51A13F3BE57,15411,6,7,1,44,27,2227
60068,60068,27F132E818644D3933B7D51A13F3BE57,12611,8,18,10,41,29,2079
60069,60069,27F132E818644D3933B7D51A13F3BE57,15411,19,20,1,44,27,2227
60079,60079,57068447BEEE4D7969FF166D57966ECA,42541,0,6,6,25,47,1297
60080,60080,57068447BEEE4D7969FF166D57966ECA,11361,6,15,9,22,48,1148
60081,60081,57068447BEEE4D7969FF166D57966ECA,12581,15,16,1,24,48,1248
60082,60082,57068447BEEE4D7969FF166D57966ECA,10171,19,20,1,26,47,1347
60083,60083,57068447BEEE4D7969FF166D57966ECA,42541,21,23,2,25,47,1297
60087,60087,A06465C33822DBAACCFCA67CF792360D,42523,0,5,5,31,47,1597
60088,60088,A06465C33822DBAACCFCA67CF792360D,10295,6,7,1,30,47,1547
60089,60089,A06465C33822DBAACCFCA67CF792360D,42523,8,15,7,31,47,1597
60090,60090,A06465C33822DBAACCFCA67CF792360D,10295,18,19,1,30,47,1547
60091,60091,A06465C33822DBAACCFCA67CF792360D,42523,21,23,2,31,47,1597
60092,60092,71EC48DD21126B9B6A22DDC82F149351,19031,0,6,6,1,42,92
60093,60093,71EC48DD21126B9B6A22DDC82F149351,43644,6,18,12,14,38,738
60094,60094,71EC48DD21126B9B6A22DDC82F149351,19261,18,19,1,6,37,337
60095,60095,71EC48DD21126B9B6A22DDC82F149351,19031,22,23,1,1,42,92
60102,60102,A25A833341BE3939DF5ACF6F00A1B542,10621,0,6,6,41,49,2099
60103,60103,A25A833341BE3939DF5ACF6F00A1B542,13351,7,19,12,48,48,2448
60104,60104,A25A833341BE3939DF5ACF6F00A1B542,10621,21,23,2,41,49,2099
60115,60115,F714E7BCDABF2B2F99991B80BC6098B2,19904,0,2,2,9,44,494
60116,60116,F714E7BCDABF2B2F99991B80BC6098B2,12641,2,3,1,10,43,543
60117,60117,F714E7BCDABF2B2F99991B80BC6098B2,19904,4,6,2,9,44,494
60118,60118,F714E7BCDABF2B2F99991B80BC6098B2,12641,6,8,2,10,43,543
60119,60119,F714E7BCDABF2B2F99991B80BC6098B2,19021,17,18,1,10,45,545
60120,60120,F714E7BCDABF2B2F99991B80BC6098B2,19904,20,21,1,9,44,494
60121,60121,9EC16DD8D58D40C2355CD3D8751C16A6,42623,4,5,1,22,49,1149
60122,60122,9EC16DD8D58D40C2355CD3D8751C16A6,42261,6,7,1,25,49,1299
60123,60123,9EC16DD8D58D40C2355CD3D8751C16A6,42071,20,21,1,31,49,1599
60127,60127,CC1D3C2DA42F1EBED6688749C3DA1D87,11381,0,1,1,30,47,1547
60128,60128,CC1D3C2DA42F1EBED6688749C3DA1D87,43971,1,4,3,30,48,1548
60129,60129,CC1D3C2DA42F1EBED6688749C3DA1D87,10731,6,7,1,33,47,1697
60130,60130,CC1D3C2DA42F1EBED6688749C3DA1D87,11381,15,16,1,30,47,1547
60131,60131,CC1D3C2DA42F1EBED6688749C3DA1D87,10951,16,18,2,29,48,1498
60132,60132,CC1D3C2DA42F1EBED6688749C3DA1D87,11381,18,21,3,30,47,1547
60133,60133,CC1D3C2DA42F1EBED6688749C3DA1D87,43971,21,22,1,30,48,1548
60134,60134,BEE853049D28B67DAA1CF8A47B438594,12921,0,7,7,9,41,491
60135,60135,BEE853049D28B67DAA1CF8A47B438594,19261,7,15,8,6,37,337
60136,60136,BEE853049D28B67DAA1CF8A47B438594,43644,16,18,2,14,38,738
60137,60137,BEE853049D28B67DAA1CF8A47B438594,12921,19,22,3,9,41,491
60138,60138,8921D19B3E6D3ABF76D7D418BD57EBCC,11521,1,7,6,41,48,2098
60139,60139,8921D19B3E6D3ABF76D7D418BD57EBCC,41601,7,15,8,39,49,1999
60140,60140,8921D19B3E6D3ABF76D7D418BD57EBCC,12083,17,22,5,36,49,1849
60151,60151,D8B46FFCD15B641FB93B8219A29A7205,10111,0,1,1,37,47,1897
60152,60152,D8B46FFCD15B641FB93B8219A29A7205,42161,2,3,1,36,47,1847
60153,60153,D8B46FFCD15B641FB93B8219A29A7205,40673,3,7,4,36,48,1848
60154,60154,D8B46FFCD15B641FB93B8219A29A7205,10251,19,21,2,35,47,1797
60155,60155,D8B46FFCD15B641FB93B8219A29A7205,42301,21,22,1,36,47,1847
60156,60156,8436FA510D59B3814E50B7F18BD1D92C,19571,0,4,4,1,36,86
60157,60157,8436FA510D59B3814E50B7F18BD1D92C,12641,6,19,13,10,43,543
60158,60158,8436FA510D59B3814E50B7F18BD1D92C,43644,21,22,1,14,38,738
60159,60159,56547DCD12E76D718E2E60F15A40B9D5,10111,0,1,1,37,47,1897
60160,60160,56547DCD12E76D718E2E60F15A40B9D5,10251,1,4,3,35,47,1797
60161,60161,56547DCD12E76D718E2E60F15A40B9D5,10111,5,8,3,37,47,1897
60162,60162,56547DCD12E76D718E2E60F15A40B9D5,10781,15,18,3,35,47,1797
60163,60163,56547DCD12E76D718E2E60F15A40B9D5,10111,19,23,4,37,47,1897
60170,60170,E648A6F090A3BE85617E0ED54A73B4F0,12601,0,4,4,25,47,1297
60171,60171,E648A6F090A3BE85617E0ED54A73B4F0,12671,4,6,2,21,43,1093
60172,60172,E648A6F090A3BE85617E0ED54A73B4F0,12601,6,8,2,25,47,1297
60173,60173,E648A6F090A3BE85617E0ED54A73B4F0,12671,15,16,1,21,43,1093
60174,60174,E648A6F090A3BE85617E0ED54A73B4F0,12601,16,23,7,25,47,1297
60175,60175,E599FEB56FA765D8959145E7D77CF1E9,11521,0,5,5,41,48,2098
60176,60176,E599FEB56FA765D8959145E7D77CF1E9,42351,5,7,2,38,45,1945
60177,60177,E599FEB56FA765D8959145E7D77CF1E9,10921,19,20,1,43,48,2198
60178,60178,E599FEB56FA765D8959145E7D77CF1E9,11301,21,23,2,41,49,2099
60182,60182,290CF9B7E8E39B2A6D619522168B66C7,19441,0,1,1,8,46,446
60183,60183,290CF9B7E8E39B2A6D619522168B66C7,19621,1,7,6,5,46,296
60184,60184,290CF9B7E8E39B2A6D619522168B66C7,12083,8,15,7,36,49,1849
60185,60185,290CF9B7E8E39B2A6D619522168B66C7,19441,20,23,3,8,46,446
60202,60202,151AF07FE1353F98EA8933566E4D900D,12921,0,4,4,9,41,491
60203,60203,151AF07FE1353F98EA8933566E4D900D,43021,5,6,1,16,43,843
60204,60204,151AF07FE1353F98EA8933566E4D900D,12921,6,18,12,9,41,491
60205,60205,151AF07FE1353F98EA8933566E4D900D,43021,18,20,2,16,43,843
60206,60206,470BE60325DA2FBBD1F75F1607157E14,12521,0,15,15,35,41,1791
60207,60207,470BE60325DA2FBBD1F75F1607157E14,13314,17,20,3,31,39,1589
60208,60208,470BE60325DA2FBBD1F75F1607157E14,12521,20,23,3,35,41,1791
60209,60209,76DA946F4DC1318DD46A32E1D303D6B7,12521,0,6,6,35,41,1791
60210,60210,76DA946F4DC1318DD46A32E1D303D6B7,13314,7,18,11,31,39,1589
60211,60211,76DA946F4DC1318DD46A32E1D303D6B7,12521,21,22,1,35,41,1791
60212,60212,9508FAE0B774FCD97D7CFB3C4BD72215,10111,0,1,1,37,47,1897
60213,60213,9508FAE0B774FCD97D7CFB3C4BD72215,42401,3,4,1,36,47,1847
60214,60214,9508FAE0B774FCD97D7CFB3C4BD72215,10111,6,8,2,37,47,1897
60215,60215,9508FAE0B774FCD97D7CFB3C4BD72215,42161,15,16,1,36,47,1847
60216,60216,9508FAE0B774FCD97D7CFB3C4BD72215,10111,16,20,4,37,47,1897
60223,60223,1AA169564F26346ABB6AD9BF731FCA16,43581,0,6,6,33,48,1698
60224,60224,1AA169564F26346ABB6AD9BF731FCA16,42941,7,18,11,37,47,1897
60225,60225,1AA169564F26346ABB6AD9BF731FCA16,43581,19,23,4,33,48,1698
60226,60226,0F2E7737761FB5772278335D9DA9FBBB,15321,2,5,3,29,26,1476
60227,60227,0F2E7737761FB5772278335D9DA9FBBB,15394,8,18,10,35,26,1776
60228,60228,0F2E7737761FB5772278335D9DA9FBBB,43121,19,20,1,25,27,1277
60232,60232,083E6F45CD758E55D59CE683A8831561,43011,0,3,3,40,42,2042
60233,60233,083E6F45CD758E55D59CE683A8831561,42381,4,5,1,39,41,1991
60234,60234,083E6F45CD758E55D59CE683A8831561,43451,6,15,9,37,40,1890
60235,60235,083E6F45CD758E55D59CE683A8831561,13071,15,16,1,41,41,2091
60236,60236,083E6F45CD758E55D59CE683A8831561,42381,20,21,1,39,41,1991
60252,60252,2D9F8EEE0946858BEC66856CB73B8335,43021,1,5,4,16,43,843
60253,60253,2D9F8EEE0946858BEC66856CB73B8335,12921,7,16,9,9,41,491
60254,60254,2D9F8EEE0946858BEC66856CB73B8335,43021,19,22,3,16,43,843
60268,60268,40A368CA34750DF505DA57A322872C86,15653,0,5,5,40,25,2025
60269,60269,40A368CA34750DF505DA57A322872C86,15411,6,15,9,44,27,2227
60270,60270,40A368CA34750DF505DA57A322872C86,12611,15,19,4,41,29,2079
60271,60271,40A368CA34750DF505DA57A322872C86,15411,19,21,2,44,27,2227
60283,60283,132BAF41704DD845C2F70543C3732C4E,42231,0,5,5,37,46,1896
60284,60284,132BAF41704DD845C2F70543C3732C4E,13711,6,7,1,38,46,1946
60285,60285,132BAF41704DD845C2F70543C3732C4E,42231,7,8,1,37,46,1896
60286,60286,132BAF41704DD845C2F70543C3732C4E,13711,15,16,1,38,46,1946
60287,60287,132BAF41704DD845C2F70543C3732C4E,42231,17,20,3,37,46,1896
60288,60288,C4C376AC061AEE8F18D7F0F807345E59,43761,0,1,1,32,47,1647
60289,60289,C4C376AC061AEE8F18D7F0F807345E59,42521,2,7,5,31,47,1597
60290,60290,C4C376AC061AEE8F18D7F0F807345E59,10161,7,16,9,35,49,1799
60291,60291,C4C376AC061AEE8F18D7F0F807345E59,40341,18,22,4,23,49,1199
60298,60298,D44EDEFE20C6E53FAD2290D9CECCD593,19441,1,5,4,8,46,446
60299,60299,D44EDEFE20C6E53FAD2290D9CECCD593,42041,6,16,10,10,47,547
60300,60300,D44EDEFE20C6E53FAD2290D9CECCD593,19441,17,18,1,8,46,446
60301,60301,D44EDEFE20C6E53FAD2290D9CECCD593,42041,19,20,1,10,47,547
60302,60302,D44EDEFE20C6E53FAD2290D9CECCD593,19441,20,23,3,8,46,446
60307,60307,085A54B112E93B58F53705ABE7F444E7,13471,0,6,6,47,49,2399
60308,60308,085A54B112E93B58F53705ABE7F444E7,11701,7,17,10,43,48,2198
60309,60309,085A54B112E93B58F53705ABE7F444E7,42601,18,22,4,44,48,2248
60310,60310,C77F23D19DAEA5BB8ADE1BB3D3C261B4,42531,3,5,2,31,45,1595
60311,60311,C77F23D19DAEA5BB8ADE1BB3D3C261B4,13911,7,17,10,39,46,1996
60312,60312,C77F23D19DAEA5BB8ADE1BB3D3C261B4,12511,21,22,1,39,47,1997
60313,60313,9B3D4DB494E6B8E7329532A1BECC6FF1,12921,6,15,9,9,41,491
60314,60314,9B3D4DB494E6B8E7329532A1BECC6FF1,12641,17,19,2,10,43,543
60315,60315,9B3D4DB494E6B8E7329532A1BECC6FF1,43021,20,23,3,16,43,843
60323,60323,3E3400E81F33727D0845365703B2CDF7,42961,0,7,7,35,49,1799
60324,60324,3E3400E81F33727D0845365703B2CDF7,10924,8,15,7,43,49,2199
60325,60325,3E3400E81F33727D0845365703B2CDF7,42471,16,23,7,35,49,1799
60342,60342,5D8816D60C17D57308FA3FDDFB8525B9,42071,0,16,16,31,49,1599
60343,60343,5D8816D60C17D57308FA3FDDFB8525B9,42081,16,17,1,24,49,1249
60344,60344,5D8816D60C17D57308FA3FDDFB8525B9,42071,18,19,1,31,49,1599
60358,60358,59E8BD2B3B6F40BDD7AA0B26E7BC6262,13351,2,6,4,48,48,2448
60359,60359,59E8BD2B3B6F40BDD7AA0B26E7BC6262,11701,7,16,9,43,48,2198
60360,60360,59E8BD2B3B6F40BDD7AA0B26E7BC6262,43621,20,21,1,46,48,2348
60361,60361,CD5F8D7604C7020A19DDE3C48998E9F5,13041,2,3,1,30,37,1537
60362,60362,CD5F8D7604C7020A19DDE3C48998E9F5,13314,4,5,1,31,39,1589
60363,60363,CD5F8D7604C7020A19DDE3C48998E9F5,43451,7,16,9,37,40,1890
60364,60364,CD5F8D7604C7020A19DDE3C48998E9F5,13314,20,21,1,31,39,1589
60365,60365,D5A1F589AD5A8A456E0D23A90489837D,43761,0,7,7,32,47,1647
60366,60366,D5A1F589AD5A8A456E0D23A90489837D,11231,8,18,10,37,49,1899
60367,60367,D5A1F589AD5A8A456E0D23A90489837D,43761,19,21,2,32,47,1647
60377,60377,355B3503DB923129940C92B8E2DDD654,10491,0,7,7,33,48,1698
60378,60378,355B3503DB923129940C92B8E2DDD654,13121,8,10,2,38,46,1946
60379,60379,355B3503DB923129940C92B8E2DDD654,10491,12,15,3,33,48,1698
60380,60380,355B3503DB923129940C92B8E2DDD654,10231,17,22,5,39,49,1999
60381,60381,15BA009B68D87958E0A9656ADB01E7D6,11491,4,7,3,36,47,1847
60382,60382,15BA009B68D87958E0A9656ADB01E7D6,11081,8,9,1,35,46,1796
60383,60383,15BA009B68D87958E0A9656ADB01E7D6,11491,9,11,2,36,47,1847
60384,60384,15BA009B68D87958E0A9656ADB01E7D6,11871,13,14,1,29,46,1496
60385,60385,15BA009B68D87958E0A9656ADB01E7D6,12381,17,18,1,32,48,1648
60386,60386,15BA009B68D87958E0A9656ADB01E7D6,10295,19,23,4,30,47,1547
60387,60387,596353D0D3BC20785C568E9889E43F87,11381,0,6,6,30,47,1547
60388,60388,596353D0D3BC20785C568E9889E43F87,12521,9,11,2,35,41,1791
60389,60389,596353D0D3BC20785C568E9889E43F87,11381,12,23,11,30,47,1547
60390,60390,B46F7CFBF42B8DF5990A028C3A15EF50,42531,0,6,6,31,45,1595
60391,60391,B46F7CFBF42B8DF5990A028C3A15EF50,13651,7,12,5,30,47,1547
60392,60392,B46F7CFBF42B8DF5990A028C3A15EF50,42531,13,14,1,31,45,1595
60393,60393,B46F7CFBF42B8DF5990A028C3A15EF50,13651,14,18,4,30,47,1547
60394,60394,B46F7CFBF42B8DF5990A028C3A15EF50,12311,22,23,1,30,44,1544
60395,60395,DAFE070AC8164EB683B9455E05DD84E1,11481,9,12,3,41,48,2098
60396,60396,DAFE070AC8164EB683B9455E05DD84E1,13101,12,18,6,40,47,2047
60397,60397,DAFE070AC8164EB683B9455E05DD84E1,10061,20,21,1,20,46,1046
60398,60398,E063ED0B410DBCBEA7B106C50A20F760,42941,0,1,1,37,47,1897
60399,60399,E063ED0B410DBCBEA7B106C50A20F760,43761,2,3,1,32,47,1647
60400,60400,E063ED0B410DBCBEA7B106C50A20F760,11491,4,22,18,36,47,1847
60404,60404,33825114014E22B38BE13400DBE8B281,10711,0,1,1,29,46,1496
60405,60405,33825114014E22B38BE13400DBE8B281,42871,2,8,6,30,45,1545
60406,60406,33825114014E22B38BE13400DBE8B281,19431,9,11,2,8,29,429
60407,60407,33825114014E22B38BE13400DBE8B281,42871,13,23,10,30,45,1545
60408,60408,C4C392AAD95009BA2F44AEA6659A6470,11381,1,7,6,30,47,1547
60409,60409,C4C392AAD95009BA2F44AEA6659A6470,10544,9,11,2,28,48,1448
60410,60410,C4C392AAD95009BA2F44AEA6659A6470,11381,12,14,2,30,47,1547
60411,60411,C4C392AAD95009BA2F44AEA6659A6470,10544,14,16,2,28,48,1448
60412,60412,C4C392AAD95009BA2F44AEA6659A6470,11301,20,21,1,41,49,2099
60417,60417,96B100113D40E22B39686C026F5DA397,42864,1,5,4,38,44,1944
60418,60418,96B100113D40E22B39686C026F5DA397,11261,8,9,1,36,46,1846
60419,60419,96B100113D40E22B39686C026F5DA397,11171,19,22,3,33,48,1698
60420,60420,0AF743660C5ED3667FE12560B223379B,16016,0,8,8,4,5,205
60421,60421,0AF743660C5ED3667FE12560B223379B,10901,12,13,1,35,48,1798
60422,60422,0AF743660C5ED3667FE12560B223379B,16016,14,23,9,4,5,205
60423,60423,457B779D00720128DC52229000CD7309,15114,0,5,5,22,16,1116
60424,60424,457B779D00720128DC52229000CD7309,16441,8,9,1,15,17,767
60425,60425,457B779D00720128DC52229000CD7309,15114,11,19,8,22,16,1116
60426,60426,457B779D00720128DC52229000CD7309,15421,20,23,3,20,18,1018
60427,60427,C783F573219BE815B78681C436E8AC03,11871,0,7,7,29,46,1496
60428,60428,C783F573219BE815B78681C436E8AC03,12601,11,17,6,25,47,1297
60429,60429,C783F573219BE815B78681C436E8AC03,11871,19,23,4,29,46,1496
60430,60430,09F64A9A641B3F2B92615DE97B925264,10351,2,4,2,28,45,1445
60431,60431,09F64A9A641B3F2B92615DE97B925264,10951,7,8,1,29,48,1498
60432,60432,09F64A9A641B3F2B92615DE97B925264,11111,9,10,1,26,48,1348
60433,60433,09F64A9A641B3F2B92615DE97B925264,10351,19,22,3,28,45,1445
60434,60434,6C0E943C8B3CE3071E466B3888DE833C,42531,6,7,1,31,45,1595
60435,60435,6C0E943C8B3CE3071E466B3888DE833C,12311,8,12,4,30,44,1544
60436,60436,6C0E943C8B3CE3071E466B3888DE833C,42531,13,14,1,31,45,1595
60437,60437,6C0E943C8B3CE3071E466B3888DE833C,12311,15,16,1,30,44,1544
60438,60438,6C0E943C8B3CE3071E466B3888DE833C,42531,16,18,2,31,45,1595
60439,60439,6C0E943C8B3CE3071E466B3888DE833C,19744,19,20,1,6,43,343
60440,60440,B4D70E7CDFA879C6A4BAE698CD44BB37,11491,0,7,7,36,47,1847
60441,60441,B4D70E7CDFA879C6A4BAE698CD44BB37,10271,7,12,5,37,46,1896
60442,60442,B4D70E7CDFA879C6A4BAE698CD44BB37,11491,13,14,1,36,47,1847
60443,60443,B4D70E7CDFA879C6A4BAE698CD44BB37,10271,17,18,1,37,46,1896
60444,60444,B4D70E7CDFA879C6A4BAE698CD44BB37,11491,19,21,2,36,47,1847
60445,60445,B8DCAC0FC6FA981D871032E55C240C8E,42581,3,4,1,38,48,1948
60446,60446,B8DCAC0FC6FA981D871032E55C240C8E,11914,5,7,2,37,48,1898
60447,60447,B8DCAC0FC6FA981D871032E55C240C8E,42581,7,8,1,38,48,1948
60448,60448,B8DCAC0FC6FA981D871032E55C240C8E,11914,9,20,11,37,48,1898
60449,60449,B8DCAC0FC6FA981D871032E55C240C8E,42581,20,22,2,38,48,1948
60450,60450,946768BFA72752D5660750415178C67F,43731,0,5,5,34,47,1747
60451,60451,946768BFA72752D5660750415178C67F,42161,6,7,1,36,47,1847
60452,60452,946768BFA72752D5660750415178C67F,11081,8,11,3,35,46,1796
60453,60453,946768BFA72752D5660750415178C67F,42161,14,15,1,36,47,1847
60454,60454,946768BFA72752D5660750415178C67F,42471,18,20,2,35,49,1799
60455,60455,CD5473964A2C6DE7DF346EF887FB8309,13381,0,6,6,39,47,1997
60456,60456,CD5473964A2C6DE7DF346EF887FB8309,40201,10,14,4,32,49,1649
60457,60457,CD5473964A2C6DE7DF346EF887FB8309,40341,17,19,2,23,49,1199
60461,60461,0E002027D741B8AED4EE58E469659344,11381,10,12,2,30,47,1547
60462,60462,0E002027D741B8AED4EE58E469659344,11151,13,14,1,30,48,1548
60463,60463,0E002027D741B8AED4EE58E469659344,10501,17,19,2,22,46,1146
60464,60464,0E002027D741B8AED4EE58E469659344,12581,21,22,1,24,48,1248
60471,60471,BE6556F4F32DDBE17FA5A6143CEC24DA,42921,0,7,7,33,47,1697
60472,60472,BE6556F4F32DDBE17FA5A6143CEC24DA,12211,12,15,3,41,44,2094
60473,60473,BE6556F4F32DDBE17FA5A6143CEC24DA,10731,20,21,1,33,47,1697
60481,60481,639EA486291B8A87A84D90343A87732A,10451,0,6,6,25,48,1298
60482,60482,639EA486291B8A87A84D90343A87732A,10661,9,11,2,37,49,1899
60483,60483,639EA486291B8A87A84D90343A87732A,10107,12,15,3,38,49,1949
60484,60484,639EA486291B8A87A84D90343A87732A,10451,18,23,5,25,48,1298
60485,60485,6C6E2D9F34BEA5CFD7B3142EF1283A14,40094,0,6,6,29,48,1498
60486,60486,6C6E2D9F34BEA5CFD7B3142EF1283A14,10621,6,12,6,41,49,2099
60487,60487,6C6E2D9F34BEA5CFD7B3142EF1283A14,40094,18,23,5,29,48,1498
60491,60491,CECBB3E00650E82884F04DE87BB5F628,43321,4,7,3,36,49,1849
60492,60492,CECBB3E00650E82884F04DE87BB5F628,40271,9,11,2,35,49,1799
60493,60493,CECBB3E00650E82884F04DE87BB5F628,40733,13,20,7,32,48,1648
60494,60494,A5A342C5B79B8AEE00BA80AE678B8EC5,10331,0,7,7,39,46,1996
60495,60495,A5A342C5B79B8AEE00BA80AE678B8EC5,11151,8,11,3,30,48,1548
60496,60496,A5A342C5B79B8AEE00BA80AE678B8EC5,10331,12,23,11,39,46,1996
60497,60497,1D1306B59D2AF3D03EE502CE86B65E29,10381,0,7,7,31,49,1599
60498,60498,1D1306B59D2AF3D03EE502CE86B65E29,12481,12,13,1,37,49,1899
60499,60499,1D1306B59D2AF3D03EE502CE86B65E29,11731,14,19,5,36,48,1848
60500,60500,1D1306B59D2AF3D03EE502CE86B65E29,10381,20,23,3,31,49,1599
60501,60501,DEE5888BD7E461DD868275DE6FB19D26,10921,0,5,5,43,48,2198
60502,60502,DEE5888BD7E461DD868275DE6FB19D26,13341,7,9,2,44,45,2245
60503,60503,DEE5888BD7E461DD868275DE6FB19D26,42201,9,11,2,43,46,2196
60504,60504,DEE5888BD7E461DD868275DE6FB19D26,10921,12,13,1,43,48,2198
60505,60505,DEE5888BD7E461DD868275DE6FB19D26,42201,13,17,4,43,46,2196
60506,60506,DEE5888BD7E461DD868275DE6FB19D26,10921,18,21,3,43,48,2198
60520,60520,292AD485DA7AE4FB3CFCA1190DC036DF,42151,0,15,15,35,45,1795
60521,60521,292AD485DA7AE4FB3CFCA1190DC036DF,12311,15,17,2,30,44,1544
60522,60522,292AD485DA7AE4FB3CFCA1190DC036DF,13231,20,21,1,39,46,1996
60523,60523,292AD485DA7AE4FB3CFCA1190DC036DF,42151,21,22,1,35,45,1795
60524,60524,FC0936587C74EF8144A5D7B54D78302D,19021,0,6,6,10,45,545
60525,60525,FC0936587C74EF8144A5D7B54D78302D,11571,9,15,6,13,46,696
60526,60526,FC0936587C74EF8144A5D7B54D78302D,19021,16,18,2,10,45,545
60527,60527,FC0936587C74EF8144A5D7B54D78302D,11571,18,22,4,13,46,696
60528,60528,FC0936587C74EF8144A5D7B54D78302D,19021,22,23,1,10,45,545
60529,60529,B2F3236A8F31ED7F34E1575A423E8F3B,43761,4,14,10,32,47,1647
60530,60530,B2F3236A8F31ED7F34E1575A423E8F3B,11231,14,16,2,37,49,1899
60531,60531,B2F3236A8F31ED7F34E1575A423E8F3B,10841,16,17,1,37,47,1897
60532,60532,B2F3236A8F31ED7F34E1575A423E8F3B,11861,20,22,2,32,47,1647
60533,60533,3B9989389C2FB72384F3330F9A990AB0,13911,0,1,1,39,46,1996
60534,60534,3B9989389C2FB72384F3330F9A990AB0,42351,1,4,3,38,45,1945
60535,60535,3B9989389C2FB72384F3330F9A990AB0,13911,5,6,1,39,46,1996
60536,60536,3B9989389C2FB72384F3330F9A990AB0,42231,7,16,9,37,46,1896
60537,60537,3B9989389C2FB72384F3330F9A990AB0,42351,18,19,1,38,45,1945
60538,60538,3B9989389C2FB72384F3330F9A990AB0,42231,21,23,2,37,46,1896
60548,60548,ACB823DB33D22CC4344D979C1DDF92F4,11261,2,3,1,36,46,1846
60549,60549,ACB823DB33D22CC4344D979C1DDF92F4,42864,8,10,2,38,44,1944
60550,60550,ACB823DB33D22CC4344D979C1DDF92F4,11261,11,14,3,36,46,1846
60551,60551,ACB823DB33D22CC4344D979C1DDF92F4,42861,14,16,2,37,44,1894
60552,60552,ACB823DB33D22CC4344D979C1DDF92F4,11261,17,19,2,36,46,1846
60553,60553,ACB823DB33D22CC4344D979C1DDF92F4,42861,21,22,1,37,44,1894
60554,60554,3877B8E5CE9312BFA7CD973C0152DE3C,12514,0,10,10,38,47,1947
60555,60555,3877B8E5CE9312BFA7CD973C0152DE3C,11951,11,12,1,31,49,1599
60556,60556,3877B8E5CE9312BFA7CD973C0152DE3C,10971,13,16,3,35,47,1797
60557,60557,3877B8E5CE9312BFA7CD973C0152DE3C,13731,19,20,1,33,49,1699
60561,60561,19A29A27E6506D34C07A04E6E9F52A03,42151,0,7,7,35,45,1795
60562,60562,19A29A27E6506D34C07A04E6E9F52A03,12491,8,9,1,36,43,1843
60563,60563,19A29A27E6506D34C07A04E6E9F52A03,42151,12,16,4,35,45,1795
60564,60564,19A29A27E6506D34C07A04E6E9F52A03,12491,17,18,1,36,43,1843
60565,60565,19A29A27E6506D34C07A04E6E9F52A03,42151,18,22,4,35,45,1795
60566,60566,44A1B2095028F2B1D6198AB3D390B206,10681,0,9,9,30,48,1548
60567,60567,44A1B2095028F2B1D6198AB3D390B206,11201,10,11,1,35,49,1799
60568,60568,44A1B2095028F2B1D6198AB3D390B206,43971,12,15,3,30,48,1548
60569,60569,44A1B2095028F2B1D6198AB3D390B206,11061,15,17,2,29,48,1498
60570,60570,44A1B2095028F2B1D6198AB3D390B206,10681,17,23,6,30,48,1548
60571,60571,4F1CE0C1A5E6BF21E963500414770875,12514,0,8,8,38,47,1947
60572,60572,4F1CE0C1A5E6BF21E963500414770875,42871,12,14,2,30,45,1545
60573,60573,4F1CE0C1A5E6BF21E963500414770875,10841,14,18,4,37,47,1897
60574,60574,4F1CE0C1A5E6BF21E963500414770875,42581,18,21,3,38,48,1948
60575,60575,4F1CE0C1A5E6BF21E963500414770875,10841,21,23,2,37,47,1897
60579,60579,E6D049947968658F47DDC695A59302A1,42321,0,1,1,43,47,2197
60580,60580,E6D049947968658F47DDC695A59302A1,43061,2,5,3,43,46,2196
60581,60581,E6D049947968658F47DDC695A59302A1,42461,6,7,1,45,47,2297
60582,60582,E6D049947968658F47DDC695A59302A1,42321,11,12,1,43,47,2197
60583,60583,E6D049947968658F47DDC695A59302A1,42461,13,15,2,45,47,2297
60584,60584,E6D049947968658F47DDC695A59302A1,42201,15,16,1,43,46,2196
60585,60585,E6D049947968658F47DDC695A59302A1,42111,17,19,2,44,46,2246
60586,60586,E6D049947968658F47DDC695A59302A1,42321,21,23,2,43,47,2197
60587,60587,71AB304A084EB4095E1F705C48CB0E23,11901,0,7,7,42,49,2149
60588,60588,71AB304A084EB4095E1F705C48CB0E23,11914,7,8,1,37,48,1898
60589,60589,71AB304A084EB4095E1F705C48CB0E23,42581,9,10,1,38,48,1948
60590,60590,71AB304A084EB4095E1F705C48CB0E23,11914,11,15,4,37,48,1898
60591,60591,71AB304A084EB4095E1F705C48CB0E23,42581,15,17,2,38,48,1948
60592,60592,71AB304A084EB4095E1F705C48CB0E23,11901,20,23,3,42,49,2149
60593,60593,AA51DE94270AE4663B2578A38D4EECC9,13961,0,6,6,42,48,2148
60594,60594,AA51DE94270AE4663B2578A38D4EECC9,11914,10,11,1,37,48,1898
60595,60595,AA51DE94270AE4663B2578A38D4EECC9,13961,11,13,2,42,48,2148
60596,60596,AA51DE94270AE4663B2578A38D4EECC9,11914,15,16,1,37,48,1898
60597,60597,AA51DE94270AE4663B2578A38D4EECC9,13961,21,23,2,42,48,2148
60610,60610,2ABD38013932BA402CF746256303FF27,42523,1,2,1,31,47,1597
60611,60611,2ABD38013932BA402CF746256303FF27,10292,4,5,1,30,47,1547
60612,60612,2ABD38013932BA402CF746256303FF27,42523,5,13,8,31,47,1597
60613,60613,2ABD38013932BA402CF746256303FF27,13121,13,14,1,38,46,1946
60614,60614,2ABD38013932BA402CF746256303FF27,42511,17,19,2,37,47,1897
60615,60615,394D700E14C58A7853C10805B183B24E,11061,1,6,5,29,48,1498
60616,60616,394D700E14C58A7853C10805B183B24E,11871,8,10,2,29,46,1496
60617,60617,394D700E14C58A7853C10805B183B24E,10107,13,17,4,38,49,1949
60618,60618,394D700E14C58A7853C10805B183B24E,11381,18,19,1,30,47,1547
60619,60619,394D700E14C58A7853C10805B183B24E,11061,20,21,1,29,48,1498
60620,60620,394D700E14C58A7853C10805B183B24E,11381,21,23,2,30,47,1547
60624,60624,D7D0C95F016F3CABBC9CD71ECFB8B763,12141,2,7,5,42,45,2145
60625,60625,D7D0C95F016F3CABBC9CD71ECFB8B763,42161,11,18,7,36,47,1847
60626,60626,D7D0C95F016F3CABBC9CD71ECFB8B763,10154,19,21,2,33,47,1697
60627,60627,D7D0C95F016F3CABBC9CD71ECFB8B763,10651,21,22,1,36,49,1849
60635,60635,697EB06F67653D08CFE9378AC3AAB5E4,43481,1,2,1,39,48,1998
60636,60636,697EB06F67653D08CFE9378AC3AAB5E4,11001,3,11,8,42,47,2147
60637,60637,697EB06F67653D08CFE9378AC3AAB5E4,13941,15,16,1,41,47,2097
60638,60638,697EB06F67653D08CFE9378AC3AAB5E4,11001,16,17,1,42,47,2147
60639,60639,697EB06F67653D08CFE9378AC3AAB5E4,13941,18,19,1,41,47,2097
60640,60640,697EB06F67653D08CFE9378AC3AAB5E4,11001,19,22,3,42,47,2147
60641,60641,ED387BC9729A0D8CA1364378D6AA6E43,10634,0,6,6,27,45,1395
60642,60642,ED387BC9729A0D8CA1364378D6AA6E43,10351,8,9,1,28,45,1445
60643,60643,ED387BC9729A0D8CA1364378D6AA6E43,10634,12,13,1,27,45,1395
60644,60644,ED387BC9729A0D8CA1364378D6AA6E43,12601,14,16,2,25,47,1297
60645,60645,ED387BC9729A0D8CA1364378D6AA6E43,10351,16,18,2,28,45,1445
60646,60646,ED387BC9729A0D8CA1364378D6AA6E43,10634,19,21,2,27,45,1395
60647,60647,F3355C7CE640AE85292C2A8D8E7E2415,13271,0,7,7,41,47,2097
60648,60648,F3355C7CE640AE85292C2A8D8E7E2415,10292,10,11,1,30,47,1547
60649,60649,F3355C7CE640AE85292C2A8D8E7E2415,10161,14,16,2,35,49,1799
60650,60650,F3355C7CE640AE85292C2A8D8E7E2415,13271,18,23,5,41,47,2097
60658,60658,5601C1A44CC85C7B09354B38FD0628D1,12311,0,7,7,30,44,1544
60659,60659,5601C1A44CC85C7B09354B38FD0628D1,13731,9,16,7,33,49,1699
60660,60660,5601C1A44CC85C7B09354B38FD0628D1,12311,19,23,4,30,44,1544
60665,60665,17D90E764FEB264827519C543FC27A49,43121,0,5,5,25,27,1277
60666,60666,17D90E764FEB264827519C543FC27A49,15321,7,9,2,29,26,1476
60667,60667,17D90E764FEB264827519C543FC27A49,43121,12,22,10,25,27,1277
60668,60668,E0F1492F64F8C4421FEE7685CFBBB89C,10491,0,8,8,33,48,1698
60669,60669,E0F1492F64F8C4421FEE7685CFBBB89C,12491,12,15,3,36,43,1843
60670,60670,E0F1492F64F8C4421FEE7685CFBBB89C,42151,15,17,2,35,45,1795
60671,60671,E0F1492F64F8C4421FEE7685CFBBB89C,10491,21,23,2,33,48,1698
60682,60682,0A61C8BC2E2F3B8A439DFBB7542FD5B0,13371,8,17,9,41,47,2097
60683,60683,0A61C8BC2E2F3B8A439DFBB7542FD5B0,10221,18,20,2,34,49,1749
60684,60684,0A61C8BC2E2F3B8A439DFBB7542FD5B0,13371,21,23,2,41,47,2097
60685,60685,7EF8399B7744B26431FFE3070C9BD313,19021,6,7,1,10,45,545
60686,60686,7EF8399B7744B26431FFE3070C9BD313,19441,9,10,1,8,46,446
60687,60687,7EF8399B7744B26431FFE3070C9BD313,42041,11,14,3,10,47,547
60688,60688,7EF8399B7744B26431FFE3070C9BD313,19441,15,16,1,8,46,446
60689,60689,7EF8399B7744B26431FFE3070C9BD313,19031,19,21,2,1,42,92
60693,60693,A1BB9BFB0530416A9A95BA5D6F72979B,42871,0,11,11,30,45,1545
60694,60694,A1BB9BFB0530416A9A95BA5D6F72979B,11875,13,14,1,30,46,1546
60695,60695,A1BB9BFB0530416A9A95BA5D6F72979B,42871,14,16,2,30,45,1545
60696,60696,A1BB9BFB0530416A9A95BA5D6F72979B,10301,16,18,2,31,45,1595
60697,60697,A1BB9BFB0530416A9A95BA5D6F72979B,42871,20,23,3,30,45,1545
60709,60709,63B27886E0E6D8A5DB2812762E3D29BA,12841,0,1,1,37,47,1897
60710,60710,63B27886E0E6D8A5DB2812762E3D29BA,10801,3,8,5,42,47,2147
60711,60711,63B27886E0E6D8A5DB2812762E3D29BA,13511,18,21,3,34,48,1748
60712,60712,5373610F890B22380CA1FA8F103E6F99,11201,0,2,2,35,49,1799
60713,60713,5373610F890B22380CA1FA8F103E6F99,43311,5,8,3,31,48,1598
60714,60714,5373610F890B22380CA1FA8F103E6F99,11381,12,16,4,30,47,1547
60715,60715,5373610F890B22380CA1FA8F103E6F99,42523,19,20,1,31,47,1597
60716,60716,5373610F890B22380CA1FA8F103E6F99,11381,21,23,2,30,47,1547
60717,60717,091497AD7ED956A0C3F93F46CFB651F5,43021,0,5,5,16,43,843
60718,60718,091497AD7ED956A0C3F93F46CFB651F5,12921,5,8,3,9,41,491
60719,60719,091497AD7ED956A0C3F93F46CFB651F5,43021,11,12,1,16,43,843
60720,60720,091497AD7ED956A0C3F93F46CFB651F5,12921,16,19,3,9,41,491
60721,60721,091497AD7ED956A0C3F93F46CFB651F5,43021,22,23,1,16,43,843
60728,60728,7DFCA2932B390D69ABC0E415A2260097,10351,0,9,9,28,45,1445
60729,60729,7DFCA2932B390D69ABC0E415A2260097,10301,11,12,1,31,45,1595
60730,60730,7DFCA2932B390D69ABC0E415A2260097,10351,16,17,1,28,45,1445
60731,60731,7DFCA2932B390D69ABC0E415A2260097,42531,18,19,1,31,45,1595
60732,60732,7DFCA2932B390D69ABC0E415A2260097,10351,22,23,1,28,45,1445
60733,60733,DC108CA51A8D783261AB9156C36F59F1,12601,0,1,1,25,47,1297
60734,60734,DC108CA51A8D783261AB9156C36F59F1,13094,2,5,3,21,42,1092
60735,60735,DC108CA51A8D783261AB9156C36F59F1,12601,6,17,11,25,47,1297
60736,60736,DC108CA51A8D783261AB9156C36F59F1,13771,18,19,1,21,45,1095
60741,60741,BC3DA9BAF9B0A0C935A79D91ECBDA067,19441,0,7,7,8,46,446
60742,60742,BC3DA9BAF9B0A0C935A79D91ECBDA067,19901,9,13,4,7,44,394
60743,60743,BC3DA9BAF9B0A0C935A79D91ECBDA067,42151,15,21,6,35,45,1795
60744,60744,C187943D20D187183526E0228C45660E,11021,0,7,7,36,49,1849
60745,60745,C187943D20D187183526E0228C45660E,11081,9,10,1,35,46,1796
60746,60746,C187943D20D187183526E0228C45660E,40034,10,12,2,32,48,1648
60747,60747,C187943D20D187183526E0228C45660E,11021,13,23,10,36,49,1849
60752,60752,E44757DC5C96DAA3D4F68F9ED452A860,11271,1,10,9,37,48,1898
60753,60753,E44757DC5C96DAA3D4F68F9ED452A860,12083,10,13,3,36,49,1849
60754,60754,E44757DC5C96DAA3D4F68F9ED452A860,42081,18,20,2,24,49,1249
60759,60759,64BD805F6D9361B926D90DA2610BBB4F,12921,1,2,1,9,41,491
60760,60760,64BD805F6D9361B926D90DA2610BBB4F,49201,2,3,1,7,41,391
60761,60761,64BD805F6D9361B926D90DA2610BBB4F,12921,3,6,3,9,41,491
60762,60762,64BD805F6D9361B926D90DA2610BBB4F,49201,7,8,1,7,41,391
60763,60763,64BD805F6D9361B926D90DA2610BBB4F,12921,8,12,4,9,41,491
60764,60764,64BD805F6D9361B926D90DA2610BBB4F,49201,14,18,4,7,41,391
60765,60765,64BD805F6D9361B926D90DA2610BBB4F,12921,20,21,1,9,41,491
60766,60766,64BD805F6D9361B926D90DA2610BBB4F,19031,22,23,1,1,42,92
60770,60770,7A69176949A6F3CD56C41411DF7AEF2C,43731,1,2,1,34,47,1747
60771,60771,7A69176949A6F3CD56C41411DF7AEF2C,42161,3,4,1,36,47,1847
60772,60772,7A69176949A6F3CD56C41411DF7AEF2C,43731,6,7,1,34,47,1747
60773,60773,7A69176949A6F3CD56C41411DF7AEF2C,11271,9,18,9,37,48,1898
60774,60774,7A69176949A6F3CD56C41411DF7AEF2C,40673,20,22,2,36,48,1848
60790,60790,9E3E758D6B4A550CE6D4227B72B6F4A8,11861,0,12,12,32,47,1647
60791,60791,9E3E758D6B4A550CE6D4227B72B6F4A8,40951,13,14,1,36,49,1849
60792,60792,9E3E758D6B4A550CE6D4227B72B6F4A8,10107,15,16,1,38,49,1949
60793,60793,9E3E758D6B4A550CE6D4227B72B6F4A8,11861,18,23,5,32,47,1647
60794,60794,642C5FCC730BC5A54E2036C81E432BC6,19114,2,5,3,7,43,393
60795,60795,642C5FCC730BC5A54E2036C81E432BC6,12641,8,11,3,10,43,543
60796,60796,642C5FCC730BC5A54E2036C81E432BC6,19114,15,17,2,7,43,393
60797,60797,642C5FCC730BC5A54E2036C81E432BC6,12641,17,19,2,10,43,543
60798,60798,642C5FCC730BC5A54E2036C81E432BC6,19114,19,23,4,7,43,393
60799,60799,B51991AF4ACE325C0342855E568A0491,12051,0,5,5,20,47,1047
60800,60800,B51991AF4ACE325C0342855E568A0491,12581,8,14,6,24,48,1248
60801,60801,B51991AF4ACE325C0342855E568A0491,12051,19,22,3,20,47,1047
60809,60809,624AB8E504B5603E94C9B5A1CE4A413E,13221,0,1,1,40,47,2047
60810,60810,624AB8E504B5603E94C9B5A1CE4A413E,13941,1,6,5,41,47,2097
60811,60811,624AB8E504B5603E94C9B5A1CE4A413E,11001,8,9,1,42,47,2147
60812,60812,624AB8E504B5603E94C9B5A1CE4A413E,13941,9,11,2,41,47,2097
60813,60813,624AB8E504B5603E94C9B5A1CE4A413E,11001,11,13,2,42,47,2147
60814,60814,624AB8E504B5603E94C9B5A1CE4A413E,13941,13,14,1,41,47,2097
60815,60815,624AB8E504B5603E94C9B5A1CE4A413E,11001,14,20,6,42,47,2147
60819,60819,530B60C597B34D2F4729C292F9EAB948,11104,0,7,7,17,47,897
60820,60820,530B60C597B34D2F4729C292F9EAB948,49201,9,16,7,7,41,391
60821,60821,530B60C597B34D2F4729C292F9EAB948,12921,16,18,2,9,41,491
60822,60822,530B60C597B34D2F4729C292F9EAB948,49201,19,20,1,7,41,391
60823,60823,6B614428F8D95ECFDE2207017437E97D,19281,0,5,5,16,32,832
60824,60824,6B614428F8D95ECFDE2207017437E97D,12871,7,19,12,22,33,1133
60825,60825,6B614428F8D95ECFDE2207017437E97D,19281,19,23,4,16,32,832
60826,60826,F8A2EC8C9348BFB1362087B807B825C5,43971,5,7,2,30,48,1548
60827,60827,F8A2EC8C9348BFB1362087B807B825C5,10161,9,17,8,35,49,1799
60828,60828,F8A2EC8C9348BFB1362087B807B825C5,11381,18,19,1,30,47,1547
60829,60829,09E35A3086ED2C100882D697DC471A83,42231,0,8,8,37,46,1896
60830,60830,09E35A3086ED2C100882D697DC471A83,11861,9,17,8,32,47,1647
60831,60831,09E35A3086ED2C100882D697DC471A83,15401,21,23,2,39,25,1975
60835,60835,64F6C3F601E54B35094A297D0E2269FC,10451,0,7,7,25,48,1298
60836,60836,64F6C3F601E54B35094A297D0E2269FC,40343,9,10,1,24,49,1249
60837,60837,64F6C3F601E54B35094A297D0E2269FC,40341,11,13,2,23,49,1199
60838,60838,64F6C3F601E54B35094A297D0E2269FC,12021,14,15,1,37,49,1899
60839,60839,64F6C3F601E54B35094A297D0E2269FC,10451,16,23,7,25,48,1298
60840,60840,666C6474C859B034AE49BB5E91C01140,42633,0,7,7,42,46,2146
60841,60841,666C6474C859B034AE49BB5E91C01140,11771,8,10,2,39,49,1999
60842,60842,666C6474C859B034AE49BB5E91C01140,43041,12,14,2,41,46,2096
60843,60843,666C6474C859B034AE49BB5E91C01140,42633,20,21,1,42,46,2146
60844,60844,666C6474C859B034AE49BB5E91C01140,12514,22,23,1,38,47,1947
60848,60848,6E4185400127263BAA432D53FEF1F217,42861,0,3,3,37,44,1894
60849,60849,6E4185400127263BAA432D53FEF1F217,11261,5,6,1,36,46,1846
60850,60850,6E4185400127263BAA432D53FEF1F217,42861,9,10,1,37,44,1894
60851,60851,6E4185400127263BAA432D53FEF1F217,13651,13,17,4,30,47,1547
60852,60852,6E4185400127263BAA432D53FEF1F217,42861,19,21,2,37,44,1894
60860,60860,5B36AF3FB8DFBC06F69C87BD2C6C60CC,11111,0,15,15,26,48,1348
60861,60861,5B36AF3FB8DFBC06F69C87BD2C6C60CC,12601,19,21,2,25,47,1297
60862,60862,5B36AF3FB8DFBC06F69C87BD2C6C60CC,10501,21,22,1,22,46,1146
60863,60863,804B7737707030C63DF2E4BD94DF220F,42971,0,6,6,43,49,2199
60864,60864,804B7737707030C63DF2E4BD94DF220F,11806,6,9,3,41,48,2098
60865,60865,804B7737707030C63DF2E4BD94DF220F,13101,9,11,2,40,47,2047
60866,60866,804B7737707030C63DF2E4BD94DF220F,11806,11,20,9,41,48,2098
60870,60870,F6947486712885EDC02BCA122A5A6DB5,15061,0,12,12,41,25,2075
60871,60871,F6947486712885EDC02BCA122A5A6DB5,12881,12,20,8,47,22,2372
60872,60872,F6947486712885EDC02BCA122A5A6DB5,15061,20,23,3,41,25,2075
60873,60873,B2405C351D1CAE2B4272A490DD149C7F,10634,0,3,3,27,45,1395
60874,60874,B2405C351D1CAE2B4272A490DD149C7F,42531,3,4,1,31,45,1595
60875,60875,B2405C351D1CAE2B4272A490DD149C7F,10634,5,7,2,27,45,1395
60876,60876,B2405C351D1CAE2B4272A490DD149C7F,10301,13,14,1,31,45,1595
60877,60877,B2405C351D1CAE2B4272A490DD149C7F,10351,14,19,5,28,45,1445
60878,60878,B2405C351D1CAE2B4272A490DD149C7F,42531,22,23,1,31,45,1595
60883,60883,A7889E15E0F93853EAB5CF324793B9C0,15411,0,5,5,44,27,2227
60884,60884,A7889E15E0F93853EAB5CF324793B9C0,13071,7,8,1,41,41,2091
60885,60885,A7889E15E0F93853EAB5CF324793B9C0,15411,10,13,3,44,27,2227
60886,60886,A7889E15E0F93853EAB5CF324793B9C0,12611,13,15,2,41,29,2079
60887,60887,A7889E15E0F93853EAB5CF324793B9C0,15411,15,23,8,44,27,2227
60888,60888,1F19D078AE02617B63A66EF47012E7A7,11331,0,3,3,37,48,1898
60889,60889,1F19D078AE02617B63A66EF47012E7A7,42271,5,7,2,40,47,2047
60890,60890,1F19D078AE02617B63A66EF47012E7A7,12381,10,12,2,32,48,1648
60891,60891,1F19D078AE02617B63A66EF47012E7A7,10107,13,23,10,38,49,1949
60896,60896,44AF7E3F6FD3AFD3E254BC36398928E0,43011,0,3,3,40,42,2042
60897,60897,44AF7E3F6FD3AFD3E254BC36398928E0,12561,8,13,5,45,43,2293
60898,60898,44AF7E3F6FD3AFD3E254BC36398928E0,13071,14,21,7,41,41,2091
60902,60902,88DA908BCBBD924A23915F0C35FE7D60,13314,0,5,5,31,39,1589
60903,60903,88DA908BCBBD924A23915F0C35FE7D60,12521,5,8,3,35,41,1791
60904,60904,88DA908BCBBD924A23915F0C35FE7D60,13314,12,23,11,31,39,1589
60905,60905,004FDED8DA71C27AC74CA54E3CE27983,12641,9,10,1,10,43,543
60906,60906,004FDED8DA71C27AC74CA54E3CE27983,19114,11,15,4,7,43,393
60907,60907,004FDED8DA71C27AC74CA54E3CE27983,12641,15,16,1,10,43,543
60908,60908,004FDED8DA71C27AC74CA54E3CE27983,43021,17,18,1,16,43,843
60912,60912,339C318AF31D2161E3FA2AD4986D9B89,10221,9,14,5,34,49,1749
60913,60913,339C318AF31D2161E3FA2AD4986D9B89,12971,15,17,2,32,48,1648
60914,60914,339C318AF31D2161E3FA2AD4986D9B89,11521,18,19,1,41,48,2098
60926,60926,AF57FD742700B6DD506E3D60F4DB6DD5,13471,1,2,1,47,49,2399
60927,60927,AF57FD742700B6DD506E3D60F4DB6DD5,13351,4,5,1,48,48,2448
60928,60928,AF57FD742700B6DD506E3D60F4DB6DD5,13471,13,15,2,47,49,2399
60929,60929,AF57FD742700B6DD506E3D60F4DB6DD5,11481,15,17,2,41,48,2098
60930,60930,AF57FD742700B6DD506E3D60F4DB6DD5,13351,18,23,5,48,48,2448
60935,60935,5C528CEBB15C8C0DDFC3A8B78AF2E8E2,12514,1,6,5,38,47,1947
60936,60936,5C528CEBB15C8C0DDFC3A8B78AF2E8E2,11151,10,12,2,30,48,1548
60937,60937,5C528CEBB15C8C0DDFC3A8B78AF2E8E2,11781,16,17,1,38,49,1949
60938,60938,5C528CEBB15C8C0DDFC3A8B78AF2E8E2,42221,21,23,2,38,48,1948
60942,60942,D59A7D67E6A2D306517724C5A50D5385,10351,0,1,1,28,45,1445
60943,60943,D59A7D67E6A2D306517724C5A50D5385,10301,1,2,1,31,45,1595
60944,60944,D59A7D67E6A2D306517724C5A50D5385,10351,6,13,7,28,45,1445
60945,60945,D59A7D67E6A2D306517724C5A50D5385,40637,14,16,2,36,47,1847
60946,60946,D59A7D67E6A2D306517724C5A50D5385,10351,20,21,1,28,45,1445
60955,60955,40C7D3C5D9F329611BF9C3A4DECD64A9,42981,0,2,2,36,49,1849
60956,60956,40C7D3C5D9F329611BF9C3A4DECD64A9,42081,3,4,1,24,49,1249
60957,60957,40C7D3C5D9F329611BF9C3A4DECD64A9,42071,5,6,1,31,49,1599
60958,60958,40C7D3C5D9F329611BF9C3A4DECD64A9,11531,20,21,1,34,49,1749
60959,60959,71CDB42BF8ABF4C8B89BDC81F92C39B7,10634,0,6,6,27,45,1395
60960,60960,71CDB42BF8ABF4C8B89BDC81F92C39B7,10351,8,12,4,28,45,1445
60961,60961,71CDB42BF8ABF4C8B89BDC81F92C39B7,11321,14,16,2,31,46,1596
60962,60962,71CDB42BF8ABF4C8B89BDC81F92C39B7,10634,18,20,2,27,45,1395
60963,60963,F475546FA2D112D7D0EDED3FAB477F8E,40801,0,7,7,43,46,2196
60964,60964,F475546FA2D112D7D0EDED3FAB477F8E,10251,8,12,4,35,47,1797
60965,60965,F475546FA2D112D7D0EDED3FAB477F8E,40801,12,23,11,43,46,2196
60966,60966,9A489F4DB17C8647E054C50181F17211,10331,0,4,4,39,46,1996
60967,60967,9A489F4DB17C8647E054C50181F17211,11261,5,13,8,36,46,1846
60968,60968,9A489F4DB17C8647E054C50181F17211,42864,15,17,2,38,44,1944
60969,60969,9A489F4DB17C8647E054C50181F17211,43011,18,21,3,40,42,2042
60970,60970,37CDA2C4F073B20F463A9C0C98829DCE,13651,0,1,1,30,47,1547
60971,60971,37CDA2C4F073B20F463A9C0C98829DCE,42523,1,3,2,31,47,1597
60972,60972,37CDA2C4F073B20F463A9C0C98829DCE,10951,3,7,4,29,48,1498
60973,60973,37CDA2C4F073B20F463A9C0C98829DCE,10151,8,9,1,34,47,1747
60974,60974,37CDA2C4F073B20F463A9C0C98829DCE,13651,10,16,6,30,47,1547
60975,60975,37CDA2C4F073B20F463A9C0C98829DCE,10151,18,19,1,34,47,1747
60976,60976,37CDA2C4F073B20F463A9C0C98829DCE,11861,20,22,2,32,47,1647
60977,60977,A09953F67FED80A8C2308F84F83FE6DA,42011,0,6,6,36,46,1846
60978,60978,A09953F67FED80A8C2308F84F83FE6DA,13711,9,12,3,38,46,1946
60979,60979,A09953F67FED80A8C2308F84F83FE6DA,43241,14,15,1,36,46,1846
60980,60980,A09953F67FED80A8C2308F84F83FE6DA,13711,15,18,3,38,46,1946
60981,60981,A09953F67FED80A8C2308F84F83FE6DA,43241,18,20,2,36,46,1846
60985,60985,0004E9A02B9F97024FE46D8B36381EE9,43021,0,8,8,16,43,843
60986,60986,0004E9A02B9F97024FE46D8B36381EE9,12311,10,18,8,30,44,1544
60987,60987,0004E9A02B9F97024FE46D8B36381EE9,42161,20,21,1,36,47,1847
60988,60988,0004E9A02B9F97024FE46D8B36381EE9,11021,22,23,1,36,49,1849
60992,60992,E75DBC8FF69066A482B9B403023F9E0C,43761,1,6,5,32,47,1647
60993,60993,E75DBC8FF69066A482B9B403023F9E0C,11521,8,18,10,41,48,2098
60994,60994,E75DBC8FF69066A482B9B403023F9E0C,10281,20,21,1,33,48,1698
60995,60995,B59895EE7DA55722188364E0C5226FD4,13121,0,7,7,38,46,1946
60996,60996,B59895EE7DA55722188364E0C5226FD4,11021,8,11,3,36,49,1849
60997,60997,B59895EE7DA55722188364E0C5226FD4,10351,13,15,2,28,45,1445
60998,60998,B59895EE7DA55722188364E0C5226FD4,13121,19,23,4,38,46,1946
60999,60999,25C8E48F46CE3AC7F14FD7208B98656B,13651,2,4,2,30,47,1547
61000,61000,25C8E48F46CE3AC7F14FD7208B98656B,12601,9,11,2,25,47,1297
61001,61001,25C8E48F46CE3AC7F14FD7208B98656B,13651,14,17,3,30,47,1547
61002,61002,25C8E48F46CE3AC7F14FD7208B98656B,13371,21,23,2,41,47,2097
61003,61003,76A50127C9E8E4C112EB1B61B027BCBF,19441,2,5,3,8,46,446
61004,61004,76A50127C9E8E4C112EB1B61B027BCBF,11101,7,9,2,18,48,948
61005,61005,76A50127C9E8E4C112EB1B61B027BCBF,12621,19,23,4,10,48,548
61009,61009,738DD67EF8A0383DB9D45ABE1F75C490,42071,0,4,4,31,49,1599
61010,61010,738DD67EF8A0383DB9D45ABE1F75C490,42081,4,7,3,24,49,1249
61011,61011,738DD67EF8A0383DB9D45ABE1F75C490,42071,7,21,14,31,49,1599
61012,61012,2EFEA3D9E50D1587D2C8297E61F47270,11091,0,4,4,29,47,1497
61013,61013,2EFEA3D9E50D1587D2C8297E61F47270,42523,5,7,2,31,47,1597
61014,61014,2EFEA3D9E50D1587D2C8297E61F47270,11091,12,13,1,29,47,1497
61015,61015,2EFEA3D9E50D1587D2C8297E61F47270,10711,14,16,2,29,46,1496
61016,61016,2EFEA3D9E50D1587D2C8297E61F47270,11091,20,23,3,29,47,1497
61020,61020,F1D52E271AD2CA60B9DB39C5E4BE77A4,12921,2,3,1,9,41,491
61021,61021,F1D52E271AD2CA60B9DB39C5E4BE77A4,19021,5,14,9,10,45,545
61022,61022,F1D52E271AD2CA60B9DB39C5E4BE77A4,19901,15,16,1,7,44,394
61023,61023,F1D52E271AD2CA60B9DB39C5E4BE77A4,19021,17,19,2,10,45,545
61024,61024,8C93E9687A717AEFB87364B357E16B82,10901,1,3,2,35,48,1798
61025,61025,8C93E9687A717AEFB87364B357E16B82,10811,5,8,3,38,46,1946
61026,61026,8C93E9687A717AEFB87364B357E16B82,12121,8,10,2,29,47,1497
61027,61027,8C93E9687A717AEFB87364B357E16B82,10911,13,14,1,39,46,1996
61028,61028,8C93E9687A717AEFB87364B357E16B82,10121,14,17,3,36,49,1849
61029,61029,8C93E9687A717AEFB87364B357E16B82,10331,18,22,4,39,46,1996
61030,61030,DF460CBD4C09A51D06C2038FDA368680,19441,4,8,4,8,46,446
61031,61031,DF460CBD4C09A51D06C2038FDA368680,42041,9,10,1,10,47,547
61032,61032,DF460CBD4C09A51D06C2038FDA368680,19441,14,15,1,8,46,446
61033,61033,DF460CBD4C09A51D06C2038FDA368680,42041,16,17,1,10,47,547
61034,61034,DF460CBD4C09A51D06C2038FDA368680,19441,21,23,2,8,46,446
61039,61039,ACB0DC94F8B8E18A0BF618F44347ABEE,42261,1,3,2,25,49,1299
61040,61040,ACB0DC94F8B8E18A0BF618F44347ABEE,42071,6,13,7,31,49,1599
61041,61041,ACB0DC94F8B8E18A0BF618F44347ABEE,11151,14,15,1,30,48,1548
61042,61042,ACB0DC94F8B8E18A0BF618F44347ABEE,11381,16,18,2,30,47,1547
61043,61043,E6E1B072EE7202225510F5B63E9E6AA7,11921,0,5,5,38,48,1948
61044,61044,E6E1B072EE7202225510F5B63E9E6AA7,42121,8,17,9,26,49,1349
61045,61045,E6E1B072EE7202225510F5B63E9E6AA7,42221,21,23,2,38,48,1948
61049,61049,73701CC9434D9172C828A8DD1EB9C8FD,12921,2,7,5,9,41,491
61050,61050,73701CC9434D9172C828A8DD1EB9C8FD,49201,7,10,3,7,41,391
61051,61051,73701CC9434D9172C828A8DD1EB9C8FD,12921,10,12,2,9,41,491
61052,61052,73701CC9434D9172C828A8DD1EB9C8FD,49201,14,15,1,7,41,391
61053,61053,73701CC9434D9172C828A8DD1EB9C8FD,12921,15,18,3,9,41,491
61054,61054,73701CC9434D9172C828A8DD1EB9C8FD,49201,18,19,1,7,41,391
61058,61058,4F54A77CCE3E4B66C9B21229376E7EB3,11753,0,17,17,35,48,1798
61059,61059,4F54A77CCE3E4B66C9B21229376E7EB3,42623,19,20,1,22,49,1149
61060,61060,4F54A77CCE3E4B66C9B21229376E7EB3,11753,21,23,2,35,48,1798
61061,61061,8D0E5EEB929E7505317A235D8A0E4D1E,42191,0,6,6,38,49,1949
61062,61062,8D0E5EEB929E7505317A235D8A0E4D1E,42961,6,9,3,35,49,1799
61063,61063,8D0E5EEB929E7505317A235D8A0E4D1E,11231,12,14,2,37,49,1899
61064,61064,8D0E5EEB929E7505317A235D8A0E4D1E,42981,14,15,1,36,49,1849
61065,61065,8D0E5EEB929E7505317A235D8A0E4D1E,11231,19,21,2,37,49,1899
61070,61070,1463E9838EB11802DBC75E65276D110F,42531,2,4,2,31,45,1595
61071,61071,1463E9838EB11802DBC75E65276D110F,12521,7,8,1,35,41,1791
61072,61072,1463E9838EB11802DBC75E65276D110F,13314,10,18,8,31,39,1589
61073,61073,1463E9838EB11802DBC75E65276D110F,42531,21,23,2,31,45,1595
61074,61074,3C5EB3D934314AD006AD5B79ACDC766A,19261,3,8,5,6,37,337
61075,61075,3C5EB3D934314AD006AD5B79ACDC766A,12921,9,11,2,9,41,491
61076,61076,3C5EB3D934314AD006AD5B79ACDC766A,19261,13,22,9,6,37,337
61077,61077,7C5210855A5DFB6ACF7A087ADA0E2F3D,13911,0,5,5,39,46,1996
61078,61078,7C5210855A5DFB6ACF7A087ADA0E2F3D,42231,6,9,3,37,46,1896
61079,61079,7C5210855A5DFB6ACF7A087ADA0E2F3D,13911,10,12,2,39,46,1996
61080,61080,7C5210855A5DFB6ACF7A087ADA0E2F3D,42231,14,18,4,37,46,1896
61081,61081,7C5210855A5DFB6ACF7A087ADA0E2F3D,13911,21,23,2,39,46,1996
61082,61082,689123C0EEDB67E843AB1B84D69E3074,42471,0,8,8,35,49,1799
61083,61083,689123C0EEDB67E843AB1B84D69E3074,10401,9,10,1,33,49,1699
61084,61084,689123C0EEDB67E843AB1B84D69E3074,11061,13,15,2,29,48,1498
61085,61085,689123C0EEDB67E843AB1B84D69E3074,11211,17,19,2,34,49,1749
61086,61086,689123C0EEDB67E843AB1B84D69E3074,11061,21,23,2,29,48,1498
61087,61087,024AB2D90319DF57F94996854D076E3D,13271,0,7,7,41,47,2097
61088,61088,024AB2D90319DF57F94996854D076E3D,11021,10,17,7,36,49,1849
61089,61089,024AB2D90319DF57F94996854D076E3D,10221,18,21,3,34,49,1749
61090,61090,024AB2D90319DF57F94996854D076E3D,11541,21,22,1,35,49,1799
61098,61098,42450E4607B078BD3F39C67BF93F8737,11111,1,13,12,26,48,1348
61099,61099,42450E4607B078BD3F39C67BF93F8737,10451,13,16,3,25,48,1298
61100,61100,42450E4607B078BD3F39C67BF93F8737,13951,18,19,1,47,45,2395
61101,61101,42450E4607B078BD3F39C67BF93F8737,10451,19,22,3,25,48,1298
61102,61102,746607B162E7EB25AA57FCC2A7B9163E,11861,0,12,12,32,47,1647
61103,61103,746607B162E7EB25AA57FCC2A7B9163E,40673,13,14,1,36,48,1848
61104,61104,746607B162E7EB25AA57FCC2A7B9163E,10251,14,16,2,35,47,1797
61105,61105,746607B162E7EB25AA57FCC2A7B9163E,42301,19,20,1,36,47,1847
61106,61106,746607B162E7EB25AA57FCC2A7B9163E,11861,21,23,2,32,47,1647
61116,61116,7C98BDF484E2B085C51A4945E804FC0C,42151,4,6,2,35,45,1795
61117,61117,7C98BDF484E2B085C51A4945E804FC0C,12491,6,8,2,36,43,1843
61118,61118,7C98BDF484E2B085C51A4945E804FC0C,42151,8,17,9,35,45,1795
61119,61119,7C98BDF484E2B085C51A4945E804FC0C,12491,17,19,2,36,43,1843
61120,61120,7C98BDF484E2B085C51A4945E804FC0C,42151,19,23,4,35,45,1795
61121,61121,7179E8D23C9EF0FE56A034B0F52DF3EB,11641,0,7,7,22,49,1149
61122,61122,7179E8D23C9EF0FE56A034B0F52DF3EB,42071,9,16,7,31,49,1599
61123,61123,7179E8D23C9EF0FE56A034B0F52DF3EB,42623,19,20,1,22,49,1149
61124,61124,CAD1FFF41FBB07303E4F900E7ED6962A,43391,0,6,6,29,48,1498
61125,61125,CAD1FFF41FBB07303E4F900E7ED6962A,10421,7,9,2,41,48,2098
61126,61126,CAD1FFF41FBB07303E4F900E7ED6962A,40637,10,11,1,36,47,1847
61127,61127,CAD1FFF41FBB07303E4F900E7ED6962A,10221,12,13,1,34,49,1749
61128,61128,CAD1FFF41FBB07303E4F900E7ED6962A,40691,14,18,4,42,48,2148
61129,61129,CAD1FFF41FBB07303E4F900E7ED6962A,13601,20,23,3,34,47,1747
61130,61130,120368F7CD3E20C4A5CFEF1F75B84608,11381,1,8,7,30,47,1547
61131,61131,120368F7CD3E20C4A5CFEF1F75B84608,41631,8,11,3,28,47,1447
61132,61132,120368F7CD3E20C4A5CFEF1F75B84608,11381,12,13,1,30,47,1547
61133,61133,120368F7CD3E20C4A5CFEF1F75B84608,41631,14,16,2,28,47,1447
61134,61134,120368F7CD3E20C4A5CFEF1F75B84608,11381,19,23,4,30,47,1547
61141,61141,E13A8412A9FC40986BB07E7EA7B51E5B,42231,0,8,8,37,46,1896
61142,61142,E13A8412A9FC40986BB07E7EA7B51E5B,13911,14,17,3,39,46,1996
61143,61143,E13A8412A9FC40986BB07E7EA7B51E5B,11631,19,21,2,12,49,649
61166,61166,8CD5156CF883DA15618BAFE58DDCF2A7,42581,0,6,6,38,48,1948
61167,61167,8CD5156CF883DA15618BAFE58DDCF2A7,11914,6,7,1,37,48,1898
61168,61168,8CD5156CF883DA15618BAFE58DDCF2A7,42581,8,15,7,38,48,1948
61169,61169,8CD5156CF883DA15618BAFE58DDCF2A7,11914,16,17,1,37,48,1898
61170,61170,8CD5156CF883DA15618BAFE58DDCF2A7,42581,17,18,1,38,48,1948
61177,61177,232A65D7E72D31ED563D0041FCDF23A8,12491,0,4,4,36,43,1843
61178,61178,232A65D7E72D31ED563D0041FCDF23A8,42151,4,11,7,35,45,1795
61179,61179,232A65D7E72D31ED563D0041FCDF23A8,12491,13,15,2,36,43,1843
61180,61180,232A65D7E72D31ED563D0041FCDF23A8,42151,21,22,1,35,45,1795
61181,61181,232A65D7E72D31ED563D0041FCDF23A8,12491,22,23,1,36,43,1843
61185,61185,2917A11EB625CB868E9962150273A0D4,10431,9,11,2,33,49,1699
61186,61186,2917A11EB625CB868E9962150273A0D4,10301,12,13,1,31,45,1595
61187,61187,2917A11EB625CB868E9962150273A0D4,10431,14,17,3,33,49,1699
61188,61188,2917A11EB625CB868E9962150273A0D4,13671,21,23,2,27,43,1393
61189,61189,4B5C492CF16B079882322240829D6566,11231,0,10,10,37,49,1899
61190,61190,4B5C492CF16B079882322240829D6566,43281,10,11,1,37,48,1898
61191,61191,4B5C492CF16B079882322240829D6566,11231,12,14,2,37,49,1899
61192,61192,4B5C492CF16B079882322240829D6566,10221,17,18,1,34,49,1749
61193,61193,4B5C492CF16B079882322240829D6566,11231,18,23,5,37,49,1899
61194,61194,3044AD5F90932CCE405DE87EFA97D7EF,43021,1,4,3,16,43,843
61195,61195,3044AD5F90932CCE405DE87EFA97D7EF,19021,7,12,5,10,45,545
61196,61196,3044AD5F90932CCE405DE87EFA97D7EF,43021,17,19,2,16,43,843
61197,61197,42C74C72D35B339ED05BC27A3DEC0690,19031,0,6,6,1,42,92
61198,61198,42C74C72D35B339ED05BC27A3DEC0690,12641,7,14,7,10,43,543
61199,61199,42C74C72D35B339ED05BC27A3DEC0690,19031,16,23,7,1,42,92
61203,61203,07952485C45B2F42535F88271FC57393,10811,0,1,1,38,46,1946
61204,61204,07952485C45B2F42535F88271FC57393,10521,4,13,9,41,47,2097
61205,61205,07952485C45B2F42535F88271FC57393,13221,13,16,3,40,47,2047
61206,61206,07952485C45B2F42535F88271FC57393,13071,17,23,6,41,41,2091
61207,61207,64812FF1B8835C5669BB93C0D5307414,42961,0,5,5,35,49,1799
61208,61208,64812FF1B8835C5669BB93C0D5307414,41271,9,11,2,38,48,1948
61209,61209,64812FF1B8835C5669BB93C0D5307414,11231,14,15,1,37,49,1899
61210,61210,64812FF1B8835C5669BB93C0D5307414,43581,16,17,1,33,48,1698
61211,61211,64812FF1B8835C5669BB93C0D5307414,11231,21,23,2,37,49,1899
61231,61231,4CDC8B55805F54C701951AA286ACE261,42521,4,6,2,31,47,1597
61232,61232,4CDC8B55805F54C701951AA286ACE261,11954,8,17,9,32,49,1649
61233,61233,4CDC8B55805F54C701951AA286ACE261,11201,18,21,3,35,49,1799
61234,61234,8436FA510D59B3814E50B7F18BD1D92C,19571,0,5,5,1,36,86
61235,61235,8436FA510D59B3814E50B7F18BD1D92C,12641,7,17,10,10,43,543
61236,61236,8436FA510D59B3814E50B7F18BD1D92C,19571,21,23,2,1,36,86
61237,61237,1C184E544EE72EBCB4C6C69605221F85,10381,0,4,4,31,49,1599
61238,61238,1C184E544EE72EBCB4C6C69605221F85,42261,4,8,4,25,49,1299
61239,61239,1C184E544EE72EBCB4C6C69605221F85,42071,12,23,11,31,49,1599
61240,61240,BF5EFB3BDBF5437ACD467C87E9038A8B,43021,0,5,5,16,43,843
61241,61241,BF5EFB3BDBF5437ACD467C87E9038A8B,12921,6,7,1,9,41,491
61242,61242,BF5EFB3BDBF5437ACD467C87E9038A8B,43021,7,12,5,16,43,843
61243,61243,BF5EFB3BDBF5437ACD467C87E9038A8B,12921,13,15,2,9,41,491
61244,61244,BF5EFB3BDBF5437ACD467C87E9038A8B,43021,19,23,4,16,43,843
61248,61248,9DD3BD519BBA02AD03DEFD759DCE6799,40673,0,8,8,36,48,1848
61249,61249,9DD3BD519BBA02AD03DEFD759DCE6799,12211,12,13,1,41,44,2094
61250,61250,9DD3BD519BBA02AD03DEFD759DCE6799,11021,15,17,2,36,49,1849
61251,61251,9DD3BD519BBA02AD03DEFD759DCE6799,12211,21,23,2,41,44,2094
61255,61255,1C0548F40841AD0870DAD8EC7BECCBC6,13314,0,7,7,31,39,1589
61256,61256,1C0548F40841AD0870DAD8EC7BECCBC6,12521,8,10,2,35,41,1791
61257,61257,1C0548F40841AD0870DAD8EC7BECCBC6,13314,11,13,2,31,39,1589
61258,61258,1C0548F40841AD0870DAD8EC7BECCBC6,12521,13,17,4,35,41,1791
61259,61259,1C0548F40841AD0870DAD8EC7BECCBC6,13314,21,23,2,31,39,1589
61263,61263,B93C16A242FE2C6BDA83A87AD4FAA434,10501,0,7,7,22,46,1146
61264,61264,B93C16A242FE2C6BDA83A87AD4FAA434,12601,11,14,3,25,47,1297
61265,61265,B93C16A242FE2C6BDA83A87AD4FAA434,10501,14,15,1,22,46,1146
61266,61266,B93C16A242FE2C6BDA83A87AD4FAA434,12601,19,20,1,25,47,1297
61267,61267,B93C16A242FE2C6BDA83A87AD4FAA434,10501,22,23,1,22,46,1146
61268,61268,E648A6F090A3BE85617E0ED54A73B4F0,12601,0,4,4,25,47,1297
61269,61269,E648A6F090A3BE85617E0ED54A73B4F0,12671,4,15,11,21,43,1093
61270,61270,E648A6F090A3BE85617E0ED54A73B4F0,12601,17,23,6,25,47,1297
61271,61271,3C07D1557002BF4F1AA6A6D7A8949EF2,42523,0,4,4,31,47,1597
61272,61272,3C07D1557002BF4F1AA6A6D7A8949EF2,12601,8,16,8,25,47,1297
61273,61273,3C07D1557002BF4F1AA6A6D7A8949EF2,42523,19,20,1,31,47,1597
61274,61274,3C07D1557002BF4F1AA6A6D7A8949EF2,43761,20,21,1,32,47,1647
61275,61275,99E96056F1348BE5EE68CAB62754CE87,10951,0,2,2,29,48,1498
61276,61276,99E96056F1348BE5EE68CAB62754CE87,11381,4,6,2,30,47,1547
61277,61277,99E96056F1348BE5EE68CAB62754CE87,10951,11,13,2,29,48,1498
61278,61278,99E96056F1348BE5EE68CAB62754CE87,42623,19,23,4,22,49,1149
61279,61279,EA51A406CE578A65A7187933536C9E6B,11561,0,8,8,32,49,1649
61280,61280,EA51A406CE578A65A7187933536C9E6B,10681,12,14,2,30,48,1548
61281,61281,EA51A406CE578A65A7187933536C9E6B,11431,15,16,1,29,47,1497
61282,61282,EA51A406CE578A65A7187933536C9E6B,42021,18,21,3,33,47,1697
61290,61290,EBEC12643A85FF06102FB66738B5C413,42581,1,3,2,38,48,1948
61291,61291,EBEC12643A85FF06102FB66738B5C413,11271,6,8,2,37,48,1898
61292,61292,EBEC12643A85FF06102FB66738B5C413,11461,8,9,1,37,49,1899
61293,61293,EBEC12643A85FF06102FB66738B5C413,11021,9,11,2,36,49,1849
61294,61294,EBEC12643A85FF06102FB66738B5C413,11291,15,19,4,40,49,2049
61295,61295,EBEC12643A85FF06102FB66738B5C413,10841,20,22,2,37,47,1897
61296,61296,0F155161AC9A08ADA75BAA1BD7450976,43751,0,6,6,19,48,998
61297,61297,0F155161AC9A08ADA75BAA1BD7450976,42681,6,8,2,24,48,1248
61298,61298,0F155161AC9A08ADA75BAA1BD7450976,43751,13,23,10,19,48,998
61299,61299,9C0ACC78786AB3EDB58D985A680EE622,11001,0,3,3,42,47,2147
61300,61300,9C0ACC78786AB3EDB58D985A680EE622,13341,4,7,3,44,45,2245
61301,61301,9C0ACC78786AB3EDB58D985A680EE622,11291,9,11,2,40,49,2049
61302,61302,9C0ACC78786AB3EDB58D985A680EE622,13341,13,14,1,44,45,2245
61303,61303,9C0ACC78786AB3EDB58D985A680EE622,11291,16,19,3,40,49,2049
61304,61304,9C0ACC78786AB3EDB58D985A680EE622,13341,19,21,2,44,45,2245
61305,61305,9C0ACC78786AB3EDB58D985A680EE622,13601,22,23,1,34,47,1747
61306,61306,9C686B624E1F19B96755FA9920EEF4B6,11781,0,1,1,38,49,1949
61307,61307,9C686B624E1F19B96755FA9920EEF4B6,42921,2,20,18,33,47,1697
61308,61308,9C686B624E1F19B96755FA9920EEF4B6,10111,20,22,2,37,47,1897
61309,61309,3AB35E62E3464B5074E82DE69E9DD0D9,42501,0,7,7,28,47,1447
61310,61310,3AB35E62E3464B5074E82DE69E9DD0D9,19441,10,14,4,8,46,446
61311,61311,3AB35E62E3464B5074E82DE69E9DD0D9,42501,18,23,5,28,47,1447
61312,61312,4C277ABE9AAFFACC84B539B0700C1F48,10221,2,15,13,34,49,1749
61313,61313,4C277ABE9AAFFACC84B539B0700C1F48,11061,18,20,2,29,48,1498
61314,61314,4C277ABE9AAFFACC84B539B0700C1F48,42961,20,22,2,35,49,1799
61318,61318,9BBBC00C93BA6A3176E2B008E6F8A88E,42351,0,5,5,38,45,1945
61319,61319,9BBBC00C93BA6A3176E2B008E6F8A88E,11261,5,10,5,36,46,1846
61320,61320,9BBBC00C93BA6A3176E2B008E6F8A88E,13911,14,16,2,39,46,1996
61321,61321,9BBBC00C93BA6A3176E2B008E6F8A88E,11261,16,18,2,36,46,1846
61322,61322,9BBBC00C93BA6A3176E2B008E6F8A88E,13911,18,20,2,39,46,1996
61323,61323,9BBBC00C93BA6A3176E2B008E6F8A88E,11261,20,21,1,36,46,1846
61324,61324,9BBBC00C93BA6A3176E2B008E6F8A88E,13911,22,23,1,39,46,1996
61328,61328,A336F8D086418A70D6F2B0EA33768B6C,10811,0,10,10,38,46,1946
61329,61329,A336F8D086418A70D6F2B0EA33768B6C,10841,10,12,2,37,47,1897
61330,61330,A336F8D086418A70D6F2B0EA33768B6C,10811,12,13,1,38,46,1946
61331,61331,A336F8D086418A70D6F2B0EA33768B6C,10841,14,16,2,37,47,1897
61332,61332,A336F8D086418A70D6F2B0EA33768B6C,19621,19,20,1,5,46,296
61333,61333,CC6A63734928B4CD8F414AAB01241B9F,10611,0,14,14,32,48,1648
61334,61334,CC6A63734928B4CD8F414AAB01241B9F,10107,14,16,2,38,49,1949
61335,61335,CC6A63734928B4CD8F414AAB01241B9F,11531,17,19,2,34,49,1749
61336,61336,CC6A63734928B4CD8F414AAB01241B9F,11751,21,23,2,35,48,1798
61340,61340,EE107F15123C6DB132974358298F51B4,11914,2,6,4,37,48,1898
61341,61341,EE107F15123C6DB132974358298F51B4,10591,8,9,1,39,48,1998
61342,61342,EE107F15123C6DB132974358298F51B4,11914,13,14,1,37,48,1898
61343,61343,EE107F15123C6DB132974358298F51B4,43181,15,17,2,39,48,1998
61344,61344,EE107F15123C6DB132974358298F51B4,42581,20,21,1,38,48,1948
61345,61345,652BF65634129AD52E8E3669162C8125,42461,0,6,6,45,47,2297
61346,61346,652BF65634129AD52E8E3669162C8125,42321,7,10,3,43,47,2197
61347,61347,652BF65634129AD52E8E3669162C8125,42461,12,14,2,45,47,2297
61348,61348,652BF65634129AD52E8E3669162C8125,11701,16,18,2,43,48,2198
61349,61349,652BF65634129AD52E8E3669162C8125,42461,19,23,4,45,47,2297
61356,61356,449E7811DCD6E8CD500501049B5A906E,13911,0,6,6,39,46,1996
61357,61357,449E7811DCD6E8CD500501049B5A906E,11261,9,10,1,36,46,1846
61358,61358,449E7811DCD6E8CD500501049B5A906E,13911,11,12,1,39,46,1996
61359,61359,449E7811DCD6E8CD500501049B5A906E,11261,14,20,6,36,46,1846
61360,61360,449E7811DCD6E8CD500501049B5A906E,13911,20,21,1,39,46,1996
61361,61361,634DBD789AFAD1E24FFCA10A088F0AE1,13341,0,9,9,44,45,2245
61362,61362,634DBD789AFAD1E24FFCA10A088F0AE1,11261,14,18,4,36,46,1846
61363,61363,634DBD789AFAD1E24FFCA10A088F0AE1,13121,19,21,2,38,46,1946
61364,61364,59269BD1EB55D92351CAC27C11455378,10331,1,8,7,39,46,1996
61365,61365,59269BD1EB55D92351CAC27C11455378,12601,12,15,3,25,47,1297
61366,61366,59269BD1EB55D92351CAC27C11455378,10331,19,23,4,39,46,1996
61370,61370,68D66AC2F31097852E1113FCAC38B096,42531,0,3,3,31,45,1595
61371,61371,68D66AC2F31097852E1113FCAC38B096,12121,6,7,1,29,47,1497
61372,61372,68D66AC2F31097852E1113FCAC38B096,42531,7,12,5,31,45,1595
61373,61373,68D66AC2F31097852E1113FCAC38B096,12311,15,16,1,30,44,1544
61374,61374,68D66AC2F31097852E1113FCAC38B096,42531,17,19,2,31,45,1595
61375,61375,FF16D1104349162E539969031BE39A02,43481,0,8,8,39,48,1998
61376,61376,FF16D1104349162E539969031BE39A02,12514,10,12,2,38,47,1947
61377,61377,FF16D1104349162E539969031BE39A02,43481,13,14,1,39,48,1998
61378,61378,FF16D1104349162E539969031BE39A02,12511,20,22,2,39,47,1997
61379,61379,FF16D1104349162E539969031BE39A02,43481,22,23,1,39,48,1998
61386,61386,0F2E7737761FB5772278335D9DA9FBBB,15321,0,7,7,29,26,1476
61387,61387,0F2E7737761FB5772278335D9DA9FBBB,43121,8,18,10,25,27,1277
61388,61388,0F2E7737761FB5772278335D9DA9FBBB,15321,19,22,3,29,26,1476
61389,61389,CF7DA1891D00F069E0E0214450037183,11381,0,8,8,30,47,1547
61390,61390,CF7DA1891D00F069E0E0214450037183,10111,9,11,2,37,47,1897
61391,61391,CF7DA1891D00F069E0E0214450037183,11381,12,23,11,30,47,1547
61392,61392,0781E535CBB143640477269330BEC7EE,40411,2,4,2,34,48,1748
61393,61393,0781E535CBB143640477269330BEC7EE,42161,7,8,1,36,47,1847
61394,61394,0781E535CBB143640477269330BEC7EE,40411,8,9,1,34,48,1748
61395,61395,0781E535CBB143640477269330BEC7EE,42161,17,18,1,36,47,1847
61396,61396,0781E535CBB143640477269330BEC7EE,40411,18,20,2,34,48,1748
61397,61397,0781E535CBB143640477269330BEC7EE,11131,21,23,2,33,48,1698
61398,61398,2E9ACB5217DEAC635E911A6AAEF6DCF5,11261,0,8,8,36,46,1846
61399,61399,2E9ACB5217DEAC635E911A6AAEF6DCF5,12021,9,11,2,37,49,1899
61400,61400,2E9ACB5217DEAC635E911A6AAEF6DCF5,11261,12,14,2,36,46,1846
61401,61401,2E9ACB5217DEAC635E911A6AAEF6DCF5,12021,15,16,1,37,49,1899
61402,61402,2E9ACB5217DEAC635E911A6AAEF6DCF5,11261,18,23,5,36,46,1846
61406,61406,0B929ACA970011AFF649AD1CE667839A,12921,1,8,7,9,41,491
61407,61407,0B929ACA970011AFF649AD1CE667839A,43021,8,10,2,16,43,843
61408,61408,0B929ACA970011AFF649AD1CE667839A,12921,11,13,2,9,41,491
61409,61409,0B929ACA970011AFF649AD1CE667839A,43021,14,23,9,16,43,843
61431,61431,B5872860E0AEBC030046A88AEA834112,15191,0,3,3,36,27,1827
61432,61432,B5872860E0AEBC030046A88AEA834112,12792,4,9,5,34,30,1730
61433,61433,B5872860E0AEBC030046A88AEA834112,15311,12,13,1,43,25,2175
61434,61434,B5872860E0AEBC030046A88AEA834112,12792,14,15,1,34,30,1730
61435,61435,B5872860E0AEBC030046A88AEA834112,15311,16,17,1,43,25,2175
61436,61436,B5872860E0AEBC030046A88AEA834112,15061,18,21,3,41,25,2075
61437,61437,B5872860E0AEBC030046A88AEA834112,12792,21,22,1,34,30,1730
61448,61448,F4D3C378527A4C5DB6117FA55BFE5A91,13711,0,9,9,38,46,1946
61449,61449,F4D3C378527A4C5DB6117FA55BFE5A91,40341,11,13,2,23,49,1199
61450,61450,F4D3C378527A4C5DB6117FA55BFE5A91,13711,15,23,8,38,46,1946
61458,61458,FCA3C665B5BF337F331669EDB597A6AC,42941,0,2,2,37,47,1897
61459,61459,FCA3C665B5BF337F331669EDB597A6AC,42791,3,7,4,35,45,1795
61460,61460,FCA3C665B5BF337F331669EDB597A6AC,10271,8,10,2,37,46,1896
61461,61461,FCA3C665B5BF337F331669EDB597A6AC,13121,12,14,2,38,46,1946
61462,61462,FCA3C665B5BF337F331669EDB597A6AC,10271,14,17,3,37,46,1896
61463,61463,FCA3C665B5BF337F331669EDB597A6AC,13121,17,18,1,38,46,1946
61464,61464,FCA3C665B5BF337F331669EDB597A6AC,42791,19,20,1,35,45,1795
61465,61465,FCA3C665B5BF337F331669EDB597A6AC,10271,20,21,1,37,46,1896
61466,61466,2D9F8EEE0946858BEC66856CB73B8335,43021,0,5,5,16,43,843
61467,61467,2D9F8EEE0946858BEC66856CB73B8335,12921,7,9,2,9,41,491
61468,61468,2D9F8EEE0946858BEC66856CB73B8335,43021,12,13,1,16,43,843
61469,61469,2D9F8EEE0946858BEC66856CB73B8335,12921,13,18,5,9,41,491
61470,61470,2D9F8EEE0946858BEC66856CB73B8335,43021,19,23,4,16,43,843
61471,61471,4EBB382643C7FAC868385593D235FA2B,13771,0,2,2,21,45,1095
61472,61472,4EBB382643C7FAC868385593D235FA2B,13091,6,7,1,20,42,1042
61473,61473,4EBB382643C7FAC868385593D235FA2B,12601,8,23,15,25,47,1297
61474,61474,71FDEFC3187A3CF24BA939D7B11B9629,12391,1,3,2,36,49,1849
61475,61475,71FDEFC3187A3CF24BA939D7B11B9629,11231,3,7,4,37,49,1899
61476,61476,71FDEFC3187A3CF24BA939D7B11B9629,10121,7,16,9,36,49,1849
61477,61477,71FDEFC3187A3CF24BA939D7B11B9629,42961,17,18,1,35,49,1799
61478,61478,71FDEFC3187A3CF24BA939D7B11B9629,10471,20,22,2,37,48,1898
61479,61479,7F2E872023193A89FBDF087A966D2170,10161,9,10,1,35,49,1799
61480,61480,7F2E872023193A89FBDF087A966D2170,10191,11,13,2,40,48,2048
61481,61481,7F2E872023193A89FBDF087A966D2170,12083,16,17,1,36,49,1849
61482,61482,7F2E872023193A89FBDF087A966D2170,11231,21,23,2,37,49,1899
61486,61486,0E91A13D0E931F32EE1FFD96FA252798,42381,0,5,5,39,41,1991
61487,61487,0E91A13D0E931F32EE1FFD96FA252798,43451,9,10,1,37,40,1890
61488,61488,0E91A13D0E931F32EE1FFD96FA252798,13071,10,11,1,41,41,2091
61489,61489,0E91A13D0E931F32EE1FFD96FA252798,43451,16,17,1,37,40,1890
61490,61490,0E91A13D0E931F32EE1FFD96FA252798,13071,19,21,2,41,41,2091
61491,61491,0E91A13D0E931F32EE1FFD96FA252798,42381,22,23,1,39,41,1991
61498,61498,815A6783B9D74E71BB7F4728D4F2621A,10881,0,6,6,34,48,1748
61499,61499,815A6783B9D74E71BB7F4728D4F2621A,42271,8,11,3,40,47,2047
61500,61500,815A6783B9D74E71BB7F4728D4F2621A,11806,16,17,1,41,48,2098
61501,61501,815A6783B9D74E71BB7F4728D4F2621A,10691,20,21,1,33,48,1698
61502,61502,8D2C2C42E63FD22BFD992889F79D269F,11061,0,1,1,29,48,1498
61503,61503,8D2C2C42E63FD22BFD992889F79D269F,11381,1,2,1,30,47,1547
61504,61504,8D2C2C42E63FD22BFD992889F79D269F,11061,3,9,6,29,48,1498
61505,61505,8D2C2C42E63FD22BFD992889F79D269F,11381,14,21,7,30,47,1547
61506,61506,8D2C2C42E63FD22BFD992889F79D269F,11061,22,23,1,29,48,1498
61507,61507,7D8BB90B66B5BB302B836A7DB354A71B,11701,0,6,6,43,48,2198
61508,61508,7D8BB90B66B5BB302B836A7DB354A71B,42321,7,8,1,43,47,2197
61509,61509,7D8BB90B66B5BB302B836A7DB354A71B,42601,12,14,2,44,48,2248
61510,61510,7D8BB90B66B5BB302B836A7DB354A71B,42321,14,17,3,43,47,2197
61511,61511,7D8BB90B66B5BB302B836A7DB354A71B,42601,20,23,3,44,48,2248
61512,61512,51ED40A82E9C1A94F7286865C3CA897F,11021,0,14,14,36,49,1849
61513,61513,51ED40A82E9C1A94F7286865C3CA897F,13941,16,17,1,41,47,2097
61514,61514,51ED40A82E9C1A94F7286865C3CA897F,11021,18,23,5,36,49,1849
61515,61515,BCCF2CDFD6C9D7A77ABBD1757075B8AB,11781,10,13,3,38,49,1949
61516,61516,BCCF2CDFD6C9D7A77ABBD1757075B8AB,11151,15,16,1,30,48,1548
61517,61517,BCCF2CDFD6C9D7A77ABBD1757075B8AB,11531,17,20,3,34,49,1749
61518,61518,BCCF2CDFD6C9D7A77ABBD1757075B8AB,10651,20,22,2,36,49,1849
61519,61519,26CDDE90E81CF115EC565EA62A47B92A,13331,10,11,1,38,47,1947
61520,61520,26CDDE90E81CF115EC565EA62A47B92A,13651,12,13,1,30,47,1547
61521,61521,26CDDE90E81CF115EC565EA62A47B92A,42523,14,16,2,31,47,1597
61522,61522,26CDDE90E81CF115EC565EA62A47B92A,19021,18,19,1,10,45,545
61523,61523,7FBC8EE4EAF538E2F5C357E9E39087FD,11201,0,7,7,35,49,1799
61524,61524,7FBC8EE4EAF538E2F5C357E9E39087FD,10211,9,11,2,16,49,849
61525,61525,7FBC8EE4EAF538E2F5C357E9E39087FD,11201,15,17,2,35,49,1799
61526,61526,7FBC8EE4EAF538E2F5C357E9E39087FD,11753,18,21,3,35,48,1798
61527,61527,7FBC8EE4EAF538E2F5C357E9E39087FD,11201,22,23,1,35,49,1799
61536,61536,831CEF471029417D091D2BE9F78234DD,13941,0,1,1,41,47,2097
61537,61537,831CEF471029417D091D2BE9F78234DD,42321,4,9,5,43,47,2197
61538,61538,831CEF471029417D091D2BE9F78234DD,10801,12,13,1,42,47,2147
61539,61539,831CEF471029417D091D2BE9F78234DD,10107,15,18,3,38,49,1949
61540,61540,849ABE491B03E58A138E48C20217078E,10716,0,5,5,30,46,1546
61541,61541,849ABE491B03E58A138E48C20217078E,43644,8,9,1,14,38,738
61542,61542,849ABE491B03E58A138E48C20217078E,19571,13,15,2,1,36,86
61543,61543,849ABE491B03E58A138E48C20217078E,11151,19,20,1,30,48,1548
61544,61544,0C0E9445DA9933EC9FC4753172D45ECC,13371,0,13,13,41,47,2097
61545,61545,0C0E9445DA9933EC9FC4753172D45ECC,13221,14,15,1,40,47,2047
61546,61546,0C0E9445DA9933EC9FC4753172D45ECC,11001,16,17,1,42,47,2147
61547,61547,0C0E9445DA9933EC9FC4753172D45ECC,11074,19,20,1,37,47,1897
61548,61548,0C0E9445DA9933EC9FC4753172D45ECC,12511,20,21,1,39,47,1997
61549,61549,0C0E9445DA9933EC9FC4753172D45ECC,13371,21,23,2,41,47,2097
61550,61550,04D3DE5FD9FDB4FD914E8F65E47E316F,19901,8,9,1,7,44,394
61551,61551,04D3DE5FD9FDB4FD914E8F65E47E316F,12641,10,11,1,10,43,543
61552,61552,04D3DE5FD9FDB4FD914E8F65E47E316F,12921,11,23,12,9,41,491
61556,61556,95A50FC77E468146BAD45CC8BD317370,43731,4,5,1,34,47,1747
61557,61557,95A50FC77E468146BAD45CC8BD317370,42921,6,7,1,33,47,1697
61558,61558,95A50FC77E468146BAD45CC8BD317370,11381,11,13,2,30,47,1547
61559,61559,95A50FC77E468146BAD45CC8BD317370,10951,16,18,2,29,48,1498
61560,61560,95A50FC77E468146BAD45CC8BD317370,43731,20,22,2,34,47,1747
61564,61564,14D802A3B202443F8B89CB3561B9B173,42531,0,7,7,31,45,1595
61565,61565,14D802A3B202443F8B89CB3561B9B173,10221,8,11,3,34,49,1749
61566,61566,14D802A3B202443F8B89CB3561B9B173,12311,13,17,4,30,44,1544
61567,61567,14D802A3B202443F8B89CB3561B9B173,42531,18,19,1,31,45,1595
61568,61568,14D802A3B202443F8B89CB3561B9B173,12311,20,21,1,30,44,1544
61569,61569,C8EB41C6B7152CD714709DA811B3B245,10681,0,10,10,30,48,1548
61570,61570,C8EB41C6B7152CD714709DA811B3B245,43391,10,13,3,29,48,1498
61571,61571,C8EB41C6B7152CD714709DA811B3B245,11151,15,16,1,30,48,1548
61572,61572,C8EB41C6B7152CD714709DA811B3B245,43391,16,20,4,29,48,1498
61573,61573,C8EB41C6B7152CD714709DA811B3B245,11151,20,22,2,30,48,1548
61574,61574,62A2F5272230052AEB85DFD96BD0E354,12601,0,8,8,25,47,1297
61575,61575,62A2F5272230052AEB85DFD96BD0E354,10411,10,14,4,36,48,1848
61576,61576,62A2F5272230052AEB85DFD96BD0E354,10901,15,16,1,35,48,1798
61577,61577,62A2F5272230052AEB85DFD96BD0E354,10411,17,20,3,36,48,1848
61578,61578,62A2F5272230052AEB85DFD96BD0E354,12601,22,23,1,25,47,1297
61582,61582,3CF7B0916CDE9473EE3871FE908999F3,19901,0,6,6,7,44,394
61583,61583,3CF7B0916CDE9473EE3871FE908999F3,12921,6,8,2,9,41,491
61584,61584,3CF7B0916CDE9473EE3871FE908999F3,19114,8,9,1,7,43,393
61585,61585,3CF7B0916CDE9473EE3871FE908999F3,19901,12,13,1,7,44,394
61586,61586,3CF7B0916CDE9473EE3871FE908999F3,19114,15,17,2,7,43,393
61587,61587,3CF7B0916CDE9473EE3871FE908999F3,19901,19,23,4,7,44,394
61591,61591,E572D34D15CCFF06895D9E2C410E6273,42151,9,15,6,35,45,1795
61592,61592,E572D34D15CCFF06895D9E2C410E6273,10491,19,20,1,33,48,1698
61593,61593,E572D34D15CCFF06895D9E2C410E6273,12381,20,23,3,32,48,1648
61594,61594,5C43416A739D6997A74BBA50F19E82A3,42541,0,7,7,25,47,1297
61595,61595,5C43416A739D6997A74BBA50F19E82A3,11861,7,12,5,32,47,1647
61596,61596,5C43416A739D6997A74BBA50F19E82A3,10171,14,15,1,26,47,1347
61597,61597,5C43416A739D6997A74BBA50F19E82A3,11861,15,19,4,32,47,1647
61598,61598,7EA20FBAC6304528CA4D807CDFD1BC6B,10301,0,2,2,31,45,1595
61599,61599,7EA20FBAC6304528CA4D807CDFD1BC6B,12311,4,5,1,30,44,1544
61600,61600,7EA20FBAC6304528CA4D807CDFD1BC6B,10301,6,9,3,31,45,1595
61601,61601,7EA20FBAC6304528CA4D807CDFD1BC6B,12311,13,14,1,30,44,1544
61602,61602,7EA20FBAC6304528CA4D807CDFD1BC6B,10301,15,16,1,31,45,1595
61603,61603,7EA20FBAC6304528CA4D807CDFD1BC6B,12311,18,19,1,30,44,1544
61610,61610,1F899C425E1D44BC86781F60DDEF728E,43021,0,8,8,16,43,843
61611,61611,1F899C425E1D44BC86781F60DDEF728E,12921,9,10,1,9,41,491
61612,61612,1F899C425E1D44BC86781F60DDEF728E,43021,11,23,12,16,43,843
61613,61613,9B3D4DB494E6B8E7329532A1BECC6FF1,12641,7,9,2,10,43,543
61614,61614,9B3D4DB494E6B8E7329532A1BECC6FF1,12921,9,10,1,9,41,491
61615,61615,9B3D4DB494E6B8E7329532A1BECC6FF1,43021,11,13,2,16,43,843
61616,61616,9B3D4DB494E6B8E7329532A1BECC6FF1,12921,16,17,1,9,41,491
61617,61617,9B3D4DB494E6B8E7329532A1BECC6FF1,43021,19,22,3,16,43,843
61618,61618,93480BD2CFFC3AF3E114C39E975B1437,43751,0,4,4,19,48,998
61619,61619,93480BD2CFFC3AF3E114C39E975B1437,12581,8,10,2,24,48,1248
61620,61620,93480BD2CFFC3AF3E114C39E975B1437,43751,10,23,13,19,48,998
61627,61627,EDBE9058BB0B28E0915A84395E9226D9,11261,0,7,7,36,46,1846
61628,61628,EDBE9058BB0B28E0915A84395E9226D9,42861,8,10,2,37,44,1894
61629,61629,EDBE9058BB0B28E0915A84395E9226D9,11261,11,12,1,36,46,1846
61630,61630,EDBE9058BB0B28E0915A84395E9226D9,42861,14,16,2,37,44,1894
61631,61631,EDBE9058BB0B28E0915A84395E9226D9,11261,17,19,2,36,46,1846
61632,61632,C8BB5B9ECE6D29A0D7A087B9918224BA,13841,0,2,2,40,46,2046
61633,61633,C8BB5B9ECE6D29A0D7A087B9918224BA,10331,4,7,3,39,46,1996
61634,61634,C8BB5B9ECE6D29A0D7A087B9918224BA,10221,7,10,3,34,49,1749
61635,61635,C8BB5B9ECE6D29A0D7A087B9918224BA,12381,13,14,1,32,48,1648
61636,61636,C8BB5B9ECE6D29A0D7A087B9918224BA,10221,15,19,4,34,49,1749
61643,61643,35FE39B951D37418385844C98A76F454,15401,0,6,6,39,25,1975
61644,61644,35FE39B951D37418385844C98A76F454,15411,7,17,10,44,27,2227
61645,61645,35FE39B951D37418385844C98A76F454,13251,17,18,1,48,28,2428
61646,61646,35FE39B951D37418385844C98A76F454,15401,19,23,4,39,25,1975
61647,61647,64B34CB87676A40B149FBA6DF8948435,40341,9,11,2,23,49,1199
61648,61648,64B34CB87676A40B149FBA6DF8948435,42623,13,14,1,22,49,1149
61649,61649,64B34CB87676A40B149FBA6DF8948435,43751,16,19,3,19,48,998
61656,61656,601A51EA671623E5E466F858B3908746,13231,0,8,8,39,46,1996
61657,61657,601A51EA671623E5E466F858B3908746,11321,9,10,1,31,46,1596
61658,61658,601A51EA671623E5E466F858B3908746,42523,10,12,2,31,47,1597
61659,61659,601A51EA671623E5E466F858B3908746,13651,13,18,5,30,47,1547
61660,61660,601A51EA671623E5E466F858B3908746,13231,19,22,3,39,46,1996
61661,61661,55D7ACFA437F11789D3C11FF383299DE,43671,0,5,5,35,48,1798
61662,61662,55D7ACFA437F11789D3C11FF383299DE,13511,5,9,4,34,48,1748
61663,61663,55D7ACFA437F11789D3C11FF383299DE,43671,13,15,2,35,48,1798
61664,61664,55D7ACFA437F11789D3C11FF383299DE,10161,17,18,1,35,49,1799
61665,61665,55D7ACFA437F11789D3C11FF383299DE,43671,19,20,1,35,48,1798
61666,61666,55D7ACFA437F11789D3C11FF383299DE,13511,21,23,2,34,48,1748
61667,61667,B20D4CCCBBF9B534BB9F26A35B371E4C,13911,1,3,2,39,46,1996
61668,61668,B20D4CCCBBF9B534BB9F26A35B371E4C,42351,4,5,1,38,45,1945
61669,61669,B20D4CCCBBF9B534BB9F26A35B371E4C,11261,6,7,1,36,46,1846
61670,61670,B20D4CCCBBF9B534BB9F26A35B371E4C,11941,11,12,1,37,46,1896
61671,61671,B20D4CCCBBF9B534BB9F26A35B371E4C,13911,14,15,1,39,46,1996
61672,61672,B20D4CCCBBF9B534BB9F26A35B371E4C,11941,16,18,2,37,46,1896
61673,61673,B20D4CCCBBF9B534BB9F26A35B371E4C,11261,18,19,1,36,46,1846
61674,61674,F9D0EC34FCB1E0B2023D1EFE7DF23CFA,13651,0,14,14,30,47,1547
61675,61675,F9D0EC34FCB1E0B2023D1EFE7DF23CFA,10841,15,18,3,37,47,1897
61676,61676,F9D0EC34FCB1E0B2023D1EFE7DF23CFA,13651,19,23,4,30,47,1547
61680,61680,F898B34C9FF3D681FFA1363A321CF375,42261,9,10,1,25,49,1299
61681,61681,F898B34C9FF3D681FFA1363A321CF375,13731,14,16,2,33,49,1699
61682,61682,F898B34C9FF3D681FFA1363A321CF375,11151,20,21,1,30,48,1548
61687,61687,569FE1B0CCF701005479FDA64CAA96A2,11074,0,7,7,37,47,1897
61688,61688,569FE1B0CCF701005479FDA64CAA96A2,11231,8,12,4,37,49,1899
61689,61689,569FE1B0CCF701005479FDA64CAA96A2,11074,12,13,1,37,47,1897
61690,61690,569FE1B0CCF701005479FDA64CAA96A2,11231,14,21,7,37,49,1899
61691,61691,569FE1B0CCF701005479FDA64CAA96A2,11074,22,23,1,37,47,1897
61692,61692,46A745F5F32E034BFD9793B2086817E0,10681,0,2,2,30,48,1548
61693,61693,46A745F5F32E034BFD9793B2086817E0,11381,3,4,1,30,47,1547
61694,61694,46A745F5F32E034BFD9793B2086817E0,10681,5,6,1,30,48,1548
61695,61695,46A745F5F32E034BFD9793B2086817E0,11381,11,13,2,30,47,1547
61696,61696,46A745F5F32E034BFD9793B2086817E0,10681,14,15,1,30,48,1548
61697,61697,46A745F5F32E034BFD9793B2086817E0,11061,17,19,2,29,48,1498
61698,61698,46A745F5F32E034BFD9793B2086817E0,10681,20,21,1,30,48,1548
61699,61699,CC63EA7467D4A1FC7EF1BC76C9DAF092,42864,2,3,1,38,44,1944
61700,61700,CC63EA7467D4A1FC7EF1BC76C9DAF092,43011,3,5,2,40,42,2042
61701,61701,CC63EA7467D4A1FC7EF1BC76C9DAF092,11261,6,8,2,36,46,1846
61702,61702,CC63EA7467D4A1FC7EF1BC76C9DAF092,12211,9,10,1,41,44,2094
61703,61703,CC63EA7467D4A1FC7EF1BC76C9DAF092,11261,11,14,3,36,46,1846
61704,61704,CC63EA7467D4A1FC7EF1BC76C9DAF092,12311,15,16,1,30,44,1544
61705,61705,CC63EA7467D4A1FC7EF1BC76C9DAF092,11261,19,21,2,36,46,1846
61706,61706,CC63EA7467D4A1FC7EF1BC76C9DAF092,42864,22,23,1,38,44,1944
61707,61707,8A4EE976F1E8BC4CA88390DFA08CB5DF,10621,0,7,7,41,49,2099
61708,61708,8A4EE976F1E8BC4CA88390DFA08CB5DF,11021,11,14,3,36,49,1849
61709,61709,8A4EE976F1E8BC4CA88390DFA08CB5DF,40261,16,17,1,35,49,1799
61710,61710,8A4EE976F1E8BC4CA88390DFA08CB5DF,10781,18,20,2,35,47,1797
61711,61711,8A4EE976F1E8BC4CA88390DFA08CB5DF,40691,22,23,1,42,48,2148
61715,61715,45B3C058C2932BE977126C481DC8DAD1,11381,1,12,11,30,47,1547
61716,61716,45B3C058C2932BE977126C481DC8DAD1,41382,19,21,2,38,49,1949
61717,61717,45B3C058C2932BE977126C481DC8DAD1,11381,22,23,1,30,47,1547
61724,61724,D256AE34DD31744D7365602849D9C40A,10341,0,8,8,31,47,1597
61725,61725,D256AE34DD31744D7365602849D9C40A,12601,12,15,3,25,47,1297
61726,61726,D256AE34DD31744D7365602849D9C40A,42491,18,20,2,32,46,1646
61727,61727,F6CF1C41F7C41D5A8B55D9B98830D394,11701,0,7,7,43,48,2198
61728,61728,F6CF1C41F7C41D5A8B55D9B98830D394,10911,11,14,3,39,46,1996
61729,61729,F6CF1C41F7C41D5A8B55D9B98830D394,13331,14,15,1,38,47,1947
61730,61730,F6CF1C41F7C41D5A8B55D9B98830D394,10621,19,20,1,41,49,2099
61731,61731,F6CF1C41F7C41D5A8B55D9B98830D394,40691,22,23,1,42,48,2148
61742,61742,09757EDFE7795D1E67DCE5C4439A4727,12521,0,9,9,35,41,1791
61743,61743,09757EDFE7795D1E67DCE5C4439A4727,13314,10,11,1,31,39,1589
61744,61744,09757EDFE7795D1E67DCE5C4439A4727,12521,11,23,12,35,41,1791
61745,61745,61DE87BB131AFCA2EBC38E2F283C9021,13671,1,2,1,27,43,1393
61746,61746,61DE87BB131AFCA2EBC38E2F283C9021,13314,3,5,2,31,39,1589
61747,61747,61DE87BB131AFCA2EBC38E2F283C9021,11834,6,8,2,32,45,1645
61748,61748,61DE87BB131AFCA2EBC38E2F283C9021,13671,9,11,2,27,43,1393
61749,61749,61DE87BB131AFCA2EBC38E2F283C9021,11834,14,16,2,32,45,1645
61750,61750,61DE87BB131AFCA2EBC38E2F283C9021,13671,18,23,5,27,43,1393
61751,61751,59E8BD2B3B6F40BDD7AA0B26E7BC6262,13351,0,1,1,48,48,2448
61752,61752,59E8BD2B3B6F40BDD7AA0B26E7BC6262,13471,3,6,3,47,49,2399
61753,61753,59E8BD2B3B6F40BDD7AA0B26E7BC6262,11701,8,9,1,43,48,2198
61754,61754,59E8BD2B3B6F40BDD7AA0B26E7BC6262,13471,12,14,2,47,49,2399
61755,61755,59E8BD2B3B6F40BDD7AA0B26E7BC6262,11701,16,18,2,43,48,2198
61756,61756,59E8BD2B3B6F40BDD7AA0B26E7BC6262,43621,21,22,1,46,48,2348
61760,61760,6FB118526D3E3A4C1190AF083475702A,43751,0,14,14,19,48,998
61761,61761,6FB118526D3E3A4C1190AF083475702A,10451,14,16,2,25,48,1298
61762,61762,6FB118526D3E3A4C1190AF083475702A,43751,21,23,2,19,48,998
61763,61763,B43AA3699824975D870EBE7EFE78E52E,42511,1,9,8,37,47,1897
61764,61764,B43AA3699824975D870EBE7EFE78E52E,11701,12,15,3,43,48,2198
61765,61765,B43AA3699824975D870EBE7EFE78E52E,10161,16,18,2,35,49,1799
61769,61769,05286C4B5017A260B39768783F7D4555,42581,0,6,6,38,48,1948
61770,61770,05286C4B5017A260B39768783F7D4555,11914,6,9,3,37,48,1898
61771,61771,05286C4B5017A260B39768783F7D4555,42581,10,12,2,38,48,1948
61772,61772,05286C4B5017A260B39768783F7D4555,11914,13,17,4,37,48,1898
61773,61773,05286C4B5017A260B39768783F7D4555,42581,21,23,2,38,48,1948
61774,61774,22E0CD429C1B1E7AC6170F90C318BE33,13941,0,7,7,41,47,2097
61775,61775,22E0CD429C1B1E7AC6170F90C318BE33,12641,8,18,10,10,43,543
61776,61776,22E0CD429C1B1E7AC6170F90C318BE33,13941,19,23,4,41,47,2097
61780,61780,F10F5F870D2BAF9C3378171A398BFD7F,42151,0,2,2,35,45,1795
61781,61781,F10F5F870D2BAF9C3378171A398BFD7F,42861,3,4,1,37,44,1894
61782,61782,F10F5F870D2BAF9C3378171A398BFD7F,12491,5,6,1,36,43,1843
61783,61783,F10F5F870D2BAF9C3378171A398BFD7F,42861,8,14,6,37,44,1894
61784,61784,F10F5F870D2BAF9C3378171A398BFD7F,42151,18,20,2,35,45,1795
61785,61785,F10F5F870D2BAF9C3378171A398BFD7F,42861,21,23,2,37,44,1894
61801,61801,BC6DAD4D62ED18FC3923EF3C412AA85C,10681,0,3,3,30,48,1548
61802,61802,BC6DAD4D62ED18FC3923EF3C412AA85C,11061,4,6,2,29,48,1498
61803,61803,BC6DAD4D62ED18FC3923EF3C412AA85C,11231,10,12,2,37,49,1899
61804,61804,BC6DAD4D62ED18FC3923EF3C412AA85C,40891,13,16,3,37,47,1897
61805,61805,BC6DAD4D62ED18FC3923EF3C412AA85C,10681,19,21,2,30,48,1548
61812,61812,3F558062FED8D455694E306F67D6AF09,13341,0,2,2,44,45,2245
61813,61813,3F558062FED8D455694E306F67D6AF09,12221,3,4,1,43,44,2194
61814,61814,3F558062FED8D455694E306F67D6AF09,43011,4,5,1,40,42,2042
61815,61815,3F558062FED8D455694E306F67D6AF09,13341,13,15,2,44,45,2245
61816,61816,3F558062FED8D455694E306F67D6AF09,42631,20,21,1,43,45,2195
61820,61820,F0BADC1DB10F78BE87B4AA8A7F62B3BC,11631,8,10,2,12,49,649
61821,61821,F0BADC1DB10F78BE87B4AA8A7F62B3BC,12921,12,18,6,9,41,491
61822,61822,F0BADC1DB10F78BE87B4AA8A7F62B3BC,12641,20,22,2,10,43,543
61823,61823,9C35C609BEEB7023F559DA7824DEFA84,11061,7,8,1,29,48,1498
61824,61824,9C35C609BEEB7023F559DA7824DEFA84,13221,11,16,5,40,47,2047
61825,61825,9C35C609BEEB7023F559DA7824DEFA84,11061,17,23,6,29,48,1498
61830,61830,802D06E8811CDC65FDAB61E1A1D233B3,12601,0,1,1,25,47,1297
61831,61831,802D06E8811CDC65FDAB61E1A1D233B3,42481,4,5,1,22,49,1149
61832,61832,802D06E8811CDC65FDAB61E1A1D233B3,10501,6,7,1,22,46,1146
61833,61833,802D06E8811CDC65FDAB61E1A1D233B3,10691,10,19,9,33,48,1698
61837,61837,110EB8ED5B33FF374638B480C238C00D,10271,2,7,5,37,46,1896
61838,61838,110EB8ED5B33FF374638B480C238C00D,19744,8,17,9,6,43,343
61839,61839,110EB8ED5B33FF374638B480C238C00D,10271,20,21,1,37,46,1896
61840,61840,BC76CCD190FA1A5238AAD9129E2B96C9,40463,0,7,7,38,49,1949
61841,61841,BC76CCD190FA1A5238AAD9129E2B96C9,10471,9,11,2,37,48,1898
61842,61842,BC76CCD190FA1A5238AAD9129E2B96C9,11231,11,13,2,37,49,1899
61843,61843,BC76CCD190FA1A5238AAD9129E2B96C9,40463,13,14,1,38,49,1949
61844,61844,BC76CCD190FA1A5238AAD9129E2B96C9,11231,16,21,5,37,49,1899
61848,61848,209CBAFCECFCFAF5ADEC7A13A8F80FC5,12641,0,1,1,10,43,543
61849,61849,209CBAFCECFCFAF5ADEC7A13A8F80FC5,19114,4,8,4,7,43,393
61850,61850,209CBAFCECFCFAF5ADEC7A13A8F80FC5,12641,11,12,1,10,43,543
61851,61851,209CBAFCECFCFAF5ADEC7A13A8F80FC5,19114,14,16,2,7,43,393
61852,61852,209CBAFCECFCFAF5ADEC7A13A8F80FC5,12921,20,23,3,9,41,491
61853,61853,E28F4E9B3D6A2BC652897C2753B36E40,19801,0,8,8,19,26,976
61854,61854,E28F4E9B3D6A2BC652897C2753B36E40,12871,13,15,2,22,33,1133
61855,61855,E28F4E9B3D6A2BC652897C2753B36E40,19801,16,18,2,19,26,976
61856,61856,E28F4E9B3D6A2BC652897C2753B36E40,12874,19,23,4,20,34,1034
61860,61860,A4CBFA774BBCB1E081978588796288CA,10681,0,7,7,30,48,1548
61861,61861,A4CBFA774BBCB1E081978588796288CA,11231,8,18,10,37,49,1899
61862,61862,A4CBFA774BBCB1E081978588796288CA,10681,18,22,4,30,48,1548
61863,61863,872EA7042E221A40D168D3255557BABA,43761,0,8,8,32,47,1647
61864,61864,872EA7042E221A40D168D3255557BABA,12021,11,13,2,37,49,1899
61865,61865,872EA7042E221A40D168D3255557BABA,43761,14,20,6,32,47,1647
61866,61866,872EA7042E221A40D168D3255557BABA,42523,20,21,1,31,47,1597
61867,61867,872EA7042E221A40D168D3255557BABA,43761,21,23,2,32,47,1647
61874,61874,92305B26A7F607A8AD97896B11A39503,42041,0,13,13,10,47,547
61875,61875,92305B26A7F607A8AD97896B11A39503,19021,13,15,2,10,45,545
61876,61876,92305B26A7F607A8AD97896B11A39503,12581,18,20,2,24,48,1248
61880,61880,4EE541C2C77ED64C3476846B8EC5E510,12871,1,3,2,22,33,1133
61881,61881,4EE541C2C77ED64C3476846B8EC5E510,12874,3,5,2,20,34,1034
61882,61882,4EE541C2C77ED64C3476846B8EC5E510,12871,10,12,2,22,33,1133
61883,61883,4EE541C2C77ED64C3476846B8EC5E510,19801,12,14,2,19,26,976
61884,61884,4EE541C2C77ED64C3476846B8EC5E510,19431,16,19,3,8,29,429
61885,61885,4EE541C2C77ED64C3476846B8EC5E510,19801,20,22,2,19,26,976
61886,61886,F32ADB5058C82ADA4AD50F7FCC196198,43751,0,4,4,19,48,998
61887,61887,F32ADB5058C82ADA4AD50F7FCC196198,12581,5,18,13,24,48,1248
61888,61888,F32ADB5058C82ADA4AD50F7FCC196198,12051,21,23,2,20,47,1047
61889,61889,344A3CF0E215A1C44A25A9F391805F64,40271,0,2,2,35,49,1799
61890,61890,344A3CF0E215A1C44A25A9F391805F64,42191,4,5,1,38,49,1949
61891,61891,344A3CF0E215A1C44A25A9F391805F64,10681,6,17,11,30,48,1548
61892,61892,344A3CF0E215A1C44A25A9F391805F64,10491,20,22,2,33,48,1698
61893,61893,4507A6AA40E86D001FA56149FC45CD13,19741,0,5,5,5,44,294
61894,61894,4507A6AA40E86D001FA56149FC45CD13,19181,7,14,7,8,40,440
61895,61895,4507A6AA40E86D001FA56149FC45CD13,43644,14,16,2,14,38,738
61896,61896,4507A6AA40E86D001FA56149FC45CD13,19061,21,22,1,3,43,193
61897,61897,690140AF4FCA682B3C0DF7937D63BB48,12221,2,7,5,43,44,2194
61898,61898,690140AF4FCA682B3C0DF7937D63BB48,12561,8,16,8,45,43,2293
61899,61899,690140AF4FCA682B3C0DF7937D63BB48,10381,21,23,2,31,49,1599
61903,61903,D7D05175178ECCC354BF6E061771BD76,42511,0,1,1,37,47,1897
61904,61904,D7D05175178ECCC354BF6E061771BD76,11491,2,6,4,36,47,1847
61905,61905,D7D05175178ECCC354BF6E061771BD76,19441,8,12,4,8,46,446
61906,61906,D7D05175178ECCC354BF6E061771BD76,11731,12,13,1,36,48,1848
61907,61907,D7D05175178ECCC354BF6E061771BD76,42511,17,20,3,37,47,1897
61908,61908,D7D05175178ECCC354BF6E061771BD76,11491,21,22,1,36,47,1847
61909,61909,52A195A8FE89EC70D1A1F00BB9B30229,12641,2,4,2,10,43,543
61910,61910,52A195A8FE89EC70D1A1F00BB9B30229,43021,5,7,2,16,43,843
61911,61911,52A195A8FE89EC70D1A1F00BB9B30229,12921,7,9,2,9,41,491
61912,61912,52A195A8FE89EC70D1A1F00BB9B30229,12641,12,22,10,10,43,543
61916,61916,2163009C55B05ECD83E44729736749E5,13511,8,11,3,34,48,1748
61917,61917,2163009C55B05ECD83E44729736749E5,12491,14,16,2,36,43,1843
61918,61918,2163009C55B05ECD83E44729736749E5,12521,18,19,1,35,41,1791
61919,61919,AA541C733BB5F99408992FE5EC11F72D,13231,1,3,2,39,46,1996
61920,61920,AA541C733BB5F99408992FE5EC11F72D,11261,7,17,10,36,46,1846
61921,61921,AA541C733BB5F99408992FE5EC11F72D,10751,19,21,2,47,43,2393
61931,61931,14909CB01CC7902DACA46E64F89B4A03,42864,6,11,5,38,44,1944
61932,61932,14909CB01CC7902DACA46E64F89B4A03,42321,13,15,2,43,47,2197
61933,61933,14909CB01CC7902DACA46E64F89B4A03,43621,15,16,1,46,48,2348
61934,61934,14909CB01CC7902DACA46E64F89B4A03,11701,19,21,2,43,48,2198
61935,61935,14909CB01CC7902DACA46E64F89B4A03,42601,21,23,2,44,48,2248
61946,61946,E8C2391DA6D45D7659D6871A0F1C6C82,11834,0,6,6,32,45,1645
61947,61947,E8C2391DA6D45D7659D6871A0F1C6C82,42531,10,12,2,31,45,1595
61948,61948,E8C2391DA6D45D7659D6871A0F1C6C82,11834,13,15,2,32,45,1645
61949,61949,E8C2391DA6D45D7659D6871A0F1C6C82,13671,19,22,3,27,43,1393
61950,61950,753369D691B504B9F7186B2CDF290F06,12792,0,3,3,34,30,1730
61951,61951,753369D691B504B9F7186B2CDF290F06,15391,4,12,8,35,26,1776
61952,61952,753369D691B504B9F7186B2CDF290F06,12791,13,14,1,31,29,1579
61953,61953,753369D691B504B9F7186B2CDF290F06,15391,14,15,1,35,26,1776
61954,61954,753369D691B504B9F7186B2CDF290F06,12792,16,21,5,34,30,1730
61955,61955,753369D691B504B9F7186B2CDF290F06,15391,21,23,2,35,26,1776
61965,61965,5AB06890D1F02153F5E7416054C280D9,43581,0,6,6,33,48,1698
61966,61966,5AB06890D1F02153F5E7416054C280D9,11861,7,8,1,32,47,1647
61967,61967,5AB06890D1F02153F5E7416054C280D9,42941,12,18,6,37,47,1897
61968,61968,4E44BBC9D86CBF4CC3EC68EEA6825DB2,12601,1,6,5,25,47,1297
61969,61969,4E44BBC9D86CBF4CC3EC68EEA6825DB2,42481,9,10,1,22,49,1149
61970,61970,4E44BBC9D86CBF4CC3EC68EEA6825DB2,12601,12,22,10,25,47,1297
61971,61971,2A1AE84DE5705835B4F61B530EFF374F,10107,1,2,1,38,49,1949
61972,61972,2A1AE84DE5705835B4F61B530EFF374F,11231,2,8,6,37,49,1899
61973,61973,2A1AE84DE5705835B4F61B530EFF374F,10731,9,13,4,33,47,1697
61974,61974,2A1AE84DE5705835B4F61B530EFF374F,11231,14,23,9,37,49,1899
61975,61975,C4D6D6893D15A40EF6C21B7CBC7CED3E,11861,4,8,4,32,47,1647
61976,61976,C4D6D6893D15A40EF6C21B7CBC7CED3E,11541,8,17,9,35,49,1799
61977,61977,C4D6D6893D15A40EF6C21B7CBC7CED3E,11861,19,23,4,32,47,1647
61978,61978,8AB561279CAFD673B81CFFF6F25401C3,13951,0,3,3,47,45,2395
61979,61979,8AB561279CAFD673B81CFFF6F25401C3,12221,6,9,3,43,44,2194
61980,61980,8AB561279CAFD673B81CFFF6F25401C3,12561,12,16,4,45,43,2293
61981,61981,8AB561279CAFD673B81CFFF6F25401C3,43011,17,19,2,40,42,2042
61982,61982,8AB561279CAFD673B81CFFF6F25401C3,12221,20,21,1,43,44,2194
61983,61983,5C25F12177E8E0F22AC67E80B322EA31,13221,0,1,1,40,47,2047
61984,61984,5C25F12177E8E0F22AC67E80B322EA31,11074,1,2,1,37,47,1897
61985,61985,5C25F12177E8E0F22AC67E80B322EA31,11331,3,6,3,37,48,1898
61986,61986,5C25F12177E8E0F22AC67E80B322EA31,11074,6,7,1,37,47,1897
61987,61987,5C25F12177E8E0F22AC67E80B322EA31,11914,8,22,14,37,48,1898
61991,61991,47C9331DF9F5BB2618B229E8F7345D02,11491,0,6,6,36,47,1847
61992,61992,47C9331DF9F5BB2618B229E8F7345D02,43751,7,9,2,19,48,998
61993,61993,47C9331DF9F5BB2618B229E8F7345D02,12581,11,12,1,24,48,1248
61994,61994,47C9331DF9F5BB2618B229E8F7345D02,43751,12,13,1,19,48,998
61995,61995,47C9331DF9F5BB2618B229E8F7345D02,11491,19,21,2,36,47,1847
61996,61996,47C9331DF9F5BB2618B229E8F7345D02,42781,22,23,1,36,46,1846
61997,61997,14032B8270EF22C1D4A35716559793F7,42341,0,6,6,43,49,2199
61998,61998,14032B8270EF22C1D4A35716559793F7,11381,8,9,1,30,47,1547
61999,61999,14032B8270EF22C1D4A35716559793F7,42131,13,15,2,44,48,2248
62000,62000,14032B8270EF22C1D4A35716559793F7,11531,20,21,1,34,49,1749
62001,62001,14032B8270EF22C1D4A35716559793F7,42341,22,23,1,43,49,2199
62014,62014,1B550A18B0397F926248F9A2C7B0A9DE,42341,0,8,8,43,49,2199
62015,62015,1B550A18B0397F926248F9A2C7B0A9DE,11201,12,13,1,35,49,1799
62016,62016,1B550A18B0397F926248F9A2C7B0A9DE,10901,18,19,1,35,48,1798
62017,62017,1B550A18B0397F926248F9A2C7B0A9DE,42341,21,23,2,43,49,2199
62018,62018,4487C805393F33B74D5C555A744300BD,42521,0,8,8,31,47,1597
62019,62019,4487C805393F33B74D5C555A744300BD,43761,10,13,3,32,47,1647
62020,62020,4487C805393F33B74D5C555A744300BD,42521,16,17,1,31,47,1597
62021,62021,4487C805393F33B74D5C555A744300BD,11201,19,21,2,35,49,1799
62028,62028,5AF7A250F769DD424B6F153B49B360AA,10901,0,7,7,35,48,1798
62029,62029,5AF7A250F769DD424B6F153B49B360AA,12601,11,15,4,25,47,1297
62030,62030,5AF7A250F769DD424B6F153B49B360AA,10901,17,23,6,35,48,1798
62031,62031,D6007C9E9048B796D7C0F12FA27C4B16,11231,0,2,2,37,49,1899
62032,62032,D6007C9E9048B796D7C0F12FA27C4B16,10511,3,17,14,35,46,1796
62033,62033,D6007C9E9048B796D7C0F12FA27C4B16,42271,22,23,1,40,47,2047
62034,62034,476CF509528DDA8C3E341A679B945B9E,42021,3,11,8,33,47,1697
62035,62035,476CF509528DDA8C3E341A679B945B9E,43731,15,17,2,34,47,1747
62036,62036,476CF509528DDA8C3E341A679B945B9E,42291,21,22,1,29,48,1498
62037,62037,34FB5BF239A7B5016E3CA81F47968839,40961,0,1,1,35,47,1797
62038,62038,34FB5BF239A7B5016E3CA81F47968839,42161,5,7,2,36,47,1847
62039,62039,34FB5BF239A7B5016E3CA81F47968839,40961,8,11,3,35,47,1797
62040,62040,34FB5BF239A7B5016E3CA81F47968839,42161,11,12,1,36,47,1847
62041,62041,34FB5BF239A7B5016E3CA81F47968839,43161,14,15,1,35,47,1797
62042,62042,34FB5BF239A7B5016E3CA81F47968839,42161,17,18,1,36,47,1847
62043,62043,34FB5BF239A7B5016E3CA81F47968839,40961,20,22,2,35,47,1797
62044,62044,CC115E075627F49AC17F5D9D869D1EC5,42041,1,2,1,10,47,547
62045,62045,CC115E075627F49AC17F5D9D869D1EC5,19441,7,8,1,8,46,446
62046,62046,CC115E075627F49AC17F5D9D869D1EC5,42041,8,10,2,10,47,547
62047,62047,CC115E075627F49AC17F5D9D869D1EC5,19021,12,13,1,10,45,545
62048,62048,CC115E075627F49AC17F5D9D869D1EC5,19441,13,14,1,8,46,446
62049,62049,CC115E075627F49AC17F5D9D869D1EC5,42041,17,19,2,10,47,547
62050,62050,CC115E075627F49AC17F5D9D869D1EC5,19441,21,22,1,8,46,446
62051,62051,C50F95F31F14C0EC9A55706C3B181C1C,15391,0,3,3,35,26,1776
62052,62052,C50F95F31F14C0EC9A55706C3B181C1C,12792,3,5,2,34,30,1730
62053,62053,C50F95F31F14C0EC9A55706C3B181C1C,15391,6,18,12,35,26,1776
62054,62054,C50F95F31F14C0EC9A55706C3B181C1C,12792,19,21,2,34,30,1730
62055,62055,C50F95F31F14C0EC9A55706C3B181C1C,15391,21,23,2,35,26,1776
62056,62056,401DBF9291C70DB6E3FE8385830F996E,13791,0,7,7,42,47,2147
62057,62057,401DBF9291C70DB6E3FE8385830F996E,10221,8,9,1,34,49,1749
62058,62058,401DBF9291C70DB6E3FE8385830F996E,11021,12,14,2,36,49,1849
62059,62059,401DBF9291C70DB6E3FE8385830F996E,10221,15,18,3,34,49,1749
62060,62060,401DBF9291C70DB6E3FE8385830F996E,11021,18,19,1,36,49,1849
62061,62061,401DBF9291C70DB6E3FE8385830F996E,10811,20,22,2,38,46,1946
62073,62073,C2B723F362390D4A27A61E65DADBF331,42623,10,12,2,22,49,1149
62074,62074,C2B723F362390D4A27A61E65DADBF331,40341,12,14,2,23,49,1199
62075,62075,C2B723F362390D4A27A61E65DADBF331,11631,15,20,5,12,49,649
62076,62076,AF85AB0F84B58F4A12483525349C1572,43121,0,6,6,25,27,1277
62077,62077,AF85AB0F84B58F4A12483525349C1572,15191,8,9,1,36,27,1827
62078,62078,AF85AB0F84B58F4A12483525349C1572,43121,11,22,11,25,27,1277
62093,62093,2FCC231DE348255A3F9CDA8D77EEA7DC,12581,0,6,6,24,48,1248
62094,62094,2FCC231DE348255A3F9CDA8D77EEA7DC,12051,6,8,2,20,47,1047
62095,62095,2FCC231DE348255A3F9CDA8D77EEA7DC,42691,11,12,1,24,48,1248
62096,62096,2FCC231DE348255A3F9CDA8D77EEA7DC,12051,12,15,3,20,47,1047
62097,62097,2FCC231DE348255A3F9CDA8D77EEA7DC,12581,16,20,4,24,48,1248
62098,62098,F8584A5277683398A2423E9367C858A2,40833,0,7,7,41,47,2097
62099,62099,F8584A5277683398A2423E9367C858A2,19744,9,13,4,6,43,343
62100,62100,F8584A5277683398A2423E9367C858A2,40341,16,20,4,23,49,1199
62101,62101,F8584A5277683398A2423E9367C858A2,40833,21,23,2,41,47,2097
62102,62102,966F90A28BBEBC18CE42E2502F1941FB,43501,0,12,12,27,48,1398
62103,62103,966F90A28BBEBC18CE42E2502F1941FB,12311,16,18,2,30,44,1544
62104,62104,966F90A28BBEBC18CE42E2502F1941FB,42511,19,20,1,37,47,1897
62114,62114,1788FF83230593384DFEF88881720D90,13551,0,7,7,45,38,2288
62115,62115,1788FF83230593384DFEF88881720D90,43101,8,12,4,46,40,2340
62116,62116,1788FF83230593384DFEF88881720D90,13551,13,14,1,45,38,2288
62117,62117,1788FF83230593384DFEF88881720D90,43101,20,21,1,46,40,2340
62118,62118,1788FF83230593384DFEF88881720D90,13551,21,23,2,45,38,2288
62119,62119,F7F6E311089E545E2ADE21E1CFF4D206,13511,0,1,1,34,48,1748
62120,62120,F7F6E311089E545E2ADE21E1CFF4D206,10841,1,2,1,37,47,1897
62121,62121,F7F6E311089E545E2ADE21E1CFF4D206,13601,3,8,5,34,47,1747
62122,62122,F7F6E311089E545E2ADE21E1CFF4D206,43761,16,18,2,32,47,1647
62123,62123,F7F6E311089E545E2ADE21E1CFF4D206,40636,20,23,3,35,48,1798
62124,62124,4B018D7292C604437EE4662682408A7D,42271,7,9,2,40,47,2047
62125,62125,4B018D7292C604437EE4662682408A7D,10151,10,11,1,34,47,1747
62126,62126,4B018D7292C604437EE4662682408A7D,42271,13,14,1,40,47,2047
62127,62127,4B018D7292C604437EE4662682408A7D,11806,19,20,1,41,48,2098
62128,62128,4B018D7292C604437EE4662682408A7D,42271,20,23,3,40,47,2047
62136,62136,48D09EA1E123F030FD71CF37426D4799,43011,1,8,7,40,42,2042
62137,62137,48D09EA1E123F030FD71CF37426D4799,42151,8,14,6,35,45,1795
62138,62138,48D09EA1E123F030FD71CF37426D4799,43011,18,19,1,40,42,2042
62139,62139,089202C74F7A5B708A3906BDD594D636,12601,0,1,1,25,47,1297
62140,62140,089202C74F7A5B708A3906BDD594D636,10351,2,8,6,28,45,1445
62141,62141,089202C74F7A5B708A3906BDD594D636,10634,8,11,3,27,45,1395
62142,62142,089202C74F7A5B708A3906BDD594D636,12121,15,16,1,29,47,1497
62143,62143,089202C74F7A5B708A3906BDD594D636,10351,19,20,1,28,45,1445
62144,62144,089202C74F7A5B708A3906BDD594D636,12601,21,23,2,25,47,1297
62145,62145,3E351ABACF5670F218BE0092A1FF748D,40343,0,7,7,24,49,1249
62146,62146,3E351ABACF5670F218BE0092A1FF748D,43761,8,16,8,32,47,1647
62147,62147,3E351ABACF5670F218BE0092A1FF748D,12581,18,21,3,24,48,1248
62148,62148,3E351ABACF5670F218BE0092A1FF748D,40343,21,23,2,24,49,1249
62149,62149,F5449661B4478E818EBFB16B1D5C019C,10431,0,7,7,33,49,1699
62150,62150,F5449661B4478E818EBFB16B1D5C019C,43581,10,11,1,33,48,1698
62151,62151,F5449661B4478E818EBFB16B1D5C019C,10411,15,16,1,36,48,1848
62152,62152,F5449661B4478E818EBFB16B1D5C019C,43581,19,20,1,33,48,1698
62153,62153,F5449661B4478E818EBFB16B1D5C019C,10411,21,23,2,36,48,1848
62164,62164,83860062E98E3B94DE72D3355E2FAF42,12661,2,6,4,32,45,1645
62165,62165,83860062E98E3B94DE72D3355E2FAF42,42151,9,18,9,35,45,1795
62166,62166,83860062E98E3B94DE72D3355E2FAF42,11151,20,23,3,30,48,1548
62167,62167,DB5F58C0BF92D33E406DDC1B3C9B82ED,10161,0,5,5,35,49,1799
62168,62168,DB5F58C0BF92D33E406DDC1B3C9B82ED,10716,7,17,10,30,46,1546
62169,62169,DB5F58C0BF92D33E406DDC1B3C9B82ED,10161,22,23,1,35,49,1799
62174,62174,5BBCD63F1FDBD49661B51EE642BD2472,12381,0,13,13,32,48,1648
62175,62175,5BBCD63F1FDBD49661B51EE642BD2472,12871,15,16,1,22,33,1133
62176,62176,5BBCD63F1FDBD49661B51EE642BD2472,10221,18,19,1,34,49,1749
62177,62177,3AEA3CF422288C2FFB9C65FD7BE694C9,19931,0,2,2,7,43,393
62178,62178,3AEA3CF422288C2FFB9C65FD7BE694C9,12921,4,6,2,9,41,491
62179,62179,3AEA3CF422288C2FFB9C65FD7BE694C9,19931,6,12,6,7,43,393
62180,62180,3AEA3CF422288C2FFB9C65FD7BE694C9,12921,12,13,1,9,41,491
62181,62181,3AEA3CF422288C2FFB9C65FD7BE694C9,19931,14,21,7,7,43,393
62182,62182,92F5B93973A04B573399FD0C4ED135D6,13381,0,1,1,39,47,1997
62183,62183,92F5B93973A04B573399FD0C4ED135D6,11541,2,13,11,35,49,1799
62184,62184,92F5B93973A04B573399FD0C4ED135D6,42301,15,16,1,36,47,1847
62185,62185,92F5B93973A04B573399FD0C4ED135D6,13271,18,22,4,41,47,2097
62186,62186,918239D4EE1CD24F89734D8227B4B571,42161,0,13,13,36,47,1847
62187,62187,918239D4EE1CD24F89734D8227B4B571,13371,13,17,4,41,47,2097
62188,62188,918239D4EE1CD24F89734D8227B4B571,42161,19,23,4,36,47,1847
62189,62189,3717F18D88C40095DBADE8C95C390E6F,42861,1,3,2,37,44,1894
62190,62190,3717F18D88C40095DBADE8C95C390E6F,42151,3,11,8,35,45,1795
62191,62191,3717F18D88C40095DBADE8C95C390E6F,42861,12,16,4,37,44,1894
62192,62192,3717F18D88C40095DBADE8C95C390E6F,42151,17,19,2,35,45,1795
62193,62193,3717F18D88C40095DBADE8C95C390E6F,42861,19,21,2,37,44,1894
62198,62198,B09144E053E0EC9288D632948891CAF2,13911,1,4,3,39,46,1996
62199,62199,B09144E053E0EC9288D632948891CAF2,11261,6,8,2,36,46,1846
62200,62200,B09144E053E0EC9288D632948891CAF2,13911,12,15,3,39,46,1996
62201,62201,B09144E053E0EC9288D632948891CAF2,11261,16,18,2,36,46,1846
62202,62202,B09144E053E0EC9288D632948891CAF2,13911,21,23,2,39,46,1996
62203,62203,4B51883F8D3BDAE9528DE7CF8D0F3245,13601,0,7,7,34,47,1747
62204,62204,4B51883F8D3BDAE9528DE7CF8D0F3245,42021,9,12,3,33,47,1697
62205,62205,4B51883F8D3BDAE9528DE7CF8D0F3245,13601,15,16,1,34,47,1747
62206,62206,4B51883F8D3BDAE9528DE7CF8D0F3245,42021,16,19,3,33,47,1697
62207,62207,4B51883F8D3BDAE9528DE7CF8D0F3245,12381,20,23,3,32,48,1648
62208,62208,1678CB8E12733A7CC4242255823809E8,11271,0,2,2,37,48,1898
62209,62209,1678CB8E12733A7CC4242255823809E8,42071,4,7,3,31,49,1599
62210,62210,1678CB8E12733A7CC4242255823809E8,43391,7,12,5,29,48,1498
62211,62211,1678CB8E12733A7CC4242255823809E8,42071,15,19,4,31,49,1599
62212,62212,1D9B3BEAA73444A543D0673D1FBABCFF,42161,0,8,8,36,47,1847
62213,62213,1D9B3BEAA73444A543D0673D1FBABCFF,42511,9,10,1,37,47,1897
62214,62214,1D9B3BEAA73444A543D0673D1FBABCFF,42771,12,13,1,36,47,1847
62215,62215,1D9B3BEAA73444A543D0673D1FBABCFF,42511,14,17,3,37,47,1897
62216,62216,1D9B3BEAA73444A543D0673D1FBABCFF,42161,18,23,5,36,47,1847
62220,62220,AAC98D8EB5664A9B5DE56F266CB31991,15143,0,1,1,18,7,907
62221,62221,AAC98D8EB5664A9B5DE56F266CB31991,16281,3,11,8,11,4,554
62222,62222,AAC98D8EB5664A9B5DE56F266CB31991,15143,12,20,8,18,7,907
62223,62223,4BEB96C1A6F8B99181CDADEF48D75275,42501,0,5,5,28,47,1447
62224,62224,4BEB96C1A6F8B99181CDADEF48D75275,40343,9,17,8,24,49,1249
62225,62225,4BEB96C1A6F8B99181CDADEF48D75275,42501,19,23,4,28,47,1447
62229,62229,A53DAA006542212C0F792E33874BF547,43151,1,9,8,40,49,2049
62230,62230,A53DAA006542212C0F792E33874BF547,42161,11,13,2,36,47,1847
62231,62231,A53DAA006542212C0F792E33874BF547,10971,16,20,4,35,47,1797
62232,62232,57C2F199AE9E417CECF7AB9838D8B317,42523,8,9,1,31,47,1597
62233,62233,57C2F199AE9E417CECF7AB9838D8B317,42491,11,15,4,32,46,1646
62234,62234,57C2F199AE9E417CECF7AB9838D8B317,42583,16,20,4,40,48,2048
62235,62235,57C2F199AE9E417CECF7AB9838D8B317,12131,22,23,1,32,47,1647
62236,62236,D75839547F19BC6AA2555211CD306BBE,12514,0,5,5,38,47,1947
62237,62237,D75839547F19BC6AA2555211CD306BBE,11481,7,9,2,41,48,2098
62238,62238,D75839547F19BC6AA2555211CD306BBE,43161,10,12,2,35,47,1797
62239,62239,D75839547F19BC6AA2555211CD306BBE,43061,17,18,1,43,46,2196
62240,62240,D75839547F19BC6AA2555211CD306BBE,12514,20,23,3,38,47,1947
62241,62241,05F5E1C40665B68C77ECAABF0F951B28,13511,0,5,5,34,48,1748
62242,62242,05F5E1C40665B68C77ECAABF0F951B28,11231,6,9,3,37,49,1899
62243,62243,05F5E1C40665B68C77ECAABF0F951B28,11021,9,12,3,36,49,1849
62244,62244,05F5E1C40665B68C77ECAABF0F951B28,11751,13,15,2,35,48,1798
62245,62245,05F5E1C40665B68C77ECAABF0F951B28,11021,15,18,3,36,49,1849
62246,62246,05F5E1C40665B68C77ECAABF0F951B28,10661,19,21,2,37,49,1899
62247,62247,46624C7A7A05E81084BABC40FE8F937C,13314,0,7,7,31,39,1589
62248,62248,46624C7A7A05E81084BABC40FE8F937C,12521,8,9,1,35,41,1791
62249,62249,46624C7A7A05E81084BABC40FE8F937C,13314,10,12,2,31,39,1589
62250,62250,46624C7A7A05E81084BABC40FE8F937C,12521,12,13,1,35,41,1791
62251,62251,46624C7A7A05E81084BABC40FE8F937C,13314,14,23,9,31,39,1589
62258,62258,9918FEABB0433C4402810CC88ACF5496,12311,0,14,14,30,44,1544
62259,62259,9918FEABB0433C4402810CC88ACF5496,12521,16,18,2,35,41,1791
62260,62260,9918FEABB0433C4402810CC88ACF5496,12311,20,22,2,30,44,1544
62261,62261,3B5439A9FD7060E7BC8644A0232D8663,10921,1,2,1,43,48,2198
62262,62262,3B5439A9FD7060E7BC8644A0232D8663,11011,3,11,8,39,49,1999
62263,62263,3B5439A9FD7060E7BC8644A0232D8663,11231,11,13,2,37,49,1899
62264,62264,3B5439A9FD7060E7BC8644A0232D8663,11701,22,23,1,43,48,2198
62265,62265,3683BCD5E2A83D301E5101A2DD111033,10107,0,18,18,38,49,1949
62266,62266,3683BCD5E2A83D301E5101A2DD111033,11541,19,21,2,35,49,1799
62267,62267,3683BCD5E2A83D301E5101A2DD111033,13731,21,22,1,33,49,1699
62271,62271,1E162D4B916E078AFCF92F80CFB320B3,40833,9,10,1,41,47,2097
62272,62272,1E162D4B916E078AFCF92F80CFB320B3,11201,11,13,2,35,49,1799
62273,62273,1E162D4B916E078AFCF92F80CFB320B3,13101,17,19,2,40,47,2047
62274,62274,7061033AE3231BB99A9FC726045EEAFB,42623,1,2,1,22,49,1149
62275,62275,7061033AE3231BB99A9FC726045EEAFB,42071,5,7,2,31,49,1599
62276,62276,7061033AE3231BB99A9FC726045EEAFB,42081,12,13,1,24,49,1249
62277,62277,7061033AE3231BB99A9FC726045EEAFB,42071,15,23,8,31,49,1599
62285,62285,5262ABE790766FD3345CF84BDACCA78B,43391,0,2,2,29,48,1498
62286,62286,5262ABE790766FD3345CF84BDACCA78B,10681,2,3,1,30,48,1548
62287,62287,5262ABE790766FD3345CF84BDACCA78B,11061,3,18,15,29,48,1498
62288,62288,5262ABE790766FD3345CF84BDACCA78B,10221,19,20,1,34,49,1749
62289,62289,5262ABE790766FD3345CF84BDACCA78B,43581,21,22,1,33,48,1698
62290,62290,181802B57A29F4FAE1E7EF60B334A9D5,13911,2,3,1,39,46,1996
62291,62291,181802B57A29F4FAE1E7EF60B334A9D5,11261,7,8,1,36,46,1846
62292,62292,181802B57A29F4FAE1E7EF60B334A9D5,13911,11,14,3,39,46,1996
62293,62293,181802B57A29F4FAE1E7EF60B334A9D5,11261,14,16,2,36,46,1846
62294,62294,181802B57A29F4FAE1E7EF60B334A9D5,13911,18,20,2,39,46,1996
62295,62295,181802B57A29F4FAE1E7EF60B334A9D5,42231,20,21,1,37,46,1896
62306,62306,63AAB4E2754CD06C7A024CF5DB6B083C,11951,0,7,7,31,49,1599
62307,62307,63AAB4E2754CD06C7A024CF5DB6B083C,11914,8,16,8,37,48,1898
62308,62308,63AAB4E2754CD06C7A024CF5DB6B083C,42071,19,23,4,31,49,1599
62309,62309,BF3354E7653978B437BDBF5412A04932,12871,2,8,6,22,33,1133
62310,62310,BF3354E7653978B437BDBF5412A04932,42491,12,13,1,32,46,1646
62311,62311,BF3354E7653978B437BDBF5412A04932,10781,16,17,1,35,47,1797
62312,62312,BF3354E7653978B437BDBF5412A04932,10221,19,23,4,34,49,1749
62317,62317,DFB39D9C16979A7A210D773BBB4B6305,42351,0,7,7,38,45,1945
62318,62318,DFB39D9C16979A7A210D773BBB4B6305,11261,9,11,2,36,46,1846
62319,62319,DFB39D9C16979A7A210D773BBB4B6305,42351,11,13,2,38,45,1945
62320,62320,DFB39D9C16979A7A210D773BBB4B6305,11261,13,14,1,36,46,1846
62321,62321,DFB39D9C16979A7A210D773BBB4B6305,42351,15,23,8,38,45,1945
62330,62330,DB3C92167D7C02EAB46060E4569D1D1B,12651,0,7,7,43,47,2197
62331,62331,DB3C92167D7C02EAB46060E4569D1D1B,11231,10,12,2,37,49,1899
62332,62332,DB3C92167D7C02EAB46060E4569D1D1B,10901,12,13,1,35,48,1798
62333,62333,DB3C92167D7C02EAB46060E4569D1D1B,10121,14,15,1,36,49,1849
62334,62334,DB3C92167D7C02EAB46060E4569D1D1B,13371,20,21,1,41,47,2097
62335,62335,193603340935DA55C70322807542A372,19111,0,6,6,9,45,495
62336,62336,193603340935DA55C70322807542A372,12921,9,11,2,9,41,491
62337,62337,193603340935DA55C70322807542A372,19261,16,17,1,6,37,337
62338,62338,193603340935DA55C70322807542A372,11351,18,19,1,36,48,1848
62339,62339,193603340935DA55C70322807542A372,12514,21,23,2,38,47,1947
62340,62340,0BC2807A95147EDBE8FE5310BDE7E404,12641,4,14,10,10,43,543
62341,62341,0BC2807A95147EDBE8FE5310BDE7E404,43021,14,16,2,16,43,843
62342,62342,0BC2807A95147EDBE8FE5310BDE7E404,12921,18,20,2,9,41,491
62346,62346,3AE9C3B6C0E6A8AA6B3B6C58033F1358,13941,0,7,7,41,47,2097
62347,62347,3AE9C3B6C0E6A8AA6B3B6C58033F1358,42981,7,18,11,36,49,1849
62348,62348,3AE9C3B6C0E6A8AA6B3B6C58033F1358,13941,20,22,2,41,47,2097
62355,62355,C2DF457F1D0C11A80CBA147D424E3E70,11871,0,7,7,29,46,1496
62356,62356,C2DF457F1D0C11A80CBA147D424E3E70,12311,7,8,1,30,44,1544
62357,62357,C2DF457F1D0C11A80CBA147D424E3E70,10281,10,13,3,33,48,1698
62358,62358,C2DF457F1D0C11A80CBA147D424E3E70,11861,13,15,2,32,47,1647
62359,62359,C2DF457F1D0C11A80CBA147D424E3E70,11871,18,23,5,29,46,1496
62360,62360,44EC2B0D5EE5BD6B35ABC292F1B0BE4A,12641,1,2,1,10,43,543
62361,62361,44EC2B0D5EE5BD6B35ABC292F1B0BE4A,12921,4,6,2,9,41,491
62362,62362,44EC2B0D5EE5BD6B35ABC292F1B0BE4A,49201,7,8,1,7,41,391
62363,62363,44EC2B0D5EE5BD6B35ABC292F1B0BE4A,11381,13,16,3,30,47,1547
62364,62364,44EC2B0D5EE5BD6B35ABC292F1B0BE4A,19114,17,23,6,7,43,393
62365,62365,D14484DB6515E86DA2EC37443AB9F264,12211,0,7,7,41,44,2094
62366,62366,D14484DB6515E86DA2EC37443AB9F264,11261,12,14,2,36,46,1846
62367,62367,D14484DB6515E86DA2EC37443AB9F264,42231,18,20,2,37,46,1896
62368,62368,D14484DB6515E86DA2EC37443AB9F264,12211,22,23,1,41,44,2094
62373,62373,64A2E9501F429B6DEC66E8EE627CCABA,10341,0,1,1,31,47,1597
62374,62374,64A2E9501F429B6DEC66E8EE627CCABA,10681,1,6,5,30,48,1548
62375,62375,64A2E9501F429B6DEC66E8EE627CCABA,10301,10,18,8,31,45,1595
62376,62376,64A2E9501F429B6DEC66E8EE627CCABA,13561,22,23,1,37,49,1899
62380,62380,91C845F33B01C4DA71C1A0D3DEBCFC93,12514,0,9,9,38,47,1947
62381,62381,91C845F33B01C4DA71C1A0D3DEBCFC93,10591,10,11,1,39,48,1998
62382,62382,91C845F33B01C4DA71C1A0D3DEBCFC93,11271,12,14,2,37,48,1898
62383,62383,91C845F33B01C4DA71C1A0D3DEBCFC93,12514,14,17,3,38,47,1947
62384,62384,91C845F33B01C4DA71C1A0D3DEBCFC93,11811,19,20,1,38,49,1949
62385,62385,C2A50BE7B064AAEC27D9E1859F234BD0,40051,0,9,9,32,49,1649
62386,62386,C2A50BE7B064AAEC27D9E1859F234BD0,10221,10,12,2,34,49,1749
62387,62387,C2A50BE7B064AAEC27D9E1859F234BD0,13481,14,18,4,26,31,1331
62392,62392,B4D705B6FACBCC009AB169FE5F38F21F,42491,0,6,6,32,46,1646
62393,62393,B4D705B6FACBCC009AB169FE5F38F21F,42041,9,12,3,10,47,547
62394,62394,B4D705B6FACBCC009AB169FE5F38F21F,19024,17,19,2,9,45,495
62395,62395,2C3A1C890B30FB06A95DD4A9EF742265,19801,0,7,7,19,26,976
62396,62396,2C3A1C890B30FB06A95DD4A9EF742265,43121,7,12,5,25,27,1277
62397,62397,2C3A1C890B30FB06A95DD4A9EF742265,19801,13,22,9,19,26,976
62398,62398,6B78BA76894FB2D58CB6C48FC3CBEEF5,13911,2,3,1,39,46,1996
62399,62399,6B78BA76894FB2D58CB6C48FC3CBEEF5,42351,4,5,1,38,45,1945
62400,62400,6B78BA76894FB2D58CB6C48FC3CBEEF5,13911,9,12,3,39,46,1996
62401,62401,6B78BA76894FB2D58CB6C48FC3CBEEF5,42231,13,14,1,37,46,1896
62402,62402,6B78BA76894FB2D58CB6C48FC3CBEEF5,13911,16,20,4,39,46,1996
62407,62407,29ED7585A7C0FD6B2E71E72A2B2372DE,12311,1,6,5,30,44,1544
62408,62408,29ED7585A7C0FD6B2E71E72A2B2372DE,11491,9,18,9,36,47,1847
62409,62409,29ED7585A7C0FD6B2E71E72A2B2372DE,42531,21,22,1,31,45,1595
62413,62413,DBE56CF804EFF98F06EBBF480586FC01,43021,0,5,5,16,43,843
62414,62414,DBE56CF804EFF98F06EBBF480586FC01,12921,6,8,2,9,41,491
62415,62415,DBE56CF804EFF98F06EBBF480586FC01,43021,10,11,1,16,43,843
62416,62416,DBE56CF804EFF98F06EBBF480586FC01,12921,14,18,4,9,41,491
62417,62417,283D32F18C3BA6BD8207C085157E283B,42151,1,3,2,35,45,1795
62418,62418,283D32F18C3BA6BD8207C085157E283B,12311,4,5,1,30,44,1544
62419,62419,283D32F18C3BA6BD8207C085157E283B,10301,8,20,12,31,45,1595
62420,62420,283D32F18C3BA6BD8207C085157E283B,12311,20,23,3,30,44,1544
62428,62428,EF3D743CCC57E603C7EAE8E058222BC4,43061,0,6,6,43,46,2196
62429,62429,EF3D743CCC57E603C7EAE8E058222BC4,11021,7,9,2,36,49,1849
62430,62430,EF3D743CCC57E603C7EAE8E058222BC4,11271,10,11,1,37,48,1898
62431,62431,EF3D743CCC57E603C7EAE8E058222BC4,42471,11,17,6,35,49,1799
62432,62432,EF3D743CCC57E603C7EAE8E058222BC4,13791,19,20,1,42,47,2147
62437,62437,1BABC9D2139583D8D5A8610AD83945FA,16281,1,7,6,11,4,554
62438,62438,1BABC9D2139583D8D5A8610AD83945FA,15051,11,15,4,19,4,954
62439,62439,1BABC9D2139583D8D5A8610AD83945FA,16281,18,19,1,11,4,554
62455,62455,86C177FE29427D11B9077C5F541A2B81,42583,0,7,7,40,48,2048
62456,62456,86C177FE29427D11B9077C5F541A2B81,11161,8,17,9,32,48,1648
62457,62457,86C177FE29427D11B9077C5F541A2B81,10191,18,19,1,40,48,2048
62458,62458,86C177FE29427D11B9077C5F541A2B81,42381,21,22,1,39,41,1991
62462,62462,E2204D6E32AC09E78AF98F20C9465FA5,10121,0,6,6,36,49,1849
62463,62463,E2204D6E32AC09E78AF98F20C9465FA5,12921,10,11,1,9,41,491
62464,62464,E2204D6E32AC09E78AF98F20C9465FA5,10121,12,23,11,36,49,1849
62469,62469,9A5D80901504211B25011A66A0C236FE,43731,1,12,11,34,47,1747
62470,62470,9A5D80901504211B25011A66A0C236FE,42161,12,14,2,36,47,1847
62471,62471,9A5D80901504211B25011A66A0C236FE,43731,15,16,1,34,47,1747
62472,62472,9A5D80901504211B25011A66A0C236FE,13311,19,21,2,27,39,1389
62473,62473,9A5D80901504211B25011A66A0C236FE,11281,22,23,1,27,40,1390
62477,62477,EC587A8D735A15FBFAB055D919B57FFC,43181,0,8,8,39,48,1998
62478,62478,EC587A8D735A15FBFAB055D919B57FFC,11531,12,14,2,34,49,1749
62479,62479,EC587A8D735A15FBFAB055D919B57FFC,10381,18,20,2,31,49,1599
62480,62480,EC587A8D735A15FBFAB055D919B57FFC,43181,22,23,1,39,48,1998
62481,62481,F3885988D9A2AA88D7FBE93D03B5F579,42021,1,2,1,33,47,1697
62482,62482,F3885988D9A2AA88D7FBE93D03B5F579,11861,3,4,1,32,47,1647
62483,62483,F3885988D9A2AA88D7FBE93D03B5F579,42021,5,6,1,33,47,1697
62484,62484,F3885988D9A2AA88D7FBE93D03B5F579,43761,7,8,1,32,47,1647
62485,62485,F3885988D9A2AA88D7FBE93D03B5F579,40611,10,23,13,35,47,1797
62486,62486,ECD2E451419916CC2E55F4C55D7D52A8,12601,1,9,8,25,47,1297
62487,62487,ECD2E451419916CC2E55F4C55D7D52A8,42501,12,15,3,28,47,1447
62488,62488,ECD2E451419916CC2E55F4C55D7D52A8,13651,16,17,1,30,47,1547
62489,62489,ECD2E451419916CC2E55F4C55D7D52A8,42521,20,23,3,31,47,1597
62493,62493,DDA8164E3F8BBB96A3E7142D04424F34,11061,0,10,10,29,48,1498
62494,62494,DDA8164E3F8BBB96A3E7142D04424F34,40341,12,15,3,23,49,1199
62495,62495,DDA8164E3F8BBB96A3E7142D04424F34,43391,16,23,7,29,48,1498
62500,62500,BB3DB8BDA13F245F7DA1B278DE6D4FF0,43021,1,5,4,16,43,843
62501,62501,BB3DB8BDA13F245F7DA1B278DE6D4FF0,12641,6,7,1,10,43,543
62502,62502,BB3DB8BDA13F245F7DA1B278DE6D4FF0,43021,10,19,9,16,43,843
62503,62503,3601FDEFB6D75DF133571064E56ECAF1,10711,0,8,8,29,46,1496
62504,62504,3601FDEFB6D75DF133571064E56ECAF1,43361,8,10,2,38,48,1948
62505,62505,3601FDEFB6D75DF133571064E56ECAF1,10711,14,18,4,29,46,1496
62506,62506,3601FDEFB6D75DF133571064E56ECAF1,11875,19,20,1,30,46,1546
62507,62507,3601FDEFB6D75DF133571064E56ECAF1,10711,21,23,2,29,46,1496
62511,62511,C2DB64B4DC1E02C55D842D394E30326F,42623,4,7,3,22,49,1149
62512,62512,C2DB64B4DC1E02C55D842D394E30326F,11061,12,14,2,29,48,1498
62513,62513,C2DB64B4DC1E02C55D842D394E30326F,42623,17,18,1,22,49,1149
62514,62514,C2DB64B4DC1E02C55D842D394E30326F,13511,19,21,2,34,48,1748
62515,62515,C2DB64B4DC1E02C55D842D394E30326F,42623,22,23,1,22,49,1149
62520,62520,07371D92249265FE55F9673D8539D18E,42301,0,18,18,36,47,1847
62521,62521,07371D92249265FE55F9673D8539D18E,40341,19,20,1,23,49,1199
62522,62522,07371D92249265FE55F9673D8539D18E,42301,20,22,2,36,47,1847
62526,62526,C415343168773013C92CA13C873C9F99,12311,1,5,4,30,44,1544
62527,62527,C415343168773013C92CA13C873C9F99,12881,9,11,2,47,22,2372
62528,62528,C415343168773013C92CA13C873C9F99,15441,11,14,3,44,20,2220
62529,62529,C415343168773013C92CA13C873C9F99,12881,15,17,2,47,22,2372
62530,62530,C415343168773013C92CA13C873C9F99,15441,17,18,1,44,20,2220
62531,62531,C415343168773013C92CA13C873C9F99,12881,18,19,1,47,22,2372
62532,62532,C415343168773013C92CA13C873C9F99,15441,20,23,3,44,20,2220
62533,62533,C9996C5C899C40302B05E33EEE511DC5,42501,0,8,8,28,47,1447
62534,62534,C9996C5C899C40302B05E33EEE511DC5,40171,10,17,7,38,48,1948
62535,62535,C9996C5C899C40302B05E33EEE511DC5,11061,18,20,2,29,48,1498
62536,62536,C9996C5C899C40302B05E33EEE511DC5,11231,21,23,2,37,49,1899
62549,62549,4668498322059FDBAD6E4D56B28B3D41,12141,1,4,3,42,45,2145
62550,62550,4668498322059FDBAD6E4D56B28B3D41,12211,8,17,9,41,44,2094
62551,62551,4668498322059FDBAD6E4D56B28B3D41,42461,19,20,1,45,47,2297
62555,62555,BE4CDA819284119F77858D547E5A076D,11561,8,14,6,32,49,1649
62556,62556,BE4CDA819284119F77858D547E5A076D,10154,15,16,1,33,47,1697
62557,62557,BE4CDA819284119F77858D547E5A076D,10111,18,22,4,37,47,1897
62558,62558,5529DD2214C36634346603006F6A0F3F,12521,0,13,13,35,41,1791
62559,62559,5529DD2214C36634346603006F6A0F3F,13314,14,15,1,31,39,1589
62560,62560,5529DD2214C36634346603006F6A0F3F,12521,19,23,4,35,41,1791
62565,62565,479BB88DD9C776BA69F274C628C53893,13121,0,5,5,38,46,1946
62566,62566,479BB88DD9C776BA69F274C628C53893,12514,8,10,2,38,47,1947
62567,62567,479BB88DD9C776BA69F274C628C53893,10271,12,16,4,37,46,1896
62568,62568,479BB88DD9C776BA69F274C628C53893,10331,19,21,2,39,46,1996
62569,62569,479BB88DD9C776BA69F274C628C53893,13121,21,23,2,38,46,1946
62570,62570,C1A86408F22C4A96CA9DED3C9439B426,10721,0,6,6,31,48,1598
62571,62571,C1A86408F22C4A96CA9DED3C9439B426,10621,9,18,9,41,49,2099
62572,62572,C1A86408F22C4A96CA9DED3C9439B426,10721,21,23,2,31,48,1598
62579,62579,CA7675D4504FF649E5D3C79C1D770D57,10901,0,6,6,35,48,1798
62580,62580,CA7675D4504FF649E5D3C79C1D770D57,10381,7,8,1,31,49,1599
62581,62581,CA7675D4504FF649E5D3C79C1D770D57,11151,10,15,5,30,48,1548
62582,62582,CA7675D4504FF649E5D3C79C1D770D57,10901,20,23,3,35,48,1798
62583,62583,96DFB74B6B273CA0FE92EAD5E311A259,42071,0,2,2,31,49,1599
62584,62584,96DFB74B6B273CA0FE92EAD5E311A259,11531,3,5,2,34,49,1749
62585,62585,96DFB74B6B273CA0FE92EAD5E311A259,11954,10,11,1,32,49,1649
62586,62586,96DFB74B6B273CA0FE92EAD5E311A259,13731,11,12,1,33,49,1699
62587,62587,96DFB74B6B273CA0FE92EAD5E311A259,42981,17,18,1,36,49,1849
62588,62588,FBFB039BFE202B4D733B8197A5DE9AA1,43751,0,6,6,19,48,998
62589,62589,FBFB039BFE202B4D733B8197A5DE9AA1,12581,9,18,9,24,48,1248
62590,62590,FBFB039BFE202B4D733B8197A5DE9AA1,43751,22,23,1,19,48,998
62591,62591,AE08A1E713DAA4F0C24DA0563595B4F9,19441,3,12,9,8,46,446
62592,62592,AE08A1E713DAA4F0C24DA0563595B4F9,11471,15,17,2,12,48,648
62593,62593,AE08A1E713DAA4F0C24DA0563595B4F9,19441,17,23,6,8,46,446
62598,62598,4DAFFFD77D4EF40D7D6643E51D6AB621,10161,0,10,10,35,49,1799
62599,62599,4DAFFFD77D4EF40D7D6643E51D6AB621,11481,11,13,2,41,48,2098
62600,62600,4DAFFFD77D4EF40D7D6643E51D6AB621,10161,19,22,3,35,49,1799
62604,62604,B330B6F87FA34F7466DC67C7BC5F8853,11921,0,6,6,38,48,1948
62605,62605,B330B6F87FA34F7466DC67C7BC5F8853,13651,10,11,1,30,47,1547
62606,62606,B330B6F87FA34F7466DC67C7BC5F8853,11954,12,15,3,32,49,1649
62607,62607,B330B6F87FA34F7466DC67C7BC5F8853,11921,17,20,3,38,48,1948
62622,62622,C5BE39F043AAB34786E4C31AB48CACA0,12051,0,15,15,20,47,1047
62623,62623,C5BE39F043AAB34786E4C31AB48CACA0,42691,18,20,2,24,48,1248
62624,62624,C5BE39F043AAB34786E4C31AB48CACA0,12051,22,23,1,20,47,1047
62631,62631,27B6DDFE3A356062F221ABD7AD70BB14,11061,0,6,6,29,48,1498
62632,62632,27B6DDFE3A356062F221ABD7AD70BB14,10681,8,9,1,30,48,1548
62633,62633,27B6DDFE3A356062F221ABD7AD70BB14,11061,11,13,2,29,48,1498
62634,62634,27B6DDFE3A356062F221ABD7AD70BB14,10681,15,16,1,30,48,1548
62635,62635,27B6DDFE3A356062F221ABD7AD70BB14,11061,19,23,4,29,48,1498
62636,62636,CE83884CFD17B5073DAD15A75E54F414,43451,0,2,2,37,40,1890
62637,62637,CE83884CFD17B5073DAD15A75E54F414,12521,6,15,9,35,41,1791
62638,62638,CE83884CFD17B5073DAD15A75E54F414,13041,15,17,2,30,37,1537
62639,62639,CE83884CFD17B5073DAD15A75E54F414,12521,17,22,5,35,41,1791
62643,62643,69E733DE4C2A7A294CFA07F4F32678A0,11771,0,2,2,39,49,1999
62644,62644,69E733DE4C2A7A294CFA07F4F32678A0,42231,3,19,16,37,46,1896
62645,62645,69E733DE4C2A7A294CFA07F4F32678A0,11791,20,22,2,38,49,1949
62650,62650,09EF5D314312C0A5BF78648C2E146E33,12141,0,2,2,42,45,2145
62651,62651,09EF5D314312C0A5BF78648C2E146E33,12221,4,6,2,43,44,2194
62652,62652,09EF5D314312C0A5BF78648C2E146E33,43011,6,18,12,40,42,2042
62653,62653,1E4ADDBFBD1C3EEA7DB4E1CBF005793C,11061,2,3,1,29,48,1498
62654,62654,1E4ADDBFBD1C3EEA7DB4E1CBF005793C,43971,6,7,1,30,48,1548
62655,62655,1E4ADDBFBD1C3EEA7DB4E1CBF005793C,11111,8,10,2,26,48,1348
62656,62656,1E4ADDBFBD1C3EEA7DB4E1CBF005793C,42521,11,18,7,31,47,1597
62657,62657,1E4ADDBFBD1C3EEA7DB4E1CBF005793C,11061,21,23,2,29,48,1498
62661,62661,40A3F567657A043546A2ED7A5DC91A85,12792,1,9,8,34,30,1730
62662,62662,40A3F567657A043546A2ED7A5DC91A85,15331,11,12,1,38,24,1924
62663,62663,40A3F567657A043546A2ED7A5DC91A85,15671,13,15,2,37,26,1876
62664,62664,40A3F567657A043546A2ED7A5DC91A85,12792,17,18,1,34,30,1730
62665,62665,40A3F567657A043546A2ED7A5DC91A85,15671,18,20,2,37,26,1876
62676,62676,D906556D477E065C32F65C1439E05D58,42791,0,6,6,35,45,1795
62677,62677,D906556D477E065C32F65C1439E05D58,42281,8,16,8,40,48,2048
62678,62678,D906556D477E065C32F65C1439E05D58,11261,20,21,1,36,46,1846
62679,62679,D906556D477E065C32F65C1439E05D58,42791,22,23,1,35,45,1795
62680,62680,37F1D2311F2383134D9A7BD374E33133,10501,5,7,2,22,46,1146
62681,62681,37F1D2311F2383134D9A7BD374E33133,11381,10,14,4,30,47,1547
62682,62682,37F1D2311F2383134D9A7BD374E33133,12051,15,23,8,20,47,1047
62683,62683,15903F2996F483F19DF9C809F94C3A96,12161,2,12,10,32,46,1646
62684,62684,15903F2996F483F19DF9C809F94C3A96,11381,14,17,3,30,47,1547
62685,62685,15903F2996F483F19DF9C809F94C3A96,10951,17,18,1,29,48,1498
62686,62686,9F589AB01E58B6B2CA9FB997F96CB7F3,13071,0,5,5,41,41,2091
62687,62687,9F589AB01E58B6B2CA9FB997F96CB7F3,43451,8,18,10,37,40,1890
62688,62688,9F589AB01E58B6B2CA9FB997F96CB7F3,13071,18,23,5,41,41,2091
62692,62692,79638A9B8D858113B3F3D1341F67F149,11231,0,2,2,37,49,1899
62693,62693,79638A9B8D858113B3F3D1341F67F149,42301,2,7,5,36,47,1847
62694,62694,79638A9B8D858113B3F3D1341F67F149,11081,9,11,2,35,46,1796
62695,62695,79638A9B8D858113B3F3D1341F67F149,11481,12,13,1,41,48,2098
62696,62696,79638A9B8D858113B3F3D1341F67F149,42401,14,16,2,36,47,1847
62697,62697,79638A9B8D858113B3F3D1341F67F149,42191,17,21,4,38,49,1949
62698,62698,03A63DF869370AF857C62BEAA12CB0D8,11571,0,7,7,13,46,696
62699,62699,03A63DF869370AF857C62BEAA12CB0D8,42521,7,10,3,31,47,1597
62700,62700,03A63DF869370AF857C62BEAA12CB0D8,40637,11,19,8,36,47,1847
62701,62701,03A63DF869370AF857C62BEAA12CB0D8,11571,21,23,2,13,46,696
62702,62702,4CEF2D9D71549E955305B2DC8309A78D,43021,1,2,1,16,43,843
62703,62703,4CEF2D9D71549E955305B2DC8309A78D,12731,2,3,1,22,40,1140
62704,62704,4CEF2D9D71549E955305B2DC8309A78D,43021,4,5,1,16,43,843
62705,62705,4CEF2D9D71549E955305B2DC8309A78D,12921,7,15,8,9,41,491
62706,62706,4CEF2D9D71549E955305B2DC8309A78D,12641,15,18,3,10,43,543
62707,62707,4CEF2D9D71549E955305B2DC8309A78D,12921,18,21,3,9,41,491
62708,62708,4CEF2D9D71549E955305B2DC8309A78D,43021,21,23,2,16,43,843
62713,62713,F312A9BDD6D19F2945BD4A135883EF0C,13771,2,9,7,21,45,1095
62714,62714,F312A9BDD6D19F2945BD4A135883EF0C,12601,11,19,8,25,47,1297
62715,62715,F312A9BDD6D19F2945BD4A135883EF0C,13771,20,23,3,21,45,1095
62723,62723,B3E65E9B8C8CAC02E61922EDB0A62E7D,41021,0,1,1,38,47,1947
62724,62724,B3E65E9B8C8CAC02E61922EDB0A62E7D,42511,6,9,3,37,47,1897
62725,62725,B3E65E9B8C8CAC02E61922EDB0A62E7D,13711,9,10,1,38,46,1946
62726,62726,B3E65E9B8C8CAC02E61922EDB0A62E7D,42511,11,13,2,37,47,1897
62727,62727,B3E65E9B8C8CAC02E61922EDB0A62E7D,13121,18,20,2,38,46,1946
62728,62728,B3E65E9B8C8CAC02E61922EDB0A62E7D,41021,22,23,1,38,47,1947
62729,62729,C4A46EA5408AA16A0ED0D09924B79885,11701,5,10,5,43,48,2198
62730,62730,C4A46EA5408AA16A0ED0D09924B79885,42641,15,16,1,33,49,1699
62731,62731,C4A46EA5408AA16A0ED0D09924B79885,10154,21,22,1,33,47,1697
62741,62741,5CF14B2B10725E82307DC412844C30B7,12311,0,6,6,30,44,1544
62742,62742,5CF14B2B10725E82307DC412844C30B7,10251,7,14,7,35,47,1797
62743,62743,5CF14B2B10725E82307DC412844C30B7,12311,14,15,1,30,44,1544
62744,62744,5CF14B2B10725E82307DC412844C30B7,10251,19,20,1,35,47,1797
62745,62745,5CF14B2B10725E82307DC412844C30B7,40637,21,23,2,36,47,1847
62746,62746,447DE8BE994FC0B5C433A70F9DE9FEA1,11781,8,10,2,38,49,1949
62747,62747,447DE8BE994FC0B5C433A70F9DE9FEA1,10841,11,13,2,37,47,1897
62748,62748,447DE8BE994FC0B5C433A70F9DE9FEA1,11781,14,17,3,38,49,1949
62749,62749,447DE8BE994FC0B5C433A70F9DE9FEA1,42511,18,21,3,37,47,1897
62750,62750,447DE8BE994FC0B5C433A70F9DE9FEA1,11781,21,22,1,38,49,1949
62751,62751,CD54A52DB6FE750484C4DFCA77624F4D,19741,0,6,6,5,44,294
62752,62752,CD54A52DB6FE750484C4DFCA77624F4D,10191,11,13,2,40,48,2048
62753,62753,CD54A52DB6FE750484C4DFCA77624F4D,19741,15,22,7,5,44,294
62764,62764,580990CDD9669C3E43DD110A27A6124E,15411,0,8,8,44,27,2227
62765,62765,580990CDD9669C3E43DD110A27A6124E,12611,10,11,1,41,29,2079
62766,62766,580990CDD9669C3E43DD110A27A6124E,15411,11,23,12,44,27,2227
62770,62770,4EE5C60035D807126AEE0DC0CD563832,42581,4,6,2,38,48,1948
62771,62771,4EE5C60035D807126AEE0DC0CD563832,11914,11,15,4,37,48,1898
62772,62772,4EE5C60035D807126AEE0DC0CD563832,42581,16,17,1,38,48,1948
62773,62773,4EE5C60035D807126AEE0DC0CD563832,11914,18,19,1,37,48,1898
62774,62774,4EE5C60035D807126AEE0DC0CD563832,42581,19,21,2,38,48,1948
62779,62779,6EB03DEC41F60785258F0AA9E4E23DB1,12761,1,7,6,25,40,1290
62780,62780,6EB03DEC41F60785258F0AA9E4E23DB1,11281,9,12,3,27,40,1390
62781,62781,6EB03DEC41F60785258F0AA9E4E23DB1,12521,13,18,5,35,41,1791
62782,62782,99B0D55649A787FC801ED0AAF800A68B,42231,0,5,5,37,46,1896
62783,62783,99B0D55649A787FC801ED0AAF800A68B,10431,9,10,1,33,49,1699
62784,62784,99B0D55649A787FC801ED0AAF800A68B,42941,13,15,2,37,47,1897
62785,62785,99B0D55649A787FC801ED0AAF800A68B,42231,19,23,4,37,46,1896
62786,62786,27A0DD6A965A1FEA8EED4D0E73345414,19181,2,6,4,8,40,440
62787,62787,27A0DD6A965A1FEA8EED4D0E73345414,12921,7,8,1,9,41,491
62788,62788,27A0DD6A965A1FEA8EED4D0E73345414,12641,8,10,2,10,43,543
62789,62789,27A0DD6A965A1FEA8EED4D0E73345414,12921,12,16,4,9,41,491
62790,62790,27A0DD6A965A1FEA8EED4D0E73345414,13731,19,21,2,33,49,1699
62791,62791,FFD84391FCD810EDFCF9E1B100BB0A91,11201,4,9,5,35,49,1799
62792,62792,FFD84391FCD810EDFCF9E1B100BB0A91,11751,10,12,2,35,48,1798
62793,62793,FFD84391FCD810EDFCF9E1B100BB0A91,40951,12,14,2,36,49,1849
62794,62794,FFD84391FCD810EDFCF9E1B100BB0A91,11201,14,16,2,35,49,1799
62795,62795,FFD84391FCD810EDFCF9E1B100BB0A91,40951,18,20,2,36,49,1849
62796,62796,FB0B14453313651E87805CBEB2B9BEA6,15411,0,1,1,44,27,2227
62797,62797,FB0B14453313651E87805CBEB2B9BEA6,13251,3,4,1,48,28,2428
62798,62798,FB0B14453313651E87805CBEB2B9BEA6,15411,8,23,15,44,27,2227
62799,62799,EB9956C9DBC511BA5FF326EEE28E7DCD,10271,4,16,12,37,46,1896
62800,62800,EB9956C9DBC511BA5FF326EEE28E7DCD,40302,18,19,1,40,49,2049
62801,62801,EB9956C9DBC511BA5FF326EEE28E7DCD,43051,21,22,1,46,45,2345
62805,62805,542BB756B513B9D8AA713D08DD5DEA3D,10711,3,5,2,29,46,1496
62806,62806,542BB756B513B9D8AA713D08DD5DEA3D,12661,8,11,3,32,45,1645
62807,62807,542BB756B513B9D8AA713D08DD5DEA3D,13671,18,20,2,27,43,1393
62808,62808,542BB756B513B9D8AA713D08DD5DEA3D,11651,22,23,1,33,47,1697
62813,62813,A0B44EDE0A0A4605549206EBBBA0709D,10211,0,6,6,16,49,849
62814,62814,A0B44EDE0A0A4605549206EBBBA0709D,42861,8,17,9,37,44,1894
62815,62815,A0B44EDE0A0A4605549206EBBBA0709D,11261,17,18,1,36,46,1846
62816,62816,A0B44EDE0A0A4605549206EBBBA0709D,10211,19,23,4,16,49,849
62817,62817,597064D826C3E01F204980F028CA1A17,42861,0,6,6,37,44,1894
62818,62818,597064D826C3E01F204980F028CA1A17,11261,6,7,1,36,46,1846
62819,62819,597064D826C3E01F204980F028CA1A17,42861,12,13,1,37,44,1894
62820,62820,597064D826C3E01F204980F028CA1A17,42864,14,15,1,38,44,1944
62821,62821,597064D826C3E01F204980F028CA1A17,42861,18,23,5,37,44,1894
62822,62822,09C2A5500F5ABAEEAC932C07F5628EC4,11021,0,8,8,36,49,1849
62823,62823,09C2A5500F5ABAEEAC932C07F5628EC4,43161,8,12,4,35,47,1797
62824,62824,09C2A5500F5ABAEEAC932C07F5628EC4,11021,12,14,2,36,49,1849
62825,62825,09C2A5500F5ABAEEAC932C07F5628EC4,42161,14,19,5,36,47,1847
62826,62826,09C2A5500F5ABAEEAC932C07F5628EC4,11021,19,22,3,36,49,1849
62833,62833,EFBE8EEC66897D29767EE27EFF3AD9CF,12401,0,1,1,39,49,1999
62834,62834,EFBE8EEC66897D29767EE27EFF3AD9CF,10191,3,9,6,40,48,2048
62835,62835,EFBE8EEC66897D29767EE27EFF3AD9CF,11074,13,14,1,37,47,1897
62836,62836,EFBE8EEC66897D29767EE27EFF3AD9CF,13221,16,18,2,40,47,2047
62837,62837,EFBE8EEC66897D29767EE27EFF3AD9CF,42801,22,23,1,40,49,2049
62838,62838,AB1E27033ABBCFEAE4B83A799FB358FD,19744,0,5,5,6,43,343
62839,62839,AB1E27033ABBCFEAE4B83A799FB358FD,12311,7,15,8,30,44,1544
62840,62840,AB1E27033ABBCFEAE4B83A799FB358FD,19744,20,22,2,6,43,343
62844,62844,BBCB9918D42B41DEDF16DD7F5A9BE26F,11861,1,10,9,32,47,1647
62845,62845,BBCB9918D42B41DEDF16DD7F5A9BE26F,10251,10,12,2,35,47,1797
62846,62846,BBCB9918D42B41DEDF16DD7F5A9BE26F,11911,12,17,5,37,48,1898
62847,62847,BBCB9918D42B41DEDF16DD7F5A9BE26F,11861,17,23,6,32,47,1647
62851,62851,15BCDD697148756030A767ED1AC11F1B,42161,0,9,9,36,47,1847
62852,62852,15BCDD697148756030A767ED1AC11F1B,13091,10,17,7,20,42,1042
62853,62853,15BCDD697148756030A767ED1AC11F1B,42161,18,23,5,36,47,1847
62868,62868,69C834810CF6013D091E0B9EA99E4EF4,40673,1,2,1,36,48,1848
62869,62869,69C834810CF6013D091E0B9EA99E4EF4,40637,2,7,5,36,47,1847
62870,62870,69C834810CF6013D091E0B9EA99E4EF4,12641,11,14,3,10,43,543
62871,62871,69C834810CF6013D091E0B9EA99E4EF4,40637,18,19,1,36,47,1847
62872,62872,69C834810CF6013D091E0B9EA99E4EF4,10107,20,21,1,38,49,1949
62877,62877,520C7CBC821664A98A49926C91FE5529,42231,7,8,1,37,46,1896
62878,62878,520C7CBC821664A98A49926C91FE5529,42623,9,10,1,22,49,1149
62879,62879,520C7CBC821664A98A49926C91FE5529,42231,13,23,10,37,46,1896
62880,62880,6684687C9F1041794E8237CE4D241C6F,10381,0,5,5,31,49,1599
62881,62881,6684687C9F1041794E8237CE4D241C6F,42081,6,8,2,24,49,1249
62882,62882,6684687C9F1041794E8237CE4D241C6F,10381,8,13,5,31,49,1599
62883,62883,6684687C9F1041794E8237CE4D241C6F,42081,14,15,1,24,49,1249
62884,62884,6684687C9F1041794E8237CE4D241C6F,10381,16,18,2,31,49,1599
62885,62885,6684687C9F1041794E8237CE4D241C6F,42081,18,22,4,24,49,1249
62886,62886,FA73CEEF86E3045F96788E3868F3C71A,11541,0,11,11,35,49,1799
62887,62887,FA73CEEF86E3045F96788E3868F3C71A,11911,11,14,3,37,48,1898
62888,62888,FA73CEEF86E3045F96788E3868F3C71A,10161,14,16,2,35,49,1799
62889,62889,FA73CEEF86E3045F96788E3868F3C71A,11331,17,18,1,37,48,1898
62890,62890,FA73CEEF86E3045F96788E3868F3C71A,40341,19,20,1,23,49,1199
62891,62891,B00B74C1DFF26602F4DA114CC908EC3C,12601,1,3,2,25,47,1297
62892,62892,B00B74C1DFF26602F4DA114CC908EC3C,13771,4,6,2,21,45,1095
62893,62893,B00B74C1DFF26602F4DA114CC908EC3C,10501,7,8,1,22,46,1146
62894,62894,B00B74C1DFF26602F4DA114CC908EC3C,12601,11,21,10,25,47,1297
62895,62895,40A368CA34750DF505DA57A322872C86,12611,0,6,6,41,29,2079
62896,62896,40A368CA34750DF505DA57A322872C86,15411,7,9,2,44,27,2227
62897,62897,40A368CA34750DF505DA57A322872C86,12611,12,13,1,41,29,2079
62898,62898,40A368CA34750DF505DA57A322872C86,15411,15,17,2,44,27,2227
62899,62899,40A368CA34750DF505DA57A322872C86,12611,18,23,5,41,29,2079
62900,62900,5A023340217ACADB6D658A3D5912E97C,11061,0,8,8,29,48,1498
62901,62901,5A023340217ACADB6D658A3D5912E97C,43241,9,16,7,36,46,1846
62902,62902,5A023340217ACADB6D658A3D5912E97C,11061,22,23,1,29,48,1498
62903,62903,52DE1B5B29EB088C4F7CC0D4865B38F5,42861,1,2,1,37,44,1894
62904,62904,52DE1B5B29EB088C4F7CC0D4865B38F5,42151,4,7,3,35,45,1795
62905,62905,52DE1B5B29EB088C4F7CC0D4865B38F5,42861,11,12,1,37,44,1894
62906,62906,52DE1B5B29EB088C4F7CC0D4865B38F5,42151,14,21,7,35,45,1795
62907,62907,52DE1B5B29EB088C4F7CC0D4865B38F5,42861,22,23,1,37,44,1894
62908,62908,132BAF41704DD845C2F70543C3732C4E,42231,0,3,3,37,46,1896
62909,62909,132BAF41704DD845C2F70543C3732C4E,13711,3,7,4,38,46,1946
62910,62910,132BAF41704DD845C2F70543C3732C4E,42231,8,14,6,37,46,1896
62911,62911,132BAF41704DD845C2F70543C3732C4E,13711,18,19,1,38,46,1946
62912,62912,132BAF41704DD845C2F70543C3732C4E,42231,19,23,4,37,46,1896
62923,62923,4D9FAA243198ABD2878F91DE0173DAC7,42091,5,6,1,43,46,2196
62924,62924,4D9FAA243198ABD2878F91DE0173DAC7,10471,9,12,3,37,48,1898
62925,62925,4D9FAA243198ABD2878F91DE0173DAC7,40801,13,22,9,43,46,2196
62926,62926,575A37EC29D335921BCA0597E7848EC3,13711,0,7,7,38,46,1946
62927,62927,575A37EC29D335921BCA0597E7848EC3,12601,8,11,3,25,47,1297
62928,62928,575A37EC29D335921BCA0597E7848EC3,13711,15,23,8,38,46,1946
62929,62929,10CBCD08F0B06B3479DA3562D07A1BB8,12311,1,15,14,30,44,1544
62930,62930,10CBCD08F0B06B3479DA3562D07A1BB8,42531,16,17,1,31,45,1595
62931,62931,10CBCD08F0B06B3479DA3562D07A1BB8,42151,17,19,2,35,45,1795
62939,62939,2CA7F7242E76579D7DF2C857A1AA360C,12971,0,3,3,32,48,1648
62940,62940,2CA7F7242E76579D7DF2C857A1AA360C,10221,3,12,9,34,49,1749
62941,62941,2CA7F7242E76579D7DF2C857A1AA360C,11541,14,15,1,35,49,1799
62942,62942,2CA7F7242E76579D7DF2C857A1AA360C,10431,16,17,1,33,49,1699
62943,62943,2CA7F7242E76579D7DF2C857A1AA360C,12971,21,23,2,32,48,1648
62947,62947,AD40D82D2B78FE36B2F14AD5CC26A994,12381,6,8,2,32,48,1648
62948,62948,AD40D82D2B78FE36B2F14AD5CC26A994,11021,9,11,2,36,49,1849
62949,62949,AD40D82D2B78FE36B2F14AD5CC26A994,10471,13,18,5,37,48,1898
62950,62950,AD40D82D2B78FE36B2F14AD5CC26A994,11074,19,20,1,37,47,1897
62951,62951,AD40D82D2B78FE36B2F14AD5CC26A994,43311,21,23,2,31,48,1598
62958,62958,EAAB672210C677BA2879CCE67BDB7DF5,11151,0,5,5,30,48,1548
62959,62959,EAAB672210C677BA2879CCE67BDB7DF5,42831,6,10,4,27,48,1398
62960,62960,EAAB672210C677BA2879CCE67BDB7DF5,11151,11,13,2,30,48,1548
62961,62961,EAAB672210C677BA2879CCE67BDB7DF5,42831,15,17,2,27,48,1398
62962,62962,EAAB672210C677BA2879CCE67BDB7DF5,11151,20,23,3,30,48,1548
62963,62963,60E47AB33736AC41E2674A67294A03D4,12491,0,5,5,36,43,1843
62964,62964,60E47AB33736AC41E2674A67294A03D4,11261,6,8,2,36,46,1846
62965,62965,60E47AB33736AC41E2674A67294A03D4,12491,9,10,1,36,43,1843
62966,62966,60E47AB33736AC41E2674A67294A03D4,11261,12,19,7,36,46,1846
62967,62967,60E47AB33736AC41E2674A67294A03D4,12491,20,23,3,36,43,1843
62968,62968,D97F93CB7946C1399F01BAA588B11A0C,42351,0,7,7,38,45,1945
62969,62969,D97F93CB7946C1399F01BAA588B11A0C,12051,11,13,2,20,47,1047
62970,62970,D97F93CB7946C1399F01BAA588B11A0C,42351,15,16,1,38,45,1945
62971,62971,D97F93CB7946C1399F01BAA588B11A0C,11261,20,23,3,36,46,1846
62979,62979,F587555054424F7ED0D63829AAEB0C06,42271,0,4,4,40,47,2047
62980,62980,F587555054424F7ED0D63829AAEB0C06,11806,4,5,1,41,48,2098
62981,62981,F587555054424F7ED0D63829AAEB0C06,42271,8,11,3,40,47,2047
62982,62982,F587555054424F7ED0D63829AAEB0C06,11806,13,14,1,41,48,2098
62983,62983,F587555054424F7ED0D63829AAEB0C06,42271,15,18,3,40,47,2047
62988,62988,B33328896E0D2DF8F24E9279DE1B216A,13941,7,8,1,41,47,2097
62989,62989,B33328896E0D2DF8F24E9279DE1B216A,10121,9,19,10,36,49,1849
62990,62990,B33328896E0D2DF8F24E9279DE1B216A,13941,20,21,1,41,47,2097
62991,62991,07BE06A8A2F6E847FDE152A4FA00E6A5,10221,0,9,9,34,49,1749
62992,62992,07BE06A8A2F6E847FDE152A4FA00E6A5,19114,10,11,1,7,43,393
62993,62993,07BE06A8A2F6E847FDE152A4FA00E6A5,10221,12,23,11,34,49,1749
62998,62998,FF6FF9B0197A91C0352AF48B73895F85,42201,0,7,7,43,46,2196
62999,62999,FF6FF9B0197A91C0352AF48B73895F85,13341,9,11,2,44,45,2245
63000,63000,FF6FF9B0197A91C0352AF48B73895F85,42201,11,13,2,43,46,2196
63001,63001,FF6FF9B0197A91C0352AF48B73895F85,42461,18,19,1,45,47,2297
63002,63002,FF6FF9B0197A91C0352AF48B73895F85,42201,22,23,1,43,46,2196
63003,63003,FC3EF5196F872A4E555EAB4D9CCCF241,12881,0,4,4,47,22,2372
63004,63004,FC3EF5196F872A4E555EAB4D9CCCF241,12781,5,6,1,46,24,2324
63005,63005,FC3EF5196F872A4E555EAB4D9CCCF241,15171,11,21,10,42,21,2121
63006,63006,085A54B112E93B58F53705ABE7F444E7,13471,0,6,6,47,49,2399
63007,63007,085A54B112E93B58F53705ABE7F444E7,42601,7,9,2,44,48,2248
63008,63008,085A54B112E93B58F53705ABE7F444E7,13471,13,14,1,47,49,2399
63009,63009,085A54B112E93B58F53705ABE7F444E7,42601,14,15,1,44,48,2248
63010,63010,085A54B112E93B58F53705ABE7F444E7,11701,18,22,4,43,48,2198
63017,63017,27FD8A6CDE751A5F2BC12F75826C7985,12921,6,7,1,9,41,491
63018,63018,27FD8A6CDE751A5F2BC12F75826C7985,19181,9,10,1,8,40,440
63019,63019,27FD8A6CDE751A5F2BC12F75826C7985,12921,10,12,2,9,41,491
63020,63020,27FD8A6CDE751A5F2BC12F75826C7985,19181,13,17,4,8,40,440
63021,63021,27FD8A6CDE751A5F2BC12F75826C7985,43021,21,23,2,16,43,843
63022,63022,0A06E26D4B63B311703019BBFB7FEF42,10471,0,9,9,37,48,1898
63023,63023,0A06E26D4B63B311703019BBFB7FEF42,11021,14,17,3,36,49,1849
63024,63024,0A06E26D4B63B311703019BBFB7FEF42,11875,19,20,1,30,46,1546
63025,63025,BA9047D5F767825C5A8967AEAD3FFE50,13101,0,12,12,40,47,2047
63026,63026,BA9047D5F767825C5A8967AEAD3FFE50,10731,16,18,2,33,47,1697
63027,63027,BA9047D5F767825C5A8967AEAD3FFE50,11074,19,20,1,37,47,1897
63028,63028,346BF3F539A4C5C04EF0491F7207CF76,19931,0,5,5,7,43,393
63029,63029,346BF3F539A4C5C04EF0491F7207CF76,12641,6,8,2,10,43,543
63030,63030,346BF3F539A4C5C04EF0491F7207CF76,19021,10,11,1,10,45,545
63031,63031,346BF3F539A4C5C04EF0491F7207CF76,43021,12,13,1,16,43,843
63032,63032,346BF3F539A4C5C04EF0491F7207CF76,12641,15,18,3,10,43,543
63033,63033,346BF3F539A4C5C04EF0491F7207CF76,19021,18,19,1,10,45,545
63034,63034,346BF3F539A4C5C04EF0491F7207CF76,19114,19,21,2,7,43,393
63038,63038,9A2E32244287B4B7AEA1F1EFBCFAADA7,40636,0,2,2,35,48,1798
63039,63039,9A2E32244287B4B7AEA1F1EFBCFAADA7,43581,3,9,6,33,48,1698
63040,63040,9A2E32244287B4B7AEA1F1EFBCFAADA7,42623,12,20,8,22,49,1149
63047,63047,B56BBE5C657FAC9D459160C06E8E60BC,10271,0,12,12,37,46,1896
63048,63048,B56BBE5C657FAC9D459160C06E8E60BC,12311,15,16,1,30,44,1544
63049,63049,B56BBE5C657FAC9D459160C06E8E60BC,42531,16,17,1,31,45,1595
63050,63050,B56BBE5C657FAC9D459160C06E8E60BC,10271,19,23,4,37,46,1896
63051,63051,FF83C80BC702988B25FE3B35D24CA178,10401,8,12,4,33,49,1699
63052,63052,FF83C80BC702988B25FE3B35D24CA178,11491,18,19,1,36,47,1847
63053,63053,FF83C80BC702988B25FE3B35D24CA178,10811,21,23,2,38,46,1946
63054,63054,5B009341D59B6503373635BF5936335C,11861,0,4,4,32,47,1647
63055,63055,5B009341D59B6503373635BF5936335C,42091,8,12,4,43,46,2196
63056,63056,5B009341D59B6503373635BF5936335C,11861,12,14,2,32,47,1647
63057,63057,5B009341D59B6503373635BF5936335C,10731,15,17,2,33,47,1697
63058,63058,5B009341D59B6503373635BF5936335C,10661,21,23,2,37,49,1899
63059,63059,7D5A0E77703D6999456241ED42B99D9C,10911,1,6,5,39,46,1996
63060,63060,7D5A0E77703D6999456241ED42B99D9C,40951,9,15,6,36,49,1849
63061,63061,7D5A0E77703D6999456241ED42B99D9C,11751,15,17,2,35,48,1798
63062,63062,7D5A0E77703D6999456241ED42B99D9C,10911,18,23,5,39,46,1996
63066,63066,FF0C11254BA355CCA708C36EE5C4353D,11381,1,6,5,30,47,1547
63067,63067,FF0C11254BA355CCA708C36EE5C4353D,11261,7,13,6,36,46,1846
63068,63068,FF0C11254BA355CCA708C36EE5C4353D,11381,18,21,3,30,47,1547
63073,63073,4DC69DC53F9E9426DABBBEF7E74B0B08,42301,0,8,8,36,47,1847
63074,63074,4DC69DC53F9E9426DABBBEF7E74B0B08,43451,10,11,1,37,40,1890
63075,63075,4DC69DC53F9E9426DABBBEF7E74B0B08,42301,13,20,7,36,47,1847
63076,63076,BA7F8D1245DF2BA170F396020DC5A58C,13671,0,8,8,27,43,1393
63077,63077,BA7F8D1245DF2BA170F396020DC5A58C,13314,9,14,5,31,39,1589
63078,63078,BA7F8D1245DF2BA170F396020DC5A58C,13671,14,17,3,27,43,1393
63079,63079,BA7F8D1245DF2BA170F396020DC5A58C,13314,19,20,1,31,39,1589
63080,63080,BA7F8D1245DF2BA170F396020DC5A58C,13671,21,23,2,27,43,1393
63081,63081,05CB49344DFAF1D6E8665C14148D60A1,42071,0,7,7,31,49,1599
63082,63082,05CB49344DFAF1D6E8665C14148D60A1,43391,11,12,1,29,48,1498
63083,63083,05CB49344DFAF1D6E8665C14148D60A1,11151,13,14,1,30,48,1548
63084,63084,05CB49344DFAF1D6E8665C14148D60A1,11061,18,20,2,29,48,1498
63085,63085,05CB49344DFAF1D6E8665C14148D60A1,11151,22,23,1,30,48,1548
63086,63086,DC066CD0495E31C3328CCF0DC4172A03,13314,0,5,5,31,39,1589
63087,63087,DC066CD0495E31C3328CCF0DC4172A03,12521,5,9,4,35,41,1791
63088,63088,DC066CD0495E31C3328CCF0DC4172A03,13314,12,23,11,31,39,1589
63108,63108,EDAA922713654FF36B4E3A7C199ADC11,19114,0,6,6,7,43,393
63109,63109,EDAA922713654FF36B4E3A7C199ADC11,12921,7,8,1,9,41,491
63110,63110,EDAA922713654FF36B4E3A7C199ADC11,19021,12,14,2,10,45,545
63111,63111,EDAA922713654FF36B4E3A7C199ADC11,19111,18,22,4,9,45,495
63116,63116,8FB2C78EB46FD562E8BB57D1602CC08C,10531,0,5,5,34,46,1746
63117,63117,8FB2C78EB46FD562E8BB57D1602CC08C,10161,6,11,5,35,49,1799
63118,63118,8FB2C78EB46FD562E8BB57D1602CC08C,11491,12,14,2,36,47,1847
63119,63119,8FB2C78EB46FD562E8BB57D1602CC08C,10161,16,18,2,35,49,1799
63120,63120,8FB2C78EB46FD562E8BB57D1602CC08C,11491,18,21,3,36,47,1847
63121,63121,0A90994D864D1DBC3EB54A8F67814706,10107,6,9,3,38,49,1949
63122,63122,0A90994D864D1DBC3EB54A8F67814706,19021,11,12,1,10,45,545
63123,63123,0A90994D864D1DBC3EB54A8F67814706,43021,14,15,1,16,43,843
63124,63124,0A90994D864D1DBC3EB54A8F67814706,19021,17,21,4,10,45,545
63128,63128,C8236143E8B93D5FDE499177CF2B28F7,11381,0,5,5,30,47,1547
63129,63129,C8236143E8B93D5FDE499177CF2B28F7,11261,6,7,1,36,46,1846
63130,63130,C8236143E8B93D5FDE499177CF2B28F7,42861,9,17,8,37,44,1894
63131,63131,C8236143E8B93D5FDE499177CF2B28F7,11381,20,23,3,30,47,1547
63142,63142,414AA00EC00DAA3D830C87A4F3E4DD09,11861,0,9,9,32,47,1647
63143,63143,414AA00EC00DAA3D830C87A4F3E4DD09,10151,12,13,1,34,47,1747
63144,63144,414AA00EC00DAA3D830C87A4F3E4DD09,42021,14,16,2,33,47,1697
63145,63145,414AA00EC00DAA3D830C87A4F3E4DD09,43981,18,21,3,36,49,1849
63146,63146,EAEFCB977DEDF23C1346736B36A6F67B,42351,1,4,3,38,45,1945
63147,63147,EAEFCB977DEDF23C1346736B36A6F67B,11261,6,8,2,36,46,1846
63148,63148,EAEFCB977DEDF23C1346736B36A6F67B,42231,8,9,1,37,46,1896
63149,63149,EAEFCB977DEDF23C1346736B36A6F67B,11261,15,17,2,36,46,1846
63150,63150,EAEFCB977DEDF23C1346736B36A6F67B,42231,19,23,4,37,46,1896
63163,63163,FADBD24FB94D9388BE2E59D5F595D57D,42461,8,15,7,45,47,2297
63164,63164,FADBD24FB94D9388BE2E59D5F595D57D,11481,18,20,2,41,48,2098
63165,63165,FADBD24FB94D9388BE2E59D5F595D57D,42161,20,22,2,36,47,1847
63169,63169,57264310C090DF3D19301CDB238DF4E1,43121,0,12,12,25,27,1277
63170,63170,57264310C090DF3D19301CDB238DF4E1,15321,13,15,2,29,26,1476
63171,63171,57264310C090DF3D19301CDB238DF4E1,43121,16,22,6,25,27,1277
63172,63172,D5A1F589AD5A8A456E0D23A90489837D,42523,1,3,2,31,47,1597
63173,63173,D5A1F589AD5A8A456E0D23A90489837D,43761,4,7,3,32,47,1647
63174,63174,D5A1F589AD5A8A456E0D23A90489837D,11231,8,18,10,37,49,1899
63175,63175,D5A1F589AD5A8A456E0D23A90489837D,43761,19,23,4,32,47,1647
63176,63176,4003E07D2A4AF66E84145561FFA003F3,10341,0,15,15,31,47,1597
63177,63177,4003E07D2A4AF66E84145561FFA003F3,10841,16,17,1,37,47,1897
63178,63178,4003E07D2A4AF66E84145561FFA003F3,10341,18,23,5,31,47,1597
63182,63182,0D9AA89290D1F445356B85B4B256A343,11001,0,6,6,42,47,2147
63183,63183,0D9AA89290D1F445356B85B4B256A343,10811,8,10,2,38,46,1946
63184,63184,0D9AA89290D1F445356B85B4B256A343,11001,12,14,2,42,47,2147
63185,63185,0D9AA89290D1F445356B85B4B256A343,10811,16,18,2,38,46,1946
63186,63186,0D9AA89290D1F445356B85B4B256A343,11001,18,20,2,42,47,2147
63187,63187,0D9AA89290D1F445356B85B4B256A343,13941,21,23,2,41,47,2097
63188,63188,3DE4A793313E3991BF5DCB3E800E4DF3,40637,0,7,7,36,47,1847
63189,63189,3DE4A793313E3991BF5DCB3E800E4DF3,11701,13,14,1,43,48,2198
63190,63190,3DE4A793313E3991BF5DCB3E800E4DF3,11021,16,17,1,36,49,1849
63191,63191,3DE4A793313E3991BF5DCB3E800E4DF3,11731,20,21,1,36,48,1848
63192,63192,21B68CEA497FE3A2A403EC9D45FC7370,11571,1,2,1,13,46,696
63193,63193,21B68CEA497FE3A2A403EC9D45FC7370,19441,5,17,12,8,46,446
63194,63194,21B68CEA497FE3A2A403EC9D45FC7370,11571,17,23,6,13,46,696
63211,63211,823A623C992AAD0FFCC8A9B77A5AFB45,10431,0,7,7,33,49,1699
63212,63212,823A623C992AAD0FFCC8A9B77A5AFB45,13841,7,11,4,40,46,2046
63213,63213,823A623C992AAD0FFCC8A9B77A5AFB45,10431,12,13,1,33,49,1699
63214,63214,823A623C992AAD0FFCC8A9B77A5AFB45,19931,14,16,2,7,43,393
63215,63215,823A623C992AAD0FFCC8A9B77A5AFB45,10431,17,23,6,33,49,1699
63222,63222,FCA1EAEE7E44DEF112E09E949BE6A553,43081,0,1,1,27,28,1378
63223,63223,FCA1EAEE7E44DEF112E09E949BE6A553,19101,2,4,2,17,29,879
63224,63224,FCA1EAEE7E44DEF112E09E949BE6A553,13481,7,22,15,26,31,1331
63236,63236,E063ED0B410DBCBEA7B106C50A20F760,42941,0,1,1,37,47,1897
63237,63237,E063ED0B410DBCBEA7B106C50A20F760,11491,1,18,17,36,47,1847
63238,63238,E063ED0B410DBCBEA7B106C50A20F760,43761,19,23,4,32,47,1647
63252,63252,33825114014E22B38BE13400DBE8B281,42871,0,9,9,30,45,1545
63253,63253,33825114014E22B38BE13400DBE8B281,19431,12,13,1,8,29,429
63254,63254,33825114014E22B38BE13400DBE8B281,42871,15,22,7,30,45,1545
63267,63267,9B27AA39D08A4AD4F1A3555FC349C4D1,13651,2,3,1,30,47,1547
63268,63268,9B27AA39D08A4AD4F1A3555FC349C4D1,42523,6,8,2,31,47,1597
63269,63269,9B27AA39D08A4AD4F1A3555FC349C4D1,43161,12,14,2,35,47,1797
63270,63270,9B27AA39D08A4AD4F1A3555FC349C4D1,13511,14,16,2,34,48,1748
63271,63271,9B27AA39D08A4AD4F1A3555FC349C4D1,10491,17,19,2,33,48,1698
63272,63272,9B27AA39D08A4AD4F1A3555FC349C4D1,42523,21,23,2,31,47,1597
63279,63279,DC84219A18D205A834F01D7743EEEE79,42021,0,7,7,33,47,1697
63280,63280,DC84219A18D205A834F01D7743EEEE79,11231,9,10,1,37,49,1899
63281,63281,DC84219A18D205A834F01D7743EEEE79,10471,10,12,2,37,48,1898
63282,63282,DC84219A18D205A834F01D7743EEEE79,11231,13,18,5,37,49,1899
63283,63283,DC84219A18D205A834F01D7743EEEE79,10471,20,23,3,37,48,1898
63287,63287,263B06A3E97A989472BE0B3ECECEEA7C,15051,0,18,18,19,4,954
63288,63288,263B06A3E97A989472BE0B3ECECEEA7C,16281,18,19,1,11,4,554
63289,63289,263B06A3E97A989472BE0B3ECECEEA7C,15051,20,21,1,19,4,954
63300,63300,46D10B971C10D2856504DC61068F66E7,19024,0,13,13,9,45,495
63301,63301,46D10B971C10D2856504DC61068F66E7,42151,14,17,3,35,45,1795
63302,63302,46D10B971C10D2856504DC61068F66E7,19901,19,20,1,7,44,394
63307,63307,74EBB90FA1C414F58477B49370E7F73F,11861,0,6,6,32,47,1647
63308,63308,74EBB90FA1C414F58477B49370E7F73F,12311,7,14,7,30,44,1544
63309,63309,74EBB90FA1C414F58477B49370E7F73F,11861,19,23,4,32,47,1647
63310,63310,241030B6FCCB97C7B3FD6A52A0CF57A2,43021,0,12,12,16,43,843
63311,63311,241030B6FCCB97C7B3FD6A52A0CF57A2,19111,13,16,3,9,45,495
63312,63312,241030B6FCCB97C7B3FD6A52A0CF57A2,12621,16,19,3,10,48,548
63313,63313,241030B6FCCB97C7B3FD6A52A0CF57A2,19111,21,23,2,9,45,495
63314,63314,39179060954ADF536A44D5CDC3D7ADA4,10921,0,12,12,43,48,2198
63315,63315,39179060954ADF536A44D5CDC3D7ADA4,13911,13,17,4,39,46,1996
63316,63316,39179060954ADF536A44D5CDC3D7ADA4,11261,19,22,3,36,46,1846
63317,63317,E3A8F4DF6909601703366C7CAB0A7DDC,19114,0,8,8,7,43,393
63318,63318,E3A8F4DF6909601703366C7CAB0A7DDC,12641,8,11,3,10,43,543
63319,63319,E3A8F4DF6909601703366C7CAB0A7DDC,40623,13,15,2,34,46,1746
63320,63320,E3A8F4DF6909601703366C7CAB0A7DDC,12641,17,18,1,10,43,543
63321,63321,E3A8F4DF6909601703366C7CAB0A7DDC,19114,19,23,4,7,43,393
63322,63322,BA6D45213D52989026A398B5D7995374,43021,0,2,2,16,43,843
63323,63323,BA6D45213D52989026A398B5D7995374,19181,7,8,1,8,40,440
63324,63324,BA6D45213D52989026A398B5D7995374,12641,13,14,1,10,43,543
63325,63325,BA6D45213D52989026A398B5D7995374,19181,16,18,2,8,40,440
63326,63326,BA6D45213D52989026A398B5D7995374,43644,21,23,2,14,38,738
63330,63330,639EA486291B8A87A84D90343A87732A,10451,0,7,7,25,48,1298
63331,63331,639EA486291B8A87A84D90343A87732A,10107,8,10,2,38,49,1949
63332,63332,639EA486291B8A87A84D90343A87732A,11111,12,15,3,26,48,1348
63333,63333,639EA486291B8A87A84D90343A87732A,10107,16,17,1,38,49,1949
63334,63334,639EA486291B8A87A84D90343A87732A,11541,18,19,1,35,49,1799
63335,63335,639EA486291B8A87A84D90343A87732A,10451,21,23,2,25,48,1298
63339,63339,CFB5B91AB0CD7543884ADBE535AD19D6,43021,0,11,11,16,43,843
63340,63340,CFB5B91AB0CD7543884ADBE535AD19D6,12921,15,16,1,9,41,491
63341,63341,CFB5B91AB0CD7543884ADBE535AD19D6,43021,17,23,6,16,43,843
63342,63342,77615EEA4815C7BC9954A76636C2199B,11531,6,8,2,34,49,1749
63343,63343,77615EEA4815C7BC9954A76636C2199B,11061,9,15,6,29,48,1498
63344,63344,77615EEA4815C7BC9954A76636C2199B,11531,20,23,3,34,49,1749
63345,63345,FF1A17FD1CDC910F0F9D0573E2F35724,42301,0,12,12,36,47,1847
63346,63346,FF1A17FD1CDC910F0F9D0573E2F35724,13341,14,16,2,44,45,2245
63347,63347,FF1A17FD1CDC910F0F9D0573E2F35724,10111,19,21,2,37,47,1897
63348,63348,6B233920E3ADCD98186EA0225BEE346B,13271,0,7,7,41,47,2097
63349,63349,6B233920E3ADCD98186EA0225BEE346B,11771,10,12,2,39,49,1999
63350,63350,6B233920E3ADCD98186EA0225BEE346B,10801,13,15,2,42,47,2147
63351,63351,6B233920E3ADCD98186EA0225BEE346B,11861,17,22,5,32,47,1647
63355,63355,83E3F73113D72A9C281803E8B6693E53,12971,0,14,14,32,48,1648
63356,63356,83E3F73113D72A9C281803E8B6693E53,11591,14,16,2,36,49,1849
63357,63357,83E3F73113D72A9C281803E8B6693E53,11751,18,19,1,35,48,1798
63358,63358,83E3F73113D72A9C281803E8B6693E53,11201,20,22,2,35,49,1799
63359,63359,F136C5B0851ABFD347D3F5CB6A305A26,42501,1,8,7,28,47,1447
63360,63360,F136C5B0851ABFD347D3F5CB6A305A26,11324,11,14,3,31,46,1596
63361,63361,F136C5B0851ABFD347D3F5CB6A305A26,40341,18,19,1,23,49,1199
63362,63362,080DFD20131EAE3468962C6D8EC04717,42071,0,4,4,31,49,1599
63363,63363,080DFD20131EAE3468962C6D8EC04717,42081,5,14,9,24,49,1249
63364,63364,080DFD20131EAE3468962C6D8EC04717,42071,14,18,4,31,49,1599
63365,63365,080DFD20131EAE3468962C6D8EC04717,42081,18,20,2,24,49,1249
63366,63366,83E9E8FDA517093E55E61D6D9B458AB2,12511,0,8,8,39,47,1997
63367,63367,83E9E8FDA517093E55E61D6D9B458AB2,13101,11,14,3,40,47,2047
63368,63368,83E9E8FDA517093E55E61D6D9B458AB2,13271,14,15,1,41,47,2097
63369,63369,83E9E8FDA517093E55E61D6D9B458AB2,13101,18,19,1,40,47,2047
63370,63370,83E9E8FDA517093E55E61D6D9B458AB2,11481,20,21,1,41,48,2098
63375,63375,00F69335A3E4CF80C535FDBF31032586,40094,8,9,1,29,48,1498
63376,63376,00F69335A3E4CF80C535FDBF31032586,11151,9,11,2,30,48,1548
63377,63377,00F69335A3E4CF80C535FDBF31032586,40094,11,12,1,29,48,1498
63378,63378,00F69335A3E4CF80C535FDBF31032586,11151,12,15,3,30,48,1548
63379,63379,00F69335A3E4CF80C535FDBF31032586,40094,17,23,6,29,48,1498
63380,63380,1B79EB886A5576DB94A20A87F2358771,43751,0,13,13,19,48,998
63381,63381,1B79EB886A5576DB94A20A87F2358771,42681,14,16,2,24,48,1248
63382,63382,1B79EB886A5576DB94A20A87F2358771,43751,18,23,5,19,48,998
63383,63383,BA3D62C73F0E217016DDCC7A46D50696,10911,0,12,12,39,46,1996
63384,63384,BA3D62C73F0E217016DDCC7A46D50696,12514,15,16,1,38,47,1947
63385,63385,BA3D62C73F0E217016DDCC7A46D50696,10911,18,20,2,39,46,1996
63386,63386,BA3D62C73F0E217016DDCC7A46D50696,40951,21,23,2,36,49,1849
63387,63387,EDA91A918395841EFF8489C3D0297A7E,12971,0,2,2,32,48,1648
63388,63388,EDA91A918395841EFF8489C3D0297A7E,10401,5,15,10,33,49,1699
63389,63389,EDA91A918395841EFF8489C3D0297A7E,12021,16,19,3,37,49,1899
63390,63390,EDA91A918395841EFF8489C3D0297A7E,10107,19,22,3,38,49,1949
63394,63394,622CAD2A1CBEEB3E7C37B415C8550447,10121,0,10,10,36,49,1849
63395,63395,622CAD2A1CBEEB3E7C37B415C8550447,11875,12,17,5,30,46,1546
63396,63396,622CAD2A1CBEEB3E7C37B415C8550447,42321,18,22,4,43,47,2197
63397,63397,8E40D265517DB178DCF488F5DA32EDD6,10251,0,7,7,35,47,1797
63398,63398,8E40D265517DB178DCF488F5DA32EDD6,43121,9,14,5,25,27,1277
63399,63399,8E40D265517DB178DCF488F5DA32EDD6,15361,14,16,2,33,25,1675
63400,63400,8E40D265517DB178DCF488F5DA32EDD6,40951,19,21,2,36,49,1849
63404,63404,3B9989389C2FB72384F3330F9A990AB0,42351,0,1,1,38,45,1945
63405,63405,3B9989389C2FB72384F3330F9A990AB0,13911,1,3,2,39,46,1996
63406,63406,3B9989389C2FB72384F3330F9A990AB0,42351,4,5,1,38,45,1945
63407,63407,3B9989389C2FB72384F3330F9A990AB0,42231,6,12,6,37,46,1896
63408,63408,3B9989389C2FB72384F3330F9A990AB0,13911,12,13,1,39,46,1996
63409,63409,3B9989389C2FB72384F3330F9A990AB0,42231,15,19,4,37,46,1896
63414,63414,C073D10A5F071E056608DF31CD8905DD,42511,0,6,6,37,47,1897
63415,63415,C073D10A5F071E056608DF31CD8905DD,10161,11,19,8,35,49,1799
63416,63416,C073D10A5F071E056608DF31CD8905DD,13731,21,22,1,33,49,1699
63423,63423,FB55B20B748C0A1CF26B4BE2B509424A,13671,0,7,7,27,43,1393
63424,63424,FB55B20B748C0A1CF26B4BE2B509424A,12761,9,11,2,25,40,1290
63425,63425,FB55B20B748C0A1CF26B4BE2B509424A,13671,13,14,1,27,43,1393
63426,63426,FB55B20B748C0A1CF26B4BE2B509424A,12761,15,23,8,25,40,1290
63430,63430,9D762F26F7844F87DB8AF114BCC8911C,11531,0,12,12,34,49,1749
63431,63431,9D762F26F7844F87DB8AF114BCC8911C,11541,12,15,3,35,49,1799
63432,63432,9D762F26F7844F87DB8AF114BCC8911C,40341,16,22,6,23,49,1199
63433,63433,3877B8E5CE9312BFA7CD973C0152DE3C,10841,0,5,5,37,47,1897
63434,63434,3877B8E5CE9312BFA7CD973C0152DE3C,10107,10,13,3,38,49,1949
63435,63435,3877B8E5CE9312BFA7CD973C0152DE3C,12514,14,16,2,38,47,1947
63436,63436,3877B8E5CE9312BFA7CD973C0152DE3C,11261,17,19,2,36,46,1846
63437,63437,3877B8E5CE9312BFA7CD973C0152DE3C,12514,19,23,4,38,47,1947
63441,63441,1C20242E26F2426ED14AAA111A51A295,42941,0,7,7,37,47,1897
63442,63442,1C20242E26F2426ED14AAA111A51A295,15381,11,12,1,19,21,971
63443,63443,1C20242E26F2426ED14AAA111A51A295,42161,15,18,3,36,47,1847
63444,63444,1C20242E26F2426ED14AAA111A51A295,10191,19,20,1,40,48,2048
63445,63445,1C20242E26F2426ED14AAA111A51A295,42161,21,23,2,36,47,1847
63454,63454,CDE61D986275B34C15BF408D2A5E4956,11261,2,9,7,36,46,1846
63455,63455,CDE61D986275B34C15BF408D2A5E4956,12311,10,12,2,30,44,1544
63456,63456,CDE61D986275B34C15BF408D2A5E4956,11061,13,16,3,29,48,1498
63457,63457,CDE61D986275B34C15BF408D2A5E4956,10381,16,18,2,31,49,1599
63464,63464,547B4B9AB8B9B0A19F4E90E8CEDA33BD,19441,0,6,6,8,46,446
63465,63465,547B4B9AB8B9B0A19F4E90E8CEDA33BD,11571,6,8,2,13,46,696
63466,63466,547B4B9AB8B9B0A19F4E90E8CEDA33BD,19441,9,23,14,8,46,446
63467,63467,440A5BC995406F5A39B97937FE6675EC,19744,2,5,3,6,43,343
63468,63468,440A5BC995406F5A39B97937FE6675EC,12921,6,8,2,9,41,491
63469,63469,440A5BC995406F5A39B97937FE6675EC,19031,9,10,1,1,42,92
63470,63470,440A5BC995406F5A39B97937FE6675EC,12921,11,20,9,9,41,491
63471,63471,440A5BC995406F5A39B97937FE6675EC,19744,22,23,1,6,43,343
63472,63472,EAF08AA8D83A6920BE6DF9D834304DC9,11351,0,8,8,36,48,1848
63473,63473,EAF08AA8D83A6920BE6DF9D834304DC9,40691,12,14,2,42,48,2148
63474,63474,EAF08AA8D83A6920BE6DF9D834304DC9,11351,21,23,2,36,48,1848
63478,63478,7CCE50F8345FAAC660CE897C8D4185C5,11091,2,12,10,29,47,1497
63479,63479,7CCE50F8345FAAC660CE897C8D4185C5,10107,13,14,1,38,49,1949
63480,63480,7CCE50F8345FAAC660CE897C8D4185C5,11091,16,23,7,29,47,1497
63481,63481,CD2AA727CA3030BF3A2E31F2C8037B37,10971,0,9,9,35,47,1797
63482,63482,CD2AA727CA3030BF3A2E31F2C8037B37,13091,12,14,2,20,42,1042
63483,63483,CD2AA727CA3030BF3A2E31F2C8037B37,40341,16,18,2,23,49,1199
63484,63484,CD2AA727CA3030BF3A2E31F2C8037B37,10901,18,20,2,35,48,1798
63485,63485,F74E1805BD471CD67AFEC7E33078A7FE,11914,1,4,3,37,48,1898
63486,63486,F74E1805BD471CD67AFEC7E33078A7FE,43361,5,9,4,38,48,1948
63487,63487,F74E1805BD471CD67AFEC7E33078A7FE,11914,10,11,1,37,48,1898
63488,63488,F74E1805BD471CD67AFEC7E33078A7FE,43361,13,17,4,38,48,1948
63489,63489,F74E1805BD471CD67AFEC7E33078A7FE,11914,19,20,1,37,48,1898
63493,63493,B9E927B8C825AF1AC2891B310330CB7E,13121,0,6,6,38,46,1946
63494,63494,B9E927B8C825AF1AC2891B310330CB7E,42011,6,9,3,36,46,1846
63495,63495,B9E927B8C825AF1AC2891B310330CB7E,11753,11,22,11,35,48,1798
63496,63496,6F8E1C68808E2CD4EADC242CA851B0A2,42971,0,13,13,43,49,2199
63497,63497,6F8E1C68808E2CD4EADC242CA851B0A2,11021,13,16,3,36,49,1849
63498,63498,6F8E1C68808E2CD4EADC242CA851B0A2,42971,21,23,2,43,49,2199
63499,63499,8420BC80E057341A3D646D0572754A34,11074,0,7,7,37,47,1897
63500,63500,8420BC80E057341A3D646D0572754A34,12921,12,13,1,9,41,491
63501,63501,8420BC80E057341A3D646D0572754A34,12641,13,15,2,10,43,543
63502,63502,8420BC80E057341A3D646D0572754A34,12921,16,19,3,9,41,491
63510,63510,AA8CC60B06B8E7A334E7FA04353D8EED,42864,2,6,4,38,44,1944
63511,63511,AA8CC60B06B8E7A334E7FA04353D8EED,11261,8,15,7,36,46,1846
63512,63512,AA8CC60B06B8E7A334E7FA04353D8EED,43041,18,21,3,41,46,2096
63513,63513,AA8CC60B06B8E7A334E7FA04353D8EED,11261,22,23,1,36,46,1846
63514,63514,4CA7727345FE5410FF8669E86CE37E32,42041,0,5,5,10,47,547
63515,63515,4CA7727345FE5410FF8669E86CE37E32,12641,7,15,8,10,43,543
63516,63516,4CA7727345FE5410FF8669E86CE37E32,19031,15,16,1,1,42,92
63517,63517,4CA7727345FE5410FF8669E86CE37E32,19024,21,22,1,9,45,495
63521,63521,71C7D3BEB879651EE771977BC4EF34E5,10341,0,6,6,31,47,1597
63522,63522,71C7D3BEB879651EE771977BC4EF34E5,10634,10,12,2,27,45,1395
63523,63523,71C7D3BEB879651EE771977BC4EF34E5,12661,12,13,1,32,45,1645
63524,63524,71C7D3BEB879651EE771977BC4EF34E5,10634,14,16,2,27,45,1395
63525,63525,71C7D3BEB879651EE771977BC4EF34E5,12311,16,17,1,30,44,1544
63526,63526,71C7D3BEB879651EE771977BC4EF34E5,10341,20,23,3,31,47,1597
63527,63527,3B80A26D2F975046E47E98855F9118F7,40637,0,7,7,36,47,1847
63528,63528,3B80A26D2F975046E47E98855F9118F7,11151,11,13,2,30,48,1548
63529,63529,3B80A26D2F975046E47E98855F9118F7,10251,14,17,3,35,47,1797
63530,63530,3B80A26D2F975046E47E98855F9118F7,41612,21,23,2,36,47,1847
63531,63531,66EB51796A3F66EB609FF4750273B99B,10924,0,8,8,43,49,2199
63532,63532,66EB51796A3F66EB609FF4750273B99B,11301,9,11,2,41,49,2099
63533,63533,66EB51796A3F66EB609FF4750273B99B,11531,11,12,1,34,49,1749
63534,63534,66EB51796A3F66EB609FF4750273B99B,10924,12,17,5,43,49,2199
63535,63535,66EB51796A3F66EB609FF4750273B99B,11901,18,20,2,42,49,2149
63536,63536,66EB51796A3F66EB609FF4750273B99B,10924,21,23,2,43,49,2199
63537,63537,697EB06F67653D08CFE9378AC3AAB5E4,13941,0,1,1,41,47,2097
63538,63538,697EB06F67653D08CFE9378AC3AAB5E4,11001,1,3,2,42,47,2147
63539,63539,697EB06F67653D08CFE9378AC3AAB5E4,13941,4,5,1,41,47,2097
63540,63540,697EB06F67653D08CFE9378AC3AAB5E4,11001,6,14,8,42,47,2147
63541,63541,697EB06F67653D08CFE9378AC3AAB5E4,13941,14,16,2,41,47,2097
63542,63542,697EB06F67653D08CFE9378AC3AAB5E4,42971,19,23,4,43,49,2199
63546,63546,1C6B014A9F7E5BF6538ED8D07E462CBD,11074,2,3,1,37,47,1897
63547,63547,1C6B014A9F7E5BF6538ED8D07E462CBD,42221,4,6,2,38,48,1948
63548,63548,1C6B014A9F7E5BF6538ED8D07E462CBD,11074,13,17,4,37,47,1897
63549,63549,1C6B014A9F7E5BF6538ED8D07E462CBD,11631,21,23,2,12,49,649
63550,63550,ED387BC9729A0D8CA1364378D6AA6E43,10634,0,6,6,27,45,1395
63551,63551,ED387BC9729A0D8CA1364378D6AA6E43,12601,7,9,2,25,47,1297
63552,63552,ED387BC9729A0D8CA1364378D6AA6E43,10351,10,12,2,28,45,1445
63553,63553,ED387BC9729A0D8CA1364378D6AA6E43,10634,12,13,1,27,45,1395
63554,63554,ED387BC9729A0D8CA1364378D6AA6E43,12601,15,17,2,25,47,1297
63555,63555,ED387BC9729A0D8CA1364378D6AA6E43,10634,19,22,3,27,45,1395
63559,63559,5EE10AD15425E092B637A43272D0E18A,11301,0,2,2,41,49,2099
63560,63560,5EE10AD15425E092B637A43272D0E18A,11901,2,13,11,42,49,2149
63561,63561,5EE10AD15425E092B637A43272D0E18A,10161,18,20,2,35,49,1799
63565,63565,A2437A4AEC8E22627D9794D535E77C0B,12921,1,6,5,9,41,491
63566,63566,A2437A4AEC8E22627D9794D535E77C0B,12641,10,12,2,10,43,543
63567,63567,A2437A4AEC8E22627D9794D535E77C0B,12921,13,15,2,9,41,491
63568,63568,A2437A4AEC8E22627D9794D535E77C0B,12641,17,19,2,10,43,543
63569,63569,A2437A4AEC8E22627D9794D535E77C0B,12921,19,22,3,9,41,491
63570,63570,6723CB5F0350D13BD8E6C66D37C805A0,12561,0,1,1,45,43,2293
63571,63571,6723CB5F0350D13BD8E6C66D37C805A0,12221,4,12,8,43,44,2194
63572,63572,6723CB5F0350D13BD8E6C66D37C805A0,12211,15,22,7,41,44,2094
63576,63576,5C74A0E82B7EFE8141C3B697694416EE,10841,0,8,8,37,47,1897
63577,63577,5C74A0E82B7EFE8141C3B697694416EE,12311,11,18,7,30,44,1544
63578,63578,5C74A0E82B7EFE8141C3B697694416EE,11875,19,21,2,30,46,1546
63579,63579,5C74A0E82B7EFE8141C3B697694416EE,42531,22,23,1,31,45,1595
63580,63580,4B092DC1F29A37B0C9B62BC92967DF2D,12031,0,6,6,33,48,1698
63581,63581,4B092DC1F29A37B0C9B62BC92967DF2D,43731,9,15,6,34,47,1747
63582,63582,4B092DC1F29A37B0C9B62BC92967DF2D,42941,15,16,1,37,47,1897
63583,63583,4B092DC1F29A37B0C9B62BC92967DF2D,10401,16,17,1,33,49,1699
63584,63584,4B092DC1F29A37B0C9B62BC92967DF2D,12031,19,23,4,33,48,1698
63585,63585,5601C1A44CC85C7B09354B38FD0628D1,12311,0,7,7,30,44,1544
63586,63586,5601C1A44CC85C7B09354B38FD0628D1,13731,10,12,2,33,49,1699
63587,63587,5601C1A44CC85C7B09354B38FD0628D1,12311,19,23,4,30,44,1544
63588,63588,EB9D09BE515328BF73FB9D5133FFE56B,11151,0,14,14,30,48,1548
63589,63589,EB9D09BE515328BF73FB9D5133FFE56B,13121,15,18,3,38,46,1946
63590,63590,EB9D09BE515328BF73FB9D5133FFE56B,11151,20,23,3,30,48,1548
63594,63594,1BF8EE0F69AE517E82DF3506BF121A91,11074,0,12,12,37,47,1897
63595,63595,1BF8EE0F69AE517E82DF3506BF121A91,40341,14,16,2,23,49,1199
63596,63596,1BF8EE0F69AE517E82DF3506BF121A91,11074,17,19,2,37,47,1897
63597,63597,E0F1492F64F8C4421FEE7685CFBBB89C,10491,0,6,6,33,48,1698
63598,63598,E0F1492F64F8C4421FEE7685CFBBB89C,12521,9,19,10,35,41,1791
63599,63599,E0F1492F64F8C4421FEE7685CFBBB89C,10491,21,23,2,33,48,1698
63606,63606,D1348284A12247DBF7195CE953852CD8,43311,1,5,4,31,48,1598
63607,63607,D1348284A12247DBF7195CE953852CD8,11161,9,10,1,32,48,1648
63608,63608,D1348284A12247DBF7195CE953852CD8,43311,13,14,1,31,48,1598
63609,63609,D1348284A12247DBF7195CE953852CD8,11061,18,19,1,29,48,1498
63610,63610,D1348284A12247DBF7195CE953852CD8,11381,21,22,1,30,47,1547
63618,63618,B1C4D7198AEA7F20B0876462B1D75047,43731,8,9,1,34,47,1747
63619,63619,B1C4D7198AEA7F20B0876462B1D75047,40697,14,17,3,43,48,2198
63620,63620,B1C4D7198AEA7F20B0876462B1D75047,13601,18,20,2,34,47,1747
63621,63621,B1C4D7198AEA7F20B0876462B1D75047,42491,21,23,2,32,46,1646
63622,63622,ECBC886277109C0582E65AB313F27C1C,13314,0,13,13,31,39,1589
63623,63623,ECBC886277109C0582E65AB313F27C1C,12521,13,17,4,35,41,1791
63624,63624,ECBC886277109C0582E65AB313F27C1C,13314,21,23,2,31,39,1589
63625,63625,C493E8EAD829832CA31397E82BE4990B,43021,0,5,5,16,43,843
63626,63626,C493E8EAD829832CA31397E82BE4990B,12641,5,10,5,10,43,543
63627,63627,C493E8EAD829832CA31397E82BE4990B,43021,12,13,1,16,43,843
63628,63628,C493E8EAD829832CA31397E82BE4990B,12641,15,17,2,10,43,543
63629,63629,C493E8EAD829832CA31397E82BE4990B,19114,20,21,1,7,43,393
63630,63630,B678CB1757AEE5076E9F8CDF51D8AF5B,42261,2,3,1,25,49,1299
63631,63631,B678CB1757AEE5076E9F8CDF51D8AF5B,13731,7,17,10,33,49,1699
63632,63632,B678CB1757AEE5076E9F8CDF51D8AF5B,11061,20,23,3,29,48,1498
63633,63633,3848A6EA0D85B136E8DB43E69E94CF19,13561,0,13,13,37,49,1899
63634,63634,3848A6EA0D85B136E8DB43E69E94CF19,40341,14,17,3,23,49,1199
63635,63635,3848A6EA0D85B136E8DB43E69E94CF19,11631,18,23,5,12,49,649
63640,63640,BC3DA9BAF9B0A0C935A79D91ECBDA067,19441,0,7,7,8,46,446
63641,63641,BC3DA9BAF9B0A0C935A79D91ECBDA067,42151,10,12,2,35,45,1795
63642,63642,BC3DA9BAF9B0A0C935A79D91ECBDA067,12491,12,17,5,36,43,1843
63643,63643,BC3DA9BAF9B0A0C935A79D91ECBDA067,42151,17,19,2,35,45,1795
63644,63644,BC3DA9BAF9B0A0C935A79D91ECBDA067,12491,19,21,2,36,43,1843
63651,63651,CA0348936899AF48372192AB3BC1286F,12401,0,1,1,39,49,1999
63652,63652,CA0348936899AF48372192AB3BC1286F,42583,1,6,5,40,48,2048
63653,63653,CA0348936899AF48372192AB3BC1286F,11491,10,12,2,36,47,1847
63654,63654,CA0348936899AF48372192AB3BC1286F,40611,12,13,1,35,47,1797
63655,63655,CA0348936899AF48372192AB3BC1286F,10111,18,22,4,37,47,1897
63659,63659,71E80706335E84CC6A7D19F4D3805DDF,19441,1,8,7,8,46,446
63660,63660,71E80706335E84CC6A7D19F4D3805DDF,42041,11,12,1,10,47,547
63661,63661,71E80706335E84CC6A7D19F4D3805DDF,19441,13,16,3,8,46,446
63662,63662,71E80706335E84CC6A7D19F4D3805DDF,42041,16,18,2,10,47,547
63663,63663,71E80706335E84CC6A7D19F4D3805DDF,19441,19,23,4,8,46,446
63664,63664,D1DF8B8CF696B3934AD219B19DE51DE4,11781,0,2,2,38,49,1949
63665,63665,D1DF8B8CF696B3934AD219B19DE51DE4,10251,3,9,6,35,47,1797
63666,63666,D1DF8B8CF696B3934AD219B19DE51DE4,10107,14,21,7,38,49,1949
63667,63667,FFA3DC290C33DCDE004F5C2F481AFA93,42633,0,7,7,42,46,2146
63668,63668,FFA3DC290C33DCDE004F5C2F481AFA93,11531,8,9,1,34,49,1749
63669,63669,FFA3DC290C33DCDE004F5C2F481AFA93,42633,11,12,1,42,46,2146
63670,63670,FFA3DC290C33DCDE004F5C2F481AFA93,10841,15,17,2,37,47,1897
63671,63671,FFA3DC290C33DCDE004F5C2F481AFA93,42633,21,23,2,42,46,2146
63678,63678,F5BFEF4A5312E87348B932E7558CA56C,42511,0,1,1,37,47,1897
63679,63679,F5BFEF4A5312E87348B932E7558CA56C,42141,3,15,12,32,47,1647
63680,63680,F5BFEF4A5312E87348B932E7558CA56C,11161,15,16,1,32,48,1648
63681,63681,F5BFEF4A5312E87348B932E7558CA56C,43761,19,20,1,32,47,1647
63692,63692,5767E0EE50B7CB3B0CFBFCA7463471BC,11806,0,6,6,41,48,2098
63693,63693,5767E0EE50B7CB3B0CFBFCA7463471BC,43761,8,18,10,32,47,1647
63694,63694,5767E0EE50B7CB3B0CFBFCA7463471BC,11806,20,23,3,41,48,2098
63699,63699,E7E982460AE26AACDF7699313597BD0B,43761,0,18,18,32,47,1647
63700,63700,E7E982460AE26AACDF7699313597BD0B,10601,19,21,2,39,47,1997
63701,63701,E7E982460AE26AACDF7699313597BD0B,10681,21,22,1,30,48,1548
63702,63702,F681B79833B44C7DE260E9A55ED030A3,19741,0,6,6,5,44,294
63703,63703,F681B79833B44C7DE260E9A55ED030A3,19021,8,10,2,10,45,545
63704,63704,F681B79833B44C7DE260E9A55ED030A3,19741,12,14,2,5,44,294
63705,63705,F681B79833B44C7DE260E9A55ED030A3,12641,15,16,1,10,43,543
63706,63706,F681B79833B44C7DE260E9A55ED030A3,19741,19,23,4,5,44,294
63710,63710,3F2FE95AB24E5E71D935604E5158C97B,41392,0,16,16,43,48,2198
63711,63711,3F2FE95AB24E5E71D935604E5158C97B,42161,16,19,3,36,47,1847
63712,63712,3F2FE95AB24E5E71D935604E5158C97B,43161,20,21,1,35,47,1797
63713,63713,4560AA6E9FF5488D13E472C26129D09F,13331,0,1,1,38,47,1947
63714,63714,4560AA6E9FF5488D13E472C26129D09F,42511,2,3,1,37,47,1897
63715,63715,4560AA6E9FF5488D13E472C26129D09F,12514,3,18,15,38,47,1947
63716,63716,4560AA6E9FF5488D13E472C26129D09F,42511,20,21,1,37,47,1897
63717,63717,4560AA6E9FF5488D13E472C26129D09F,13331,22,23,1,38,47,1947
63718,63718,E02F64059E677B81EAF8B96D760DDB0F,16281,1,11,10,11,4,554
63719,63719,E02F64059E677B81EAF8B96D760DDB0F,15143,12,15,3,18,7,907
63720,63720,E02F64059E677B81EAF8B96D760DDB0F,16281,16,17,1,11,4,554
63721,63721,E02F64059E677B81EAF8B96D760DDB0F,15143,17,20,3,18,7,907
63722,63722,06DA10A5127707E5C949D4A6A9073869,42871,3,5,2,30,45,1545
63723,63723,06DA10A5127707E5C949D4A6A9073869,42531,8,9,1,31,45,1595
63724,63724,06DA10A5127707E5C949D4A6A9073869,42871,10,11,1,30,45,1545
63725,63725,06DA10A5127707E5C949D4A6A9073869,42471,12,13,1,35,49,1799
63726,63726,06DA10A5127707E5C949D4A6A9073869,42531,16,18,2,31,45,1595
63727,63727,06DA10A5127707E5C949D4A6A9073869,12311,20,22,2,30,44,1544
63734,63734,E51EE41655D386174398555E16D6604B,12381,0,8,8,32,48,1648
63735,63735,E51EE41655D386174398555E16D6604B,11074,12,18,6,37,47,1897
63736,63736,E51EE41655D386174398555E16D6604B,10661,21,23,2,37,49,1899
63737,63737,6B614428F8D95ECFDE2207017437E97D,19281,0,5,5,16,32,832
63738,63738,6B614428F8D95ECFDE2207017437E97D,12871,6,9,3,22,33,1133
63739,63739,6B614428F8D95ECFDE2207017437E97D,19281,10,11,1,16,32,832
63740,63740,6B614428F8D95ECFDE2207017437E97D,12871,15,18,3,22,33,1133
63741,63741,6B614428F8D95ECFDE2207017437E97D,19281,21,23,2,16,32,832
63745,63745,7861278735CDA91B9BABB196FBF7605C,43951,0,6,6,49,41,2491
63746,63746,7861278735CDA91B9BABB196FBF7605C,13951,12,17,5,47,45,2395
63747,63747,7861278735CDA91B9BABB196FBF7605C,43951,18,23,5,49,41,2491
63758,63758,2537B60C965C279B6BA27AFBCFCDD68D,11541,9,11,2,35,49,1799
63759,63759,2537B60C965C279B6BA27AFBCFCDD68D,10841,14,16,2,37,47,1897
63760,63760,2537B60C965C279B6BA27AFBCFCDD68D,11701,18,20,2,43,48,2198
63761,63761,E1D9DCC26BD9E70C84DC1D28D9FFAAE6,12641,0,16,16,10,43,543
63762,63762,E1D9DCC26BD9E70C84DC1D28D9FFAAE6,19114,17,18,1,7,43,393
63763,63763,E1D9DCC26BD9E70C84DC1D28D9FFAAE6,13091,19,20,1,20,42,1042
63778,63778,CA13573EC489EC297A1DB55BF08926BD,42231,0,14,14,37,46,1896
63779,63779,CA13573EC489EC297A1DB55BF08926BD,43951,17,19,2,49,41,2491
63780,63780,CA13573EC489EC297A1DB55BF08926BD,42231,20,23,3,37,46,1896
63781,63781,50B8E4460C6E38DE46F5A7F7239C0140,43751,0,4,4,19,48,998
63782,63782,50B8E4460C6E38DE46F5A7F7239C0140,42691,6,7,1,24,48,1248
63783,63783,50B8E4460C6E38DE46F5A7F7239C0140,43751,11,23,12,19,48,998
63784,63784,6AD981E757B177FB5B64F1D1D2EAA27F,40411,0,3,3,34,48,1748
63785,63785,6AD981E757B177FB5B64F1D1D2EAA27F,12651,6,7,1,43,47,2197
63786,63786,6AD981E757B177FB5B64F1D1D2EAA27F,10901,10,15,5,35,48,1798
63787,63787,6AD981E757B177FB5B64F1D1D2EAA27F,42961,18,20,2,35,49,1799
63788,63788,6AD981E757B177FB5B64F1D1D2EAA27F,10901,21,22,1,35,48,1798
63809,63809,88DA908BCBBD924A23915F0C35FE7D60,13314,0,4,4,31,39,1589
63810,63810,88DA908BCBBD924A23915F0C35FE7D60,12521,4,9,5,35,41,1791
63811,63811,88DA908BCBBD924A23915F0C35FE7D60,13314,12,22,10,31,39,1589
63812,63812,AA98F3536DB0C9A531CA597216F8D06C,42071,0,1,1,31,49,1599
63813,63813,AA98F3536DB0C9A531CA597216F8D06C,42623,3,6,3,22,49,1149
63814,63814,AA98F3536DB0C9A531CA597216F8D06C,42261,10,12,2,25,49,1299
63815,63815,AA98F3536DB0C9A531CA597216F8D06C,42623,14,15,1,22,49,1149
63816,63816,AA98F3536DB0C9A531CA597216F8D06C,42261,15,18,3,25,49,1299
63817,63817,AA98F3536DB0C9A531CA597216F8D06C,42623,19,20,1,22,49,1149
63818,63818,5C7F8A03755C44742187CEE0EDAF92C8,11571,0,17,17,13,46,696
63819,63819,5C7F8A03755C44742187CEE0EDAF92C8,19021,17,18,1,10,45,545
63820,63820,5C7F8A03755C44742187CEE0EDAF92C8,42521,20,22,2,31,47,1597
63821,63821,E9BD418C5A52720354B1FE19B15DAEE5,11331,0,8,8,37,48,1898
63822,63822,E9BD418C5A52720354B1FE19B15DAEE5,12021,12,15,3,37,49,1899
63823,63823,E9BD418C5A52720354B1FE19B15DAEE5,40341,16,17,1,23,49,1199
63824,63824,E9BD418C5A52720354B1FE19B15DAEE5,42221,21,23,2,38,48,1948
63825,63825,29A3C9E428978BBE2ECF8EB615AF2DD1,10924,0,8,8,43,49,2199
63826,63826,29A3C9E428978BBE2ECF8EB615AF2DD1,40381,11,12,1,32,46,1646
63827,63827,29A3C9E428978BBE2ECF8EB615AF2DD1,10924,13,18,5,43,49,2199
63828,63828,29A3C9E428978BBE2ECF8EB615AF2DD1,12131,20,21,1,32,47,1647
63829,63829,FD26A6D5BBA5F38876B2DAAB4BBFF5D0,10951,0,8,8,29,48,1498
63830,63830,FD26A6D5BBA5F38876B2DAAB4BBFF5D0,10731,9,10,1,33,47,1697
63831,63831,FD26A6D5BBA5F38876B2DAAB4BBFF5D0,12121,12,13,1,29,47,1497
63832,63832,FD26A6D5BBA5F38876B2DAAB4BBFF5D0,10951,18,20,2,29,48,1498
63833,63833,8167EF05D15F996A6B93D96BD3E78468,11001,2,7,5,42,47,2147
63834,63834,8167EF05D15F996A6B93D96BD3E78468,10521,8,11,3,41,47,2097
63835,63835,8167EF05D15F996A6B93D96BD3E78468,43481,14,18,4,39,48,1998
63836,63836,8167EF05D15F996A6B93D96BD3E78468,12514,21,22,1,38,47,1947
63837,63837,8167EF05D15F996A6B93D96BD3E78468,12511,22,23,1,39,47,1997
63838,63838,91284BBE72A4661BF1E53E3FAFD2E3D8,13651,0,8,8,30,47,1547
63839,63839,91284BBE72A4661BF1E53E3FAFD2E3D8,42523,9,11,2,31,47,1597
63840,63840,91284BBE72A4661BF1E53E3FAFD2E3D8,13651,11,13,2,30,47,1547
63841,63841,91284BBE72A4661BF1E53E3FAFD2E3D8,13341,14,16,2,44,45,2245
63842,63842,91284BBE72A4661BF1E53E3FAFD2E3D8,10295,20,23,3,30,47,1547
63843,63843,C247820FF94535A6E7B0AE8ABDC5672D,43011,1,12,11,40,42,2042
63844,63844,C247820FF94535A6E7B0AE8ABDC5672D,12221,12,18,6,43,44,2194
63845,63845,C247820FF94535A6E7B0AE8ABDC5672D,43061,22,23,1,43,46,2196
63846,63846,DDF363C64B8F6ACF3450F0B1AA087EA1,19441,0,4,4,8,46,446
63847,63847,DDF363C64B8F6ACF3450F0B1AA087EA1,19621,4,7,3,5,46,296
63848,63848,DDF363C64B8F6ACF3450F0B1AA087EA1,42041,11,12,1,10,47,547
63849,63849,DDF363C64B8F6ACF3450F0B1AA087EA1,19441,14,16,2,8,46,446
63850,63850,DDF363C64B8F6ACF3450F0B1AA087EA1,19114,16,19,3,7,43,393
63851,63851,DDF363C64B8F6ACF3450F0B1AA087EA1,19441,20,23,3,8,46,446
63852,63852,280F8FF78EE4DA7C811CECAC3A91BB36,11861,0,8,8,32,47,1647
63853,63853,280F8FF78EE4DA7C811CECAC3A91BB36,12491,9,11,2,36,43,1843
63854,63854,280F8FF78EE4DA7C811CECAC3A91BB36,42531,11,13,2,31,45,1595
63855,63855,280F8FF78EE4DA7C811CECAC3A91BB36,42151,14,16,2,35,45,1795
63856,63856,280F8FF78EE4DA7C811CECAC3A91BB36,42531,16,17,1,31,45,1595
63857,63857,280F8FF78EE4DA7C811CECAC3A91BB36,11861,18,23,5,32,47,1647
63858,63858,AF57FD742700B6DD506E3D60F4DB6DD5,13351,0,11,11,48,48,2448
63859,63859,AF57FD742700B6DD506E3D60F4DB6DD5,13471,12,14,2,47,49,2399
63860,63860,AF57FD742700B6DD506E3D60F4DB6DD5,13101,15,17,2,40,47,2047
63861,63861,AF57FD742700B6DD506E3D60F4DB6DD5,11661,19,22,3,40,49,2049
63862,63862,8671664FCEA72D44791A077CF27C82B3,12921,3,13,10,9,41,491
63863,63863,8671664FCEA72D44791A077CF27C82B3,43021,14,17,3,16,43,843
63864,63864,8671664FCEA72D44791A077CF27C82B3,12921,21,23,2,9,41,491
63868,63868,64A9FFE7519C55981E8239DF182FAEB6,13561,0,9,9,37,49,1899
63869,63869,64A9FFE7519C55981E8239DF182FAEB6,43621,18,20,2,46,48,2348
63870,63870,64A9FFE7519C55981E8239DF182FAEB6,12971,21,23,2,32,48,1648
63871,63871,541F648F1B8E5FD6A32D32095FA2CB17,43581,0,6,6,33,48,1698
63872,63872,541F648F1B8E5FD6A32D32095FA2CB17,42941,8,14,6,37,47,1897
63873,63873,541F648F1B8E5FD6A32D32095FA2CB17,43581,17,20,3,33,48,1698
63874,63874,541F648F1B8E5FD6A32D32095FA2CB17,12083,20,23,3,36,49,1849
63878,63878,EF91711DC8C252AD8DF41B40BCB4AA29,42541,0,3,3,25,47,1297
63879,63879,EF91711DC8C252AD8DF41B40BCB4AA29,11111,5,8,3,26,48,1348
63880,63880,EF91711DC8C252AD8DF41B40BCB4AA29,43761,9,11,2,32,47,1647
63881,63881,EF91711DC8C252AD8DF41B40BCB4AA29,11481,13,15,2,41,48,2098
63882,63882,EF91711DC8C252AD8DF41B40BCB4AA29,11701,16,17,1,43,48,2198
63883,63883,EF91711DC8C252AD8DF41B40BCB4AA29,40341,19,21,2,23,49,1199
63887,63887,400659CE2E6F8BFF6D95D6F52F73DF5B,42921,0,6,6,33,47,1697
63888,63888,400659CE2E6F8BFF6D95D6F52F73DF5B,11861,6,8,2,32,47,1647
63889,63889,400659CE2E6F8BFF6D95D6F52F73DF5B,42921,10,13,3,33,47,1697
63890,63890,400659CE2E6F8BFF6D95D6F52F73DF5B,11861,13,19,6,32,47,1647
63891,63891,400659CE2E6F8BFF6D95D6F52F73DF5B,42921,21,23,2,33,47,1697
63892,63892,8AC8B1E6CB950C4620C9ADD9BF2E2AE1,42071,0,5,5,31,49,1599
63893,63893,8AC8B1E6CB950C4620C9ADD9BF2E2AE1,11151,16,18,2,30,48,1548
63894,63894,8AC8B1E6CB950C4620C9ADD9BF2E2AE1,42281,20,23,3,40,48,2048
63895,63895,59D8DE6CCA1C8C60E0FF5545DF1DAE9D,11431,0,10,10,29,47,1497
63896,63896,59D8DE6CCA1C8C60E0FF5545DF1DAE9D,12514,11,12,1,38,47,1947
63897,63897,59D8DE6CCA1C8C60E0FF5545DF1DAE9D,11431,13,19,6,29,47,1497
63898,63898,59D8DE6CCA1C8C60E0FF5545DF1DAE9D,11781,20,21,1,38,49,1949
63909,63909,4EDC19CD93919058B04A382B8B329FC1,11074,0,7,7,37,47,1897
63910,63910,4EDC19CD93919058B04A382B8B329FC1,11481,10,11,1,41,48,2098
63911,63911,4EDC19CD93919058B04A382B8B329FC1,10841,14,20,6,37,47,1897
63912,63912,99D2FDE591A4B0AB59A92F0D027D6568,10601,0,7,7,39,47,1997
63913,63913,99D2FDE591A4B0AB59A92F0D027D6568,10251,8,9,1,35,47,1797
63914,63914,99D2FDE591A4B0AB59A92F0D027D6568,42401,9,13,4,36,47,1847
63915,63915,99D2FDE591A4B0AB59A92F0D027D6568,10111,13,15,2,37,47,1897
63916,63916,99D2FDE591A4B0AB59A92F0D027D6568,10251,17,18,1,35,47,1797
63917,63917,99D2FDE591A4B0AB59A92F0D027D6568,13011,20,23,3,39,47,1997
63918,63918,BF33FC216018FCEE58E02CD2AA5B5470,15401,0,6,6,39,25,1975
63919,63919,BF33FC216018FCEE58E02CD2AA5B5470,15331,6,8,2,38,24,1924
63920,63920,BF33FC216018FCEE58E02CD2AA5B5470,40341,15,17,2,23,49,1199
63921,63921,BF33FC216018FCEE58E02CD2AA5B5470,15401,21,23,2,39,25,1975
63925,63925,71406CAB7DAA1D3016D1EDF130C6F573,10491,0,6,6,33,48,1698
63926,63926,71406CAB7DAA1D3016D1EDF130C6F573,10431,11,12,1,33,49,1699
63927,63927,71406CAB7DAA1D3016D1EDF130C6F573,42491,13,14,1,32,46,1646
63928,63928,71406CAB7DAA1D3016D1EDF130C6F573,42021,15,17,2,33,47,1697
63929,63929,71406CAB7DAA1D3016D1EDF130C6F573,10491,18,23,5,33,48,1698
63930,63930,6328F7CDE1FD4A3418797D65E47142EC,42691,9,12,3,24,48,1248
63931,63931,6328F7CDE1FD4A3418797D65E47142EC,12051,12,16,4,20,47,1047
63932,63932,6328F7CDE1FD4A3418797D65E47142EC,42501,16,20,4,28,47,1447
63933,63933,6328F7CDE1FD4A3418797D65E47142EC,19031,20,23,3,1,42,92
63934,63934,40869A2D236BB613CA374F75D6D7BD2E,42301,0,5,5,36,47,1847
63935,63935,40869A2D236BB613CA374F75D6D7BD2E,11701,8,10,2,43,48,2198
63936,63936,40869A2D236BB613CA374F75D6D7BD2E,40691,13,14,1,42,48,2148
63937,63937,40869A2D236BB613CA374F75D6D7BD2E,11701,15,20,5,43,48,2198
63938,63938,40869A2D236BB613CA374F75D6D7BD2E,42301,22,23,1,36,47,1847
63939,63939,D9FB4B7A1A81D0A30B6556214B953AB1,42711,0,9,9,26,48,1348
63940,63940,D9FB4B7A1A81D0A30B6556214B953AB1,11641,10,16,6,22,49,1149
63941,63941,D9FB4B7A1A81D0A30B6556214B953AB1,42691,19,21,2,24,48,1248
63951,63951,ED329B71006D1766A598ADE6F5BD2F71,11321,0,6,6,31,46,1596
63952,63952,ED329B71006D1766A598ADE6F5BD2F71,12311,7,10,3,30,44,1544
63953,63953,ED329B71006D1766A598ADE6F5BD2F71,11321,11,13,2,31,46,1596
63954,63954,ED329B71006D1766A598ADE6F5BD2F71,12311,14,17,3,30,44,1544
63955,63955,ED329B71006D1766A598ADE6F5BD2F71,11321,19,23,4,31,46,1596
63959,63959,0933B06061F8F3536F06AEF0D300106F,11941,0,8,8,37,46,1896
63960,63960,0933B06061F8F3536F06AEF0D300106F,10107,12,13,1,38,49,1949
63961,63961,0933B06061F8F3536F06AEF0D300106F,13711,13,18,5,38,46,1946
63962,63962,0933B06061F8F3536F06AEF0D300106F,11941,19,20,1,37,46,1896
63963,63963,0933B06061F8F3536F06AEF0D300106F,13711,21,22,1,38,46,1946
63964,63964,DE735024253C8C734B51C6AEBDF59E03,10491,0,11,11,33,48,1698
63965,63965,DE735024253C8C734B51C6AEBDF59E03,40341,12,17,5,23,49,1199
63966,63966,DE735024253C8C734B51C6AEBDF59E03,10491,18,22,4,33,48,1698
63967,63967,17B310C5C0CD98D91D2EAE008E1E6775,42491,0,14,14,32,46,1646
63968,63968,17B310C5C0CD98D91D2EAE008E1E6775,12401,15,17,2,39,49,1999
63969,63969,17B310C5C0CD98D91D2EAE008E1E6775,42491,18,20,2,32,46,1646
63970,63970,17B310C5C0CD98D91D2EAE008E1E6775,11751,21,23,2,35,48,1798
63974,63974,D27AD15B109272EBC96B3A5E9E02000F,42861,1,3,2,37,44,1894
63975,63975,D27AD15B109272EBC96B3A5E9E02000F,13911,4,5,1,39,46,1996
63976,63976,D27AD15B109272EBC96B3A5E9E02000F,11261,6,8,2,36,46,1846
63977,63977,D27AD15B109272EBC96B3A5E9E02000F,12491,8,10,2,36,43,1843
63978,63978,D27AD15B109272EBC96B3A5E9E02000F,11261,10,20,10,36,46,1846
63979,63979,DAE197CEBF1E1EC8C00EDC17E5E96BDF,11271,3,5,2,37,48,1898
63980,63980,DAE197CEBF1E1EC8C00EDC17E5E96BDF,10381,5,13,8,31,49,1599
63981,63981,DAE197CEBF1E1EC8C00EDC17E5E96BDF,40341,16,20,4,23,49,1199
63982,63982,DAE197CEBF1E1EC8C00EDC17E5E96BDF,11211,21,23,2,34,49,1749
63989,63989,4FB7544A1E67AE742452DB3735E5F7CF,10771,4,6,2,41,46,2096
63990,63990,4FB7544A1E67AE742452DB3735E5F7CF,43951,7,10,3,49,41,2491
63991,63991,4FB7544A1E67AE742452DB3735E5F7CF,42631,13,15,2,43,45,2195
63992,63992,4FB7544A1E67AE742452DB3735E5F7CF,12561,15,17,2,45,43,2293
63993,63993,4FB7544A1E67AE742452DB3735E5F7CF,10771,18,22,4,41,46,2096
63994,63994,445A90121514A82FCCD431DD3088A581,42921,1,5,4,33,47,1697
63995,63995,445A90121514A82FCCD431DD3088A581,40637,6,8,2,36,47,1847
63996,63996,445A90121514A82FCCD431DD3088A581,42921,8,10,2,33,47,1697
63997,63997,445A90121514A82FCCD431DD3088A581,11861,10,16,6,32,47,1647
63998,63998,445A90121514A82FCCD431DD3088A581,10107,19,20,1,38,49,1949
63999,63999,D1C734A887FEA6FA5FA72DD89F2DF0BE,43391,0,8,8,29,48,1498
64000,64000,D1C734A887FEA6FA5FA72DD89F2DF0BE,11751,8,11,3,35,48,1798
64001,64001,D1C734A887FEA6FA5FA72DD89F2DF0BE,43391,12,16,4,29,48,1498
64002,64002,D1C734A887FEA6FA5FA72DD89F2DF0BE,11751,17,21,4,35,48,1798
64009,64009,134DE55405BEF261D5BD51612163C60F,19441,0,7,7,8,46,446
64010,64010,134DE55405BEF261D5BD51612163C60F,42041,9,18,9,10,47,547
64011,64011,134DE55405BEF261D5BD51612163C60F,11021,21,22,1,36,49,1849
64015,64015,1D9DFB17A52C3A50FBCA11AE1C46CF31,13111,0,8,8,42,46,2146
64016,64016,1D9DFB17A52C3A50FBCA11AE1C46CF31,13951,9,11,2,47,45,2395
64017,64017,1D9DFB17A52C3A50FBCA11AE1C46CF31,10471,11,15,4,37,48,1898
64018,64018,1D9DFB17A52C3A50FBCA11AE1C46CF31,13111,17,23,6,42,46,2146
64019,64019,CA5A17D561EB9E25269F629C4481540B,19441,1,13,12,8,46,446
64020,64020,CA5A17D561EB9E25269F629C4481540B,11571,14,19,5,13,46,696
64021,64021,CA5A17D561EB9E25269F629C4481540B,19441,19,21,2,8,46,446
64022,64022,0402987D46A940B2D062ECAC79227896,19741,0,8,8,5,44,294
64023,64023,0402987D46A940B2D062ECAC79227896,43761,10,14,4,32,47,1647
64024,64024,0402987D46A940B2D062ECAC79227896,19741,15,23,8,5,44,294
64025,64025,C992F2C09A20796F8964115F6C03FAB6,40891,0,11,11,37,47,1897
64026,64026,C992F2C09A20796F8964115F6C03FAB6,42311,14,15,1,41,46,2096
64027,64027,C992F2C09A20796F8964115F6C03FAB6,13094,16,18,2,21,42,1092
64028,64028,C992F2C09A20796F8964115F6C03FAB6,41101,21,22,1,32,48,1648
64029,64029,DAD4C4CCB9D717CA848AB20853599079,42523,0,5,5,31,47,1597
64030,64030,DAD4C4CCB9D717CA848AB20853599079,42121,7,11,4,26,49,1349
64031,64031,DAD4C4CCB9D717CA848AB20853599079,42523,12,13,1,31,47,1597
64032,64032,DAD4C4CCB9D717CA848AB20853599079,42121,15,19,4,26,49,1349
64033,64033,DAD4C4CCB9D717CA848AB20853599079,42801,19,20,1,40,49,2049
64040,64040,8376D19E65EF2C30F16F6D8DCBD4B812,10221,2,10,8,34,49,1749
64041,64041,8376D19E65EF2C30F16F6D8DCBD4B812,12381,12,14,2,32,48,1648
64042,64042,8376D19E65EF2C30F16F6D8DCBD4B812,42471,18,20,2,35,49,1799
64043,64043,8376D19E65EF2C30F16F6D8DCBD4B812,11701,21,23,2,43,48,2198
64048,64048,D86DEEF11DACD3E50F1ED6647E18D8F1,11081,0,6,6,35,46,1796
64049,64049,D86DEEF11DACD3E50F1ED6647E18D8F1,11381,6,13,7,30,47,1547
64050,64050,D86DEEF11DACD3E50F1ED6647E18D8F1,10107,14,15,1,38,49,1949
64051,64051,D86DEEF11DACD3E50F1ED6647E18D8F1,10511,16,23,7,35,46,1796
64052,64052,E6E1B072EE7202225510F5B63E9E6AA7,42221,0,6,6,38,48,1948
64053,64053,E6E1B072EE7202225510F5B63E9E6AA7,42121,8,18,10,26,49,1349
64054,64054,E6E1B072EE7202225510F5B63E9E6AA7,13011,20,21,1,39,47,1997
64055,64055,E6E1B072EE7202225510F5B63E9E6AA7,11074,22,23,1,37,47,1897
64059,64059,27F132E818644D3933B7D51A13F3BE57,13781,2,3,1,48,32,2432
64060,64060,27F132E818644D3933B7D51A13F3BE57,15391,8,9,1,35,26,1776
64061,64061,27F132E818644D3933B7D51A13F3BE57,15661,11,13,2,36,26,1826
64062,64062,27F132E818644D3933B7D51A13F3BE57,15391,13,15,2,35,26,1776
64063,64063,27F132E818644D3933B7D51A13F3BE57,15411,18,22,4,44,27,2227
64084,64084,823BB637426A4B64F4A56D087D45C241,49201,0,7,7,7,41,391
64085,64085,823BB637426A4B64F4A56D087D45C241,12921,7,9,2,9,41,491
64086,64086,823BB637426A4B64F4A56D087D45C241,19181,12,13,1,8,40,440
64087,64087,823BB637426A4B64F4A56D087D45C241,49201,15,16,1,7,41,391
64088,64088,823BB637426A4B64F4A56D087D45C241,12921,20,22,2,9,41,491
64093,64093,E7D13D922A1B600C3FF10C90AE32F045,13911,0,8,8,39,46,1996
64094,64094,E7D13D922A1B600C3FF10C90AE32F045,12491,10,18,8,36,43,1843
64095,64095,E7D13D922A1B600C3FF10C90AE32F045,13331,19,20,1,38,47,1947
64103,64103,BA6468A84C81B4949B332F392AF7BE2D,40833,1,9,8,41,47,2097
64104,64104,BA6468A84C81B4949B332F392AF7BE2D,12311,11,13,2,30,44,1544
64105,64105,BA6468A84C81B4949B332F392AF7BE2D,13101,15,22,7,40,47,2047
64109,64109,21A180321800B594D0DD89707450AB6F,42583,1,5,4,40,48,2048
64110,64110,21A180321800B594D0DD89707450AB6F,13481,7,13,6,26,31,1331
64111,64111,21A180321800B594D0DD89707450AB6F,42583,14,16,2,40,48,2048
64112,64112,21A180321800B594D0DD89707450AB6F,42941,18,20,2,37,47,1897
64113,64113,21A180321800B594D0DD89707450AB6F,11491,21,22,1,36,47,1847
64114,64114,BDBB21AEE3790F9ACB8B206867A4B001,13314,0,6,6,31,39,1589
64115,64115,BDBB21AEE3790F9ACB8B206867A4B001,12521,6,17,11,35,41,1791
64116,64116,BDBB21AEE3790F9ACB8B206867A4B001,13314,19,23,4,31,39,1589
64117,64117,B714BB514E86FE03FE7F7627EB47ACB6,11651,0,9,9,33,47,1697
64118,64118,B714BB514E86FE03FE7F7627EB47ACB6,19021,12,14,2,10,45,545
64119,64119,B714BB514E86FE03FE7F7627EB47ACB6,12311,15,17,2,30,44,1544
64120,64120,B714BB514E86FE03FE7F7627EB47ACB6,12601,20,22,2,25,47,1297
64121,64121,5D9A09786F570CED3C296C81274238B5,12521,6,16,10,35,41,1791
64122,64122,5D9A09786F570CED3C296C81274238B5,13314,19,21,2,31,39,1589
64123,64123,5D9A09786F570CED3C296C81274238B5,12521,22,23,1,35,41,1791
64124,64124,AB33B0C33D5A8AB69BB147D674F32282,19744,1,2,1,6,43,343
64125,64125,AB33B0C33D5A8AB69BB147D674F32282,12641,2,3,1,10,43,543
64126,64126,AB33B0C33D5A8AB69BB147D674F32282,19931,5,6,1,7,43,393
64127,64127,AB33B0C33D5A8AB69BB147D674F32282,12641,7,12,5,10,43,543
64128,64128,AB33B0C33D5A8AB69BB147D674F32282,19744,18,20,2,6,43,343
64129,64129,AB33B0C33D5A8AB69BB147D674F32282,19031,21,22,1,1,42,92
64142,64142,7E23708DF428068CC3C502A016CDF44C,11321,0,16,16,31,46,1596
64143,64143,7E23708DF428068CC3C502A016CDF44C,10471,18,20,2,37,48,1898
64144,64144,7E23708DF428068CC3C502A016CDF44C,11321,21,23,2,31,46,1596
64148,64148,024AB2D90319DF57F94996854D076E3D,40833,0,13,13,41,47,2097
64149,64149,024AB2D90319DF57F94996854D076E3D,11541,14,16,2,35,49,1799
64150,64150,024AB2D90319DF57F94996854D076E3D,12131,16,17,1,32,47,1647
64151,64151,024AB2D90319DF57F94996854D076E3D,13271,21,23,2,41,47,2097
64155,64155,39A12A7E8C423731CE90191A15A5C3F4,43021,0,5,5,16,43,843
64156,64156,39A12A7E8C423731CE90191A15A5C3F4,12921,9,10,1,9,41,491
64157,64157,39A12A7E8C423731CE90191A15A5C3F4,43021,12,13,1,16,43,843
64158,64158,39A12A7E8C423731CE90191A15A5C3F4,12921,16,18,2,9,41,491
64159,64159,42450E4607B078BD3F39C67BF93F8737,10451,1,8,7,25,48,1298
64160,64160,42450E4607B078BD3F39C67BF93F8737,42711,9,13,4,26,48,1348
64161,64161,42450E4607B078BD3F39C67BF93F8737,42581,16,18,2,38,48,1948
64162,64162,42450E4607B078BD3F39C67BF93F8737,10431,19,21,2,33,49,1699
64163,64163,42450E4607B078BD3F39C67BF93F8737,10221,21,22,1,34,49,1749
64176,64176,1C11E829C965E98C9AACE0FB801A921E,42021,0,13,13,33,47,1697
64177,64177,1C11E829C965E98C9AACE0FB801A921E,42191,14,16,2,38,49,1949
64178,64178,1C11E829C965E98C9AACE0FB801A921E,42921,18,23,5,33,47,1697
64179,64179,C7D4935453BFEC1CB164593EE1B84EA4,15391,0,10,10,35,26,1776
64180,64180,C7D4935453BFEC1CB164593EE1B84EA4,12792,11,12,1,34,30,1730
64181,64181,C7D4935453BFEC1CB164593EE1B84EA4,15391,17,23,6,35,26,1776
64185,64185,48E15F7773EDEEFF950E5A2CE7CBD12F,11321,0,5,5,31,46,1596
64186,64186,48E15F7773EDEEFF950E5A2CE7CBD12F,13671,6,13,7,27,43,1393
64187,64187,48E15F7773EDEEFF950E5A2CE7CBD12F,12641,16,17,1,10,43,543
64188,64188,48E15F7773EDEEFF950E5A2CE7CBD12F,11321,20,22,2,31,46,1596
64199,64199,78F7FD1E2500A38B2C1DE46278C057AF,12514,8,10,2,38,47,1947
64200,64200,78F7FD1E2500A38B2C1DE46278C057AF,42511,11,16,5,37,47,1897
64201,64201,78F7FD1E2500A38B2C1DE46278C057AF,40341,18,20,2,23,49,1199
64202,64202,78F7FD1E2500A38B2C1DE46278C057AF,12514,21,22,1,38,47,1947
64203,64203,4A1E2DF13E9399DEAE7966E1EFE6FC6B,13941,0,4,4,41,47,2097
64204,64204,4A1E2DF13E9399DEAE7966E1EFE6FC6B,42871,6,8,2,30,45,1545
64205,64205,4A1E2DF13E9399DEAE7966E1EFE6FC6B,42151,8,10,2,35,45,1795
64206,64206,4A1E2DF13E9399DEAE7966E1EFE6FC6B,42861,10,11,1,37,44,1894
64207,64207,4A1E2DF13E9399DEAE7966E1EFE6FC6B,42151,12,13,1,35,45,1795
64208,64208,4A1E2DF13E9399DEAE7966E1EFE6FC6B,11481,15,18,3,41,48,2098
64209,64209,4A1E2DF13E9399DEAE7966E1EFE6FC6B,13271,19,23,4,41,47,2097
64213,64213,EB78CE17EE1992DBCDC597ED4B236EB9,12601,10,16,6,25,47,1297
64214,64214,EB78CE17EE1992DBCDC597ED4B236EB9,10501,16,20,4,22,46,1146
64215,64215,EB78CE17EE1992DBCDC597ED4B236EB9,13511,21,23,2,34,48,1748
64223,64223,21E01FD73F60A460B78DB5B37A75E13F,12561,8,10,2,45,43,2293
64224,64224,21E01FD73F60A460B78DB5B37A75E13F,43951,15,16,1,49,41,2491
64225,64225,21E01FD73F60A460B78DB5B37A75E13F,12561,19,22,3,45,43,2293
64229,64229,428B188218234958DE1D29D91C2ACBA1,12601,0,11,11,25,47,1297
64230,64230,428B188218234958DE1D29D91C2ACBA1,11751,16,17,1,35,48,1798
64231,64231,428B188218234958DE1D29D91C2ACBA1,40951,17,18,1,36,49,1849
64232,64232,428B188218234958DE1D29D91C2ACBA1,12601,20,22,2,25,47,1297
64237,64237,76B5A35D98B8893850740B68B6528B2B,42321,0,2,2,43,47,2197
64238,64238,76B5A35D98B8893850740B68B6528B2B,10801,5,7,2,42,47,2147
64239,64239,76B5A35D98B8893850740B68B6528B2B,42321,8,15,7,43,47,2197
64240,64240,76B5A35D98B8893850740B68B6528B2B,40341,18,21,3,23,49,1199
64247,64247,7DF20745CA3702FAFFAC0138B1B2E95E,11231,0,8,8,37,49,1899
64248,64248,7DF20745CA3702FAFFAC0138B1B2E95E,13821,11,12,1,49,45,2495
64249,64249,7DF20745CA3702FAFFAC0138B1B2E95E,13561,14,21,7,37,49,1899
64263,64263,B8898C497E6ED0E8DDEA262D08B9F0FE,40981,6,7,1,34,47,1747
64264,64264,B8898C497E6ED0E8DDEA262D08B9F0FE,42401,10,11,1,36,47,1847
64265,64265,B8898C497E6ED0E8DDEA262D08B9F0FE,43731,13,17,4,34,47,1747
64266,64266,B8898C497E6ED0E8DDEA262D08B9F0FE,11531,20,21,1,34,49,1749
64267,64267,B8898C497E6ED0E8DDEA262D08B9F0FE,43731,21,23,2,34,47,1747
64271,64271,2075B4FB25DAADC66CD593580F270747,11801,1,10,9,42,48,2148
64272,64272,2075B4FB25DAADC66CD593580F270747,11751,11,13,2,35,48,1798
64273,64273,2075B4FB25DAADC66CD593580F270747,40361,15,23,8,42,48,2148
64274,64274,ABA306CA497592C3E24A3217BA4072DF,43041,2,6,4,41,46,2096
64275,64275,ABA306CA497592C3E24A3217BA4072DF,42221,7,8,1,38,48,1948
64276,64276,ABA306CA497592C3E24A3217BA4072DF,12514,11,12,1,38,47,1947
64277,64277,ABA306CA497592C3E24A3217BA4072DF,42221,16,17,1,38,48,1948
64278,64278,ABA306CA497592C3E24A3217BA4072DF,43041,18,22,4,41,46,2096
64279,64279,ED54D9A6448FF51B585DC3225EB6058D,19181,0,6,6,8,40,440
64280,64280,ED54D9A6448FF51B585DC3225EB6058D,43644,10,21,11,14,38,738
64281,64281,ED54D9A6448FF51B585DC3225EB6058D,19181,21,22,1,8,40,440
64285,64285,EA84EDCB7C9475F6273168934FDD6476,19441,1,7,6,8,46,446
64286,64286,EA84EDCB7C9475F6273168934FDD6476,42041,10,11,1,10,47,547
64287,64287,EA84EDCB7C9475F6273168934FDD6476,19441,11,16,5,8,46,446
64288,64288,EA84EDCB7C9475F6273168934FDD6476,11571,17,19,2,13,46,696
64289,64289,EA84EDCB7C9475F6273168934FDD6476,19114,19,20,1,7,43,393
64290,64290,EA84EDCB7C9475F6273168934FDD6476,19441,21,23,2,8,46,446
64291,64291,8CD5156CF883DA15618BAFE58DDCF2A7,42581,0,6,6,38,48,1948
64292,64292,8CD5156CF883DA15618BAFE58DDCF2A7,10471,10,11,1,37,48,1898
64293,64293,8CD5156CF883DA15618BAFE58DDCF2A7,42581,12,15,3,38,48,1948
64294,64294,8CD5156CF883DA15618BAFE58DDCF2A7,11914,15,18,3,37,48,1898
64295,64295,8CD5156CF883DA15618BAFE58DDCF2A7,42581,22,23,1,38,48,1948
64296,64296,D7349708A10855AEF98FEB8D22C33E59,40833,0,7,7,41,47,2097
64297,64297,D7349708A10855AEF98FEB8D22C33E59,11231,12,18,6,37,49,1899
64298,64298,D7349708A10855AEF98FEB8D22C33E59,40833,20,23,3,41,47,2097
64313,64313,DA89C441D646E086826B181431451536,43341,0,8,8,41,46,2096
64314,64314,DA89C441D646E086826B181431451536,40341,9,13,4,23,49,1199
64315,64315,DA89C441D646E086826B181431451536,40691,15,16,1,42,48,2148
64316,64316,DA89C441D646E086826B181431451536,43341,17,23,6,41,46,2096
64317,64317,558E528B130FFE9671BD3B55BDB9C2B6,19441,0,11,11,8,46,446
64318,64318,558E528B130FFE9671BD3B55BDB9C2B6,42041,11,14,3,10,47,547
64319,64319,558E528B130FFE9671BD3B55BDB9C2B6,19441,14,16,2,8,46,446
64320,64320,558E528B130FFE9671BD3B55BDB9C2B6,42041,16,19,3,10,47,547
64321,64321,558E528B130FFE9671BD3B55BDB9C2B6,19441,20,23,3,8,46,446
64322,64322,92E1BAA88B052422B820ED36A9E8F107,41392,0,14,14,43,48,2198
64323,64323,92E1BAA88B052422B820ED36A9E8F107,11271,15,18,3,37,48,1898
64324,64324,92E1BAA88B052422B820ED36A9E8F107,41392,19,23,4,43,48,2198
64325,64325,2917A11EB625CB868E9962150273A0D4,13671,0,10,10,27,43,1393
64326,64326,2917A11EB625CB868E9962150273A0D4,10301,12,14,2,31,45,1595
64327,64327,2917A11EB625CB868E9962150273A0D4,10471,17,19,2,37,48,1898
64328,64328,2917A11EB625CB868E9962150273A0D4,10301,21,23,2,31,45,1595
64329,64329,ACD04627348D28EB014FAB46490D4B92,10351,3,8,5,28,45,1445
64330,64330,ACD04627348D28EB014FAB46490D4B92,12601,8,14,6,25,47,1297
64331,64331,ACD04627348D28EB014FAB46490D4B92,13771,15,17,2,21,45,1095
64332,64332,ACD04627348D28EB014FAB46490D4B92,10501,20,21,1,22,46,1146
64333,64333,ACD04627348D28EB014FAB46490D4B92,12601,21,23,2,25,47,1297
64334,64334,B2DA3C1B549D7309C9D7406F9BC72847,42321,2,4,2,43,47,2197
64335,64335,B2DA3C1B549D7309C9D7406F9BC72847,13791,4,7,3,42,47,2147
64336,64336,B2DA3C1B549D7309C9D7406F9BC72847,42321,7,17,10,43,47,2197
64337,64337,B2DA3C1B549D7309C9D7406F9BC72847,13791,18,19,1,42,47,2147
64338,64338,B2DA3C1B549D7309C9D7406F9BC72847,42321,22,23,1,43,47,2197
64339,64339,4B5C492CF16B079882322240829D6566,11271,0,4,4,37,48,1898
64340,64340,4B5C492CF16B079882322240829D6566,42191,4,6,2,38,49,1949
64341,64341,4B5C492CF16B079882322240829D6566,11231,6,14,8,37,49,1899
64342,64342,4B5C492CF16B079882322240829D6566,10221,15,16,1,34,49,1749
64343,64343,4B5C492CF16B079882322240829D6566,11231,16,19,3,37,49,1899
64344,64344,4B5C492CF16B079882322240829D6566,10471,19,21,2,37,48,1898
64345,64345,4B5C492CF16B079882322240829D6566,11231,21,23,2,37,49,1899
64346,64346,F17FA2BD0CF3F60546423A323C9B3C80,43751,0,5,5,19,48,998
64347,64347,F17FA2BD0CF3F60546423A323C9B3C80,10451,6,18,12,25,48,1298
64348,64348,F17FA2BD0CF3F60546423A323C9B3C80,11361,22,23,1,22,48,1148
64353,64353,85FD0824809DD36E6F4EE776DF75318A,12083,0,7,7,36,49,1849
64354,64354,85FD0824809DD36E6F4EE776DF75318A,42641,10,12,2,33,49,1699
64355,64355,85FD0824809DD36E6F4EE776DF75318A,40343,15,16,1,24,49,1249
64356,64356,85FD0824809DD36E6F4EE776DF75318A,12391,20,23,3,36,49,1849
64360,64360,1B1161CB64D4F33B625617AD87ACE363,19621,0,8,8,5,46,296
64361,64361,1B1161CB64D4F33B625617AD87ACE363,11061,9,19,10,29,48,1498
64362,64362,1B1161CB64D4F33B625617AD87ACE363,43971,20,22,2,30,48,1548
64369,64369,8A51E1903C4D12FB1E8FB98699BED268,43644,0,6,6,14,38,738
64370,64370,8A51E1903C4D12FB1E8FB98699BED268,12921,8,9,1,9,41,491
64371,64371,8A51E1903C4D12FB1E8FB98699BED268,49201,12,23,11,7,41,391
64375,64375,0E4B3B25FE0CAB1DCA768980553C13E7,42791,0,8,8,35,45,1795
64376,64376,0E4B3B25FE0CAB1DCA768980553C13E7,19021,9,17,8,10,45,545
64377,64377,0E4B3B25FE0CAB1DCA768980553C13E7,12661,18,21,3,32,45,1645
64378,64378,0E4B3B25FE0CAB1DCA768980553C13E7,42791,22,23,1,35,45,1795
64379,64379,8436FA510D59B3814E50B7F18BD1D92C,12641,9,10,1,10,43,543
64380,64380,8436FA510D59B3814E50B7F18BD1D92C,43644,11,13,2,14,38,738
64381,64381,8436FA510D59B3814E50B7F18BD1D92C,12641,14,19,5,10,43,543
64382,64382,8436FA510D59B3814E50B7F18BD1D92C,43644,20,23,3,14,38,738
64389,64389,9552ADEB6DCDC64B46CF1570AC45DA60,13411,0,11,11,49,42,2492
64390,64390,9552ADEB6DCDC64B46CF1570AC45DA60,12561,14,18,4,45,43,2293
64391,64391,9552ADEB6DCDC64B46CF1570AC45DA60,13411,21,23,2,49,42,2492
64395,64395,B587C9E11BF2CDFAA894E59FA9E36E12,12311,0,2,2,30,44,1544
64396,64396,B587C9E11BF2CDFAA894E59FA9E36E12,42151,4,16,12,35,45,1795
64397,64397,B587C9E11BF2CDFAA894E59FA9E36E12,12311,17,21,4,30,44,1544
64398,64398,2DF528642956EE7F281EE1C987DEF31F,10271,0,8,8,37,46,1896
64399,64399,2DF528642956EE7F281EE1C987DEF31F,13121,9,10,1,38,46,1946
64400,64400,2DF528642956EE7F281EE1C987DEF31F,10271,12,14,2,37,46,1896
64401,64401,2DF528642956EE7F281EE1C987DEF31F,43241,14,16,2,36,46,1846
64402,64402,2DF528642956EE7F281EE1C987DEF31F,13711,17,21,4,38,46,1946
64403,64403,2FC977AAECB05F28AE0C53353C4DD1FC,13121,0,1,1,38,46,1946
64404,64404,2FC977AAECB05F28AE0C53353C4DD1FC,10271,3,8,5,37,46,1896
64405,64405,2FC977AAECB05F28AE0C53353C4DD1FC,13711,8,9,1,38,46,1946
64406,64406,2FC977AAECB05F28AE0C53353C4DD1FC,40691,13,14,1,42,48,2148
64407,64407,2FC977AAECB05F28AE0C53353C4DD1FC,13711,16,23,7,38,46,1946
64411,64411,82982FDED88A128DD095DBAD32562CF7,11021,0,8,8,36,49,1849
64412,64412,82982FDED88A128DD095DBAD32562CF7,10501,9,10,1,22,46,1146
64413,64413,82982FDED88A128DD095DBAD32562CF7,12601,10,14,4,25,47,1297
64414,64414,82982FDED88A128DD095DBAD32562CF7,12391,16,23,7,36,49,1849
64415,64415,980A9577BEF7CF37F3066AF55CE621DF,43061,0,6,6,43,46,2196
64416,64416,980A9577BEF7CF37F3066AF55CE621DF,11941,11,12,1,37,46,1896
64417,64417,980A9577BEF7CF37F3066AF55CE621DF,13711,14,17,3,38,46,1946
64418,64418,980A9577BEF7CF37F3066AF55CE621DF,43061,21,22,1,43,46,2196
64419,64419,AD3EE3BD5870AF753A3A96B6C340F5E0,10611,1,10,9,32,48,1648
64420,64420,AD3EE3BD5870AF753A3A96B6C340F5E0,11381,12,15,3,30,47,1547
64421,64421,AD3EE3BD5870AF753A3A96B6C340F5E0,11791,19,23,4,38,49,1949
64426,64426,477345C6A2CD3C952FF4D82E4FC5D93D,43731,0,14,14,34,47,1747
64427,64427,477345C6A2CD3C952FF4D82E4FC5D93D,11161,15,17,2,32,48,1648
64428,64428,477345C6A2CD3C952FF4D82E4FC5D93D,40341,18,21,3,23,49,1199
64432,64432,4A05C11F924E5E77EEF26908B87D29D6,12031,0,7,7,33,48,1698
64433,64433,4A05C11F924E5E77EEF26908B87D29D6,12521,11,15,4,35,41,1791
64434,64434,4A05C11F924E5E77EEF26908B87D29D6,10881,19,23,4,34,48,1748
64435,64435,1C0548F40841AD0870DAD8EC7BECCBC6,13314,0,6,6,31,39,1589
64436,64436,1C0548F40841AD0870DAD8EC7BECCBC6,12521,9,10,1,35,41,1791
64437,64437,1C0548F40841AD0870DAD8EC7BECCBC6,13314,10,13,3,31,39,1589
64438,64438,1C0548F40841AD0870DAD8EC7BECCBC6,12521,13,15,2,35,41,1791
64439,64439,1C0548F40841AD0870DAD8EC7BECCBC6,13314,16,23,7,31,39,1589
64450,64450,3C07D1557002BF4F1AA6A6D7A8949EF2,42523,0,5,5,31,47,1597
64451,64451,3C07D1557002BF4F1AA6A6D7A8949EF2,43761,6,8,2,32,47,1647
64452,64452,3C07D1557002BF4F1AA6A6D7A8949EF2,40951,12,14,2,36,49,1849
64453,64453,3C07D1557002BF4F1AA6A6D7A8949EF2,12131,17,23,6,32,47,1647
64458,64458,80866E343D0F286B5A5BF07E0FAD0123,42221,2,5,3,38,48,1948
64459,64459,80866E343D0F286B5A5BF07E0FAD0123,12514,7,9,2,38,47,1947
64460,64460,80866E343D0F286B5A5BF07E0FAD0123,42221,9,10,1,38,48,1948
64461,64461,80866E343D0F286B5A5BF07E0FAD0123,13651,13,19,6,30,47,1547
64462,64462,80866E343D0F286B5A5BF07E0FAD0123,10041,22,23,1,39,49,1999
64463,64463,0EE0313B12B9F1B71F01783385794A53,42341,0,8,8,43,49,2199
64464,64464,0EE0313B12B9F1B71F01783385794A53,43041,13,17,4,41,46,2096
64465,64465,0EE0313B12B9F1B71F01783385794A53,42633,18,21,3,42,46,2146
64466,64466,2F66AC01887397A198C9CCA6611EA97B,12521,0,9,9,35,41,1791
64467,64467,2F66AC01887397A198C9CCA6611EA97B,13314,10,11,1,31,39,1589
64468,64468,2F66AC01887397A198C9CCA6611EA97B,12521,11,23,12,35,41,1791
64469,64469,0ACD42FBA28A767F44D73783967C8C23,10731,0,9,9,33,47,1697
64470,64470,0ACD42FBA28A767F44D73783967C8C23,10281,11,14,3,33,48,1698
64471,64471,0ACD42FBA28A767F44D73783967C8C23,40341,16,19,3,23,49,1199
64472,64472,0ACD42FBA28A767F44D73783967C8C23,10401,19,21,2,33,49,1699
64489,64489,2CC13EA906DAB3CB7AF83A3C71EAF8F6,10341,0,1,1,31,47,1597
64490,64490,2CC13EA906DAB3CB7AF83A3C71EAF8F6,10292,3,7,4,30,47,1547
64491,64491,2CC13EA906DAB3CB7AF83A3C71EAF8F6,42521,8,10,2,31,47,1597
64492,64492,2CC13EA906DAB3CB7AF83A3C71EAF8F6,42351,12,13,1,38,45,1945
64493,64493,2CC13EA906DAB3CB7AF83A3C71EAF8F6,42521,15,21,6,31,47,1597
64494,64494,2CC13EA906DAB3CB7AF83A3C71EAF8F6,10292,22,23,1,30,47,1547
64495,64495,1DE02BA597EA4F42F2480320BABC9C62,11231,0,2,2,37,49,1899
64496,64496,1DE02BA597EA4F42F2480320BABC9C62,11861,2,17,15,32,47,1647
64497,64497,1DE02BA597EA4F42F2480320BABC9C62,11271,18,20,2,37,48,1898
64498,64498,1DE02BA597EA4F42F2480320BABC9C62,42141,21,23,2,32,47,1647
64499,64499,9BBBC00C93BA6A3176E2B008E6F8A88E,13911,0,6,6,39,46,1996
64500,64500,9BBBC00C93BA6A3176E2B008E6F8A88E,11261,6,8,2,36,46,1846
64501,64501,9BBBC00C93BA6A3176E2B008E6F8A88E,13911,12,14,2,39,46,1996
64502,64502,9BBBC00C93BA6A3176E2B008E6F8A88E,11261,14,21,7,36,46,1846
64503,64503,9BBBC00C93BA6A3176E2B008E6F8A88E,13911,22,23,1,39,46,1996
64504,64504,05C3A7EB5EF4E026B421540B8AC90475,10661,0,8,8,37,49,1899
64505,64505,05C3A7EB5EF4E026B421540B8AC90475,42151,9,11,2,35,45,1795
64506,64506,05C3A7EB5EF4E026B421540B8AC90475,42531,12,13,1,31,45,1595
64507,64507,05C3A7EB5EF4E026B421540B8AC90475,12311,13,14,1,30,44,1544
64508,64508,05C3A7EB5EF4E026B421540B8AC90475,42151,16,18,2,35,45,1795
64509,64509,652BF65634129AD52E8E3669162C8125,42461,0,5,5,45,47,2297
64510,64510,652BF65634129AD52E8E3669162C8125,42321,9,10,1,43,47,2197
64511,64511,652BF65634129AD52E8E3669162C8125,42461,11,14,3,45,47,2297
64512,64512,652BF65634129AD52E8E3669162C8125,11701,18,19,1,43,48,2198
64513,64513,652BF65634129AD52E8E3669162C8125,42461,21,23,2,45,47,2297
64514,64514,B6484480F84EEA1B29FA5A5F5E8F3563,43021,0,7,7,16,43,843
64515,64515,B6484480F84EEA1B29FA5A5F5E8F3563,12021,11,12,1,37,49,1899
64516,64516,B6484480F84EEA1B29FA5A5F5E8F3563,43021,14,15,1,16,43,843
64517,64517,B6484480F84EEA1B29FA5A5F5E8F3563,12641,17,18,1,10,43,543
64518,64518,B6484480F84EEA1B29FA5A5F5E8F3563,43021,19,23,4,16,43,843
64523,64523,151AF07FE1353F98EA8933566E4D900D,12921,1,11,10,9,41,491
64524,64524,151AF07FE1353F98EA8933566E4D900D,43021,11,12,1,16,43,843
64525,64525,151AF07FE1353F98EA8933566E4D900D,12921,13,18,5,9,41,491
64530,64530,1A1A9DD5831EECCE9A59AC983CF04EE5,40302,0,11,11,40,49,2049
64531,64531,1A1A9DD5831EECCE9A59AC983CF04EE5,42471,11,13,2,35,49,1799
64532,64532,1A1A9DD5831EECCE9A59AC983CF04EE5,11291,13,18,5,40,49,2049
64533,64533,8A524E85431660319A09E8D071AC107B,10801,0,6,6,42,47,2147
64534,64534,8A524E85431660319A09E8D071AC107B,42321,6,11,5,43,47,2197
64535,64535,8A524E85431660319A09E8D071AC107B,13011,16,17,1,39,47,1997
64536,64536,8A524E85431660319A09E8D071AC107B,42321,17,20,3,43,47,2197
64537,64537,8A524E85431660319A09E8D071AC107B,40833,20,22,2,41,47,2097
64545,64545,89CA2603AB460CC5371CFF262CF45064,10971,0,10,10,35,47,1797
64546,64546,89CA2603AB460CC5371CFF262CF45064,12581,11,12,1,24,48,1248
64547,64547,89CA2603AB460CC5371CFF262CF45064,42161,14,17,3,36,47,1847
64548,64548,89CA2603AB460CC5371CFF262CF45064,43161,21,23,2,35,47,1797
64549,64549,9E75AA99C64D2637AC564EB72A3C9979,10411,0,9,9,36,48,1848
64550,64550,9E75AA99C64D2637AC564EB72A3C9979,11381,10,17,7,30,47,1547
64551,64551,9E75AA99C64D2637AC564EB72A3C9979,10411,18,23,5,36,48,1848
64555,64555,1DAFF76ACB610741A4BE36A701B9B8ED,11791,0,7,7,38,49,1949
64556,64556,1DAFF76ACB610741A4BE36A701B9B8ED,13731,9,12,3,33,49,1699
64557,64557,1DAFF76ACB610741A4BE36A701B9B8ED,42071,12,13,1,31,49,1599
64558,64558,1DAFF76ACB610741A4BE36A701B9B8ED,13731,17,19,2,33,49,1699
64559,64559,1DAFF76ACB610741A4BE36A701B9B8ED,11791,20,23,3,38,49,1949
64563,64563,68D66AC2F31097852E1113FCAC38B096,12311,0,2,2,30,44,1544
64564,64564,68D66AC2F31097852E1113FCAC38B096,12121,5,6,1,29,47,1497
64565,64565,68D66AC2F31097852E1113FCAC38B096,12311,8,19,11,30,44,1544
64566,64566,68D66AC2F31097852E1113FCAC38B096,42531,19,21,2,31,45,1595
64567,64567,68D66AC2F31097852E1113FCAC38B096,12311,22,23,1,30,44,1544
64574,64574,066B72E80EA4B722EDAEA104926529E8,19441,0,10,10,8,46,446
64575,64575,066B72E80EA4B722EDAEA104926529E8,13511,12,13,1,34,48,1748
64576,64576,066B72E80EA4B722EDAEA104926529E8,12621,15,17,2,10,48,548
64577,64577,066B72E80EA4B722EDAEA104926529E8,19901,18,19,1,7,44,394
64578,64578,066B72E80EA4B722EDAEA104926529E8,19441,21,23,2,8,46,446
64582,64582,EAAC45FB100EE8A458EC0FF985DACA2D,11751,2,7,5,35,48,1798
64583,64583,EAAC45FB100EE8A458EC0FF985DACA2D,12391,9,14,5,36,49,1849
64584,64584,EAAC45FB100EE8A458EC0FF985DACA2D,11271,15,17,2,37,48,1898
64585,64585,EAAC45FB100EE8A458EC0FF985DACA2D,40454,19,20,1,35,49,1799
64586,64586,EAAC45FB100EE8A458EC0FF985DACA2D,40951,21,22,1,36,49,1849
64590,64590,E29D5E2A4C053B8D0F389CF2B8DB0821,15051,2,15,13,19,4,954
64591,64591,E29D5E2A4C053B8D0F389CF2B8DB0821,15281,17,18,1,25,3,1253
64592,64592,E29D5E2A4C053B8D0F389CF2B8DB0821,16281,20,22,2,11,4,554
64596,64596,AE9DABC8C76DE8782FA56379E8CBF939,10544,1,7,6,28,48,1448
64597,64597,AE9DABC8C76DE8782FA56379E8CBF939,12971,10,13,3,32,48,1648
64598,64598,AE9DABC8C76DE8782FA56379E8CBF939,43501,14,15,1,27,48,1398
64599,64599,AE9DABC8C76DE8782FA56379E8CBF939,40112,16,18,2,32,48,1648
64600,64600,AE9DABC8C76DE8782FA56379E8CBF939,43501,22,23,1,27,48,1398
64601,64601,1CE292700BBF1D8A212B5BB7B6028F74,11861,0,8,8,32,47,1647
64602,64602,1CE292700BBF1D8A212B5BB7B6028F74,42381,10,12,2,39,41,1991
64603,64603,1CE292700BBF1D8A212B5BB7B6028F74,12771,13,14,1,20,46,1046
64604,64604,1CE292700BBF1D8A212B5BB7B6028F74,13511,19,20,1,34,48,1748
64605,64605,1CE292700BBF1D8A212B5BB7B6028F74,11861,22,23,1,32,47,1647
64606,64606,89B3BFDED87D6E0E820EFE71F7C3C8DA,11861,0,10,10,32,47,1647
64607,64607,89B3BFDED87D6E0E820EFE71F7C3C8DA,10451,14,15,1,25,48,1298
64608,64608,89B3BFDED87D6E0E820EFE71F7C3C8DA,11861,19,23,4,32,47,1647
64609,64609,22300DEAB3F7A20A2F8DD7892A11C5B7,13271,0,3,3,41,47,2097
64610,64610,22300DEAB3F7A20A2F8DD7892A11C5B7,13101,5,6,1,40,47,2047
64611,64611,22300DEAB3F7A20A2F8DD7892A11C5B7,10107,10,13,3,38,49,1949
64612,64612,22300DEAB3F7A20A2F8DD7892A11C5B7,13271,14,16,2,41,47,2097
64613,64613,22300DEAB3F7A20A2F8DD7892A11C5B7,13101,19,21,2,40,47,2047
64614,64614,180CFA670233CC55937ED4D2C76E2806,10634,0,5,5,27,45,1395
64615,64615,180CFA670233CC55937ED4D2C76E2806,13671,7,10,3,27,43,1393
64616,64616,180CFA670233CC55937ED4D2C76E2806,12761,10,13,3,25,40,1290
64617,64617,180CFA670233CC55937ED4D2C76E2806,13671,14,19,5,27,43,1393
64618,64618,180CFA670233CC55937ED4D2C76E2806,10634,22,23,1,27,45,1395
64619,64619,40F471DD86450F7E02A9160B1DB5571E,11701,0,6,6,43,48,2198
64620,64620,40F471DD86450F7E02A9160B1DB5571E,42201,8,9,1,43,46,2196
64621,64621,40F471DD86450F7E02A9160B1DB5571E,42321,10,11,1,43,47,2197
64622,64622,40F471DD86450F7E02A9160B1DB5571E,11701,11,13,2,43,48,2198
64623,64623,40F471DD86450F7E02A9160B1DB5571E,42321,15,19,4,43,47,2197
64624,64624,40F471DD86450F7E02A9160B1DB5571E,42461,20,21,1,45,47,2297
64628,64628,CC7496BDC75891A464D44322CA00AA04,11351,0,6,6,36,48,1848
64629,64629,CC7496BDC75891A464D44322CA00AA04,10351,6,11,5,28,45,1445
64630,64630,CC7496BDC75891A464D44322CA00AA04,10634,13,14,1,27,45,1395
64631,64631,CC7496BDC75891A464D44322CA00AA04,10351,14,17,3,28,45,1445
64632,64632,CC7496BDC75891A464D44322CA00AA04,10634,20,22,2,27,45,1395
64633,64633,16815028EA56365EF962CAF32236D88D,16261,0,7,7,3,3,153
64634,64634,16815028EA56365EF962CAF32236D88D,13561,12,17,5,37,49,1899
64635,64635,16815028EA56365EF962CAF32236D88D,42623,19,21,2,22,49,1149
64636,64636,B6674F6BB1F07CBF5417C9023D07052B,12651,0,10,10,43,47,2197
64637,64637,B6674F6BB1F07CBF5417C9023D07052B,40691,12,13,1,42,48,2148
64638,64638,B6674F6BB1F07CBF5417C9023D07052B,40951,16,17,1,36,49,1849
64639,64639,B6674F6BB1F07CBF5417C9023D07052B,11751,18,20,2,35,48,1798
64640,64640,B6674F6BB1F07CBF5417C9023D07052B,40951,21,22,1,36,49,1849
64648,64648,D6B662C0D72BBB94314A69A6BE13D66E,13711,0,10,10,38,46,1946
64649,64649,D6B662C0D72BBB94314A69A6BE13D66E,10061,15,17,2,20,46,1046
64650,64650,D6B662C0D72BBB94314A69A6BE13D66E,43281,21,23,2,37,48,1898
64651,64651,1B1AA14FCBEAAD141CA6FAC7B338917E,42864,0,1,1,38,44,1944
64652,64652,1B1AA14FCBEAAD141CA6FAC7B338917E,11261,1,2,1,36,46,1846
64653,64653,1B1AA14FCBEAAD141CA6FAC7B338917E,42864,2,6,4,38,44,1944
64654,64654,1B1AA14FCBEAAD141CA6FAC7B338917E,42861,6,11,5,37,44,1894
64655,64655,1B1AA14FCBEAAD141CA6FAC7B338917E,11261,11,12,1,36,46,1846
64656,64656,1B1AA14FCBEAAD141CA6FAC7B338917E,42861,14,18,4,37,44,1894
64657,64657,1A781977FAF109F9FB129E523F36ACF2,13671,0,10,10,27,43,1393
64658,64658,1A781977FAF109F9FB129E523F36ACF2,10351,11,13,2,28,45,1445
64659,64659,1A781977FAF109F9FB129E523F36ACF2,13671,14,16,2,27,43,1393
64660,64660,1A781977FAF109F9FB129E523F36ACF2,10301,20,21,1,31,45,1595
64661,64661,1A781977FAF109F9FB129E523F36ACF2,10351,21,23,2,28,45,1445
64662,64662,1B3E2B40FE85118B6153584A8B129202,11231,0,1,1,37,49,1899
64663,64663,1B3E2B40FE85118B6153584A8B129202,43281,5,6,1,37,48,1898
64664,64664,1B3E2B40FE85118B6153584A8B129202,11231,8,10,2,37,49,1899
64665,64665,1B3E2B40FE85118B6153584A8B129202,10471,12,14,2,37,48,1898
64666,64666,1B3E2B40FE85118B6153584A8B129202,10661,17,23,6,37,49,1899
64667,64667,CC1D2177DD0D219F75CA040FDDB7782F,11861,6,11,5,32,47,1647
64668,64668,CC1D2177DD0D219F75CA040FDDB7782F,11201,12,13,1,35,49,1799
64669,64669,CC1D2177DD0D219F75CA040FDDB7782F,11861,14,23,9,32,47,1647
64673,64673,373B9F2F8734E5B584F83EF928681C8C,43321,6,7,1,36,49,1849
64674,64674,373B9F2F8734E5B584F83EF928681C8C,12401,10,11,1,39,49,1999
64675,64675,373B9F2F8734E5B584F83EF928681C8C,10061,12,13,1,20,46,1046
64676,64676,373B9F2F8734E5B584F83EF928681C8C,10881,17,19,2,34,48,1748
64677,64677,373B9F2F8734E5B584F83EF928681C8C,43321,20,23,3,36,49,1849
64686,64686,FCA3C665B5BF337F331669EDB597A6AC,42791,0,7,7,35,45,1795
64687,64687,FCA3C665B5BF337F331669EDB597A6AC,13121,8,10,2,38,46,1946
64688,64688,FCA3C665B5BF337F331669EDB597A6AC,10271,13,14,1,37,46,1896
64689,64689,FCA3C665B5BF337F331669EDB597A6AC,13121,14,16,2,38,46,1946
64690,64690,FCA3C665B5BF337F331669EDB597A6AC,10271,16,18,2,37,46,1896
64691,64691,9A2CC673971AD6F69D338DA76299B5EC,40561,0,10,10,32,48,1648
64692,64692,9A2CC673971AD6F69D338DA76299B5EC,42161,12,13,1,36,47,1847
64693,64693,9A2CC673971AD6F69D338DA76299B5EC,10161,16,19,3,35,49,1799
64694,64694,9A2CC673971AD6F69D338DA76299B5EC,12381,19,23,4,32,48,1648
64699,64699,AB5381797B6ADC5A15B6453B748F1596,42231,0,6,6,37,46,1896
64700,64700,AB5381797B6ADC5A15B6453B748F1596,42301,6,8,2,36,47,1847
64701,64701,AB5381797B6ADC5A15B6453B748F1596,40463,10,12,2,38,49,1949
64702,64702,AB5381797B6ADC5A15B6453B748F1596,42231,14,15,1,37,46,1896
64703,64703,AB5381797B6ADC5A15B6453B748F1596,42301,17,23,6,36,47,1847
64704,64704,6FDEE2D2AAF4416CE8355DF93698DD7A,13111,0,8,8,42,46,2146
64705,64705,6FDEE2D2AAF4416CE8355DF93698DD7A,11271,17,18,1,37,48,1898
64706,64706,6FDEE2D2AAF4416CE8355DF93698DD7A,13111,21,22,1,42,46,2146
64710,64710,EF513E7C00BFDF832A0C526F0CB25E65,43011,0,6,6,40,42,2042
64711,64711,EF513E7C00BFDF832A0C526F0CB25E65,12561,11,16,5,45,43,2293
64712,64712,EF513E7C00BFDF832A0C526F0CB25E65,43011,21,23,2,40,42,2042
64719,64719,9365C0731F1C4631FF8F1D06F7923828,12581,4,5,1,24,48,1248
64720,64720,9365C0731F1C4631FF8F1D06F7923828,11361,5,8,3,22,48,1148
64721,64721,9365C0731F1C4631FF8F1D06F7923828,10951,11,14,3,29,48,1498
64722,64722,9365C0731F1C4631FF8F1D06F7923828,11101,16,17,1,18,48,948
64723,64723,9365C0731F1C4631FF8F1D06F7923828,12581,19,20,1,24,48,1248
64724,64724,9ECA5557B94DDF8D494B58216329A377,42864,3,5,2,38,44,1944
64725,64725,9ECA5557B94DDF8D494B58216329A377,12561,6,8,2,45,43,2293
64726,64726,9ECA5557B94DDF8D494B58216329A377,11261,9,12,3,36,46,1846
64727,64727,9ECA5557B94DDF8D494B58216329A377,42864,15,17,2,38,44,1944
64728,64728,9ECA5557B94DDF8D494B58216329A377,11261,18,23,5,36,46,1846
64729,64729,66BF2E4899B4E57AFD9485A7423B59AE,11481,1,7,6,41,48,2098
64730,64730,66BF2E4899B4E57AFD9485A7423B59AE,11875,13,15,2,30,46,1546
64731,64731,66BF2E4899B4E57AFD9485A7423B59AE,13101,17,23,6,40,47,2047
64732,64732,06CD0D9A51BF6B03AA66A2A0C792CAB3,10731,0,4,4,33,47,1697
64733,64733,06CD0D9A51BF6B03AA66A2A0C792CAB3,40637,5,6,1,36,47,1847
64734,64734,06CD0D9A51BF6B03AA66A2A0C792CAB3,11651,6,13,7,33,47,1697
64735,64735,06CD0D9A51BF6B03AA66A2A0C792CAB3,40637,14,15,1,36,47,1847
64736,64736,06CD0D9A51BF6B03AA66A2A0C792CAB3,10971,15,17,2,35,47,1797
64737,64737,06CD0D9A51BF6B03AA66A2A0C792CAB3,10731,18,21,3,33,47,1697
64742,64742,2D6BB08D0028E1950DC24BE69D8E3BA3,10811,1,2,1,38,46,1946
64743,64743,2D6BB08D0028E1950DC24BE69D8E3BA3,42711,4,7,3,26,48,1348
64744,64744,2D6BB08D0028E1950DC24BE69D8E3BA3,10451,8,9,1,25,48,1298
64745,64745,2D6BB08D0028E1950DC24BE69D8E3BA3,41591,12,14,2,34,49,1749
64746,64746,2D6BB08D0028E1950DC24BE69D8E3BA3,42021,14,15,1,33,47,1697
64747,64747,2D6BB08D0028E1950DC24BE69D8E3BA3,42711,16,18,2,26,48,1348
64748,64748,2D6BB08D0028E1950DC24BE69D8E3BA3,10451,21,23,2,25,48,1298
64752,64752,EC6E830AA2F511C8D67634B2F5AE8A13,11061,0,3,3,29,48,1498
64753,64753,EC6E830AA2F511C8D67634B2F5AE8A13,10381,3,6,3,31,49,1599
64754,64754,EC6E830AA2F511C8D67634B2F5AE8A13,11061,11,16,5,29,48,1498
64755,64755,EC6E830AA2F511C8D67634B2F5AE8A13,11151,18,19,1,30,48,1548
64756,64756,EC6E830AA2F511C8D67634B2F5AE8A13,11061,21,23,2,29,48,1498
64760,64760,5986650BBF1F6A8E978985FB0E2D0CAE,10295,0,11,11,30,47,1547
64761,64761,5986650BBF1F6A8E978985FB0E2D0CAE,12021,13,15,2,37,49,1899
64762,64762,5986650BBF1F6A8E978985FB0E2D0CAE,42523,15,18,3,31,47,1597
64763,64763,23CA9F48DF69D9D3E4139C4D5570E2C8,11954,7,10,3,32,49,1649
64764,64764,23CA9F48DF69D9D3E4139C4D5570E2C8,12971,14,15,1,32,48,1648
64765,64765,23CA9F48DF69D9D3E4139C4D5570E2C8,11731,16,17,1,36,48,1848
64766,64766,23CA9F48DF69D9D3E4139C4D5570E2C8,11954,22,23,1,32,49,1649
64767,64767,1DFC063262F02B96AF96AED120E22A58,40673,0,9,9,36,48,1848
64768,64768,1DFC063262F02B96AF96AED120E22A58,13821,14,15,1,49,45,2495
64769,64769,1DFC063262F02B96AF96AED120E22A58,11231,16,18,2,37,49,1899
64770,64770,1DFC063262F02B96AF96AED120E22A58,40673,19,23,4,36,48,1848
64771,64771,F78EC9DDECA6B3700774788DCB5A4A6B,43581,0,6,6,33,48,1698
64772,64772,F78EC9DDECA6B3700774788DCB5A4A6B,43731,8,9,1,34,47,1747
64773,64773,F78EC9DDECA6B3700774788DCB5A4A6B,42941,12,15,3,37,47,1897
64774,64774,F78EC9DDECA6B3700774788DCB5A4A6B,43581,19,23,4,33,48,1698
64778,64778,FCAD054B21E17BB146DD8C9FA66703D1,10331,0,8,8,39,46,1996
64779,64779,FCAD054B21E17BB146DD8C9FA66703D1,10251,10,12,2,35,47,1797
64780,64780,FCAD054B21E17BB146DD8C9FA66703D1,42501,13,14,1,28,47,1447
64781,64781,FCAD054B21E17BB146DD8C9FA66703D1,10251,15,19,4,35,47,1797
64782,64782,2C60CBDD38FCCC260C13A921C2C9974B,42691,0,3,3,24,48,1248
64783,64783,2C60CBDD38FCCC260C13A921C2C9974B,12051,4,18,14,20,47,1047
64784,64784,2C60CBDD38FCCC260C13A921C2C9974B,11361,19,20,1,22,48,1148
64785,64785,87268C35D2C26CE8D0D34B26791C8611,41591,0,10,10,34,49,1749
64786,64786,87268C35D2C26CE8D0D34B26791C8611,43391,12,13,1,29,48,1498
64787,64787,87268C35D2C26CE8D0D34B26791C8611,19441,13,15,2,8,46,446
64788,64788,87268C35D2C26CE8D0D34B26791C8611,40341,16,18,2,23,49,1199
64789,64789,87268C35D2C26CE8D0D34B26791C8611,41591,21,23,2,34,49,1749
64790,64790,89C5F5C036761FD2C32F64BC4CDE2E5B,19441,0,12,12,8,46,446
64791,64791,89C5F5C036761FD2C32F64BC4CDE2E5B,12621,12,14,2,10,48,548
64792,64792,89C5F5C036761FD2C32F64BC4CDE2E5B,11211,17,19,2,34,49,1749
64793,64793,89C5F5C036761FD2C32F64BC4CDE2E5B,19441,20,22,2,8,46,446
64794,64794,B2012EE6BD195EC80673B0F2B5EC1C5E,43644,0,7,7,14,38,738
64795,64795,B2012EE6BD195EC80673B0F2B5EC1C5E,12641,8,9,1,10,43,543
64796,64796,B2012EE6BD195EC80673B0F2B5EC1C5E,49201,11,14,3,7,41,391
64797,64797,B2012EE6BD195EC80673B0F2B5EC1C5E,19931,15,16,1,7,43,393
64798,64798,B2012EE6BD195EC80673B0F2B5EC1C5E,12641,16,22,6,10,43,543
64802,64802,D539A3D289BDD04DB34F6952C2709AEC,40801,0,7,7,43,46,2196
64803,64803,D539A3D289BDD04DB34F6952C2709AEC,13561,8,15,7,37,49,1899
64804,64804,D539A3D289BDD04DB34F6952C2709AEC,40801,18,23,5,43,46,2196
64805,64805,A30C524CE1CE6CCC97F57F505F7BFDED,42601,0,8,8,44,48,2248
64806,64806,A30C524CE1CE6CCC97F57F505F7BFDED,41591,9,18,9,34,49,1749
64807,64807,A30C524CE1CE6CCC97F57F505F7BFDED,11541,19,21,2,35,49,1799
64808,64808,A30C524CE1CE6CCC97F57F505F7BFDED,42601,21,23,2,44,48,2248
64823,64823,B4B9EF8B2509C5B7E6B8F05B2AFC5406,10841,1,17,16,37,47,1897
64824,64824,B4B9EF8B2509C5B7E6B8F05B2AFC5406,40341,17,19,2,23,49,1199
64825,64825,B4B9EF8B2509C5B7E6B8F05B2AFC5406,10841,21,23,2,37,47,1897
64826,64826,656752102BA99654C7060CE5B2133D72,49201,0,6,6,7,41,391
64827,64827,656752102BA99654C7060CE5B2133D72,12641,6,8,2,10,43,543
64828,64828,656752102BA99654C7060CE5B2133D72,12921,9,15,6,9,41,491
64829,64829,656752102BA99654C7060CE5B2133D72,49201,19,23,4,7,41,391
64838,64838,B9C1F629614C9E76806B6B721E6D2EB3,10801,0,9,9,42,47,2147
64839,64839,B9C1F629614C9E76806B6B721E6D2EB3,41601,13,14,1,39,49,1999
64840,64840,B9C1F629614C9E76806B6B721E6D2EB3,10221,15,17,2,34,49,1749
64841,64841,B9C1F629614C9E76806B6B721E6D2EB3,42021,17,20,3,33,47,1697
64849,64849,C132E4C242B7EC12A7123616F55E9237,42461,0,13,13,45,47,2297
64850,64850,C132E4C242B7EC12A7123616F55E9237,42321,15,17,2,43,47,2197
64851,64851,C132E4C242B7EC12A7123616F55E9237,11701,17,18,1,43,48,2198
64852,64852,C132E4C242B7EC12A7123616F55E9237,42321,18,20,2,43,47,2197
64853,64853,C132E4C242B7EC12A7123616F55E9237,43621,21,23,2,46,48,2348
64858,64858,62A2F5272230052AEB85DFD96BD0E354,11111,0,3,3,26,48,1348
64859,64859,62A2F5272230052AEB85DFD96BD0E354,12601,4,8,4,25,47,1297
64860,64860,62A2F5272230052AEB85DFD96BD0E354,10411,10,18,8,36,48,1848
64861,64861,3CF7B0916CDE9473EE3871FE908999F3,19901,0,5,5,7,44,394
64862,64862,3CF7B0916CDE9473EE3871FE908999F3,12921,7,11,4,9,41,491
64863,64863,3CF7B0916CDE9473EE3871FE908999F3,19901,11,13,2,7,44,394
64864,64864,3CF7B0916CDE9473EE3871FE908999F3,12921,13,14,1,9,41,491
64865,64865,3CF7B0916CDE9473EE3871FE908999F3,19114,17,18,1,7,43,393
64866,64866,3CF7B0916CDE9473EE3871FE908999F3,19901,19,21,2,7,44,394
64882,64882,B54E3A2D68D0F7F1CD5888CC2F25FE2F,42261,10,11,1,25,49,1299
64883,64883,B54E3A2D68D0F7F1CD5888CC2F25FE2F,40343,12,13,1,24,49,1249
64884,64884,B54E3A2D68D0F7F1CD5888CC2F25FE2F,10381,18,19,1,31,49,1599
64885,64885,B54E3A2D68D0F7F1CD5888CC2F25FE2F,11151,20,21,1,30,48,1548
64886,64886,C77F23D19DAEA5BB8ADE1BB3D3C261B4,13091,0,6,6,20,42,1042
64887,64887,C77F23D19DAEA5BB8ADE1BB3D3C261B4,13911,8,17,9,39,46,1996
64888,64888,C77F23D19DAEA5BB8ADE1BB3D3C261B4,42531,18,20,2,31,45,1595
64889,64889,C77F23D19DAEA5BB8ADE1BB3D3C261B4,42371,21,22,1,34,46,1746
64890,64890,9B3D4DB494E6B8E7329532A1BECC6FF1,43644,0,4,4,14,38,738
64891,64891,9B3D4DB494E6B8E7329532A1BECC6FF1,12641,7,8,1,10,43,543
64892,64892,9B3D4DB494E6B8E7329532A1BECC6FF1,43021,12,13,1,16,43,843
64893,64893,9B3D4DB494E6B8E7329532A1BECC6FF1,12641,14,16,2,10,43,543
64894,64894,9B3D4DB494E6B8E7329532A1BECC6FF1,12921,16,18,2,9,41,491
64895,64895,735AC6A81B1D92C565ED849CD65C0FF3,10292,0,7,7,30,47,1547
64896,64896,735AC6A81B1D92C565ED849CD65C0FF3,10301,7,8,1,31,45,1595
64897,64897,735AC6A81B1D92C565ED849CD65C0FF3,10292,9,12,3,30,47,1547
64898,64898,735AC6A81B1D92C565ED849CD65C0FF3,10781,14,15,1,35,47,1797
64899,64899,735AC6A81B1D92C565ED849CD65C0FF3,10292,17,18,1,30,47,1547
64900,64900,735AC6A81B1D92C565ED849CD65C0FF3,10301,19,23,4,31,45,1595
64913,64913,C67AD33695FBB59FE91EDDED93659237,11151,2,6,4,30,48,1548
64914,64914,C67AD33695FBB59FE91EDDED93659237,11331,8,17,9,37,48,1898
64915,64915,C67AD33695FBB59FE91EDDED93659237,11061,20,21,1,29,48,1498
64919,64919,E68557F6935BD30B9953F631E31CCEB6,11301,1,10,9,41,49,2099
64920,64920,E68557F6935BD30B9953F631E31CCEB6,12401,13,14,1,39,49,1999
64921,64921,E68557F6935BD30B9953F631E31CCEB6,40341,16,17,1,23,49,1199
64922,64922,E68557F6935BD30B9953F631E31CCEB6,40691,21,22,1,42,48,2148
64923,64923,601A51EA671623E5E466F858B3908746,13231,0,7,7,39,46,1996
64924,64924,601A51EA671623E5E466F858B3908746,13651,8,9,1,30,47,1547
64925,64925,601A51EA671623E5E466F858B3908746,10711,14,16,2,29,46,1496
64926,64926,601A51EA671623E5E466F858B3908746,13231,17,23,6,39,46,1996
64927,64927,B046A650BE0C1BBB3512CD7DA14AD148,13941,0,7,7,41,47,2097
64928,64928,B046A650BE0C1BBB3512CD7DA14AD148,13651,8,17,9,30,47,1547
64929,64929,B046A650BE0C1BBB3512CD7DA14AD148,13271,18,23,5,41,47,2097
64930,64930,34A4600E2EBB00DA28DDECA5142B5287,16241,0,9,9,3,3,153
64931,64931,34A4600E2EBB00DA28DDECA5142B5287,16181,12,15,3,4,2,202
64932,64932,34A4600E2EBB00DA28DDECA5142B5287,42623,17,21,4,22,49,1149
64936,64936,702A499FD39D0BCD3CFB88CB328366DB,13111,1,6,5,42,46,2146
64937,64937,702A499FD39D0BCD3CFB88CB328366DB,42321,8,10,2,43,47,2197
64938,64938,702A499FD39D0BCD3CFB88CB328366DB,42111,13,17,4,44,46,2246
64939,64939,702A499FD39D0BCD3CFB88CB328366DB,42031,20,21,1,40,46,2046
64940,64940,702A499FD39D0BCD3CFB88CB328366DB,13111,21,22,1,42,46,2146
64945,64945,87A579BD8EB5C5CE5240DDB8F2C166E2,13671,0,8,8,27,43,1393
64946,64946,87A579BD8EB5C5CE5240DDB8F2C166E2,12521,11,14,3,35,41,1791
64947,64947,87A579BD8EB5C5CE5240DDB8F2C166E2,13314,18,23,5,31,39,1589
64948,64948,4DA21EF09DE00955AFF28F16D2698178,15391,0,1,1,35,26,1776
64949,64949,4DA21EF09DE00955AFF28F16D2698178,12792,2,6,4,34,30,1730
64950,64950,4DA21EF09DE00955AFF28F16D2698178,15361,7,8,1,33,25,1675
64951,64951,4DA21EF09DE00955AFF28F16D2698178,12792,14,15,1,34,30,1730
64952,64952,4DA21EF09DE00955AFF28F16D2698178,15391,18,22,4,35,26,1776
64956,64956,8DB788CEA0B2BA646B47A6A2A954AB01,13111,0,8,8,42,46,2146
64957,64957,8DB788CEA0B2BA646B47A6A2A954AB01,10471,11,15,4,37,48,1898
64958,64958,8DB788CEA0B2BA646B47A6A2A954AB01,40341,15,16,1,23,49,1199
64959,64959,8DB788CEA0B2BA646B47A6A2A954AB01,13111,18,19,1,42,46,2146
64960,64960,8DB788CEA0B2BA646B47A6A2A954AB01,40271,21,23,2,35,49,1799
64961,64961,69A2BE2C8E8C7C266144086560BD5BC9,43121,9,11,2,25,27,1277
64962,64962,69A2BE2C8E8C7C266144086560BD5BC9,15321,12,15,3,29,26,1476
64963,64963,69A2BE2C8E8C7C266144086560BD5BC9,43121,15,17,2,25,27,1277
64964,64964,69A2BE2C8E8C7C266144086560BD5BC9,15321,20,22,2,29,26,1476
64965,64965,34D0F1740730A8549938BF81A7322203,10451,0,7,7,25,48,1298
64966,64966,34D0F1740730A8549938BF81A7322203,12141,9,17,8,42,45,2145
64967,64967,34D0F1740730A8549938BF81A7322203,11021,22,23,1,36,49,1849
64968,64968,9A00542CAFFEB5945C49D11E59022915,42301,0,10,10,36,47,1847
64969,64969,9A00542CAFFEB5945C49D11E59022915,13041,14,17,3,30,37,1537
64970,64970,9A00542CAFFEB5945C49D11E59022915,40891,22,23,1,37,47,1897
64971,64971,D429753EEB35077FBB0F7FD7B24671DA,42381,1,6,5,39,41,1991
64972,64972,D429753EEB35077FBB0F7FD7B24671DA,43451,6,9,3,37,40,1890
64973,64973,D429753EEB35077FBB0F7FD7B24671DA,42381,12,13,1,39,41,1991
64974,64974,D429753EEB35077FBB0F7FD7B24671DA,43451,13,15,2,37,40,1890
64975,64975,D429753EEB35077FBB0F7FD7B24671DA,13071,16,18,2,41,41,2091
64976,64976,11B7F7677A0CABD0DA5C6CA237E025AC,10691,2,10,8,33,48,1698
64977,64977,11B7F7677A0CABD0DA5C6CA237E025AC,11521,11,16,5,41,48,2098
64978,64978,11B7F7677A0CABD0DA5C6CA237E025AC,10801,20,23,3,42,47,2147
64979,64979,33984A316287D4F4BD9C4DD953F5F514,19061,0,14,14,3,43,193
64980,64980,33984A316287D4F4BD9C4DD953F5F514,12311,15,17,2,30,44,1544
64981,64981,33984A316287D4F4BD9C4DD953F5F514,10301,17,19,2,31,45,1595
64982,64982,33984A316287D4F4BD9C4DD953F5F514,19061,20,23,3,3,43,193
64995,64995,D256AE34DD31744D7365602849D9C40A,10341,2,6,4,31,47,1597
64996,64996,D256AE34DD31744D7365602849D9C40A,42491,7,8,1,32,46,1646
64997,64997,D256AE34DD31744D7365602849D9C40A,12601,8,16,8,25,47,1297
64998,64998,D256AE34DD31744D7365602849D9C40A,42491,20,23,3,32,46,1646
64999,64999,61DE87BB131AFCA2EBC38E2F283C9021,11834,1,2,1,32,45,1645
65000,65000,61DE87BB131AFCA2EBC38E2F283C9021,13314,4,8,4,31,39,1589
65001,65001,61DE87BB131AFCA2EBC38E2F283C9021,11834,8,23,15,32,45,1645
65012,65012,A02CC63C83B0DB8DAC13DDD011BB9A96,11161,0,7,7,32,48,1648
65013,65013,A02CC63C83B0DB8DAC13DDD011BB9A96,13821,9,18,9,49,45,2495
65014,65014,A02CC63C83B0DB8DAC13DDD011BB9A96,12381,20,22,2,32,48,1648
65035,65035,6418FA5B857C53267B53554872550655,11861,0,5,5,32,47,1647
65036,65036,6418FA5B857C53267B53554872550655,11131,5,9,4,33,48,1698
65037,65037,6418FA5B857C53267B53554872550655,10251,9,10,1,35,47,1797
65038,65038,6418FA5B857C53267B53554872550655,11861,11,16,5,32,47,1647
65039,65039,6418FA5B857C53267B53554872550655,10611,16,17,1,32,48,1648
65040,65040,6418FA5B857C53267B53554872550655,42161,18,19,1,36,47,1847
65041,65041,6418FA5B857C53267B53554872550655,11861,21,23,2,32,47,1647
65045,65045,AC63A44AAFE297AD4CD776B1B1348D18,42801,0,9,9,40,49,2049
65046,65046,AC63A44AAFE297AD4CD776B1B1348D18,11061,12,13,1,29,48,1498
65047,65047,AC63A44AAFE297AD4CD776B1B1348D18,12601,14,15,1,25,47,1297
65048,65048,AC63A44AAFE297AD4CD776B1B1348D18,10491,18,20,2,33,48,1698
65057,65057,C587B8BBA49D2BF4E222CE1A0182D385,42583,0,10,10,40,48,2048
65058,65058,C587B8BBA49D2BF4E222CE1A0182D385,10931,12,13,1,41,48,2098
65059,65059,C587B8BBA49D2BF4E222CE1A0182D385,11081,16,19,3,35,46,1796
65067,65067,C68BD884038901FC3E44D28FCEB3DA1A,12311,0,13,13,30,44,1544
65068,65068,C68BD884038901FC3E44D28FCEB3DA1A,10211,17,18,1,16,49,849
65069,65069,C68BD884038901FC3E44D28FCEB3DA1A,12311,22,23,1,30,44,1544
65073,65073,1EA626A844647C06D04A94E766E87CA8,42031,0,11,11,40,46,2046
65074,65074,1EA626A844647C06D04A94E766E87CA8,40951,15,16,1,36,49,1849
65075,65075,1EA626A844647C06D04A94E766E87CA8,42031,20,22,2,40,46,2046
65076,65076,4FA7E2AF35091649A8D61648BF92F5C0,42581,0,6,6,38,48,1948
65077,65077,4FA7E2AF35091649A8D61648BF92F5C0,10471,7,11,4,37,48,1898
65078,65078,4FA7E2AF35091649A8D61648BF92F5C0,42581,12,14,2,38,48,1948
65079,65079,4FA7E2AF35091649A8D61648BF92F5C0,10471,14,18,4,37,48,1898
65080,65080,4FA7E2AF35091649A8D61648BF92F5C0,42071,19,22,3,31,49,1599
65084,65084,4BD0C03EBB350DA61DA47C4CF465084D,42071,0,1,1,31,49,1599
65085,65085,4BD0C03EBB350DA61DA47C4CF465084D,42081,4,5,1,24,49,1249
65086,65086,4BD0C03EBB350DA61DA47C4CF465084D,42071,5,7,2,31,49,1599
65087,65087,4BD0C03EBB350DA61DA47C4CF465084D,42081,8,10,2,24,49,1249
65088,65088,4BD0C03EBB350DA61DA47C4CF465084D,42071,10,20,10,31,49,1599
65089,65089,4BD0C03EBB350DA61DA47C4CF465084D,42081,21,22,1,24,49,1249
65090,65090,7EA63201A47B68AA085BD7B8AF1F7767,10721,0,7,7,31,48,1598
65091,65091,7EA63201A47B68AA085BD7B8AF1F7767,11231,9,16,7,37,49,1899
65092,65092,7EA63201A47B68AA085BD7B8AF1F7767,12083,17,18,1,36,49,1849
65093,65093,7EA63201A47B68AA085BD7B8AF1F7767,13341,18,23,5,44,45,2245
65094,65094,F34BB6ACFCE210E7291D20313D1902FC,19441,2,7,5,8,46,446
65095,65095,F34BB6ACFCE210E7291D20313D1902FC,11381,8,11,3,30,47,1547
65096,65096,F34BB6ACFCE210E7291D20313D1902FC,19441,13,17,4,8,46,446
65097,65097,F34BB6ACFCE210E7291D20313D1902FC,11381,18,19,1,30,47,1547
65113,65113,43BF896D3B851119060F11E58E6A9940,11324,0,7,7,31,46,1596
65114,65114,43BF896D3B851119060F11E58E6A9940,12311,8,10,2,30,44,1544
65115,65115,43BF896D3B851119060F11E58E6A9940,42871,10,11,1,30,45,1545
65116,65116,43BF896D3B851119060F11E58E6A9940,11871,14,16,2,29,46,1496
65117,65117,43BF896D3B851119060F11E58E6A9940,12311,17,18,1,30,44,1544
65118,65118,43BF896D3B851119060F11E58E6A9940,11324,19,23,4,31,46,1596
65119,65119,5453F860C61AA8BCEF2B2EA0FA937607,11061,0,10,10,29,48,1498
65120,65120,5453F860C61AA8BCEF2B2EA0FA937607,42161,10,18,8,36,47,1847
65121,65121,5453F860C61AA8BCEF2B2EA0FA937607,11061,19,23,4,29,48,1498
65128,65128,2B655361F72B291A8AF64958D14F3BDC,12971,0,8,8,32,48,1648
65129,65129,2B655361F72B291A8AF64958D14F3BDC,10731,10,11,1,33,47,1697
65130,65130,2B655361F72B291A8AF64958D14F3BDC,10381,12,15,3,31,49,1599
65131,65131,2B655361F72B291A8AF64958D14F3BDC,12971,18,21,3,32,48,1648
65132,65132,2B655361F72B291A8AF64958D14F3BDC,11531,21,22,1,34,49,1749
65145,65145,46897925257B2D033C63BB065FD79FB2,10771,0,10,10,41,46,2096
65146,65146,46897925257B2D033C63BB065FD79FB2,42021,14,15,1,33,47,1697
65147,65147,46897925257B2D033C63BB065FD79FB2,11261,17,22,5,36,46,1846
65151,65151,F32ADB5058C82ADA4AD50F7FCC196198,12051,1,4,3,20,47,1047
65152,65152,F32ADB5058C82ADA4AD50F7FCC196198,12581,6,10,4,24,48,1248
65153,65153,F32ADB5058C82ADA4AD50F7FCC196198,43751,13,15,2,19,48,998
65154,65154,F32ADB5058C82ADA4AD50F7FCC196198,12051,16,18,2,20,47,1047
65155,65155,F32ADB5058C82ADA4AD50F7FCC196198,43751,19,23,4,19,48,998
65159,65159,965C27734097AF6DA274066995F7BA78,42071,0,11,11,31,49,1599
65160,65160,965C27734097AF6DA274066995F7BA78,40094,12,17,5,29,48,1498
65161,65161,965C27734097AF6DA274066995F7BA78,42081,17,19,2,24,49,1249
65162,65162,965C27734097AF6DA274066995F7BA78,42071,19,20,1,31,49,1599
65166,65166,FDC21990CE7957FD340BB3EF965B0501,10511,0,5,5,35,46,1796
65167,65167,FDC21990CE7957FD340BB3EF965B0501,43241,8,9,1,36,46,1846
65168,65168,FDC21990CE7957FD340BB3EF965B0501,10951,10,12,2,29,48,1498
65169,65169,FDC21990CE7957FD340BB3EF965B0501,11381,13,14,1,30,47,1547
65170,65170,FDC21990CE7957FD340BB3EF965B0501,43241,17,22,5,36,46,1846
65171,65171,1129CFAE9FE6FF8D7F89EAB9AE20D07F,19441,0,9,9,8,46,446
65172,65172,1129CFAE9FE6FF8D7F89EAB9AE20D07F,19621,9,11,2,5,46,296
65173,65173,1129CFAE9FE6FF8D7F89EAB9AE20D07F,19441,11,13,2,8,46,446
65174,65174,1129CFAE9FE6FF8D7F89EAB9AE20D07F,19621,14,19,5,5,46,296
65175,65175,1129CFAE9FE6FF8D7F89EAB9AE20D07F,42041,21,23,2,10,47,547
65176,65176,D7D05175178ECCC354BF6E061771BD76,42511,0,7,7,37,47,1897
65177,65177,D7D05175178ECCC354BF6E061771BD76,11491,7,9,2,36,47,1847
65178,65178,D7D05175178ECCC354BF6E061771BD76,42511,9,10,1,37,47,1897
65179,65179,D7D05175178ECCC354BF6E061771BD76,43061,13,14,1,43,46,2196
65180,65180,D7D05175178ECCC354BF6E061771BD76,42601,18,19,1,44,48,2248
65181,65181,D7D05175178ECCC354BF6E061771BD76,42461,20,23,3,45,47,2297
65182,65182,4B5119258FB3482B746B53277561992F,12581,0,4,4,24,48,1248
65183,65183,4B5119258FB3482B746B53277561992F,12601,6,10,4,25,47,1297
65184,65184,4B5119258FB3482B746B53277561992F,12581,12,15,3,24,48,1248
65185,65185,4B5119258FB3482B746B53277561992F,12051,16,23,7,20,47,1047
65186,65186,6630F73295E745A92489061DD06C61E4,11324,0,7,7,31,46,1596
65187,65187,6630F73295E745A92489061DD06C61E4,42151,9,10,1,35,45,1795
65188,65188,6630F73295E745A92489061DD06C61E4,11324,13,22,9,31,46,1596
65192,65192,35E9D5C4DB2798EB0F9B63FDEDCAB714,42511,0,7,7,37,47,1897
65193,65193,35E9D5C4DB2798EB0F9B63FDEDCAB714,10631,8,16,8,28,46,1446
65194,65194,35E9D5C4DB2798EB0F9B63FDEDCAB714,42511,20,23,3,37,47,1897
65195,65195,52A195A8FE89EC70D1A1F00BB9B30229,12641,1,2,1,10,43,543
65196,65196,52A195A8FE89EC70D1A1F00BB9B30229,43021,5,13,8,16,43,843
65197,65197,52A195A8FE89EC70D1A1F00BB9B30229,43644,17,21,4,14,38,738
65198,65198,CE46A02CA196948C3D07DA5CEEB7BE83,43101,0,5,5,46,40,2340
65199,65199,CE46A02CA196948C3D07DA5CEEB7BE83,13551,5,6,1,45,38,2288
65200,65200,CE46A02CA196948C3D07DA5CEEB7BE83,43101,8,9,1,46,40,2340
65201,65201,CE46A02CA196948C3D07DA5CEEB7BE83,13551,9,12,3,45,38,2288
65202,65202,CE46A02CA196948C3D07DA5CEEB7BE83,43101,12,15,3,46,40,2340
65203,65203,CE46A02CA196948C3D07DA5CEEB7BE83,13551,15,22,7,45,38,2288
65204,65204,2163009C55B05ECD83E44729736749E5,40636,0,11,11,35,48,1798
65205,65205,2163009C55B05ECD83E44729736749E5,11381,13,15,2,30,47,1547
65206,65206,2163009C55B05ECD83E44729736749E5,42601,17,18,1,44,48,2248
65210,65210,6C2244D79333FB126D7C044044FC52BA,12491,0,5,5,36,43,1843
65211,65211,6C2244D79333FB126D7C044044FC52BA,43451,6,8,2,37,40,1890
65212,65212,6C2244D79333FB126D7C044044FC52BA,12491,11,13,2,36,43,1843
65213,65213,6C2244D79333FB126D7C044044FC52BA,43451,14,16,2,37,40,1890
65214,65214,6C2244D79333FB126D7C044044FC52BA,12491,16,17,1,36,43,1843
65215,65215,6C2244D79333FB126D7C044044FC52BA,43451,17,19,2,37,40,1890
65216,65216,6C2244D79333FB126D7C044044FC52BA,12491,19,23,4,36,43,1843
65227,65227,88BD05605A9A7AEE925115A05AB374F3,10491,0,10,10,33,48,1698
65228,65228,88BD05605A9A7AEE925115A05AB374F3,40341,12,17,5,23,49,1199
65229,65229,88BD05605A9A7AEE925115A05AB374F3,10491,18,23,5,33,48,1698
65236,65236,FACA7C472055342CB52356ECCA18D789,11261,0,2,2,36,46,1846
65237,65237,FACA7C472055342CB52356ECCA18D789,42864,2,3,1,38,44,1944
65238,65238,FACA7C472055342CB52356ECCA18D789,11261,7,9,2,36,46,1846
65239,65239,FACA7C472055342CB52356ECCA18D789,43041,9,10,1,41,46,2096
65240,65240,FACA7C472055342CB52356ECCA18D789,11261,10,12,2,36,46,1846
65241,65241,FACA7C472055342CB52356ECCA18D789,43341,13,23,10,41,46,2096
65242,65242,8AB561279CAFD673B81CFFF6F25401C3,12221,0,1,1,43,44,2194
65243,65243,8AB561279CAFD673B81CFFF6F25401C3,43011,5,8,3,40,42,2042
65244,65244,8AB561279CAFD673B81CFFF6F25401C3,13951,11,16,5,47,45,2395
65245,65245,8AB561279CAFD673B81CFFF6F25401C3,43011,18,23,5,40,42,2042
65246,65246,83410884B9DB9AC46D3034688A007B97,10191,0,14,14,40,48,2048
65247,65247,83410884B9DB9AC46D3034688A007B97,42623,15,16,1,22,49,1149
65248,65248,83410884B9DB9AC46D3034688A007B97,10191,21,23,2,40,48,2048
65252,65252,78875D602E8E6F484D7C11BFF3A852AA,10471,0,9,9,37,48,1898
65253,65253,78875D602E8E6F484D7C11BFF3A852AA,13091,11,13,2,20,42,1042
65254,65254,78875D602E8E6F484D7C11BFF3A852AA,43644,13,18,5,14,38,738
65268,65268,19D25F279817497EFC21CEB22B8E493D,10292,0,14,14,30,47,1547
65269,65269,19D25F279817497EFC21CEB22B8E493D,40341,15,16,1,23,49,1199
65270,65270,19D25F279817497EFC21CEB22B8E493D,10292,18,23,5,30,47,1547
65294,65294,F5CAB8F803ECE6BB91E5E9B3677179B2,11301,0,1,1,41,49,2099
65295,65295,F5CAB8F803ECE6BB91E5E9B3677179B2,42401,4,8,4,36,47,1847
65296,65296,F5CAB8F803ECE6BB91E5E9B3677179B2,10111,12,15,3,37,47,1897
65297,65297,F5CAB8F803ECE6BB91E5E9B3677179B2,40637,17,19,2,36,47,1847
65298,65298,F5CAB8F803ECE6BB91E5E9B3677179B2,10111,20,21,1,37,47,1897
65299,65299,5E72105F6B6E65DB7F6B78D7187F276E,13271,0,6,6,41,47,2097
65300,65300,5E72105F6B6E65DB7F6B78D7187F276E,12971,7,10,3,32,48,1648
65301,65301,5E72105F6B6E65DB7F6B78D7187F276E,11954,13,18,5,32,49,1649
65302,65302,5E72105F6B6E65DB7F6B78D7187F276E,10381,18,21,3,31,49,1599
65303,65303,06B93EFB145B54DB179CA15458589D6B,19441,0,4,4,8,46,446
65304,65304,06B93EFB145B54DB179CA15458589D6B,11104,5,7,2,17,47,897
65305,65305,06B93EFB145B54DB179CA15458589D6B,19441,11,14,3,8,46,446
65306,65306,06B93EFB145B54DB179CA15458589D6B,42041,15,17,2,10,47,547
65307,65307,06B93EFB145B54DB179CA15458589D6B,11231,19,23,4,37,49,1899
65314,65314,835E4AB3BB8C4699720E70AB108BA996,12491,3,5,2,36,43,1843
65315,65315,835E4AB3BB8C4699720E70AB108BA996,43451,6,10,4,37,40,1890
65316,65316,835E4AB3BB8C4699720E70AB108BA996,12491,12,13,1,36,43,1843
65317,65317,835E4AB3BB8C4699720E70AB108BA996,43451,13,15,2,37,40,1890
65318,65318,835E4AB3BB8C4699720E70AB108BA996,12491,19,23,4,36,43,1843
65319,65319,439D8CB010A4086802C0243322BA6C31,11061,0,7,7,29,48,1498
65320,65320,439D8CB010A4086802C0243322BA6C31,40343,9,16,7,24,49,1249
65321,65321,439D8CB010A4086802C0243322BA6C31,11061,18,23,5,29,48,1498
65322,65322,AF85AB0F84B58F4A12483525349C1572,43121,0,6,6,25,27,1277
65323,65323,AF85AB0F84B58F4A12483525349C1572,15191,6,10,4,36,27,1827
65324,65324,AF85AB0F84B58F4A12483525349C1572,43121,12,22,10,25,27,1277
65328,65328,01475812195B35D1DB0C04042252CA74,43361,0,16,16,38,48,1948
65329,65329,01475812195B35D1DB0C04042252CA74,40341,17,18,1,23,49,1199
65330,65330,01475812195B35D1DB0C04042252CA74,43361,20,23,3,38,48,1948
65331,65331,5BEB2181A6A1F539E3F1ADE013B38F8B,42071,0,9,9,31,49,1599
65332,65332,5BEB2181A6A1F539E3F1ADE013B38F8B,42081,10,11,1,24,49,1249
65333,65333,5BEB2181A6A1F539E3F1ADE013B38F8B,42071,12,15,3,31,49,1599
65334,65334,5BEB2181A6A1F539E3F1ADE013B38F8B,42081,15,16,1,24,49,1249
65335,65335,5BEB2181A6A1F539E3F1ADE013B38F8B,42071,18,20,2,31,49,1599
65336,65336,15A693525A24C01A2693CDB0D010B08C,12841,0,2,2,37,47,1897
65337,65337,15A693525A24C01A2693CDB0D010B08C,43761,2,14,12,32,47,1647
65338,65338,15A693525A24C01A2693CDB0D010B08C,43731,19,21,2,34,47,1747
65346,65346,F6265BE8D5B1D90F759154EDAB63EA2C,15191,0,16,16,36,27,1827
65347,65347,F6265BE8D5B1D90F759154EDAB63EA2C,12792,19,20,1,34,30,1730
65348,65348,F6265BE8D5B1D90F759154EDAB63EA2C,15191,20,23,3,36,27,1827
65355,65355,A8C8F80025B85535EF17FF46CAF9BC48,12661,1,7,6,32,45,1645
65356,65356,A8C8F80025B85535EF17FF46CAF9BC48,41591,12,13,1,34,49,1749
65357,65357,A8C8F80025B85535EF17FF46CAF9BC48,12661,16,22,6,32,45,1645
65358,65358,CC6CC1EF079547EC2E29F4E8D6EAB9B4,10881,1,4,3,34,48,1748
65359,65359,CC6CC1EF079547EC2E29F4E8D6EAB9B4,10491,5,11,6,33,48,1698
65360,65360,CC6CC1EF079547EC2E29F4E8D6EAB9B4,40341,12,17,5,23,49,1199
65361,65361,CC6CC1EF079547EC2E29F4E8D6EAB9B4,12031,18,22,4,33,48,1698
65362,65362,2FC430E1448F290A8E229F5C2301E320,49201,1,7,6,7,41,391
65363,65363,2FC430E1448F290A8E229F5C2301E320,12921,7,14,7,9,41,491
65364,65364,2FC430E1448F290A8E229F5C2301E320,12641,15,16,1,10,43,543
65365,65365,2FC430E1448F290A8E229F5C2301E320,12921,17,18,1,9,41,491
65366,65366,2FC430E1448F290A8E229F5C2301E320,49201,19,23,4,7,41,391
65377,65377,D8AC71E887733E14F7F7C2D94DADEE3F,11541,0,7,7,35,49,1799
65378,65378,D8AC71E887733E14F7F7C2D94DADEE3F,11531,8,15,7,34,49,1749
65379,65379,D8AC71E887733E14F7F7C2D94DADEE3F,40341,15,22,7,23,49,1199
65389,65389,2368366E71BED22EE0EB6EB4406A1C57,11151,0,1,1,30,48,1548
65390,65390,2368366E71BED22EE0EB6EB4406A1C57,10295,3,9,6,30,47,1547
65391,65391,2368366E71BED22EE0EB6EB4406A1C57,11324,12,13,1,31,46,1596
65392,65392,2368366E71BED22EE0EB6EB4406A1C57,40341,16,19,3,23,49,1199
65393,65393,2368366E71BED22EE0EB6EB4406A1C57,10295,19,20,1,30,47,1547
65403,65403,E75E9A8559DDAA5F20100934DD35A3D8,12841,0,3,3,37,47,1897
65404,65404,E75E9A8559DDAA5F20100934DD35A3D8,40673,4,5,1,36,48,1848
65405,65405,E75E9A8559DDAA5F20100934DD35A3D8,12841,5,7,2,37,47,1897
65406,65406,E75E9A8559DDAA5F20100934DD35A3D8,40673,9,18,9,36,48,1848
65407,65407,E75E9A8559DDAA5F20100934DD35A3D8,12841,19,20,1,37,47,1897
65408,65408,48D09EA1E123F030FD71CF37426D4799,43011,1,5,4,40,42,2042
65409,65409,48D09EA1E123F030FD71CF37426D4799,42151,6,14,8,35,45,1795
65410,65410,48D09EA1E123F030FD71CF37426D4799,43011,14,18,4,40,42,2042
65411,65411,48D09EA1E123F030FD71CF37426D4799,42151,19,23,4,35,45,1795
65412,65412,1283A24391E1B11BD547128AAB6C731F,11481,1,9,8,41,48,2098
65413,65413,1283A24391E1B11BD547128AAB6C731F,13091,12,13,1,20,42,1042
65414,65414,1283A24391E1B11BD547128AAB6C731F,40341,14,17,3,23,49,1199
65415,65415,1283A24391E1B11BD547128AAB6C731F,11481,20,23,3,41,48,2098
65416,65416,F5449661B4478E818EBFB16B1D5C019C,10411,0,13,13,36,48,1848
65417,65417,F5449661B4478E818EBFB16B1D5C019C,10221,13,15,2,34,49,1749
65418,65418,F5449661B4478E818EBFB16B1D5C019C,11551,19,20,1,39,49,1999
65419,65419,F5449661B4478E818EBFB16B1D5C019C,10771,22,23,1,41,46,2096
65423,65423,A4A9AA3D8E3E361C0226F1E837E451BF,11061,0,7,7,29,48,1498
65424,65424,A4A9AA3D8E3E361C0226F1E837E451BF,10381,10,12,2,31,49,1599
65425,65425,A4A9AA3D8E3E361C0226F1E837E451BF,11151,12,14,2,30,48,1548
65426,65426,A4A9AA3D8E3E361C0226F1E837E451BF,10107,16,18,2,38,49,1949
65427,65427,A4A9AA3D8E3E361C0226F1E837E451BF,12021,19,21,2,37,49,1899
65431,65431,4CA1188698B5DD1E66E2EDCA80216CDE,13071,1,6,5,41,41,2091
65432,65432,4CA1188698B5DD1E66E2EDCA80216CDE,43101,6,11,5,46,40,2340
65433,65433,4CA1188698B5DD1E66E2EDCA80216CDE,13071,14,20,6,41,41,2091
65441,65441,80E764BD1AB344D5249D2A4A0F5F0950,11591,0,6,6,36,49,1849
65442,65442,80E764BD1AB344D5249D2A4A0F5F0950,16211,9,20,11,4,3,203
65443,65443,80E764BD1AB344D5249D2A4A0F5F0950,11021,21,23,2,36,49,1849
65444,65444,3717F18D88C40095DBADE8C95C390E6F,42861,2,3,1,37,44,1894
65445,65445,3717F18D88C40095DBADE8C95C390E6F,42151,4,8,4,35,45,1795
65446,65446,3717F18D88C40095DBADE8C95C390E6F,42861,8,14,6,37,44,1894
65447,65447,3717F18D88C40095DBADE8C95C390E6F,42151,14,16,2,35,45,1795
65448,65448,3717F18D88C40095DBADE8C95C390E6F,43341,19,20,1,41,46,2096
65449,65449,3717F18D88C40095DBADE8C95C390E6F,42151,22,23,1,35,45,1795
65460,65460,4B51883F8D3BDAE9528DE7CF8D0F3245,12381,0,8,8,32,48,1648
65461,65461,4B51883F8D3BDAE9528DE7CF8D0F3245,42021,8,10,2,33,47,1697
65462,65462,4B51883F8D3BDAE9528DE7CF8D0F3245,12381,11,13,2,32,48,1648
65463,65463,4B51883F8D3BDAE9528DE7CF8D0F3245,42021,14,15,1,33,47,1697
65464,65464,4B51883F8D3BDAE9528DE7CF8D0F3245,12381,15,17,2,32,48,1648
65465,65465,4B51883F8D3BDAE9528DE7CF8D0F3245,42021,18,20,2,33,47,1697
65466,65466,4B51883F8D3BDAE9528DE7CF8D0F3245,12381,20,22,2,32,48,1648
65473,65473,AAC98D8EB5664A9B5DE56F266CB31991,16281,0,13,13,11,4,554
65474,65474,AAC98D8EB5664A9B5DE56F266CB31991,15143,13,15,2,18,7,907
65475,65475,AAC98D8EB5664A9B5DE56F266CB31991,16281,16,18,2,11,4,554
65479,65479,6E17E209924D93962579B4220EAAAC4C,13321,1,7,6,41,37,2087
65480,65480,6E17E209924D93962579B4220EAAAC4C,13911,9,15,6,39,46,1996
65481,65481,6E17E209924D93962579B4220EAAAC4C,43101,16,19,3,46,40,2340
65482,65482,6E17E209924D93962579B4220EAAAC4C,10331,21,22,1,39,46,1996
65483,65483,770F259854DCA0491B9BD5F231A3EB21,11861,0,13,13,32,47,1647
65484,65484,770F259854DCA0491B9BD5F231A3EB21,13961,14,16,2,42,48,2148
65485,65485,770F259854DCA0491B9BD5F231A3EB21,11861,17,21,4,32,47,1647
65486,65486,770F259854DCA0491B9BD5F231A3EB21,10151,22,23,1,34,47,1747
65491,65491,4568F4CB3839A063AA85BE5AD656F1DE,11201,0,5,5,35,49,1799
65492,65492,4568F4CB3839A063AA85BE5AD656F1DE,42491,9,14,5,32,46,1646
65493,65493,4568F4CB3839A063AA85BE5AD656F1DE,11751,21,23,2,35,48,1798
65494,65494,46624C7A7A05E81084BABC40FE8F937C,13314,0,8,8,31,39,1589
65495,65495,46624C7A7A05E81084BABC40FE8F937C,12521,8,15,7,35,41,1791
65496,65496,46624C7A7A05E81084BABC40FE8F937C,13314,20,23,3,31,39,1589
65500,65500,CA41CB6FEF51EB54C24504996257175B,19741,0,9,9,5,44,294
65501,65501,CA41CB6FEF51EB54C24504996257175B,13381,15,16,1,39,47,1997
65502,65502,CA41CB6FEF51EB54C24504996257175B,11261,17,20,3,36,46,1846
65503,65503,CA41CB6FEF51EB54C24504996257175B,19741,21,23,2,5,44,294
65504,65504,2387C9B8CDBCC76964EECEDCBE770F19,42401,4,14,10,36,47,1847
65505,65505,2387C9B8CDBCC76964EECEDCBE770F19,42381,15,16,1,39,41,1991
65506,65506,2387C9B8CDBCC76964EECEDCBE770F19,13561,18,19,1,37,49,1899
65507,65507,2387C9B8CDBCC76964EECEDCBE770F19,40637,20,23,3,36,47,1847
65514,65514,D8190C5AEF802F660361781E1849508A,10731,9,10,1,33,47,1697
65515,65515,D8190C5AEF802F660361781E1849508A,40951,15,16,1,36,49,1849
65516,65516,D8190C5AEF802F660361781E1849508A,10731,18,21,3,33,47,1697
65517,65517,B16AADC70667F1407A8020F9E0E0F89A,11921,0,4,4,38,48,1948
65518,65518,B16AADC70667F1407A8020F9E0E0F89A,10634,6,7,1,27,45,1395
65519,65519,B16AADC70667F1407A8020F9E0E0F89A,11921,11,23,12,38,48,1948
65520,65520,FEA371B99B04FC8CCEB8F07D4D5C7BA2,13601,1,8,7,34,47,1747
65521,65521,FEA371B99B04FC8CCEB8F07D4D5C7BA2,10292,8,12,4,30,47,1547
65522,65522,FEA371B99B04FC8CCEB8F07D4D5C7BA2,13601,12,15,3,34,47,1747
65523,65523,FEA371B99B04FC8CCEB8F07D4D5C7BA2,42921,16,17,1,33,47,1697
65524,65524,FEA371B99B04FC8CCEB8F07D4D5C7BA2,10781,22,23,1,35,47,1797
65535,65535,7A143BD9C6C6A603EFC39F168BBE922E,12521,0,7,7,35,41,1791
65536,65536,7A143BD9C6C6A603EFC39F168BBE922E,13351,10,15,5,48,48,2448
65537,65537,7A143BD9C6C6A603EFC39F168BBE922E,12521,19,23,4,35,41,1791
65538,65538,687AA535BB1385DA256EEAE1E316875E,13671,1,12,11,27,43,1393
65539,65539,687AA535BB1385DA256EEAE1E316875E,10292,14,16,2,30,47,1547
65540,65540,687AA535BB1385DA256EEAE1E316875E,11861,20,22,2,32,47,1647
65544,65544,F1249E9F0C0E4CFC8DF3A999C283E2E8,42791,0,7,7,35,45,1795
65545,65545,F1249E9F0C0E4CFC8DF3A999C283E2E8,10351,8,15,7,28,45,1445
65546,65546,F1249E9F0C0E4CFC8DF3A999C283E2E8,42791,19,23,4,35,45,1795
65547,65547,FA215D037E3ED3281544DD70764B37AD,11021,0,12,12,36,49,1849
65548,65548,FA215D037E3ED3281544DD70764B37AD,11324,13,15,2,31,46,1596
65549,65549,FA215D037E3ED3281544DD70764B37AD,11021,16,23,7,36,49,1849
65550,65550,C7B2C2AE2DF954A69981F5A4F94159CA,13671,1,7,6,27,43,1393
65551,65551,C7B2C2AE2DF954A69981F5A4F94159CA,42351,9,13,4,38,45,1945
65552,65552,C7B2C2AE2DF954A69981F5A4F94159CA,13671,16,17,1,27,43,1393
65553,65553,C7B2C2AE2DF954A69981F5A4F94159CA,42351,20,21,1,38,45,1945
65554,65554,6975A57D8AEEA17C1A623171368D0686,43181,0,8,8,39,48,1998
65555,65555,6975A57D8AEEA17C1A623171368D0686,42221,10,12,2,38,48,1948
65556,65556,6975A57D8AEEA17C1A623171368D0686,41601,15,17,2,39,49,1999
65557,65557,6975A57D8AEEA17C1A623171368D0686,42523,20,23,3,31,47,1597
65558,65558,8DA8A44C9645A67744675BFF876BC4D6,13121,1,7,6,38,46,1946
65559,65559,8DA8A44C9645A67744675BFF876BC4D6,12083,9,19,10,36,49,1849
65560,65560,8DA8A44C9645A67744675BFF876BC4D6,13121,22,23,1,38,46,1946
65565,65565,FA7A94CADC962325319C28486D92F065,15051,0,7,7,19,4,954
65566,65566,FA7A94CADC962325319C28486D92F065,16281,7,9,2,11,4,554
65567,65567,FA7A94CADC962325319C28486D92F065,15051,11,22,11,19,4,954
65568,65568,181802B57A29F4FAE1E7EF60B334A9D5,13911,0,1,1,39,46,1996
65569,65569,181802B57A29F4FAE1E7EF60B334A9D5,42351,1,2,1,38,45,1945
65570,65570,181802B57A29F4FAE1E7EF60B334A9D5,13911,2,5,3,39,46,1996
65571,65571,181802B57A29F4FAE1E7EF60B334A9D5,42231,6,11,5,37,46,1896
65572,65572,181802B57A29F4FAE1E7EF60B334A9D5,42351,11,12,1,38,45,1945
65573,65573,181802B57A29F4FAE1E7EF60B334A9D5,42231,14,18,4,37,46,1896
65577,65577,E50F4145E7172C777C1211201DD5EE77,42871,0,7,7,30,45,1545
65578,65578,E50F4145E7172C777C1211201DD5EE77,12311,7,10,3,30,44,1544
65579,65579,E50F4145E7172C777C1211201DD5EE77,42871,12,13,1,30,45,1545
65580,65580,E50F4145E7172C777C1211201DD5EE77,12311,14,17,3,30,44,1544
65581,65581,E50F4145E7172C777C1211201DD5EE77,42871,18,23,5,30,45,1545
65582,65582,91F3AF3BE43493682A07F2B71D9E0F35,10631,1,10,9,28,46,1446
65583,65583,91F3AF3BE43493682A07F2B71D9E0F35,40951,14,15,1,36,49,1849
65584,65584,91F3AF3BE43493682A07F2B71D9E0F35,10631,20,21,1,28,46,1446
65603,65603,6DF35DAE192483CB93C20B4A54B0D0B0,10431,1,14,13,33,49,1699
65604,65604,6DF35DAE192483CB93C20B4A54B0D0B0,13771,16,17,1,21,45,1095
65605,65605,6DF35DAE192483CB93C20B4A54B0D0B0,12971,20,23,3,32,48,1648
65606,65606,63AAB4E2754CD06C7A024CF5DB6B083C,11951,0,7,7,31,49,1599
65607,65607,63AAB4E2754CD06C7A024CF5DB6B083C,11914,7,19,12,37,48,1898
65608,65608,63AAB4E2754CD06C7A024CF5DB6B083C,11951,21,23,2,31,49,1599
65615,65615,A1E88710F597AD993ACF1C23AEB06926,42271,0,6,6,40,47,2047
65616,65616,A1E88710F597AD993ACF1C23AEB06926,15261,7,10,3,39,13,1963
65617,65617,A1E88710F597AD993ACF1C23AEB06926,42271,12,23,11,40,47,2047
65618,65618,FC386E5EE84DD966E138539871A3312A,10881,1,8,7,34,48,1748
65619,65619,FC386E5EE84DD966E138539871A3312A,13711,12,13,1,38,46,1946
65620,65620,FC386E5EE84DD966E138539871A3312A,41091,15,18,3,35,49,1799
65625,65625,AB45C6D4DFF8370476E2476D3FA63031,19441,0,2,2,8,46,446
65626,65626,AB45C6D4DFF8370476E2476D3FA63031,42041,3,4,1,10,47,547
65627,65627,AB45C6D4DFF8370476E2476D3FA63031,19441,6,15,9,8,46,446
65628,65628,AB45C6D4DFF8370476E2476D3FA63031,42041,15,17,2,10,47,547
65629,65629,AB45C6D4DFF8370476E2476D3FA63031,19441,18,20,2,8,46,446
65633,65633,193603340935DA55C70322807542A372,19111,1,6,5,9,45,495
65634,65634,193603340935DA55C70322807542A372,12641,7,12,5,10,43,543
65635,65635,193603340935DA55C70322807542A372,19111,12,14,2,9,45,495
65636,65636,193603340935DA55C70322807542A372,12921,16,18,2,9,41,491
65637,65637,193603340935DA55C70322807542A372,19114,18,19,1,7,43,393
65638,65638,193603340935DA55C70322807542A372,13121,22,23,1,38,46,1946
65639,65639,AC0F9A0DA655EB0858F47B6C2577B3DE,13671,0,2,2,27,43,1393
65640,65640,AC0F9A0DA655EB0858F47B6C2577B3DE,11281,3,5,2,27,40,1390
65641,65641,AC0F9A0DA655EB0858F47B6C2577B3DE,13671,5,11,6,27,43,1393
65642,65642,AC0F9A0DA655EB0858F47B6C2577B3DE,11281,11,13,2,27,40,1390
65643,65643,AC0F9A0DA655EB0858F47B6C2577B3DE,13671,14,15,1,27,43,1393
65644,65644,AC0F9A0DA655EB0858F47B6C2577B3DE,11281,15,22,7,27,40,1390
65645,65645,ACE6CA8B487669BE8A7949AA7EA2747D,12381,4,12,8,32,48,1648
65646,65646,ACE6CA8B487669BE8A7949AA7EA2747D,10911,13,16,3,39,46,1996
65647,65647,ACE6CA8B487669BE8A7949AA7EA2747D,10221,18,19,1,34,49,1749
65648,65648,ACE6CA8B487669BE8A7949AA7EA2747D,11201,20,23,3,35,49,1799
65652,65652,92E340B82C56A45F91D53CD2B709557E,11914,7,8,1,37,48,1898
65653,65653,92E340B82C56A45F91D53CD2B709557E,42581,11,14,3,38,48,1948
65654,65654,92E340B82C56A45F91D53CD2B709557E,12514,14,15,1,38,47,1947
65655,65655,92E340B82C56A45F91D53CD2B709557E,11914,16,17,1,37,48,1898
65656,65656,92E340B82C56A45F91D53CD2B709557E,42581,18,23,5,38,48,1948
65657,65657,60E7DB34A5C3339F3E380BAE16A05DCF,19741,0,7,7,5,44,294
65658,65658,60E7DB34A5C3339F3E380BAE16A05DCF,12641,9,10,1,10,43,543
65659,65659,60E7DB34A5C3339F3E380BAE16A05DCF,19111,12,15,3,9,45,495
65660,65660,60E7DB34A5C3339F3E380BAE16A05DCF,19114,16,17,1,7,43,393
65661,65661,60E7DB34A5C3339F3E380BAE16A05DCF,19741,18,23,5,5,44,294
65662,65662,513F68B36275430998F4E5E2941E1D28,10271,0,14,14,37,46,1896
65663,65663,513F68B36275430998F4E5E2941E1D28,11531,19,20,1,34,49,1749
65664,65664,513F68B36275430998F4E5E2941E1D28,13121,21,23,2,38,46,1946
65665,65665,FF9FF13467BA4E869B472FF302BE470A,43471,0,10,10,31,49,1599
65666,65666,FF9FF13467BA4E869B472FF302BE470A,40951,13,15,2,36,49,1849
65667,65667,FF9FF13467BA4E869B472FF302BE470A,11751,16,17,1,35,48,1798
65668,65668,FF9FF13467BA4E869B472FF302BE470A,43471,19,23,4,31,49,1599
65669,65669,2C19FDC386B0B2E924F75B25676D719F,42231,0,1,1,37,46,1896
65670,65670,2C19FDC386B0B2E924F75B25676D719F,42351,2,10,8,38,45,1945
65671,65671,2C19FDC386B0B2E924F75B25676D719F,42231,13,15,2,37,46,1896
65672,65672,2C19FDC386B0B2E924F75B25676D719F,42351,16,18,2,38,45,1945
65673,65673,2C19FDC386B0B2E924F75B25676D719F,13011,20,22,2,39,47,1997
65677,65677,0AE01B9B54FEFE84315FE108EDDE3B30,43761,0,7,7,32,47,1647
65678,65678,0AE01B9B54FEFE84315FE108EDDE3B30,11161,7,13,6,32,48,1648
65679,65679,0AE01B9B54FEFE84315FE108EDDE3B30,43761,13,14,1,32,47,1647
65680,65680,0AE01B9B54FEFE84315FE108EDDE3B30,11161,16,19,3,32,48,1648
65681,65681,0AE01B9B54FEFE84315FE108EDDE3B30,43761,19,21,2,32,47,1647
65682,65682,91C845F33B01C4DA71C1A0D3DEBCFC93,42221,3,6,3,38,48,1948
65683,65683,91C845F33B01C4DA71C1A0D3DEBCFC93,10591,7,8,1,39,48,1998
65684,65684,91C845F33B01C4DA71C1A0D3DEBCFC93,12514,10,13,3,38,47,1947
65685,65685,91C845F33B01C4DA71C1A0D3DEBCFC93,42221,13,17,4,38,48,1948
65686,65686,91C845F33B01C4DA71C1A0D3DEBCFC93,13951,20,22,2,47,45,2395
65690,65690,0BE2407C55A4DCDC9485B61EAADF205F,10411,0,10,10,36,48,1848
65691,65691,0BE2407C55A4DCDC9485B61EAADF205F,11541,14,16,2,35,49,1799
65692,65692,0BE2407C55A4DCDC9485B61EAADF205F,40341,18,21,3,23,49,1199
65693,65693,C3725AB64BF9C173A9EEFFE545CDAD83,10107,0,10,10,38,49,1949
65694,65694,C3725AB64BF9C173A9EEFFE545CDAD83,10921,11,12,1,43,48,2198
65695,65695,C3725AB64BF9C173A9EEFFE545CDAD83,10924,12,14,2,43,49,2199
65696,65696,C3725AB64BF9C173A9EEFFE545CDAD83,43161,20,21,1,35,47,1797
65697,65697,B1D714EAA88F4188BDEB8AEAFDE91C5B,42461,0,6,6,45,47,2297
65698,65698,B1D714EAA88F4188BDEB8AEAFDE91C5B,42111,6,7,1,44,46,2246
65699,65699,B1D714EAA88F4188BDEB8AEAFDE91C5B,42461,10,11,1,45,47,2297
65700,65700,B1D714EAA88F4188BDEB8AEAFDE91C5B,42111,11,18,7,44,46,2246
65701,65701,B1D714EAA88F4188BDEB8AEAFDE91C5B,11701,19,21,2,43,48,2198
65702,65702,B1D714EAA88F4188BDEB8AEAFDE91C5B,42461,21,23,2,45,47,2297
65709,65709,2C3A1C890B30FB06A95DD4A9EF742265,19801,0,5,5,19,26,976
65710,65710,2C3A1C890B30FB06A95DD4A9EF742265,43121,6,11,5,25,27,1277
65711,65711,2C3A1C890B30FB06A95DD4A9EF742265,19801,12,14,2,19,26,976
65712,65712,2C3A1C890B30FB06A95DD4A9EF742265,43121,15,19,4,25,27,1277
65713,65713,2C3A1C890B30FB06A95DD4A9EF742265,19801,19,22,3,19,26,976
65714,65714,6B78BA76894FB2D58CB6C48FC3CBEEF5,13911,0,3,3,39,46,1996
65715,65715,6B78BA76894FB2D58CB6C48FC3CBEEF5,42231,5,6,1,37,46,1896
65716,65716,6B78BA76894FB2D58CB6C48FC3CBEEF5,13911,9,11,2,39,46,1996
65717,65717,6B78BA76894FB2D58CB6C48FC3CBEEF5,42231,14,16,2,37,46,1896
65718,65718,6B78BA76894FB2D58CB6C48FC3CBEEF5,13911,17,20,3,39,46,1996
65732,65732,D8F26E13541A4D201885591EA4BE04DA,19114,2,6,4,7,43,393
65733,65733,D8F26E13541A4D201885591EA4BE04DA,12641,6,9,3,10,43,543
65734,65734,D8F26E13541A4D201885591EA4BE04DA,19114,11,13,2,7,43,393
65735,65735,D8F26E13541A4D201885591EA4BE04DA,12921,14,17,3,9,41,491
65736,65736,D8F26E13541A4D201885591EA4BE04DA,19114,18,19,1,7,43,393
65737,65737,2D6FDB3C321FD7B096048D3D8304E7BC,11001,0,1,1,42,47,2147
65738,65738,2D6FDB3C321FD7B096048D3D8304E7BC,42321,1,6,5,43,47,2197
65739,65739,2D6FDB3C321FD7B096048D3D8304E7BC,11001,8,9,1,42,47,2147
65740,65740,2D6FDB3C321FD7B096048D3D8304E7BC,43061,10,12,2,43,46,2196
65741,65741,2D6FDB3C321FD7B096048D3D8304E7BC,11001,13,14,1,42,47,2147
65742,65742,2D6FDB3C321FD7B096048D3D8304E7BC,13371,14,17,3,41,47,2097
65743,65743,2D6FDB3C321FD7B096048D3D8304E7BC,43061,19,20,1,43,46,2196
65744,65744,2D6FDB3C321FD7B096048D3D8304E7BC,11001,22,23,1,42,47,2147
65748,65748,1BABC9D2139583D8D5A8610AD83945FA,16281,9,18,9,11,4,554
65749,65749,1BABC9D2139583D8D5A8610AD83945FA,15051,20,21,1,19,4,954
65750,65750,1BABC9D2139583D8D5A8610AD83945FA,16281,22,23,1,11,4,554
65755,65755,37962856117A2407567ADA7A2024E465,11351,0,2,2,36,48,1848
65756,65756,37962856117A2407567ADA7A2024E465,10911,4,9,5,39,46,1996
65757,65757,37962856117A2407567ADA7A2024E465,13711,11,23,12,38,46,1946
65758,65758,2ADB2706A9353131D282383D1A05F963,11351,0,10,10,36,48,1848
65759,65759,2ADB2706A9353131D282383D1A05F963,11021,14,18,4,36,49,1849
65760,65760,2ADB2706A9353131D282383D1A05F963,42121,21,23,2,26,49,1349
65770,65770,D79344AF708957F6520D85DB97251A94,11281,2,5,3,27,40,1390
65771,65771,D79344AF708957F6520D85DB97251A94,12521,8,17,9,35,41,1791
65772,65772,D79344AF708957F6520D85DB97251A94,12841,21,23,2,37,47,1897
65773,65773,2810C9C93BF5DC5223E22FA55DF1299D,42623,2,10,8,22,49,1149
65774,65774,2810C9C93BF5DC5223E22FA55DF1299D,10107,13,14,1,38,49,1949
65775,65775,2810C9C93BF5DC5223E22FA55DF1299D,40951,15,16,1,36,49,1849
65776,65776,2810C9C93BF5DC5223E22FA55DF1299D,42623,18,21,3,22,49,1149
65783,65783,8158B46C2C2D7019B94606EB933B844C,12641,0,8,8,10,43,543
65784,65784,8158B46C2C2D7019B94606EB933B844C,13481,12,14,2,26,31,1331
65785,65785,8158B46C2C2D7019B94606EB933B844C,40341,15,16,1,23,49,1199
65786,65786,8158B46C2C2D7019B94606EB933B844C,12641,20,23,3,10,43,543
65787,65787,86C177FE29427D11B9077C5F541A2B81,10191,0,8,8,40,48,2048
65788,65788,86C177FE29427D11B9077C5F541A2B81,12131,9,11,2,32,47,1647
65789,65789,86C177FE29427D11B9077C5F541A2B81,10191,12,14,2,40,48,2048
65790,65790,86C177FE29427D11B9077C5F541A2B81,12401,18,20,2,39,49,1999
65791,65791,86C177FE29427D11B9077C5F541A2B81,11701,20,23,3,43,48,2198
65792,65792,90568B514F9B63E4374F225CB87C45A4,11021,0,11,11,36,49,1849
65793,65793,90568B514F9B63E4374F225CB87C45A4,40271,11,12,1,35,49,1799
65794,65794,90568B514F9B63E4374F225CB87C45A4,11021,13,14,1,36,49,1849
65795,65795,90568B514F9B63E4374F225CB87C45A4,40271,16,17,1,35,49,1799
65796,65796,90568B514F9B63E4374F225CB87C45A4,12381,19,21,2,32,48,1648
65797,65797,90568B514F9B63E4374F225CB87C45A4,11021,22,23,1,36,49,1849
65816,65816,3AAB646736804F2C3C62D48784909771,42921,0,8,8,33,47,1697
65817,65817,3AAB646736804F2C3C62D48784909771,13371,10,18,8,41,47,2097
65818,65818,3AAB646736804F2C3C62D48784909771,42921,22,23,1,33,47,1697
65819,65819,4B35F3A0B07623EAC4DADDFC732DD8CB,43011,0,8,8,40,42,2042
65820,65820,4B35F3A0B07623EAC4DADDFC732DD8CB,10911,9,15,6,39,46,1996
65821,65821,4B35F3A0B07623EAC4DADDFC732DD8CB,11481,16,18,2,41,48,2098
65825,65825,6817DB094271302744F441100FAF5A74,10931,2,5,3,41,48,2098
65826,65826,6817DB094271302744F441100FAF5A74,10191,8,11,3,40,48,2048
65827,65827,6817DB094271302744F441100FAF5A74,10931,12,13,1,41,48,2098
65828,65828,6817DB094271302744F441100FAF5A74,10191,13,14,1,40,48,2048
65829,65829,6817DB094271302744F441100FAF5A74,42341,15,16,1,43,49,2199
65830,65830,6817DB094271302744F441100FAF5A74,10931,18,23,5,41,48,2098
65841,65841,ECD2E451419916CC2E55F4C55D7D52A8,10295,0,6,6,30,47,1547
65842,65842,ECD2E451419916CC2E55F4C55D7D52A8,42541,7,14,7,25,47,1297
65843,65843,ECD2E451419916CC2E55F4C55D7D52A8,10511,16,17,1,35,46,1796
65844,65844,ECD2E451419916CC2E55F4C55D7D52A8,43341,19,20,1,41,46,2096
65845,65845,8B98AD14780EFE4A809080D8E1142428,42221,0,8,8,38,48,1948
65846,65846,8B98AD14780EFE4A809080D8E1142428,42201,10,16,6,43,46,2196
65847,65847,8B98AD14780EFE4A809080D8E1142428,42511,19,23,4,37,47,1897
65848,65848,BB3DB8BDA13F245F7DA1B278DE6D4FF0,43021,0,5,5,16,43,843
65849,65849,BB3DB8BDA13F245F7DA1B278DE6D4FF0,12641,6,7,1,10,43,543
65850,65850,BB3DB8BDA13F245F7DA1B278DE6D4FF0,12921,8,9,1,9,41,491
65851,65851,BB3DB8BDA13F245F7DA1B278DE6D4FF0,12641,12,16,4,10,43,543
65852,65852,BB3DB8BDA13F245F7DA1B278DE6D4FF0,43021,18,23,5,16,43,843
65853,65853,75219378BBB10FFE07C7301517B53FE1,11231,0,12,12,37,49,1899
65854,65854,75219378BBB10FFE07C7301517B53FE1,43281,12,18,6,37,48,1898
65855,65855,75219378BBB10FFE07C7301517B53FE1,11074,19,21,2,37,47,1897
65856,65856,75219378BBB10FFE07C7301517B53FE1,42271,22,23,1,40,47,2047
65857,65857,999F2C76DEAF7D23C337AF7700A1D1B4,12641,0,2,2,10,43,543
65858,65858,999F2C76DEAF7D23C337AF7700A1D1B4,43644,4,5,1,14,38,738
65859,65859,999F2C76DEAF7D23C337AF7700A1D1B4,12641,5,6,1,10,43,543
65860,65860,999F2C76DEAF7D23C337AF7700A1D1B4,43641,15,17,2,16,38,838
65861,65861,999F2C76DEAF7D23C337AF7700A1D1B4,12641,20,22,2,10,43,543
65868,65868,706D3686B63F45412BBEC0FD26A6D729,11381,7,8,1,30,47,1547
65869,65869,706D3686B63F45412BBEC0FD26A6D729,10901,9,18,9,35,48,1798
65870,65870,706D3686B63F45412BBEC0FD26A6D729,11381,19,22,3,30,47,1547
65874,65874,4AAC306965E56CD4A348AD06A8E0AA0B,11551,0,14,14,39,49,1999
65875,65875,4AAC306965E56CD4A348AD06A8E0AA0B,42161,14,17,3,36,47,1847
65876,65876,4AAC306965E56CD4A348AD06A8E0AA0B,41591,18,20,2,34,49,1749
65877,65877,4AAC306965E56CD4A348AD06A8E0AA0B,11551,20,23,3,39,49,1999
65887,65887,F36A73BDDFA53560DF71BCDBD0DE662F,13461,3,4,1,39,44,1994
65888,65888,F36A73BDDFA53560DF71BCDBD0DE662F,11261,5,8,3,36,46,1846
65889,65889,F36A73BDDFA53560DF71BCDBD0DE662F,13461,8,9,1,39,44,1994
65890,65890,F36A73BDDFA53560DF71BCDBD0DE662F,11261,13,19,6,36,46,1846
65891,65891,F36A73BDDFA53560DF71BCDBD0DE662F,42861,22,23,1,37,44,1894
65892,65892,6DCAC2F18F7407E5D3AE4A23200E1C6B,13511,0,2,2,34,48,1748
65893,65893,6DCAC2F18F7407E5D3AE4A23200E1C6B,11381,3,11,8,30,47,1547
65894,65894,6DCAC2F18F7407E5D3AE4A23200E1C6B,10951,11,16,5,29,48,1498
65895,65895,6DCAC2F18F7407E5D3AE4A23200E1C6B,13941,19,21,2,41,47,2097
65896,65896,A6B119DF434B85333915F512414EB539,19441,0,14,14,8,46,446
65897,65897,A6B119DF434B85333915F512414EB539,10211,15,16,1,16,49,849
65898,65898,A6B119DF434B85333915F512414EB539,19441,20,23,3,8,46,446
65906,65906,28300346F85722C9AE073B4E944370CF,40123,0,7,7,38,47,1947
65907,65907,28300346F85722C9AE073B4E944370CF,42161,11,12,1,36,47,1847
65908,65908,28300346F85722C9AE073B4E944370CF,10841,12,14,2,37,47,1897
65909,65909,28300346F85722C9AE073B4E944370CF,42161,15,16,1,36,47,1847
65910,65910,28300346F85722C9AE073B4E944370CF,10841,18,19,1,37,47,1897
65911,65911,28300346F85722C9AE073B4E944370CF,12514,19,23,4,38,47,1947
65916,65916,32DF610796708DAF5BAF2E5269C26359,43011,0,6,6,40,42,2042
65917,65917,32DF610796708DAF5BAF2E5269C26359,13071,7,8,1,41,41,2091
65918,65918,32DF610796708DAF5BAF2E5269C26359,43011,9,10,1,40,42,2042
65919,65919,32DF610796708DAF5BAF2E5269C26359,12511,14,16,2,39,47,1997
65920,65920,32DF610796708DAF5BAF2E5269C26359,13071,18,23,5,41,41,2091
65928,65928,FBFB039BFE202B4D733B8197A5DE9AA1,43751,1,5,4,19,48,998
65929,65929,FBFB039BFE202B4D733B8197A5DE9AA1,12581,7,15,8,24,48,1248
65930,65930,FBFB039BFE202B4D733B8197A5DE9AA1,11361,15,16,1,22,48,1148
65931,65931,FBFB039BFE202B4D733B8197A5DE9AA1,43751,19,20,1,19,48,998
65932,65932,14DC78B96F17324DFD0B44C76818BC45,11381,0,14,14,30,47,1547
65933,65933,14DC78B96F17324DFD0B44C76818BC45,43761,15,16,1,32,47,1647
65934,65934,14DC78B96F17324DFD0B44C76818BC45,40271,21,22,1,35,49,1799
65938,65938,370BEBFAF0F07D0E48A05EAAA57C2ED7,43761,1,15,14,32,47,1647
65939,65939,370BEBFAF0F07D0E48A05EAAA57C2ED7,40691,17,20,3,42,48,2148
65940,65940,370BEBFAF0F07D0E48A05EAAA57C2ED7,11861,22,23,1,32,47,1647
65962,65962,3CA411279DBBFEE58EB92FE73F745066,11461,0,10,10,37,49,1899
65963,65963,3CA411279DBBFEE58EB92FE73F745066,40341,13,14,1,23,49,1199
65964,65964,3CA411279DBBFEE58EB92FE73F745066,11461,17,23,6,37,49,1899
65971,65971,001A105B6094BC6BD898C0673D443477,11361,3,6,3,22,48,1148
65972,65972,001A105B6094BC6BD898C0673D443477,12581,6,9,3,24,48,1248
65973,65973,001A105B6094BC6BD898C0673D443477,12601,11,14,3,25,47,1297
65974,65974,001A105B6094BC6BD898C0673D443477,11324,15,23,8,31,46,1596
65975,65975,B969FE7CA88FA294C8201CFC44CC669E,12121,0,7,7,29,47,1497
65976,65976,B969FE7CA88FA294C8201CFC44CC669E,12601,11,13,2,25,47,1297
65977,65977,B969FE7CA88FA294C8201CFC44CC669E,10501,14,15,1,22,46,1146
65978,65978,B969FE7CA88FA294C8201CFC44CC669E,12121,16,23,7,29,47,1497
65983,65983,4F4B2C6A2634BA91ED0EC0EA220AA310,10491,3,9,6,33,48,1698
65984,65984,4F4B2C6A2634BA91ED0EC0EA220AA310,12514,12,13,1,38,47,1947
65985,65985,4F4B2C6A2634BA91ED0EC0EA220AA310,10841,13,16,3,37,47,1897
65986,65986,4F4B2C6A2634BA91ED0EC0EA220AA310,12514,16,18,2,38,47,1947
65987,65987,4F4B2C6A2634BA91ED0EC0EA220AA310,10881,21,23,2,34,48,1748
65994,65994,B103546F88903BAA077A28BC1468C0D4,12921,0,2,2,9,41,491
65995,65995,B103546F88903BAA077A28BC1468C0D4,13091,3,5,2,20,42,1042
65996,65996,B103546F88903BAA077A28BC1468C0D4,12921,6,19,13,9,41,491
66000,66000,494D4CE05480984DBEB3A2073E0D7F93,42411,2,8,6,40,49,2049
66001,66001,494D4CE05480984DBEB3A2073E0D7F93,12381,9,18,9,32,48,1648
66002,66002,494D4CE05480984DBEB3A2073E0D7F93,12401,19,20,1,39,49,1999
66003,66003,494D4CE05480984DBEB3A2073E0D7F93,43321,21,23,2,36,49,1849
66007,66007,566A98F570A1628E8F6EFD9CFCC9370E,12491,0,7,7,36,43,1843
66008,66008,566A98F570A1628E8F6EFD9CFCC9370E,12661,8,10,2,32,45,1645
66009,66009,566A98F570A1628E8F6EFD9CFCC9370E,12491,12,23,11,36,43,1843
66014,66014,B86DD6B56CB6E62518694B88E33F0217,10191,0,9,9,40,48,2048
66015,66015,B86DD6B56CB6E62518694B88E33F0217,11021,11,15,4,36,49,1849
66016,66016,B86DD6B56CB6E62518694B88E33F0217,11954,15,17,2,32,49,1649
66017,66017,B86DD6B56CB6E62518694B88E33F0217,41591,18,20,2,34,49,1749
66018,66018,B86DD6B56CB6E62518694B88E33F0217,42623,21,23,2,22,49,1149
66019,66019,27B6DDFE3A356062F221ABD7AD70BB14,11061,0,9,9,29,48,1498
66020,66020,27B6DDFE3A356062F221ABD7AD70BB14,10681,10,11,1,30,48,1548
66021,66021,27B6DDFE3A356062F221ABD7AD70BB14,11061,11,15,4,29,48,1498
66022,66022,27B6DDFE3A356062F221ABD7AD70BB14,10681,17,18,1,30,48,1548
66023,66023,27B6DDFE3A356062F221ABD7AD70BB14,11061,19,23,4,29,48,1498
66028,66028,CE83884CFD17B5073DAD15A75E54F414,12521,6,11,5,35,41,1791
66029,66029,CE83884CFD17B5073DAD15A75E54F414,42511,14,15,1,37,47,1897
66030,66030,CE83884CFD17B5073DAD15A75E54F414,12521,20,21,1,35,41,1791
66035,66035,D3316346B786BB724018E391DDA219EB,11211,0,11,11,34,49,1749
66036,66036,D3316346B786BB724018E391DDA219EB,40341,12,15,3,23,49,1199
66037,66037,D3316346B786BB724018E391DDA219EB,10221,17,23,6,34,49,1749
66038,66038,A845F5E6E274947D69D978D433D48E69,11331,0,8,8,37,48,1898
66039,66039,A845F5E6E274947D69D978D433D48E69,10841,8,11,3,37,47,1897
66040,66040,A845F5E6E274947D69D978D433D48E69,12601,13,15,2,25,47,1297
66041,66041,A845F5E6E274947D69D978D433D48E69,11914,17,19,2,37,48,1898
66042,66042,A845F5E6E274947D69D978D433D48E69,10661,20,23,3,37,49,1899
66043,66043,1EAE8E0D28D79DCFE0DA0CD7004A4A71,11571,0,4,4,13,46,696
66044,66044,1EAE8E0D28D79DCFE0DA0CD7004A4A71,19441,5,8,3,8,46,446
66045,66045,1EAE8E0D28D79DCFE0DA0CD7004A4A71,42041,8,10,2,10,47,547
66046,66046,1EAE8E0D28D79DCFE0DA0CD7004A4A71,19621,10,12,2,5,46,296
66047,66047,1EAE8E0D28D79DCFE0DA0CD7004A4A71,42041,15,18,3,10,47,547
66048,66048,1EAE8E0D28D79DCFE0DA0CD7004A4A71,19441,19,20,1,8,46,446
66049,66049,40A3F567657A043546A2ED7A5DC91A85,12792,1,2,1,34,30,1730
66050,66050,40A3F567657A043546A2ED7A5DC91A85,15401,5,8,3,39,25,1975
66051,66051,40A3F567657A043546A2ED7A5DC91A85,12792,9,10,1,34,30,1730
66052,66052,40A3F567657A043546A2ED7A5DC91A85,15401,12,15,3,39,25,1975
66053,66053,40A3F567657A043546A2ED7A5DC91A85,15671,19,20,1,37,26,1876
66061,66061,9353D9E6D3F1DEDA1EB0CD9335DEBA77,42681,0,6,6,24,48,1248
66062,66062,9353D9E6D3F1DEDA1EB0CD9335DEBA77,42081,6,8,2,24,49,1249
66063,66063,9353D9E6D3F1DEDA1EB0CD9335DEBA77,42681,9,10,1,24,48,1248
66064,66064,9353D9E6D3F1DEDA1EB0CD9335DEBA77,12051,10,11,1,20,47,1047
66065,66065,9353D9E6D3F1DEDA1EB0CD9335DEBA77,42681,16,17,1,24,48,1248
66066,66066,9353D9E6D3F1DEDA1EB0CD9335DEBA77,12051,18,22,4,20,47,1047
66084,66084,C598BC458A3C3A8EE84844CDB0EA3356,11021,9,11,2,36,49,1849
66085,66085,C598BC458A3C3A8EE84844CDB0EA3356,40073,14,16,2,37,48,1898
66086,66086,C598BC458A3C3A8EE84844CDB0EA3356,10681,20,22,2,30,48,1548
66096,66096,37F1D2311F2383134D9A7BD374E33133,43751,8,9,1,19,48,998
66097,66097,37F1D2311F2383134D9A7BD374E33133,10501,9,11,2,22,46,1146
66098,66098,37F1D2311F2383134D9A7BD374E33133,12051,12,14,2,20,47,1047
66099,66099,37F1D2311F2383134D9A7BD374E33133,11381,17,21,4,30,47,1547
66100,66100,37F1D2311F2383134D9A7BD374E33133,12051,22,23,1,20,47,1047
66104,66104,9F589AB01E58B6B2CA9FB997F96CB7F3,13071,0,6,6,41,41,2091
66105,66105,9F589AB01E58B6B2CA9FB997F96CB7F3,43451,7,18,11,37,40,1890
66106,66106,9F589AB01E58B6B2CA9FB997F96CB7F3,13071,21,23,2,41,41,2091
66107,66107,BA865EE03D54F441A6E18D3EAF3533FA,11381,0,5,5,30,47,1547
66108,66108,BA865EE03D54F441A6E18D3EAF3533FA,13351,17,19,2,48,48,2448
66109,66109,BA865EE03D54F441A6E18D3EAF3533FA,11381,19,21,2,30,47,1547
66110,66110,EC53D0ABF0A80775E4E61E73AEA5DC42,40891,0,11,11,37,47,1897
66111,66111,EC53D0ABF0A80775E4E61E73AEA5DC42,42311,14,15,1,41,46,2096
66112,66112,EC53D0ABF0A80775E4E61E73AEA5DC42,13091,16,18,2,20,42,1042
66113,66113,EC53D0ABF0A80775E4E61E73AEA5DC42,41101,21,22,1,32,48,1648
66114,66114,54AF0735D887B9C0B8CEE7B0E8BAEF2D,19441,10,11,1,8,46,446
66115,66115,54AF0735D887B9C0B8CEE7B0E8BAEF2D,11571,14,15,1,13,46,696
66116,66116,54AF0735D887B9C0B8CEE7B0E8BAEF2D,19441,20,21,1,8,46,446
66121,66121,4CAAF5F78E045189E38517E39BAC837A,10511,0,8,8,35,46,1796
66122,66122,4CAAF5F78E045189E38517E39BAC837A,10531,12,16,4,34,46,1746
66123,66123,4CAAF5F78E045189E38517E39BAC837A,40341,18,21,3,23,49,1199
66124,66124,4CEF2D9D71549E955305B2DC8309A78D,43021,4,6,2,16,43,843
66125,66125,4CEF2D9D71549E955305B2DC8309A78D,12921,6,8,2,9,41,491
66126,66126,4CEF2D9D71549E955305B2DC8309A78D,43021,11,23,12,16,43,843
66130,66130,EF11EBB34C417206AA46122A1E63E54C,10951,0,10,10,29,48,1498
66131,66131,EF11EBB34C417206AA46122A1E63E54C,13511,12,13,1,34,48,1748
66132,66132,EF11EBB34C417206AA46122A1E63E54C,11861,14,18,4,32,47,1647
66133,66133,EF11EBB34C417206AA46122A1E63E54C,10491,19,21,2,33,48,1698
66134,66134,EF11EBB34C417206AA46122A1E63E54C,11753,22,23,1,35,48,1798
66138,66138,F312A9BDD6D19F2945BD4A135883EF0C,13771,0,1,1,21,45,1095
66139,66139,F312A9BDD6D19F2945BD4A135883EF0C,12601,1,15,14,25,47,1297
66140,66140,F312A9BDD6D19F2945BD4A135883EF0C,13771,15,16,1,21,45,1095
66141,66141,F312A9BDD6D19F2945BD4A135883EF0C,12601,20,22,2,25,47,1297
66142,66142,470BE60325DA2FBBD1F75F1607157E14,12521,0,6,6,35,41,1791
66143,66143,470BE60325DA2FBBD1F75F1607157E14,13314,7,11,4,31,39,1589
66144,66144,470BE60325DA2FBBD1F75F1607157E14,12521,11,23,12,35,41,1791
66152,66152,90AC20E6CC0B4ABA3A4EAC5C3086C030,13741,0,7,7,37,49,1899
66153,66153,90AC20E6CC0B4ABA3A4EAC5C3086C030,11541,8,10,2,35,49,1799
66154,66154,90AC20E6CC0B4ABA3A4EAC5C3086C030,13561,13,16,3,37,49,1899
66155,66155,90AC20E6CC0B4ABA3A4EAC5C3086C030,11074,16,17,1,37,47,1897
66156,66156,90AC20E6CC0B4ABA3A4EAC5C3086C030,13741,19,23,4,37,49,1899
66157,66157,05285A1552C297CAB9E2CA0C1588A769,16441,0,7,7,15,17,767
66158,66158,05285A1552C297CAB9E2CA0C1588A769,15271,11,16,5,14,20,720
66159,66159,05285A1552C297CAB9E2CA0C1588A769,16231,16,18,2,11,15,565
66160,66160,C9255107859C2FB6A49577C5ACBDC9FD,11381,0,6,6,30,47,1547
66161,66161,C9255107859C2FB6A49577C5ACBDC9FD,10041,8,20,12,39,49,1999
66162,66162,C9255107859C2FB6A49577C5ACBDC9FD,11061,20,22,2,29,48,1498
66163,66163,33DD6EFAB6F630D5C348ED3B5E9AA619,12792,0,3,3,34,30,1730
66164,66164,33DD6EFAB6F630D5C348ED3B5E9AA619,15391,7,9,2,35,26,1776
66165,66165,33DD6EFAB6F630D5C348ED3B5E9AA619,15361,10,11,1,33,25,1675
66166,66166,33DD6EFAB6F630D5C348ED3B5E9AA619,12792,14,16,2,34,30,1730
66167,66167,33DD6EFAB6F630D5C348ED3B5E9AA619,12791,17,18,1,31,29,1579
66172,66172,D345EC4766755C4776AF774070A442F0,11875,0,5,5,30,46,1546
66173,66173,D345EC4766755C4776AF774070A442F0,12311,8,10,2,30,44,1544
66174,66174,D345EC4766755C4776AF774070A442F0,11875,12,14,2,30,46,1546
66175,66175,D345EC4766755C4776AF774070A442F0,12311,14,17,3,30,44,1544
66176,66176,D345EC4766755C4776AF774070A442F0,11875,20,23,3,30,46,1546
66180,66180,340D1A3260E724C7611F6D9F267F9C52,11231,0,11,11,37,49,1899
66181,66181,340D1A3260E724C7611F6D9F267F9C52,10471,13,15,2,37,48,1898
66182,66182,340D1A3260E724C7611F6D9F267F9C52,40341,17,20,3,23,49,1199
66183,66183,340D1A3260E724C7611F6D9F267F9C52,10111,22,23,1,37,47,1897
66184,66184,DFB301D7F19E8A2E109EFF3A69DC69CC,11021,0,10,10,36,49,1849
66185,66185,DFB301D7F19E8A2E109EFF3A69DC69CC,10661,15,18,3,37,49,1899
66186,66186,DFB301D7F19E8A2E109EFF3A69DC69CC,10921,19,20,1,43,48,2198
66190,66190,A06BAFFFC2499366CBFC92A75B071153,11381,1,4,3,30,47,1547
66191,66191,A06BAFFFC2499366CBFC92A75B071153,11061,4,12,8,29,48,1498
66192,66192,A06BAFFFC2499366CBFC92A75B071153,11151,14,16,2,30,48,1548
66193,66193,A06BAFFFC2499366CBFC92A75B071153,11701,17,18,1,43,48,2198
66194,66194,B7B94AB4252BB650186A02C1E9267F6F,10661,0,7,7,37,49,1899
66195,66195,B7B94AB4252BB650186A02C1E9267F6F,12083,7,8,1,36,49,1849
66196,66196,B7B94AB4252BB650186A02C1E9267F6F,42601,21,22,1,44,48,2248
66197,66197,CB31E024FF5A5A733C4A993360BA5C04,42531,0,5,5,31,45,1595
66198,66198,CB31E024FF5A5A733C4A993360BA5C04,12661,9,17,8,32,45,1645
66199,66199,CB31E024FF5A5A733C4A993360BA5C04,10531,18,20,2,34,46,1746
66200,66200,CB31E024FF5A5A733C4A993360BA5C04,11231,21,23,2,37,49,1899
66204,66204,FFD84391FCD810EDFCF9E1B100BB0A91,11201,4,10,6,35,49,1799
66205,66205,FFD84391FCD810EDFCF9E1B100BB0A91,40951,11,16,5,36,49,1849
66206,66206,FFD84391FCD810EDFCF9E1B100BB0A91,11751,16,17,1,35,48,1798
66207,66207,FFD84391FCD810EDFCF9E1B100BB0A91,40951,17,21,4,36,49,1849
66208,66208,FFD84391FCD810EDFCF9E1B100BB0A91,11201,21,22,1,35,49,1799
66221,66221,E7F0BEFEB527574747952B709C847F2A,15051,0,7,7,19,4,954
66222,66222,E7F0BEFEB527574747952B709C847F2A,16281,8,16,8,11,4,554
66223,66223,E7F0BEFEB527574747952B709C847F2A,15051,17,23,6,19,4,954
66224,66224,A0B44EDE0A0A4605549206EBBBA0709D,10211,0,6,6,16,49,849
66225,66225,A0B44EDE0A0A4605549206EBBBA0709D,42861,8,9,1,37,44,1894
66226,66226,A0B44EDE0A0A4605549206EBBBA0709D,11261,10,15,5,36,46,1846
66227,66227,A0B44EDE0A0A4605549206EBBBA0709D,10211,19,22,3,16,49,849
66231,66231,0C2217DD45F283F09C2DD3FB7C361FB9,13671,0,9,9,27,43,1393
66232,66232,0C2217DD45F283F09C2DD3FB7C361FB9,10711,12,14,2,29,46,1496
66233,66233,0C2217DD45F283F09C2DD3FB7C361FB9,13671,15,16,1,27,43,1393
66234,66234,0C2217DD45F283F09C2DD3FB7C361FB9,13314,17,18,1,31,39,1589
66235,66235,0C2217DD45F283F09C2DD3FB7C361FB9,11875,19,20,1,30,46,1546
66236,66236,AB1E27033ABBCFEAE4B83A799FB358FD,19744,0,5,5,6,43,343
66237,66237,AB1E27033ABBCFEAE4B83A799FB358FD,12311,6,17,11,30,44,1544
66238,66238,AB1E27033ABBCFEAE4B83A799FB358FD,19744,19,23,4,6,43,343
66239,66239,F276DA0C0E39AE3BAD5B91AE46CB6EA8,42971,0,4,4,43,49,2199
66240,66240,F276DA0C0E39AE3BAD5B91AE46CB6EA8,10471,7,11,4,37,48,1898
66241,66241,F276DA0C0E39AE3BAD5B91AE46CB6EA8,11231,11,22,11,37,49,1899
66242,66242,AAC9A929AB4846A902E16BBBA362DF9C,40124,0,9,9,38,47,1947
66243,66243,AAC9A929AB4846A902E16BBBA362DF9C,42531,10,12,2,31,45,1595
66244,66244,AAC9A929AB4846A902E16BBBA362DF9C,42381,12,13,1,39,41,1991
66245,66245,AAC9A929AB4846A902E16BBBA362DF9C,40124,14,18,4,38,47,1947
66246,66246,AAC9A929AB4846A902E16BBBA362DF9C,42511,22,23,1,37,47,1897
66247,66247,4F985171E935EB3DC7536EAA1C4743E5,42081,1,13,12,24,49,1249
66248,66248,4F985171E935EB3DC7536EAA1C4743E5,42623,13,14,1,22,49,1149
66249,66249,4F985171E935EB3DC7536EAA1C4743E5,42071,18,19,1,31,49,1599
66250,66250,51F5495BA667D4962DCC18EF0F9E6ED3,42031,3,5,2,40,46,2046
66251,66251,51F5495BA667D4962DCC18EF0F9E6ED3,10821,6,8,2,40,47,2047
66252,66252,51F5495BA667D4962DCC18EF0F9E6ED3,12561,12,17,5,45,43,2293
66253,66253,51F5495BA667D4962DCC18EF0F9E6ED3,10821,19,23,4,40,47,2047
66254,66254,BBCB9918D42B41DEDF16DD7F5A9BE26F,11861,0,10,10,32,47,1647
66255,66255,BBCB9918D42B41DEDF16DD7F5A9BE26F,10111,10,12,2,37,47,1897
66256,66256,BBCB9918D42B41DEDF16DD7F5A9BE26F,11911,13,15,2,37,48,1898
66257,66257,BBCB9918D42B41DEDF16DD7F5A9BE26F,40431,15,16,1,36,47,1847
66258,66258,BBCB9918D42B41DEDF16DD7F5A9BE26F,11861,18,23,5,32,47,1647
66259,66259,15BCDD697148756030A767ED1AC11F1B,10251,0,12,12,35,47,1797
66260,66260,15BCDD697148756030A767ED1AC11F1B,40341,13,14,1,23,49,1199
66261,66261,15BCDD697148756030A767ED1AC11F1B,42161,16,23,7,36,47,1847
66262,66262,D69A9CA77637E2C7D249EEE1CAB09A1F,43011,0,8,8,40,42,2042
66263,66263,D69A9CA77637E2C7D249EEE1CAB09A1F,13071,12,14,2,41,41,2091
66264,66264,D69A9CA77637E2C7D249EEE1CAB09A1F,43101,15,17,2,46,40,2340
66265,66265,D69A9CA77637E2C7D249EEE1CAB09A1F,13071,17,19,2,41,41,2091
66266,66266,D69A9CA77637E2C7D249EEE1CAB09A1F,43951,20,22,2,49,41,2491
66267,66267,A345B58C2304F83DF0BAD404D00E0742,42151,1,12,11,35,45,1795
66268,66268,A345B58C2304F83DF0BAD404D00E0742,42861,14,15,1,37,44,1894
66269,66269,A345B58C2304F83DF0BAD404D00E0742,42151,16,19,3,35,45,1795
66270,66270,A345B58C2304F83DF0BAD404D00E0742,10911,20,23,3,39,46,1996
66271,66271,9006CB68DA3704FCFEC4F8E4FD200E11,15091,0,6,6,35,26,1776
66272,66272,9006CB68DA3704FCFEC4F8E4FD200E11,19801,7,8,1,19,26,976
66273,66273,9006CB68DA3704FCFEC4F8E4FD200E11,15091,12,19,7,35,26,1776
66274,66274,9006CB68DA3704FCFEC4F8E4FD200E11,12792,20,23,3,34,30,1730
66275,66275,778FCC24D7E33BA6E0BE6A312CE18590,10431,0,10,10,33,49,1699
66276,66276,778FCC24D7E33BA6E0BE6A312CE18590,10491,10,12,2,33,48,1698
66277,66277,778FCC24D7E33BA6E0BE6A312CE18590,42161,12,23,11,36,47,1847
66278,66278,B3B147972ECD6C8A2C0FDDE3D7D5F774,13941,0,5,5,41,47,2097
66279,66279,B3B147972ECD6C8A2C0FDDE3D7D5F774,10771,6,8,2,41,46,2096
66280,66280,B3B147972ECD6C8A2C0FDDE3D7D5F774,13941,8,16,8,41,47,2097
66281,66281,B3B147972ECD6C8A2C0FDDE3D7D5F774,13221,16,17,1,40,47,2047
66282,66282,B3B147972ECD6C8A2C0FDDE3D7D5F774,40491,19,20,1,39,49,1999
66283,66283,D4FB6B465C87A5D763D7E62820C6F264,19441,2,3,1,8,46,446
66284,66284,D4FB6B465C87A5D763D7E62820C6F264,12121,4,6,2,29,47,1497
66285,66285,D4FB6B465C87A5D763D7E62820C6F264,19441,9,23,14,8,46,446
66289,66289,C20A8602CB56BFEFEAACF19FBFC3B84E,42191,4,5,1,38,49,1949
66290,66290,C20A8602CB56BFEFEAACF19FBFC3B84E,42381,10,13,3,39,41,1991
66291,66291,C20A8602CB56BFEFEAACF19FBFC3B84E,11531,14,17,3,34,49,1749
66292,66292,C20A8602CB56BFEFEAACF19FBFC3B84E,11541,22,23,1,35,49,1799
66296,66296,9F6A737DE3019254ADA69C7D3ADBD9AD,11301,0,6,6,41,49,2099
66297,66297,9F6A737DE3019254ADA69C7D3ADBD9AD,12601,7,8,1,25,47,1297
66298,66298,9F6A737DE3019254ADA69C7D3ADBD9AD,13671,9,10,1,27,43,1393
66299,66299,9F6A737DE3019254ADA69C7D3ADBD9AD,11301,14,23,9,41,49,2099
66300,66300,FA8F43ACACB74477686D52766F6B458E,42071,4,9,5,31,49,1599
66301,66301,FA8F43ACACB74477686D52766F6B458E,42623,13,14,1,22,49,1149
66302,66302,FA8F43ACACB74477686D52766F6B458E,10381,17,19,2,31,49,1599
66303,66303,58248472739B462ECE2ED62B9B35F4B0,42921,0,14,14,33,47,1697
66304,66304,58248472739B462ECE2ED62B9B35F4B0,40341,18,19,1,23,49,1199
66305,66305,58248472739B462ECE2ED62B9B35F4B0,42921,21,23,2,33,47,1697
66310,66310,520C7CBC821664A98A49926C91FE5529,42231,8,9,1,37,46,1896
66311,66311,520C7CBC821664A98A49926C91FE5529,43101,13,15,2,46,40,2340
66312,66312,520C7CBC821664A98A49926C91FE5529,42231,17,21,4,37,46,1896
66313,66313,6684687C9F1041794E8237CE4D241C6F,42081,0,1,1,24,49,1249
66314,66314,6684687C9F1041794E8237CE4D241C6F,10381,1,3,2,31,49,1599
66315,66315,6684687C9F1041794E8237CE4D241C6F,42081,5,10,5,24,49,1249
66316,66316,6684687C9F1041794E8237CE4D241C6F,10381,10,11,1,31,49,1599
66317,66317,6684687C9F1041794E8237CE4D241C6F,42081,12,21,9,24,49,1249
66318,66318,30165500CA5F6A8CB10812947A58AC25,42491,0,9,9,32,46,1646
66319,66319,30165500CA5F6A8CB10812947A58AC25,10061,11,12,1,20,46,1046
66320,66320,30165500CA5F6A8CB10812947A58AC25,10251,12,16,4,35,47,1797
66321,66321,30165500CA5F6A8CB10812947A58AC25,42491,16,23,7,32,46,1646
66322,66322,5B005239AD91B224060A740123F8C94E,13231,0,1,1,39,46,1996
66323,66323,5B005239AD91B224060A740123F8C94E,42231,2,5,3,37,46,1896
66324,66324,5B005239AD91B224060A740123F8C94E,42351,5,10,5,38,45,1945
66325,66325,5B005239AD91B224060A740123F8C94E,13911,14,16,2,39,46,1996
66326,66326,5B005239AD91B224060A740123F8C94E,42231,16,19,3,37,46,1896
66327,66327,40A368CA34750DF505DA57A322872C86,12611,3,15,12,41,29,2079
66328,66328,40A368CA34750DF505DA57A322872C86,15411,15,18,3,44,27,2227
66329,66329,40A368CA34750DF505DA57A322872C86,12611,18,23,5,41,29,2079
66330,66330,A6B86C51D1E851C8306B13F3333CE4AD,42401,0,3,3,36,47,1847
66331,66331,A6B86C51D1E851C8306B13F3333CE4AD,43161,3,4,1,35,47,1797
66332,66332,A6B86C51D1E851C8306B13F3333CE4AD,10651,9,10,1,36,49,1849
66333,66333,A6B86C51D1E851C8306B13F3333CE4AD,42401,14,16,2,36,47,1847
66334,66334,A6B86C51D1E851C8306B13F3333CE4AD,10111,16,17,1,37,47,1897
66335,66335,A6B86C51D1E851C8306B13F3333CE4AD,42301,21,23,2,36,47,1847
66340,66340,132BAF41704DD845C2F70543C3732C4E,13711,7,8,1,38,46,1946
66341,66341,132BAF41704DD845C2F70543C3732C4E,42231,8,12,4,37,46,1896
66342,66342,132BAF41704DD845C2F70543C3732C4E,13711,12,15,3,38,46,1946
66343,66343,132BAF41704DD845C2F70543C3732C4E,42231,15,16,1,37,46,1896
66344,66344,132BAF41704DD845C2F70543C3732C4E,13711,21,23,2,38,46,1946
66345,66345,58A0AAD1597EB0CB45ED09B67FBFF92F,42941,0,10,10,37,47,1897
66346,66346,58A0AAD1597EB0CB45ED09B67FBFF92F,43041,11,12,1,41,46,2096
66347,66347,58A0AAD1597EB0CB45ED09B67FBFF92F,41601,13,14,1,39,49,1999
66348,66348,58A0AAD1597EB0CB45ED09B67FBFF92F,42581,17,21,4,38,48,1948
66349,66349,33355741ED0AC97461CECC52FEC57FD4,13231,2,5,3,39,46,1996
66350,66350,33355741ED0AC97461CECC52FEC57FD4,42864,7,10,3,38,44,1944
66351,66351,33355741ED0AC97461CECC52FEC57FD4,11261,11,12,1,36,46,1846
66352,66352,33355741ED0AC97461CECC52FEC57FD4,13461,14,16,2,39,44,1994
66353,66353,33355741ED0AC97461CECC52FEC57FD4,42861,18,19,1,37,44,1894
66354,66354,D8649491D8359E263FDD367C6CA795FB,10107,1,2,1,38,49,1949
66355,66355,D8649491D8359E263FDD367C6CA795FB,10221,3,10,7,34,49,1749
66356,66356,D8649491D8359E263FDD367C6CA795FB,10161,10,16,6,35,49,1799
66357,66357,D8649491D8359E263FDD367C6CA795FB,19111,16,21,5,9,45,495
66361,66361,4C6EBE1C4B2FAAFACD17B57BF7692986,10531,0,2,2,34,46,1746
66362,66362,4C6EBE1C4B2FAAFACD17B57BF7692986,42161,3,5,2,36,47,1847
66363,66363,4C6EBE1C4B2FAAFACD17B57BF7692986,43731,7,8,1,34,47,1747
66364,66364,4C6EBE1C4B2FAAFACD17B57BF7692986,43161,10,11,1,35,47,1797
66365,66365,4C6EBE1C4B2FAAFACD17B57BF7692986,43731,14,22,8,34,47,1747
66366,66366,CDF6ADDC899F34326492126BCC50D6B8,10951,0,1,1,29,48,1498
66367,66367,CDF6ADDC899F34326492126BCC50D6B8,10716,2,5,3,30,46,1546
66368,66368,CDF6ADDC899F34326492126BCC50D6B8,11361,8,19,11,22,48,1148
66369,66369,CDF6ADDC899F34326492126BCC50D6B8,12601,19,20,1,25,47,1297
66370,66370,CDF6ADDC899F34326492126BCC50D6B8,11361,21,22,1,22,48,1148
66374,66374,623A8C7A39ECFD690A37FD70B234C101,11381,10,12,2,30,47,1547
66375,66375,623A8C7A39ECFD690A37FD70B234C101,42621,14,17,3,24,49,1249
66376,66376,623A8C7A39ECFD690A37FD70B234C101,10951,18,20,2,29,48,1498
66377,66377,623A8C7A39ECFD690A37FD70B234C101,42861,20,22,2,37,44,1894
66389,66389,66F421352C22D8571066F0AF8EA7BD0D,10491,0,1,1,33,48,1698
66390,66390,66F421352C22D8571066F0AF8EA7BD0D,10251,2,13,11,35,47,1797
66391,66391,66F421352C22D8571066F0AF8EA7BD0D,11861,14,15,1,32,47,1647
66392,66392,66F421352C22D8571066F0AF8EA7BD0D,10251,18,19,1,35,47,1797
66393,66393,66F421352C22D8571066F0AF8EA7BD0D,11861,21,23,2,32,47,1647
66394,66394,594938434184D7E316399D23A5A1DE0B,11521,0,7,7,41,48,2098
66395,66395,594938434184D7E316399D23A5A1DE0B,42511,11,13,2,37,47,1897
66396,66396,594938434184D7E316399D23A5A1DE0B,11521,14,17,3,41,48,2098
66397,66397,594938434184D7E316399D23A5A1DE0B,11914,18,20,2,37,48,1898
66398,66398,594938434184D7E316399D23A5A1DE0B,11521,21,23,2,41,48,2098
66399,66399,EAAB672210C677BA2879CCE67BDB7DF5,11151,0,5,5,30,48,1548
66400,66400,EAAB672210C677BA2879CCE67BDB7DF5,42831,7,9,2,27,48,1398
66401,66401,EAAB672210C677BA2879CCE67BDB7DF5,11151,10,13,3,30,48,1548
66402,66402,EAAB672210C677BA2879CCE67BDB7DF5,42831,13,15,2,27,48,1398
66403,66403,EAAB672210C677BA2879CCE67BDB7DF5,11151,15,23,8,30,48,1548
66404,66404,182A42BB7961D14AD940FD065D4EDF33,13711,1,7,6,38,46,1946
66405,66405,182A42BB7961D14AD940FD065D4EDF33,10271,9,11,2,37,46,1896
66406,66406,182A42BB7961D14AD940FD065D4EDF33,13711,13,19,6,38,46,1946
66407,66407,182A42BB7961D14AD940FD065D4EDF33,42531,20,21,1,31,45,1595
66408,66408,60E47AB33736AC41E2674A67294A03D4,12491,0,14,14,36,43,1843
66409,66409,60E47AB33736AC41E2674A67294A03D4,11261,15,17,2,36,46,1846
66410,66410,60E47AB33736AC41E2674A67294A03D4,12491,18,19,1,36,43,1843
66411,66411,60E47AB33736AC41E2674A67294A03D4,13711,20,22,2,38,46,1946
66416,66416,9398C8C66FCD9C9C571837501897C592,10951,0,4,4,29,48,1498
66417,66417,9398C8C66FCD9C9C571837501897C592,11381,4,5,1,30,47,1547
66418,66418,9398C8C66FCD9C9C571837501897C592,10951,5,7,2,29,48,1498
66419,66419,9398C8C66FCD9C9C571837501897C592,13651,16,17,1,30,47,1547
66420,66420,9398C8C66FCD9C9C571837501897C592,10951,19,20,1,29,48,1498
66424,66424,F587555054424F7ED0D63829AAEB0C06,42271,0,8,8,40,47,2047
66425,66425,F587555054424F7ED0D63829AAEB0C06,11806,12,14,2,41,48,2098
66426,66426,F587555054424F7ED0D63829AAEB0C06,42271,14,15,1,40,47,2047
66427,66427,F587555054424F7ED0D63829AAEB0C06,43361,18,19,1,38,48,1948
66428,66428,F587555054424F7ED0D63829AAEB0C06,42271,20,21,1,40,47,2047
66433,66433,AD3BAB8A9D569B2ED70F2835EA6D4CFF,11151,6,8,2,30,48,1548
66434,66434,AD3BAB8A9D569B2ED70F2835EA6D4CFF,11491,10,12,2,36,47,1847
66435,66435,AD3BAB8A9D569B2ED70F2835EA6D4CFF,11151,15,17,2,30,48,1548
66436,66436,AD3BAB8A9D569B2ED70F2835EA6D4CFF,42261,17,18,1,25,49,1299
66437,66437,35507D733CAF04397C1F4C352260CF5D,42583,1,11,10,40,48,2048
66438,66438,35507D733CAF04397C1F4C352260CF5D,11201,12,15,3,35,49,1799
66439,66439,35507D733CAF04397C1F4C352260CF5D,11751,17,21,4,35,48,1798
66452,66452,3D2ECC6A4BAE851C87C67624F1270EC4,42351,0,5,5,38,45,1945
66453,66453,3D2ECC6A4BAE851C87C67624F1270EC4,42691,6,10,4,24,48,1248
66454,66454,3D2ECC6A4BAE851C87C67624F1270EC4,43751,11,12,1,19,48,998
66455,66455,3D2ECC6A4BAE851C87C67624F1270EC4,12581,14,17,3,24,48,1248
66456,66456,3D2ECC6A4BAE851C87C67624F1270EC4,42351,20,23,3,38,45,1945
66457,66457,534F3B1CD78FDD46A8ACE2B5E3E0C898,13231,1,4,3,39,46,1996
66458,66458,534F3B1CD78FDD46A8ACE2B5E3E0C898,11261,6,7,1,36,46,1846
66459,66459,534F3B1CD78FDD46A8ACE2B5E3E0C898,13231,10,11,1,39,46,1996
66460,66460,534F3B1CD78FDD46A8ACE2B5E3E0C898,11261,12,21,9,36,46,1846
66461,66461,534F3B1CD78FDD46A8ACE2B5E3E0C898,13231,22,23,1,39,46,1996
66474,66474,2A299573B8ADE5EDDBBA5F82D87A0B34,13601,0,8,8,34,47,1747
66475,66475,2A299573B8ADE5EDDBBA5F82D87A0B34,13091,9,10,1,20,42,1042
66476,66476,2A299573B8ADE5EDDBBA5F82D87A0B34,13601,12,23,11,34,47,1747
66477,66477,B33429D7A00DB66721EA07FF9AC9AB45,11861,0,9,9,32,47,1647
66478,66478,B33429D7A00DB66721EA07FF9AC9AB45,11231,9,22,13,37,49,1899
66479,66479,B33429D7A00DB66721EA07FF9AC9AB45,11861,22,23,1,32,47,1647
66487,66487,3F835C29252B1ECBD00EFD53E3222DE1,11541,0,9,9,35,49,1799
66488,66488,3F835C29252B1ECBD00EFD53E3222DE1,42021,11,13,2,33,47,1697
66489,66489,3F835C29252B1ECBD00EFD53E3222DE1,43761,17,18,1,32,47,1647
66490,66490,3F835C29252B1ECBD00EFD53E3222DE1,42471,19,23,4,35,49,1799
66494,66494,0FD66F23349FEB00AD893343601C4D25,13381,0,5,5,39,47,1997
66495,66495,0FD66F23349FEB00AD893343601C4D25,42271,5,11,6,40,47,2047
66496,66496,0FD66F23349FEB00AD893343601C4D25,13311,12,16,4,27,39,1389
66497,66497,0FD66F23349FEB00AD893343601C4D25,12731,19,21,2,22,40,1140
66501,66501,5B009341D59B6503373635BF5936335C,43761,0,12,12,32,47,1647
66502,66502,5B009341D59B6503373635BF5936335C,12561,15,16,1,45,43,2293
66503,66503,5B009341D59B6503373635BF5936335C,43011,17,19,2,40,42,2042
66504,66504,5B009341D59B6503373635BF5936335C,42921,20,22,2,33,47,1697
66519,66519,CB51EA3DFBAD71C46F446085843381F3,15391,0,7,7,35,26,1776
66520,66520,CB51EA3DFBAD71C46F446085843381F3,43121,7,15,8,25,27,1277
66521,66521,CB51EA3DFBAD71C46F446085843381F3,12792,16,18,2,34,30,1730
66522,66522,CB51EA3DFBAD71C46F446085843381F3,43121,18,22,4,25,27,1277
66531,66531,49237ECED003BFEF5E21C688FECB20EC,19061,0,8,8,3,43,193
66532,66532,49237ECED003BFEF5E21C688FECB20EC,11061,13,17,4,29,48,1498
66533,66533,49237ECED003BFEF5E21C688FECB20EC,19061,19,23,4,3,43,193
66537,66537,E9E9C9DE1050FFAD63256F714329F12B,42201,0,16,16,43,46,2196
66538,66538,E9E9C9DE1050FFAD63256F714329F12B,13951,16,17,1,47,45,2395
66539,66539,E9E9C9DE1050FFAD63256F714329F12B,42201,18,23,5,43,46,2196
66540,66540,493077368598217FBCAD1599A1244463,10511,0,4,4,35,46,1796
66541,66541,493077368598217FBCAD1599A1244463,12311,9,10,1,30,44,1544
66542,66542,493077368598217FBCAD1599A1244463,10511,14,23,9,35,46,1796
66543,66543,C1D79A070CFCF442F4B341637205D8DD,12211,0,3,3,41,44,2094
66544,66544,C1D79A070CFCF442F4B341637205D8DD,12561,5,13,8,45,43,2293
66545,66545,C1D79A070CFCF442F4B341637205D8DD,12211,17,18,1,41,44,2094
66546,66546,0EF5CC18E50533A99D4FFAAC4B40B0EA,43761,0,17,17,32,47,1647
66547,66547,0EF5CC18E50533A99D4FFAAC4B40B0EA,12021,20,21,1,37,49,1899
66548,66548,0EF5CC18E50533A99D4FFAAC4B40B0EA,43761,22,23,1,32,47,1647
66549,66549,852BB5540E2D1D044093F0A403D4011D,19441,3,10,7,8,46,446
66550,66550,852BB5540E2D1D044093F0A403D4011D,11751,12,14,2,35,48,1798
66551,66551,852BB5540E2D1D044093F0A403D4011D,11201,18,19,1,35,49,1799
66552,66552,C0A424EE6BA5512990F2A0EDAE308C20,42231,0,6,6,37,46,1896
66553,66553,C0A424EE6BA5512990F2A0EDAE308C20,12391,6,9,3,36,49,1849
66554,66554,C0A424EE6BA5512990F2A0EDAE308C20,11231,12,14,2,37,49,1899
66555,66555,C0A424EE6BA5512990F2A0EDAE308C20,11021,17,18,1,36,49,1849
66556,66556,C0A424EE6BA5512990F2A0EDAE308C20,42231,20,23,3,37,46,1896
66557,66557,079D8B606B741550F5C3182CF58367EA,10431,2,3,1,33,49,1699
66558,66558,079D8B606B741550F5C3182CF58367EA,42621,4,5,1,24,49,1249
66559,66559,079D8B606B741550F5C3182CF58367EA,11061,6,20,14,29,48,1498
66560,66560,04FC279D8763FD0D52EBF8F599CB8F45,11021,0,8,8,36,49,1849
66561,66561,04FC279D8763FD0D52EBF8F599CB8F45,40171,10,11,1,38,48,1948
66562,66562,04FC279D8763FD0D52EBF8F599CB8F45,10121,12,16,4,36,49,1849
66563,66563,04FC279D8763FD0D52EBF8F599CB8F45,42511,16,18,2,37,47,1897
66564,66564,04FC279D8763FD0D52EBF8F599CB8F45,10121,18,23,5,36,49,1849
66568,66568,39F2DA1CFE88E9E32A213EC95DCD30C2,11351,0,10,10,36,48,1848
66569,66569,39F2DA1CFE88E9E32A213EC95DCD30C2,12561,11,13,2,45,43,2293
66570,66570,39F2DA1CFE88E9E32A213EC95DCD30C2,11351,15,23,8,36,48,1848
66571,66571,68C9F04DAA4541DA8F80DE2D18F7E884,13471,0,8,8,47,49,2399
66572,66572,68C9F04DAA4541DA8F80DE2D18F7E884,11801,10,13,3,42,48,2148
66573,66573,68C9F04DAA4541DA8F80DE2D18F7E884,13821,14,15,1,49,45,2495
66574,66574,68C9F04DAA4541DA8F80DE2D18F7E884,42601,19,21,2,44,48,2248
66575,66575,68C9F04DAA4541DA8F80DE2D18F7E884,13471,22,23,1,47,49,2399
66582,66582,38EAD9C71E0631172BE43F523D61F0B8,42971,0,5,5,43,49,2199
66583,66583,38EAD9C71E0631172BE43F523D61F0B8,11381,8,10,2,30,47,1547
66584,66584,38EAD9C71E0631172BE43F523D61F0B8,42521,14,16,2,31,47,1597
66585,66585,38EAD9C71E0631172BE43F523D61F0B8,42971,20,22,2,43,49,2199
66589,66589,B5980B50E16CAA8A40D53500802F1FEF,10111,0,11,11,37,47,1897
66590,66590,B5980B50E16CAA8A40D53500802F1FEF,42301,11,12,1,36,47,1847
66591,66591,B5980B50E16CAA8A40D53500802F1FEF,10111,15,16,1,37,47,1897
66592,66592,B5980B50E16CAA8A40D53500802F1FEF,12051,21,23,2,20,47,1047
66593,66593,E4A99F1C3E7ED34FBD67066F6ADB6F92,12311,0,9,9,30,44,1544
66594,66594,E4A99F1C3E7ED34FBD67066F6ADB6F92,10301,9,10,1,31,45,1595
66595,66595,E4A99F1C3E7ED34FBD67066F6ADB6F92,12311,10,16,6,30,44,1544
66596,66596,E4A99F1C3E7ED34FBD67066F6ADB6F92,10301,16,17,1,31,45,1595
66597,66597,E4A99F1C3E7ED34FBD67066F6ADB6F92,12311,18,23,5,30,44,1544
66611,66611,007883C4896DAF2F56308DBC4E144D6F,42921,0,9,9,33,47,1697
66612,66612,007883C4896DAF2F56308DBC4E144D6F,40034,10,12,2,32,48,1648
66613,66613,007883C4896DAF2F56308DBC4E144D6F,11111,14,16,2,26,48,1348
66614,66614,007883C4896DAF2F56308DBC4E144D6F,11731,19,21,2,36,48,1848
66615,66615,C8236143E8B93D5FDE499177CF2B28F7,11381,0,5,5,30,47,1547
66616,66616,C8236143E8B93D5FDE499177CF2B28F7,42861,6,13,7,37,44,1894
66617,66617,C8236143E8B93D5FDE499177CF2B28F7,11261,14,19,5,36,46,1846
66618,66618,C8236143E8B93D5FDE499177CF2B28F7,11381,19,23,4,30,47,1547
66619,66619,2E62A5B337815344E4A20C9B16E4C300,11541,0,10,10,35,49,1799
66620,66620,2E62A5B337815344E4A20C9B16E4C300,11531,11,12,1,34,49,1749
66621,66621,2E62A5B337815344E4A20C9B16E4C300,11021,12,15,3,36,49,1849
66622,66622,2E62A5B337815344E4A20C9B16E4C300,40341,15,22,7,23,49,1199
66634,66634,CDDA9D2F8DFE80A26EF0E394C3C9A4D7,11021,0,10,10,36,49,1849
66635,66635,CDDA9D2F8DFE80A26EF0E394C3C9A4D7,10161,10,11,1,35,49,1799
66636,66636,CDDA9D2F8DFE80A26EF0E394C3C9A4D7,19101,13,14,1,17,29,879
66637,66637,CDDA9D2F8DFE80A26EF0E394C3C9A4D7,11231,21,22,1,37,49,1899
66638,66638,CDDA9D2F8DFE80A26EF0E394C3C9A4D7,42471,22,23,1,35,49,1799
66639,66639,854F0EB359498CE780ED8E1798DCE379,10681,0,12,12,30,48,1548
66640,66640,854F0EB359498CE780ED8E1798DCE379,42261,12,14,2,25,49,1299
66641,66641,854F0EB359498CE780ED8E1798DCE379,42623,14,15,1,22,49,1149
66642,66642,854F0EB359498CE780ED8E1798DCE379,11834,16,17,1,32,45,1645
66643,66643,854F0EB359498CE780ED8E1798DCE379,10681,21,23,2,30,48,1548
66655,66655,909FE24282032BE2FFBF86A121DA90F1,10471,0,16,16,37,48,1898
66656,66656,909FE24282032BE2FFBF86A121DA90F1,11381,17,18,1,30,47,1547
66657,66657,909FE24282032BE2FFBF86A121DA90F1,10471,19,23,4,37,48,1898
66661,66661,2E6ECF3A2D9F0F99E9DEBA2062D89A0D,12601,9,11,2,25,47,1297
66662,66662,2E6ECF3A2D9F0F99E9DEBA2062D89A0D,10351,12,14,2,28,45,1445
66663,66663,2E6ECF3A2D9F0F99E9DEBA2062D89A0D,10634,17,19,2,27,45,1395
66664,66664,2E6ECF3A2D9F0F99E9DEBA2062D89A0D,12601,21,23,2,25,47,1297
66669,66669,BE5F35F3E4D48887CD67A887D7E93C82,42623,0,2,2,22,49,1149
66670,66670,BE5F35F3E4D48887CD67A887D7E93C82,10381,2,3,1,31,49,1599
66671,66671,BE5F35F3E4D48887CD67A887D7E93C82,42623,6,8,2,22,49,1149
66672,66672,BE5F35F3E4D48887CD67A887D7E93C82,11941,18,20,2,37,46,1896
66673,66673,BE5F35F3E4D48887CD67A887D7E93C82,43241,20,22,2,36,46,1846
66674,66674,FADBD24FB94D9388BE2E59D5F595D57D,42461,10,11,1,45,47,2297
66675,66675,FADBD24FB94D9388BE2E59D5F595D57D,11481,12,13,1,41,48,2098
66676,66676,FADBD24FB94D9388BE2E59D5F595D57D,40431,13,23,10,36,47,1847
66680,66680,26E97CCAAB10F50751FB25FC2D6D6457,11261,0,14,14,36,46,1846
66681,66681,26E97CCAAB10F50751FB25FC2D6D6457,43011,15,16,1,40,42,2042
66682,66682,26E97CCAAB10F50751FB25FC2D6D6457,42861,18,23,5,37,44,1894
66683,66683,89EC37A7B83D9B7D194154C37975BD9C,11061,0,1,1,29,48,1498
66684,66684,89EC37A7B83D9B7D194154C37975BD9C,42521,2,8,6,31,47,1597
66685,66685,89EC37A7B83D9B7D194154C37975BD9C,11061,10,11,1,29,48,1498
66686,66686,89EC37A7B83D9B7D194154C37975BD9C,11231,12,14,2,37,49,1899
66687,66687,89EC37A7B83D9B7D194154C37975BD9C,11061,18,19,1,29,48,1498
66688,66688,89EC37A7B83D9B7D194154C37975BD9C,11331,21,23,2,37,48,1898
66689,66689,F7E6C88DD777EED1AED99746069AF71C,42583,0,11,11,40,48,2048
66690,66690,F7E6C88DD777EED1AED99746069AF71C,40343,12,17,5,24,49,1249
66691,66691,F7E6C88DD777EED1AED99746069AF71C,41591,18,19,1,34,49,1749
66692,66692,F7E6C88DD777EED1AED99746069AF71C,40343,21,23,2,24,49,1249
66693,66693,BC92AFF0EAE5975D6D389942086AC293,10221,0,11,11,34,49,1749
66694,66694,BC92AFF0EAE5975D6D389942086AC293,40925,12,13,1,35,49,1799
66695,66695,BC92AFF0EAE5975D6D389942086AC293,11531,14,17,3,34,49,1749
66696,66696,BC92AFF0EAE5975D6D389942086AC293,41601,21,22,1,39,49,1999
66697,66697,8E7E1D3BA1392AF853A6068E181E9940,12971,1,9,8,32,48,1648
66698,66698,8E7E1D3BA1392AF853A6068E181E9940,10431,12,14,2,33,49,1699
66699,66699,8E7E1D3BA1392AF853A6068E181E9940,13461,15,16,1,39,44,1994
66700,66700,8E7E1D3BA1392AF853A6068E181E9940,12021,17,18,1,37,49,1899
66701,66701,8E7E1D3BA1392AF853A6068E181E9940,10191,21,23,2,40,48,2048
66702,66702,966EF37DD81DE2F009202B5BDDCFCE29,42351,1,4,3,38,45,1945
66703,66703,966EF37DD81DE2F009202B5BDDCFCE29,13911,4,5,1,39,46,1996
66704,66704,966EF37DD81DE2F009202B5BDDCFCE29,42231,8,11,3,37,46,1896
66705,66705,966EF37DD81DE2F009202B5BDDCFCE29,13911,16,17,1,39,46,1996
66706,66706,966EF37DD81DE2F009202B5BDDCFCE29,42231,18,20,2,37,46,1896
66707,66707,B7ED26A69282414DBFE099D3D608BE80,10921,0,8,8,43,48,2198
66708,66708,B7ED26A69282414DBFE099D3D608BE80,10841,10,19,9,37,47,1897
66709,66709,B7ED26A69282414DBFE099D3D608BE80,10921,22,23,1,43,48,2198
66710,66710,A0B07DBD7CFEABE1E4A0E9444C496CF6,42271,0,1,1,40,47,2047
66711,66711,A0B07DBD7CFEABE1E4A0E9444C496CF6,43481,1,3,2,39,48,1998
66712,66712,A0B07DBD7CFEABE1E4A0E9444C496CF6,13381,3,15,12,39,47,1997
66713,66713,A0B07DBD7CFEABE1E4A0E9444C496CF6,42271,15,16,1,40,47,2047
66714,66714,A0B07DBD7CFEABE1E4A0E9444C496CF6,10601,17,19,2,39,47,1997
66715,66715,A0B07DBD7CFEABE1E4A0E9444C496CF6,42271,20,23,3,40,47,2047
66719,66719,0D9AA89290D1F445356B85B4B256A343,10521,0,4,4,41,47,2097
66720,66720,0D9AA89290D1F445356B85B4B256A343,11001,6,8,2,42,47,2147
66721,66721,0D9AA89290D1F445356B85B4B256A343,12561,8,9,1,45,43,2293
66722,66722,0D9AA89290D1F445356B85B4B256A343,11001,12,14,2,42,47,2147
66723,66723,0D9AA89290D1F445356B85B4B256A343,13941,15,19,4,41,47,2097
66724,66724,0D9AA89290D1F445356B85B4B256A343,11001,20,22,2,42,47,2147
66725,66725,A53907219614BC9E0FC05C0EC4AF6DC2,13911,0,5,5,39,46,1996
66726,66726,A53907219614BC9E0FC05C0EC4AF6DC2,42231,6,8,2,37,46,1896
66727,66727,A53907219614BC9E0FC05C0EC4AF6DC2,13911,12,13,1,39,46,1996
66728,66728,A53907219614BC9E0FC05C0EC4AF6DC2,42231,14,18,4,37,46,1896
66729,66729,A53907219614BC9E0FC05C0EC4AF6DC2,13911,19,23,4,39,46,1996
66730,66730,B041461E36B355457CA97CA2324D4DB7,15411,0,7,7,44,27,2227
66731,66731,B041461E36B355457CA97CA2324D4DB7,12792,9,11,2,34,30,1730
66732,66732,B041461E36B355457CA97CA2324D4DB7,15411,12,18,6,44,27,2227
66746,66746,135F69DF6576D58D65D68D87AD4585F4,11914,0,3,3,37,48,1898
66747,66747,135F69DF6576D58D65D68D87AD4585F4,43361,7,8,1,38,48,1948
66748,66748,135F69DF6576D58D65D68D87AD4585F4,11914,10,13,3,37,48,1898
66749,66749,135F69DF6576D58D65D68D87AD4585F4,43361,15,17,2,38,48,1948
66750,66750,135F69DF6576D58D65D68D87AD4585F4,11914,20,23,3,37,48,1898
66751,66751,2808B465D0CA5BE626B66BA705E41B68,42861,6,7,1,37,44,1894
66752,66752,2808B465D0CA5BE626B66BA705E41B68,11261,11,12,1,36,46,1846
66753,66753,2808B465D0CA5BE626B66BA705E41B68,13231,12,13,1,39,46,1996
66754,66754,2808B465D0CA5BE626B66BA705E41B68,11261,14,17,3,36,46,1846
66755,66755,2808B465D0CA5BE626B66BA705E41B68,42351,18,20,2,38,45,1945
66756,66756,88D9016A574145DA3F3F4EC0E1ACFF78,12521,0,6,6,35,41,1791
66757,66757,88D9016A574145DA3F3F4EC0E1ACFF78,43451,7,10,3,37,40,1890
66758,66758,88D9016A574145DA3F3F4EC0E1ACFF78,12521,11,13,2,35,41,1791
66759,66759,88D9016A574145DA3F3F4EC0E1ACFF78,43451,14,16,2,37,40,1890
66760,66760,88D9016A574145DA3F3F4EC0E1ACFF78,12521,16,23,7,35,41,1791
66768,66768,85AD2874D498116E81BFFFA0A5E4F159,42491,7,8,1,32,46,1646
66769,66769,85AD2874D498116E81BFFFA0A5E4F159,12131,13,14,1,32,47,1647
66770,66770,85AD2874D498116E81BFFFA0A5E4F159,12391,16,17,1,36,49,1849
66771,66771,85AD2874D498116E81BFFFA0A5E4F159,42961,18,19,1,35,49,1799
66772,66772,93DBC0E5F74F5AE4691CE93E5624E28A,10221,0,12,12,34,49,1749
66773,66773,93DBC0E5F74F5AE4691CE93E5624E28A,10681,15,19,4,30,48,1548
66774,66774,93DBC0E5F74F5AE4691CE93E5624E28A,11061,20,21,1,29,48,1498
66782,66782,FF54487E0B5C80FA4088AB1638FB8194,42581,0,8,8,38,48,1948
66783,66783,FF54487E0B5C80FA4088AB1638FB8194,11914,8,10,2,37,48,1898
66784,66784,FF54487E0B5C80FA4088AB1638FB8194,42581,15,16,1,38,48,1948
66785,66785,FF54487E0B5C80FA4088AB1638FB8194,11914,17,18,1,37,48,1898
66786,66786,FF54487E0B5C80FA4088AB1638FB8194,42581,21,23,2,38,48,1948
66797,66797,1D2317C764BA4D56DB46A252B7A975A0,42331,0,1,1,39,46,1996
66798,66798,1D2317C764BA4D56DB46A252B7A975A0,42031,1,7,6,40,46,2046
66799,66799,1D2317C764BA4D56DB46A252B7A975A0,40341,10,16,6,23,49,1199
66800,66800,1D2317C764BA4D56DB46A252B7A975A0,11381,16,17,1,30,47,1547
66801,66801,1D2317C764BA4D56DB46A252B7A975A0,42031,20,21,1,40,46,2046
66802,66802,9B27AA39D08A4AD4F1A3555FC349C4D1,10341,3,8,5,31,47,1597
66803,66803,9B27AA39D08A4AD4F1A3555FC349C4D1,40636,9,10,1,35,48,1798
66804,66804,9B27AA39D08A4AD4F1A3555FC349C4D1,11941,11,14,3,37,46,1896
66805,66805,9B27AA39D08A4AD4F1A3555FC349C4D1,42523,18,23,5,31,47,1597
66806,66806,B0ABBF0DFF7135309A03DB54A0531587,43971,2,10,8,30,48,1548
66807,66807,B0ABBF0DFF7135309A03DB54A0531587,19021,14,19,5,10,45,545
66808,66808,B0ABBF0DFF7135309A03DB54A0531587,11061,21,22,1,29,48,1498
66809,66809,A67F948B05FC7E2F067AD14E85A0E030,43241,0,9,9,36,46,1846
66810,66810,A67F948B05FC7E2F067AD14E85A0E030,12521,10,17,7,35,41,1791
66811,66811,A67F948B05FC7E2F067AD14E85A0E030,42011,18,23,5,36,46,1846
66812,66812,35E2175E021CD04E6CF0361F38962323,10811,0,12,12,38,46,1946
66813,66813,35E2175E021CD04E6CF0361F38962323,13111,12,15,3,42,46,2146
66814,66814,35E2175E021CD04E6CF0361F38962323,10811,15,17,2,38,46,1946
66815,66815,35E2175E021CD04E6CF0361F38962323,11801,19,20,1,42,48,2148
66816,66816,96B100113D40E22B39686C026F5DA397,11171,0,8,8,33,48,1698
66817,66817,96B100113D40E22B39686C026F5DA397,11261,9,15,6,36,46,1846
66818,66818,96B100113D40E22B39686C026F5DA397,11074,18,20,2,37,47,1897
66819,66819,3C02B5838EDEAB0B15A337805B269A42,10601,0,6,6,39,47,1997
66820,66820,3C02B5838EDEAB0B15A337805B269A42,42321,7,10,3,43,47,2197
66821,66821,3C02B5838EDEAB0B15A337805B269A42,43621,10,12,2,46,48,2348
66822,66822,3C02B5838EDEAB0B15A337805B269A42,42321,14,16,2,43,47,2197
66823,66823,3C02B5838EDEAB0B15A337805B269A42,43621,17,18,1,46,48,2348
66824,66824,3C02B5838EDEAB0B15A337805B269A42,13011,19,21,2,39,47,1997
66828,66828,0FFF5F408770D048188D5E71EF374A23,43751,0,11,11,19,48,998
66829,66829,0FFF5F408770D048188D5E71EF374A23,12051,11,13,2,20,47,1047
66830,66830,0FFF5F408770D048188D5E71EF374A23,40341,16,19,3,23,49,1199
66831,66831,0FFF5F408770D048188D5E71EF374A23,12051,19,21,2,20,47,1047
66832,66832,7B63B781AF1E5C1909C9ECFED6946980,10281,0,4,4,33,48,1698
66833,66833,7B63B781AF1E5C1909C9ECFED6946980,43761,5,14,9,32,47,1647
66834,66834,7B63B781AF1E5C1909C9ECFED6946980,42523,15,16,1,31,47,1597
66835,66835,7B63B781AF1E5C1909C9ECFED6946980,43761,16,20,4,32,47,1647
66836,66836,7B63B781AF1E5C1909C9ECFED6946980,42523,22,23,1,31,47,1597
66840,66840,946768BFA72752D5660750415178C67F,11131,0,8,8,33,48,1698
66841,66841,946768BFA72752D5660750415178C67F,43731,12,13,1,34,47,1747
66842,66842,946768BFA72752D5660750415178C67F,40411,14,15,1,34,48,1748
66843,66843,946768BFA72752D5660750415178C67F,42161,16,17,1,36,47,1847
66844,66844,946768BFA72752D5660750415178C67F,10251,18,19,1,35,47,1797
66845,66845,0CFE988ACC4C875C64FD106BD1BAEAD4,42231,1,7,6,37,46,1896
66846,66846,0CFE988ACC4C875C64FD106BD1BAEAD4,13951,11,12,1,47,45,2395
66847,66847,0CFE988ACC4C875C64FD106BD1BAEAD4,13821,14,15,1,49,45,2495
66848,66848,0CFE988ACC4C875C64FD106BD1BAEAD4,10511,17,23,6,35,46,1796
66849,66849,3E43826B2F3C90E1974FF5F797EBAA40,42581,0,4,4,38,48,1948
66850,66850,3E43826B2F3C90E1974FF5F797EBAA40,13731,17,18,1,33,49,1699
66851,66851,3E43826B2F3C90E1974FF5F797EBAA40,42581,19,21,2,38,48,1948
66855,66855,39179060954ADF536A44D5CDC3D7ADA4,10921,0,5,5,43,48,2198
66856,66856,39179060954ADF536A44D5CDC3D7ADA4,13911,5,10,5,39,46,1996
66857,66857,39179060954ADF536A44D5CDC3D7ADA4,11261,10,12,2,36,46,1846
66858,66858,39179060954ADF536A44D5CDC3D7ADA4,13911,13,18,5,39,46,1996
66859,66859,39179060954ADF536A44D5CDC3D7ADA4,11261,19,23,4,36,46,1846
66860,66860,54656B13132CFC1BC054058C18C29F2B,11021,0,9,9,36,49,1849
66861,66861,54656B13132CFC1BC054058C18C29F2B,11201,11,12,1,35,49,1799
66862,66862,54656B13132CFC1BC054058C18C29F2B,13711,12,13,1,38,46,1946
66863,66863,54656B13132CFC1BC054058C18C29F2B,43241,13,15,2,36,46,1846
66864,66864,54656B13132CFC1BC054058C18C29F2B,11021,15,23,8,36,49,1849
66865,66865,BA6D45213D52989026A398B5D7995374,43644,0,4,4,14,38,738
66866,66866,BA6D45213D52989026A398B5D7995374,12641,6,8,2,10,43,543
66867,66867,BA6D45213D52989026A398B5D7995374,19181,9,11,2,8,40,440
66868,66868,BA6D45213D52989026A398B5D7995374,12641,13,14,1,10,43,543
66869,66869,BA6D45213D52989026A398B5D7995374,19181,17,19,2,8,40,440
66870,66870,BA6D45213D52989026A398B5D7995374,12921,21,22,1,9,41,491
66871,66871,CFB5B91AB0CD7543884ADBE535AD19D6,43021,0,4,4,16,43,843
66872,66872,CFB5B91AB0CD7543884ADBE535AD19D6,12921,6,10,4,9,41,491
66873,66873,CFB5B91AB0CD7543884ADBE535AD19D6,12641,13,18,5,10,43,543
66874,66874,58DF107986367FA88C1D627635A20D98,42521,1,5,4,31,47,1597
66875,66875,58DF107986367FA88C1D627635A20D98,11861,6,8,2,32,47,1647
66876,66876,58DF107986367FA88C1D627635A20D98,42011,11,12,1,36,46,1846
66877,66877,58DF107986367FA88C1D627635A20D98,11861,15,21,6,32,47,1647
66878,66878,9F2BAB521AAFFBE7CC97AED22DC2FAF1,11261,0,14,14,36,46,1846
66879,66879,9F2BAB521AAFFBE7CC97AED22DC2FAF1,42864,17,18,1,38,44,1944
66880,66880,9F2BAB521AAFFBE7CC97AED22DC2FAF1,11261,18,20,2,36,46,1846
66881,66881,9F2BAB521AAFFBE7CC97AED22DC2FAF1,42864,20,21,1,38,44,1944
66882,66882,9F2BAB521AAFFBE7CC97AED22DC2FAF1,11261,22,23,1,36,46,1846
66893,66893,E89F56AD5A93714B53D26D204A21FEB5,42471,0,14,14,35,49,1799
66894,66894,E89F56AD5A93714B53D26D204A21FEB5,10781,15,18,3,35,47,1797
66895,66895,E89F56AD5A93714B53D26D204A21FEB5,11151,22,23,1,30,48,1548
66896,66896,37C29D4674FBC06EF76342F2283F4E15,42031,0,9,9,40,46,2046
66897,66897,37C29D4674FBC06EF76342F2283F4E15,40697,10,12,2,43,48,2198
66898,66898,37C29D4674FBC06EF76342F2283F4E15,13671,17,23,6,27,43,1393
66899,66899,ADD9A834063D27F9A488B82DA400593C,13791,0,3,3,42,47,2147
66900,66900,ADD9A834063D27F9A488B82DA400593C,42321,4,6,2,43,47,2197
66901,66901,ADD9A834063D27F9A488B82DA400593C,10221,8,14,6,34,49,1749
66902,66902,ADD9A834063D27F9A488B82DA400593C,10151,16,23,7,34,47,1747
66914,66914,922E5B6BA26614D3BEB02D04A2BC34BE,13911,0,14,14,39,46,1996
66915,66915,922E5B6BA26614D3BEB02D04A2BC34BE,42151,18,19,1,35,45,1795
66916,66916,922E5B6BA26614D3BEB02D04A2BC34BE,13911,22,23,1,39,46,1996
66917,66917,36B9A094E8D22C518990766A8F925428,19621,10,12,2,5,46,296
66918,66918,36B9A094E8D22C518990766A8F925428,19114,13,14,1,7,43,393
66919,66919,36B9A094E8D22C518990766A8F925428,12641,15,17,2,10,43,543
66920,66920,36B9A094E8D22C518990766A8F925428,19901,21,23,2,7,44,394
66927,66927,8DABC1EEC8D558B02F294983CBCCF5A0,42511,0,2,2,37,47,1897
66928,66928,8DABC1EEC8D558B02F294983CBCCF5A0,13331,3,7,4,38,47,1947
66929,66929,8DABC1EEC8D558B02F294983CBCCF5A0,42511,8,10,2,37,47,1897
66930,66930,8DABC1EEC8D558B02F294983CBCCF5A0,42301,11,12,1,36,47,1847
66931,66931,8DABC1EEC8D558B02F294983CBCCF5A0,42511,14,19,5,37,47,1897
66939,66939,FB55B20B748C0A1CF26B4BE2B509424A,12761,0,6,6,25,40,1290
66940,66940,FB55B20B748C0A1CF26B4BE2B509424A,10351,10,11,1,28,45,1445
66941,66941,FB55B20B748C0A1CF26B4BE2B509424A,11091,12,14,2,29,47,1497
66942,66942,FB55B20B748C0A1CF26B4BE2B509424A,13671,14,20,6,27,43,1393
66943,66943,FB55B20B748C0A1CF26B4BE2B509424A,12731,22,23,1,22,40,1140
66944,66944,3877B8E5CE9312BFA7CD973C0152DE3C,12514,0,6,6,38,47,1947
66945,66945,3877B8E5CE9312BFA7CD973C0152DE3C,10841,8,12,4,37,47,1897
66946,66946,3877B8E5CE9312BFA7CD973C0152DE3C,10221,14,16,2,34,49,1749
66947,66947,3877B8E5CE9312BFA7CD973C0152DE3C,12514,17,23,6,38,47,1947
66948,66948,755A1FA6C962DCA1F0C6C27EDC12A160,13371,5,7,2,41,47,2097
66949,66949,755A1FA6C962DCA1F0C6C27EDC12A160,12601,10,11,1,25,47,1297
66950,66950,755A1FA6C962DCA1F0C6C27EDC12A160,13371,12,23,11,41,47,2097
66951,66951,C6A8E88AF4FAB8E3B900B709C1644500,10411,0,8,8,36,48,1848
66952,66952,C6A8E88AF4FAB8E3B900B709C1644500,10107,9,11,2,38,49,1949
66953,66953,C6A8E88AF4FAB8E3B900B709C1644500,42461,14,15,1,45,47,2297
66954,66954,C6A8E88AF4FAB8E3B900B709C1644500,10251,20,22,2,35,47,1797
66955,66955,C6A8E88AF4FAB8E3B900B709C1644500,10411,22,23,1,36,48,1848
66956,66956,990F89A555478F97C2E0E123BB133187,49201,5,8,3,7,41,391
66957,66957,990F89A555478F97C2E0E123BB133187,13961,10,11,1,42,48,2148
66958,66958,990F89A555478F97C2E0E123BB133187,49201,14,20,6,7,41,391
66965,66965,803884DAE228D36B780CDE250AFE5FD1,13711,0,17,17,38,46,1946
66966,66966,803884DAE228D36B780CDE250AFE5FD1,11541,19,21,2,35,49,1799
66967,66967,803884DAE228D36B780CDE250AFE5FD1,13711,21,23,2,38,46,1946
66974,66974,CC542EA3A72441C176DD8B2A582775E3,10251,0,8,8,35,47,1797
66975,66975,CC542EA3A72441C176DD8B2A582775E3,13941,10,11,1,41,47,2097
66976,66976,CC542EA3A72441C176DD8B2A582775E3,11001,12,14,2,42,47,2147
66977,66977,CC542EA3A72441C176DD8B2A582775E3,10841,15,16,1,37,47,1897
66978,66978,CC542EA3A72441C176DD8B2A582775E3,11231,16,18,2,37,49,1899
66979,66979,CC542EA3A72441C176DD8B2A582775E3,42401,20,23,3,36,47,1847
66984,66984,519CE2AE351197FBF1FF46D5A72F3CE5,12971,0,13,13,32,48,1648
66985,66985,519CE2AE351197FBF1FF46D5A72F3CE5,42351,15,16,1,38,45,1945
66986,66986,519CE2AE351197FBF1FF46D5A72F3CE5,10901,20,22,2,35,48,1798
66990,66990,9A0E1728710A4135A2CED14F55D7DC99,43281,2,8,6,37,48,1898
66991,66991,9A0E1728710A4135A2CED14F55D7DC99,11151,8,17,9,30,48,1548
66992,66992,9A0E1728710A4135A2CED14F55D7DC99,10841,18,21,3,37,47,1897
66993,66993,9A0E1728710A4135A2CED14F55D7DC99,12083,21,22,1,36,49,1849
66994,66994,03A91EC93647A8BA652DF6ED44DA5BB9,10281,0,7,7,33,48,1698
66995,66995,03A91EC93647A8BA652DF6ED44DA5BB9,11161,12,13,1,32,48,1648
66996,66996,03A91EC93647A8BA652DF6ED44DA5BB9,10281,13,14,1,33,48,1698
66997,66997,03A91EC93647A8BA652DF6ED44DA5BB9,42461,15,16,1,45,47,2297
66998,66998,03A91EC93647A8BA652DF6ED44DA5BB9,42141,18,23,5,32,47,1647
67002,67002,AA8CC60B06B8E7A334E7FA04353D8EED,11261,0,3,3,36,46,1846
67003,67003,AA8CC60B06B8E7A334E7FA04353D8EED,43041,4,7,3,41,46,2096
67004,67004,AA8CC60B06B8E7A334E7FA04353D8EED,11381,8,9,1,30,47,1547
67005,67005,AA8CC60B06B8E7A334E7FA04353D8EED,11261,9,23,14,36,46,1846
67006,67006,2D7ACF8AD7E4B49F2A7FD23DB75DC6F1,42971,0,6,6,43,49,2199
67007,67007,2D7ACF8AD7E4B49F2A7FD23DB75DC6F1,11741,6,8,2,42,49,2149
67008,67008,2D7ACF8AD7E4B49F2A7FD23DB75DC6F1,10921,8,10,2,43,48,2198
67009,67009,2D7ACF8AD7E4B49F2A7FD23DB75DC6F1,42971,12,13,1,43,49,2199
67010,67010,2D7ACF8AD7E4B49F2A7FD23DB75DC6F1,11741,14,15,1,42,49,2149
67011,67011,2D7ACF8AD7E4B49F2A7FD23DB75DC6F1,42971,15,22,7,43,49,2199
67012,67012,BB72FBDB509C0EDC7CB7986BE504F263,12661,0,7,7,32,45,1645
67013,67013,BB72FBDB509C0EDC7CB7986BE504F263,12514,9,11,2,38,47,1947
67014,67014,BB72FBDB509C0EDC7CB7986BE504F263,12661,11,13,2,32,45,1645
67015,67015,BB72FBDB509C0EDC7CB7986BE504F263,12491,14,16,2,36,43,1843
67016,67016,BB72FBDB509C0EDC7CB7986BE504F263,12661,21,23,2,32,45,1645
67017,67017,71C7D3BEB879651EE771977BC4EF34E5,10341,0,6,6,31,47,1597
67018,67018,71C7D3BEB879651EE771977BC4EF34E5,12311,6,7,1,30,44,1544
67019,67019,71C7D3BEB879651EE771977BC4EF34E5,10351,8,11,3,28,45,1445
67020,67020,71C7D3BEB879651EE771977BC4EF34E5,12311,12,13,1,30,44,1544
67021,67021,71C7D3BEB879651EE771977BC4EF34E5,10634,16,18,2,27,45,1395
67022,67022,71C7D3BEB879651EE771977BC4EF34E5,10341,21,23,2,31,47,1597
67023,67023,3F5AFF7B77303E1764ED829FD6E8A9F3,11791,0,9,9,38,49,1949
67024,67024,3F5AFF7B77303E1764ED829FD6E8A9F3,11201,13,14,1,35,49,1799
67025,67025,3F5AFF7B77303E1764ED829FD6E8A9F3,10221,16,18,2,34,49,1749
67026,67026,3F5AFF7B77303E1764ED829FD6E8A9F3,43731,18,19,1,34,47,1747
67027,67027,3F5AFF7B77303E1764ED829FD6E8A9F3,11701,21,23,2,43,48,2198
67034,67034,A2437A4AEC8E22627D9794D535E77C0B,19744,0,7,7,6,43,343
67035,67035,A2437A4AEC8E22627D9794D535E77C0B,12641,8,9,1,10,43,543
67036,67036,A2437A4AEC8E22627D9794D535E77C0B,12921,10,12,2,9,41,491
67037,67037,A2437A4AEC8E22627D9794D535E77C0B,12641,17,19,2,10,43,543
67038,67038,D157013D3488A5412F8F2595D1038B6C,12661,1,5,4,32,45,1645
67039,67039,D157013D3488A5412F8F2595D1038B6C,12311,8,10,2,30,44,1544
67040,67040,D157013D3488A5412F8F2595D1038B6C,12661,11,12,1,32,45,1645
67041,67041,D157013D3488A5412F8F2595D1038B6C,12311,14,20,6,30,44,1544
67042,67042,D157013D3488A5412F8F2595D1038B6C,10716,21,23,2,30,46,1546
67043,67043,9FC39451E6DCCE94D942B7AE2584CFA7,41392,0,7,7,43,48,2198
67044,67044,9FC39451E6DCCE94D942B7AE2584CFA7,42321,8,10,2,43,47,2197
67045,67045,9FC39451E6DCCE94D942B7AE2584CFA7,41392,12,13,1,43,48,2198
67046,67046,9FC39451E6DCCE94D942B7AE2584CFA7,10801,14,15,1,42,47,2147
67047,67047,9FC39451E6DCCE94D942B7AE2584CFA7,41392,18,23,5,43,48,2198
67048,67048,84BFDA5775B1A36CF113618F1669E73C,42521,0,6,6,31,47,1597
67049,67049,84BFDA5775B1A36CF113618F1669E73C,13651,7,8,1,30,47,1547
67050,67050,84BFDA5775B1A36CF113618F1669E73C,42521,10,14,4,31,47,1597
67051,67051,84BFDA5775B1A36CF113618F1669E73C,13651,15,16,1,30,47,1547
67052,67052,84BFDA5775B1A36CF113618F1669E73C,42521,18,23,5,31,47,1597
67053,67053,4B092DC1F29A37B0C9B62BC92967DF2D,12031,0,6,6,33,48,1698
67054,67054,4B092DC1F29A37B0C9B62BC92967DF2D,10401,7,11,4,33,49,1699
67055,67055,4B092DC1F29A37B0C9B62BC92967DF2D,43731,14,16,2,34,47,1747
67056,67056,4B092DC1F29A37B0C9B62BC92967DF2D,42941,16,17,1,37,47,1897
67057,67057,4B092DC1F29A37B0C9B62BC92967DF2D,12031,19,23,4,33,48,1698
67058,67058,F4D1CACDA44EA0B56E4022B1E4015F81,42511,0,8,8,37,47,1897
67059,67059,F4D1CACDA44EA0B56E4022B1E4015F81,11261,11,12,1,36,46,1846
67060,67060,F4D1CACDA44EA0B56E4022B1E4015F81,41591,13,15,2,34,49,1749
67061,67061,F4D1CACDA44EA0B56E4022B1E4015F81,42301,18,21,3,36,47,1847
67062,67062,F4D1CACDA44EA0B56E4022B1E4015F81,42511,21,23,2,37,47,1897
67063,67063,669C34237215178780FBCDB7F5444D7E,10221,0,1,1,34,49,1749
67064,67064,669C34237215178780FBCDB7F5444D7E,42521,3,12,9,31,47,1597
67065,67065,669C34237215178780FBCDB7F5444D7E,11061,13,16,3,29,48,1498
67066,67066,669C34237215178780FBCDB7F5444D7E,43761,20,21,1,32,47,1647
67067,67067,720B1030F9AA451F5DB7F94C393FD381,11731,1,2,1,36,48,1848
67068,67068,720B1030F9AA451F5DB7F94C393FD381,10661,2,4,2,37,49,1899
67069,67069,720B1030F9AA451F5DB7F94C393FD381,12651,4,16,12,43,47,2197
67070,67070,720B1030F9AA451F5DB7F94C393FD381,13711,19,21,2,38,46,1946
67071,67071,4A64F91296EF8C1DAA19E0A02FF0729A,11151,0,8,8,30,48,1548
67072,67072,4A64F91296EF8C1DAA19E0A02FF0729A,10231,10,16,6,39,49,1999
67073,67073,4A64F91296EF8C1DAA19E0A02FF0729A,11291,17,18,1,40,49,2049
67074,67074,90BD61F3A66CAAA0B741B693E1039E7C,13121,0,3,3,38,46,1946
67075,67075,90BD61F3A66CAAA0B741B693E1039E7C,12381,7,19,12,32,48,1648
67076,67076,90BD61F3A66CAAA0B741B693E1039E7C,13121,19,21,2,38,46,1946
67077,67077,6224797A94401F7316FE4DF239A66FE7,12221,0,10,10,43,44,2194
67078,67078,6224797A94401F7316FE4DF239A66FE7,12561,12,13,1,45,43,2293
67079,67079,6224797A94401F7316FE4DF239A66FE7,12221,14,15,1,43,44,2194
67080,67080,6224797A94401F7316FE4DF239A66FE7,12561,17,19,2,45,43,2293
67081,67081,6224797A94401F7316FE4DF239A66FE7,13341,20,21,1,44,45,2245
67082,67082,6680C80DFC3F7ACED725F17452013614,11161,0,11,11,32,48,1648
67083,67083,6680C80DFC3F7ACED725F17452013614,12521,15,16,1,35,41,1791
67084,67084,6680C80DFC3F7ACED725F17452013614,10691,18,20,2,33,48,1698
67085,67085,A79B530D2C24A6DA0A95FCC8A927C5D7,43981,10,11,1,36,49,1849
67086,67086,A79B530D2C24A6DA0A95FCC8A927C5D7,11161,13,18,5,32,48,1648
67087,67087,A79B530D2C24A6DA0A95FCC8A927C5D7,42261,19,21,2,25,49,1299
67091,67091,0A61C8BC2E2F3B8A439DFBB7542FD5B0,13371,0,14,14,41,47,2097
67092,67092,0A61C8BC2E2F3B8A439DFBB7542FD5B0,11541,16,18,2,35,49,1799
67093,67093,0A61C8BC2E2F3B8A439DFBB7542FD5B0,13371,19,23,4,41,47,2097
67094,67094,ECBC886277109C0582E65AB313F27C1C,13314,0,6,6,31,39,1589
67095,67095,ECBC886277109C0582E65AB313F27C1C,12521,7,8,1,35,41,1791
67096,67096,ECBC886277109C0582E65AB313F27C1C,43451,8,10,2,37,40,1890
67097,67097,ECBC886277109C0582E65AB313F27C1C,12521,10,15,5,35,41,1791
67098,67098,ECBC886277109C0582E65AB313F27C1C,13314,18,23,5,31,39,1589
67099,67099,7EF8399B7744B26431FFE3070C9BD313,19441,0,13,13,8,46,446
67100,67100,7EF8399B7744B26431FFE3070C9BD313,12641,15,16,1,10,43,543
67101,67101,7EF8399B7744B26431FFE3070C9BD313,19441,17,18,1,8,46,446
67102,67102,1A55CEB18A726CCE74CF0F2DC867FF78,42471,0,7,7,35,49,1799
67103,67103,1A55CEB18A726CCE74CF0F2DC867FF78,42351,9,10,1,38,45,1945
67104,67104,1A55CEB18A726CCE74CF0F2DC867FF78,10161,12,23,11,35,49,1799
67105,67105,B678CB1757AEE5076E9F8CDF51D8AF5B,11061,0,5,5,29,48,1498
67106,67106,B678CB1757AEE5076E9F8CDF51D8AF5B,13731,6,11,5,33,49,1699
67107,67107,B678CB1757AEE5076E9F8CDF51D8AF5B,42261,19,23,4,25,49,1299
67108,67108,9F5215EB6F19506AA8AED2CAA1CBC8E6,11481,7,16,9,41,48,2098
67109,67109,9F5215EB6F19506AA8AED2CAA1CBC8E6,10511,17,18,1,35,46,1796
67110,67110,9F5215EB6F19506AA8AED2CAA1CBC8E6,43761,20,22,2,32,47,1647
67114,67114,C493E8EAD829832CA31397E82BE4990B,43021,0,5,5,16,43,843
67115,67115,C493E8EAD829832CA31397E82BE4990B,12641,6,10,4,10,43,543
67116,67116,C493E8EAD829832CA31397E82BE4990B,43021,13,19,6,16,43,843
67117,67117,6164F469738A30A14CD373EB73D02471,11801,0,10,10,42,48,2148
67118,67118,6164F469738A30A14CD373EB73D02471,10107,16,20,4,38,49,1949
67119,67119,6164F469738A30A14CD373EB73D02471,11801,21,23,2,42,48,2148
67120,67120,57BAF35AE6AF4C6D9BC47B5285870095,11261,0,8,8,36,46,1846
67121,67121,57BAF35AE6AF4C6D9BC47B5285870095,12401,9,11,2,39,49,1999
67122,67122,57BAF35AE6AF4C6D9BC47B5285870095,12971,13,14,1,32,48,1648
67123,67123,57BAF35AE6AF4C6D9BC47B5285870095,42921,16,18,2,33,47,1697
67124,67124,57BAF35AE6AF4C6D9BC47B5285870095,10151,18,20,2,34,47,1747
67131,67131,FA38F7224DEF6C90951F6B804E6C067C,13911,1,3,2,39,46,1996
67132,67132,FA38F7224DEF6C90951F6B804E6C067C,42151,3,4,1,35,45,1795
67133,67133,FA38F7224DEF6C90951F6B804E6C067C,13911,5,17,12,39,46,1996
67134,67134,FA38F7224DEF6C90951F6B804E6C067C,42351,18,23,5,38,45,1945
67135,67135,2BEF2F1DF9F53E26FBA10E115C641BD7,42151,0,1,1,35,45,1795
67136,67136,2BEF2F1DF9F53E26FBA10E115C641BD7,12311,1,2,1,30,44,1544
67137,67137,2BEF2F1DF9F53E26FBA10E115C641BD7,42151,2,4,2,35,45,1795
67138,67138,2BEF2F1DF9F53E26FBA10E115C641BD7,12491,17,18,1,36,43,1843
67139,67139,2BEF2F1DF9F53E26FBA10E115C641BD7,11081,19,21,2,35,46,1796
67140,67140,D69C298A6AE4CBEEB47F4921DBC93123,11801,2,9,7,42,48,2148
67141,67141,D69C298A6AE4CBEEB47F4921DBC93123,11331,15,18,3,37,48,1898
67142,67142,D69C298A6AE4CBEEB47F4921DBC93123,11151,19,20,1,30,48,1548
67143,67143,D69C298A6AE4CBEEB47F4921DBC93123,11801,21,23,2,42,48,2148
67150,67150,71E80706335E84CC6A7D19F4D3805DDF,19441,0,1,1,8,46,446
67151,67151,71E80706335E84CC6A7D19F4D3805DDF,11631,3,7,4,12,49,649
67152,67152,71E80706335E84CC6A7D19F4D3805DDF,19441,8,23,15,8,46,446
67160,67160,F4A5CE128B0276BA64A57CF9F5D60F74,42831,0,14,14,27,48,1398
67161,67161,F4A5CE128B0276BA64A57CF9F5D60F74,10661,19,20,1,37,49,1899
67162,67162,F4A5CE128B0276BA64A57CF9F5D60F74,42831,21,23,2,27,48,1398
67163,67163,64BD805F6D9361B926D90DA2610BBB4F,49201,5,6,1,7,41,391
67164,67164,64BD805F6D9361B926D90DA2610BBB4F,40691,11,12,1,42,48,2148
67165,67165,64BD805F6D9361B926D90DA2610BBB4F,49201,14,16,2,7,41,391
67166,67166,64BD805F6D9361B926D90DA2610BBB4F,12921,20,21,1,9,41,491
67167,67167,97C2BF5A29CED539C43A6B4C2D504EB5,12651,0,8,8,43,47,2197
67168,67168,97C2BF5A29CED539C43A6B4C2D504EB5,40637,11,12,1,36,47,1847
67169,67169,97C2BF5A29CED539C43A6B4C2D504EB5,10251,13,14,1,35,47,1797
67170,67170,97C2BF5A29CED539C43A6B4C2D504EB5,10111,17,18,1,37,47,1897
67171,67171,AAC8BE0C4552458DD989D6BDD72B447F,43361,0,8,8,38,48,1948
67172,67172,AAC8BE0C4552458DD989D6BDD72B447F,40341,9,13,4,23,49,1199
67173,67173,AAC8BE0C4552458DD989D6BDD72B447F,43361,15,22,7,38,48,1948
67174,67174,CD55B44A3FD4B718A673CC03711FD344,12921,3,10,7,9,41,491
67175,67175,CD55B44A3FD4B718A673CC03711FD344,12641,11,12,1,10,43,543
67176,67176,CD55B44A3FD4B718A673CC03711FD344,12921,13,15,2,9,41,491
67177,67177,CD55B44A3FD4B718A673CC03711FD344,12641,16,18,2,10,43,543
67178,67178,CD55B44A3FD4B718A673CC03711FD344,12921,18,19,1,9,41,491
67179,67179,CD55B44A3FD4B718A673CC03711FD344,19021,20,22,2,10,45,545
67190,67190,B2C61EE4080ED347D0314F331516889E,10292,0,15,15,30,47,1547
67191,67191,B2C61EE4080ED347D0314F331516889E,11751,18,19,1,35,48,1798
67192,67192,B2C61EE4080ED347D0314F331516889E,10292,20,23,3,30,47,1547
67193,67193,7D40FDA16D9F775EEBE4F7D8E79E845C,42521,1,16,15,31,47,1597
67194,67194,7D40FDA16D9F775EEBE4F7D8E79E845C,19114,17,18,1,7,43,393
67195,67195,7D40FDA16D9F775EEBE4F7D8E79E845C,11271,20,22,2,37,48,1898
67199,67199,E02F64059E677B81EAF8B96D760DDB0F,16281,6,8,2,11,4,554
67200,67200,E02F64059E677B81EAF8B96D760DDB0F,15051,9,13,4,19,4,954
67201,67201,E02F64059E677B81EAF8B96D760DDB0F,16281,13,19,6,11,4,554
67209,67209,FCB991997D2B7B038C060D519018406D,42021,0,3,3,33,47,1697
67210,67210,FCB991997D2B7B038C060D519018406D,10107,4,11,7,38,49,1949
67211,67211,FCB991997D2B7B038C060D519018406D,42021,14,15,1,33,47,1697
67212,67212,FCB991997D2B7B038C060D519018406D,12971,21,23,2,32,48,1648
67213,67213,4D4354448E6EA09F1B4E4241448CDCDF,11381,0,14,14,30,47,1547
67214,67214,4D4354448E6EA09F1B4E4241448CDCDF,42801,15,17,2,40,49,2049
67215,67215,4D4354448E6EA09F1B4E4241448CDCDF,13651,20,23,3,30,47,1547
67219,67219,2873DE93703B028193B7B9719DCFE691,12521,0,7,7,35,41,1791
67220,67220,2873DE93703B028193B7B9719DCFE691,43451,7,11,4,37,40,1890
67221,67221,2873DE93703B028193B7B9719DCFE691,12521,11,13,2,35,41,1791
67222,67222,2873DE93703B028193B7B9719DCFE691,43451,14,17,3,37,40,1890
67223,67223,2873DE93703B028193B7B9719DCFE691,12521,18,22,4,35,41,1791
67227,67227,DCC0D76C64600FBE8830281530410EAC,12221,2,4,2,43,44,2194
67228,67228,DCC0D76C64600FBE8830281530410EAC,43051,7,9,2,46,45,2345
67229,67229,DCC0D76C64600FBE8830281530410EAC,13341,10,15,5,44,45,2245
67230,67230,DCC0D76C64600FBE8830281530410EAC,12211,19,20,1,41,44,2094
67231,67231,DCC0D76C64600FBE8830281530410EAC,13341,21,22,1,44,45,2245
67232,67232,6B614428F8D95ECFDE2207017437E97D,12874,0,3,3,20,34,1034
67233,67233,6B614428F8D95ECFDE2207017437E97D,19281,3,5,2,16,32,832
67234,67234,6B614428F8D95ECFDE2207017437E97D,12871,6,9,3,22,33,1133
67235,67235,6B614428F8D95ECFDE2207017437E97D,19281,13,15,2,16,32,832
67236,67236,6B614428F8D95ECFDE2207017437E97D,12871,15,19,4,22,33,1133
67237,67237,6B614428F8D95ECFDE2207017437E97D,19281,20,21,1,16,32,832
67238,67238,F8A2EC8C9348BFB1362087B807B825C5,43971,3,4,1,30,48,1548
67239,67239,F8A2EC8C9348BFB1362087B807B825C5,11381,5,6,1,30,47,1547
67240,67240,F8A2EC8C9348BFB1362087B807B825C5,43971,6,8,2,30,48,1548
67241,67241,F8A2EC8C9348BFB1362087B807B825C5,13671,16,18,2,27,43,1393
67242,67242,F8A2EC8C9348BFB1362087B807B825C5,43971,20,23,3,30,48,1548
67246,67246,8216976CCAE5E4C68F70476A01BDA009,13071,1,3,2,41,41,2091
67247,67247,8216976CCAE5E4C68F70476A01BDA009,42381,4,14,10,39,41,1991
67248,67248,8216976CCAE5E4C68F70476A01BDA009,43451,14,15,1,37,40,1890
67249,67249,8216976CCAE5E4C68F70476A01BDA009,42381,16,23,7,39,41,1991
67250,67250,E969EC1FA6E19F3F5A602F2FE47F2E7D,13911,0,2,2,39,46,1996
67251,67251,E969EC1FA6E19F3F5A602F2FE47F2E7D,12491,2,4,2,36,43,1843
67252,67252,E969EC1FA6E19F3F5A602F2FE47F2E7D,11261,4,18,14,36,46,1846
67259,67259,CA13573EC489EC297A1DB55BF08926BD,42231,0,6,6,37,46,1896
67260,67260,CA13573EC489EC297A1DB55BF08926BD,43951,7,11,4,49,41,2491
67261,67261,CA13573EC489EC297A1DB55BF08926BD,42231,12,15,3,37,46,1896
67262,67262,CA13573EC489EC297A1DB55BF08926BD,13331,15,18,3,38,47,1947
67263,67263,CA13573EC489EC297A1DB55BF08926BD,42231,20,23,3,37,46,1896
67264,67264,15AF53FBA0C13FBD61024895398ED2FD,11471,1,7,6,12,48,648
67265,67265,15AF53FBA0C13FBD61024895398ED2FD,19441,10,11,1,8,46,446
67266,67266,15AF53FBA0C13FBD61024895398ED2FD,42041,13,15,2,10,47,547
67267,67267,15AF53FBA0C13FBD61024895398ED2FD,19441,19,20,1,8,46,446
67268,67268,15AF53FBA0C13FBD61024895398ED2FD,11471,20,22,2,12,48,648
67273,67273,F6947486712885EDC02BCA122A5A6DB5,15061,0,6,6,41,25,2075
67274,67274,F6947486712885EDC02BCA122A5A6DB5,12881,9,18,9,47,22,2372
67275,67275,F6947486712885EDC02BCA122A5A6DB5,15061,19,23,4,41,25,2075
67276,67276,6AD981E757B177FB5B64F1D1D2EAA27F,12651,1,8,7,43,47,2197
67277,67277,6AD981E757B177FB5B64F1D1D2EAA27F,11201,12,14,2,35,49,1799
67278,67278,6AD981E757B177FB5B64F1D1D2EAA27F,11231,14,16,2,37,49,1899
67279,67279,6AD981E757B177FB5B64F1D1D2EAA27F,42471,18,19,1,35,49,1799
67280,67280,6AD981E757B177FB5B64F1D1D2EAA27F,11231,20,22,2,37,49,1899
67294,67294,A7889E15E0F93853EAB5CF324793B9C0,15411,0,1,1,44,27,2227
67295,67295,A7889E15E0F93853EAB5CF324793B9C0,12611,3,9,6,41,29,2079
67296,67296,A7889E15E0F93853EAB5CF324793B9C0,15411,14,22,8,44,27,2227
67303,67303,5C7F8A03755C44742187CEE0EDAF92C8,11631,0,6,6,12,49,649
67304,67304,5C7F8A03755C44742187CEE0EDAF92C8,19021,7,10,3,10,45,545
67305,67305,5C7F8A03755C44742187CEE0EDAF92C8,11631,12,14,2,12,49,649
67306,67306,5C7F8A03755C44742187CEE0EDAF92C8,19021,15,17,2,10,45,545
67307,67307,5C7F8A03755C44742187CEE0EDAF92C8,11631,22,23,1,12,49,649
67308,67308,43857F135F7541B4685E34097E43A46E,12921,0,5,5,9,41,491
67309,67309,43857F135F7541B4685E34097E43A46E,43021,6,7,1,16,43,843
67310,67310,43857F135F7541B4685E34097E43A46E,12921,9,11,2,9,41,491
67311,67311,43857F135F7541B4685E34097E43A46E,12641,17,19,2,10,43,543
67312,67312,43857F135F7541B4685E34097E43A46E,19021,21,22,1,10,45,545
67313,67313,486099ACFD60FA026B2FB72449273C53,13511,0,8,8,34,48,1748
67314,67314,486099ACFD60FA026B2FB72449273C53,12083,8,12,4,36,49,1849
67315,67315,486099ACFD60FA026B2FB72449273C53,12021,14,15,1,37,49,1899
67316,67316,486099ACFD60FA026B2FB72449273C53,10771,15,23,8,41,46,2096
67324,67324,5B8895269B90579A9B495097DE3A061A,40833,0,6,6,41,47,2097
67325,67325,5B8895269B90579A9B495097DE3A061A,13314,9,10,1,31,39,1589
67326,67326,5B8895269B90579A9B495097DE3A061A,12521,10,15,5,35,41,1791
67327,67327,5B8895269B90579A9B495097DE3A061A,13314,15,18,3,31,39,1589
67328,67328,5B8895269B90579A9B495097DE3A061A,40833,21,23,2,41,47,2097
67329,67329,AA9DDBAE747C0C61A76E689DD898E315,42301,0,7,7,36,47,1847
67330,67330,AA9DDBAE747C0C61A76E689DD898E315,12311,7,18,11,30,44,1544
67331,67331,AA9DDBAE747C0C61A76E689DD898E315,42301,19,20,1,36,47,1847
67338,67338,400659CE2E6F8BFF6D95D6F52F73DF5B,42921,0,5,5,33,47,1697
67339,67339,400659CE2E6F8BFF6D95D6F52F73DF5B,11861,6,11,5,32,47,1647
67340,67340,400659CE2E6F8BFF6D95D6F52F73DF5B,42921,12,13,1,33,47,1697
67341,67341,400659CE2E6F8BFF6D95D6F52F73DF5B,11861,13,19,6,32,47,1647
67342,67342,400659CE2E6F8BFF6D95D6F52F73DF5B,42921,21,23,2,33,47,1697
67354,67354,B7685410B5F2070987C141F92E3D6247,42471,8,10,2,35,49,1799
67355,67355,B7685410B5F2070987C141F92E3D6247,13711,12,13,1,38,46,1946
67356,67356,B7685410B5F2070987C141F92E3D6247,11021,15,23,8,36,49,1849
67364,67364,B26931836DA329DC52FEE9F969ECA44E,11921,1,8,7,38,48,1948
67365,67365,B26931836DA329DC52FEE9F969ECA44E,10107,9,11,2,38,49,1949
67366,67366,B26931836DA329DC52FEE9F969ECA44E,40171,12,14,2,38,48,1948
67367,67367,B26931836DA329DC52FEE9F969ECA44E,10161,15,16,1,35,49,1799
67368,67368,B26931836DA329DC52FEE9F969ECA44E,40171,16,18,2,38,48,1948
67369,67369,93E2DE921E47D3798DC5D4DD35FE7A3F,40697,0,2,2,43,48,2198
67370,67370,93E2DE921E47D3798DC5D4DD35FE7A3F,10801,6,8,2,42,47,2147
67371,67371,93E2DE921E47D3798DC5D4DD35FE7A3F,43621,11,13,2,46,48,2348
67372,67372,93E2DE921E47D3798DC5D4DD35FE7A3F,13371,13,17,4,41,47,2097
67373,67373,93E2DE921E47D3798DC5D4DD35FE7A3F,13071,20,21,1,41,41,2091
67374,67374,33BB1FBC807A18D7B763AE4B57056758,12521,6,18,12,35,41,1791
67375,67375,33BB1FBC807A18D7B763AE4B57056758,13314,18,19,1,31,39,1589
67376,67376,33BB1FBC807A18D7B763AE4B57056758,12521,19,21,2,35,41,1791
67380,67380,4BD400D7F597B681CE3C274F3ADB197C,16311,0,1,1,2,11,111
67381,67381,4BD400D7F597B681CE3C274F3ADB197C,16233,2,5,3,5,15,265
67382,67382,4BD400D7F597B681CE3C274F3ADB197C,16311,13,22,9,2,11,111
67383,67383,BB2213F6CD0581F26FA9CDBA17E84BA3,42271,1,11,10,40,47,2047
67384,67384,BB2213F6CD0581F26FA9CDBA17E84BA3,12391,13,15,2,36,49,1849
67385,67385,BB2213F6CD0581F26FA9CDBA17E84BA3,42271,19,23,4,40,47,2047
67397,67397,B253B5F217D8C5A21EFEEAEBC1D897DA,43761,2,3,1,32,47,1647
67398,67398,B253B5F217D8C5A21EFEEAEBC1D897DA,42581,4,8,4,38,48,1948
67399,67399,B253B5F217D8C5A21EFEEAEBC1D897DA,10281,10,15,5,33,48,1698
67400,67400,B253B5F217D8C5A21EFEEAEBC1D897DA,42221,16,23,7,38,48,1948
67410,67410,E75DBC8FF69066A482B9B403023F9E0C,11521,9,18,9,41,48,2098
67411,67411,E75DBC8FF69066A482B9B403023F9E0C,11861,20,21,1,32,47,1647
67412,67412,E75DBC8FF69066A482B9B403023F9E0C,10281,22,23,1,33,48,1698
67420,67420,4FB7544A1E67AE742452DB3735E5F7CF,10771,1,2,1,41,46,2096
67421,67421,4FB7544A1E67AE742452DB3735E5F7CF,13111,3,6,3,42,46,2146
67422,67422,4FB7544A1E67AE742452DB3735E5F7CF,12561,7,9,2,45,43,2293
67423,67423,4FB7544A1E67AE742452DB3735E5F7CF,43951,14,17,3,49,41,2491
67424,67424,4FB7544A1E67AE742452DB3735E5F7CF,11001,21,23,2,42,47,2147
67434,67434,F93FC485E5AA02DFA65C5E4A357B61F3,11481,0,8,8,41,48,2098
67435,67435,F93FC485E5AA02DFA65C5E4A357B61F3,43341,8,9,1,41,46,2096
67436,67436,F93FC485E5AA02DFA65C5E4A357B61F3,42921,11,13,2,33,47,1697
67437,67437,F93FC485E5AA02DFA65C5E4A357B61F3,13101,14,15,1,40,47,2047
67438,67438,F93FC485E5AA02DFA65C5E4A357B61F3,11521,20,22,2,41,48,2098
67445,67445,45F7BED1A33423D605A441382F01DFAF,19244,3,6,3,1,43,93
67446,67446,45F7BED1A33423D605A441382F01DFAF,12641,11,12,1,10,43,543
67447,67447,45F7BED1A33423D605A441382F01DFAF,12921,17,18,1,9,41,491
67448,67448,45F7BED1A33423D605A441382F01DFAF,19031,20,22,2,1,42,92
67453,67453,12CD49247659842CCDEA8C017DBD960B,43621,2,5,3,46,48,2348
67454,67454,12CD49247659842CCDEA8C017DBD960B,41393,8,10,2,43,49,2199
67455,67455,12CD49247659842CCDEA8C017DBD960B,13471,11,12,1,47,49,2399
67456,67456,12CD49247659842CCDEA8C017DBD960B,41393,17,21,4,43,49,2199
67457,67457,12CD49247659842CCDEA8C017DBD960B,13471,21,22,1,47,49,2399
67461,67461,7300FFB733BFFEA187DB110E4D4DC3D2,19181,2,6,4,8,40,440
67462,67462,7300FFB733BFFEA187DB110E4D4DC3D2,12921,8,10,2,9,41,491
67463,67463,7300FFB733BFFEA187DB110E4D4DC3D2,49201,12,14,2,7,41,391
67464,67464,7300FFB733BFFEA187DB110E4D4DC3D2,12921,16,17,1,9,41,491
67465,67465,7300FFB733BFFEA187DB110E4D4DC3D2,12581,19,20,1,24,48,1248
67466,67466,7300FFB733BFFEA187DB110E4D4DC3D2,49201,21,23,2,7,41,391
67467,67467,27F132E818644D3933B7D51A13F3BE57,15411,7,9,2,44,27,2227
67468,67468,27F132E818644D3933B7D51A13F3BE57,12611,9,10,1,41,29,2079
67469,67469,27F132E818644D3933B7D51A13F3BE57,15411,11,22,11,44,27,2227
67473,67473,3F5925A3FD04D7B749827F005E853BB0,42961,0,9,9,35,49,1799
67474,67474,3F5925A3FD04D7B749827F005E853BB0,40341,10,13,3,23,49,1199
67475,67475,3F5925A3FD04D7B749827F005E853BB0,40271,14,23,9,35,49,1799
67476,67476,AB35C432DC3D59E7929F031635A675AA,10501,0,3,3,22,46,1146
67477,67477,AB35C432DC3D59E7929F031635A675AA,10061,6,8,2,20,46,1046
67478,67478,AB35C432DC3D59E7929F031635A675AA,10951,9,11,2,29,48,1498
67479,67479,AB35C432DC3D59E7929F031635A675AA,12601,12,23,11,25,47,1297
67484,67484,9F3870E44557C7F72D14CE772A3EFDF6,10151,10,11,1,34,47,1747
67485,67485,9F3870E44557C7F72D14CE772A3EFDF6,11011,12,14,2,39,49,1999
67486,67486,9F3870E44557C7F72D14CE772A3EFDF6,10151,14,17,3,34,47,1747
67487,67487,9F3870E44557C7F72D14CE772A3EFDF6,10231,20,23,3,39,49,1999
67488,67488,1FA24F76587DEEEE9ED93C46D3D68950,42371,0,10,10,34,46,1746
67489,67489,1FA24F76587DEEEE9ED93C46D3D68950,12491,14,15,1,36,43,1843
67490,67490,1FA24F76587DEEEE9ED93C46D3D68950,42371,16,18,2,34,46,1746
67491,67491,1FA24F76587DEEEE9ED93C46D3D68950,12491,22,23,1,36,43,1843
67496,67496,45C47FA5BF235859DE3305ED73E71C2A,11061,0,10,10,29,48,1498
67497,67497,45C47FA5BF235859DE3305ED73E71C2A,11381,11,12,1,30,47,1547
67498,67498,45C47FA5BF235859DE3305ED73E71C2A,11061,12,14,2,29,48,1498
67499,67499,45C47FA5BF235859DE3305ED73E71C2A,40341,14,18,4,23,49,1199
67500,67500,45C47FA5BF235859DE3305ED73E71C2A,11061,21,23,2,29,48,1498
67501,67501,E131C5415CA4464B2E2B8BBC4B15D17C,43761,0,15,15,32,47,1647
67502,67502,E131C5415CA4464B2E2B8BBC4B15D17C,42261,19,20,1,25,49,1299
67503,67503,E131C5415CA4464B2E2B8BBC4B15D17C,43761,22,23,1,32,47,1647
67504,67504,853A16C8E6E154D13F9864F752CCB2E5,13101,0,4,4,40,47,2047
67505,67505,853A16C8E6E154D13F9864F752CCB2E5,11481,5,9,4,41,48,2098
67506,67506,853A16C8E6E154D13F9864F752CCB2E5,13101,10,11,1,40,47,2047
67507,67507,853A16C8E6E154D13F9864F752CCB2E5,11481,11,12,1,41,48,2098
67508,67508,853A16C8E6E154D13F9864F752CCB2E5,13101,14,23,9,40,47,2047
67512,67512,F49185C5E99D83C9DDF9416C77837C12,42201,0,6,6,43,46,2196
67513,67513,F49185C5E99D83C9DDF9416C77837C12,43011,9,10,1,40,42,2042
67514,67514,F49185C5E99D83C9DDF9416C77837C12,43061,11,13,2,43,46,2196
67515,67515,F49185C5E99D83C9DDF9416C77837C12,42461,15,20,5,45,47,2297
67516,67516,0407AC9F4B447C49ABB57DABBBF0B0D5,11491,0,7,7,36,47,1847
67517,67517,0407AC9F4B447C49ABB57DABBBF0B0D5,13091,8,10,2,20,42,1042
67518,67518,0407AC9F4B447C49ABB57DABBBF0B0D5,11074,10,12,2,37,47,1897
67519,67519,0407AC9F4B447C49ABB57DABBBF0B0D5,11491,13,15,2,36,47,1847
67520,67520,0407AC9F4B447C49ABB57DABBBF0B0D5,41724,16,18,2,38,48,1948
67521,67521,0407AC9F4B447C49ABB57DABBBF0B0D5,12514,18,19,1,38,47,1947
67522,67522,F22947DE130D46751493BC4E4F717C11,12311,0,7,7,30,44,1544
67523,67523,F22947DE130D46751493BC4E4F717C11,12661,9,10,1,32,45,1645
67524,67524,F22947DE130D46751493BC4E4F717C11,12311,11,14,3,30,44,1544
67525,67525,F22947DE130D46751493BC4E4F717C11,12661,17,19,2,32,45,1645
67526,67526,F22947DE130D46751493BC4E4F717C11,12311,20,22,2,30,44,1544
67540,67540,DC9866094212A637CCAC17CF01FE4B5F,42861,0,6,6,37,44,1894
67541,67541,DC9866094212A637CCAC17CF01FE4B5F,11261,6,8,2,36,46,1846
67542,67542,DC9866094212A637CCAC17CF01FE4B5F,42861,11,12,1,37,44,1894
67543,67543,DC9866094212A637CCAC17CF01FE4B5F,11261,13,16,3,36,46,1846
67544,67544,DC9866094212A637CCAC17CF01FE4B5F,42861,19,23,4,37,44,1894
67549,67549,91681CB3BCF154EFD2E5540E1C0B24C4,42801,0,10,10,40,49,2049
67550,67550,91681CB3BCF154EFD2E5540E1C0B24C4,11551,12,15,3,39,49,1999
67551,67551,91681CB3BCF154EFD2E5540E1C0B24C4,42961,17,19,2,35,49,1799
67552,67552,91681CB3BCF154EFD2E5540E1C0B24C4,40411,20,21,1,34,48,1748
67553,67553,91681CB3BCF154EFD2E5540E1C0B24C4,11701,22,23,1,43,48,2198
67554,67554,A94573BDDECBBDBAA7F89BE9CE71D3CF,43581,0,7,7,33,48,1698
67555,67555,A94573BDDECBBDBAA7F89BE9CE71D3CF,12511,8,11,3,39,47,1997
67556,67556,A94573BDDECBBDBAA7F89BE9CE71D3CF,43481,11,15,4,39,48,1998
67557,67557,A94573BDDECBBDBAA7F89BE9CE71D3CF,43581,19,23,4,33,48,1698
67561,67561,6C020C892F288D31D45E761066653E6E,13711,0,8,8,38,46,1946
67562,67562,6C020C892F288D31D45E761066653E6E,40951,12,15,3,36,49,1849
67563,67563,6C020C892F288D31D45E761066653E6E,11074,16,19,3,37,47,1897
67564,67564,6C020C892F288D31D45E761066653E6E,13711,22,23,1,38,46,1946
67568,67568,D9BB41A84CF921B48387DB07E0CD66FA,42221,10,12,2,38,48,1948
67569,67569,D9BB41A84CF921B48387DB07E0CD66FA,11074,17,18,1,37,47,1897
67570,67570,D9BB41A84CF921B48387DB07E0CD66FA,12381,19,20,1,32,48,1648
67574,67574,47E4F54E03FF965656814484703AFDF1,43671,0,10,10,35,48,1798
67575,67575,47E4F54E03FF965656814484703AFDF1,11381,12,17,5,30,47,1547
67576,67576,47E4F54E03FF965656814484703AFDF1,11201,20,23,3,35,49,1799
67577,67577,1C11E829C965E98C9AACE0FB801A921E,42921,0,10,10,33,47,1697
67578,67578,1C11E829C965E98C9AACE0FB801A921E,11271,15,16,1,37,48,1898
67579,67579,1C11E829C965E98C9AACE0FB801A921E,42921,17,23,6,33,47,1697
67580,67580,48E15F7773EDEEFF950E5A2CE7CBD12F,11321,0,5,5,31,46,1596
67581,67581,48E15F7773EDEEFF950E5A2CE7CBD12F,12641,8,12,4,10,43,543
67582,67582,48E15F7773EDEEFF950E5A2CE7CBD12F,19114,15,22,7,7,43,393
67594,67594,4A1E2DF13E9399DEAE7966E1EFE6FC6B,13271,0,4,4,41,47,2097
67595,67595,4A1E2DF13E9399DEAE7966E1EFE6FC6B,12661,9,12,3,32,45,1645
67596,67596,4A1E2DF13E9399DEAE7966E1EFE6FC6B,13271,14,23,9,41,47,2097
67597,67597,387C2BFABED9CD0C7C45EBAD5F5242F9,10251,0,2,2,35,47,1797
67598,67598,387C2BFABED9CD0C7C45EBAD5F5242F9,13511,7,9,2,34,48,1748
67599,67599,387C2BFABED9CD0C7C45EBAD5F5242F9,12521,12,14,2,35,41,1791
67600,67600,387C2BFABED9CD0C7C45EBAD5F5242F9,12491,15,23,8,36,43,1843
67604,67604,00ED2280FB2BEC22D8FB36F8A7AFB1A5,42791,2,7,5,35,45,1795
67605,67605,00ED2280FB2BEC22D8FB36F8A7AFB1A5,13121,8,13,5,38,46,1946
67606,67606,00ED2280FB2BEC22D8FB36F8A7AFB1A5,10271,13,16,3,37,46,1896
67607,67607,00ED2280FB2BEC22D8FB36F8A7AFB1A5,42801,21,23,2,40,49,2049
67608,67608,21E01FD73F60A460B78DB5B37A75E13F,12561,0,6,6,45,43,2293
67609,67609,21E01FD73F60A460B78DB5B37A75E13F,43951,9,11,2,49,41,2491
67610,67610,21E01FD73F60A460B78DB5B37A75E13F,12971,12,13,1,32,48,1648
67611,67611,21E01FD73F60A460B78DB5B37A75E13F,43951,17,23,6,49,41,2491
67612,67612,C96AF7724AE07D1D1BE56C246C9FE7FC,13341,0,8,8,44,45,2245
67613,67613,C96AF7724AE07D1D1BE56C246C9FE7FC,42631,9,11,2,43,45,2195
67614,67614,C96AF7724AE07D1D1BE56C246C9FE7FC,13341,11,12,1,44,45,2245
67615,67615,C96AF7724AE07D1D1BE56C246C9FE7FC,42631,16,17,1,43,45,2195
67616,67616,C96AF7724AE07D1D1BE56C246C9FE7FC,13341,20,22,2,44,45,2245
67617,67617,65AF5F43B5EE42BA72E4D27FF698C71E,12481,0,10,10,37,49,1899
67618,67618,65AF5F43B5EE42BA72E4D27FF698C71E,10107,11,13,2,38,49,1949
67619,67619,65AF5F43B5EE42BA72E4D27FF698C71E,11381,14,23,9,30,47,1547
67620,67620,7B7EC78C492826B1A2F98257774A5C01,11061,3,10,7,29,48,1498
67621,67621,7B7EC78C492826B1A2F98257774A5C01,40171,11,17,6,38,48,1948
67622,67622,7B7EC78C492826B1A2F98257774A5C01,11061,20,23,3,29,48,1498
67623,67623,1C12FD1823A36FA85667FC8316128B0A,42511,1,2,1,37,47,1897
67624,67624,1C12FD1823A36FA85667FC8316128B0A,13681,3,4,1,38,47,1947
67625,67625,1C12FD1823A36FA85667FC8316128B0A,42511,8,9,1,37,47,1897
67626,67626,1C12FD1823A36FA85667FC8316128B0A,13121,9,10,1,38,46,1946
67627,67627,1C12FD1823A36FA85667FC8316128B0A,13681,13,23,10,38,47,1947
67634,67634,A922D7161F816C1FD25F52BCCB616DFE,40673,0,4,4,36,48,1848
67635,67635,A922D7161F816C1FD25F52BCCB616DFE,10251,4,13,9,35,47,1797
67636,67636,A922D7161F816C1FD25F52BCCB616DFE,15301,15,17,2,35,16,1766
67637,67637,A922D7161F816C1FD25F52BCCB616DFE,10251,19,22,3,35,47,1797
67638,67638,2075B4FB25DAADC66CD593580F270747,11801,0,13,13,42,48,2148
67639,67639,2075B4FB25DAADC66CD593580F270747,11751,14,16,2,35,48,1798
67640,67640,2075B4FB25DAADC66CD593580F270747,43311,17,18,1,31,48,1598
67641,67641,2075B4FB25DAADC66CD593580F270747,42161,20,22,2,36,47,1847
67642,67642,0602042818CF9564A739B80A039ADA67,12391,0,12,12,36,49,1849
67643,67643,0602042818CF9564A739B80A039ADA67,42021,13,14,1,33,47,1697
67644,67644,0602042818CF9564A739B80A039ADA67,12601,15,17,2,25,47,1297
67645,67645,0602042818CF9564A739B80A039ADA67,11231,18,23,5,37,49,1899
67668,67668,92E1BAA88B052422B820ED36A9E8F107,11701,0,6,6,43,48,2198
67669,67669,92E1BAA88B052422B820ED36A9E8F107,11271,7,8,1,37,48,1898
67670,67670,92E1BAA88B052422B820ED36A9E8F107,41392,12,14,2,43,48,2198
67671,67671,92E1BAA88B052422B820ED36A9E8F107,11794,14,16,2,38,49,1949
67672,67672,92E1BAA88B052422B820ED36A9E8F107,11271,16,17,1,37,48,1898
67673,67673,92E1BAA88B052422B820ED36A9E8F107,11701,19,23,4,43,48,2198
67680,67680,BA82D8F6A8707F20D96FD8F810B92699,42864,0,8,8,38,44,1944
67681,67681,BA82D8F6A8707F20D96FD8F810B92699,11261,8,10,2,36,46,1846
67682,67682,BA82D8F6A8707F20D96FD8F810B92699,42861,10,13,3,37,44,1894
67683,67683,BA82D8F6A8707F20D96FD8F810B92699,11261,14,17,3,36,46,1846
67684,67684,BA82D8F6A8707F20D96FD8F810B92699,42864,20,23,3,38,44,1944
67688,67688,B24DFEF6BEA91CB0AE942579D8124FCB,10971,0,9,9,35,47,1797
67689,67689,B24DFEF6BEA91CB0AE942579D8124FCB,16071,13,15,2,3,3,153
67690,67690,B24DFEF6BEA91CB0AE942579D8124FCB,10971,19,23,4,35,47,1797
67694,67694,3B86E1CB99F9A063FEA255A004EE193F,11261,0,20,20,36,46,1846
67695,67695,3B86E1CB99F9A063FEA255A004EE193F,12311,20,21,1,30,44,1544
67696,67696,3B86E1CB99F9A063FEA255A004EE193F,11261,22,23,1,36,46,1846
67697,67697,A1A4DD7E55DDB13F494E46C7D5A04665,43761,0,9,9,32,47,1647
67698,67698,A1A4DD7E55DDB13F494E46C7D5A04665,11914,12,14,2,37,48,1898
67699,67699,A1A4DD7E55DDB13F494E46C7D5A04665,43761,15,23,8,32,47,1647
67700,67700,C021E76648D87720801E48AF87CED835,11954,0,10,10,32,49,1649
67701,67701,C021E76648D87720801E48AF87CED835,42041,15,18,3,10,47,547
67702,67702,C021E76648D87720801E48AF87CED835,19024,21,23,2,9,45,495
67710,67710,8436FA510D59B3814E50B7F18BD1D92C,43644,0,6,6,14,38,738
67711,67711,8436FA510D59B3814E50B7F18BD1D92C,12641,6,18,12,10,43,543
67712,67712,8436FA510D59B3814E50B7F18BD1D92C,43644,20,22,2,14,38,738
67733,67733,BC5F5A048F874E8EDED6AF765E340D8C,11914,1,11,10,37,48,1898
67734,67734,BC5F5A048F874E8EDED6AF765E340D8C,42581,11,12,1,38,48,1948
67735,67735,BC5F5A048F874E8EDED6AF765E340D8C,11914,13,18,5,37,48,1898
67736,67736,BC5F5A048F874E8EDED6AF765E340D8C,42581,18,20,2,38,48,1948
67737,67737,BC5F5A048F874E8EDED6AF765E340D8C,11914,20,22,2,37,48,1898
67738,67738,8020D6CD5B4750BEB7E6488AFAD27C6F,13511,0,8,8,34,48,1748
67739,67739,8020D6CD5B4750BEB7E6488AFAD27C6F,11541,9,11,2,35,49,1799
67740,67740,8020D6CD5B4750BEB7E6488AFAD27C6F,42081,12,13,1,24,49,1249
67741,67741,8020D6CD5B4750BEB7E6488AFAD27C6F,13511,15,23,8,34,48,1748
67742,67742,1C0548F40841AD0870DAD8EC7BECCBC6,13314,0,7,7,31,39,1589
67743,67743,1C0548F40841AD0870DAD8EC7BECCBC6,12521,8,11,3,35,41,1791
67744,67744,1C0548F40841AD0870DAD8EC7BECCBC6,13314,11,13,2,31,39,1589
67745,67745,1C0548F40841AD0870DAD8EC7BECCBC6,12521,14,16,2,35,41,1791
67746,67746,1C0548F40841AD0870DAD8EC7BECCBC6,13314,18,23,5,31,39,1589
67747,67747,26B9AAC369331C3B7CCBFCA623526739,13231,0,2,2,39,46,1996
67748,67748,26B9AAC369331C3B7CCBFCA623526739,43011,5,6,1,40,42,2042
67749,67749,26B9AAC369331C3B7CCBFCA623526739,13461,6,13,7,39,44,1994
67750,67750,26B9AAC369331C3B7CCBFCA623526739,10811,14,22,8,38,46,1946
67751,67751,E648A6F090A3BE85617E0ED54A73B4F0,12601,0,3,3,25,47,1297
67752,67752,E648A6F090A3BE85617E0ED54A73B4F0,12671,3,10,7,21,43,1093
67753,67753,E648A6F090A3BE85617E0ED54A73B4F0,13771,11,13,2,21,45,1095
67754,67754,E648A6F090A3BE85617E0ED54A73B4F0,12671,13,14,1,21,43,1093
67755,67755,E648A6F090A3BE85617E0ED54A73B4F0,13091,15,16,1,20,42,1042
67756,67756,E648A6F090A3BE85617E0ED54A73B4F0,12601,17,23,6,25,47,1297
67757,67757,4D0ED6C01EC55D2BA8CCC5E44CD25B70,13121,3,4,1,38,46,1946
67758,67758,4D0ED6C01EC55D2BA8CCC5E44CD25B70,11941,4,7,3,37,46,1896
67759,67759,4D0ED6C01EC55D2BA8CCC5E44CD25B70,12381,7,19,12,32,48,1648
67760,67760,848A877E923FAE990F640409C3D68042,11861,0,9,9,32,47,1647
67761,67761,848A877E923FAE990F640409C3D68042,43621,11,12,1,46,48,2348
67762,67762,848A877E923FAE990F640409C3D68042,10661,12,15,3,37,49,1899
67763,67763,848A877E923FAE990F640409C3D68042,11861,17,21,4,32,47,1647
67768,67768,E7330DDF6C8CCBEBED87B3FE6F5940D2,42041,10,11,1,10,47,547
67769,67769,E7330DDF6C8CCBEBED87B3FE6F5940D2,19114,12,20,8,7,43,393
67770,67770,E7330DDF6C8CCBEBED87B3FE6F5940D2,19441,20,21,1,8,46,446
67771,67771,F870A9773CDBF996E3E853E2572A7188,11231,0,1,1,37,49,1899
67772,67772,F870A9773CDBF996E3E853E2572A7188,42961,2,4,2,35,49,1799
67773,67773,F870A9773CDBF996E3E853E2572A7188,12083,5,6,1,36,49,1849
67774,67774,F870A9773CDBF996E3E853E2572A7188,42961,6,9,3,35,49,1799
67775,67775,F870A9773CDBF996E3E853E2572A7188,10901,21,22,1,35,48,1798
67779,67779,2F66AC01887397A198C9CCA6611EA97B,12521,0,6,6,35,41,1791
67780,67780,2F66AC01887397A198C9CCA6611EA97B,13314,7,17,10,31,39,1589
67781,67781,2F66AC01887397A198C9CCA6611EA97B,12521,19,23,4,35,41,1791
67782,67782,9C686B624E1F19B96755FA9920EEF4B6,42921,1,7,6,33,47,1697
67783,67783,9C686B624E1F19B96755FA9920EEF4B6,13601,14,15,1,34,47,1747
67784,67784,9C686B624E1F19B96755FA9920EEF4B6,42921,18,19,1,33,47,1697
67785,67785,9C686B624E1F19B96755FA9920EEF4B6,11781,21,23,2,38,49,1949
67794,67794,9442AAEA05C831A2075E8352FC15EF6E,43361,0,10,10,38,48,1948
67795,67795,9442AAEA05C831A2075E8352FC15EF6E,10351,11,18,7,28,45,1445
67796,67796,9442AAEA05C831A2075E8352FC15EF6E,11875,20,21,1,30,46,1546
67797,67797,9442AAEA05C831A2075E8352FC15EF6E,10221,21,22,1,34,49,1749
67798,67798,B36689DDA21B95DB81960B9F94D43A75,13271,0,8,8,41,47,2097
67799,67799,B36689DDA21B95DB81960B9F94D43A75,10107,9,10,1,38,49,1949
67800,67800,B36689DDA21B95DB81960B9F94D43A75,13271,12,15,3,41,47,2097
67801,67801,B36689DDA21B95DB81960B9F94D43A75,40341,17,18,1,23,49,1199
67802,67802,B36689DDA21B95DB81960B9F94D43A75,13271,22,23,1,41,47,2097
67803,67803,60DB2F1E5C63BE640D47B87EE3CFB05B,42461,0,6,6,45,47,2297
67804,67804,60DB2F1E5C63BE640D47B87EE3CFB05B,42321,6,7,1,43,47,2197
67805,67805,60DB2F1E5C63BE640D47B87EE3CFB05B,42461,8,9,1,45,47,2297
67806,67806,60DB2F1E5C63BE640D47B87EE3CFB05B,42321,11,19,8,43,47,2197
67807,67807,60DB2F1E5C63BE640D47B87EE3CFB05B,42461,19,23,4,45,47,2297
67808,67808,9BBBC00C93BA6A3176E2B008E6F8A88E,13911,1,3,2,39,46,1996
67809,67809,9BBBC00C93BA6A3176E2B008E6F8A88E,11261,5,11,6,36,46,1846
67810,67810,9BBBC00C93BA6A3176E2B008E6F8A88E,13911,11,13,2,39,46,1996
67811,67811,9BBBC00C93BA6A3176E2B008E6F8A88E,11261,13,18,5,36,46,1846
67812,67812,9BBBC00C93BA6A3176E2B008E6F8A88E,13911,19,22,3,39,46,1996
67816,67816,9C638407CFA3114C707D1E9F8E4232DD,11541,0,8,8,35,49,1799
67817,67817,9C638407CFA3114C707D1E9F8E4232DD,40341,12,19,7,23,49,1199
67818,67818,9C638407CFA3114C707D1E9F8E4232DD,11541,20,23,3,35,49,1799
67822,67822,A336F8D086418A70D6F2B0EA33768B6C,10811,0,13,13,38,46,1946
67823,67823,A336F8D086418A70D6F2B0EA33768B6C,19621,16,18,2,5,46,296
67824,67824,A336F8D086418A70D6F2B0EA33768B6C,11531,18,19,1,34,49,1749
67825,67825,A336F8D086418A70D6F2B0EA33768B6C,10811,22,23,1,38,46,1946
67829,67829,4AE93F20F703B65B87F8746D93A2B5AE,43061,0,15,15,43,46,2196
67830,67830,4AE93F20F703B65B87F8746D93A2B5AE,12521,18,21,3,35,41,1791
67831,67831,4AE93F20F703B65B87F8746D93A2B5AE,43061,22,23,1,43,46,2196
67838,67838,98EE631F21B5B96C89767B999F280C46,19621,0,15,15,5,46,296
67839,67839,98EE631F21B5B96C89767B999F280C46,10401,18,21,3,33,49,1699
67840,67840,98EE631F21B5B96C89767B999F280C46,19621,22,23,1,5,46,296
67841,67841,5DC656AE1F755A21D4CE0049D29039D4,12491,0,1,1,36,43,1843
67842,67842,5DC656AE1F755A21D4CE0049D29039D4,12521,2,3,1,35,41,1791
67843,67843,5DC656AE1F755A21D4CE0049D29039D4,12491,5,10,5,36,43,1843
67844,67844,5DC656AE1F755A21D4CE0049D29039D4,43451,11,12,1,37,40,1890
67845,67845,5DC656AE1F755A21D4CE0049D29039D4,12491,12,13,1,36,43,1843
67846,67846,5DC656AE1F755A21D4CE0049D29039D4,11261,16,19,3,36,46,1846
67847,67847,5DC656AE1F755A21D4CE0049D29039D4,12491,19,20,1,36,43,1843
67851,67851,A79534BBCA0DDDDF6D160742220606F4,43051,0,3,3,46,45,2345
67852,67852,A79534BBCA0DDDDF6D160742220606F4,43951,6,9,3,49,41,2491
67853,67853,A79534BBCA0DDDDF6D160742220606F4,43051,13,23,10,46,45,2345
67857,67857,649CA0B4C9C73F10630BCAC6C100E533,42151,1,3,2,35,45,1795
67858,67858,649CA0B4C9C73F10630BCAC6C100E533,42371,4,5,1,34,46,1746
67859,67859,649CA0B4C9C73F10630BCAC6C100E533,12311,6,7,1,30,44,1544
67860,67860,649CA0B4C9C73F10630BCAC6C100E533,42151,10,21,11,35,45,1795
67861,67861,76DA946F4DC1318DD46A32E1D303D6B7,12521,0,14,14,35,41,1791
67862,67862,76DA946F4DC1318DD46A32E1D303D6B7,13314,16,17,1,31,39,1589
67863,67863,76DA946F4DC1318DD46A32E1D303D6B7,12521,17,23,6,35,41,1791
67881,67881,36F39935AFA02A62793DAB143061180F,10471,0,6,6,37,48,1898
67882,67882,36F39935AFA02A62793DAB143061180F,11231,6,8,2,37,49,1899
67883,67883,36F39935AFA02A62793DAB143061180F,40833,9,10,1,41,47,2097
67884,67884,36F39935AFA02A62793DAB143061180F,11231,13,14,1,37,49,1899
67885,67885,36F39935AFA02A62793DAB143061180F,13941,16,19,3,41,47,2097
67886,67886,36F39935AFA02A62793DAB143061180F,13911,20,22,2,39,46,1996
67887,67887,DE69FEBC50432F9871EF62D07F7A5C1A,19181,0,5,5,8,40,440
67888,67888,DE69FEBC50432F9871EF62D07F7A5C1A,43644,7,8,1,14,38,738
67889,67889,DE69FEBC50432F9871EF62D07F7A5C1A,19181,8,21,13,8,40,440
67893,67893,FF16D1104349162E539969031BE39A02,43481,1,7,6,39,48,1998
67894,67894,FF16D1104349162E539969031BE39A02,12511,9,12,3,39,47,1997
67895,67895,FF16D1104349162E539969031BE39A02,43481,12,14,2,39,48,1998
67896,67896,FF16D1104349162E539969031BE39A02,12511,14,15,1,39,47,1997
67897,67897,FF16D1104349162E539969031BE39A02,12514,17,18,1,38,47,1947
67898,67898,FF16D1104349162E539969031BE39A02,43481,20,21,1,39,48,1998
67899,67899,68D66AC2F31097852E1113FCAC38B096,12311,0,4,4,30,44,1544
67900,67900,68D66AC2F31097852E1113FCAC38B096,42531,7,11,4,31,45,1595
67901,67901,68D66AC2F31097852E1113FCAC38B096,12311,11,16,5,30,44,1544
67902,67902,68D66AC2F31097852E1113FCAC38B096,42531,17,18,1,31,45,1595
67903,67903,68D66AC2F31097852E1113FCAC38B096,12311,22,23,1,30,44,1544
67904,67904,EAAC45FB100EE8A458EC0FF985DACA2D,11751,0,6,6,35,48,1798
67905,67905,EAAC45FB100EE8A458EC0FF985DACA2D,12391,10,14,4,36,49,1849
67906,67906,EAAC45FB100EE8A458EC0FF985DACA2D,11271,14,17,3,37,48,1898
67907,67907,EAAC45FB100EE8A458EC0FF985DACA2D,12391,18,20,2,36,49,1849
67908,67908,EAAC45FB100EE8A458EC0FF985DACA2D,11751,21,23,2,35,48,1798
67913,67913,EB4A9C7818DC6FC2815CEF12E693A5CC,10716,0,11,11,30,46,1546
67914,67914,EB4A9C7818DC6FC2815CEF12E693A5CC,40341,12,15,3,23,49,1199
67915,67915,EB4A9C7818DC6FC2815CEF12E693A5CC,11151,16,18,2,30,48,1548
67919,67919,AE9DABC8C76DE8782FA56379E8CBF939,43501,0,9,9,27,48,1398
67920,67920,AE9DABC8C76DE8782FA56379E8CBF939,12971,10,11,1,32,48,1648
67921,67921,AE9DABC8C76DE8782FA56379E8CBF939,43501,13,20,7,27,48,1398
67922,67922,892D738384FB85CFDFBBF1F6536B279E,11061,10,17,7,29,48,1498
67923,67923,892D738384FB85CFDFBBF1F6536B279E,11151,17,18,1,30,48,1548
67924,67924,892D738384FB85CFDFBBF1F6536B279E,11751,20,23,3,35,48,1798
67936,67936,0C2847EFE5F93E92ACEB4EA16E4104D9,40925,0,2,2,35,49,1799
67937,67937,0C2847EFE5F93E92ACEB4EA16E4104D9,13411,11,13,2,49,42,2492
67938,67938,0C2847EFE5F93E92ACEB4EA16E4104D9,43951,15,17,2,49,41,2491
67939,67939,0C2847EFE5F93E92ACEB4EA16E4104D9,13411,19,22,3,49,42,2492
67940,67940,6A457FC295BEABB4E7455CBB04B50835,43021,5,7,2,16,43,843
67941,67941,6A457FC295BEABB4E7455CBB04B50835,12921,10,11,1,9,41,491
67942,67942,6A457FC295BEABB4E7455CBB04B50835,43021,15,16,1,16,43,843
67943,67943,6A457FC295BEABB4E7455CBB04B50835,12921,18,19,1,9,41,491
67944,67944,8827A35309A216F0F6E4CBB2FFAC456D,11954,0,13,13,32,49,1649
67945,67945,8827A35309A216F0F6E4CBB2FFAC456D,11701,14,16,2,43,48,2198
67946,67946,8827A35309A216F0F6E4CBB2FFAC456D,11201,19,21,2,35,49,1799
67950,67950,EC62AA7CA7274F1E17A2CBCF519E3FFB,43761,0,9,9,32,47,1647
67951,67951,EC62AA7CA7274F1E17A2CBCF519E3FFB,40341,13,16,3,23,49,1199
67952,67952,EC62AA7CA7274F1E17A2CBCF519E3FFB,43761,17,21,4,32,47,1647
67953,67953,EC62AA7CA7274F1E17A2CBCF519E3FFB,12161,22,23,1,32,46,1646
67954,67954,16A0589A145EA4C47047324378E38CE2,42631,0,6,6,43,45,2195
67955,67955,16A0589A145EA4C47047324378E38CE2,11753,7,9,2,35,48,1798
67956,67956,16A0589A145EA4C47047324378E38CE2,42633,13,21,8,42,46,2146
67957,67957,B65986D45181EA9BD7712A84F575953B,15351,0,2,2,24,22,1222
67958,67958,B65986D45181EA9BD7712A84F575953B,19071,3,4,1,7,29,379
67959,67959,B65986D45181EA9BD7712A84F575953B,15121,7,9,2,27,19,1369
67960,67960,B65986D45181EA9BD7712A84F575953B,19051,12,13,1,16,23,823
67961,67961,B65986D45181EA9BD7712A84F575953B,15121,15,18,3,27,19,1369
67962,67962,B65986D45181EA9BD7712A84F575953B,19071,19,20,1,7,29,379
67970,67970,32135C530A7BC386A060ACB64AF96B4A,19244,0,1,1,1,43,93
67971,67971,32135C530A7BC386A060ACB64AF96B4A,19031,2,3,1,1,42,92
67972,67972,32135C530A7BC386A060ACB64AF96B4A,12641,7,8,1,10,43,543
67973,67973,32135C530A7BC386A060ACB64AF96B4A,19031,11,12,1,1,42,92
67974,67974,32135C530A7BC386A060ACB64AF96B4A,19244,13,15,2,1,43,93
67975,67975,32135C530A7BC386A060ACB64AF96B4A,19031,16,22,6,1,42,92
67976,67976,D1D4F1B4017FEA89A042CB8ED8E15110,42081,0,14,14,24,49,1249
67977,67977,D1D4F1B4017FEA89A042CB8ED8E15110,41591,16,18,2,34,49,1749
67978,67978,D1D4F1B4017FEA89A042CB8ED8E15110,40343,21,23,2,24,49,1249
67982,67982,1A781977FAF109F9FB129E523F36ACF2,13671,1,5,4,27,43,1393
67983,67983,1A781977FAF109F9FB129E523F36ACF2,10301,10,11,1,31,45,1595
67984,67984,1A781977FAF109F9FB129E523F36ACF2,13671,12,23,11,27,43,1393
67988,67988,30EE4ED515D97FFC1B2D380D08A1F01B,11074,0,8,8,37,47,1897
67989,67989,30EE4ED515D97FFC1B2D380D08A1F01B,41591,12,13,1,34,49,1749
67990,67990,30EE4ED515D97FFC1B2D380D08A1F01B,11074,16,18,2,37,47,1897
67991,67991,34CC2E0F290DBAD6162BFABEC143C619,19261,0,8,8,6,37,337
67992,67992,34CC2E0F290DBAD6162BFABEC143C619,43644,9,12,3,14,38,738
67993,67993,34CC2E0F290DBAD6162BFABEC143C619,19264,13,14,1,10,36,536
67994,67994,34CC2E0F290DBAD6162BFABEC143C619,43644,16,17,1,14,38,738
67995,67995,34CC2E0F290DBAD6162BFABEC143C619,19264,21,23,2,10,36,536
67999,67999,8ECC26CF92064D4498527FD180BC1C4B,13101,5,10,5,40,47,2047
68000,68000,8ECC26CF92064D4498527FD180BC1C4B,42381,13,14,1,39,41,1991
68001,68001,8ECC26CF92064D4498527FD180BC1C4B,10421,16,19,3,41,48,2098
68002,68002,8ECC26CF92064D4498527FD180BC1C4B,42271,19,20,1,40,47,2047
68003,68003,FCA3C665B5BF337F331669EDB597A6AC,42791,2,7,5,35,45,1795
68004,68004,FCA3C665B5BF337F331669EDB597A6AC,10271,8,10,2,37,46,1896
68005,68005,FCA3C665B5BF337F331669EDB597A6AC,13121,11,18,7,38,46,1946
68006,68006,FCA3C665B5BF337F331669EDB597A6AC,42801,21,23,2,40,49,2049
68014,68014,AC9A35D001464E087369411DD671E08D,42301,0,6,6,36,47,1847
68015,68015,AC9A35D001464E087369411DD671E08D,12521,7,11,4,35,41,1791
68016,68016,AC9A35D001464E087369411DD671E08D,43361,12,23,11,38,48,1948
68017,68017,117923098B279F74D27191BEAC2A99A8,42071,4,13,9,31,49,1599
68018,68018,117923098B279F74D27191BEAC2A99A8,42623,13,15,2,22,49,1149
68019,68019,117923098B279F74D27191BEAC2A99A8,11151,19,20,1,30,48,1548
68020,68020,319D2ABA8E3446CCA76186E69AB55EFF,42623,9,11,2,22,49,1149
68021,68021,319D2ABA8E3446CCA76186E69AB55EFF,40341,12,13,1,23,49,1199
68022,68022,319D2ABA8E3446CCA76186E69AB55EFF,42071,18,19,1,31,49,1599
68023,68023,319D2ABA8E3446CCA76186E69AB55EFF,11151,20,21,1,30,48,1548
68036,68036,673C7752ED9E3B3369D8D81C56DEA1B1,11151,3,5,2,30,48,1548
68037,68037,673C7752ED9E3B3369D8D81C56DEA1B1,13371,7,20,13,41,47,2097
68038,68038,673C7752ED9E3B3369D8D81C56DEA1B1,11091,21,23,2,29,47,1497
68042,68042,08B22EEE6E957330DAD27E7217103ACF,43011,1,5,4,40,42,2042
68043,68043,08B22EEE6E957330DAD27E7217103ACF,42221,7,19,12,38,48,1948
68044,68044,08B22EEE6E957330DAD27E7217103ACF,11914,21,22,1,37,48,1898
68045,68045,F2E0A788EC41736380A7AB3495E7AB34,42161,0,6,6,36,47,1847
68046,68046,F2E0A788EC41736380A7AB3495E7AB34,12051,7,9,2,20,47,1047
68047,68047,F2E0A788EC41736380A7AB3495E7AB34,42681,14,16,2,24,48,1248
68048,68048,F2E0A788EC41736380A7AB3495E7AB34,42161,19,23,4,36,47,1847
68059,68059,6902B095816DEE42BB8BCB5226AA6999,10381,0,13,13,31,49,1599
68060,68060,6902B095816DEE42BB8BCB5226AA6999,11781,14,16,2,38,49,1949
68061,68061,6902B095816DEE42BB8BCB5226AA6999,10381,16,18,2,31,49,1599
68062,68062,6902B095816DEE42BB8BCB5226AA6999,11531,19,20,1,34,49,1749
68066,68066,2770DAF26F856B8C604C0FF1601A7902,12921,5,12,7,9,41,491
68067,68067,2770DAF26F856B8C604C0FF1601A7902,19181,12,13,1,8,40,440
68068,68068,2770DAF26F856B8C604C0FF1601A7902,19031,14,19,5,1,42,92
68069,68069,2770DAF26F856B8C604C0FF1601A7902,19181,21,23,2,8,40,440
68079,68079,94DF6D416CC5B92A0E5062ABBAC5B786,12514,1,2,1,38,47,1947
68080,68080,94DF6D416CC5B92A0E5062ABBAC5B786,11914,3,6,3,37,48,1898
68081,68081,94DF6D416CC5B92A0E5062ABBAC5B786,42071,8,20,12,31,49,1599
68082,68082,94DF6D416CC5B92A0E5062ABBAC5B786,11074,22,23,1,37,47,1897
68083,68083,6D52C793EB371471F35F7C1C2F1CBCD2,40561,0,8,8,32,48,1648
68084,68084,6D52C793EB371471F35F7C1C2F1CBCD2,13121,9,11,2,38,46,1946
68085,68085,6D52C793EB371471F35F7C1C2F1CBCD2,10901,13,14,1,35,48,1798
68086,68086,6D52C793EB371471F35F7C1C2F1CBCD2,12381,16,23,7,32,48,1648
68087,68087,1880F74143F84BFDBE0B70F1D38D5149,43281,0,1,1,37,48,1898
68088,68088,1880F74143F84BFDBE0B70F1D38D5149,11231,2,11,9,37,49,1899
68089,68089,1880F74143F84BFDBE0B70F1D38D5149,11271,13,15,2,37,48,1898
68090,68090,1880F74143F84BFDBE0B70F1D38D5149,12391,17,18,1,36,49,1849
68091,68091,1880F74143F84BFDBE0B70F1D38D5149,11271,21,23,2,37,48,1898
68092,68092,1511CFAF94B568A5555A92AE32FB6139,43181,0,9,9,39,48,1998
68093,68093,1511CFAF94B568A5555A92AE32FB6139,43361,12,14,2,38,48,1948
68094,68094,1511CFAF94B568A5555A92AE32FB6139,11211,21,23,2,34,49,1749
68099,68099,F78EC9DDECA6B3700774788DCB5A4A6B,43581,0,6,6,33,48,1698
68100,68100,F78EC9DDECA6B3700774788DCB5A4A6B,42941,7,17,10,37,47,1897
68101,68101,F78EC9DDECA6B3700774788DCB5A4A6B,43581,21,23,2,33,48,1698
68102,68102,21EB856A09F8676FC9C2284B8E81753B,10951,5,13,8,29,48,1498
68103,68103,21EB856A09F8676FC9C2284B8E81753B,40341,13,16,3,23,49,1199
68104,68104,21EB856A09F8676FC9C2284B8E81753B,11381,18,23,5,30,47,1547
68105,68105,2295C74F0BD2BB081A3FCDFFDED68B9C,12921,3,4,1,9,41,491
68106,68106,2295C74F0BD2BB081A3FCDFFDED68B9C,43644,8,21,13,14,38,738
68107,68107,2295C74F0BD2BB081A3FCDFFDED68B9C,12641,21,22,1,10,43,543
68108,68108,B15DA7AF1D6582603A3FD1BBCB7F011C,42121,0,7,7,26,49,1349
68109,68109,B15DA7AF1D6582603A3FD1BBCB7F011C,10381,8,10,2,31,49,1599
68110,68110,B15DA7AF1D6582603A3FD1BBCB7F011C,43731,14,17,3,34,47,1747
68111,68111,B15DA7AF1D6582603A3FD1BBCB7F011C,42121,20,23,3,26,49,1349
68112,68112,D9992C666E803E8DF2E8B28F916B43DA,13711,0,2,2,38,46,1946
68113,68113,D9992C666E803E8DF2E8B28F916B43DA,42511,2,3,1,37,47,1897
68114,68114,D9992C666E803E8DF2E8B28F916B43DA,40421,3,10,7,37,48,1898
68115,68115,D9992C666E803E8DF2E8B28F916B43DA,12514,10,12,2,38,47,1947
68116,68116,D9992C666E803E8DF2E8B28F916B43DA,10841,12,20,8,37,47,1897
68117,68117,D9992C666E803E8DF2E8B28F916B43DA,11331,20,23,3,37,48,1898
68118,68118,D0670C4E9577EEDCBDDABD4AB09A2868,13561,1,6,5,37,49,1899
68119,68119,D0670C4E9577EEDCBDDABD4AB09A2868,11021,6,7,1,36,49,1849
68120,68120,D0670C4E9577EEDCBDDABD4AB09A2868,11541,10,11,1,35,49,1799
68121,68121,D0670C4E9577EEDCBDDABD4AB09A2868,13561,15,16,1,37,49,1899
68122,68122,D0670C4E9577EEDCBDDABD4AB09A2868,10491,18,22,4,33,48,1698
68123,68123,D6932FB45D03368B8FD3FCD5E6F4054F,11531,0,7,7,34,49,1749
68124,68124,D6932FB45D03368B8FD3FCD5E6F4054F,11021,9,10,1,36,49,1849
68125,68125,D6932FB45D03368B8FD3FCD5E6F4054F,11201,11,15,4,35,49,1799
68126,68126,D6932FB45D03368B8FD3FCD5E6F4054F,13561,15,16,1,37,49,1899
68127,68127,D6932FB45D03368B8FD3FCD5E6F4054F,11381,18,21,3,30,47,1547
68128,68128,50CCE154C32A1BD191B98F8DDB956DFF,19051,1,3,2,16,23,823
68129,68129,50CCE154C32A1BD191B98F8DDB956DFF,19801,6,7,1,19,26,976
68130,68130,50CCE154C32A1BD191B98F8DDB956DFF,19051,12,22,10,16,23,823
68137,68137,E3F6BEAC53881C33A9632EFCBC166461,13511,0,9,9,34,48,1748
68138,68138,E3F6BEAC53881C33A9632EFCBC166461,43671,11,14,3,35,48,1798
68139,68139,E3F6BEAC53881C33A9632EFCBC166461,11801,16,17,1,42,48,2148
68140,68140,E3F6BEAC53881C33A9632EFCBC166461,43181,18,20,2,39,48,1998
68145,68145,E3A7AEE39E50249865D28AC81FC6A175,11021,9,18,9,36,49,1849
68146,68146,E3A7AEE39E50249865D28AC81FC6A175,13121,19,21,2,38,46,1946
68147,68147,E3A7AEE39E50249865D28AC81FC6A175,11021,21,23,2,36,49,1849
68148,68148,B4412E0203CA22F7718C6124EFEAC727,10271,3,9,6,37,46,1896
68149,68149,B4412E0203CA22F7718C6124EFEAC727,12511,10,12,2,39,47,1997
68150,68150,B4412E0203CA22F7718C6124EFEAC727,12514,13,16,3,38,47,1947
68151,68151,B4412E0203CA22F7718C6124EFEAC727,11074,17,18,1,37,47,1897
68152,68152,B4412E0203CA22F7718C6124EFEAC727,40123,18,23,5,38,47,1947
68153,68153,8A6C506FC93EDC7EFD230CEBD87531C3,19901,0,2,2,7,44,394
68154,68154,8A6C506FC93EDC7EFD230CEBD87531C3,19741,5,7,2,5,44,294
68155,68155,8A6C506FC93EDC7EFD230CEBD87531C3,19114,7,8,1,7,43,393
68156,68156,8A6C506FC93EDC7EFD230CEBD87531C3,19741,9,10,1,5,44,294
68157,68157,8A6C506FC93EDC7EFD230CEBD87531C3,12921,13,17,4,9,41,491
68158,68158,8A6C506FC93EDC7EFD230CEBD87531C3,19244,18,23,5,1,43,93
68159,68159,F107A92BB1866B207FD71FC38586806E,11361,0,1,1,22,48,1148
68160,68160,F107A92BB1866B207FD71FC38586806E,42541,4,10,6,25,47,1297
68161,68161,F107A92BB1866B207FD71FC38586806E,10107,14,16,2,38,49,1949
68162,68162,F107A92BB1866B207FD71FC38586806E,40951,18,20,2,36,49,1849
68163,68163,BA37435DC45EBEEC65A73010B846F113,43761,0,1,1,32,47,1647
68164,68164,BA37435DC45EBEEC65A73010B846F113,43311,1,12,11,31,48,1598
68165,68165,BA37435DC45EBEEC65A73010B846F113,43761,13,14,1,32,47,1647
68166,68166,BA37435DC45EBEEC65A73010B846F113,11161,15,18,3,32,48,1648
68167,68167,BA37435DC45EBEEC65A73010B846F113,11541,20,21,1,35,49,1799
68168,68168,499426AABDFB3A48AD7C69EA8E2B51C2,19621,0,13,13,5,46,296
68169,68169,499426AABDFB3A48AD7C69EA8E2B51C2,42623,14,15,1,22,49,1149
68170,68170,499426AABDFB3A48AD7C69EA8E2B51C2,10107,15,17,2,38,49,1949
68171,68171,499426AABDFB3A48AD7C69EA8E2B51C2,41591,17,19,2,34,49,1749
68172,68172,499426AABDFB3A48AD7C69EA8E2B51C2,19621,21,23,2,5,46,296
68173,68173,EB7EB6074C1F2A07A41462E31EDA6629,42161,0,7,7,36,47,1847
68174,68174,EB7EB6074C1F2A07A41462E31EDA6629,10111,7,9,2,37,47,1897
68175,68175,EB7EB6074C1F2A07A41462E31EDA6629,42161,11,16,5,36,47,1847
68176,68176,EB7EB6074C1F2A07A41462E31EDA6629,12971,18,20,2,32,48,1648
68177,68177,EB7EB6074C1F2A07A41462E31EDA6629,42401,21,23,2,36,47,1847
68182,68182,C4FB796AE5B06BCB7AD90F4C2938C172,19356,0,8,8,7,19,369
68183,68183,C4FB796AE5B06BCB7AD90F4C2938C172,16233,8,11,3,5,15,265
68184,68184,C4FB796AE5B06BCB7AD90F4C2938C172,19356,12,17,5,7,19,369
68185,68185,C4FB796AE5B06BCB7AD90F4C2938C172,19841,18,23,5,4,22,222
68186,68186,E572D34D15CCFF06895D9E2C410E6273,12381,0,7,7,32,48,1648
68187,68187,E572D34D15CCFF06895D9E2C410E6273,42151,10,18,8,35,45,1795
68188,68188,E572D34D15CCFF06895D9E2C410E6273,10491,19,22,3,33,48,1698
68189,68189,E572D34D15CCFF06895D9E2C410E6273,12381,22,23,1,32,48,1648
68190,68190,433A8296FD808A23A2F68CFBFC543D3C,11531,0,9,9,34,49,1749
68191,68191,433A8296FD808A23A2F68CFBFC543D3C,40341,12,14,2,23,49,1199
68192,68192,433A8296FD808A23A2F68CFBFC543D3C,11531,16,23,7,34,49,1749
68193,68193,9B080BD632F80B9D835296E651FE0CBE,10111,0,11,11,37,47,1897
68194,68194,9B080BD632F80B9D835296E651FE0CBE,16071,12,21,9,3,3,153
68195,68195,9B080BD632F80B9D835296E651FE0CBE,16011,22,23,1,3,4,154
68196,68196,4EABE655BE26B3EDCCD7B6B2C89F187F,10161,0,11,11,35,49,1799
68197,68197,4EABE655BE26B3EDCCD7B6B2C89F187F,43041,14,15,1,41,46,2096
68198,68198,4EABE655BE26B3EDCCD7B6B2C89F187F,10841,18,20,2,37,47,1897
68205,68205,267A36CBF6FADE60E151261B3CF154A0,13711,0,1,1,38,46,1946
68206,68206,267A36CBF6FADE60E151261B3CF154A0,10411,2,14,12,36,48,1848
68207,68207,267A36CBF6FADE60E151261B3CF154A0,11271,14,17,3,37,48,1898
68208,68208,267A36CBF6FADE60E151261B3CF154A0,12083,20,23,3,36,49,1849
68217,68217,F6C52E9A95BBF21409A2176F78573BF3,42071,6,7,1,31,49,1599
68218,68218,F6C52E9A95BBF21409A2176F78573BF3,42261,10,14,4,25,49,1299
68219,68219,F6C52E9A95BBF21409A2176F78573BF3,11541,17,19,2,35,49,1799
68224,68224,EDBE9058BB0B28E0915A84395E9226D9,42861,7,8,1,37,44,1894
68225,68225,EDBE9058BB0B28E0915A84395E9226D9,11261,10,12,2,36,46,1846
68226,68226,EDBE9058BB0B28E0915A84395E9226D9,42861,14,16,2,37,44,1894
68227,68227,EDBE9058BB0B28E0915A84395E9226D9,11261,17,18,1,36,46,1846
68228,68228,EDBE9058BB0B28E0915A84395E9226D9,42861,19,21,2,37,44,1894
68238,68238,975688BDD7D3B41B53C460B57B5AC58A,43751,0,5,5,19,48,998
68239,68239,975688BDD7D3B41B53C460B57B5AC58A,42681,9,13,4,24,48,1248
68240,68240,975688BDD7D3B41B53C460B57B5AC58A,43751,14,18,4,19,48,998
68241,68241,975688BDD7D3B41B53C460B57B5AC58A,42691,22,23,1,24,48,1248
68242,68242,946767D262A9BE6D511524A0FF18D936,11841,0,8,8,33,46,1696
68243,68243,946767D262A9BE6D511524A0FF18D936,10151,10,15,5,34,47,1747
68244,68244,946767D262A9BE6D511524A0FF18D936,40951,18,19,1,36,49,1849
68245,68245,946767D262A9BE6D511524A0FF18D936,10151,22,23,1,34,47,1747
68249,68249,01CEC16F882EBE0260B8567F6A4388D2,43041,2,10,8,41,46,2096
68250,68250,01CEC16F882EBE0260B8567F6A4388D2,42971,13,16,3,43,49,2199
68251,68251,01CEC16F882EBE0260B8567F6A4388D2,13911,20,22,2,39,46,1996
68255,68255,6F7C6FCFD5043C0C2B8E10FFFF215E35,10531,0,9,9,34,46,1746
68256,68256,6F7C6FCFD5043C0C2B8E10FFFF215E35,11841,17,18,1,33,46,1696
68257,68257,6F7C6FCFD5043C0C2B8E10FFFF215E35,19111,18,20,2,9,45,495
68258,68258,6F7C6FCFD5043C0C2B8E10FFFF215E35,11841,20,23,3,33,46,1696
68259,68259,4E8CF0BE1A57E085938ED2B5916A9E34,11381,0,13,13,30,47,1547
68260,68260,4E8CF0BE1A57E085938ED2B5916A9E34,12601,14,17,3,25,47,1297
68261,68261,4E8CF0BE1A57E085938ED2B5916A9E34,11061,17,18,1,29,48,1498
68262,68262,4E8CF0BE1A57E085938ED2B5916A9E34,11381,21,23,2,30,47,1547
68269,68269,586D3412322F83F403EF1DE57025AE48,10634,0,1,1,27,45,1395
68270,68270,586D3412322F83F403EF1DE57025AE48,11875,2,3,1,30,46,1546
68271,68271,586D3412322F83F403EF1DE57025AE48,10634,4,5,1,27,45,1395
68272,68272,586D3412322F83F403EF1DE57025AE48,12311,9,10,1,30,44,1544
68273,68273,586D3412322F83F403EF1DE57025AE48,42491,12,13,1,32,46,1646
68274,68274,586D3412322F83F403EF1DE57025AE48,12311,14,15,1,30,44,1544
68275,68275,586D3412322F83F403EF1DE57025AE48,10634,18,19,1,27,45,1395
68276,68276,B4BA824D03B689E71343C29B23089A47,12491,0,5,5,36,43,1843
68277,68277,B4BA824D03B689E71343C29B23089A47,43011,9,10,1,40,42,2042
68278,68278,B4BA824D03B689E71343C29B23089A47,12491,10,12,2,36,43,1843
68279,68279,B4BA824D03B689E71343C29B23089A47,40073,19,20,1,37,48,1898
68283,68283,9D475010C21846A053E7197E570390B8,11151,1,9,8,30,48,1548
68284,68284,9D475010C21846A053E7197E570390B8,43391,10,11,1,29,48,1498
68285,68285,9D475010C21846A053E7197E570390B8,11151,11,18,7,30,48,1548
68286,68286,9D475010C21846A053E7197E570390B8,43391,19,20,1,29,48,1498
68287,68287,9D475010C21846A053E7197E570390B8,11151,22,23,1,30,48,1548
68288,68288,CC63EA7467D4A1FC7EF1BC76C9DAF092,42864,0,5,5,38,44,1944
68289,68289,CC63EA7467D4A1FC7EF1BC76C9DAF092,11261,6,17,11,36,46,1846
68290,68290,CC63EA7467D4A1FC7EF1BC76C9DAF092,12311,20,21,1,30,44,1544
68291,68291,CC63EA7467D4A1FC7EF1BC76C9DAF092,11261,22,23,1,36,46,1846
68292,68292,732CCF1BC496C93C41B70E7FF8357762,10634,0,9,9,27,45,1395
68293,68293,732CCF1BC496C93C41B70E7FF8357762,10351,10,11,1,28,45,1445
68294,68294,732CCF1BC496C93C41B70E7FF8357762,10634,11,20,9,27,45,1395
68295,68295,732CCF1BC496C93C41B70E7FF8357762,12311,21,22,1,30,44,1544
68296,68296,732CCF1BC496C93C41B70E7FF8357762,10634,22,23,1,27,45,1395
68301,68301,7B1A31035ABB5629AB02D0CDEFD9DB7A,13371,0,1,1,41,47,2097
68302,68302,7B1A31035ABB5629AB02D0CDEFD9DB7A,10611,2,8,6,32,48,1648
68303,68303,7B1A31035ABB5629AB02D0CDEFD9DB7A,11261,12,13,1,36,46,1846
68304,68304,7B1A31035ABB5629AB02D0CDEFD9DB7A,11431,13,17,4,29,47,1497
68305,68305,7B1A31035ABB5629AB02D0CDEFD9DB7A,10221,18,19,1,34,49,1749
68306,68306,7B1A31035ABB5629AB02D0CDEFD9DB7A,12121,21,23,2,29,47,1497
68307,68307,D429753EEB35077FBB0F7FD7B24671DA,13071,0,1,1,41,41,2091
68308,68308,D429753EEB35077FBB0F7FD7B24671DA,42381,1,6,5,39,41,1991
68309,68309,D429753EEB35077FBB0F7FD7B24671DA,43451,6,17,11,37,40,1890
68310,68310,D429753EEB35077FBB0F7FD7B24671DA,43011,21,23,2,40,42,2042
68311,68311,FAC926B1FBA72CAA4F88B54F827C065F,40673,0,8,8,36,48,1848
68312,68312,FAC926B1FBA72CAA4F88B54F827C065F,12481,9,10,1,37,49,1899
68313,68313,FAC926B1FBA72CAA4F88B54F827C065F,40691,12,14,2,42,48,2148
68314,68314,FAC926B1FBA72CAA4F88B54F827C065F,11701,15,17,2,43,48,2198
68315,68315,FAC926B1FBA72CAA4F88B54F827C065F,10161,18,20,2,35,49,1799
68316,68316,FAC926B1FBA72CAA4F88B54F827C065F,10411,20,23,3,36,48,1848
68320,68320,9637A49CA49F0EFD37F0D0143383C518,42351,0,2,2,38,45,1945
68321,68321,9637A49CA49F0EFD37F0D0143383C518,42231,2,3,1,37,46,1896
68322,68322,9637A49CA49F0EFD37F0D0143383C518,42351,4,5,1,38,45,1945
68323,68323,9637A49CA49F0EFD37F0D0143383C518,42231,5,21,16,37,46,1896
68324,68324,9637A49CA49F0EFD37F0D0143383C518,13911,21,23,2,39,46,1996
68335,68335,61DE87BB131AFCA2EBC38E2F283C9021,13671,0,10,10,27,43,1393
68336,68336,61DE87BB131AFCA2EBC38E2F283C9021,11834,11,14,3,32,45,1645
68337,68337,61DE87BB131AFCA2EBC38E2F283C9021,13671,14,16,2,27,43,1393
68338,68338,61DE87BB131AFCA2EBC38E2F283C9021,13314,16,18,2,31,39,1589
68339,68339,61DE87BB131AFCA2EBC38E2F283C9021,13671,18,22,4,27,43,1393
68340,68340,09757EDFE7795D1E67DCE5C4439A4727,12521,0,17,17,35,41,1791
68341,68341,09757EDFE7795D1E67DCE5C4439A4727,13314,17,18,1,31,39,1589
68342,68342,09757EDFE7795D1E67DCE5C4439A4727,12521,18,23,5,35,41,1791
68346,68346,179C9FE89AB1A0E7249FE171F554F068,42523,0,9,9,31,47,1597
68347,68347,179C9FE89AB1A0E7249FE171F554F068,11541,10,11,1,35,49,1799
68348,68348,179C9FE89AB1A0E7249FE171F554F068,42523,13,17,4,31,47,1597
68349,68349,179C9FE89AB1A0E7249FE171F554F068,43761,20,21,1,32,47,1647
68353,68353,CD5F8D7604C7020A19DDE3C48998E9F5,13041,0,1,1,30,37,1537
68354,68354,CD5F8D7604C7020A19DDE3C48998E9F5,13314,2,3,1,31,39,1589
68355,68355,CD5F8D7604C7020A19DDE3C48998E9F5,13311,7,10,3,27,39,1389
68356,68356,CD5F8D7604C7020A19DDE3C48998E9F5,12521,13,18,5,35,41,1791
68357,68357,E2F2F4143F844EB76521711717E3F1F1,43641,0,5,5,16,38,838
68358,68358,E2F2F4143F844EB76521711717E3F1F1,12641,8,10,2,10,43,543
68359,68359,E2F2F4143F844EB76521711717E3F1F1,12921,11,12,1,9,41,491
68360,68360,E2F2F4143F844EB76521711717E3F1F1,19261,13,14,1,6,37,337
68361,68361,E2F2F4143F844EB76521711717E3F1F1,12921,14,15,1,9,41,491
68362,68362,E2F2F4143F844EB76521711717E3F1F1,12641,16,18,2,10,43,543
68363,68363,E2F2F4143F844EB76521711717E3F1F1,19261,22,23,1,6,37,337
68371,68371,1432315E02B72C61B42AD2B5294AED3D,42401,0,8,8,36,47,1847
68372,68372,1432315E02B72C61B42AD2B5294AED3D,10251,8,10,2,35,47,1797
68373,68373,1432315E02B72C61B42AD2B5294AED3D,40411,11,13,2,34,48,1748
68374,68374,1432315E02B72C61B42AD2B5294AED3D,10161,13,15,2,35,49,1799
68375,68375,1432315E02B72C61B42AD2B5294AED3D,43311,18,20,2,31,48,1598
68376,68376,1432315E02B72C61B42AD2B5294AED3D,10251,21,23,2,35,47,1797
68377,68377,29D0A6984D06B1D20AB655BABC09F11F,42071,0,4,4,31,49,1599
68378,68378,29D0A6984D06B1D20AB655BABC09F11F,42081,4,6,2,24,49,1249
68379,68379,29D0A6984D06B1D20AB655BABC09F11F,10107,9,12,3,38,49,1949
68380,68380,29D0A6984D06B1D20AB655BABC09F11F,10381,13,23,10,31,49,1599
68381,68381,22E0CD429C1B1E7AC6170F90C318BE33,13941,0,6,6,41,47,2097
68382,68382,22E0CD429C1B1E7AC6170F90C318BE33,19031,11,13,2,1,42,92
68383,68383,22E0CD429C1B1E7AC6170F90C318BE33,12641,14,19,5,10,43,543
68384,68384,22E0CD429C1B1E7AC6170F90C318BE33,19031,20,22,2,1,42,92
68385,68385,5167DC1F4BFD1A0D0829AB5529153CCE,15561,1,4,3,32,22,1622
68386,68386,5167DC1F4BFD1A0D0829AB5529153CCE,15361,5,10,5,33,25,1675
68387,68387,5167DC1F4BFD1A0D0829AB5529153CCE,12792,11,14,3,34,30,1730
68388,68388,5167DC1F4BFD1A0D0829AB5529153CCE,15361,14,18,4,33,25,1675
68389,68389,5167DC1F4BFD1A0D0829AB5529153CCE,15184,20,21,1,29,22,1472
68390,68390,58FF60972C1637520443DC5766A2AB67,13411,0,5,5,49,42,2492
68391,68391,58FF60972C1637520443DC5766A2AB67,43951,6,9,3,49,41,2491
68392,68392,58FF60972C1637520443DC5766A2AB67,13411,11,13,2,49,42,2492
68393,68393,58FF60972C1637520443DC5766A2AB67,43951,13,18,5,49,41,2491
68394,68394,58FF60972C1637520443DC5766A2AB67,13411,21,23,2,49,42,2492
68395,68395,B3B9E7CAA281FDC11E6B1AB8159D5D86,11941,0,8,8,37,46,1896
68396,68396,B3B9E7CAA281FDC11E6B1AB8159D5D86,43751,13,15,2,19,48,998
68397,68397,B3B9E7CAA281FDC11E6B1AB8159D5D86,12584,15,16,1,24,48,1248
68398,68398,B3B9E7CAA281FDC11E6B1AB8159D5D86,43751,16,19,3,19,48,998
68399,68399,A101AAE3209181ABAB59261AAADF2FAB,12311,0,12,12,30,44,1544
68400,68400,A101AAE3209181ABAB59261AAADF2FAB,12381,13,14,1,32,48,1648
68401,68401,A101AAE3209181ABAB59261AAADF2FAB,12311,17,21,4,30,44,1544
68414,68414,44456DB2F546B5FE9E15EA75927471A8,10351,0,7,7,28,45,1445
68415,68415,44456DB2F546B5FE9E15EA75927471A8,43761,8,13,5,32,47,1647
68416,68416,44456DB2F546B5FE9E15EA75927471A8,42521,15,17,2,31,47,1597
68417,68417,44456DB2F546B5FE9E15EA75927471A8,43761,17,19,2,32,47,1647
68418,68418,44456DB2F546B5FE9E15EA75927471A8,42521,20,21,1,31,47,1597
68422,68422,A573FF285872EC96818445928AD4461A,13671,0,2,2,27,43,1393
68423,68423,A573FF285872EC96818445928AD4461A,13094,3,10,7,21,42,1092
68424,68424,A573FF285872EC96818445928AD4461A,11281,11,12,1,27,40,1390
68425,68425,A573FF285872EC96818445928AD4461A,13671,12,13,1,27,43,1393
68426,68426,A573FF285872EC96818445928AD4461A,11281,18,20,2,27,40,1390
68427,68427,A573FF285872EC96818445928AD4461A,13671,21,23,2,27,43,1393
68428,68428,0BDAF69C7AB80550E0362911AC25E517,19031,2,7,5,1,42,92
68429,68429,0BDAF69C7AB80550E0362911AC25E517,12641,8,9,1,10,43,543
68430,68430,0BDAF69C7AB80550E0362911AC25E517,19031,9,11,2,1,42,92
68431,68431,0BDAF69C7AB80550E0362911AC25E517,12641,13,14,1,10,43,543
68432,68432,0BDAF69C7AB80550E0362911AC25E517,43021,19,20,1,16,43,843
68433,68433,0BDAF69C7AB80550E0362911AC25E517,19021,20,23,3,10,45,545
68440,68440,2FDC946F8B6A51B630A4BECC3A802810,10921,1,11,10,43,48,2198
68441,68441,2FDC946F8B6A51B630A4BECC3A802810,13821,14,16,2,49,45,2495
68442,68442,2FDC946F8B6A51B630A4BECC3A802810,10421,18,21,3,41,48,2098
68443,68443,A0C13743AF441FE8099AA940DA71C612,42581,0,9,9,38,48,1948
68444,68444,A0C13743AF441FE8099AA940DA71C612,11914,10,11,1,37,48,1898
68445,68445,A0C13743AF441FE8099AA940DA71C612,42581,12,17,5,38,48,1948
68446,68446,A0C13743AF441FE8099AA940DA71C612,11914,18,20,2,37,48,1898
68447,68447,A0C13743AF441FE8099AA940DA71C612,12514,21,23,2,38,47,1947
68448,68448,4FA7E2AF35091649A8D61648BF92F5C0,42581,1,7,6,38,48,1948
68449,68449,4FA7E2AF35091649A8D61648BF92F5C0,10471,8,9,1,37,48,1898
68450,68450,4FA7E2AF35091649A8D61648BF92F5C0,42581,11,13,2,38,48,1948
68451,68451,4FA7E2AF35091649A8D61648BF92F5C0,10471,14,18,4,37,48,1898
68452,68452,4FA7E2AF35091649A8D61648BF92F5C0,10381,19,23,4,31,49,1599
68453,68453,D9422BEE211456163267FFC30F57A9AC,11571,1,2,1,13,46,696
68454,68454,D9422BEE211456163267FFC30F57A9AC,19441,7,11,4,8,46,446
68455,68455,D9422BEE211456163267FFC30F57A9AC,11571,13,20,7,13,46,696
68456,68456,99E9F1C00865FC65DCC65581E4C4D733,12521,0,6,6,35,41,1791
68457,68457,99E9F1C00865FC65DCC65581E4C4D733,42151,8,9,1,35,45,1795
68458,68458,99E9F1C00865FC65DCC65581E4C4D733,12521,11,13,2,35,41,1791
68459,68459,99E9F1C00865FC65DCC65581E4C4D733,13041,16,17,1,30,37,1537
68460,68460,99E9F1C00865FC65DCC65581E4C4D733,42151,19,21,2,35,45,1795
68461,68461,99E9F1C00865FC65DCC65581E4C4D733,12521,21,23,2,35,41,1791
68462,68462,5207EE79E9F39513BDDCF0A0815EB507,40171,0,1,1,38,48,1948
68463,68463,5207EE79E9F39513BDDCF0A0815EB507,12514,1,11,10,38,47,1947
68464,68464,5207EE79E9F39513BDDCF0A0815EB507,11331,14,16,2,37,48,1898
68465,68465,5207EE79E9F39513BDDCF0A0815EB507,13681,17,18,1,38,47,1947
68466,68466,5207EE79E9F39513BDDCF0A0815EB507,40171,20,23,3,38,48,1948
68467,68467,802D06E8811CDC65FDAB61E1A1D233B3,10501,0,7,7,22,46,1146
68468,68468,802D06E8811CDC65FDAB61E1A1D233B3,12601,8,9,1,25,47,1297
68469,68469,802D06E8811CDC65FDAB61E1A1D233B3,10491,10,14,4,33,48,1698
68470,68470,802D06E8811CDC65FDAB61E1A1D233B3,11461,16,18,2,37,49,1899
68478,68478,2B393DCEE96CA0B48803BDF9B1BBDE4E,10151,0,8,8,34,47,1747
68479,68479,2B393DCEE96CA0B48803BDF9B1BBDE4E,11481,9,10,1,41,48,2098
68480,68480,2B393DCEE96CA0B48803BDF9B1BBDE4E,13101,12,17,5,40,47,2047
68481,68481,2B393DCEE96CA0B48803BDF9B1BBDE4E,10151,18,23,5,34,47,1747
68485,68485,209CBAFCECFCFAF5ADEC7A13A8F80FC5,12641,1,3,2,10,43,543
68486,68486,209CBAFCECFCFAF5ADEC7A13A8F80FC5,19114,5,6,1,7,43,393
68487,68487,209CBAFCECFCFAF5ADEC7A13A8F80FC5,12921,6,8,2,9,41,491
68488,68488,209CBAFCECFCFAF5ADEC7A13A8F80FC5,19114,13,20,7,7,43,393
68489,68489,209CBAFCECFCFAF5ADEC7A13A8F80FC5,12381,21,23,2,32,48,1648
68503,68503,F2C5EC57808705B9AD12F4B58D41E320,11331,4,7,3,37,48,1898
68504,68504,F2C5EC57808705B9AD12F4B58D41E320,10601,9,13,4,39,47,1997
68505,68505,F2C5EC57808705B9AD12F4B58D41E320,11431,15,19,4,29,47,1497
68506,68506,F2C5EC57808705B9AD12F4B58D41E320,11074,21,22,1,37,47,1897
68516,68516,BE6CE97CF16AAE126E10FC7A027E915F,40171,0,13,13,38,48,1948
68517,68517,BE6CE97CF16AAE126E10FC7A027E915F,40341,15,16,1,23,49,1199
68518,68518,BE6CE97CF16AAE126E10FC7A027E915F,11811,20,23,3,38,49,1949
68519,68519,36B3A59DC3717B6CFE44B02139ABDA9E,10111,0,7,7,37,47,1897
68520,68520,36B3A59DC3717B6CFE44B02139ABDA9E,42301,9,11,2,36,47,1847
68521,68521,36B3A59DC3717B6CFE44B02139ABDA9E,10111,12,16,4,37,47,1897
68522,68522,36B3A59DC3717B6CFE44B02139ABDA9E,42151,16,17,1,35,45,1795
68523,68523,36B3A59DC3717B6CFE44B02139ABDA9E,10111,18,23,5,37,47,1897
68524,68524,FA838B96191C90B328ED11B1AB407A18,12601,9,11,2,25,47,1297
68525,68525,FA838B96191C90B328ED11B1AB407A18,10401,15,17,2,33,49,1699
68526,68526,FA838B96191C90B328ED11B1AB407A18,11211,18,22,4,34,49,1749
68530,68530,C11958CA68DCC24D143388B1E6ECEAA7,11151,0,11,11,30,48,1548
68531,68531,C11958CA68DCC24D143388B1E6ECEAA7,40094,11,12,1,29,48,1498
68532,68532,C11958CA68DCC24D143388B1E6ECEAA7,11151,13,17,4,30,48,1548
68533,68533,C11958CA68DCC24D143388B1E6ECEAA7,11061,17,20,3,29,48,1498
68534,68534,C11958CA68DCC24D143388B1E6ECEAA7,11151,22,23,1,30,48,1548
68550,68550,E610935782979ECFD62FB0099155ECBC,10471,0,2,2,37,48,1898
68551,68551,E610935782979ECFD62FB0099155ECBC,40833,4,10,6,41,47,2097
68552,68552,E610935782979ECFD62FB0099155ECBC,11481,11,12,1,41,48,2098
68553,68553,E610935782979ECFD62FB0099155ECBC,11491,14,16,2,36,47,1847
68554,68554,E610935782979ECFD62FB0099155ECBC,11061,17,19,2,29,48,1498
68555,68555,F7A01C0C2D7C70FD8B57D216EF0464EE,13371,0,9,9,41,47,2097
68556,68556,F7A01C0C2D7C70FD8B57D216EF0464EE,10781,11,13,2,35,47,1797
68557,68557,F7A01C0C2D7C70FD8B57D216EF0464EE,11111,15,16,1,26,48,1348
68558,68558,F7A01C0C2D7C70FD8B57D216EF0464EE,13371,17,23,6,41,47,2097
68559,68559,587AB025BBD9FBC66092AA76B95297E6,10161,0,8,8,35,49,1799
68560,68560,587AB025BBD9FBC66092AA76B95297E6,13041,14,18,4,30,37,1537
68561,68561,587AB025BBD9FBC66092AA76B95297E6,10161,20,23,3,35,49,1799
68562,68562,52A195A8FE89EC70D1A1F00BB9B30229,12641,1,4,3,10,43,543
68563,68563,52A195A8FE89EC70D1A1F00BB9B30229,12921,5,6,1,9,41,491
68564,68564,52A195A8FE89EC70D1A1F00BB9B30229,43021,8,9,1,16,43,843
68565,68565,52A195A8FE89EC70D1A1F00BB9B30229,12921,10,11,1,9,41,491
68566,68566,52A195A8FE89EC70D1A1F00BB9B30229,12641,12,13,1,10,43,543
68567,68567,52A195A8FE89EC70D1A1F00BB9B30229,12921,18,20,2,9,41,491
68568,68568,52A195A8FE89EC70D1A1F00BB9B30229,12641,20,21,1,10,43,543
68575,68575,B57FA6A577B54BB28114ABA28733D834,11061,0,11,11,29,48,1498
68576,68576,B57FA6A577B54BB28114ABA28733D834,11161,13,14,1,32,48,1648
68577,68577,B57FA6A577B54BB28114ABA28733D834,11061,15,16,1,29,48,1498
68578,68578,B57FA6A577B54BB28114ABA28733D834,11381,19,21,2,30,47,1547
68579,68579,B57FA6A577B54BB28114ABA28733D834,11061,21,23,2,29,48,1498
68583,68583,07BDD3FC9C0370EC0810F6F38EA5874D,10381,1,2,1,31,49,1599
68584,68584,07BDD3FC9C0370EC0810F6F38EA5874D,10301,2,3,1,31,45,1595
68585,68585,07BDD3FC9C0370EC0810F6F38EA5874D,12311,12,13,1,30,44,1544
68586,68586,07BDD3FC9C0370EC0810F6F38EA5874D,42871,21,23,2,30,45,1545
68587,68587,6C2244D79333FB126D7C044044FC52BA,12491,0,5,5,36,43,1843
68588,68588,6C2244D79333FB126D7C044044FC52BA,43451,6,10,4,37,40,1890
68589,68589,6C2244D79333FB126D7C044044FC52BA,12491,12,13,1,36,43,1843
68590,68590,6C2244D79333FB126D7C044044FC52BA,43451,14,17,3,37,40,1890
68591,68591,6C2244D79333FB126D7C044044FC52BA,12491,19,23,4,36,43,1843
68592,68592,2B75D649D733D42AAC85CA634BF0D07B,11914,2,3,1,37,48,1898
68593,68593,2B75D649D733D42AAC85CA634BF0D07B,42581,5,6,1,38,48,1948
68594,68594,2B75D649D733D42AAC85CA634BF0D07B,11914,7,15,8,37,48,1898
68595,68595,2B75D649D733D42AAC85CA634BF0D07B,10107,19,21,2,38,49,1949
68596,68596,2B75D649D733D42AAC85CA634BF0D07B,11914,21,23,2,37,48,1898
68597,68597,753369D691B504B9F7186B2CDF290F06,12791,3,4,1,31,29,1579
68598,68598,753369D691B504B9F7186B2CDF290F06,15391,6,7,1,35,26,1776
68599,68599,753369D691B504B9F7186B2CDF290F06,12791,9,10,1,31,29,1579
68600,68600,753369D691B504B9F7186B2CDF290F06,15391,12,23,11,35,26,1776
68607,68607,46CB095EF81B7090747D900A43220105,42071,0,1,1,31,49,1599
68608,68608,46CB095EF81B7090747D900A43220105,42121,3,5,2,26,49,1349
68609,68609,46CB095EF81B7090747D900A43220105,42071,6,8,2,31,49,1599
68610,68610,46CB095EF81B7090747D900A43220105,11021,14,19,5,36,49,1849
68611,68611,46CB095EF81B7090747D900A43220105,42071,21,22,1,31,49,1599
68612,68612,0B8932166F1C0A1A0F3F412DE80013A1,42281,0,7,7,40,48,2048
68613,68613,0B8932166F1C0A1A0F3F412DE80013A1,42221,8,10,2,38,48,1948
68614,68614,0B8932166F1C0A1A0F3F412DE80013A1,13091,14,16,2,20,42,1042
68615,68615,0B8932166F1C0A1A0F3F412DE80013A1,42281,20,22,2,40,48,2048
68623,68623,FACA7C472055342CB52356ECCA18D789,43341,0,7,7,41,46,2096
68624,68624,FACA7C472055342CB52356ECCA18D789,11261,10,11,1,36,46,1846
68625,68625,FACA7C472055342CB52356ECCA18D789,13911,13,15,2,39,46,1996
68626,68626,FACA7C472055342CB52356ECCA18D789,43341,17,23,6,41,46,2096
68630,68630,C4D6D6893D15A40EF6C21B7CBC7CED3E,42021,0,3,3,33,47,1697
68631,68631,C4D6D6893D15A40EF6C21B7CBC7CED3E,11861,3,9,6,32,47,1647
68632,68632,C4D6D6893D15A40EF6C21B7CBC7CED3E,42501,13,15,2,28,47,1447
68633,68633,C4D6D6893D15A40EF6C21B7CBC7CED3E,10292,16,17,1,30,47,1547
68634,68634,C4D6D6893D15A40EF6C21B7CBC7CED3E,10951,19,20,1,29,48,1498
68635,68635,C4D6D6893D15A40EF6C21B7CBC7CED3E,11861,20,22,2,32,47,1647
68639,68639,DD4D28FDBCFFE930AF28BD3956ED9308,11381,0,15,15,30,47,1547
68640,68640,DD4D28FDBCFFE930AF28BD3956ED9308,10271,18,20,2,37,46,1896
68641,68641,DD4D28FDBCFFE930AF28BD3956ED9308,11381,21,23,2,30,47,1547
68651,68651,C2BD63FD363040B37F7F4C9767A45D9C,42031,0,7,7,40,46,2046
68652,68652,C2BD63FD363040B37F7F4C9767A45D9C,12221,11,16,5,43,44,2194
68653,68653,C2BD63FD363040B37F7F4C9767A45D9C,42031,19,23,4,40,46,2046
68654,68654,BC71A128CC1D1FD204F1FA3A371EA53A,43021,0,6,6,16,43,843
68655,68655,BC71A128CC1D1FD204F1FA3A371EA53A,12921,6,11,5,9,41,491
68656,68656,BC71A128CC1D1FD204F1FA3A371EA53A,43021,13,23,10,16,43,843
68663,68663,3F7BC333AFC8445B1A1F538D40A9EDC8,11561,1,8,7,32,49,1649
68664,68664,3F7BC333AFC8445B1A1F538D40A9EDC8,41721,14,15,1,39,48,1998
68665,68665,3F7BC333AFC8445B1A1F538D40A9EDC8,10151,16,18,2,34,47,1747
68666,68666,3F7BC333AFC8445B1A1F538D40A9EDC8,41721,18,23,5,39,48,1998
68667,68667,EBA7165C555CC8E7F5C07D37A066F01A,11481,1,18,17,41,48,2098
68668,68668,EBA7165C555CC8E7F5C07D37A066F01A,11074,19,20,1,37,47,1897
68669,68669,EBA7165C555CC8E7F5C07D37A066F01A,40636,21,22,1,35,48,1798
68670,68670,5AF7A250F769DD424B6F153B49B360AA,10901,0,7,7,35,48,1798
68671,68671,5AF7A250F769DD424B6F153B49B360AA,12051,12,13,1,20,47,1047
68672,68672,5AF7A250F769DD424B6F153B49B360AA,12601,13,14,1,25,47,1297
68673,68673,5AF7A250F769DD424B6F153B49B360AA,10901,17,23,6,35,48,1798
68677,68677,6E4234E109445FFB7193B800D0A5359E,11001,1,5,4,42,47,2147
68678,68678,6E4234E109445FFB7193B800D0A5359E,11021,9,13,4,36,49,1849
68679,68679,6E4234E109445FFB7193B800D0A5359E,13941,13,23,10,41,47,2097
68684,68684,F5CAB8F803ECE6BB91E5E9B3677179B2,11781,0,1,1,38,49,1949
68685,68685,F5CAB8F803ECE6BB91E5E9B3677179B2,42401,1,13,12,36,47,1847
68686,68686,F5CAB8F803ECE6BB91E5E9B3677179B2,13371,14,23,9,41,47,2097
68687,68687,CFF94BDD3912D31FF08169D30B4453C3,11324,0,15,15,31,46,1596
68688,68688,CFF94BDD3912D31FF08169D30B4453C3,40341,18,19,1,23,49,1199
68689,68689,CFF94BDD3912D31FF08169D30B4453C3,11324,19,22,3,31,46,1596
68690,68690,C644771D2D9F4182BC18DB70E907DF2B,42581,2,5,3,38,48,1948
68691,68691,C644771D2D9F4182BC18DB70E907DF2B,11914,6,11,5,37,48,1898
68692,68692,C644771D2D9F4182BC18DB70E907DF2B,42581,12,13,1,38,48,1948
68693,68693,C644771D2D9F4182BC18DB70E907DF2B,10471,15,16,1,37,48,1898
68694,68694,C644771D2D9F4182BC18DB70E907DF2B,42581,18,20,2,38,48,1948
68695,68695,C644771D2D9F4182BC18DB70E907DF2B,11914,20,21,1,37,48,1898
68702,68702,439D8CB010A4086802C0243322BA6C31,11061,0,7,7,29,48,1498
68703,68703,439D8CB010A4086802C0243322BA6C31,40343,9,14,5,24,49,1249
68704,68704,439D8CB010A4086802C0243322BA6C31,11061,17,23,6,29,48,1498
68705,68705,835E4AB3BB8C4699720E70AB108BA996,12491,0,5,5,36,43,1843
68706,68706,835E4AB3BB8C4699720E70AB108BA996,43451,6,8,2,37,40,1890
68707,68707,835E4AB3BB8C4699720E70AB108BA996,12491,11,13,2,36,43,1843
68708,68708,835E4AB3BB8C4699720E70AB108BA996,43451,13,18,5,37,40,1890
68709,68709,835E4AB3BB8C4699720E70AB108BA996,12491,20,23,3,36,43,1843
68713,68713,AEE701715FEFA9408B3EA20922F57230,11731,0,9,9,36,48,1848
68714,68714,AEE701715FEFA9408B3EA20922F57230,10451,12,17,5,25,48,1298
68715,68715,AEE701715FEFA9408B3EA20922F57230,13951,18,20,2,47,45,2395
68716,68716,AEE701715FEFA9408B3EA20922F57230,11731,21,23,2,36,48,1848
68717,68717,E5C724FE755A2BD8CB361D33CC70B058,12651,1,8,7,43,47,2197
68718,68718,E5C724FE755A2BD8CB361D33CC70B058,12021,13,15,2,37,49,1899
68719,68719,E5C724FE755A2BD8CB361D33CC70B058,40341,16,21,5,23,49,1199
68720,68720,E5C724FE755A2BD8CB361D33CC70B058,12651,22,23,1,43,47,2197
68721,68721,FF43CA7C8856E7AF01EE704BBAD84406,13691,7,8,1,47,30,2380
68722,68722,FF43CA7C8856E7AF01EE704BBAD84406,42271,11,14,3,40,47,2047
68723,68723,FF43CA7C8856E7AF01EE704BBAD84406,11551,16,17,1,39,49,1999
68724,68724,FF43CA7C8856E7AF01EE704BBAD84406,11201,21,22,1,35,49,1799
68728,68728,4509CA6F4F6AE506CFF527F6805D5251,19031,2,5,3,1,42,92
68729,68729,4509CA6F4F6AE506CFF527F6805D5251,12641,6,11,5,10,43,543
68730,68730,4509CA6F4F6AE506CFF527F6805D5251,12921,13,15,2,9,41,491
68731,68731,4509CA6F4F6AE506CFF527F6805D5251,12641,18,19,1,10,43,543
68732,68732,4509CA6F4F6AE506CFF527F6805D5251,12921,22,23,1,9,41,491
68733,68733,10A422C047D598ECAC1912DEA262C9AA,42351,1,7,6,38,45,1945
68734,68734,10A422C047D598ECAC1912DEA262C9AA,11871,11,17,6,29,46,1496
68735,68735,10A422C047D598ECAC1912DEA262C9AA,13231,20,23,3,39,46,1996
68736,68736,051D5FB1E868B920875D67A284A55CE9,43751,0,12,12,19,48,998
68737,68737,051D5FB1E868B920875D67A284A55CE9,42081,15,16,1,24,49,1249
68738,68738,051D5FB1E868B920875D67A284A55CE9,43751,18,21,3,19,48,998
68742,68742,5C0B09304D4760B33072EF80F4C96136,10611,0,7,7,32,48,1648
68743,68743,5C0B09304D4760B33072EF80F4C96136,13651,8,9,1,30,47,1547
68744,68744,5C0B09304D4760B33072EF80F4C96136,10611,11,14,3,32,48,1648
68745,68745,5C0B09304D4760B33072EF80F4C96136,42523,15,16,1,31,47,1597
68746,68746,5C0B09304D4760B33072EF80F4C96136,42471,18,20,2,35,49,1799
68747,68747,5C0B09304D4760B33072EF80F4C96136,10611,21,23,2,32,48,1648
68748,68748,9D9FE72A397A314AB576A38D7D4AF37B,42351,0,5,5,38,45,1945
68749,68749,9D9FE72A397A314AB576A38D7D4AF37B,13941,5,8,3,41,47,2097
68750,68750,9D9FE72A397A314AB576A38D7D4AF37B,13911,9,23,14,39,46,1996
68757,68757,7D82D5935900C8E17FA7305F1C513E56,42521,0,8,8,31,47,1597
68758,68758,7D82D5935900C8E17FA7305F1C513E56,40341,9,12,3,23,49,1199
68759,68759,7D82D5935900C8E17FA7305F1C513E56,42521,13,23,10,31,47,1597
68760,68760,5F3681CA154176D9C587280037CBB99D,13561,0,9,9,37,49,1899
68761,68761,5F3681CA154176D9C587280037CBB99D,13091,11,19,8,20,42,1042
68762,68762,5F3681CA154176D9C587280037CBB99D,13561,21,23,2,37,49,1899
68781,68781,F7F6E311089E545E2ADE21E1CFF4D206,40636,0,1,1,35,48,1798
68782,68782,F7F6E311089E545E2ADE21E1CFF4D206,42523,4,6,2,31,47,1597
68783,68783,F7F6E311089E545E2ADE21E1CFF4D206,42921,6,18,12,33,47,1697
68784,68784,F7F6E311089E545E2ADE21E1CFF4D206,40636,21,22,1,35,48,1798
68785,68785,FC3FF2A4A79867965BF8FB27343C354A,11361,0,2,2,22,48,1148
68786,68786,FC3FF2A4A79867965BF8FB27343C354A,11641,2,3,1,22,49,1149
68787,68787,FC3FF2A4A79867965BF8FB27343C354A,11361,4,5,1,22,48,1148
68788,68788,FC3FF2A4A79867965BF8FB27343C354A,10951,9,10,1,29,48,1498
68789,68789,FC3FF2A4A79867965BF8FB27343C354A,43971,10,11,1,30,48,1548
68790,68790,FC3FF2A4A79867965BF8FB27343C354A,11361,14,15,1,22,48,1148
68791,68791,FC3FF2A4A79867965BF8FB27343C354A,42691,17,19,2,24,48,1248
68792,68792,FC3FF2A4A79867965BF8FB27343C354A,11361,20,23,3,22,48,1148
68797,68797,48D09EA1E123F030FD71CF37426D4799,43011,1,6,5,40,42,2042
68798,68798,48D09EA1E123F030FD71CF37426D4799,42151,6,10,4,35,45,1795
68799,68799,48D09EA1E123F030FD71CF37426D4799,43011,11,15,4,40,42,2042
68800,68800,48D09EA1E123F030FD71CF37426D4799,42151,16,21,5,35,45,1795
68801,68801,48D09EA1E123F030FD71CF37426D4799,43011,22,23,1,40,42,2042
68802,68802,F933276E840F8E84214D3C6BDA6A4447,11061,1,15,14,29,48,1498
68803,68803,F933276E840F8E84214D3C6BDA6A4447,40951,15,16,1,36,49,1849
68804,68804,F933276E840F8E84214D3C6BDA6A4447,12971,19,22,3,32,48,1648
68805,68805,A09B631BCC319D5EC41B3CFE0EF885AC,10401,0,9,9,33,49,1699
68806,68806,A09B631BCC319D5EC41B3CFE0EF885AC,12601,11,13,2,25,47,1297
68807,68807,A09B631BCC319D5EC41B3CFE0EF885AC,11211,15,18,3,34,49,1749
68808,68808,A09B631BCC319D5EC41B3CFE0EF885AC,11461,21,22,1,37,49,1899
68812,68812,5210593E93E22E41AC5A4023DDD7AF8A,11801,3,7,4,42,48,2148
68813,68813,5210593E93E22E41AC5A4023DDD7AF8A,11731,9,17,8,36,48,1848
68814,68814,5210593E93E22E41AC5A4023DDD7AF8A,13271,17,18,1,41,47,2097
68815,68815,5210593E93E22E41AC5A4023DDD7AF8A,11731,19,20,1,36,48,1848
68822,68822,51591F8EA07D8177C3E0ABFE6A0BF706,42623,0,3,3,22,49,1149
68823,68823,51591F8EA07D8177C3E0ABFE6A0BF706,13731,14,15,1,33,49,1699
68824,68824,51591F8EA07D8177C3E0ABFE6A0BF706,42623,19,23,4,22,49,1149
68825,68825,D3EF141BDC81929D7A3D2C86A2B15366,15411,0,1,1,44,27,2227
68826,68826,D3EF141BDC81929D7A3D2C86A2B15366,12611,2,18,16,41,29,2079
68827,68827,D3EF141BDC81929D7A3D2C86A2B15366,15411,20,23,3,44,27,2227
68834,68834,4CA1188698B5DD1E66E2EDCA80216CDE,12571,0,6,6,48,39,2439
68835,68835,4CA1188698B5DD1E66E2EDCA80216CDE,13071,11,15,4,41,41,2091
68836,68836,4CA1188698B5DD1E66E2EDCA80216CDE,13491,19,20,1,48,39,2439
68840,68840,80E764BD1AB344D5249D2A4A0F5F0950,11021,0,7,7,36,49,1849
68841,68841,80E764BD1AB344D5249D2A4A0F5F0950,16181,9,10,1,4,2,202
68842,68842,80E764BD1AB344D5249D2A4A0F5F0950,16211,12,13,1,4,3,203
68843,68843,80E764BD1AB344D5249D2A4A0F5F0950,13561,15,16,1,37,49,1899
68844,68844,80E764BD1AB344D5249D2A4A0F5F0950,11021,17,22,5,36,49,1849
68861,68861,725F4DF1678770995D2853C4CA844B3D,42491,1,12,11,32,46,1646
68862,68862,725F4DF1678770995D2853C4CA844B3D,11061,15,16,1,29,48,1498
68863,68863,725F4DF1678770995D2853C4CA844B3D,10681,18,19,1,30,48,1548
68864,68864,3717F18D88C40095DBADE8C95C390E6F,42151,0,8,8,35,45,1795
68865,68865,3717F18D88C40095DBADE8C95C390E6F,42861,8,13,5,37,44,1894
68866,68866,3717F18D88C40095DBADE8C95C390E6F,42151,13,14,1,35,45,1795
68867,68867,3717F18D88C40095DBADE8C95C390E6F,11261,15,16,1,36,46,1846
68868,68868,3717F18D88C40095DBADE8C95C390E6F,42151,16,17,1,35,45,1795
68869,68869,3717F18D88C40095DBADE8C95C390E6F,42861,22,23,1,37,44,1894
68870,68870,AAC98D8EB5664A9B5DE56F266CB31991,15143,0,3,3,18,7,907
68871,68871,AAC98D8EB5664A9B5DE56F266CB31991,16281,4,6,2,11,4,554
68872,68872,AAC98D8EB5664A9B5DE56F266CB31991,15143,10,13,3,18,7,907
68873,68873,AAC98D8EB5664A9B5DE56F266CB31991,16281,16,17,1,11,4,554
68874,68874,AAC98D8EB5664A9B5DE56F266CB31991,15143,21,23,2,18,7,907
68878,68878,6CC24D921FE70D79D98FA5B7890BCB55,19441,3,8,5,8,46,446
68879,68879,6CC24D921FE70D79D98FA5B7890BCB55,42041,9,12,3,10,47,547
68880,68880,6CC24D921FE70D79D98FA5B7890BCB55,19441,14,16,2,8,46,446
68881,68881,6CC24D921FE70D79D98FA5B7890BCB55,19031,19,20,1,1,42,92
68882,68882,B1456CBC1BA8C10499BC790BFEE66A44,12971,0,11,11,32,48,1648
68883,68883,B1456CBC1BA8C10499BC790BFEE66A44,11541,12,13,1,35,49,1799
68884,68884,B1456CBC1BA8C10499BC790BFEE66A44,12971,14,17,3,32,48,1648
68885,68885,B1456CBC1BA8C10499BC790BFEE66A44,10841,18,20,2,37,47,1897
68886,68886,DE7A331A2ADB65AF4D6289538234B91E,42201,0,10,10,43,46,2196
68887,68887,DE7A331A2ADB65AF4D6289538234B91E,11491,13,15,2,36,47,1847
68888,68888,DE7A331A2ADB65AF4D6289538234B91E,10531,19,20,1,34,46,1746
68889,68889,875AC5C0D7E2AE98DB67A22B97796652,11021,0,1,1,36,49,1849
68890,68890,875AC5C0D7E2AE98DB67A22B97796652,43361,3,11,8,38,48,1948
68891,68891,875AC5C0D7E2AE98DB67A22B97796652,13121,14,17,3,38,46,1946
68892,68892,875AC5C0D7E2AE98DB67A22B97796652,11231,17,23,6,37,49,1899
68893,68893,4568F4CB3839A063AA85BE5AD656F1DE,11351,9,13,4,36,48,1848
68894,68894,4568F4CB3839A063AA85BE5AD656F1DE,40691,15,16,1,42,48,2148
68895,68895,4568F4CB3839A063AA85BE5AD656F1DE,11751,21,22,1,35,48,1798
68896,68896,406EDA02B30F2BAE6E77943EDDABB841,42461,0,4,4,45,47,2297
68897,68897,406EDA02B30F2BAE6E77943EDDABB841,42801,6,19,13,40,49,2049
68898,68898,406EDA02B30F2BAE6E77943EDDABB841,42091,19,23,4,43,46,2196
68902,68902,46624C7A7A05E81084BABC40FE8F937C,13314,0,7,7,31,39,1589
68903,68903,46624C7A7A05E81084BABC40FE8F937C,12521,12,13,1,35,41,1791
68904,68904,46624C7A7A05E81084BABC40FE8F937C,13314,18,23,5,31,39,1589
68905,68905,0B2A92CB01E0E95C741AFADF50C7B551,10121,3,10,7,36,49,1849
68906,68906,0B2A92CB01E0E95C741AFADF50C7B551,42621,12,15,3,24,49,1249
68907,68907,0B2A92CB01E0E95C741AFADF50C7B551,10121,22,23,1,36,49,1849
68912,68912,1F953F5DDA94789CC05A9CC3A1537BDC,42581,1,8,7,38,48,1948
68913,68913,1F953F5DDA94789CC05A9CC3A1537BDC,11914,11,13,2,37,48,1898
68914,68914,1F953F5DDA94789CC05A9CC3A1537BDC,42581,14,16,2,38,48,1948
68915,68915,1F953F5DDA94789CC05A9CC3A1537BDC,11914,20,21,1,37,48,1898
68916,68916,1F953F5DDA94789CC05A9CC3A1537BDC,42191,21,23,2,38,49,1949
68917,68917,6606CC80A620FB56A8D3818C167DB7F4,10711,0,8,8,29,46,1496
68918,68918,6606CC80A620FB56A8D3818C167DB7F4,43471,8,10,2,31,49,1599
68919,68919,6606CC80A620FB56A8D3818C167DB7F4,10731,11,13,2,33,47,1697
68920,68920,6606CC80A620FB56A8D3818C167DB7F4,42511,14,17,3,37,47,1897
68921,68921,6606CC80A620FB56A8D3818C167DB7F4,11531,19,20,1,34,49,1749
68925,68925,DBB647C4A4603B7F4340A7E09EDD7C70,43051,0,4,4,46,45,2345
68926,68926,DBB647C4A4603B7F4340A7E09EDD7C70,42321,6,10,4,43,47,2197
68927,68927,DBB647C4A4603B7F4340A7E09EDD7C70,43621,13,15,2,46,48,2348
68928,68928,DBB647C4A4603B7F4340A7E09EDD7C70,13951,17,23,6,47,45,2395
68929,68929,498FA21A928D94A5AF2C1CBF48D37607,40331,0,3,3,30,47,1547
68930,68930,498FA21A928D94A5AF2C1CBF48D37607,43161,5,7,2,35,47,1797
68931,68931,498FA21A928D94A5AF2C1CBF48D37607,10731,9,10,1,33,47,1697
68932,68932,498FA21A928D94A5AF2C1CBF48D37607,40331,13,19,6,30,47,1547
68933,68933,498FA21A928D94A5AF2C1CBF48D37607,10731,21,23,2,33,47,1697
68938,68938,84D09807769454188E86D49181B1B5D0,11001,0,1,1,42,47,2147
68939,68939,84D09807769454188E86D49181B1B5D0,13111,2,11,9,42,46,2146
68940,68940,84D09807769454188E86D49181B1B5D0,11211,13,14,1,34,49,1749
68941,68941,84D09807769454188E86D49181B1B5D0,43061,17,18,1,43,46,2196
68942,68942,A9135E0F0EF7AD09CCCAB1CA8CBFF827,40271,8,9,1,35,49,1799
68943,68943,A9135E0F0EF7AD09CCCAB1CA8CBFF827,40341,9,13,4,23,49,1199
68944,68944,A9135E0F0EF7AD09CCCAB1CA8CBFF827,40271,14,23,9,35,49,1799
68945,68945,4DA57F9F33C37E2CA21407DE781C18AF,12211,0,3,3,41,44,2094
68946,68946,4DA57F9F33C37E2CA21407DE781C18AF,11261,6,9,3,36,46,1846
68947,68947,4DA57F9F33C37E2CA21407DE781C18AF,13911,14,15,1,39,46,1996
68948,68948,4DA57F9F33C37E2CA21407DE781C18AF,11261,15,19,4,36,46,1846
68949,68949,4DA57F9F33C37E2CA21407DE781C18AF,42351,20,21,1,38,45,1945
68954,68954,FA215D037E3ED3281544DD70764B37AD,11021,0,13,13,36,49,1849
68955,68955,FA215D037E3ED3281544DD70764B37AD,11324,13,15,2,31,46,1596
68956,68956,FA215D037E3ED3281544DD70764B37AD,11021,16,23,7,36,49,1849
68957,68957,9B49BEB65E16F10DE8E30D5D01D652E3,10811,0,9,9,38,46,1946
68958,68958,9B49BEB65E16F10DE8E30D5D01D652E3,12311,11,13,2,30,44,1544
68959,68959,9B49BEB65E16F10DE8E30D5D01D652E3,42121,15,16,1,26,49,1349
68960,68960,9B49BEB65E16F10DE8E30D5D01D652E3,12311,16,18,2,30,44,1544
68961,68961,8DA8A44C9645A67744675BFF876BC4D6,13121,0,8,8,38,46,1946
68962,68962,8DA8A44C9645A67744675BFF876BC4D6,12083,10,19,9,36,49,1849
68963,68963,8DA8A44C9645A67744675BFF876BC4D6,43241,21,22,1,36,46,1846
68964,68964,F8BEE6828A230B629710C39CF00996DF,11806,0,7,7,41,48,2098
68965,68965,F8BEE6828A230B629710C39CF00996DF,12971,8,9,1,32,48,1648
68966,68966,F8BEE6828A230B629710C39CF00996DF,11806,14,15,1,41,48,2098
68967,68967,F8BEE6828A230B629710C39CF00996DF,11551,17,18,1,39,49,1999
68968,68968,F8BEE6828A230B629710C39CF00996DF,11806,19,23,4,41,48,2098
68972,68972,6F5F484DB207DF62D8B9EA23248F67B8,11011,0,9,9,39,49,1999
68973,68973,6F5F484DB207DF62D8B9EA23248F67B8,13471,14,20,6,47,49,2399
68974,68974,6F5F484DB207DF62D8B9EA23248F67B8,10231,21,23,2,39,49,1999
68975,68975,79BA17D265886FEE32010557748B02BD,11381,3,8,5,30,47,1547
68976,68976,79BA17D265886FEE32010557748B02BD,11061,9,15,6,29,48,1498
68977,68977,79BA17D265886FEE32010557748B02BD,13094,16,17,1,21,42,1092
68978,68978,79BA17D265886FEE32010557748B02BD,11061,18,19,1,29,48,1498
68983,68983,6820D80730A8A8A08F77C5AB731C6748,10351,0,13,13,28,45,1445
68984,68984,6820D80730A8A8A08F77C5AB731C6748,40341,15,17,2,23,49,1199
68985,68985,6820D80730A8A8A08F77C5AB731C6748,10351,20,23,3,28,45,1445
68989,68989,6B3F4B4FC4700C1EE425F34033D36D32,40891,0,16,16,37,47,1897
68990,68990,6B3F4B4FC4700C1EE425F34033D36D32,40341,16,17,1,23,49,1199
68991,68991,6B3F4B4FC4700C1EE425F34033D36D32,40891,19,22,3,37,47,1897
68992,68992,662A548A8B14F9AD655562C24AF54A9A,10351,0,13,13,28,45,1445
68993,68993,662A548A8B14F9AD655562C24AF54A9A,40341,15,17,2,23,49,1199
68994,68994,662A548A8B14F9AD655562C24AF54A9A,10351,20,23,3,28,45,1445
68995,68995,63AAB4E2754CD06C7A024CF5DB6B083C,11951,0,6,6,31,49,1599
68996,68996,63AAB4E2754CD06C7A024CF5DB6B083C,11914,7,17,10,37,48,1898
68997,68997,63AAB4E2754CD06C7A024CF5DB6B083C,11951,21,23,2,31,49,1599
68998,68998,1E75C00E3AD6CAD770CB267492850EC7,11461,1,3,2,37,49,1899
68999,68999,1E75C00E3AD6CAD770CB267492850EC7,10107,3,6,3,38,49,1949
69000,69000,1E75C00E3AD6CAD770CB267492850EC7,10471,7,12,5,37,48,1898
69001,69001,1E75C00E3AD6CAD770CB267492850EC7,10107,12,13,1,38,49,1949
69002,69002,1E75C00E3AD6CAD770CB267492850EC7,10471,14,22,8,37,48,1898
69003,69003,DFB39D9C16979A7A210D773BBB4B6305,42221,0,8,8,38,48,1948
69004,69004,DFB39D9C16979A7A210D773BBB4B6305,11261,9,10,1,36,46,1846
69005,69005,DFB39D9C16979A7A210D773BBB4B6305,42351,10,12,2,38,45,1945
69006,69006,DFB39D9C16979A7A210D773BBB4B6305,11261,13,18,5,36,46,1846
69007,69007,DFB39D9C16979A7A210D773BBB4B6305,42151,20,21,1,35,45,1795
69008,69008,27500E75DDE6B3503D76B279925A9776,11021,0,8,8,36,49,1849
69009,69009,27500E75DDE6B3503D76B279925A9776,42471,8,10,2,35,49,1799
69010,69010,27500E75DDE6B3503D76B279925A9776,11021,13,17,4,36,49,1849
69011,69011,27500E75DDE6B3503D76B279925A9776,40341,18,19,1,23,49,1199
69012,69012,27500E75DDE6B3503D76B279925A9776,10381,22,23,1,31,49,1599
69013,69013,19DD9EA3315ECB699A68A051C9281E6B,11491,0,1,1,36,47,1847
69014,69014,19DD9EA3315ECB699A68A051C9281E6B,10471,2,12,10,37,48,1898
69015,69015,19DD9EA3315ECB699A68A051C9281E6B,11381,12,13,1,30,47,1547
69016,69016,19DD9EA3315ECB699A68A051C9281E6B,10471,18,21,3,37,48,1898
69024,69024,C51EE78995B692FB9DA132D6AABD43B2,10651,0,8,8,36,49,1849
69025,69025,C51EE78995B692FB9DA132D6AABD43B2,10811,8,10,2,38,46,1946
69026,69026,C51EE78995B692FB9DA132D6AABD43B2,10651,10,14,4,36,49,1849
69027,69027,C51EE78995B692FB9DA132D6AABD43B2,11801,18,20,2,42,48,2148
69028,69028,C51EE78995B692FB9DA132D6AABD43B2,10651,21,23,2,36,49,1849
69033,69033,EF81D5350C78C47D74F1239C7A88A260,11541,0,2,2,35,49,1799
69034,69034,EF81D5350C78C47D74F1239C7A88A260,11861,4,5,1,32,47,1647
69035,69035,EF81D5350C78C47D74F1239C7A88A260,11381,6,15,9,30,47,1547
69036,69036,EF81D5350C78C47D74F1239C7A88A260,11861,17,18,1,32,47,1647
69046,69046,167F0AD4C372262B104F1E644C482559,10731,2,8,6,33,47,1697
69047,69047,167F0AD4C372262B104F1E644C482559,13121,9,16,7,38,46,1946
69048,69048,167F0AD4C372262B104F1E644C482559,10731,17,22,5,33,47,1697
69052,69052,B07F9654999A27B565B093B7A4D6A968,11661,0,8,8,40,49,2049
69053,69053,B07F9654999A27B565B093B7A4D6A968,11551,11,13,2,39,49,1999
69054,69054,B07F9654999A27B565B093B7A4D6A968,11661,14,17,3,40,49,2049
69055,69055,B07F9654999A27B565B093B7A4D6A968,40691,18,20,2,42,48,2148
69056,69056,B07F9654999A27B565B093B7A4D6A968,11661,21,23,2,40,49,2049
69057,69057,C2A50BE7B064AAEC27D9E1859F234BD0,12971,0,9,9,32,48,1648
69058,69058,C2A50BE7B064AAEC27D9E1859F234BD0,11701,10,13,3,43,48,2198
69059,69059,C2A50BE7B064AAEC27D9E1859F234BD0,10431,13,17,4,33,49,1699
69060,69060,C2A50BE7B064AAEC27D9E1859F234BD0,11541,18,20,2,35,49,1799
69070,69070,A36A27382F119D22AFBE4444170D00B7,12211,1,6,5,41,44,2094
69071,69071,A36A27382F119D22AFBE4444170D00B7,13341,6,7,1,44,45,2245
69072,69072,A36A27382F119D22AFBE4444170D00B7,13221,11,13,2,40,47,2047
69073,69073,A36A27382F119D22AFBE4444170D00B7,13341,13,21,8,44,45,2245
69074,69074,A36A27382F119D22AFBE4444170D00B7,12211,22,23,1,41,44,2094
69075,69075,2C3A1C890B30FB06A95DD4A9EF742265,43121,0,2,2,25,27,1277
69076,69076,2C3A1C890B30FB06A95DD4A9EF742265,19801,2,6,4,19,26,976
69077,69077,2C3A1C890B30FB06A95DD4A9EF742265,43121,10,20,10,25,27,1277
69078,69078,2C3A1C890B30FB06A95DD4A9EF742265,19801,20,23,3,19,26,976
69082,69082,57068447BEEE4D7969FF166D57966ECA,42541,0,5,5,25,47,1297
69083,69083,57068447BEEE4D7969FF166D57966ECA,11361,6,8,2,22,48,1148
69084,69084,57068447BEEE4D7969FF166D57966ECA,12581,8,11,3,24,48,1248
69085,69085,57068447BEEE4D7969FF166D57966ECA,42541,12,13,1,25,47,1297
69086,69086,57068447BEEE4D7969FF166D57966ECA,12581,14,17,3,24,48,1248
69087,69087,57068447BEEE4D7969FF166D57966ECA,42541,20,22,2,25,47,1297
69104,69104,D618A6C3100C9BD1930907167F1B2D2D,42091,0,9,9,43,46,2196
69105,69105,D618A6C3100C9BD1930907167F1B2D2D,13041,14,18,4,30,37,1537
69106,69106,D618A6C3100C9BD1930907167F1B2D2D,42091,21,23,2,43,46,2196
69110,69110,6DDBF820841AFBD305C7AF01F7FC7879,19114,0,10,10,7,43,393
69111,69111,6DDBF820841AFBD305C7AF01F7FC7879,11781,15,16,1,38,49,1949
69112,69112,6DDBF820841AFBD305C7AF01F7FC7879,19114,19,23,4,7,43,393
69129,69129,490931B4E3C6BBF337EBB9ADCD95E6F3,10281,1,8,7,33,48,1698
69130,69130,490931B4E3C6BBF337EBB9ADCD95E6F3,19114,13,16,3,7,43,393
69131,69131,490931B4E3C6BBF337EBB9ADCD95E6F3,19441,20,22,2,8,46,446
69136,69136,86C177FE29427D11B9077C5F541A2B81,10191,0,12,12,40,48,2048
69137,69137,86C177FE29427D11B9077C5F541A2B81,40951,13,15,2,36,49,1849
69138,69138,86C177FE29427D11B9077C5F541A2B81,10191,17,21,4,40,48,2048
69139,69139,8158B46C2C2D7019B94606EB933B844C,12641,0,7,7,10,43,543
69140,69140,8158B46C2C2D7019B94606EB933B844C,10251,9,18,9,35,47,1797
69141,69141,8158B46C2C2D7019B94606EB933B844C,11731,19,20,1,36,48,1848
69142,69142,8158B46C2C2D7019B94606EB933B844C,42771,21,23,2,36,47,1847
69143,69143,F725A3F859B25741A70E1B3AC0517A8A,10111,0,12,12,37,47,1897
69144,69144,F725A3F859B25741A70E1B3AC0517A8A,11201,14,17,3,35,49,1799
69145,69145,F725A3F859B25741A70E1B3AC0517A8A,42081,18,19,1,24,49,1249
69146,69146,F725A3F859B25741A70E1B3AC0517A8A,10111,22,23,1,37,47,1897
69151,69151,C135D0CC048BFF7E971403A8703667AE,11871,2,5,3,29,46,1496
69152,69152,C135D0CC048BFF7E971403A8703667AE,10351,6,7,1,28,45,1445
69153,69153,C135D0CC048BFF7E971403A8703667AE,11875,11,13,2,30,46,1546
69154,69154,C135D0CC048BFF7E971403A8703667AE,12121,16,17,1,29,47,1497
69155,69155,C135D0CC048BFF7E971403A8703667AE,10351,19,21,2,28,45,1445
69156,69156,4BCE8F3D44B6D775FF828315B62C8CD6,13371,0,8,8,41,47,2097
69157,69157,4BCE8F3D44B6D775FF828315B62C8CD6,11781,9,17,8,38,49,1949
69158,69158,4BCE8F3D44B6D775FF828315B62C8CD6,13371,18,21,3,41,47,2097
69159,69159,A67556B4B8FB75D5E258CF8F82E11551,10111,2,12,10,37,47,1897
69160,69160,A67556B4B8FB75D5E258CF8F82E11551,40341,16,19,3,23,49,1199
69161,69161,A67556B4B8FB75D5E258CF8F82E11551,10111,22,23,1,37,47,1897
69162,69162,1846E44CCA2E3A6B814B078932AB4837,11201,0,8,8,35,49,1799
69163,69163,1846E44CCA2E3A6B814B078932AB4837,11381,11,20,9,30,47,1547
69164,69164,1846E44CCA2E3A6B814B078932AB4837,11201,20,23,3,35,49,1799
69168,69168,1439D71C3B1C0FF45CC1AED4C666D5BA,43101,0,1,1,46,40,2340
69169,69169,1439D71C3B1C0FF45CC1AED4C666D5BA,13071,3,7,4,41,41,2091
69170,69170,1439D71C3B1C0FF45CC1AED4C666D5BA,43101,8,15,7,46,40,2340
69171,69171,1439D71C3B1C0FF45CC1AED4C666D5BA,13071,16,18,2,41,41,2091
69179,69179,507C264A3FC1C39E70D178529DA708EA,11074,0,7,7,37,47,1897
69180,69180,507C264A3FC1C39E70D178529DA708EA,40951,8,9,1,36,49,1849
69181,69181,507C264A3FC1C39E70D178529DA708EA,10221,14,17,3,34,49,1749
69182,69182,507C264A3FC1C39E70D178529DA708EA,11074,20,23,3,37,47,1897
69183,69183,9EC16DD8D58D40C2355CD3D8751C16A6,42071,7,9,2,31,49,1599
69184,69184,9EC16DD8D58D40C2355CD3D8751C16A6,42261,11,13,2,25,49,1299
69185,69185,9EC16DD8D58D40C2355CD3D8751C16A6,42071,16,18,2,31,49,1599
69186,69186,9EC16DD8D58D40C2355CD3D8751C16A6,42121,19,23,4,26,49,1349
69198,69198,1F9F1C83F1B526750C2575DE062BE373,11001,0,2,2,42,47,2147
69199,69199,1F9F1C83F1B526750C2575DE062BE373,43761,2,8,6,32,47,1647
69200,69200,1F9F1C83F1B526750C2575DE062BE373,42523,9,15,6,31,47,1597
69201,69201,1F9F1C83F1B526750C2575DE062BE373,43761,15,16,1,32,47,1647
69202,69202,1F9F1C83F1B526750C2575DE062BE373,42021,17,18,1,33,47,1697
69203,69203,1F9F1C83F1B526750C2575DE062BE373,10521,20,21,1,41,47,2097
69213,69213,5529DD2214C36634346603006F6A0F3F,12521,0,13,13,35,41,1791
69214,69214,5529DD2214C36634346603006F6A0F3F,13314,15,16,1,31,39,1589
69215,69215,5529DD2214C36634346603006F6A0F3F,12521,17,23,6,35,41,1791
69222,69222,636D66B9C2DD39D28485A7810A6E1528,43311,0,11,11,31,48,1598
69223,69223,636D66B9C2DD39D28485A7810A6E1528,42981,13,14,1,36,49,1849
69224,69224,636D66B9C2DD39D28485A7810A6E1528,42091,21,23,2,43,46,2196
69225,69225,C3F3FC9DE9B83627059FACAF83128857,10107,0,7,7,38,49,1949
69226,69226,C3F3FC9DE9B83627059FACAF83128857,11481,9,11,2,41,48,2098
69227,69227,C3F3FC9DE9B83627059FACAF83128857,10107,12,15,3,38,49,1949
69228,69228,C3F3FC9DE9B83627059FACAF83128857,13561,16,17,1,37,49,1899
69229,69229,C3F3FC9DE9B83627059FACAF83128857,10107,17,18,1,38,49,1949
69230,69230,C3F3FC9DE9B83627059FACAF83128857,40951,20,21,1,36,49,1849
69231,69231,EC971BEA56DBA93E199ED44EE6EDF346,11861,0,16,16,32,47,1647
69232,69232,EC971BEA56DBA93E199ED44EE6EDF346,42831,19,20,1,27,48,1398
69233,69233,EC971BEA56DBA93E199ED44EE6EDF346,11861,22,23,1,32,47,1647
69234,69234,CA7675D4504FF649E5D3C79C1D770D57,10901,0,5,5,35,48,1798
69235,69235,CA7675D4504FF649E5D3C79C1D770D57,11151,10,17,7,30,48,1548
69236,69236,CA7675D4504FF649E5D3C79C1D770D57,10161,18,23,5,35,49,1799
69237,69237,9BE9B638A03223167AF819AA94751264,43121,0,5,5,25,27,1277
69238,69238,9BE9B638A03223167AF819AA94751264,15321,6,9,3,29,26,1476
69239,69239,9BE9B638A03223167AF819AA94751264,43121,10,15,5,25,27,1277
69240,69240,9BE9B638A03223167AF819AA94751264,15321,16,18,2,29,26,1476
69241,69241,9BE9B638A03223167AF819AA94751264,43121,20,23,3,25,27,1277
69242,69242,1392C8E19F85085262C8C4C5B019D410,11074,0,8,8,37,47,1897
69243,69243,1392C8E19F85085262C8C4C5B019D410,11271,9,14,5,37,48,1898
69244,69244,1392C8E19F85085262C8C4C5B019D410,13951,18,21,3,47,45,2395
69245,69245,8653F490165C5E4408F801ED221A6191,13311,1,10,9,27,39,1389
69246,69246,8653F490165C5E4408F801ED221A6191,11281,10,11,1,27,40,1390
69247,69247,8653F490165C5E4408F801ED221A6191,11381,14,15,1,30,47,1547
69248,69248,8653F490165C5E4408F801ED221A6191,11281,17,20,3,27,40,1390
69249,69249,2F380CE2E674806561EC26C449F15D1B,41393,0,7,7,43,49,2199
69250,69250,2F380CE2E674806561EC26C449F15D1B,10431,9,10,1,33,49,1699
69251,69251,2F380CE2E674806561EC26C449F15D1B,13094,12,13,1,21,42,1092
69252,69252,2F380CE2E674806561EC26C449F15D1B,41393,14,17,3,43,49,2199
69253,69253,2F380CE2E674806561EC26C449F15D1B,40691,17,18,1,42,48,2148
69254,69254,2F380CE2E674806561EC26C449F15D1B,11201,20,23,3,35,49,1799
69255,69255,D66DDB1AF696D6DDB044E124EA6B793E,13941,3,10,7,41,47,2097
69256,69256,D66DDB1AF696D6DDB044E124EA6B793E,10681,12,17,5,30,48,1548
69257,69257,D66DDB1AF696D6DDB044E124EA6B793E,13951,18,19,1,47,45,2395
69258,69258,D66DDB1AF696D6DDB044E124EA6B793E,10681,20,23,3,30,48,1548
69282,69282,A907F1FD9C6E827C729A4F36D915F4F7,11701,0,10,10,43,48,2198
69283,69283,A907F1FD9C6E827C729A4F36D915F4F7,11151,11,13,2,30,48,1548
69284,69284,A907F1FD9C6E827C729A4F36D915F4F7,11701,17,23,6,43,48,2198
69285,69285,566A98F570A1628E8F6EFD9CFCC9370E,12491,1,14,13,36,43,1843
69286,69286,566A98F570A1628E8F6EFD9CFCC9370E,12661,17,18,1,32,45,1645
69287,69287,566A98F570A1628E8F6EFD9CFCC9370E,11861,19,20,1,32,47,1647
69288,69288,566A98F570A1628E8F6EFD9CFCC9370E,12661,21,22,1,32,45,1645
69289,69289,C5BE39F043AAB34786E4C31AB48CACA0,12051,0,5,5,20,47,1047
69290,69290,C5BE39F043AAB34786E4C31AB48CACA0,43751,6,9,3,19,48,998
69291,69291,C5BE39F043AAB34786E4C31AB48CACA0,42691,12,13,1,24,48,1248
69292,69292,C5BE39F043AAB34786E4C31AB48CACA0,43751,14,17,3,19,48,998
69293,69293,C5BE39F043AAB34786E4C31AB48CACA0,42681,19,20,1,24,48,1248
69294,69294,0722208BA05F2FA64560C4BADA491D8E,11381,2,11,9,30,47,1547
69295,69295,0722208BA05F2FA64560C4BADA491D8E,10221,17,19,2,34,49,1749
69296,69296,0722208BA05F2FA64560C4BADA491D8E,12121,20,23,3,29,47,1497
69307,69307,B62640ECB6AD629262C58DA6E6AD811B,15661,0,1,1,36,26,1826
69308,69308,B62640ECB6AD629262C58DA6E6AD811B,15671,5,7,2,37,26,1876
69309,69309,B62640ECB6AD629262C58DA6E6AD811B,16281,11,17,6,11,4,554
69310,69310,B62640ECB6AD629262C58DA6E6AD811B,15331,18,20,2,38,24,1924
69311,69311,B62640ECB6AD629262C58DA6E6AD811B,15671,21,22,1,37,26,1876
69316,69316,A845F5E6E274947D69D978D433D48E69,11914,0,8,8,37,48,1898
69317,69317,A845F5E6E274947D69D978D433D48E69,12601,13,16,3,25,47,1297
69318,69318,A845F5E6E274947D69D978D433D48E69,10221,18,20,2,34,49,1749
69319,69319,A845F5E6E274947D69D978D433D48E69,11541,21,22,1,35,49,1799
69326,69326,CB6CE8B284764CB65EC4187E6FE5A3FF,43021,5,13,8,16,43,843
69327,69327,CB6CE8B284764CB65EC4187E6FE5A3FF,19021,14,16,2,10,45,545
69328,69328,CB6CE8B284764CB65EC4187E6FE5A3FF,43021,21,23,2,16,43,843
69333,69333,ACBBAD48FBD0946DF020A027F3C96FB3,10191,0,8,8,40,48,2048
69334,69334,ACBBAD48FBD0946DF020A027F3C96FB3,43181,9,10,1,39,48,1998
69335,69335,ACBBAD48FBD0946DF020A027F3C96FB3,10191,11,15,4,40,48,2048
69336,69336,ACBBAD48FBD0946DF020A027F3C96FB3,40341,16,19,3,23,49,1199
69340,69340,CBC7BFCA8A8C6A27834AC5E27A34598D,10471,0,9,9,37,48,1898
69341,69341,CBC7BFCA8A8C6A27834AC5E27A34598D,13091,11,13,2,20,42,1042
69342,69342,CBC7BFCA8A8C6A27834AC5E27A34598D,10471,16,23,7,37,48,1898
69343,69343,D7301CE77CA5E58EF5F8E9B412922B88,10111,0,12,12,37,47,1897
69344,69344,D7301CE77CA5E58EF5F8E9B412922B88,42381,14,16,2,39,41,1991
69345,69345,D7301CE77CA5E58EF5F8E9B412922B88,10111,19,22,3,37,47,1897
69346,69346,AB57CFBC7FBBD1B4F46C04046F726522,15171,0,5,5,42,21,2121
69347,69347,AB57CFBC7FBBD1B4F46C04046F726522,15021,6,9,3,46,18,2318
69348,69348,AB57CFBC7FBBD1B4F46C04046F726522,15441,11,12,1,44,20,2220
69349,69349,AB57CFBC7FBBD1B4F46C04046F726522,12881,12,14,2,47,22,2372
69350,69350,AB57CFBC7FBBD1B4F46C04046F726522,15021,14,16,2,46,18,2318
69351,69351,AB57CFBC7FBBD1B4F46C04046F726522,15171,21,23,2,42,21,2121
69352,69352,F3ADE38A6219C04719D8BAB38E16EC80,10811,7,9,2,38,46,1946
69353,69353,F3ADE38A6219C04719D8BAB38E16EC80,11701,10,12,2,43,48,2198
69354,69354,F3ADE38A6219C04719D8BAB38E16EC80,10151,13,14,1,34,47,1747
69355,69355,F3ADE38A6219C04719D8BAB38E16EC80,11231,18,19,1,37,49,1899
69356,69356,F3ADE38A6219C04719D8BAB38E16EC80,42471,20,22,2,35,49,1799
69366,69366,ACFFCEADC3F589A8F690FE2669E3730D,42041,0,5,5,10,47,547
69367,69367,ACFFCEADC3F589A8F690FE2669E3730D,19441,5,6,1,8,46,446
69368,69368,ACFFCEADC3F589A8F690FE2669E3730D,42041,8,9,1,10,47,547
69369,69369,ACFFCEADC3F589A8F690FE2669E3730D,19441,15,16,1,8,46,446
69370,69370,ACFFCEADC3F589A8F690FE2669E3730D,42041,18,19,1,10,47,547
69374,69374,37F1D2311F2383134D9A7BD374E33133,10501,9,10,1,22,46,1146
69375,69375,37F1D2311F2383134D9A7BD374E33133,12051,10,22,12,20,47,1047
69376,69376,37F1D2311F2383134D9A7BD374E33133,43751,22,23,1,19,48,998
69377,69377,15903F2996F483F19DF9C809F94C3A96,42151,1,7,6,35,45,1795
69378,69378,15903F2996F483F19DF9C809F94C3A96,11381,12,16,4,30,47,1547
69379,69379,15903F2996F483F19DF9C809F94C3A96,10951,16,19,3,29,48,1498
69380,69380,15903F2996F483F19DF9C809F94C3A96,12161,20,21,1,32,46,1646
69393,69393,C60F12F63C2D7D6CCCE36F55A7BBAF31,11151,1,8,7,30,48,1548
69394,69394,C60F12F63C2D7D6CCCE36F55A7BBAF31,11061,8,10,2,29,48,1498
69395,69395,C60F12F63C2D7D6CCCE36F55A7BBAF31,11151,12,14,2,30,48,1548
69396,69396,C60F12F63C2D7D6CCCE36F55A7BBAF31,42801,16,17,1,40,49,2049
69397,69397,C60F12F63C2D7D6CCCE36F55A7BBAF31,10951,19,23,4,29,48,1498
69398,69398,F3B16B9F2FE5D66DD896BE8E61C1FA80,10351,0,4,4,28,45,1445
69399,69399,F3B16B9F2FE5D66DD896BE8E61C1FA80,10301,5,8,3,31,45,1595
69400,69400,F3B16B9F2FE5D66DD896BE8E61C1FA80,10351,8,11,3,28,45,1445
69401,69401,F3B16B9F2FE5D66DD896BE8E61C1FA80,42531,11,14,3,31,45,1595
69402,69402,F3B16B9F2FE5D66DD896BE8E61C1FA80,10351,16,17,1,28,45,1445
69403,69403,F3B16B9F2FE5D66DD896BE8E61C1FA80,10301,18,21,3,31,45,1595
69404,69404,F3B16B9F2FE5D66DD896BE8E61C1FA80,12311,21,23,2,30,44,1544
69405,69405,11684217103366D3A9F5B7813C6A8152,11261,0,2,2,36,46,1846
69406,69406,11684217103366D3A9F5B7813C6A8152,42151,3,7,4,35,45,1795
69407,69407,11684217103366D3A9F5B7813C6A8152,11261,7,8,1,36,46,1846
69408,69408,11684217103366D3A9F5B7813C6A8152,42151,11,15,4,35,45,1795
69409,69409,11684217103366D3A9F5B7813C6A8152,11261,19,21,2,36,46,1846
69414,69414,83FDD34D3F9074FDFBE20640C3EB2CF6,10951,2,6,4,29,48,1498
69415,69415,83FDD34D3F9074FDFBE20640C3EB2CF6,12121,7,8,1,29,47,1497
69416,69416,83FDD34D3F9074FDFBE20640C3EB2CF6,10951,8,10,2,29,48,1498
69417,69417,83FDD34D3F9074FDFBE20640C3EB2CF6,11381,11,12,1,30,47,1547
69418,69418,83FDD34D3F9074FDFBE20640C3EB2CF6,10951,12,22,10,29,48,1498
69422,69422,251B7D1A8A51051AE9510BBE19BE3817,40632,0,10,10,35,48,1798
69423,69423,251B7D1A8A51051AE9510BBE19BE3817,13511,11,12,1,34,48,1748
69424,69424,251B7D1A8A51051AE9510BBE19BE3817,40632,14,17,3,35,48,1798
69425,69425,251B7D1A8A51051AE9510BBE19BE3817,13511,18,20,2,34,48,1748
69426,69426,251B7D1A8A51051AE9510BBE19BE3817,40632,20,23,3,35,48,1798
69427,69427,6D1767685CFDF945848EE7885E835BAF,11871,1,8,7,29,46,1496
69428,69428,6D1767685CFDF945848EE7885E835BAF,42051,12,13,1,42,48,2148
69429,69429,6D1767685CFDF945848EE7885E835BAF,42871,14,16,2,30,45,1545
69430,69430,6D1767685CFDF945848EE7885E835BAF,11871,18,20,2,29,46,1496
69444,69444,90AC20E6CC0B4ABA3A4EAC5C3086C030,13561,0,15,15,37,49,1899
69445,69445,90AC20E6CC0B4ABA3A4EAC5C3086C030,13271,16,18,2,41,47,2097
69446,69446,90AC20E6CC0B4ABA3A4EAC5C3086C030,11271,21,23,2,37,48,1898
69447,69447,97C28224A360AF4AD406F4028992AC3E,13511,3,8,5,34,48,1748
69448,69448,97C28224A360AF4AD406F4028992AC3E,40171,12,14,2,38,48,1948
69449,69449,97C28224A360AF4AD406F4028992AC3E,10221,17,18,1,34,49,1749
69450,69450,97C28224A360AF4AD406F4028992AC3E,42961,18,20,2,35,49,1799
69451,69451,97C28224A360AF4AD406F4028992AC3E,13511,20,22,2,34,48,1748
69461,69461,A685A6EEE28C4F735F39A2E559306C8C,12671,1,2,1,21,43,1093
69462,69462,A685A6EEE28C4F735F39A2E559306C8C,13091,2,4,2,20,42,1042
69463,69463,A685A6EEE28C4F735F39A2E559306C8C,10634,7,17,10,27,45,1395
69464,69464,A685A6EEE28C4F735F39A2E559306C8C,13091,21,23,2,20,42,1042
69471,69471,27A0DD6A965A1FEA8EED4D0E73345414,12921,1,4,3,9,41,491
69472,69472,27A0DD6A965A1FEA8EED4D0E73345414,12641,7,10,3,10,43,543
69473,69473,27A0DD6A965A1FEA8EED4D0E73345414,12921,13,14,1,9,41,491
69474,69474,27A0DD6A965A1FEA8EED4D0E73345414,12641,15,17,2,10,43,543
69475,69475,27A0DD6A965A1FEA8EED4D0E73345414,12921,17,18,1,9,41,491
69476,69476,FFD84391FCD810EDFCF9E1B100BB0A91,11201,0,12,12,35,49,1799
69477,69477,FFD84391FCD810EDFCF9E1B100BB0A91,40951,12,17,5,36,49,1849
69478,69478,FFD84391FCD810EDFCF9E1B100BB0A91,11751,17,18,1,35,48,1798
69479,69479,FFD84391FCD810EDFCF9E1B100BB0A91,40951,18,20,2,36,49,1849
69480,69480,FFD84391FCD810EDFCF9E1B100BB0A91,10161,21,23,2,35,49,1799
69481,69481,1FF80D2D93D85E7E7CD7674A4424222F,43501,0,16,16,27,48,1398
69482,69482,1FF80D2D93D85E7E7CD7674A4424222F,12391,17,18,1,36,49,1849
69483,69483,1FF80D2D93D85E7E7CD7674A4424222F,10411,18,20,2,36,48,1848
69491,69491,2B174A2FF1063311A281D3E6DB697BD8,11231,0,10,10,37,49,1899
69492,69492,2B174A2FF1063311A281D3E6DB697BD8,42201,13,14,1,43,46,2196
69493,69493,2B174A2FF1063311A281D3E6DB697BD8,42461,15,18,3,45,47,2297
69494,69494,2B174A2FF1063311A281D3E6DB697BD8,11231,21,23,2,37,49,1899
69501,69501,59B01263F45C14A71D099F1B8AC4DAC5,13331,0,5,5,38,47,1947
69502,69502,59B01263F45C14A71D099F1B8AC4DAC5,19931,12,13,1,7,43,393
69503,69503,59B01263F45C14A71D099F1B8AC4DAC5,13331,17,23,6,38,47,1947
69504,69504,A0B44EDE0A0A4605549206EBBBA0709D,10211,0,6,6,16,49,849
69505,69505,A0B44EDE0A0A4605549206EBBBA0709D,42861,6,18,12,37,44,1894
69506,69506,A0B44EDE0A0A4605549206EBBBA0709D,10211,21,23,2,16,49,849
69510,69510,AD05D7DE6F19DCC7BB0AFE0EA923FC67,11231,0,8,8,37,49,1899
69511,69511,AD05D7DE6F19DCC7BB0AFE0EA923FC67,10511,10,12,2,35,46,1796
69512,69512,AD05D7DE6F19DCC7BB0AFE0EA923FC67,11261,12,13,1,36,46,1846
69513,69513,AD05D7DE6F19DCC7BB0AFE0EA923FC67,11231,17,23,6,37,49,1899
69514,69514,09C2A5500F5ABAEEAC932C07F5628EC4,11021,0,5,5,36,49,1849
69515,69515,09C2A5500F5ABAEEAC932C07F5628EC4,11631,6,8,2,12,49,649
69516,69516,09C2A5500F5ABAEEAC932C07F5628EC4,11021,10,19,9,36,49,1849
69520,69520,AB1E27033ABBCFEAE4B83A799FB358FD,19744,0,5,5,6,43,343
69521,69521,AB1E27033ABBCFEAE4B83A799FB358FD,12311,6,16,10,30,44,1544
69522,69522,AB1E27033ABBCFEAE4B83A799FB358FD,19744,19,23,4,6,43,343
69523,69523,E33CFB94D211CC4A30BA6CCB43250F42,10271,0,11,11,37,46,1896
69524,69524,E33CFB94D211CC4A30BA6CCB43250F42,13711,12,14,2,38,46,1946
69525,69525,E33CFB94D211CC4A30BA6CCB43250F42,11631,15,18,3,12,49,649
69529,69529,A411E983DACA35A3B6AE4368CE7232D1,13711,3,11,8,38,46,1946
69530,69530,A411E983DACA35A3B6AE4368CE7232D1,42201,13,14,1,43,46,2196
69531,69531,A411E983DACA35A3B6AE4368CE7232D1,40341,17,19,2,23,49,1199
69532,69532,64C3FBCEF7A3037F02A9B6659D9718CD,10471,1,16,15,37,48,1898
69533,69533,64C3FBCEF7A3037F02A9B6659D9718CD,40341,16,18,2,23,49,1199
69534,69534,64C3FBCEF7A3037F02A9B6659D9718CD,43281,21,23,2,37,48,1898
69538,69538,278E7A3571B833BC06992F250F8D46A1,43361,0,6,6,38,48,1948
69539,69539,278E7A3571B833BC06992F250F8D46A1,12401,7,8,1,39,49,1999
69540,69540,278E7A3571B833BC06992F250F8D46A1,40341,9,13,4,23,49,1199
69541,69541,278E7A3571B833BC06992F250F8D46A1,43361,14,15,1,38,48,1948
69542,69542,278E7A3571B833BC06992F250F8D46A1,12401,16,17,1,39,49,1999
69543,69543,278E7A3571B833BC06992F250F8D46A1,43361,18,21,3,38,48,1948
69544,69544,86BFA158A4D9AEA002C37BB31FC1DB0C,13094,0,4,4,21,42,1092
69545,69545,86BFA158A4D9AEA002C37BB31FC1DB0C,42541,4,5,1,25,47,1297
69546,69546,86BFA158A4D9AEA002C37BB31FC1DB0C,42691,9,10,1,24,48,1248
69547,69547,86BFA158A4D9AEA002C37BB31FC1DB0C,42541,13,17,4,25,47,1297
69548,69548,86BFA158A4D9AEA002C37BB31FC1DB0C,13094,20,23,3,21,42,1092
69557,69557,81565F9704E60766FEFBB47B416D00DF,12581,0,2,2,24,48,1248
69558,69558,81565F9704E60766FEFBB47B416D00DF,12051,5,9,4,20,47,1047
69559,69559,81565F9704E60766FEFBB47B416D00DF,12581,11,13,2,24,48,1248
69560,69560,81565F9704E60766FEFBB47B416D00DF,12051,14,16,2,20,47,1047
69561,69561,81565F9704E60766FEFBB47B416D00DF,12581,20,23,3,24,48,1248
69562,69562,0F63EB0E2A76702961055628B34A5DB2,43241,0,7,7,36,46,1846
69563,69563,0F63EB0E2A76702961055628B34A5DB2,13121,9,10,1,38,46,1946
69564,69564,0F63EB0E2A76702961055628B34A5DB2,12401,12,13,1,39,49,1999
69565,69565,0F63EB0E2A76702961055628B34A5DB2,43241,15,18,3,36,46,1846
69569,69569,44204903DA6B531E6F888417C2B4381D,10491,0,12,12,33,48,1698
69570,69570,44204903DA6B531E6F888417C2B4381D,42221,13,14,1,38,48,1948
69571,69571,44204903DA6B531E6F888417C2B4381D,42511,19,23,4,37,47,1897
69576,69576,6684687C9F1041794E8237CE4D241C6F,10381,0,6,6,31,49,1599
69577,69577,6684687C9F1041794E8237CE4D241C6F,42081,6,13,7,24,49,1249
69578,69578,6684687C9F1041794E8237CE4D241C6F,10381,14,21,7,31,49,1599
69579,69579,FC32FCDE5EA162E6A3931CE10EF22190,11231,7,9,2,37,49,1899
69580,69580,FC32FCDE5EA162E6A3931CE10EF22190,43501,12,14,2,27,48,1398
69581,69581,FC32FCDE5EA162E6A3931CE10EF22190,11231,15,17,2,37,49,1899
69582,69582,FC32FCDE5EA162E6A3931CE10EF22190,13121,19,21,2,38,46,1946
69583,69583,FC32FCDE5EA162E6A3931CE10EF22190,11021,21,23,2,36,49,1849
69587,69587,132BAF41704DD845C2F70543C3732C4E,42231,1,3,2,37,46,1896
69588,69588,132BAF41704DD845C2F70543C3732C4E,13711,4,5,1,38,46,1946
69589,69589,132BAF41704DD845C2F70543C3732C4E,42231,7,9,2,37,46,1896
69590,69590,132BAF41704DD845C2F70543C3732C4E,13711,12,13,1,38,46,1946
69591,69591,132BAF41704DD845C2F70543C3732C4E,42231,14,17,3,37,46,1896
69592,69592,132BAF41704DD845C2F70543C3732C4E,13711,18,23,5,38,46,1946
69596,69596,0AB3FB3A5BD0A79F217BD5A37B334853,11061,0,8,8,29,48,1498
69597,69597,0AB3FB3A5BD0A79F217BD5A37B334853,10107,9,10,1,38,49,1949
69598,69598,0AB3FB3A5BD0A79F217BD5A37B334853,11151,13,20,7,30,48,1548
69599,69599,0AB3FB3A5BD0A79F217BD5A37B334853,11751,21,23,2,35,48,1798
69603,69603,D8649491D8359E263FDD367C6CA795FB,10161,2,10,8,35,49,1799
69604,69604,D8649491D8359E263FDD367C6CA795FB,19111,10,15,5,9,45,495
69605,69605,D8649491D8359E263FDD367C6CA795FB,11531,17,18,1,34,49,1749
69606,69606,D8649491D8359E263FDD367C6CA795FB,10901,19,23,4,35,48,1798
69607,69607,842A1C1E3500FEFF04D25304E41263AF,12671,1,4,3,21,43,1093
69608,69608,842A1C1E3500FEFF04D25304E41263AF,13091,6,11,5,20,42,1042
69609,69609,842A1C1E3500FEFF04D25304E41263AF,12671,12,14,2,21,43,1093
69610,69610,842A1C1E3500FEFF04D25304E41263AF,13091,14,15,1,20,42,1042
69611,69611,842A1C1E3500FEFF04D25304E41263AF,12671,16,18,2,21,43,1093
69612,69612,842A1C1E3500FEFF04D25304E41263AF,13094,19,22,3,21,42,1092
69613,69613,4C6EBE1C4B2FAAFACD17B57BF7692986,42161,1,3,2,36,47,1847
69614,69614,4C6EBE1C4B2FAAFACD17B57BF7692986,10531,5,7,2,34,46,1746
69615,69615,4C6EBE1C4B2FAAFACD17B57BF7692986,43731,9,12,3,34,47,1747
69616,69616,4C6EBE1C4B2FAAFACD17B57BF7692986,10107,15,16,1,38,49,1949
69617,69617,4C6EBE1C4B2FAAFACD17B57BF7692986,43731,17,22,5,34,47,1747
69621,69621,15351107348D533F1A62174A9ED24724,12521,0,6,6,35,41,1791
69622,69622,15351107348D533F1A62174A9ED24724,43451,10,11,1,37,40,1890
69623,69623,15351107348D533F1A62174A9ED24724,13314,12,14,2,31,39,1589
69624,69624,15351107348D533F1A62174A9ED24724,12521,14,17,3,35,41,1791
69625,69625,15351107348D533F1A62174A9ED24724,13314,18,23,5,31,39,1589
69636,69636,66F421352C22D8571066F0AF8EA7BD0D,10251,0,3,3,35,47,1797
69637,69637,66F421352C22D8571066F0AF8EA7BD0D,43731,3,9,6,34,47,1747
69638,69638,66F421352C22D8571066F0AF8EA7BD0D,10251,10,13,3,35,47,1797
69639,69639,66F421352C22D8571066F0AF8EA7BD0D,10491,13,15,2,33,48,1698
69640,69640,66F421352C22D8571066F0AF8EA7BD0D,10251,19,23,4,35,47,1797
69641,69641,1E478A5FEF40D5F63DF757696B4C9EAC,12311,1,10,9,30,44,1544
69642,69642,1E478A5FEF40D5F63DF757696B4C9EAC,12381,18,19,1,32,48,1648
69643,69643,1E478A5FEF40D5F63DF757696B4C9EAC,11753,20,22,2,35,48,1798
69651,69651,60E47AB33736AC41E2674A67294A03D4,12491,2,6,4,36,43,1843
69652,69652,60E47AB33736AC41E2674A67294A03D4,13711,8,10,2,38,46,1946
69653,69653,60E47AB33736AC41E2674A67294A03D4,12491,12,14,2,36,43,1843
69654,69654,60E47AB33736AC41E2674A67294A03D4,42231,16,17,1,37,46,1896
69655,69655,60E47AB33736AC41E2674A67294A03D4,11261,20,23,3,36,46,1846
69656,69656,E92442C28CB44C67B1AFA3BE5AC81485,42741,0,1,1,43,48,2198
69657,69657,E92442C28CB44C67B1AFA3BE5AC81485,12131,2,17,15,32,47,1647
69658,69658,E92442C28CB44C67B1AFA3BE5AC81485,19024,19,23,4,9,45,495
69659,69659,884F24C0C30AAAE18B1978D3F711D159,43761,0,6,6,32,47,1647
69660,69660,884F24C0C30AAAE18B1978D3F711D159,42521,9,12,3,31,47,1597
69661,69661,884F24C0C30AAAE18B1978D3F711D159,43761,12,16,4,32,47,1647
69662,69662,884F24C0C30AAAE18B1978D3F711D159,42521,16,18,2,31,47,1597
69663,69663,884F24C0C30AAAE18B1978D3F711D159,43761,18,20,2,32,47,1647
69664,69664,EAAB672210C677BA2879CCE67BDB7DF5,11151,0,6,6,30,48,1548
69665,69665,EAAB672210C677BA2879CCE67BDB7DF5,42831,6,8,2,27,48,1398
69666,69666,EAAB672210C677BA2879CCE67BDB7DF5,42071,8,10,2,31,49,1599
69667,69667,EAAB672210C677BA2879CCE67BDB7DF5,11151,11,13,2,30,48,1548
69668,69668,EAAB672210C677BA2879CCE67BDB7DF5,42831,13,16,3,27,48,1398
69669,69669,EAAB672210C677BA2879CCE67BDB7DF5,11151,16,23,7,30,48,1548
69677,69677,7AEC9C7CCBAB2805F6D8B21C69CF29C4,10681,1,2,1,30,48,1548
69678,69678,7AEC9C7CCBAB2805F6D8B21C69CF29C4,10381,5,7,2,31,49,1599
69679,69679,7AEC9C7CCBAB2805F6D8B21C69CF29C4,10544,12,13,1,28,48,1448
69680,69680,7AEC9C7CCBAB2805F6D8B21C69CF29C4,10381,14,17,3,31,49,1599
69681,69681,7AEC9C7CCBAB2805F6D8B21C69CF29C4,10681,20,23,3,30,48,1548
69682,69682,02800F10016A5F5488F069DBB4436366,10161,0,6,6,35,49,1799
69683,69683,02800F10016A5F5488F069DBB4436366,42623,11,13,2,22,49,1149
69684,69684,02800F10016A5F5488F069DBB4436366,10161,14,23,9,35,49,1799
69685,69685,9F22CEAACF5F9765BA896D571A934437,43021,0,5,5,16,43,843
69686,69686,9F22CEAACF5F9765BA896D571A934437,12121,6,7,1,29,47,1497
69687,69687,9F22CEAACF5F9765BA896D571A934437,43021,9,10,1,16,43,843
69688,69688,9F22CEAACF5F9765BA896D571A934437,12921,11,17,6,9,41,491
69689,69689,9F22CEAACF5F9765BA896D571A934437,43021,21,23,2,16,43,843
69696,69696,451F5F0EB837B74F27398B4D7A9CF1A9,42301,0,1,1,36,47,1847
69697,69697,451F5F0EB837B74F27398B4D7A9CF1A9,42941,1,8,7,37,47,1897
69698,69698,451F5F0EB837B74F27398B4D7A9CF1A9,10491,10,13,3,33,48,1698
69699,69699,451F5F0EB837B74F27398B4D7A9CF1A9,11921,14,18,4,38,48,1948
69700,69700,451F5F0EB837B74F27398B4D7A9CF1A9,42161,20,21,1,36,47,1847
69701,69701,E72C56E918C3552E9C098607838C3B6C,11834,0,8,8,32,45,1645
69702,69702,E72C56E918C3552E9C098607838C3B6C,12491,11,17,6,36,43,1843
69703,69703,E72C56E918C3552E9C098607838C3B6C,42151,18,20,2,35,45,1795
69704,69704,2A299573B8ADE5EDDBBA5F82D87A0B34,13601,0,7,7,34,47,1747
69705,69705,2A299573B8ADE5EDDBBA5F82D87A0B34,11791,8,9,1,38,49,1949
69706,69706,2A299573B8ADE5EDDBBA5F82D87A0B34,42921,13,14,1,33,47,1697
69707,69707,2A299573B8ADE5EDDBBA5F82D87A0B34,13601,16,19,3,34,47,1747
69708,69708,2A299573B8ADE5EDDBBA5F82D87A0B34,42921,20,23,3,33,47,1697
69709,69709,B33429D7A00DB66721EA07FF9AC9AB45,11861,0,9,9,32,47,1647
69710,69710,B33429D7A00DB66721EA07FF9AC9AB45,11231,9,22,13,37,49,1899
69711,69711,B33429D7A00DB66721EA07FF9AC9AB45,11861,22,23,1,32,47,1647
69715,69715,27FD8A6CDE751A5F2BC12F75826C7985,12921,6,7,1,9,41,491
69716,69716,27FD8A6CDE751A5F2BC12F75826C7985,12641,7,9,2,10,43,543
69717,69717,27FD8A6CDE751A5F2BC12F75826C7985,12921,10,11,1,9,41,491
69718,69718,27FD8A6CDE751A5F2BC12F75826C7985,43021,11,13,2,16,43,843
69719,69719,27FD8A6CDE751A5F2BC12F75826C7985,12921,13,18,5,9,41,491
69724,69724,DB020001015A5B58B041C450BD45A3E6,11381,1,10,9,30,47,1547
69725,69725,DB020001015A5B58B041C450BD45A3E6,10951,10,14,4,29,48,1498
69726,69726,DB020001015A5B58B041C450BD45A3E6,19071,17,18,1,7,29,379
69727,69727,3F835C29252B1ECBD00EFD53E3222DE1,42471,0,9,9,35,49,1799
69728,69728,3F835C29252B1ECBD00EFD53E3222DE1,43881,11,13,2,25,34,1284
69729,69729,3F835C29252B1ECBD00EFD53E3222DE1,11541,15,16,1,35,49,1799
69730,69730,3F835C29252B1ECBD00EFD53E3222DE1,43581,17,19,2,33,48,1698
69731,69731,3F835C29252B1ECBD00EFD53E3222DE1,11541,20,23,3,35,49,1799
69732,69732,346BF3F539A4C5C04EF0491F7207CF76,19114,0,5,5,7,43,393
69733,69733,346BF3F539A4C5C04EF0491F7207CF76,19021,5,7,2,10,45,545
69734,69734,346BF3F539A4C5C04EF0491F7207CF76,12641,7,10,3,10,43,543
69735,69735,346BF3F539A4C5C04EF0491F7207CF76,19021,10,19,9,10,45,545
69736,69736,346BF3F539A4C5C04EF0491F7207CF76,19114,22,23,1,7,43,393
69737,69737,9A2E32244287B4B7AEA1F1EFBCFAADA7,42623,0,9,9,22,49,1149
69738,69738,9A2E32244287B4B7AEA1F1EFBCFAADA7,13091,10,11,1,20,42,1042
69739,69739,9A2E32244287B4B7AEA1F1EFBCFAADA7,12731,13,15,2,22,40,1140
69740,69740,9A2E32244287B4B7AEA1F1EFBCFAADA7,42623,16,22,6,22,49,1149
69747,69747,32C7AC4BB895B55BE341F6E1B0749F00,10431,1,8,7,33,49,1699
69748,69748,32C7AC4BB895B55BE341F6E1B0749F00,10351,12,14,2,28,45,1445
69749,69749,32C7AC4BB895B55BE341F6E1B0749F00,11281,14,18,4,27,40,1390
69750,69750,32C7AC4BB895B55BE341F6E1B0749F00,42341,20,23,3,43,49,2199
69755,69755,B2B648550DDCA6742E226B630323B4A8,11281,1,7,6,27,40,1390
69756,69756,B2B648550DDCA6742E226B630323B4A8,10351,12,19,7,28,45,1445
69757,69757,B2B648550DDCA6742E226B630323B4A8,11281,20,22,2,27,40,1390
69767,69767,7900186BCBC4D40222397B4DB2316DEC,43391,0,13,13,29,48,1498
69768,69768,7900186BCBC4D40222397B4DB2316DEC,11151,15,16,1,30,48,1548
69769,69769,7900186BCBC4D40222397B4DB2316DEC,11021,18,20,2,36,49,1849
69770,69770,7900186BCBC4D40222397B4DB2316DEC,12381,20,23,3,32,48,1648
69781,69781,49237ECED003BFEF5E21C688FECB20EC,19061,0,8,8,3,43,193
69782,69782,49237ECED003BFEF5E21C688FECB20EC,11061,11,16,5,29,48,1498
69783,69783,49237ECED003BFEF5E21C688FECB20EC,19061,18,21,3,3,43,193
69788,69788,BA7F8D1245DF2BA170F396020DC5A58C,13671,0,6,6,27,43,1393
69789,69789,BA7F8D1245DF2BA170F396020DC5A58C,13314,7,8,1,31,39,1589
69790,69790,BA7F8D1245DF2BA170F396020DC5A58C,13671,12,23,11,27,43,1393
69791,69791,E5B8920F3E3691BAA92FB7B056CFD690,43161,0,8,8,35,47,1797
69792,69792,E5B8920F3E3691BAA92FB7B056CFD690,42161,9,11,2,36,47,1847
69793,69793,E5B8920F3E3691BAA92FB7B056CFD690,43161,11,13,2,35,47,1797
69794,69794,E5B8920F3E3691BAA92FB7B056CFD690,11074,14,15,1,37,47,1897
69795,69795,E5B8920F3E3691BAA92FB7B056CFD690,43161,18,22,4,35,47,1797
69796,69796,A5311EF1CA402BCBEEABEF66FD300F8D,11381,5,13,8,30,47,1547
69797,69797,A5311EF1CA402BCBEEABEF66FD300F8D,40341,13,16,3,23,49,1199
69798,69798,A5311EF1CA402BCBEEABEF66FD300F8D,11381,17,22,5,30,47,1547
69799,69799,C81FC2E9808AA726781F412721963B0B,19111,0,7,7,9,45,495
69800,69800,C81FC2E9808AA726781F412721963B0B,43761,8,12,4,32,47,1647
69801,69801,C81FC2E9808AA726781F412721963B0B,19111,16,23,7,9,45,495
69816,69816,2E5B93B6FE04610C56A0B33EE6E9E88D,42691,9,15,6,24,48,1248
69817,69817,2E5B93B6FE04610C56A0B33EE6E9E88D,43751,15,19,4,19,48,998
69818,69818,2E5B93B6FE04610C56A0B33EE6E9E88D,11361,20,22,2,22,48,1148
69819,69819,C8886154F373877089A89790BB3295C2,15261,0,8,8,39,13,1963
69820,69820,C8886154F373877089A89790BB3295C2,15341,9,14,5,34,14,1714
69821,69821,C8886154F373877089A89790BB3295C2,40341,17,18,1,23,49,1199
69826,69826,4B82D968727F719DC3F252B34E10B162,42583,0,1,1,40,48,2048
69827,69827,4B82D968727F719DC3F252B34E10B162,43181,1,6,5,39,48,1998
69828,69828,4B82D968727F719DC3F252B34E10B162,42271,7,9,2,40,47,2047
69829,69829,4B82D968727F719DC3F252B34E10B162,43181,12,14,2,39,48,1998
69830,69830,4B82D968727F719DC3F252B34E10B162,42583,14,22,8,40,48,2048
69834,69834,38EAD9C71E0631172BE43F523D61F0B8,42971,0,13,13,43,49,2199
69835,69835,38EAD9C71E0631172BE43F523D61F0B8,11381,17,18,1,30,47,1547
69836,69836,38EAD9C71E0631172BE43F523D61F0B8,11061,20,22,2,29,48,1498
69837,69837,38EAD9C71E0631172BE43F523D61F0B8,43971,22,23,1,30,48,1548
69838,69838,1277ACA424D6A91D4C363B632562549C,13094,0,1,1,21,42,1092
69839,69839,1277ACA424D6A91D4C363B632562549C,12601,3,14,11,25,47,1297
69840,69840,1277ACA424D6A91D4C363B632562549C,10501,16,18,2,22,46,1146
69841,69841,1277ACA424D6A91D4C363B632562549C,12601,19,23,4,25,47,1297
69845,69845,34F27C7A373225C2AEC66AAEB6E46436,13411,6,7,1,49,42,2492
69846,69846,34F27C7A373225C2AEC66AAEB6E46436,13941,12,15,3,41,47,2097
69847,69847,34F27C7A373225C2AEC66AAEB6E46436,10601,19,22,3,39,47,1997
69848,69848,D26ACFC1CDC1B6BFE7B2C20BFA3DB497,11201,0,9,9,35,49,1799
69849,69849,D26ACFC1CDC1B6BFE7B2C20BFA3DB497,11091,11,13,2,29,47,1497
69850,69850,D26ACFC1CDC1B6BFE7B2C20BFA3DB497,42501,15,16,1,28,47,1447
69851,69851,D26ACFC1CDC1B6BFE7B2C20BFA3DB497,11751,18,19,1,35,48,1798
69852,69852,D26ACFC1CDC1B6BFE7B2C20BFA3DB497,11541,20,22,2,35,49,1799
69853,69853,ECC55A41DE7DF4FF6A356DE1634B0C55,19181,6,9,3,8,40,440
69854,69854,ECC55A41DE7DF4FF6A356DE1634B0C55,43644,11,17,6,14,38,738
69855,69855,ECC55A41DE7DF4FF6A356DE1634B0C55,19264,18,23,5,10,36,536
69859,69859,93DD2C863C5AA53C83002ED6F1D5AEBB,12641,4,6,2,10,43,543
69860,69860,93DD2C863C5AA53C83002ED6F1D5AEBB,12921,7,13,6,9,41,491
69861,69861,93DD2C863C5AA53C83002ED6F1D5AEBB,43644,14,16,2,14,38,738
69862,69862,93DD2C863C5AA53C83002ED6F1D5AEBB,19901,20,22,2,7,44,394
69863,69863,8FB2C78EB46FD562E8BB57D1602CC08C,11491,0,5,5,36,47,1847
69864,69864,8FB2C78EB46FD562E8BB57D1602CC08C,10161,6,11,5,35,49,1799
69865,69865,8FB2C78EB46FD562E8BB57D1602CC08C,11491,12,13,1,36,47,1847
69866,69866,8FB2C78EB46FD562E8BB57D1602CC08C,10161,14,18,4,35,49,1799
69867,69867,8FB2C78EB46FD562E8BB57D1602CC08C,11491,20,23,3,36,47,1847
69868,69868,C8236143E8B93D5FDE499177CF2B28F7,11381,0,5,5,30,47,1547
69869,69869,C8236143E8B93D5FDE499177CF2B28F7,42861,7,18,11,37,44,1894
69870,69870,C8236143E8B93D5FDE499177CF2B28F7,11381,19,23,4,30,47,1547
69871,69871,BBA244405FCBF580331CF1C7DC28986A,13671,0,3,3,27,43,1393
69872,69872,BBA244405FCBF580331CF1C7DC28986A,13314,3,8,5,31,39,1589
69873,69873,BBA244405FCBF580331CF1C7DC28986A,13671,9,16,7,27,43,1393
69874,69874,BBA244405FCBF580331CF1C7DC28986A,13314,17,18,1,31,39,1589
69881,69881,0FA8C8AAB4B26075FA3507BDC0BDD0C7,11861,0,12,12,32,47,1647
69882,69882,0FA8C8AAB4B26075FA3507BDC0BDD0C7,15041,15,18,3,36,9,1809
69883,69883,0FA8C8AAB4B26075FA3507BDC0BDD0C7,11861,21,23,2,32,47,1647
69887,69887,EAEFCB977DEDF23C1346736B36A6F67B,42231,6,7,1,37,46,1896
69888,69888,EAEFCB977DEDF23C1346736B36A6F67B,11261,8,10,2,36,46,1846
69889,69889,EAEFCB977DEDF23C1346736B36A6F67B,42231,10,13,3,37,46,1896
69890,69890,EAEFCB977DEDF23C1346736B36A6F67B,13911,13,15,2,39,46,1996
69891,69891,EAEFCB977DEDF23C1346736B36A6F67B,42231,17,18,1,37,46,1896
69892,69892,2E7B2253AC418B1A43B0E145571CC5CD,42511,0,7,7,37,47,1897
69893,69893,2E7B2253AC418B1A43B0E145571CC5CD,10781,8,11,3,35,47,1797
69894,69894,2E7B2253AC418B1A43B0E145571CC5CD,42623,14,15,1,22,49,1149
69895,69895,2E7B2253AC418B1A43B0E145571CC5CD,42511,16,19,3,37,47,1897
69896,69896,2E7B2253AC418B1A43B0E145571CC5CD,10531,20,22,2,34,46,1746
69900,69900,0A501EA010779C8F9EB8C2F8834C3F4F,10351,0,4,4,28,45,1445
69901,69901,0A501EA010779C8F9EB8C2F8834C3F4F,10301,5,7,2,31,45,1595
69902,69902,0A501EA010779C8F9EB8C2F8834C3F4F,10351,7,9,2,28,45,1445
69903,69903,0A501EA010779C8F9EB8C2F8834C3F4F,10301,10,11,1,31,45,1595
69904,69904,0A501EA010779C8F9EB8C2F8834C3F4F,10634,13,14,1,27,45,1395
69905,69905,0A501EA010779C8F9EB8C2F8834C3F4F,10351,14,18,4,28,45,1445
69906,69906,33ED93023E3AD7A598E0E42FBD60B0B2,10781,1,13,12,35,47,1797
69907,69907,33ED93023E3AD7A598E0E42FBD60B0B2,12311,15,17,2,30,44,1544
69908,69908,33ED93023E3AD7A598E0E42FBD60B0B2,10781,22,23,1,35,47,1797
69909,69909,89EC37A7B83D9B7D194154C37975BD9C,11381,2,6,4,30,47,1547
69910,69910,89EC37A7B83D9B7D194154C37975BD9C,40445,10,11,1,30,48,1548
69911,69911,89EC37A7B83D9B7D194154C37975BD9C,11061,13,15,2,29,48,1498
69912,69912,89EC37A7B83D9B7D194154C37975BD9C,42521,17,18,1,31,47,1597
69913,69913,89EC37A7B83D9B7D194154C37975BD9C,11061,21,22,1,29,48,1498
69914,69914,FE157E2906F39F22EFF42EFD9B7DC358,11061,1,4,3,29,48,1498
69915,69915,FE157E2906F39F22EFF42EFD9B7DC358,11381,5,8,3,30,47,1547
69916,69916,FE157E2906F39F22EFF42EFD9B7DC358,11061,9,13,4,29,48,1498
69917,69917,FE157E2906F39F22EFF42EFD9B7DC358,11381,17,19,2,30,47,1547
69918,69918,FE157E2906F39F22EFF42EFD9B7DC358,10681,20,21,1,30,48,1548
69919,69919,966EF37DD81DE2F009202B5BDDCFCE29,13461,0,1,1,39,44,1994
69920,69920,966EF37DD81DE2F009202B5BDDCFCE29,42351,4,6,2,38,45,1945
69921,69921,966EF37DD81DE2F009202B5BDDCFCE29,42231,7,16,9,37,46,1896
69922,69922,966EF37DD81DE2F009202B5BDDCFCE29,11074,19,20,1,37,47,1897
69923,69923,AF77E83C33BBDAC9BE49E19DF29439BD,11351,0,3,3,36,48,1848
69924,69924,AF77E83C33BBDAC9BE49E19DF29439BD,42871,4,16,12,30,45,1545
69925,69925,AF77E83C33BBDAC9BE49E19DF29439BD,42511,18,20,2,37,47,1897
69926,69926,AF77E83C33BBDAC9BE49E19DF29439BD,42871,21,23,2,30,45,1545
69937,69937,396BA88BF14A25B94D633DC54B4F0A20,43041,0,8,8,41,46,2096
69938,69938,396BA88BF14A25B94D633DC54B4F0A20,43051,8,13,5,46,45,2345
69939,69939,396BA88BF14A25B94D633DC54B4F0A20,42461,13,18,5,45,47,2297
69940,69940,396BA88BF14A25B94D633DC54B4F0A20,43061,18,19,1,43,46,2196
69941,69941,396BA88BF14A25B94D633DC54B4F0A20,43341,20,21,1,41,46,2096
69959,69959,DAFE070AC8164EB683B9455E05DD84E1,40833,0,7,7,41,47,2097
69960,69960,DAFE070AC8164EB683B9455E05DD84E1,13101,7,9,2,40,47,2047
69961,69961,DAFE070AC8164EB683B9455E05DD84E1,13271,11,12,1,41,47,2097
69962,69962,DAFE070AC8164EB683B9455E05DD84E1,11481,14,17,3,41,48,2098
69963,69963,DAFE070AC8164EB683B9455E05DD84E1,13101,18,22,4,40,47,2047
69976,69976,33825114014E22B38BE13400DBE8B281,42871,0,8,8,30,45,1545
69977,69977,33825114014E22B38BE13400DBE8B281,42633,11,12,1,42,46,2146
69978,69978,33825114014E22B38BE13400DBE8B281,10901,13,14,1,35,48,1798
69979,69979,33825114014E22B38BE13400DBE8B281,10716,15,16,1,30,46,1546
69980,69980,33825114014E22B38BE13400DBE8B281,42871,17,18,1,30,45,1545
69981,69981,33825114014E22B38BE13400DBE8B281,43731,19,21,2,34,47,1747
69982,69982,33825114014E22B38BE13400DBE8B281,42511,21,23,2,37,47,1897
69994,69994,35E2175E021CD04E6CF0361F38962323,10811,0,7,7,38,46,1946
69995,69995,35E2175E021CD04E6CF0361F38962323,11541,9,11,2,35,49,1799
69996,69996,35E2175E021CD04E6CF0361F38962323,42601,12,14,2,44,48,2248
69997,69997,35E2175E021CD04E6CF0361F38962323,10421,19,21,2,41,48,2098
69998,69998,35E2175E021CD04E6CF0361F38962323,13101,21,22,1,40,47,2047
69999,69999,541EF9DBA819D5A506A75ABBCDD3DCCA,12161,0,7,7,32,46,1646
70000,70000,541EF9DBA819D5A506A75ABBCDD3DCCA,41631,8,13,5,28,47,1447
70001,70001,541EF9DBA819D5A506A75ABBCDD3DCCA,12161,15,20,5,32,46,1646
70006,70006,457B779D00720128DC52229000CD7309,15114,0,16,16,22,16,1116
70007,70007,457B779D00720128DC52229000CD7309,16441,16,18,2,15,17,767
70008,70008,457B779D00720128DC52229000CD7309,15114,21,23,2,22,16,1116
70019,70019,7BB31A1D059FD6D88C054A61BB3B7FB1,42531,0,7,7,31,45,1595
70020,70020,7BB31A1D059FD6D88C054A61BB3B7FB1,10951,11,13,2,29,48,1498
70021,70021,7BB31A1D059FD6D88C054A61BB3B7FB1,42531,14,22,8,31,45,1595
70031,70031,03D6FFA8E0742D0181BD0480CCE1246D,41027,0,7,7,38,47,1947
70032,70032,03D6FFA8E0742D0181BD0480CCE1246D,13911,8,9,1,39,46,1996
70033,70033,03D6FFA8E0742D0181BD0480CCE1246D,10621,19,20,1,41,49,2099
70034,70034,03D6FFA8E0742D0181BD0480CCE1246D,10111,21,23,2,37,47,1897
70038,70038,74EBB90FA1C414F58477B49370E7F73F,11861,0,6,6,32,47,1647
70039,70039,74EBB90FA1C414F58477B49370E7F73F,12311,7,18,11,30,44,1544
70040,70040,74EBB90FA1C414F58477B49370E7F73F,11861,19,23,4,32,47,1647
70044,70044,39179060954ADF536A44D5CDC3D7ADA4,11261,5,7,2,36,46,1846
70045,70045,39179060954ADF536A44D5CDC3D7ADA4,13911,7,9,2,39,46,1996
70046,70046,39179060954ADF536A44D5CDC3D7ADA4,11261,9,11,2,36,46,1846
70047,70047,39179060954ADF536A44D5CDC3D7ADA4,10921,13,23,10,43,48,2198
70048,70048,BE6556F4F32DDBE17FA5A6143CEC24DA,12481,0,1,1,37,49,1899
70049,70049,BE6556F4F32DDBE17FA5A6143CEC24DA,42921,3,18,15,33,47,1697
70050,70050,BE6556F4F32DDBE17FA5A6143CEC24DA,10107,21,23,2,38,49,1949
70054,70054,BA6D45213D52989026A398B5D7995374,43644,0,6,6,14,38,738
70055,70055,BA6D45213D52989026A398B5D7995374,19181,6,18,12,8,40,440
70056,70056,BA6D45213D52989026A398B5D7995374,49201,21,23,2,7,41,391
70057,70057,639EA486291B8A87A84D90343A87732A,10451,0,6,6,25,48,1298
70058,70058,639EA486291B8A87A84D90343A87732A,10661,8,15,7,37,49,1899
70059,70059,639EA486291B8A87A84D90343A87732A,43581,20,21,1,33,48,1698
70060,70060,639EA486291B8A87A84D90343A87732A,10451,21,23,2,25,48,1298
70071,70071,F19EB67B80E918E14D885286800F46C3,13671,0,7,7,27,43,1393
70072,70072,F19EB67B80E918E14D885286800F46C3,10951,8,13,5,29,48,1498
70073,70073,F19EB67B80E918E14D885286800F46C3,13671,15,17,2,27,43,1393
70074,70074,F19EB67B80E918E14D885286800F46C3,11381,20,22,2,30,47,1547
70078,70078,C94109F455448027CE60D8FE61F82261,42623,5,9,4,22,49,1149
70079,70079,C94109F455448027CE60D8FE61F82261,10451,9,11,2,25,48,1298
70080,70080,C94109F455448027CE60D8FE61F82261,42071,11,12,1,31,49,1599
70081,70081,C94109F455448027CE60D8FE61F82261,42623,21,23,2,22,49,1149
70092,70092,292AD485DA7AE4FB3CFCA1190DC036DF,13911,0,1,1,39,46,1996
70093,70093,292AD485DA7AE4FB3CFCA1190DC036DF,42151,3,4,1,35,45,1795
70094,70094,292AD485DA7AE4FB3CFCA1190DC036DF,42351,7,9,2,38,45,1945
70095,70095,292AD485DA7AE4FB3CFCA1190DC036DF,13911,10,17,7,39,46,1996
70096,70096,292AD485DA7AE4FB3CFCA1190DC036DF,42231,18,19,1,37,46,1896
70097,70097,A0D0A92258D9DAF7EDCF60BEFD3CB622,19441,1,2,1,8,46,446
70098,70098,A0D0A92258D9DAF7EDCF60BEFD3CB622,11571,5,6,1,13,46,696
70099,70099,A0D0A92258D9DAF7EDCF60BEFD3CB622,19441,7,9,2,8,46,446
70100,70100,A0D0A92258D9DAF7EDCF60BEFD3CB622,19021,10,11,1,10,45,545
70101,70101,A0D0A92258D9DAF7EDCF60BEFD3CB622,42041,12,14,2,10,47,547
70102,70102,A0D0A92258D9DAF7EDCF60BEFD3CB622,19441,15,22,7,8,46,446
70103,70103,2BB5E6319C361908A67DD8509286CF7C,19031,0,6,6,1,42,92
70104,70104,2BB5E6319C361908A67DD8509286CF7C,12641,7,10,3,10,43,543
70105,70105,2BB5E6319C361908A67DD8509286CF7C,19031,12,15,3,1,42,92
70106,70106,2BB5E6319C361908A67DD8509286CF7C,12641,15,19,4,10,43,543
70107,70107,2BB5E6319C361908A67DD8509286CF7C,19031,19,23,4,1,42,92
70108,70108,36B9A094E8D22C518990766A8F925428,12641,0,5,5,10,43,543
70109,70109,36B9A094E8D22C518990766A8F925428,19621,7,8,1,5,46,296
70110,70110,36B9A094E8D22C518990766A8F925428,19114,12,23,11,7,43,393
70117,70117,ACB823DB33D22CC4344D979C1DDF92F4,11261,2,6,4,36,46,1846
70118,70118,ACB823DB33D22CC4344D979C1DDF92F4,42861,7,10,3,37,44,1894
70119,70119,ACB823DB33D22CC4344D979C1DDF92F4,11261,11,13,2,36,46,1846
70120,70120,ACB823DB33D22CC4344D979C1DDF92F4,42861,14,17,3,37,44,1894
70121,70121,ACB823DB33D22CC4344D979C1DDF92F4,11261,20,22,2,36,46,1846
70122,70122,C6A8E88AF4FAB8E3B900B709C1644500,10411,1,7,6,36,48,1848
70123,70123,C6A8E88AF4FAB8E3B900B709C1644500,42321,8,11,3,43,47,2197
70124,70124,C6A8E88AF4FAB8E3B900B709C1644500,11021,13,15,2,36,49,1849
70125,70125,C6A8E88AF4FAB8E3B900B709C1644500,10731,18,20,2,33,47,1697
70126,70126,C6A8E88AF4FAB8E3B900B709C1644500,12083,20,23,3,36,49,1849
70127,70127,19A29A27E6506D34C07A04E6E9F52A03,12491,0,6,6,36,43,1843
70128,70128,19A29A27E6506D34C07A04E6E9F52A03,11834,10,12,2,32,45,1645
70129,70129,19A29A27E6506D34C07A04E6E9F52A03,42151,15,17,2,35,45,1795
70130,70130,19A29A27E6506D34C07A04E6E9F52A03,12491,17,19,2,36,43,1843
70131,70131,19A29A27E6506D34C07A04E6E9F52A03,42151,20,23,3,35,45,1795
70132,70132,ECF78558A2502F5F4BF694C288917477,10471,9,11,2,37,48,1898
70133,70133,ECF78558A2502F5F4BF694C288917477,42521,18,19,1,31,47,1597
70134,70134,ECF78558A2502F5F4BF694C288917477,10716,20,23,3,30,46,1546
70138,70138,00C46323BD8632FDFD12406CD2A43CD2,40833,0,14,14,41,47,2097
70139,70139,00C46323BD8632FDFD12406CD2A43CD2,11061,15,17,2,29,48,1498
70140,70140,00C46323BD8632FDFD12406CD2A43CD2,11151,18,19,1,30,48,1548
70141,70141,D623986D271452579D7B3AD2B1D662DE,42281,2,3,1,40,48,2048
70142,70142,D623986D271452579D7B3AD2B1D662DE,42271,3,4,1,40,47,2047
70143,70143,D623986D271452579D7B3AD2B1D662DE,11806,5,6,1,41,48,2098
70144,70144,D623986D271452579D7B3AD2B1D662DE,13101,11,12,1,40,47,2047
70145,70145,D623986D271452579D7B3AD2B1D662DE,11481,13,14,1,41,48,2098
70146,70146,D623986D271452579D7B3AD2B1D662DE,11291,16,18,2,40,49,2049
70147,70147,803884DAE228D36B780CDE250AFE5FD1,13711,0,13,13,38,46,1946
70148,70148,803884DAE228D36B780CDE250AFE5FD1,11231,15,16,1,37,49,1899
70149,70149,803884DAE228D36B780CDE250AFE5FD1,11541,18,20,2,35,49,1799
70154,70154,71AB304A084EB4095E1F705C48CB0E23,11901,0,7,7,42,49,2149
70155,70155,71AB304A084EB4095E1F705C48CB0E23,11914,10,11,1,37,48,1898
70156,70156,71AB304A084EB4095E1F705C48CB0E23,42581,11,12,1,38,48,1948
70157,70157,71AB304A084EB4095E1F705C48CB0E23,11914,14,18,4,37,48,1898
70158,70158,71AB304A084EB4095E1F705C48CB0E23,11901,19,23,4,42,49,2149
70159,70159,5B38B567B1C7BA8CD66BEFDF9C575D7A,11231,1,12,11,37,49,1899
70160,70160,5B38B567B1C7BA8CD66BEFDF9C575D7A,12083,13,15,2,36,49,1849
70161,70161,5B38B567B1C7BA8CD66BEFDF9C575D7A,11151,17,21,4,30,48,1548
70162,70162,6B06D901D974BEC75E000EB80A1DC6E2,11861,0,7,7,32,47,1647
70163,70163,6B06D901D974BEC75E000EB80A1DC6E2,42151,9,11,2,35,45,1795
70164,70164,6B06D901D974BEC75E000EB80A1DC6E2,42141,14,20,6,32,47,1647
70165,70165,67989E09393EF8E4CA02800849539DBB,11331,1,6,5,37,48,1898
70166,70166,67989E09393EF8E4CA02800849539DBB,11351,8,14,6,36,48,1848
70167,70167,67989E09393EF8E4CA02800849539DBB,11261,14,15,1,36,46,1846
70168,70168,67989E09393EF8E4CA02800849539DBB,42351,16,17,1,38,45,1945
70169,70169,67989E09393EF8E4CA02800849539DBB,11261,18,20,2,36,46,1846
70170,70170,67989E09393EF8E4CA02800849539DBB,10331,20,23,3,39,46,1996
70175,70175,CC542EA3A72441C176DD8B2A582775E3,10251,0,9,9,35,47,1797
70176,70176,CC542EA3A72441C176DD8B2A582775E3,13941,12,14,2,41,47,2097
70177,70177,CC542EA3A72441C176DD8B2A582775E3,10371,14,18,4,37,49,1899
70178,70178,CC542EA3A72441C176DD8B2A582775E3,10411,19,22,3,36,48,1848
70179,70179,28C93346D3A9FF94865CD4FD2489E292,12401,0,5,5,39,49,1999
70180,70180,28C93346D3A9FF94865CD4FD2489E292,42301,7,8,1,36,47,1847
70181,70181,28C93346D3A9FF94865CD4FD2489E292,42511,9,10,1,37,47,1897
70182,70182,28C93346D3A9FF94865CD4FD2489E292,10191,14,23,9,40,48,2048
70183,70183,9A0E1728710A4135A2CED14F55D7DC99,12083,0,1,1,36,49,1849
70184,70184,9A0E1728710A4135A2CED14F55D7DC99,43471,2,9,7,31,49,1599
70185,70185,9A0E1728710A4135A2CED14F55D7DC99,40094,11,18,7,29,48,1498
70186,70186,9A0E1728710A4135A2CED14F55D7DC99,11151,20,23,3,30,48,1548
70191,70191,CDEDDC7EB9BBB406F00B4A47C203F67B,42691,1,2,1,24,48,1248
70192,70192,CDEDDC7EB9BBB406F00B4A47C203F67B,43751,6,8,2,19,48,998
70193,70193,CDEDDC7EB9BBB406F00B4A47C203F67B,12581,8,16,8,24,48,1248
70194,70194,CDEDDC7EB9BBB406F00B4A47C203F67B,43751,18,19,1,19,48,998
70195,70195,71C7D3BEB879651EE771977BC4EF34E5,10341,0,6,6,31,47,1597
70196,70196,71C7D3BEB879651EE771977BC4EF34E5,10634,10,11,1,27,45,1395
70197,70197,71C7D3BEB879651EE771977BC4EF34E5,10351,13,15,2,28,45,1445
70198,70198,71C7D3BEB879651EE771977BC4EF34E5,10341,20,23,3,31,47,1597
70199,70199,E752BE8C76D89879B74771E0026F6236,42091,7,9,2,43,46,2196
70200,70200,E752BE8C76D89879B74771E0026F6236,42111,10,17,7,44,46,2246
70201,70201,E752BE8C76D89879B74771E0026F6236,13951,19,21,2,47,45,2395
70208,70208,5601C1A44CC85C7B09354B38FD0628D1,12311,0,7,7,30,44,1544
70209,70209,5601C1A44CC85C7B09354B38FD0628D1,13731,8,9,1,33,49,1699
70210,70210,5601C1A44CC85C7B09354B38FD0628D1,12311,11,23,12,30,44,1544
70211,70211,3C20A4FB5A5B0FD7EA7A50D0F5C8CA66,12921,1,3,2,9,41,491
70212,70212,3C20A4FB5A5B0FD7EA7A50D0F5C8CA66,12641,3,4,1,10,43,543
70213,70213,3C20A4FB5A5B0FD7EA7A50D0F5C8CA66,12921,6,9,3,9,41,491
70214,70214,3C20A4FB5A5B0FD7EA7A50D0F5C8CA66,12641,9,19,10,10,43,543
70215,70215,3C20A4FB5A5B0FD7EA7A50D0F5C8CA66,12921,20,23,3,9,41,491
70216,70216,9FC39451E6DCCE94D942B7AE2584CFA7,11701,0,7,7,43,48,2198
70217,70217,9FC39451E6DCCE94D942B7AE2584CFA7,10801,8,9,1,42,47,2147
70218,70218,9FC39451E6DCCE94D942B7AE2584CFA7,42321,11,12,1,43,47,2197
70219,70219,9FC39451E6DCCE94D942B7AE2584CFA7,11701,12,13,1,43,48,2198
70220,70220,9FC39451E6DCCE94D942B7AE2584CFA7,42321,14,17,3,43,47,2197
70221,70221,9FC39451E6DCCE94D942B7AE2584CFA7,41392,21,23,2,43,48,2198
70222,70222,195C0B620F9B68C9BF46EA51D613FD24,42511,0,6,6,37,47,1897
70223,70223,195C0B620F9B68C9BF46EA51D613FD24,13711,6,8,2,38,46,1946
70224,70224,195C0B620F9B68C9BF46EA51D613FD24,42511,12,14,2,37,47,1897
70225,70225,195C0B620F9B68C9BF46EA51D613FD24,11631,17,19,2,12,49,649
70226,70226,ED1B197D1A6AAA8BFAE9A2A66FB2A911,19901,0,6,6,7,44,394
70227,70227,ED1B197D1A6AAA8BFAE9A2A66FB2A911,49201,7,9,2,7,41,391
70228,70228,ED1B197D1A6AAA8BFAE9A2A66FB2A911,12921,11,12,1,9,41,491
70229,70229,ED1B197D1A6AAA8BFAE9A2A66FB2A911,49201,16,21,5,7,41,391
70236,70236,6DFA48F81EF42083077B44FC80706865,42161,0,5,5,36,47,1847
70237,70237,6DFA48F81EF42083077B44FC80706865,10161,8,10,2,35,49,1799
70238,70238,6DFA48F81EF42083077B44FC80706865,10971,12,18,6,35,47,1797
70239,70239,6DFA48F81EF42083077B44FC80706865,11201,18,20,2,35,49,1799
70240,70240,6DFA48F81EF42083077B44FC80706865,43161,20,23,3,35,47,1797
70241,70241,7EF8399B7744B26431FFE3070C9BD313,19441,3,6,3,8,46,446
70242,70242,7EF8399B7744B26431FFE3070C9BD313,42041,11,12,1,10,47,547
70243,70243,7EF8399B7744B26431FFE3070C9BD313,19441,13,15,2,8,46,446
70244,70244,7EF8399B7744B26431FFE3070C9BD313,42041,16,17,1,10,47,547
70245,70245,7EF8399B7744B26431FFE3070C9BD313,19441,20,23,3,8,46,446
70246,70246,C493E8EAD829832CA31397E82BE4990B,43021,0,12,12,16,43,843
70247,70247,C493E8EAD829832CA31397E82BE4990B,12921,12,13,1,9,41,491
70248,70248,C493E8EAD829832CA31397E82BE4990B,43021,15,19,4,16,43,843
70252,70252,981FF39DB0050476FC5E5BA7D49F90F5,42864,1,5,4,38,44,1944
70253,70253,981FF39DB0050476FC5E5BA7D49F90F5,11261,7,10,3,36,46,1846
70254,70254,981FF39DB0050476FC5E5BA7D49F90F5,42864,14,16,2,38,44,1944
70255,70255,981FF39DB0050476FC5E5BA7D49F90F5,11261,17,18,1,36,46,1846
70256,70256,981FF39DB0050476FC5E5BA7D49F90F5,42861,19,20,1,37,44,1894
70260,70260,9CD240854124665887C6D458FF6AE3B7,11324,0,13,13,31,46,1596
70261,70261,9CD240854124665887C6D458FF6AE3B7,40341,14,16,2,23,49,1199
70262,70262,9CD240854124665887C6D458FF6AE3B7,11324,18,23,5,31,46,1596
70263,70263,C187943D20D187183526E0228C45660E,11021,0,7,7,36,49,1849
70264,70264,C187943D20D187183526E0228C45660E,40034,12,15,3,32,48,1648
70265,70265,C187943D20D187183526E0228C45660E,11021,19,23,4,36,49,1849
70273,70273,F0D6A0DD95FECBA9B8057DD90C2A5CED,11381,0,2,2,30,47,1547
70274,70274,F0D6A0DD95FECBA9B8057DD90C2A5CED,10681,2,8,6,30,48,1548
70275,70275,F0D6A0DD95FECBA9B8057DD90C2A5CED,11061,10,11,1,29,48,1498
70276,70276,F0D6A0DD95FECBA9B8057DD90C2A5CED,10681,12,13,1,30,48,1548
70277,70277,F0D6A0DD95FECBA9B8057DD90C2A5CED,11061,17,18,1,29,48,1498
70278,70278,F0D6A0DD95FECBA9B8057DD90C2A5CED,10681,19,20,1,30,48,1548
70279,70279,F0D6A0DD95FECBA9B8057DD90C2A5CED,11061,21,22,1,29,48,1498
70283,70283,F2457E810B67D341A15B778C704B1944,11361,0,1,1,22,48,1148
70284,70284,F2457E810B67D341A15B778C704B1944,43751,1,3,2,19,48,998
70285,70285,F2457E810B67D341A15B778C704B1944,12581,5,12,7,24,48,1248
70286,70286,F2457E810B67D341A15B778C704B1944,11101,20,21,1,18,48,948
70287,70287,F2457E810B67D341A15B778C704B1944,10501,22,23,1,22,46,1146
70288,70288,CAF83309DC5164BDCFC4AF3B395E1D5C,10841,1,10,9,37,47,1897
70289,70289,CAF83309DC5164BDCFC4AF3B395E1D5C,11861,15,18,3,32,47,1647
70290,70290,CAF83309DC5164BDCFC4AF3B395E1D5C,10841,21,23,2,37,47,1897
70291,70291,394B81CC36B31D897120A6153D7C1457,11061,0,2,2,29,48,1498
70292,70292,394B81CC36B31D897120A6153D7C1457,11431,6,7,1,29,47,1497
70293,70293,394B81CC36B31D897120A6153D7C1457,42501,9,11,2,28,47,1447
70294,70294,394B81CC36B31D897120A6153D7C1457,12121,12,14,2,29,47,1497
70295,70295,394B81CC36B31D897120A6153D7C1457,11061,18,20,2,29,48,1498
70296,70296,E02F64059E677B81EAF8B96D760DDB0F,15143,1,7,6,18,7,907
70297,70297,E02F64059E677B81EAF8B96D760DDB0F,16281,8,12,4,11,4,554
70298,70298,E02F64059E677B81EAF8B96D760DDB0F,15143,14,17,3,18,7,907
70299,70299,E02F64059E677B81EAF8B96D760DDB0F,16281,18,23,5,11,4,554
70300,70300,06DA10A5127707E5C949D4A6A9073869,42531,0,6,6,31,45,1595
70301,70301,06DA10A5127707E5C949D4A6A9073869,42871,6,13,7,30,45,1545
70302,70302,06DA10A5127707E5C949D4A6A9073869,10301,14,15,1,31,45,1595
70303,70303,06DA10A5127707E5C949D4A6A9073869,42871,15,17,2,30,45,1545
70304,70304,06DA10A5127707E5C949D4A6A9073869,42531,17,19,2,31,45,1595
70305,70305,06DA10A5127707E5C949D4A6A9073869,12311,19,22,3,30,44,1544
70324,70324,B74B3DCD8F19C67166A66D0048B31F03,13331,0,7,7,38,47,1947
70325,70325,B74B3DCD8F19C67166A66D0048B31F03,13711,8,10,2,38,46,1946
70326,70326,B74B3DCD8F19C67166A66D0048B31F03,11231,11,13,2,37,49,1899
70327,70327,B74B3DCD8F19C67166A66D0048B31F03,13711,15,17,2,38,46,1946
70328,70328,B74B3DCD8F19C67166A66D0048B31F03,41401,19,20,1,37,46,1896
70335,70335,6B614428F8D95ECFDE2207017437E97D,19281,0,5,5,16,32,832
70336,70336,6B614428F8D95ECFDE2207017437E97D,12871,8,13,5,22,33,1133
70337,70337,6B614428F8D95ECFDE2207017437E97D,19281,13,23,10,16,32,832
70338,70338,F8A2EC8C9348BFB1362087B807B825C5,43971,0,7,7,30,48,1548
70339,70339,F8A2EC8C9348BFB1362087B807B825C5,40271,8,17,9,35,49,1799
70340,70340,F8A2EC8C9348BFB1362087B807B825C5,43971,19,21,2,30,48,1548
70341,70341,F8A2EC8C9348BFB1362087B807B825C5,43761,21,22,1,32,47,1647
70342,70342,28EBDF129D422CC62555B67FAF051D3A,42921,0,7,7,33,47,1697
70343,70343,28EBDF129D422CC62555B67FAF051D3A,10901,8,13,5,35,48,1798
70344,70344,28EBDF129D422CC62555B67FAF051D3A,11231,14,15,1,37,49,1899
70345,70345,28EBDF129D422CC62555B67FAF051D3A,43761,19,22,3,32,47,1647
70346,70346,666C6474C859B034AE49BB5E91C01140,42633,0,7,7,42,46,2146
70347,70347,666C6474C859B034AE49BB5E91C01140,11771,8,10,2,39,49,1999
70348,70348,666C6474C859B034AE49BB5E91C01140,11281,12,13,1,27,40,1390
70349,70349,666C6474C859B034AE49BB5E91C01140,11771,17,18,1,39,49,1999
70350,70350,666C6474C859B034AE49BB5E91C01140,42633,20,23,3,42,46,2146
70357,70357,6AD981E757B177FB5B64F1D1D2EAA27F,12651,1,8,7,43,47,2197
70358,70358,6AD981E757B177FB5B64F1D1D2EAA27F,42961,9,14,5,35,49,1799
70359,70359,6AD981E757B177FB5B64F1D1D2EAA27F,10491,17,18,1,33,48,1698
70360,70360,FCD017DA96D35849C76561036D34B0CB,11641,0,6,6,22,49,1149
70361,70361,FCD017DA96D35849C76561036D34B0CB,43751,7,9,2,19,48,998
70362,70362,FCD017DA96D35849C76561036D34B0CB,11641,12,13,1,22,49,1149
70363,70363,FCD017DA96D35849C76561036D34B0CB,43751,15,17,2,19,48,998
70364,70364,FCD017DA96D35849C76561036D34B0CB,42481,20,22,2,22,49,1149
70376,70376,494B444F0049F1B11EE9933CF89C0C3A,13341,0,11,11,44,45,2245
70377,70377,494B444F0049F1B11EE9933CF89C0C3A,13651,13,14,1,30,47,1547
70378,70378,494B444F0049F1B11EE9933CF89C0C3A,40941,15,16,1,32,48,1648
70379,70379,494B444F0049F1B11EE9933CF89C0C3A,13341,17,23,6,44,45,2245
70380,70380,30EC1F807EEC306D244EB53BC8B7C8C8,40941,0,7,7,32,48,1648
70381,70381,30EC1F807EEC306D244EB53BC8B7C8C8,40302,8,9,1,40,49,2049
70382,70382,30EC1F807EEC306D244EB53BC8B7C8C8,40941,12,14,2,32,48,1648
70383,70383,30EC1F807EEC306D244EB53BC8B7C8C8,40302,14,15,1,40,49,2049
70384,70384,30EC1F807EEC306D244EB53BC8B7C8C8,11171,20,23,3,33,48,1698
70391,70391,0B302A96FA0DFDEB2B3F6999345F0CFE,12381,0,2,2,32,48,1648
70392,70392,0B302A96FA0DFDEB2B3F6999345F0CFE,12311,12,14,2,30,44,1544
70393,70393,0B302A96FA0DFDEB2B3F6999345F0CFE,12661,17,18,1,32,45,1645
70400,70400,924C94FEA337955066B022FCC7607D38,11361,1,2,1,22,48,1148
70401,70401,924C94FEA337955066B022FCC7607D38,12581,3,5,2,24,48,1248
70402,70402,924C94FEA337955066B022FCC7607D38,11361,9,11,2,22,48,1148
70403,70403,924C94FEA337955066B022FCC7607D38,12581,11,20,9,24,48,1248
70404,70404,924C94FEA337955066B022FCC7607D38,11361,20,22,2,22,48,1148
70405,70405,AA9DDBAE747C0C61A76E689DD898E315,42301,0,6,6,36,47,1847
70406,70406,AA9DDBAE747C0C61A76E689DD898E315,12311,7,15,8,30,44,1544
70407,70407,AA9DDBAE747C0C61A76E689DD898E315,11875,15,18,3,30,46,1546
70408,70408,AA9DDBAE747C0C61A76E689DD898E315,42301,18,23,5,36,47,1847
70409,70409,966592CD48E24DD17B5B9C8B94D59F8F,19261,0,6,6,6,37,337
70410,70410,966592CD48E24DD17B5B9C8B94D59F8F,19741,8,16,8,5,44,294
70411,70411,966592CD48E24DD17B5B9C8B94D59F8F,12971,18,23,5,32,48,1648
70412,70412,9F7BD4B191C6CDB262073FE9BC5F12C5,11381,1,2,1,30,47,1547
70413,70413,9F7BD4B191C6CDB262073FE9BC5F12C5,11061,6,8,2,29,48,1498
70414,70414,9F7BD4B191C6CDB262073FE9BC5F12C5,11381,9,19,10,30,47,1547
70415,70415,9F7BD4B191C6CDB262073FE9BC5F12C5,11491,21,23,2,36,47,1847
70427,70427,64670A0AA34CA99040A17830BE4514C3,11261,6,7,1,36,46,1846
70428,70428,64670A0AA34CA99040A17830BE4514C3,42864,8,9,1,38,44,1944
70429,70429,64670A0AA34CA99040A17830BE4514C3,11261,13,20,7,36,46,1846
70430,70430,64670A0AA34CA99040A17830BE4514C3,12211,22,23,1,41,44,2094
70431,70431,C6AC8895632679A119F682F1B4D03E3B,42281,0,7,7,40,48,2048
70432,70432,C6AC8895632679A119F682F1B4D03E3B,19114,9,21,12,7,43,393
70433,70433,C6AC8895632679A119F682F1B4D03E3B,19741,21,23,2,5,44,294
70434,70434,CCE6FF71F1C58ADC8D7C29AFD1955DDD,12601,0,8,8,25,47,1297
70435,70435,CCE6FF71F1C58ADC8D7C29AFD1955DDD,10634,8,9,1,27,45,1395
70436,70436,CCE6FF71F1C58ADC8D7C29AFD1955DDD,10351,11,13,2,28,45,1445
70437,70437,CCE6FF71F1C58ADC8D7C29AFD1955DDD,12601,17,23,6,25,47,1297
70438,70438,400659CE2E6F8BFF6D95D6F52F73DF5B,42921,0,5,5,33,47,1697
70439,70439,400659CE2E6F8BFF6D95D6F52F73DF5B,11861,6,11,5,32,47,1647
70440,70440,400659CE2E6F8BFF6D95D6F52F73DF5B,42921,12,13,1,33,47,1697
70441,70441,400659CE2E6F8BFF6D95D6F52F73DF5B,11861,14,19,5,32,47,1647
70442,70442,400659CE2E6F8BFF6D95D6F52F73DF5B,42921,19,23,4,33,47,1697
70443,70443,D1B681929BD44A1A7918A0268A3E43F0,12641,0,4,4,10,43,543
70444,70444,D1B681929BD44A1A7918A0268A3E43F0,43021,7,13,6,16,43,843
70445,70445,D1B681929BD44A1A7918A0268A3E43F0,12641,13,18,5,10,43,543
70446,70446,D1B681929BD44A1A7918A0268A3E43F0,19181,21,23,2,8,40,440
70454,70454,559777BBBCD664850DC1E8E7503633C6,11861,0,2,2,32,47,1647
70455,70455,559777BBBCD664850DC1E8E7503633C6,10351,3,13,10,28,45,1445
70456,70456,559777BBBCD664850DC1E8E7503633C6,10301,17,18,1,31,45,1595
70461,70461,D59A7D67E6A2D306517724C5A50D5385,10351,0,5,5,28,45,1445
70462,70462,D59A7D67E6A2D306517724C5A50D5385,42531,9,10,1,31,45,1595
70463,70463,D59A7D67E6A2D306517724C5A50D5385,10351,13,14,1,28,45,1445
70464,70464,D59A7D67E6A2D306517724C5A50D5385,42531,17,19,2,31,45,1595
70465,70465,D59A7D67E6A2D306517724C5A50D5385,10351,19,21,2,28,45,1445
70473,70473,39BBEF64C110B28293452839586DC4E1,10531,0,8,8,34,46,1746
70474,70474,39BBEF64C110B28293452839586DC4E1,13381,11,15,4,39,47,1997
70475,70475,39BBEF64C110B28293452839586DC4E1,10151,16,23,7,34,47,1747
70476,70476,13442D9CC8FCCC718EDB9D3EAB7825ED,11541,0,11,11,35,49,1799
70477,70477,13442D9CC8FCCC718EDB9D3EAB7825ED,10881,14,16,2,34,48,1748
70478,70478,13442D9CC8FCCC718EDB9D3EAB7825ED,40431,17,19,2,36,47,1847
70479,70479,13442D9CC8FCCC718EDB9D3EAB7825ED,10351,21,23,2,28,45,1445
70480,70480,33BB1FBC807A18D7B763AE4B57056758,13314,0,14,14,31,39,1589
70481,70481,33BB1FBC807A18D7B763AE4B57056758,12521,15,19,4,35,41,1791
70482,70482,33BB1FBC807A18D7B763AE4B57056758,13314,22,23,1,31,39,1589
70486,70486,93E2DE921E47D3798DC5D4DD35FE7A3F,10801,0,9,9,42,47,2147
70487,70487,93E2DE921E47D3798DC5D4DD35FE7A3F,13371,12,18,6,41,47,2097
70488,70488,93E2DE921E47D3798DC5D4DD35FE7A3F,10801,19,21,2,42,47,2147
70489,70489,93E2DE921E47D3798DC5D4DD35FE7A3F,43621,21,23,2,46,48,2348
70490,70490,ACC988BC7C7C8AB1A0A907CFDFB620E6,10451,0,15,15,25,48,1298
70491,70491,ACC988BC7C7C8AB1A0A907CFDFB620E6,40171,19,21,2,38,48,1948
70492,70492,ACC988BC7C7C8AB1A0A907CFDFB620E6,10451,21,23,2,25,48,1298
70500,70500,FBD410ECA90E3AA6B412199F9EA19C86,12083,0,8,8,36,49,1849
70501,70501,FBD410ECA90E3AA6B412199F9EA19C86,42521,14,16,2,31,47,1597
70502,70502,FBD410ECA90E3AA6B412199F9EA19C86,12083,20,23,3,36,49,1849
70509,70509,5A31AA15CC197C9237A9A16B14069CB4,43581,0,7,7,33,48,1698
70510,70510,5A31AA15CC197C9237A9A16B14069CB4,10921,15,17,2,43,48,2198
70511,70511,5A31AA15CC197C9237A9A16B14069CB4,43581,21,23,2,33,48,1698
70512,70512,4FB7544A1E67AE742452DB3735E5F7CF,13111,0,3,3,42,46,2146
70513,70513,4FB7544A1E67AE742452DB3735E5F7CF,10771,3,5,2,41,46,2096
70514,70514,4FB7544A1E67AE742452DB3735E5F7CF,13111,5,6,1,42,46,2146
70515,70515,4FB7544A1E67AE742452DB3735E5F7CF,43951,7,8,1,49,41,2491
70516,70516,4FB7544A1E67AE742452DB3735E5F7CF,13341,14,16,2,44,45,2245
70517,70517,4FB7544A1E67AE742452DB3735E5F7CF,13111,21,22,1,42,46,2146
70518,70518,169A49D404C7EB2E941D9568D85D1AFD,13371,2,11,9,41,47,2097
70519,70519,169A49D404C7EB2E941D9568D85D1AFD,10107,13,15,2,38,49,1949
70520,70520,169A49D404C7EB2E941D9568D85D1AFD,15114,19,22,3,22,16,1116
70524,70524,1C7E94D55EEEDFD690B2FBD89FA459D0,11521,0,2,2,41,48,2098
70525,70525,1C7E94D55EEEDFD690B2FBD89FA459D0,10251,2,10,8,35,47,1797
70526,70526,1C7E94D55EEEDFD690B2FBD89FA459D0,42491,10,11,1,32,46,1646
70527,70527,1C7E94D55EEEDFD690B2FBD89FA459D0,43361,18,20,2,38,48,1948
70528,70528,1C7E94D55EEEDFD690B2FBD89FA459D0,11521,20,23,3,41,48,2098
70538,70538,1C1BDEE72C59AB3D15F95F838C21E5AB,19441,0,5,5,8,46,446
70539,70539,1C1BDEE72C59AB3D15F95F838C21E5AB,12621,7,10,3,10,48,548
70540,70540,1C1BDEE72C59AB3D15F95F838C21E5AB,19441,11,13,2,8,46,446
70541,70541,1C1BDEE72C59AB3D15F95F838C21E5AB,19821,17,18,1,4,46,246
70542,70542,1C1BDEE72C59AB3D15F95F838C21E5AB,19441,19,22,3,8,46,446
70543,70543,24CACD73BA8D75767DDD668E5EA165E2,40171,0,6,6,38,48,1948
70544,70544,24CACD73BA8D75767DDD668E5EA165E2,11914,9,11,2,37,48,1898
70545,70545,24CACD73BA8D75767DDD668E5EA165E2,42191,12,13,1,38,49,1949
70546,70546,24CACD73BA8D75767DDD668E5EA165E2,11914,13,18,5,37,48,1898
70547,70547,24CACD73BA8D75767DDD668E5EA165E2,42191,21,23,2,38,49,1949
70551,70551,E6E1B072EE7202225510F5B63E9E6AA7,42221,4,5,1,38,48,1948
70552,70552,E6E1B072EE7202225510F5B63E9E6AA7,42121,8,11,3,26,49,1349
70553,70553,E6E1B072EE7202225510F5B63E9E6AA7,40341,15,17,2,23,49,1199
70554,70554,E6E1B072EE7202225510F5B63E9E6AA7,11914,21,22,1,37,48,1898
70563,70563,D2B8716D34A46618978AE776619FC5DF,42301,0,8,8,36,47,1847
70564,70564,D2B8716D34A46618978AE776619FC5DF,13471,10,11,1,47,49,2399
70565,70565,D2B8716D34A46618978AE776619FC5DF,10111,12,13,1,37,47,1897
70566,70566,D2B8716D34A46618978AE776619FC5DF,10251,17,18,1,35,47,1797
70567,70567,D2B8716D34A46618978AE776619FC5DF,40637,19,23,4,36,47,1847
70568,70568,823BB637426A4B64F4A56D087D45C241,12641,2,3,1,10,43,543
70569,70569,823BB637426A4B64F4A56D087D45C241,49201,3,6,3,7,41,391
70570,70570,823BB637426A4B64F4A56D087D45C241,12921,8,9,1,9,41,491
70571,70571,823BB637426A4B64F4A56D087D45C241,12641,12,13,1,10,43,543
70572,70572,823BB637426A4B64F4A56D087D45C241,49201,14,16,2,7,41,391
70573,70573,823BB637426A4B64F4A56D087D45C241,12921,17,20,3,9,41,491
70577,70577,BA6468A84C81B4949B332F392AF7BE2D,40833,2,9,7,41,47,2097
70578,70578,BA6468A84C81B4949B332F392AF7BE2D,12311,12,14,2,30,44,1544
70579,70579,BA6468A84C81B4949B332F392AF7BE2D,13101,16,18,2,40,47,2047
70580,70580,6428FC1D2F17D8BB440D0F9FCA04C935,13911,0,6,6,39,46,1996
70581,70581,6428FC1D2F17D8BB440D0F9FCA04C935,11261,11,12,1,36,46,1846
70582,70582,6428FC1D2F17D8BB440D0F9FCA04C935,42231,14,15,1,37,46,1896
70583,70583,6428FC1D2F17D8BB440D0F9FCA04C935,42351,15,16,1,38,45,1945
70584,70584,6428FC1D2F17D8BB440D0F9FCA04C935,13911,18,19,1,39,46,1996
70585,70585,6428FC1D2F17D8BB440D0F9FCA04C935,42351,20,22,2,38,45,1945
70586,70586,5D9A09786F570CED3C296C81274238B5,12521,0,5,5,35,41,1791
70587,70587,5D9A09786F570CED3C296C81274238B5,13314,5,7,2,31,39,1589
70588,70588,5D9A09786F570CED3C296C81274238B5,12521,7,23,16,35,41,1791
70589,70589,5EF7E68928329842CB67D20FA9512ADE,43481,1,6,5,39,48,1998
70590,70590,5EF7E68928329842CB67D20FA9512ADE,12514,8,10,2,38,47,1947
70591,70591,5EF7E68928329842CB67D20FA9512ADE,43481,13,15,2,39,48,1998
70592,70592,5EF7E68928329842CB67D20FA9512ADE,12514,15,16,1,38,47,1947
70593,70593,5EF7E68928329842CB67D20FA9512ADE,42031,20,22,2,40,46,2046
70598,70598,16D740AE27D92BE968DE244652195181,13671,4,8,4,27,43,1393
70599,70599,16D740AE27D92BE968DE244652195181,12671,12,13,1,21,43,1093
70600,70600,16D740AE27D92BE968DE244652195181,13671,16,18,2,27,43,1393
70601,70601,16D740AE27D92BE968DE244652195181,13314,22,23,1,31,39,1589
70605,70605,1463E9838EB11802DBC75E65276D110F,12521,10,17,7,35,41,1791
70606,70606,1463E9838EB11802DBC75E65276D110F,12661,19,20,1,32,45,1645
70607,70607,1463E9838EB11802DBC75E65276D110F,42531,21,22,1,31,45,1595
70608,70608,DC9866094212A637CCAC17CF01FE4B5F,42861,0,5,5,37,44,1894
70609,70609,DC9866094212A637CCAC17CF01FE4B5F,11261,7,10,3,36,46,1846
70610,70610,DC9866094212A637CCAC17CF01FE4B5F,42861,10,11,1,37,44,1894
70611,70611,DC9866094212A637CCAC17CF01FE4B5F,11261,13,18,5,36,46,1846
70612,70612,DC9866094212A637CCAC17CF01FE4B5F,42861,18,23,5,37,44,1894
70613,70613,9758D80D2BEA42E4CD5500C45A8AE915,10801,0,10,10,42,47,2147
70614,70614,9758D80D2BEA42E4CD5500C45A8AE915,10971,12,13,1,35,47,1797
70615,70615,9758D80D2BEA42E4CD5500C45A8AE915,11151,21,23,2,30,48,1548
70624,70624,39A12A7E8C423731CE90191A15A5C3F4,43021,0,6,6,16,43,843
70625,70625,39A12A7E8C423731CE90191A15A5C3F4,12641,9,13,4,10,43,543
70626,70626,39A12A7E8C423731CE90191A15A5C3F4,43021,13,14,1,16,43,843
70627,70627,39A12A7E8C423731CE90191A15A5C3F4,12921,15,19,4,9,41,491
70628,70628,42450E4607B078BD3F39C67BF93F8737,11111,2,8,6,26,48,1348
70629,70629,42450E4607B078BD3F39C67BF93F8737,10451,9,10,1,25,48,1298
70630,70630,42450E4607B078BD3F39C67BF93F8737,10107,13,14,1,38,49,1949
70631,70631,42450E4607B078BD3F39C67BF93F8737,10451,18,21,3,25,48,1298
70635,70635,6B4D51A4231E697456281435F5175150,13841,0,8,8,40,46,2046
70636,70636,6B4D51A4231E697456281435F5175150,43341,11,14,3,41,46,2096
70637,70637,6B4D51A4231E697456281435F5175150,10331,16,17,1,39,46,1996
70638,70638,6B4D51A4231E697456281435F5175150,13841,18,21,3,40,46,2046
70639,70639,6B4D51A4231E697456281435F5175150,10911,21,22,1,39,46,1996
70646,70646,A486521758A27268CCD3905C2122B6F8,42161,0,9,9,36,47,1847
70647,70647,A486521758A27268CCD3905C2122B6F8,19811,11,12,1,10,34,534
70648,70648,A486521758A27268CCD3905C2122B6F8,42161,15,17,2,36,47,1847
70649,70649,A486521758A27268CCD3905C2122B6F8,11861,19,22,3,32,47,1647
70650,70650,A486521758A27268CCD3905C2122B6F8,42161,22,23,1,36,47,1847
70651,70651,4A1E2DF13E9399DEAE7966E1EFE6FC6B,11481,0,4,4,41,48,2098
70652,70652,4A1E2DF13E9399DEAE7966E1EFE6FC6B,42151,6,17,11,35,45,1795
70653,70653,4A1E2DF13E9399DEAE7966E1EFE6FC6B,11481,21,22,1,41,48,2098
70658,70658,00ED2280FB2BEC22D8FB36F8A7AFB1A5,42791,0,8,8,35,45,1795
70659,70659,00ED2280FB2BEC22D8FB36F8A7AFB1A5,10271,8,10,2,37,46,1896
70660,70660,00ED2280FB2BEC22D8FB36F8A7AFB1A5,13121,14,15,1,38,46,1946
70661,70661,00ED2280FB2BEC22D8FB36F8A7AFB1A5,10271,16,18,2,37,46,1896
70662,70662,00ED2280FB2BEC22D8FB36F8A7AFB1A5,13711,18,19,1,38,46,1946
70663,70663,0FCEEFFD7B0523F1BDB598915EAAE9D9,40302,0,5,5,40,49,2049
70664,70664,0FCEEFFD7B0523F1BDB598915EAAE9D9,10431,10,11,1,33,49,1699
70665,70665,0FCEEFFD7B0523F1BDB598915EAAE9D9,41591,11,20,9,34,49,1749
70666,70666,46FBB102C6B8DD3727737A749B2D8106,42921,1,8,7,33,47,1697
70667,70667,46FBB102C6B8DD3727737A749B2D8106,12131,8,12,4,32,47,1647
70668,70668,46FBB102C6B8DD3727737A749B2D8106,42371,12,13,1,34,46,1746
70669,70669,46FBB102C6B8DD3727737A749B2D8106,42921,14,15,1,33,47,1697
70670,70670,46FBB102C6B8DD3727737A749B2D8106,42371,15,23,8,34,46,1746
70674,70674,8CD5156CF883DA15618BAFE58DDCF2A7,42581,3,8,5,38,48,1948
70675,70675,8CD5156CF883DA15618BAFE58DDCF2A7,11914,9,15,6,37,48,1898
70676,70676,8CD5156CF883DA15618BAFE58DDCF2A7,42581,15,16,1,38,48,1948
70677,70677,8CD5156CF883DA15618BAFE58DDCF2A7,11914,17,18,1,37,48,1898
70678,70678,8CD5156CF883DA15618BAFE58DDCF2A7,42581,20,23,3,38,48,1948
70679,70679,CC06B39421E630BF724D00DE65DABB6E,43751,0,4,4,19,48,998
70680,70680,CC06B39421E630BF724D00DE65DABB6E,12581,7,9,2,24,48,1248
70681,70681,CC06B39421E630BF724D00DE65DABB6E,43751,11,13,2,19,48,998
70682,70682,CC06B39421E630BF724D00DE65DABB6E,12581,16,19,3,24,48,1248
70683,70683,CC06B39421E630BF724D00DE65DABB6E,43751,21,23,2,19,48,998
70684,70684,D7349708A10855AEF98FEB8D22C33E59,13271,0,7,7,41,47,2097
70685,70685,D7349708A10855AEF98FEB8D22C33E59,11231,8,17,9,37,49,1899
70686,70686,D7349708A10855AEF98FEB8D22C33E59,13271,19,22,3,41,47,2097
70690,70690,1FF51BEDE1EE107E389C5F3436ED1FEC,42864,0,9,9,38,44,1944
70691,70691,1FF51BEDE1EE107E389C5F3436ED1FEC,42081,11,13,2,24,49,1249
70692,70692,1FF51BEDE1EE107E389C5F3436ED1FEC,40341,14,16,2,23,49,1199
70693,70693,1FF51BEDE1EE107E389C5F3436ED1FEC,42864,17,22,5,38,44,1944
70697,70697,E85441693EFC4527ACD20D018FFC1F78,42961,0,7,7,35,49,1799
70698,70698,E85441693EFC4527ACD20D018FFC1F78,42501,8,17,9,28,47,1447
70699,70699,E85441693EFC4527ACD20D018FFC1F78,12021,19,22,3,37,49,1899
70700,70700,4B5C492CF16B079882322240829D6566,11231,0,7,7,37,49,1899
70701,70701,4B5C492CF16B079882322240829D6566,10471,7,8,1,37,48,1898
70702,70702,4B5C492CF16B079882322240829D6566,11231,13,15,2,37,49,1899
70703,70703,4B5C492CF16B079882322240829D6566,10471,16,18,2,37,48,1898
70704,70704,4B5C492CF16B079882322240829D6566,11231,21,22,1,37,49,1899
70712,70712,A36FC51CF8D96EF7C4D42DADD5566352,15391,6,7,1,35,26,1776
70713,70713,A36FC51CF8D96EF7C4D42DADD5566352,12792,7,8,1,34,30,1730
70714,70714,A36FC51CF8D96EF7C4D42DADD5566352,15091,12,13,1,35,26,1776
70715,70715,A36FC51CF8D96EF7C4D42DADD5566352,43121,16,18,2,25,27,1277
70716,70716,A36FC51CF8D96EF7C4D42DADD5566352,12792,22,23,1,34,30,1730
70717,70717,F06696253146EEBB7842F43A19CD992F,12871,0,6,6,22,33,1133
70718,70718,F06696253146EEBB7842F43A19CD992F,19801,7,8,1,19,26,976
70719,70719,F06696253146EEBB7842F43A19CD992F,43121,9,10,1,25,27,1277
70720,70720,F06696253146EEBB7842F43A19CD992F,15184,14,15,1,29,22,1472
70721,70721,F06696253146EEBB7842F43A19CD992F,19801,19,21,2,19,26,976
70722,70722,11D0C3BFA1EEA48E71CAB72BD84A5D2F,13671,1,4,3,27,43,1393
70723,70723,11D0C3BFA1EEA48E71CAB72BD84A5D2F,10711,4,6,2,29,46,1496
70724,70724,11D0C3BFA1EEA48E71CAB72BD84A5D2F,10351,11,14,3,28,45,1445
70725,70725,11D0C3BFA1EEA48E71CAB72BD84A5D2F,10634,18,19,1,27,45,1395
70726,70726,11D0C3BFA1EEA48E71CAB72BD84A5D2F,10351,20,23,3,28,45,1445
70727,70727,3B86E1CB99F9A063FEA255A004EE193F,11261,0,1,1,36,46,1846
70728,70728,3B86E1CB99F9A063FEA255A004EE193F,42864,2,5,3,38,44,1944
70729,70729,3B86E1CB99F9A063FEA255A004EE193F,11261,10,19,9,36,46,1846
70730,70730,3B86E1CB99F9A063FEA255A004EE193F,12311,21,23,2,30,44,1544
70734,70734,945C433E7EC858F8A3B3DD3CBC284459,42511,0,1,1,37,47,1897
70735,70735,945C433E7EC858F8A3B3DD3CBC284459,13461,2,4,2,39,44,1994
70736,70736,945C433E7EC858F8A3B3DD3CBC284459,43241,4,7,3,36,46,1846
70737,70737,945C433E7EC858F8A3B3DD3CBC284459,11081,8,10,2,35,46,1796
70738,70738,945C433E7EC858F8A3B3DD3CBC284459,13651,12,15,3,30,47,1547
70739,70739,945C433E7EC858F8A3B3DD3CBC284459,12021,20,21,1,37,49,1899
70740,70740,F004825C5EEC7F8B7A184D4985895C55,13341,0,6,6,44,45,2245
70741,70741,F004825C5EEC7F8B7A184D4985895C55,42631,8,10,2,43,45,2195
70742,70742,F004825C5EEC7F8B7A184D4985895C55,13341,11,13,2,44,45,2245
70743,70743,F004825C5EEC7F8B7A184D4985895C55,42631,13,16,3,43,45,2195
70744,70744,F004825C5EEC7F8B7A184D4985895C55,13341,20,22,2,44,45,2245
70745,70745,8436FA510D59B3814E50B7F18BD1D92C,19571,10,12,2,1,36,86
70746,70746,8436FA510D59B3814E50B7F18BD1D92C,12641,16,18,2,10,43,543
70747,70747,8436FA510D59B3814E50B7F18BD1D92C,19571,19,23,4,1,36,86
70748,70748,4EAEA07A12B611EF65EDB5896F86C5E3,42151,4,5,1,35,45,1795
70749,70749,4EAEA07A12B611EF65EDB5896F86C5E3,42531,7,12,5,31,45,1595
70750,70750,4EAEA07A12B611EF65EDB5896F86C5E3,11321,13,15,2,31,46,1596
70751,70751,4EAEA07A12B611EF65EDB5896F86C5E3,42531,18,22,4,31,45,1595
70752,70752,3F29D0D409D1B6D4E7D2087740FD0BBC,10491,1,7,6,33,48,1698
70753,70753,3F29D0D409D1B6D4E7D2087740FD0BBC,10251,8,9,1,35,47,1797
70754,70754,3F29D0D409D1B6D4E7D2087740FD0BBC,40697,14,16,2,43,48,2198
70755,70755,3F29D0D409D1B6D4E7D2087740FD0BBC,11731,20,23,3,36,48,1848
70756,70756,16555A55644E33BD3176F1C346ED0657,11351,0,7,7,36,48,1848
70757,70757,16555A55644E33BD3176F1C346ED0657,10841,8,12,4,37,47,1897
70758,70758,16555A55644E33BD3176F1C346ED0657,11351,13,14,1,36,48,1848
70759,70759,16555A55644E33BD3176F1C346ED0657,11151,21,23,2,30,48,1548
70760,70760,D4EEB41F9DCFA5F5AD327647250F501D,42623,10,11,1,22,49,1149
70761,70761,D4EEB41F9DCFA5F5AD327647250F501D,43471,13,14,1,31,49,1599
70762,70762,D4EEB41F9DCFA5F5AD327647250F501D,42623,17,19,2,22,49,1149
70763,70763,376DDDFE24216F652E9CDE9E324BF6F4,11061,0,1,1,29,48,1498
70764,70764,376DDDFE24216F652E9CDE9E324BF6F4,10544,3,9,6,28,48,1448
70765,70765,376DDDFE24216F652E9CDE9E324BF6F4,10107,11,12,1,38,49,1949
70766,70766,376DDDFE24216F652E9CDE9E324BF6F4,10544,12,23,11,28,48,1448
70767,70767,8754D75561ECA9632B70CECEA43ED98F,43021,0,8,8,16,43,843
70768,70768,8754D75561ECA9632B70CECEA43ED98F,11491,11,13,2,36,47,1847
70769,70769,8754D75561ECA9632B70CECEA43ED98F,10471,13,23,10,37,48,1898
70774,70774,1C0548F40841AD0870DAD8EC7BECCBC6,13314,0,7,7,31,39,1589
70775,70775,1C0548F40841AD0870DAD8EC7BECCBC6,12521,7,9,2,35,41,1791
70776,70776,1C0548F40841AD0870DAD8EC7BECCBC6,13314,11,13,2,31,39,1589
70777,70777,1C0548F40841AD0870DAD8EC7BECCBC6,12521,13,15,2,35,41,1791
70778,70778,1C0548F40841AD0870DAD8EC7BECCBC6,13314,17,23,6,31,39,1589
70783,70783,E648A6F090A3BE85617E0ED54A73B4F0,12601,0,3,3,25,47,1297
70784,70784,E648A6F090A3BE85617E0ED54A73B4F0,12671,3,6,3,21,43,1093
70785,70785,E648A6F090A3BE85617E0ED54A73B4F0,12601,7,23,16,25,47,1297
70786,70786,3C07D1557002BF4F1AA6A6D7A8949EF2,42523,0,5,5,31,47,1597
70787,70787,3C07D1557002BF4F1AA6A6D7A8949EF2,12601,8,16,8,25,47,1297
70788,70788,3C07D1557002BF4F1AA6A6D7A8949EF2,43761,20,22,2,32,47,1647
70792,70792,2F66AC01887397A198C9CCA6611EA97B,12521,0,13,13,35,41,1791
70793,70793,2F66AC01887397A198C9CCA6611EA97B,13314,14,15,1,31,39,1589
70794,70794,2F66AC01887397A198C9CCA6611EA97B,12521,17,23,6,35,41,1791
70795,70795,62A4DF59E8BCEC0DCF6C971E2D9209AC,42471,9,11,2,35,49,1799
70796,70796,62A4DF59E8BCEC0DCF6C971E2D9209AC,11021,12,17,5,36,49,1849
70797,70797,62A4DF59E8BCEC0DCF6C971E2D9209AC,10271,19,20,1,37,46,1896
70798,70798,E9D770EEFB01329DD324302189C0C476,11061,0,1,1,29,48,1498
70799,70799,E9D770EEFB01329DD324302189C0C476,11151,2,12,10,30,48,1548
70800,70800,E9D770EEFB01329DD324302189C0C476,11061,12,16,4,29,48,1498
70801,70801,E9D770EEFB01329DD324302189C0C476,11631,18,23,5,12,49,649
70809,70809,D8AE02857BA77543AC93BD79AFFC45E0,11801,0,8,8,42,48,2148
70810,70810,D8AE02857BA77543AC93BD79AFFC45E0,40341,12,15,3,23,49,1199
70811,70811,D8AE02857BA77543AC93BD79AFFC45E0,10421,17,20,3,41,48,2098
70812,70812,D8AE02857BA77543AC93BD79AFFC45E0,11801,21,23,2,42,48,2148
70816,70816,D96A749176144B0BD68C7800D528E6EC,12514,1,7,6,38,47,1947
70817,70817,D96A749176144B0BD68C7800D528E6EC,10601,9,10,1,39,47,1997
70818,70818,D96A749176144B0BD68C7800D528E6EC,11481,13,14,1,41,48,2098
70819,70819,D96A749176144B0BD68C7800D528E6EC,12514,17,18,1,38,47,1947
70820,70820,D96A749176144B0BD68C7800D528E6EC,42281,20,23,3,40,48,2048
70824,70824,AC604569EDEC121EE97D76ACCBB6C578,12521,0,6,6,35,41,1791
70825,70825,AC604569EDEC121EE97D76ACCBB6C578,42151,7,10,3,35,45,1795
70826,70826,AC604569EDEC121EE97D76ACCBB6C578,12521,12,13,1,35,41,1791
70827,70827,AC604569EDEC121EE97D76ACCBB6C578,42151,15,16,1,35,45,1795
70828,70828,AC604569EDEC121EE97D76ACCBB6C578,12521,18,23,5,35,41,1791
70829,70829,A90DF15BDCC250FD2332980F74AEEAAC,41721,0,8,8,39,48,1998
70830,70830,A90DF15BDCC250FD2332980F74AEEAAC,11541,15,16,1,35,49,1799
70831,70831,A90DF15BDCC250FD2332980F74AEEAAC,11331,16,18,2,37,48,1898
70832,70832,A90DF15BDCC250FD2332980F74AEEAAC,13951,18,20,2,47,45,2395
70833,70833,A90DF15BDCC250FD2332980F74AEEAAC,10191,21,23,2,40,48,2048
70834,70834,29B96562D3FA47D9DF0D0600B31647F5,11324,10,11,1,31,46,1596
70835,70835,29B96562D3FA47D9DF0D0600B31647F5,12641,14,15,1,10,43,543
70836,70836,29B96562D3FA47D9DF0D0600B31647F5,42271,19,20,1,40,47,2047
70837,70837,29B96562D3FA47D9DF0D0600B31647F5,13381,21,22,1,39,47,1997
70838,70838,3226BA33BF43A27078264E19B0FFB00B,42631,9,12,3,43,45,2195
70839,70839,3226BA33BF43A27078264E19B0FFB00B,13341,13,15,2,44,45,2245
70840,70840,3226BA33BF43A27078264E19B0FFB00B,13671,16,19,3,27,43,1393
70841,70841,05C3A7EB5EF4E026B421540B8AC90475,42151,7,9,2,35,45,1795
70842,70842,05C3A7EB5EF4E026B421540B8AC90475,12661,10,14,4,32,45,1645
70843,70843,05C3A7EB5EF4E026B421540B8AC90475,42151,16,17,1,35,45,1795
70844,70844,05C3A7EB5EF4E026B421540B8AC90475,42531,18,19,1,31,45,1595
70845,70845,05C3A7EB5EF4E026B421540B8AC90475,11231,20,23,3,37,49,1899
70849,70849,13CC40471AC83D6354BC2D2A78721A9B,11741,0,9,9,42,49,2149
70850,70850,13CC40471AC83D6354BC2D2A78721A9B,10721,10,12,2,31,48,1598
70851,70851,13CC40471AC83D6354BC2D2A78721A9B,11741,15,17,2,42,49,2149
70852,70852,13CC40471AC83D6354BC2D2A78721A9B,11751,19,20,1,35,48,1798
70853,70853,13CC40471AC83D6354BC2D2A78721A9B,12651,21,23,2,43,47,2197
70857,70857,5CB395EE61B203CDEC22915C029A400C,10331,0,9,9,39,46,1996
70858,70858,5CB395EE61B203CDEC22915C029A400C,42281,13,14,1,40,48,2048
70859,70859,5CB395EE61B203CDEC22915C029A400C,10531,15,17,2,34,46,1746
70860,70860,5CB395EE61B203CDEC22915C029A400C,11481,18,19,1,41,48,2098
70861,70861,5CB395EE61B203CDEC22915C029A400C,10911,20,23,3,39,46,1996
70872,70872,0BF9081B921E7C1EC68F2248D31F0D32,16281,6,8,2,11,4,554
70873,70873,0BF9081B921E7C1EC68F2248D31F0D32,15143,9,11,2,18,7,907
70874,70874,0BF9081B921E7C1EC68F2248D31F0D32,16281,11,22,11,11,4,554
70875,70875,C4580799FCCA3685A63A7BF4926F695F,11171,0,7,7,33,48,1698
70876,70876,C4580799FCCA3685A63A7BF4926F695F,42511,7,11,4,37,47,1897
70877,70877,C4580799FCCA3685A63A7BF4926F695F,11171,13,22,9,33,48,1698
70878,70878,87BFC0665C0C86E89B1E3FA8E068DCB9,11061,0,6,6,29,48,1498
70879,70879,87BFC0665C0C86E89B1E3FA8E068DCB9,43971,7,13,6,30,48,1548
70880,70880,87BFC0665C0C86E89B1E3FA8E068DCB9,42491,14,16,2,32,46,1646
70881,70881,87BFC0665C0C86E89B1E3FA8E068DCB9,43971,17,18,1,30,48,1548
70882,70882,9508FAE0B774FCD97D7CFB3C4BD72215,10111,0,5,5,37,47,1897
70883,70883,9508FAE0B774FCD97D7CFB3C4BD72215,13911,8,9,1,39,46,1996
70884,70884,9508FAE0B774FCD97D7CFB3C4BD72215,42161,11,13,2,36,47,1847
70885,70885,9508FAE0B774FCD97D7CFB3C4BD72215,10111,13,16,3,37,47,1897
70886,70886,9508FAE0B774FCD97D7CFB3C4BD72215,42401,18,23,5,36,47,1847
70887,70887,51F784C888CDC439364E57C73AA7020C,11161,0,6,6,32,48,1648
70888,70888,51F784C888CDC439364E57C73AA7020C,43761,10,13,3,32,47,1647
70889,70889,51F784C888CDC439364E57C73AA7020C,12021,17,19,2,37,49,1899
70890,70890,9DB3A2DB1E13125B46099531905D1FEE,13731,8,9,1,33,49,1699
70891,70891,9DB3A2DB1E13125B46099531905D1FEE,10107,11,13,2,38,49,1949
70892,70892,9DB3A2DB1E13125B46099531905D1FEE,10161,17,19,2,35,49,1799
70893,70893,9DB3A2DB1E13125B46099531905D1FEE,13731,21,22,1,33,49,1699
70894,70894,458EBC255B183BF22B23CE89879E2CC9,13471,0,2,2,47,49,2399
70895,70895,458EBC255B183BF22B23CE89879E2CC9,42601,6,9,3,44,48,2248
70896,70896,458EBC255B183BF22B23CE89879E2CC9,40691,12,16,4,42,48,2148
70897,70897,458EBC255B183BF22B23CE89879E2CC9,13471,20,21,1,47,49,2399
70901,70901,E0692EE549D6645BD2FBF58E906BA460,12051,4,6,2,20,47,1047
70902,70902,E0692EE549D6645BD2FBF58E906BA460,42691,8,10,2,24,48,1248
70903,70903,E0692EE549D6645BD2FBF58E906BA460,12051,15,19,4,20,47,1047
70904,70904,658F12866DF04DEFD1752C8716ACBB95,11471,1,7,6,12,48,648
70905,70905,658F12866DF04DEFD1752C8716ACBB95,42041,10,11,1,10,47,547
70906,70906,658F12866DF04DEFD1752C8716ACBB95,11471,12,15,3,12,48,648
70907,70907,658F12866DF04DEFD1752C8716ACBB95,19441,19,21,2,8,46,446
70908,70908,E886E5251030835554FC7C0727BBE348,12871,0,5,5,22,33,1133
70909,70909,E886E5251030835554FC7C0727BBE348,13481,7,8,1,26,31,1331
70910,70910,E886E5251030835554FC7C0727BBE348,19101,11,12,1,17,29,879
70911,70911,E886E5251030835554FC7C0727BBE348,12871,15,18,3,22,33,1133
70918,70918,89B3BFDED87D6E0E820EFE71F7C3C8DA,11861,0,13,13,32,47,1647
70919,70919,89B3BFDED87D6E0E820EFE71F7C3C8DA,42151,15,17,2,35,45,1795
70920,70920,89B3BFDED87D6E0E820EFE71F7C3C8DA,42921,22,23,1,33,47,1697
70927,70927,40F471DD86450F7E02A9160B1DB5571E,11701,4,6,2,43,48,2198
70928,70928,40F471DD86450F7E02A9160B1DB5571E,42321,6,10,4,43,47,2197
70929,70929,40F471DD86450F7E02A9160B1DB5571E,11701,14,16,2,43,48,2198
70930,70930,40F471DD86450F7E02A9160B1DB5571E,42321,16,17,1,43,47,2197
70931,70931,40F471DD86450F7E02A9160B1DB5571E,42461,18,20,2,45,47,2297
70932,70932,40F471DD86450F7E02A9160B1DB5571E,42321,20,21,1,43,47,2197
70933,70933,0B929ACA970011AFF649AD1CE667839A,12921,1,8,7,9,41,491
70934,70934,0B929ACA970011AFF649AD1CE667839A,43021,9,18,9,16,43,843
70935,70935,0B929ACA970011AFF649AD1CE667839A,12921,19,23,4,9,41,491
70942,70942,6DDEE1FE5DEAA10574D4FF4CB295DF53,13711,0,14,14,38,46,1946
70943,70943,6DDEE1FE5DEAA10574D4FF4CB295DF53,12131,19,20,1,32,47,1647
70944,70944,6DDEE1FE5DEAA10574D4FF4CB295DF53,42941,21,23,2,37,47,1897
70945,70945,2D914C2EB253165A5763D18FAE5FB6D2,10151,8,10,2,34,47,1747
70946,70946,2D914C2EB253165A5763D18FAE5FB6D2,42461,19,20,1,45,47,2297
70947,70947,2D914C2EB253165A5763D18FAE5FB6D2,43061,21,23,2,43,46,2196
70948,70948,FAB7310BEC2AACEAAB0173BD441351AC,43751,0,5,5,19,48,998
70949,70949,FAB7310BEC2AACEAAB0173BD441351AC,42691,7,8,1,24,48,1248
70950,70950,FAB7310BEC2AACEAAB0173BD441351AC,43751,12,13,1,19,48,998
70951,70951,FAB7310BEC2AACEAAB0173BD441351AC,12581,14,16,2,24,48,1248
70952,70952,FAB7310BEC2AACEAAB0173BD441351AC,11101,21,22,1,18,48,948
70953,70953,2F8FBE6FB38F00CB192B148FD4827906,42321,0,4,4,43,47,2197
70954,70954,2F8FBE6FB38F00CB192B148FD4827906,42601,4,6,2,44,48,2248
70955,70955,2F8FBE6FB38F00CB192B148FD4827906,42321,14,16,2,43,47,2197
70956,70956,2F8FBE6FB38F00CB192B148FD4827906,40697,21,22,1,43,48,2198
70957,70957,2F8FBE6FB38F00CB192B148FD4827906,42321,22,23,1,43,47,2197
70958,70958,30EE4ED515D97FFC1B2D380D08A1F01B,11074,0,8,8,37,47,1897
70959,70959,30EE4ED515D97FFC1B2D380D08A1F01B,11561,9,11,2,32,49,1649
70960,70960,30EE4ED515D97FFC1B2D380D08A1F01B,11731,12,13,1,36,48,1848
70961,70961,30EE4ED515D97FFC1B2D380D08A1F01B,11074,13,15,2,37,47,1897
70962,70962,30EE4ED515D97FFC1B2D380D08A1F01B,10401,16,18,2,33,49,1699
70963,70963,30EE4ED515D97FFC1B2D380D08A1F01B,10841,20,23,3,37,47,1897
70967,70967,8ECC26CF92064D4498527FD180BC1C4B,11481,0,1,1,41,48,2098
70968,70968,8ECC26CF92064D4498527FD180BC1C4B,13101,4,18,14,40,47,2047
70969,70969,8ECC26CF92064D4498527FD180BC1C4B,11631,21,22,1,12,49,649
70980,70980,EF513E7C00BFDF832A0C526F0CB25E65,43011,0,6,6,40,42,2042
70981,70981,EF513E7C00BFDF832A0C526F0CB25E65,12561,6,12,6,45,43,2293
70982,70982,EF513E7C00BFDF832A0C526F0CB25E65,43011,13,23,10,40,42,2042
70986,70986,6F881E54FD8247C10253271465BFC769,10111,0,7,7,37,47,1897
70987,70987,6F881E54FD8247C10253271465BFC769,11061,9,11,2,29,48,1498
70988,70988,6F881E54FD8247C10253271465BFC769,10111,13,23,10,37,47,1897
70989,70989,0E91A13D0E931F32EE1FFD96FA252798,13071,3,4,1,41,41,2091
70990,70990,0E91A13D0E931F32EE1FFD96FA252798,43451,6,15,9,37,40,1890
70991,70991,0E91A13D0E931F32EE1FFD96FA252798,42381,18,23,5,39,41,1991
70992,70992,DECBADB784F62E2168F122A4EE160759,42291,8,10,2,29,48,1498
70993,70993,DECBADB784F62E2168F122A4EE160759,11381,10,16,6,30,47,1547
70994,70994,DECBADB784F62E2168F122A4EE160759,12792,21,22,1,34,30,1730
70995,70995,403E4ED8501B3F3BFADB94D815ACA889,42771,0,7,7,36,47,1847
70996,70996,403E4ED8501B3F3BFADB94D815ACA889,11021,8,15,7,36,49,1849
70997,70997,403E4ED8501B3F3BFADB94D815ACA889,11875,16,18,2,30,46,1546
70998,70998,403E4ED8501B3F3BFADB94D815ACA889,10251,19,23,4,35,47,1797
71002,71002,F767C7D1FEC3D15975CABED7883C2378,42691,0,6,6,24,48,1248
71003,71003,F767C7D1FEC3D15975CABED7883C2378,10501,11,12,1,22,46,1146
71004,71004,F767C7D1FEC3D15975CABED7883C2378,12601,12,14,2,25,47,1297
71005,71005,F767C7D1FEC3D15975CABED7883C2378,13701,15,19,4,21,38,1088
71006,71006,2AC99B20B35898870B961D5169457B47,43761,3,9,6,32,47,1647
71007,71007,2AC99B20B35898870B961D5169457B47,12601,10,15,5,25,47,1297
71008,71008,2AC99B20B35898870B961D5169457B47,11061,19,20,1,29,48,1498
71009,71009,CBA3EEB115425BF46575E225F464D168,13941,0,2,2,41,47,2097
71010,71010,CBA3EEB115425BF46575E225F464D168,42321,2,5,3,43,47,2197
71011,71011,CBA3EEB115425BF46575E225F464D168,13941,5,9,4,41,47,2097
71012,71012,CBA3EEB115425BF46575E225F464D168,10107,13,14,1,38,49,1949
71013,71013,CBA3EEB115425BF46575E225F464D168,13941,15,16,1,41,47,2097
71014,71014,CBA3EEB115425BF46575E225F464D168,42051,20,21,1,42,48,2148
71018,71018,C5E92E08BD54D1F8D1119F34E806E13B,43971,0,1,1,30,48,1548
71019,71019,C5E92E08BD54D1F8D1119F34E806E13B,11861,1,4,3,32,47,1647
71020,71020,C5E92E08BD54D1F8D1119F34E806E13B,42521,4,5,1,31,47,1597
71021,71021,C5E92E08BD54D1F8D1119F34E806E13B,11861,13,14,1,32,47,1647
71022,71022,C5E92E08BD54D1F8D1119F34E806E13B,10951,15,17,2,29,48,1498
71023,71023,C5E92E08BD54D1F8D1119F34E806E13B,11381,17,19,2,30,47,1547
71024,71024,C5E92E08BD54D1F8D1119F34E806E13B,43971,21,22,1,30,48,1548
71028,71028,009D1F94EA0952D45CBA60A867E56473,43311,0,7,7,31,48,1598
71029,71029,009D1F94EA0952D45CBA60A867E56473,40951,12,13,1,36,49,1849
71030,71030,009D1F94EA0952D45CBA60A867E56473,42521,17,19,2,31,47,1597
71031,71031,009D1F94EA0952D45CBA60A867E56473,43311,20,22,2,31,48,1598
71032,71032,3CFF352FC0F760E9B7CC6021501C3AD4,11061,0,5,5,29,48,1498
71033,71033,3CFF352FC0F760E9B7CC6021501C3AD4,40171,8,16,8,38,48,1948
71034,71034,3CFF352FC0F760E9B7CC6021501C3AD4,43391,19,20,1,29,48,1498
71035,71035,FE4547C9BDE2F0CE3554897F6352AE34,43011,1,6,5,40,42,2042
71036,71036,FE4547C9BDE2F0CE3554897F6352AE34,43451,6,10,4,37,40,1890
71037,71037,FE4547C9BDE2F0CE3554897F6352AE34,43011,11,13,2,40,42,2042
71038,71038,FE4547C9BDE2F0CE3554897F6352AE34,43451,14,16,2,37,40,1890
71039,71039,FE4547C9BDE2F0CE3554897F6352AE34,13071,16,18,2,41,41,2091
71040,71040,09D4E4AC27B1C2BD71280354244F178D,42121,1,8,7,26,49,1349
71041,71041,09D4E4AC27B1C2BD71280354244F178D,42461,9,14,5,45,47,2297
71042,71042,09D4E4AC27B1C2BD71280354244F178D,42623,14,15,1,22,49,1149
71043,71043,09D4E4AC27B1C2BD71280354244F178D,11331,19,20,1,37,48,1898
71044,71044,09D4E4AC27B1C2BD71280354244F178D,10731,21,23,2,33,47,1697
71045,71045,FCAD054B21E17BB146DD8C9FA66703D1,10331,0,7,7,39,46,1996
71046,71046,FCAD054B21E17BB146DD8C9FA66703D1,10251,11,15,4,35,47,1797
71047,71047,FCAD054B21E17BB146DD8C9FA66703D1,11111,16,17,1,26,48,1348
71048,71048,FCAD054B21E17BB146DD8C9FA66703D1,10331,19,23,4,39,46,1996
71052,71052,1D51AC4BBFB933A632C5A69F521FA887,11861,0,12,12,32,47,1647
71053,71053,1D51AC4BBFB933A632C5A69F521FA887,11271,13,18,5,37,48,1898
71054,71054,1D51AC4BBFB933A632C5A69F521FA887,11861,18,23,5,32,47,1647
71055,71055,D6932FB45D03368B8FD3FCD5E6F4054F,11481,0,7,7,41,48,2098
71056,71056,D6932FB45D03368B8FD3FCD5E6F4054F,10121,8,10,2,36,49,1849
71057,71057,D6932FB45D03368B8FD3FCD5E6F4054F,11751,13,15,2,35,48,1798
71058,71058,D6932FB45D03368B8FD3FCD5E6F4054F,13561,16,18,2,37,49,1899
71059,71059,D6932FB45D03368B8FD3FCD5E6F4054F,42471,18,20,2,35,49,1799
71060,71060,D6932FB45D03368B8FD3FCD5E6F4054F,10107,20,21,1,38,49,1949
71061,71061,D6932FB45D03368B8FD3FCD5E6F4054F,42281,22,23,1,40,48,2048
71065,71065,705DFE0F0CF99753368D655C68C21E78,43011,2,7,5,40,42,2042
71066,71066,705DFE0F0CF99753368D655C68C21E78,12221,7,15,8,43,44,2194
71067,71067,705DFE0F0CF99753368D655C68C21E78,12211,15,17,2,41,44,2094
71068,71068,705DFE0F0CF99753368D655C68C21E78,12221,19,23,4,43,44,2194
71069,71069,AEB67BDC79FE6552942E6F2DEC149F32,11701,0,1,1,43,48,2198
71070,71070,AEB67BDC79FE6552942E6F2DEC149F32,11551,2,11,9,39,49,1999
71071,71071,AEB67BDC79FE6552942E6F2DEC149F32,42981,14,16,2,36,49,1849
71072,71072,AEB67BDC79FE6552942E6F2DEC149F32,10107,21,22,1,38,49,1949
71073,71073,656752102BA99654C7060CE5B2133D72,49201,0,6,6,7,41,391
71074,71074,656752102BA99654C7060CE5B2133D72,12921,7,11,4,9,41,491
71075,71075,656752102BA99654C7060CE5B2133D72,12641,15,16,1,10,43,543
71076,71076,656752102BA99654C7060CE5B2133D72,12921,16,19,3,9,41,491
71083,71083,8A6C506FC93EDC7EFD230CEBD87531C3,19244,0,12,12,1,43,93
71084,71084,8A6C506FC93EDC7EFD230CEBD87531C3,12921,14,15,1,9,41,491
71085,71085,8A6C506FC93EDC7EFD230CEBD87531C3,19244,16,19,3,1,43,93
71089,71089,DEA13AE4E25C1F5535D501BC3C7ECF55,19111,0,7,7,9,45,495
71090,71090,DEA13AE4E25C1F5535D501BC3C7ECF55,10721,9,11,2,31,48,1598
71091,71091,DEA13AE4E25C1F5535D501BC3C7ECF55,19111,13,23,10,9,45,495
71092,71092,2E7CC4EF44F5328D020B21B2138E3C1D,11061,0,8,8,29,48,1498
71093,71093,2E7CC4EF44F5328D020B21B2138E3C1D,11751,12,13,1,35,48,1798
71094,71094,2E7CC4EF44F5328D020B21B2138E3C1D,11061,15,22,7,29,48,1498
71098,71098,583602182C31C8E2D985404EA5592339,12641,0,2,2,10,43,543
71099,71099,583602182C31C8E2D985404EA5592339,12921,7,8,1,9,41,491
71100,71100,583602182C31C8E2D985404EA5592339,12641,8,10,2,10,43,543
71101,71101,583602182C31C8E2D985404EA5592339,12921,14,18,4,9,41,491
71102,71102,583602182C31C8E2D985404EA5592339,19114,21,22,1,7,43,393
71103,71103,EB7EB6074C1F2A07A41462E31EDA6629,42161,0,10,10,36,47,1847
71104,71104,EB7EB6074C1F2A07A41462E31EDA6629,10111,10,17,7,37,47,1897
71105,71105,EB7EB6074C1F2A07A41462E31EDA6629,42161,17,18,1,36,47,1847
71106,71106,EB7EB6074C1F2A07A41462E31EDA6629,11074,19,20,1,37,47,1897
71107,71107,EB7EB6074C1F2A07A41462E31EDA6629,42401,22,23,1,36,47,1847
71111,71111,5C43416A739D6997A74BBA50F19E82A3,10171,0,6,6,26,47,1347
71112,71112,5C43416A739D6997A74BBA50F19E82A3,11861,8,10,2,32,47,1647
71113,71113,5C43416A739D6997A74BBA50F19E82A3,10171,12,14,2,26,47,1347
71114,71114,5C43416A739D6997A74BBA50F19E82A3,11091,15,16,1,29,47,1497
71115,71115,5C43416A739D6997A74BBA50F19E82A3,11861,19,22,3,32,47,1647
71116,71116,B3F13C4F2F7672938ACC18445C7E0271,19821,0,8,8,4,46,246
71117,71117,B3F13C4F2F7672938ACC18445C7E0271,12621,11,13,2,10,48,548
71118,71118,B3F13C4F2F7672938ACC18445C7E0271,19621,15,18,3,5,46,296
71129,71129,25CC66D599A64006DB1C07E7C87CDB76,12921,0,4,4,9,41,491
71130,71130,25CC66D599A64006DB1C07E7C87CDB76,43021,8,12,4,16,43,843
71131,71131,25CC66D599A64006DB1C07E7C87CDB76,12921,12,22,10,9,41,491
71132,71132,EDBE9058BB0B28E0915A84395E9226D9,11261,0,5,5,36,46,1846
71133,71133,EDBE9058BB0B28E0915A84395E9226D9,42861,6,12,6,37,44,1894
71134,71134,EDBE9058BB0B28E0915A84395E9226D9,11261,12,14,2,36,46,1846
71135,71135,EDBE9058BB0B28E0915A84395E9226D9,42861,15,18,3,37,44,1894
71136,71136,EDBE9058BB0B28E0915A84395E9226D9,11261,19,22,3,36,46,1846
71149,71149,F0C7EDE2A4789958616B0A004CA8540F,11161,0,4,4,32,48,1648
71150,71150,F0C7EDE2A4789958616B0A004CA8540F,43761,8,13,5,32,47,1647
71151,71151,F0C7EDE2A4789958616B0A004CA8540F,13271,16,21,5,41,47,2097
71152,71152,091DCC0237DDF0F056E1A7BFB1F57890,12641,2,5,3,10,43,543
71153,71153,091DCC0237DDF0F056E1A7BFB1F57890,43021,6,7,1,16,43,843
71154,71154,091DCC0237DDF0F056E1A7BFB1F57890,12641,10,19,9,10,43,543
71158,71158,35FE39B951D37418385844C98A76F454,15401,0,6,6,39,25,1975
71159,71159,35FE39B951D37418385844C98A76F454,15411,11,16,5,44,27,2227
71160,71160,35FE39B951D37418385844C98A76F454,15401,19,23,4,39,25,1975
71161,71161,601A51EA671623E5E466F858B3908746,10811,0,7,7,38,46,1946
71162,71162,601A51EA671623E5E466F858B3908746,13651,8,19,11,30,47,1547
71163,71163,601A51EA671623E5E466F858B3908746,13231,20,23,3,39,46,1996
71170,71170,B4A2087258428A6F2A18F4027E197DD7,11061,0,14,14,29,48,1498
71171,71171,B4A2087258428A6F2A18F4027E197DD7,12661,18,19,1,32,45,1645
71172,71172,B4A2087258428A6F2A18F4027E197DD7,11151,19,21,2,30,48,1548
71177,71177,6245D429440CF214FBA1601A6953A01C,42071,0,9,9,31,49,1599
71178,71178,6245D429440CF214FBA1601A6953A01C,42261,11,13,2,25,49,1299
71179,71179,6245D429440CF214FBA1601A6953A01C,42071,13,20,7,31,49,1599
71184,71184,0BDFC6D6EF86CBFADC783421EB551361,11151,0,12,12,30,48,1548
71185,71185,0BDFC6D6EF86CBFADC783421EB551361,11231,15,17,2,37,49,1899
71186,71186,0BDFC6D6EF86CBFADC783421EB551361,11151,18,23,5,30,48,1548
71193,71193,6F60DF43E72A344D99FCB3944A72DCC7,12601,3,5,2,25,47,1297
71194,71194,6F60DF43E72A344D99FCB3944A72DCC7,42871,7,13,6,30,45,1545
71195,71195,6F60DF43E72A344D99FCB3944A72DCC7,10716,13,14,1,30,46,1546
71196,71196,6F60DF43E72A344D99FCB3944A72DCC7,42871,17,20,3,30,45,1545
71197,71197,6F60DF43E72A344D99FCB3944A72DCC7,10716,21,23,2,30,46,1546
71207,71207,A02CC63C83B0DB8DAC13DDD011BB9A96,11161,0,7,7,32,48,1648
71208,71208,A02CC63C83B0DB8DAC13DDD011BB9A96,13821,9,18,9,49,45,2495
71209,71209,A02CC63C83B0DB8DAC13DDD011BB9A96,11861,20,23,3,32,47,1647
71210,71210,CD5F8D7604C7020A19DDE3C48998E9F5,13314,3,4,1,31,39,1589
71211,71211,CD5F8D7604C7020A19DDE3C48998E9F5,12521,6,19,13,35,41,1791
71212,71212,CD5F8D7604C7020A19DDE3C48998E9F5,13314,21,22,1,31,39,1589
71233,71233,AD5871AA9EAD75878C606AE9C3D0E3D8,43951,6,9,3,49,41,2491
71234,71234,AD5871AA9EAD75878C606AE9C3D0E3D8,13411,9,11,2,49,42,2492
71235,71235,AD5871AA9EAD75878C606AE9C3D0E3D8,43951,14,16,2,49,41,2491
71236,71236,AD5871AA9EAD75878C606AE9C3D0E3D8,13411,16,18,2,49,42,2492
71237,71237,AD5871AA9EAD75878C606AE9C3D0E3D8,12561,20,22,2,45,43,2293
71244,71244,CAB47C85629646AC05B696BEE2F5B14A,10214,0,5,5,15,49,799
71245,71245,CAB47C85629646AC05B696BEE2F5B14A,10211,5,6,1,16,49,849
71246,71246,CAB47C85629646AC05B696BEE2F5B14A,11861,9,12,3,32,47,1647
71247,71247,CAB47C85629646AC05B696BEE2F5B14A,40951,12,14,2,36,49,1849
71248,71248,CAB47C85629646AC05B696BEE2F5B14A,11381,15,16,1,30,47,1547
71249,71249,CAB47C85629646AC05B696BEE2F5B14A,10214,20,23,3,15,49,799
71250,71250,D21AD56E1413F233CB19B53125C6F06A,11021,0,9,9,36,49,1849
71251,71251,D21AD56E1413F233CB19B53125C6F06A,13341,11,15,4,44,45,2245
71252,71252,D21AD56E1413F233CB19B53125C6F06A,42471,19,21,2,35,49,1799
71253,71253,D21AD56E1413F233CB19B53125C6F06A,11591,21,23,2,36,49,1849
71254,71254,E478E2D9BCF7A4F7B498F875A46F0A1D,13111,2,3,1,42,46,2146
71255,71255,E478E2D9BCF7A4F7B498F875A46F0A1D,40801,3,6,3,43,46,2196
71256,71256,E478E2D9BCF7A4F7B498F875A46F0A1D,42461,6,8,2,45,47,2297
71257,71257,E478E2D9BCF7A4F7B498F875A46F0A1D,43621,11,12,1,46,48,2348
71258,71258,E478E2D9BCF7A4F7B498F875A46F0A1D,43061,16,18,2,43,46,2196
71259,71259,CF045BB51AB834592F0FA9268C200D5E,40431,0,8,8,36,47,1847
71260,71260,CF045BB51AB834592F0FA9268C200D5E,10781,12,14,2,35,47,1797
71261,71261,CF045BB51AB834592F0FA9268C200D5E,13791,15,21,6,42,47,2147
71262,71262,93385A44FB64392F87A63CBA23C74FC5,11954,2,3,1,32,49,1649
71263,71263,93385A44FB64392F87A63CBA23C74FC5,11951,12,15,3,31,49,1599
71264,71264,93385A44FB64392F87A63CBA23C74FC5,11954,16,17,1,32,49,1649
71265,71265,93385A44FB64392F87A63CBA23C74FC5,11951,17,21,4,31,49,1599
71266,71266,93385A44FB64392F87A63CBA23C74FC5,11954,22,23,1,32,49,1649
71267,71267,FC2CF44FB72CAD842657734968AC0CF0,10295,2,4,2,30,47,1547
71268,71268,FC2CF44FB72CAD842657734968AC0CF0,13121,6,14,8,38,46,1946
71269,71269,FC2CF44FB72CAD842657734968AC0CF0,11331,19,21,2,37,48,1898
71270,71270,FC2CF44FB72CAD842657734968AC0CF0,11231,22,23,1,37,49,1899
71275,71275,802D06E8811CDC65FDAB61E1A1D233B3,12601,0,9,9,25,47,1297
71276,71276,802D06E8811CDC65FDAB61E1A1D233B3,10491,11,19,8,33,48,1698
71277,71277,802D06E8811CDC65FDAB61E1A1D233B3,12601,20,21,1,25,47,1297
71278,71278,7EA63201A47B68AA085BD7B8AF1F7767,10721,0,7,7,31,48,1598
71279,71279,7EA63201A47B68AA085BD7B8AF1F7767,11231,9,11,2,37,49,1899
71280,71280,7EA63201A47B68AA085BD7B8AF1F7767,12083,11,13,2,36,49,1849
71281,71281,7EA63201A47B68AA085BD7B8AF1F7767,11231,13,16,3,37,49,1899
71282,71282,7EA63201A47B68AA085BD7B8AF1F7767,12083,17,18,1,36,49,1849
71283,71283,7EA63201A47B68AA085BD7B8AF1F7767,11231,21,23,2,37,49,1899
71288,71288,110EB8ED5B33FF374638B480C238C00D,10271,0,6,6,37,46,1896
71289,71289,110EB8ED5B33FF374638B480C238C00D,19744,9,17,8,6,43,343
71290,71290,110EB8ED5B33FF374638B480C238C00D,10271,19,20,1,37,46,1896
71291,71291,BC76CCD190FA1A5238AAD9129E2B96C9,40463,4,7,3,38,49,1949
71292,71292,BC76CCD190FA1A5238AAD9129E2B96C9,11231,9,12,3,37,49,1899
71293,71293,BC76CCD190FA1A5238AAD9129E2B96C9,40463,13,14,1,38,49,1949
71294,71294,BC76CCD190FA1A5238AAD9129E2B96C9,11231,14,17,3,37,49,1899
71295,71295,BC76CCD190FA1A5238AAD9129E2B96C9,10107,17,23,6,38,49,1949
71322,71322,A4CBFA774BBCB1E081978588796288CA,10681,0,7,7,30,48,1548
71323,71323,A4CBFA774BBCB1E081978588796288CA,12083,9,10,1,36,49,1849
71324,71324,A4CBFA774BBCB1E081978588796288CA,11231,11,17,6,37,49,1899
71325,71325,A4CBFA774BBCB1E081978588796288CA,10681,20,23,3,30,48,1548
71332,71332,271B7B4ACFB433A285F2845962764110,43751,0,1,1,19,48,998
71333,71333,271B7B4ACFB433A285F2845962764110,11101,2,20,18,18,48,948
71334,71334,271B7B4ACFB433A285F2845962764110,10901,22,23,1,35,48,1798
71338,71338,B60ABB25F56CD1431A35405235543A75,11011,8,10,2,39,49,1999
71339,71339,B60ABB25F56CD1431A35405235543A75,10801,15,21,6,42,47,2147
71340,71340,B60ABB25F56CD1431A35405235543A75,13221,21,22,1,40,47,2047
71341,71341,FF016D5E5B1C79C9C47299BA17505875,13681,8,10,2,38,47,1947
71342,71342,FF016D5E5B1C79C9C47299BA17505875,13121,11,15,4,38,46,1946
71343,71343,FF016D5E5B1C79C9C47299BA17505875,13681,17,19,2,38,47,1947
71344,71344,FF016D5E5B1C79C9C47299BA17505875,43311,20,21,1,31,48,1598
71348,71348,67324219FD0B98BECEBB85768BC60718,13791,0,6,6,42,47,2147
71349,71349,67324219FD0B98BECEBB85768BC60718,42091,8,9,1,43,46,2196
71350,71350,67324219FD0B98BECEBB85768BC60718,42461,12,13,1,45,47,2297
71351,71351,67324219FD0B98BECEBB85768BC60718,13791,16,18,2,42,47,2147
71352,71352,67324219FD0B98BECEBB85768BC60718,13111,20,21,1,42,46,2146
71353,71353,67324219FD0B98BECEBB85768BC60718,13791,22,23,1,42,47,2147
71360,71360,10530AA3545BA3AAA2634E512B3F731F,11261,2,4,2,36,46,1846
71361,71361,10530AA3545BA3AAA2634E512B3F731F,42861,6,9,3,37,44,1894
71362,71362,10530AA3545BA3AAA2634E512B3F731F,11261,13,14,1,36,46,1846
71363,71363,10530AA3545BA3AAA2634E512B3F731F,42861,15,16,1,37,44,1894
71364,71364,10530AA3545BA3AAA2634E512B3F731F,11261,18,23,5,36,46,1846
71365,71365,31BEDC61F88406C4E8F329FDA8AB6C28,43971,5,7,2,30,48,1548
71366,71366,31BEDC61F88406C4E8F329FDA8AB6C28,13911,9,11,2,39,46,1996
71367,71367,31BEDC61F88406C4E8F329FDA8AB6C28,11111,14,22,8,26,48,1348
71368,71368,03175FB6AFB4F200ADEA10CA8FF33747,13511,0,3,3,34,48,1748
71369,71369,03175FB6AFB4F200ADEA10CA8FF33747,10251,3,4,1,35,47,1797
71370,71370,03175FB6AFB4F200ADEA10CA8FF33747,40637,5,6,1,36,47,1847
71371,71371,03175FB6AFB4F200ADEA10CA8FF33747,42151,7,16,9,35,45,1795
71372,71372,03175FB6AFB4F200ADEA10CA8FF33747,42161,18,19,1,36,47,1847
71373,71373,6E802E6EED0751631BE3E26AAC23D1D7,19114,0,6,6,7,43,393
71374,71374,6E802E6EED0751631BE3E26AAC23D1D7,12921,7,8,1,9,41,491
71375,71375,6E802E6EED0751631BE3E26AAC23D1D7,19114,12,13,1,7,43,393
71376,71376,6E802E6EED0751631BE3E26AAC23D1D7,12921,14,17,3,9,41,491
71377,71377,6E802E6EED0751631BE3E26AAC23D1D7,19931,19,20,1,7,43,393
71386,71386,6C2244D79333FB126D7C044044FC52BA,12491,0,5,5,36,43,1843
71387,71387,6C2244D79333FB126D7C044044FC52BA,43451,6,9,3,37,40,1890
71388,71388,6C2244D79333FB126D7C044044FC52BA,12491,12,13,1,36,43,1843
71389,71389,6C2244D79333FB126D7C044044FC52BA,43451,14,18,4,37,40,1890
71390,71390,6C2244D79333FB126D7C044044FC52BA,42151,20,23,3,35,45,1795
71394,71394,15EEAA3837867716D665BDD38A041903,10331,0,10,10,39,46,1996
71395,71395,15EEAA3837867716D665BDD38A041903,11261,10,13,3,36,46,1846
71396,71396,15EEAA3837867716D665BDD38A041903,42861,16,17,1,37,44,1894
71397,71397,15EEAA3837867716D665BDD38A041903,10271,18,19,1,37,46,1896
71398,71398,15EEAA3837867716D665BDD38A041903,10331,22,23,1,39,46,1996
71399,71399,E93D8B02977789FF5BDAF0EE317471D5,10451,0,8,8,25,48,1298
71400,71400,E93D8B02977789FF5BDAF0EE317471D5,12311,9,10,1,30,44,1544
71401,71401,E93D8B02977789FF5BDAF0EE317471D5,10716,11,14,3,30,46,1546
71402,71402,E93D8B02977789FF5BDAF0EE317471D5,12311,14,16,2,30,44,1544
71403,71403,E93D8B02977789FF5BDAF0EE317471D5,10451,16,18,2,25,48,1298
71404,71404,E93D8B02977789FF5BDAF0EE317471D5,11211,19,21,2,34,49,1749
71409,71409,A3DA59B0AA7FB48E3453D160DA6CAD69,16181,0,5,5,4,2,202
71410,71410,A3DA59B0AA7FB48E3453D160DA6CAD69,10191,12,15,3,40,48,2048
71411,71411,A3DA59B0AA7FB48E3453D160DA6CAD69,16181,19,23,4,4,2,202
71412,71412,F934A070299A0C2535F9C55A84D4AE40,11471,0,5,5,12,48,648
71413,71413,F934A070299A0C2535F9C55A84D4AE40,19441,8,17,9,8,46,446
71414,71414,F934A070299A0C2535F9C55A84D4AE40,11471,20,23,3,12,48,648
71418,71418,579FA37FD5EC3632D2EAC944DBC23A1E,12971,8,11,3,32,48,1648
71419,71419,579FA37FD5EC3632D2EAC944DBC23A1E,10471,11,15,4,37,48,1898
71420,71420,579FA37FD5EC3632D2EAC944DBC23A1E,40171,18,20,2,38,48,1948
71421,71421,F3B474CDCD415AC2258B7CBD95BD7C95,10351,1,6,5,28,45,1445
71422,71422,F3B474CDCD415AC2258B7CBD95BD7C95,42871,8,19,11,30,45,1545
71423,71423,F3B474CDCD415AC2258B7CBD95BD7C95,10221,21,23,2,34,49,1749
71424,71424,8AB561279CAFD673B81CFFF6F25401C3,43011,1,2,1,40,42,2042
71425,71425,8AB561279CAFD673B81CFFF6F25401C3,12561,3,5,2,45,43,2293
71426,71426,8AB561279CAFD673B81CFFF6F25401C3,12221,6,7,1,43,44,2194
71427,71427,8AB561279CAFD673B81CFFF6F25401C3,43011,7,15,8,40,42,2042
71428,71428,8AB561279CAFD673B81CFFF6F25401C3,12221,18,19,1,43,44,2194
71429,71429,8AB561279CAFD673B81CFFF6F25401C3,43011,21,22,1,40,42,2042
71436,71436,ADD7A4F0BB30FA67DC391964A4C8D11C,11741,0,9,9,42,49,2149
71437,71437,ADD7A4F0BB30FA67DC391964A4C8D11C,11481,11,12,1,41,48,2098
71438,71438,ADD7A4F0BB30FA67DC391964A4C8D11C,13221,13,16,3,40,47,2047
71439,71439,ADD7A4F0BB30FA67DC391964A4C8D11C,40341,17,19,2,23,49,1199
71440,71440,E6F8254FB06F11B0E1B2D4AA336C6A03,12921,0,1,1,9,41,491
71441,71441,E6F8254FB06F11B0E1B2D4AA336C6A03,19061,1,2,1,3,43,193
71442,71442,E6F8254FB06F11B0E1B2D4AA336C6A03,12921,2,20,18,9,41,491
71443,71443,E6F8254FB06F11B0E1B2D4AA336C6A03,19061,21,23,2,3,43,193
71447,71447,5AF7A250F769DD424B6F153B49B360AA,10901,0,6,6,35,48,1798
71448,71448,5AF7A250F769DD424B6F153B49B360AA,12601,8,13,5,25,47,1297
71449,71449,5AF7A250F769DD424B6F153B49B360AA,10901,14,23,9,35,48,1798
71450,71450,E2E7904AF585940CD43CDDA5A90CDD82,10661,0,7,7,37,49,1899
71451,71451,E2E7904AF585940CD43CDDA5A90CDD82,19031,8,17,9,1,42,92
71452,71452,E2E7904AF585940CD43CDDA5A90CDD82,11541,22,23,1,35,49,1799
71453,71453,B304D2AD98C7DE24CAE6DD0DA65095F0,10431,0,7,7,33,49,1699
71454,71454,B304D2AD98C7DE24CAE6DD0DA65095F0,43581,8,9,1,33,48,1698
71455,71455,B304D2AD98C7DE24CAE6DD0DA65095F0,42491,10,12,2,32,46,1646
71456,71456,B304D2AD98C7DE24CAE6DD0DA65095F0,43581,13,17,4,33,48,1698
71457,71457,B304D2AD98C7DE24CAE6DD0DA65095F0,10431,18,22,4,33,49,1699
71465,71465,EA4346C82B2DB28BABC4E2B816D4C45D,15121,7,10,3,27,19,1369
71466,71466,EA4346C82B2DB28BABC4E2B816D4C45D,19801,11,13,2,19,26,976
71467,71467,EA4346C82B2DB28BABC4E2B816D4C45D,15121,14,18,4,27,19,1369
71468,71468,EA4346C82B2DB28BABC4E2B816D4C45D,15351,19,21,2,24,22,1222
71472,71472,642745E21737EAC7A7647B9B2F014688,11061,4,6,2,29,48,1498
71473,71473,642745E21737EAC7A7647B9B2F014688,19901,8,9,1,7,44,394
71474,71474,642745E21737EAC7A7647B9B2F014688,19114,10,21,11,7,43,393
71475,71475,0D486619F64035C218591A9D2CE04F84,10801,0,2,2,42,47,2147
71476,71476,0D486619F64035C218591A9D2CE04F84,13101,2,8,6,40,47,2047
71477,71477,0D486619F64035C218591A9D2CE04F84,43341,9,10,1,41,46,2096
71478,71478,0D486619F64035C218591A9D2CE04F84,13101,11,21,10,40,47,2047
71479,71479,0D486619F64035C218591A9D2CE04F84,10801,21,23,2,42,47,2147
71480,71480,BD53C276FA848F9945E17388715D20B4,10531,0,6,6,34,46,1746
71481,71481,BD53C276FA848F9945E17388715D20B4,11491,12,14,2,36,47,1847
71482,71482,BD53C276FA848F9945E17388715D20B4,10211,16,17,1,16,49,849
71483,71483,BD53C276FA848F9945E17388715D20B4,10151,19,22,3,34,47,1747
71484,71484,D5D027DEC2E15CD439B6E37A42DFD8C1,12921,0,8,8,9,41,491
71485,71485,D5D027DEC2E15CD439B6E37A42DFD8C1,43021,8,19,11,16,43,843
71486,71486,D5D027DEC2E15CD439B6E37A42DFD8C1,12921,20,23,3,9,41,491
71494,71494,AF85AB0F84B58F4A12483525349C1572,43121,0,6,6,25,27,1277
71495,71495,AF85AB0F84B58F4A12483525349C1572,15191,7,10,3,36,27,1827
71496,71496,AF85AB0F84B58F4A12483525349C1572,43121,12,23,11,25,27,1277
71497,71497,AEE701715FEFA9408B3EA20922F57230,10901,2,11,9,35,48,1798
71498,71498,AEE701715FEFA9408B3EA20922F57230,11951,11,14,3,31,49,1599
71499,71499,AEE701715FEFA9408B3EA20922F57230,11731,15,22,7,36,48,1848
71506,71506,89A29DA093E55F037F89890FCC2F6E32,43101,0,7,7,46,40,2340
71507,71507,89A29DA093E55F037F89890FCC2F6E32,13071,8,10,2,41,41,2091
71508,71508,89A29DA093E55F037F89890FCC2F6E32,43101,11,20,9,46,40,2340
71509,71509,89A29DA093E55F037F89890FCC2F6E32,43011,21,23,2,40,42,2042
71510,71510,28175ECC216070F78526740D264992E2,11261,1,11,10,36,46,1846
71511,71511,28175ECC216070F78526740D264992E2,13651,14,17,3,30,47,1547
71512,71512,28175ECC216070F78526740D264992E2,12021,20,21,1,37,49,1899
71513,71513,2A05642B57A7D1B356943BDFFC1803E1,10721,0,7,7,31,48,1598
71514,71514,2A05642B57A7D1B356943BDFFC1803E1,12381,7,10,3,32,48,1648
71515,71515,2A05642B57A7D1B356943BDFFC1803E1,10292,12,14,2,30,47,1547
71516,71516,2A05642B57A7D1B356943BDFFC1803E1,12381,14,15,1,32,48,1648
71517,71517,2A05642B57A7D1B356943BDFFC1803E1,10721,18,23,5,31,48,1598
71530,71530,11C5ACA60B0246DE7069023057E8285F,40101,2,3,1,34,49,1749
71531,71531,11C5ACA60B0246DE7069023057E8285F,11951,3,14,11,31,49,1599
71532,71532,11C5ACA60B0246DE7069023057E8285F,11381,18,22,4,30,47,1547
71537,71537,48D09EA1E123F030FD71CF37426D4799,43011,2,14,12,40,42,2042
71538,71538,48D09EA1E123F030FD71CF37426D4799,42151,14,16,2,35,45,1795
71539,71539,48D09EA1E123F030FD71CF37426D4799,43011,16,18,2,40,42,2042
71540,71540,48D09EA1E123F030FD71CF37426D4799,42151,18,20,2,35,45,1795
71541,71541,D2A48FC60ADAD9E2BF11727867EF8CE8,40637,1,7,6,36,47,1847
71542,71542,D2A48FC60ADAD9E2BF11727867EF8CE8,10251,9,11,2,35,47,1797
71543,71543,D2A48FC60ADAD9E2BF11727867EF8CE8,40637,13,14,1,36,47,1847
71544,71544,D2A48FC60ADAD9E2BF11727867EF8CE8,13231,17,18,1,39,46,1996
71545,71545,D2A48FC60ADAD9E2BF11727867EF8CE8,11074,22,23,1,37,47,1897
71556,71556,E9C5D67F82A2CCBA27E905D3F4A2B0C8,10221,0,7,7,34,49,1749
71557,71557,E9C5D67F82A2CCBA27E905D3F4A2B0C8,43581,11,14,3,33,48,1698
71558,71558,E9C5D67F82A2CCBA27E905D3F4A2B0C8,10191,19,23,4,40,48,2048
71566,71566,DB5F58C0BF92D33E406DDC1B3C9B82ED,10161,0,6,6,35,49,1799
71567,71567,DB5F58C0BF92D33E406DDC1B3C9B82ED,10716,7,9,2,30,46,1546
71568,71568,DB5F58C0BF92D33E406DDC1B3C9B82ED,42521,11,12,1,31,47,1597
71569,71569,DB5F58C0BF92D33E406DDC1B3C9B82ED,10716,13,16,3,30,46,1546
71570,71570,DB5F58C0BF92D33E406DDC1B3C9B82ED,10161,17,23,6,35,49,1799
71574,71574,C38A2FBDADA545E6421F3EB66F4CD3D6,11021,0,8,8,36,49,1849
71575,71575,C38A2FBDADA545E6421F3EB66F4CD3D6,42081,11,13,2,24,49,1249
71576,71576,C38A2FBDADA545E6421F3EB66F4CD3D6,10221,13,16,3,34,49,1749
71577,71577,C38A2FBDADA545E6421F3EB66F4CD3D6,10651,19,23,4,36,49,1849
71578,71578,D0C71966F80C46BE3AC1456E238AC377,15261,0,8,8,39,13,1963
71579,71579,D0C71966F80C46BE3AC1456E238AC377,10151,10,11,1,34,47,1747
71580,71580,D0C71966F80C46BE3AC1456E238AC377,15661,18,20,2,36,26,1826
71581,71581,D0C71966F80C46BE3AC1456E238AC377,15401,21,23,2,39,25,1975
71582,71582,BD842B9C1DCEEEB4F1BBCE4C129C4FE9,12921,6,9,3,9,41,491
71583,71583,BD842B9C1DCEEEB4F1BBCE4C129C4FE9,19181,12,14,2,8,40,440
71584,71584,BD842B9C1DCEEEB4F1BBCE4C129C4FE9,11151,17,19,2,30,48,1548
71612,71612,E851663A4AFDBBD685EADA85BD388CFB,11021,2,7,5,36,49,1849
71613,71613,E851663A4AFDBBD685EADA85BD388CFB,40271,9,11,2,35,49,1799
71614,71614,E851663A4AFDBBD685EADA85BD388CFB,11021,12,14,2,36,49,1849
71615,71615,E851663A4AFDBBD685EADA85BD388CFB,40271,14,18,4,35,49,1799
71616,71616,E851663A4AFDBBD685EADA85BD388CFB,11591,21,22,1,36,49,1849
71620,71620,3D4645296AA1F5D06D7AAE27828BD3AA,42623,4,6,2,22,49,1149
71621,71621,3D4645296AA1F5D06D7AAE27828BD3AA,42071,10,13,3,31,49,1599
71622,71622,3D4645296AA1F5D06D7AAE27828BD3AA,11381,15,16,1,30,47,1547
71623,71623,3D4645296AA1F5D06D7AAE27828BD3AA,42071,19,21,2,31,49,1599
71627,71627,8F2DCDB1E6ACA3D4E7FFFCA1E99BF72D,11091,0,3,3,29,47,1497
71628,71628,8F2DCDB1E6ACA3D4E7FFFCA1E99BF72D,42491,4,7,3,32,46,1646
71629,71629,8F2DCDB1E6ACA3D4E7FFFCA1E99BF72D,43161,14,15,1,35,47,1797
71630,71630,8F2DCDB1E6ACA3D4E7FFFCA1E99BF72D,42021,15,17,2,33,47,1697
71631,71631,8F2DCDB1E6ACA3D4E7FFFCA1E99BF72D,10292,19,22,3,30,47,1547
71632,71632,46624C7A7A05E81084BABC40FE8F937C,13314,0,7,7,31,39,1589
71633,71633,46624C7A7A05E81084BABC40FE8F937C,12521,7,13,6,35,41,1791
71634,71634,46624C7A7A05E81084BABC40FE8F937C,13314,18,23,5,31,39,1589
71635,71635,D700D33D7FCF796465977B814A6F9A5F,42351,2,6,4,38,45,1945
71636,71636,D700D33D7FCF796465977B814A6F9A5F,11261,8,9,1,36,46,1846
71637,71637,D700D33D7FCF796465977B814A6F9A5F,42351,11,14,3,38,45,1945
71638,71638,D700D33D7FCF796465977B814A6F9A5F,11261,14,21,7,36,46,1846
71639,71639,D700D33D7FCF796465977B814A6F9A5F,42864,21,23,2,38,44,1944
71640,71640,0B2A92CB01E0E95C741AFADF50C7B551,10121,0,7,7,36,49,1849
71641,71641,0B2A92CB01E0E95C741AFADF50C7B551,13091,9,14,5,20,42,1042
71642,71642,0B2A92CB01E0E95C741AFADF50C7B551,10121,15,17,2,36,49,1849
71643,71643,0B2A92CB01E0E95C741AFADF50C7B551,10661,21,23,2,37,49,1899
71648,71648,2F1F7798F5E8889B4080CA59D71F0274,10271,5,6,1,37,46,1896
71649,71649,2F1F7798F5E8889B4080CA59D71F0274,11081,7,10,3,35,46,1796
71650,71650,2F1F7798F5E8889B4080CA59D71F0274,10271,11,14,3,37,46,1896
71651,71651,2F1F7798F5E8889B4080CA59D71F0274,13711,14,20,6,38,46,1946
71652,71652,2F1F7798F5E8889B4080CA59D71F0274,10271,21,22,1,37,46,1896
71653,71653,3B5439A9FD7060E7BC8644A0232D8663,11011,0,10,10,39,49,1999
71654,71654,3B5439A9FD7060E7BC8644A0232D8663,13961,18,19,1,42,48,2148
71655,71655,3B5439A9FD7060E7BC8644A0232D8663,11954,21,23,2,32,49,1649
71663,71663,1B8F18C0A7FDA056CB5A51CF0154EAE9,12521,2,14,12,35,41,1791
71664,71664,1B8F18C0A7FDA056CB5A51CF0154EAE9,42381,16,17,1,39,41,1991
71665,71665,1B8F18C0A7FDA056CB5A51CF0154EAE9,11151,19,20,1,30,48,1548
71666,71666,1B8F18C0A7FDA056CB5A51CF0154EAE9,12521,21,23,2,35,41,1791
71670,71670,498FA21A928D94A5AF2C1CBF48D37607,43161,4,5,1,35,47,1797
71671,71671,498FA21A928D94A5AF2C1CBF48D37607,10731,6,9,3,33,47,1697
71672,71672,498FA21A928D94A5AF2C1CBF48D37607,40331,11,23,12,30,47,1547
71677,71677,84D09807769454188E86D49181B1B5D0,13111,2,8,6,42,46,2146
71678,71678,84D09807769454188E86D49181B1B5D0,13481,12,14,2,26,31,1331
71679,71679,84D09807769454188E86D49181B1B5D0,43061,18,19,1,43,46,2196
71680,71680,84D09807769454188E86D49181B1B5D0,13561,20,21,1,37,49,1899
71687,71687,A4A0783CECDF6013F8B01991B706ECDF,42071,5,7,2,31,49,1599
71688,71688,A4A0783CECDF6013F8B01991B706ECDF,42623,8,9,1,22,49,1149
71689,71689,A4A0783CECDF6013F8B01991B706ECDF,42071,12,13,1,31,49,1599
71690,71690,A4A0783CECDF6013F8B01991B706ECDF,42623,16,17,1,22,49,1149
71691,71691,A4A0783CECDF6013F8B01991B706ECDF,42071,19,23,4,31,49,1599
71692,71692,C7B2C2AE2DF954A69981F5A4F94159CA,42151,0,7,7,35,45,1795
71693,71693,C7B2C2AE2DF954A69981F5A4F94159CA,12731,8,9,1,22,40,1140
71694,71694,C7B2C2AE2DF954A69981F5A4F94159CA,11261,12,13,1,36,46,1846
71695,71695,C7B2C2AE2DF954A69981F5A4F94159CA,42351,13,14,1,38,45,1945
71696,71696,C7B2C2AE2DF954A69981F5A4F94159CA,11261,18,19,1,36,46,1846
71705,71705,692AC6DE13BF1FE0F43D1EA4E139D774,10841,0,12,12,37,47,1897
71706,71706,692AC6DE13BF1FE0F43D1EA4E139D774,13331,12,13,1,38,47,1947
71707,71707,692AC6DE13BF1FE0F43D1EA4E139D774,10841,14,16,2,37,47,1897
71708,71708,692AC6DE13BF1FE0F43D1EA4E139D774,13331,16,18,2,38,47,1947
71709,71709,692AC6DE13BF1FE0F43D1EA4E139D774,10841,21,23,2,37,47,1897
71710,71710,3BE46C14B2CA2CE1D859CAF16A631486,12561,0,4,4,45,43,2293
71711,71711,3BE46C14B2CA2CE1D859CAF16A631486,13341,5,6,1,44,45,2245
71712,71712,3BE46C14B2CA2CE1D859CAF16A631486,43951,7,15,8,49,41,2491
71713,71713,3BE46C14B2CA2CE1D859CAF16A631486,13341,18,22,4,44,45,2245
71714,71714,70E36A4B82878626B569C66E46C7827C,43341,0,2,2,41,46,2096
71715,71715,70E36A4B82878626B569C66E46C7827C,12521,3,11,8,35,41,1791
71716,71716,70E36A4B82878626B569C66E46C7827C,13601,13,14,1,34,47,1747
71717,71717,70E36A4B82878626B569C66E46C7827C,42941,18,20,2,37,47,1897
71718,71718,70E36A4B82878626B569C66E46C7827C,12083,20,23,3,36,49,1849
71719,71719,F587F66602084AF6E62D2423843D131D,43751,2,3,1,19,48,998
71720,71720,F587F66602084AF6E62D2423843D131D,10501,4,5,1,22,46,1146
71721,71721,F587F66602084AF6E62D2423843D131D,43751,8,9,1,19,48,998
71722,71722,F587F66602084AF6E62D2423843D131D,12581,19,20,1,24,48,1248
71723,71723,C52E8E136ADF3FD4043CDEC3333A5E9F,10921,0,10,10,43,48,2198
71724,71724,C52E8E136ADF3FD4043CDEC3333A5E9F,11231,10,13,3,37,49,1899
71725,71725,C52E8E136ADF3FD4043CDEC3333A5E9F,40341,14,16,2,23,49,1199
71726,71726,C52E8E136ADF3FD4043CDEC3333A5E9F,10921,21,23,2,43,48,2198
71727,71727,19DD9EA3315ECB699A68A051C9281E6B,13651,0,13,13,30,47,1547
71728,71728,19DD9EA3315ECB699A68A051C9281E6B,10471,15,16,1,37,48,1898
71729,71729,19DD9EA3315ECB699A68A051C9281E6B,12841,17,18,1,37,47,1897
71730,71730,19DD9EA3315ECB699A68A051C9281E6B,13651,19,20,1,30,47,1547
71731,71731,ACF091EB1E15063CE70493C1F0B4FB69,19441,0,5,5,8,46,446
71732,71732,ACF091EB1E15063CE70493C1F0B4FB69,11571,8,10,2,13,46,696
71733,71733,ACF091EB1E15063CE70493C1F0B4FB69,19441,12,13,1,8,46,446
71734,71734,ACF091EB1E15063CE70493C1F0B4FB69,42041,16,17,1,10,47,547
71735,71735,ACF091EB1E15063CE70493C1F0B4FB69,19441,18,22,4,8,46,446
71736,71736,DAF070E37522449552E837969D087804,11171,0,6,6,33,48,1698
71737,71737,DAF070E37522449552E837969D087804,11231,7,11,4,37,49,1899
71738,71738,DAF070E37522449552E837969D087804,10491,12,14,2,33,48,1698
71739,71739,DAF070E37522449552E837969D087804,11231,14,19,5,37,49,1899
71740,71740,DAF070E37522449552E837969D087804,10491,20,23,3,33,48,1698
71741,71741,0DCD9EEA776860D0621554B5A42521A4,11061,0,12,12,29,48,1498
71742,71742,0DCD9EEA776860D0621554B5A42521A4,10681,13,14,1,30,48,1548
71743,71743,0DCD9EEA776860D0621554B5A42521A4,11061,15,16,1,29,48,1498
71744,71744,0DCD9EEA776860D0621554B5A42521A4,40341,18,20,2,23,49,1199
71745,71745,0DCD9EEA776860D0621554B5A42521A4,10401,21,22,1,33,49,1699
71750,71750,AC0F9A0DA655EB0858F47B6C2577B3DE,13671,1,3,2,27,43,1393
71751,71751,AC0F9A0DA655EB0858F47B6C2577B3DE,11281,6,15,9,27,40,1390
71752,71752,AC0F9A0DA655EB0858F47B6C2577B3DE,13671,18,20,2,27,43,1393
71753,71753,AC0F9A0DA655EB0858F47B6C2577B3DE,12521,20,22,2,35,41,1791
71757,71757,ACE6CA8B487669BE8A7949AA7EA2747D,11201,2,3,1,35,49,1799
71758,71758,ACE6CA8B487669BE8A7949AA7EA2747D,12381,3,14,11,32,48,1648
71759,71759,ACE6CA8B487669BE8A7949AA7EA2747D,10601,19,20,1,39,47,1997
71760,71760,D14484DB6515E86DA2EC37443AB9F264,13911,1,3,2,39,46,1996
71761,71761,D14484DB6515E86DA2EC37443AB9F264,12211,4,9,5,41,44,2094
71762,71762,D14484DB6515E86DA2EC37443AB9F264,11261,11,12,1,36,46,1846
71763,71763,D14484DB6515E86DA2EC37443AB9F264,13911,15,16,1,39,46,1996
71764,71764,D14484DB6515E86DA2EC37443AB9F264,11261,16,18,2,36,46,1846
71765,71765,D14484DB6515E86DA2EC37443AB9F264,12211,18,19,1,41,44,2094
71769,71769,F2229754FABF7F398D6839D6208AC86F,10544,0,8,8,28,48,1448
71770,71770,F2229754FABF7F398D6839D6208AC86F,10951,10,11,1,29,48,1498
71771,71771,F2229754FABF7F398D6839D6208AC86F,10544,12,14,2,28,48,1448
71772,71772,F2229754FABF7F398D6839D6208AC86F,10381,15,17,2,31,49,1599
71773,71773,F2229754FABF7F398D6839D6208AC86F,10544,18,23,5,28,48,1448
71774,71774,CB569F11653BED8355DBB1B17AC5F222,40171,0,8,8,38,48,1948
71775,71775,CB569F11653BED8355DBB1B17AC5F222,11914,10,12,2,37,48,1898
71776,71776,CB569F11653BED8355DBB1B17AC5F222,40171,14,16,2,38,48,1948
71777,71777,CB569F11653BED8355DBB1B17AC5F222,11914,18,19,1,37,48,1898
71778,71778,CB569F11653BED8355DBB1B17AC5F222,40171,22,23,1,38,48,1948
71786,71786,6C96EE989846ABECA961FEB7DAD4E3B3,43361,0,6,6,38,48,1948
71787,71787,6C96EE989846ABECA961FEB7DAD4E3B3,10471,10,11,1,37,48,1898
71788,71788,6C96EE989846ABECA961FEB7DAD4E3B3,43361,12,14,2,38,48,1948
71789,71789,6C96EE989846ABECA961FEB7DAD4E3B3,10471,15,17,2,37,48,1898
71790,71790,6C96EE989846ABECA961FEB7DAD4E3B3,40171,17,20,3,38,48,1948
71791,71791,6C96EE989846ABECA961FEB7DAD4E3B3,10471,20,23,3,37,48,1898
71798,71798,57068447BEEE4D7969FF166D57966ECA,11111,2,4,2,26,48,1348
71799,71799,57068447BEEE4D7969FF166D57966ECA,42541,5,6,1,25,47,1297
71800,71800,57068447BEEE4D7969FF166D57966ECA,11361,6,15,9,22,48,1148
71801,71801,57068447BEEE4D7969FF166D57966ECA,12584,16,17,1,24,48,1248
71802,71802,57068447BEEE4D7969FF166D57966ECA,11361,17,18,1,22,48,1148
71803,71803,57068447BEEE4D7969FF166D57966ECA,10171,19,20,1,26,47,1347
71804,71804,DBE56CF804EFF98F06EBBF480586FC01,43021,2,3,1,16,43,843
71805,71805,DBE56CF804EFF98F06EBBF480586FC01,19261,4,5,1,6,37,337
71806,71806,DBE56CF804EFF98F06EBBF480586FC01,12921,7,8,1,9,41,491
71807,71807,DBE56CF804EFF98F06EBBF480586FC01,43021,13,19,6,16,43,843
71808,71808,DBE56CF804EFF98F06EBBF480586FC01,12921,22,23,1,9,41,491
71809,71809,4184E3FF971C281C08C6293355FE7F7B,12511,0,1,1,39,47,1997
71810,71810,4184E3FF971C281C08C6293355FE7F7B,11481,3,4,1,41,48,2098
71811,71811,4184E3FF971C281C08C6293355FE7F7B,13271,4,9,5,41,47,2097
71812,71812,4184E3FF971C281C08C6293355FE7F7B,11481,9,15,6,41,48,2098
71813,71813,4184E3FF971C281C08C6293355FE7F7B,40341,17,22,5,23,49,1199
71820,71820,8EA53D8E1525E5DC764AA8B750C1926A,10841,0,11,11,37,47,1897
71821,71821,8EA53D8E1525E5DC764AA8B750C1926A,43951,13,14,1,49,41,2491
71822,71822,8EA53D8E1525E5DC764AA8B750C1926A,13411,19,20,1,49,42,2492
71826,71826,4BE03AB7B88CA8091DBCEF6257C15779,43761,0,5,5,32,47,1647
71827,71827,4BE03AB7B88CA8091DBCEF6257C15779,11161,8,10,2,32,48,1648
71828,71828,4BE03AB7B88CA8091DBCEF6257C15779,43761,12,13,1,32,47,1647
71829,71829,4BE03AB7B88CA8091DBCEF6257C15779,42371,13,15,2,34,46,1746
71830,71830,4BE03AB7B88CA8091DBCEF6257C15779,43761,16,23,7,32,47,1647
71831,71831,50654F68D94497D10A1C2B9ADDEB1DF4,10191,0,8,8,40,48,2048
71832,71832,50654F68D94497D10A1C2B9ADDEB1DF4,12381,10,11,1,32,48,1648
71833,71833,50654F68D94497D10A1C2B9ADDEB1DF4,11771,12,18,6,39,49,1999
71834,71834,50654F68D94497D10A1C2B9ADDEB1DF4,12381,20,23,3,32,48,1648
71846,71846,A25A833341BE3939DF5ACF6F00A1B542,10621,0,7,7,41,49,2099
71847,71847,A25A833341BE3939DF5ACF6F00A1B542,13951,9,10,1,47,45,2395
71848,71848,A25A833341BE3939DF5ACF6F00A1B542,10621,12,14,2,41,49,2099
71849,71849,A25A833341BE3939DF5ACF6F00A1B542,10924,16,18,2,43,49,2199
71850,71850,A25A833341BE3939DF5ACF6F00A1B542,10621,20,23,3,41,49,2099
71851,71851,6E71207F40ABEC46B7131A267F90969E,19114,0,5,5,7,43,393
71852,71852,6E71207F40ABEC46B7131A267F90969E,19901,8,9,1,7,44,394
71853,71853,6E71207F40ABEC46B7131A267F90969E,19114,12,13,1,7,43,393
71854,71854,6E71207F40ABEC46B7131A267F90969E,12641,13,17,4,10,43,543
71855,71855,6E71207F40ABEC46B7131A267F90969E,19114,21,22,1,7,43,393
71856,71856,83032CC6A0DAD180410F046AB9CA56B4,11381,0,6,6,30,47,1547
71857,71857,83032CC6A0DAD180410F046AB9CA56B4,43761,9,11,2,32,47,1647
71858,71858,83032CC6A0DAD180410F046AB9CA56B4,11381,12,14,2,30,47,1547
71859,71859,83032CC6A0DAD180410F046AB9CA56B4,10281,17,18,1,33,48,1698
71860,71860,83032CC6A0DAD180410F046AB9CA56B4,11381,19,23,4,30,47,1547
71867,71867,F999122850ABCF0D21F7F61B1E504BF8,11301,3,4,1,41,49,2099
71868,71868,F999122850ABCF0D21F7F61B1E504BF8,42341,6,9,3,43,49,2199
71869,71869,F999122850ABCF0D21F7F61B1E504BF8,43101,13,22,9,46,40,2340
71870,71870,3AAB646736804F2C3C62D48784909771,42921,0,7,7,33,47,1697
71871,71871,3AAB646736804F2C3C62D48784909771,13371,10,18,8,41,47,2097
71872,71872,3AAB646736804F2C3C62D48784909771,42921,20,23,3,33,47,1697
71873,71873,9A5D80901504211B25011A66A0C236FE,13671,0,1,1,27,43,1393
71874,71874,9A5D80901504211B25011A66A0C236FE,13311,3,7,4,27,39,1389
71875,71875,9A5D80901504211B25011A66A0C236FE,43731,8,16,8,34,47,1747
71876,71876,9A5D80901504211B25011A66A0C236FE,42161,16,17,1,36,47,1847
71877,71877,9A5D80901504211B25011A66A0C236FE,43731,19,20,1,34,47,1747
71885,71885,BB3DB8BDA13F245F7DA1B278DE6D4FF0,43021,0,3,3,16,43,843
71886,71886,BB3DB8BDA13F245F7DA1B278DE6D4FF0,12641,6,7,1,10,43,543
71887,71887,BB3DB8BDA13F245F7DA1B278DE6D4FF0,43021,10,12,2,16,43,843
71888,71888,BB3DB8BDA13F245F7DA1B278DE6D4FF0,12921,12,14,2,9,41,491
71889,71889,BB3DB8BDA13F245F7DA1B278DE6D4FF0,43021,16,18,2,16,43,843
71890,71890,BB3DB8BDA13F245F7DA1B278DE6D4FF0,12921,20,21,1,9,41,491
71894,71894,7D0B5FCD22D145BBE916FD977FC9A1B6,10111,0,7,7,37,47,1897
71895,71895,7D0B5FCD22D145BBE916FD977FC9A1B6,40733,8,18,10,32,48,1648
71896,71896,7D0B5FCD22D145BBE916FD977FC9A1B6,10111,19,21,2,37,47,1897
71897,71897,47BD90FF18C5C6120B29A51C7AAA3770,13231,0,2,2,39,46,1996
71898,71898,47BD90FF18C5C6120B29A51C7AAA3770,13461,4,5,1,39,44,1994
71899,71899,47BD90FF18C5C6120B29A51C7AAA3770,11261,9,11,2,36,46,1846
71900,71900,47BD90FF18C5C6120B29A51C7AAA3770,42351,12,13,1,38,45,1945
71901,71901,47BD90FF18C5C6120B29A51C7AAA3770,11261,18,20,2,36,46,1846
71905,71905,466DCF1406EFBC3DC226AF4CB46068CC,19181,0,5,5,8,40,440
71906,71906,466DCF1406EFBC3DC226AF4CB46068CC,12641,6,19,13,10,43,543
71907,71907,466DCF1406EFBC3DC226AF4CB46068CC,12921,20,22,2,9,41,491
71908,71908,4CCA23C849E6CF72B9F5665583603418,19024,0,1,1,9,45,495
71909,71909,4CCA23C849E6CF72B9F5665583603418,19441,2,4,2,8,46,446
71910,71910,4CCA23C849E6CF72B9F5665583603418,19621,8,18,10,5,46,296
71911,71911,4CCA23C849E6CF72B9F5665583603418,19024,20,23,3,9,45,495
71918,71918,5529DD2214C36634346603006F6A0F3F,12521,0,8,8,35,41,1791
71919,71919,5529DD2214C36634346603006F6A0F3F,13314,10,11,1,31,39,1589
71920,71920,5529DD2214C36634346603006F6A0F3F,12521,12,15,3,35,41,1791
71921,71921,5529DD2214C36634346603006F6A0F3F,13314,15,16,1,31,39,1589
71922,71922,5529DD2214C36634346603006F6A0F3F,12521,16,22,6,35,41,1791
71923,71923,856662FA58779B8DF6DFA1F8018025EB,10971,2,5,3,35,47,1797
71924,71924,856662FA58779B8DF6DFA1F8018025EB,10221,6,7,1,34,49,1749
71925,71925,856662FA58779B8DF6DFA1F8018025EB,42541,9,10,1,25,47,1297
71926,71926,856662FA58779B8DF6DFA1F8018025EB,12921,15,16,1,9,41,491
71927,71927,856662FA58779B8DF6DFA1F8018025EB,10251,21,23,2,35,47,1797
71928,71928,3B5AEA05F36216184217F6895629427A,19744,0,6,6,6,43,343
71929,71929,3B5AEA05F36216184217F6895629427A,19031,8,9,1,1,42,92
71930,71930,3B5AEA05F36216184217F6895629427A,19741,12,14,2,5,44,294
71931,71931,3B5AEA05F36216184217F6895629427A,12641,14,17,3,10,43,543
71932,71932,3B5AEA05F36216184217F6895629427A,19031,19,20,1,1,42,92
71933,71933,3B5AEA05F36216184217F6895629427A,19744,22,23,1,6,43,343
71934,71934,A847C99BCF3FA2F2462B28662C04DEC1,16281,0,1,1,11,4,554
71935,71935,A847C99BCF3FA2F2462B28662C04DEC1,15143,1,16,15,18,7,907
71936,71936,A847C99BCF3FA2F2462B28662C04DEC1,16281,19,23,4,11,4,554
71937,71937,636D66B9C2DD39D28485A7810A6E1528,10721,0,9,9,31,48,1598
71938,71938,636D66B9C2DD39D28485A7810A6E1528,10491,10,11,1,33,48,1698
71939,71939,636D66B9C2DD39D28485A7810A6E1528,12381,11,13,2,32,48,1648
71940,71940,636D66B9C2DD39D28485A7810A6E1528,10107,19,21,2,38,49,1949
71941,71941,9BE9B638A03223167AF819AA94751264,43121,0,6,6,25,27,1277
71942,71942,9BE9B638A03223167AF819AA94751264,15321,6,9,3,29,26,1476
71943,71943,9BE9B638A03223167AF819AA94751264,43121,11,23,12,25,27,1277
71950,71950,79180DDD86B22B2BAEB51E3552560D4E,11381,1,13,12,30,47,1547
71951,71951,79180DDD86B22B2BAEB51E3552560D4E,42401,14,18,4,36,47,1847
71952,71952,79180DDD86B22B2BAEB51E3552560D4E,11381,18,21,3,30,47,1547
71953,71953,79180DDD86B22B2BAEB51E3552560D4E,11491,21,23,2,36,47,1847
71954,71954,3F48B0843A6DE79E1B79258D18F461E8,42341,0,8,8,43,49,2199
71955,71955,3F48B0843A6DE79E1B79258D18F461E8,42461,12,14,2,45,47,2297
71956,71956,3F48B0843A6DE79E1B79258D18F461E8,13821,18,19,1,49,45,2495
71957,71957,3F48B0843A6DE79E1B79258D18F461E8,10921,19,21,2,43,48,2198
71958,71958,3F48B0843A6DE79E1B79258D18F461E8,42341,22,23,1,43,49,2199
71959,71959,EC5A21D69DAEA91AA737A76E2CB0C5FE,42691,2,11,9,24,48,1248
71960,71960,EC5A21D69DAEA91AA737A76E2CB0C5FE,10211,15,18,3,16,49,849
71961,71961,EC5A21D69DAEA91AA737A76E2CB0C5FE,12581,21,23,2,24,48,1248
71974,71974,A9FAA4B4C51A5D14416D1899F40B6E9A,19531,1,3,2,17,30,880
71975,71975,A9FAA4B4C51A5D14416D1899F40B6E9A,19801,6,21,15,19,26,976
71976,71976,A9FAA4B4C51A5D14416D1899F40B6E9A,13481,21,23,2,26,31,1331
71983,71983,B04440F57A2334689CE151EAF133623D,11791,1,6,5,38,49,1949
71984,71984,B04440F57A2334689CE151EAF133623D,10292,7,9,2,30,47,1547
71985,71985,B04440F57A2334689CE151EAF133623D,42521,9,14,5,31,47,1597
71986,71986,B04440F57A2334689CE151EAF133623D,10292,14,18,4,30,47,1547
71987,71987,EB723F2604EF7AE7C37A9459E67C1BA0,10171,0,1,1,26,47,1347
71988,71988,EB723F2604EF7AE7C37A9459E67C1BA0,42501,1,5,4,28,47,1447
71989,71989,EB723F2604EF7AE7C37A9459E67C1BA0,11261,8,22,14,36,46,1846
71990,71990,4A738DA40DC51A413284A84FD94422C1,11151,0,5,5,30,48,1548
71991,71991,4A738DA40DC51A413284A84FD94422C1,11061,6,7,1,29,48,1498
71992,71992,4A738DA40DC51A413284A84FD94422C1,11151,9,11,2,30,48,1548
71993,71993,4A738DA40DC51A413284A84FD94422C1,11631,15,23,8,12,49,649
72000,72000,56547DCD12E76D718E2E60F15A40B9D5,10111,0,8,8,37,47,1897
72001,72001,56547DCD12E76D718E2E60F15A40B9D5,42401,8,10,2,36,47,1847
72002,72002,56547DCD12E76D718E2E60F15A40B9D5,10401,12,17,5,33,49,1699
72003,72003,56547DCD12E76D718E2E60F15A40B9D5,10251,18,23,5,35,47,1797
72004,72004,DC9D8459A1C91A7E063D2DC1FB280BD0,11261,0,7,7,36,46,1846
72005,72005,DC9D8459A1C91A7E063D2DC1FB280BD0,10841,9,10,1,37,47,1897
72006,72006,DC9D8459A1C91A7E063D2DC1FB280BD0,42161,12,13,1,36,47,1847
72007,72007,DC9D8459A1C91A7E063D2DC1FB280BD0,10841,13,16,3,37,47,1897
72008,72008,DC9D8459A1C91A7E063D2DC1FB280BD0,11261,17,23,6,36,46,1846
72015,72015,AB57CFBC7FBBD1B4F46C04046F726522,15171,0,4,4,42,21,2121
72016,72016,AB57CFBC7FBBD1B4F46C04046F726522,15021,6,13,7,46,18,2318
72017,72017,AB57CFBC7FBBD1B4F46C04046F726522,12881,16,19,3,47,22,2372
72018,72018,AB57CFBC7FBBD1B4F46C04046F726522,15171,21,23,2,42,21,2121
72019,72019,2DC192DC303083B8FEFB2CD2D1161047,42461,0,6,6,45,47,2297
72020,72020,2DC192DC303083B8FEFB2CD2D1161047,10151,9,10,1,34,47,1747
72021,72021,2DC192DC303083B8FEFB2CD2D1161047,42201,10,12,2,43,46,2196
72022,72022,2DC192DC303083B8FEFB2CD2D1161047,42461,13,19,6,45,47,2297
72023,72023,2DC192DC303083B8FEFB2CD2D1161047,11384,20,22,2,30,47,1547
72027,72027,37F1D2311F2383134D9A7BD374E33133,43751,0,5,5,19,48,998
72028,72028,37F1D2311F2383134D9A7BD374E33133,10061,7,8,1,20,46,1046
72029,72029,37F1D2311F2383134D9A7BD374E33133,12051,11,12,1,20,47,1047
72030,72030,37F1D2311F2383134D9A7BD374E33133,10501,18,19,1,22,46,1146
72031,72031,37F1D2311F2383134D9A7BD374E33133,12051,20,22,2,20,47,1047
72032,72032,0CEDFC599FE515911C8AF1ADD0F867C7,13711,9,10,1,38,46,1946
72033,72033,0CEDFC599FE515911C8AF1ADD0F867C7,42511,10,17,7,37,47,1897
72034,72034,0CEDFC599FE515911C8AF1ADD0F867C7,42091,21,22,1,43,46,2196
72038,72038,8AAB036B09D3D2F76995D9AF3741FD6E,10381,1,8,7,31,49,1599
72039,72039,8AAB036B09D3D2F76995D9AF3741FD6E,42121,10,12,2,26,49,1349
72040,72040,8AAB036B09D3D2F76995D9AF3741FD6E,42071,12,16,4,31,49,1599
72041,72041,8AAB036B09D3D2F76995D9AF3741FD6E,42121,19,20,1,26,49,1349
72059,72059,470BE60325DA2FBBD1F75F1607157E14,12521,0,8,8,35,41,1791
72060,72060,470BE60325DA2FBBD1F75F1607157E14,13314,8,10,2,31,39,1589
72061,72061,470BE60325DA2FBBD1F75F1607157E14,12521,14,22,8,35,41,1791
72062,72062,0A22F61F47C43DA3AF3E24CBDD266B75,11231,8,14,6,37,49,1899
72063,72063,0A22F61F47C43DA3AF3E24CBDD266B75,19931,16,18,2,7,43,393
72064,72064,0A22F61F47C43DA3AF3E24CBDD266B75,11231,20,23,3,37,49,1899
72065,72065,D5C98D28246C767D0FFD7F7274CFF193,13314,0,14,14,31,39,1589
72066,72066,D5C98D28246C767D0FFD7F7274CFF193,12521,14,18,4,35,41,1791
72067,72067,D5C98D28246C767D0FFD7F7274CFF193,13314,19,23,4,31,39,1589
72068,72068,05DB08AFAEA6B1FFF1B9BBD7B1A29A93,10411,0,7,7,36,48,1848
72069,72069,05DB08AFAEA6B1FFF1B9BBD7B1A29A93,13371,9,17,8,41,47,2097
72070,72070,05DB08AFAEA6B1FFF1B9BBD7B1A29A93,43761,20,21,1,32,47,1647
72071,72071,8C54F679DD59F109DAF19BDB41D1658A,40673,0,12,12,36,48,1848
72072,72072,8C54F679DD59F109DAF19BDB41D1658A,10711,12,14,2,29,46,1496
72073,72073,8C54F679DD59F109DAF19BDB41D1658A,11061,19,20,1,29,48,1498
72080,72080,ED7D6E0D6245554973BF1FC4EA5C6C28,11151,2,5,3,30,48,1548
72081,72081,ED7D6E0D6245554973BF1FC4EA5C6C28,11061,7,9,2,29,48,1498
72082,72082,ED7D6E0D6245554973BF1FC4EA5C6C28,11151,9,15,6,30,48,1548
72083,72083,ED7D6E0D6245554973BF1FC4EA5C6C28,11061,15,18,3,29,48,1498
72084,72084,ED7D6E0D6245554973BF1FC4EA5C6C28,11151,19,20,1,30,48,1548
72085,72085,90AC20E6CC0B4ABA3A4EAC5C3086C030,13741,0,8,8,37,49,1899
72086,72086,90AC20E6CC0B4ABA3A4EAC5C3086C030,11271,11,12,1,37,48,1898
72087,72087,90AC20E6CC0B4ABA3A4EAC5C3086C030,13741,13,14,1,37,49,1899
72088,72088,90AC20E6CC0B4ABA3A4EAC5C3086C030,11081,18,19,1,35,46,1796
72089,72089,90AC20E6CC0B4ABA3A4EAC5C3086C030,11271,21,23,2,37,48,1898
72090,72090,CE78EE553F777788EEB60C0414830F41,42071,1,3,2,31,49,1599
72091,72091,CE78EE553F777788EEB60C0414830F41,42261,3,5,2,25,49,1299
72092,72092,CE78EE553F777788EEB60C0414830F41,42071,8,21,13,31,49,1599
72103,72103,775D2A8F104041B3D53BA2721A326EFF,42151,0,1,1,35,45,1795
72104,72104,775D2A8F104041B3D53BA2721A326EFF,42861,2,3,1,37,44,1894
72105,72105,775D2A8F104041B3D53BA2721A326EFF,13911,7,8,1,39,46,1996
72106,72106,775D2A8F104041B3D53BA2721A326EFF,42151,9,21,12,35,45,1795
72107,72107,6EB03DEC41F60785258F0AA9E4E23DB1,13671,0,7,7,27,43,1393
72108,72108,6EB03DEC41F60785258F0AA9E4E23DB1,11281,10,16,6,27,40,1390
72109,72109,6EB03DEC41F60785258F0AA9E4E23DB1,12521,18,23,5,35,41,1791
72110,72110,9027D7BCCA8B9488D727103093A0EE77,43951,2,4,2,49,41,2491
72111,72111,9027D7BCCA8B9488D727103093A0EE77,13341,5,9,4,44,45,2245
72112,72112,9027D7BCCA8B9488D727103093A0EE77,42631,11,18,7,43,45,2195
72113,72113,9027D7BCCA8B9488D727103093A0EE77,13341,19,23,4,44,45,2245
72114,72114,7CB7FF64BE81A0CF357C12C917AEAFB5,42381,0,1,1,39,41,1991
72115,72115,7CB7FF64BE81A0CF357C12C917AEAFB5,43451,2,5,3,37,40,1890
72116,72116,7CB7FF64BE81A0CF357C12C917AEAFB5,42381,9,10,1,39,41,1991
72117,72117,7CB7FF64BE81A0CF357C12C917AEAFB5,13071,17,19,2,41,41,2091
72118,72118,7CB7FF64BE81A0CF357C12C917AEAFB5,42381,21,22,1,39,41,1991
72119,72119,4F6A74BBD714EF065A4DB365EFF3390D,11271,0,7,7,37,48,1898
72120,72120,4F6A74BBD714EF065A4DB365EFF3390D,10411,8,10,2,36,48,1848
72121,72121,4F6A74BBD714EF065A4DB365EFF3390D,11271,11,13,2,37,48,1898
72122,72122,4F6A74BBD714EF065A4DB365EFF3390D,10411,16,17,1,36,48,1848
72123,72123,4F6A74BBD714EF065A4DB365EFF3390D,11271,20,21,1,37,48,1898
72124,72124,A027C5DDBE3D7192B84A5A46054C8047,13561,1,8,7,37,49,1899
72125,72125,A027C5DDBE3D7192B84A5A46054C8047,10651,8,9,1,36,49,1849
72126,72126,A027C5DDBE3D7192B84A5A46054C8047,42623,11,12,1,22,49,1149
72127,72127,A027C5DDBE3D7192B84A5A46054C8047,11021,16,18,2,36,49,1849
72135,72135,BBCB9918D42B41DEDF16DD7F5A9BE26F,11861,0,9,9,32,47,1647
72136,72136,BBCB9918D42B41DEDF16DD7F5A9BE26F,43311,10,12,2,31,48,1598
72137,72137,BBCB9918D42B41DEDF16DD7F5A9BE26F,11331,13,16,3,37,48,1898
72138,72138,BBCB9918D42B41DEDF16DD7F5A9BE26F,11861,17,23,6,32,47,1647
72139,72139,1D5FEB85097765A4DAC299D8A4D17B3D,10951,0,7,7,29,48,1498
72140,72140,1D5FEB85097765A4DAC299D8A4D17B3D,42501,11,14,3,28,47,1447
72141,72141,1D5FEB85097765A4DAC299D8A4D17B3D,11201,17,18,1,35,49,1799
72142,72142,1D5FEB85097765A4DAC299D8A4D17B3D,12381,19,22,3,32,48,1648
72143,72143,46248CD3AE5F02514CBE5AD511617E45,43641,0,9,9,16,38,838
72144,72144,46248CD3AE5F02514CBE5AD511617E45,11281,12,17,5,27,40,1390
72145,72145,46248CD3AE5F02514CBE5AD511617E45,13671,19,20,1,27,43,1393
72156,72156,B0FF888F2A2CE698F2B8641BCE4B074A,11875,2,6,4,30,46,1546
72157,72157,B0FF888F2A2CE698F2B8641BCE4B074A,12601,9,11,2,25,47,1297
72158,72158,B0FF888F2A2CE698F2B8641BCE4B074A,11875,13,15,2,30,46,1546
72159,72159,B0FF888F2A2CE698F2B8641BCE4B074A,10634,15,17,2,27,45,1395
72160,72160,B0FF888F2A2CE698F2B8641BCE4B074A,10351,17,19,2,28,45,1445
72161,72161,B0FF888F2A2CE698F2B8641BCE4B074A,10634,22,23,1,27,45,1395
72166,72166,A5267560F8241F40BFCB325C4ADBB18D,12601,0,5,5,25,47,1297
72167,72167,A5267560F8241F40BFCB325C4ADBB18D,10351,8,17,9,28,45,1445
72168,72168,A5267560F8241F40BFCB325C4ADBB18D,12601,17,23,6,25,47,1297
72172,72172,6684687C9F1041794E8237CE4D241C6F,10381,0,10,10,31,49,1599
72173,72173,6684687C9F1041794E8237CE4D241C6F,42081,11,15,4,24,49,1249
72174,72174,6684687C9F1041794E8237CE4D241C6F,11531,19,20,1,34,49,1749
72175,72175,6684687C9F1041794E8237CE4D241C6F,42081,21,22,1,24,49,1249
72186,72186,18535AFB54958AC8380701DD2588A05F,11811,0,7,7,38,49,1949
72187,72187,18535AFB54958AC8380701DD2588A05F,10471,7,19,12,37,48,1898
72188,72188,18535AFB54958AC8380701DD2588A05F,42071,20,21,1,31,49,1599
72192,72192,A4C8C00FA0A4D1520AC6B2AE48C6B569,11074,1,4,3,37,47,1897
72193,72193,A4C8C00FA0A4D1520AC6B2AE48C6B569,42021,7,8,1,33,47,1697
72194,72194,A4C8C00FA0A4D1520AC6B2AE48C6B569,43761,8,15,7,32,47,1647
72195,72195,A4C8C00FA0A4D1520AC6B2AE48C6B569,42021,15,16,1,33,47,1697
72196,72196,A4C8C00FA0A4D1520AC6B2AE48C6B569,11074,20,22,2,37,47,1897
72200,72200,7E31616D6D23FAEB6817BBE7B00B0724,11111,1,5,4,26,48,1348
72201,72201,7E31616D6D23FAEB6817BBE7B00B0724,42541,6,7,1,25,47,1297
72202,72202,7E31616D6D23FAEB6817BBE7B00B0724,42554,8,13,5,14,46,746
72203,72203,7E31616D6D23FAEB6817BBE7B00B0724,11211,15,18,3,34,49,1749
72210,72210,CA6629DF906B91DD4EA4830F2264CDB1,19901,8,9,1,7,44,394
72211,72211,CA6629DF906B91DD4EA4830F2264CDB1,12641,10,11,1,10,43,543
72212,72212,CA6629DF906B91DD4EA4830F2264CDB1,19114,11,12,1,7,43,393
72213,72213,CA6629DF906B91DD4EA4830F2264CDB1,12641,15,16,1,10,43,543
72214,72214,CA6629DF906B91DD4EA4830F2264CDB1,19114,16,18,2,7,43,393
72228,72228,884F24C0C30AAAE18B1978D3F711D159,43761,0,11,11,32,47,1647
72229,72229,884F24C0C30AAAE18B1978D3F711D159,40925,13,14,1,35,49,1799
72230,72230,884F24C0C30AAAE18B1978D3F711D159,43761,18,23,5,32,47,1647
72234,72234,7E5917195BA3F2D417497A12D2FCFAD6,43241,7,17,10,36,46,1846
72235,72235,7E5917195BA3F2D417497A12D2FCFAD6,13121,19,20,1,38,46,1946
72236,72236,7E5917195BA3F2D417497A12D2FCFAD6,13101,21,23,2,40,47,2047
72240,72240,73BB02B492444F6C22DA7784C4E36BAE,19741,0,8,8,5,44,294
72241,72241,73BB02B492444F6C22DA7784C4E36BAE,12641,8,10,2,10,43,543
72242,72242,73BB02B492444F6C22DA7784C4E36BAE,19741,13,23,10,5,44,294
72243,72243,FD926C96A4F9758B0E89829758CD18F3,10151,0,7,7,34,47,1747
72244,72244,FD926C96A4F9758B0E89829758CD18F3,40271,8,9,1,35,49,1799
72245,72245,FD926C96A4F9758B0E89829758CD18F3,43181,13,14,1,39,48,1998
72246,72246,FD926C96A4F9758B0E89829758CD18F3,10191,16,17,1,40,48,2048
72247,72247,FD926C96A4F9758B0E89829758CD18F3,10531,21,23,2,34,46,1746
72248,72248,9E74C4204DF0368A301BB287E42AE5CC,13371,0,17,17,41,47,2097
72249,72249,9E74C4204DF0368A301BB287E42AE5CC,11061,20,21,1,29,48,1498
72250,72250,9E74C4204DF0368A301BB287E42AE5CC,10231,22,23,1,39,49,1999
72251,72251,FC3EF5196F872A4E555EAB4D9CCCF241,15171,2,9,7,42,21,2121
72252,72252,FC3EF5196F872A4E555EAB4D9CCCF241,15661,12,15,3,36,26,1826
72253,72253,FC3EF5196F872A4E555EAB4D9CCCF241,15171,18,22,4,42,21,2121
72254,72254,41DD0A6027648481BFEC7812042262C9,42351,0,5,5,38,45,1945
72255,72255,41DD0A6027648481BFEC7812042262C9,13911,6,13,7,39,46,1996
72256,72256,41DD0A6027648481BFEC7812042262C9,11231,16,18,2,37,49,1899
72257,72257,41DD0A6027648481BFEC7812042262C9,13911,18,19,1,39,46,1996
72265,72265,B5F39D13F6C5569149EE5FC76B988FFF,10531,0,7,7,34,46,1746
72266,72266,B5F39D13F6C5569149EE5FC76B988FFF,43951,8,16,8,49,41,2491
72267,72267,B5F39D13F6C5569149EE5FC76B988FFF,43051,18,20,2,46,45,2345
72268,72268,346BF3F539A4C5C04EF0491F7207CF76,19114,0,5,5,7,43,393
72269,72269,346BF3F539A4C5C04EF0491F7207CF76,12641,6,11,5,10,43,543
72270,72270,346BF3F539A4C5C04EF0491F7207CF76,19114,12,13,1,7,43,393
72271,72271,346BF3F539A4C5C04EF0491F7207CF76,12641,14,16,2,10,43,543
72272,72272,346BF3F539A4C5C04EF0491F7207CF76,19114,18,22,4,7,43,393
72286,72286,DD0DDE62019DBDC86E7016216D82713F,42461,1,7,6,45,47,2297
72287,72287,DD0DDE62019DBDC86E7016216D82713F,42091,10,12,2,43,46,2196
72288,72288,DD0DDE62019DBDC86E7016216D82713F,42461,18,20,2,45,47,2297
72289,72289,DD0DDE62019DBDC86E7016216D82713F,12141,22,23,1,42,45,2145
72290,72290,C89DD497B3E25F408D5F4E0FF457EA4C,19071,0,15,15,7,29,379
72291,72291,C89DD497B3E25F408D5F4E0FF457EA4C,11914,17,20,3,37,48,1898
72292,72292,C89DD497B3E25F408D5F4E0FF457EA4C,40171,21,22,1,38,48,1948
72293,72293,AB0DFF3AE061724D46B37D576A8456F6,11491,0,3,3,36,47,1847
72294,72294,AB0DFF3AE061724D46B37D576A8456F6,13711,4,5,1,38,46,1946
72295,72295,AB0DFF3AE061724D46B37D576A8456F6,11491,9,11,2,36,47,1847
72296,72296,AB0DFF3AE061724D46B37D576A8456F6,41401,13,14,1,37,46,1896
72297,72297,AB0DFF3AE061724D46B37D576A8456F6,42511,16,18,2,37,47,1897
72298,72298,BA7F8D1245DF2BA170F396020DC5A58C,13671,0,18,18,27,43,1393
72299,72299,BA7F8D1245DF2BA170F396020DC5A58C,13314,20,22,2,31,39,1589
72300,72300,BA7F8D1245DF2BA170F396020DC5A58C,12521,22,23,1,35,41,1791
72301,72301,F3B7C397DA870428A84CFF50541D9D51,12211,0,8,8,41,44,2094
72302,72302,F3B7C397DA870428A84CFF50541D9D51,12561,12,14,2,45,43,2293
72303,72303,F3B7C397DA870428A84CFF50541D9D51,10301,16,17,1,31,45,1595
72304,72304,F3B7C397DA870428A84CFF50541D9D51,13941,19,21,2,41,47,2097
72305,72305,F3B7C397DA870428A84CFF50541D9D51,12211,21,23,2,41,44,2094
72306,72306,C1D79A070CFCF442F4B341637205D8DD,12561,0,5,5,45,43,2293
72307,72307,C1D79A070CFCF442F4B341637205D8DD,12211,8,18,10,41,44,2094
72308,72308,C1D79A070CFCF442F4B341637205D8DD,13221,20,22,2,40,47,2047
72309,72309,345D4029BCC33DBFE6D7841DB885E7B2,12131,0,7,7,32,47,1647
72310,72310,345D4029BCC33DBFE6D7841DB885E7B2,10621,9,11,2,41,49,2099
72311,72311,345D4029BCC33DBFE6D7841DB885E7B2,11021,12,14,2,36,49,1849
72312,72312,345D4029BCC33DBFE6D7841DB885E7B2,11301,15,17,2,41,49,2099
72313,72313,345D4029BCC33DBFE6D7841DB885E7B2,40951,19,22,3,36,49,1849
72314,72314,84B5C60C523AD3E6B3A5504D42211F29,11801,5,7,2,42,48,2148
72315,72315,84B5C60C523AD3E6B3A5504D42211F29,43731,11,14,3,34,47,1747
72316,72316,84B5C60C523AD3E6B3A5504D42211F29,11801,17,19,2,42,48,2148
72317,72317,84B5C60C523AD3E6B3A5504D42211F29,11701,22,23,1,43,48,2198
72324,72324,1277ACA424D6A91D4C363B632562549C,12601,1,2,1,25,47,1297
72325,72325,1277ACA424D6A91D4C363B632562549C,10501,3,5,2,22,46,1146
72326,72326,1277ACA424D6A91D4C363B632562549C,12601,10,17,7,25,47,1297
72327,72327,1277ACA424D6A91D4C363B632562549C,10501,19,20,1,22,46,1146
72328,72328,1277ACA424D6A91D4C363B632562549C,12601,21,23,2,25,47,1297
72329,72329,030F54FCA42B4F4796403A3FF24FCB98,10841,0,12,12,37,47,1897
72330,72330,030F54FCA42B4F4796403A3FF24FCB98,11211,13,17,4,34,49,1749
72331,72331,030F54FCA42B4F4796403A3FF24FCB98,10841,20,22,2,37,47,1897
72338,72338,0E949A83AE9C47CC26A81BD159EB88C0,43761,0,5,5,32,47,1647
72339,72339,0E949A83AE9C47CC26A81BD159EB88C0,10716,5,7,2,30,46,1546
72340,72340,0E949A83AE9C47CC26A81BD159EB88C0,42371,7,8,1,34,46,1746
72341,72341,0E949A83AE9C47CC26A81BD159EB88C0,43761,9,10,1,32,47,1647
72342,72342,0E949A83AE9C47CC26A81BD159EB88C0,10731,15,17,2,33,47,1697
72343,72343,0E949A83AE9C47CC26A81BD159EB88C0,10107,17,21,4,38,49,1949
72344,72344,0E949A83AE9C47CC26A81BD159EB88C0,11861,21,23,2,32,47,1647
72348,72348,968D16BB7A2C8AD194DFB66B25014586,43021,0,6,6,16,43,843
72349,72349,968D16BB7A2C8AD194DFB66B25014586,43644,10,15,5,14,38,738
72350,72350,968D16BB7A2C8AD194DFB66B25014586,43021,15,20,5,16,43,843
72351,72351,968D16BB7A2C8AD194DFB66B25014586,19261,20,22,2,6,37,337
72352,72352,968D16BB7A2C8AD194DFB66B25014586,12731,22,23,1,22,40,1140
72353,72353,EAEFCB977DEDF23C1346736B36A6F67B,42231,2,3,1,37,46,1896
72354,72354,EAEFCB977DEDF23C1346736B36A6F67B,11261,6,10,4,36,46,1846
72355,72355,EAEFCB977DEDF23C1346736B36A6F67B,13911,13,15,2,39,46,1996
72356,72356,EAEFCB977DEDF23C1346736B36A6F67B,11261,15,17,2,36,46,1846
72357,72357,EAEFCB977DEDF23C1346736B36A6F67B,42231,20,23,3,37,46,1896
72365,72365,A0A00D4FFCF39B121347488247DF3626,12311,1,6,5,30,44,1544
72366,72366,A0A00D4FFCF39B121347488247DF3626,11875,6,7,1,30,46,1546
72367,72367,A0A00D4FFCF39B121347488247DF3626,10301,8,9,1,31,45,1595
72368,72368,A0A00D4FFCF39B121347488247DF3626,11875,10,14,4,30,46,1546
72369,72369,A0A00D4FFCF39B121347488247DF3626,10531,16,19,3,34,46,1746
72370,72370,A0A00D4FFCF39B121347488247DF3626,12311,22,23,1,30,44,1544
72371,72371,89EC37A7B83D9B7D194154C37975BD9C,42521,0,4,4,31,47,1597
72372,72372,89EC37A7B83D9B7D194154C37975BD9C,43311,8,10,2,31,48,1598
72373,72373,89EC37A7B83D9B7D194154C37975BD9C,11061,10,13,3,29,48,1498
72374,72374,89EC37A7B83D9B7D194154C37975BD9C,43311,15,17,2,31,48,1598
72375,72375,89EC37A7B83D9B7D194154C37975BD9C,11061,17,19,2,29,48,1498
72379,72379,23DF459841C9C2453F55C2C4FAAF1034,10281,1,8,7,33,48,1698
72380,72380,23DF459841C9C2453F55C2C4FAAF1034,12311,9,17,8,30,44,1544
72381,72381,23DF459841C9C2453F55C2C4FAAF1034,42921,20,22,2,33,47,1697
72382,72382,F38AB0098BE65E711BE711E13E868DCB,43981,0,8,8,36,49,1849
72383,72383,F38AB0098BE65E711BE711E13E868DCB,11001,9,10,1,42,47,2147
72384,72384,F38AB0098BE65E711BE711E13E868DCB,13561,12,14,2,37,49,1899
72385,72385,F38AB0098BE65E711BE711E13E868DCB,13941,15,16,1,41,47,2097
72386,72386,F38AB0098BE65E711BE711E13E868DCB,13101,20,21,1,40,47,2047
72387,72387,F38AB0098BE65E711BE711E13E868DCB,11021,22,23,1,36,49,1849
72388,72388,6DC6899EB806586526087D7D07A5BEC1,10331,9,11,2,39,46,1996
72389,72389,6DC6899EB806586526087D7D07A5BEC1,11481,13,14,1,41,48,2098
72390,72390,6DC6899EB806586526087D7D07A5BEC1,10901,20,21,1,35,48,1798
72391,72391,D5A1F589AD5A8A456E0D23A90489837D,43761,0,7,7,32,47,1647
72392,72392,D5A1F589AD5A8A456E0D23A90489837D,11231,9,11,2,37,49,1899
72393,72393,D5A1F589AD5A8A456E0D23A90489837D,10901,12,17,5,35,48,1798
72394,72394,D5A1F589AD5A8A456E0D23A90489837D,43761,19,22,3,32,47,1647
72395,72395,966EF37DD81DE2F009202B5BDDCFCE29,42351,0,4,4,38,45,1945
72396,72396,966EF37DD81DE2F009202B5BDDCFCE29,13911,7,8,1,39,46,1996
72397,72397,966EF37DD81DE2F009202B5BDDCFCE29,42351,11,12,1,38,45,1945
72398,72398,966EF37DD81DE2F009202B5BDDCFCE29,42231,13,17,4,37,46,1896
72399,72399,966EF37DD81DE2F009202B5BDDCFCE29,42351,20,21,1,38,45,1945
72400,72400,966EF37DD81DE2F009202B5BDDCFCE29,11261,22,23,1,36,46,1846
72401,72401,5CBB3BFC4ED61841A41A893768B01036,13911,0,1,1,39,46,1996
72402,72402,5CBB3BFC4ED61841A41A893768B01036,42351,1,6,5,38,45,1945
72403,72403,5CBB3BFC4ED61841A41A893768B01036,13911,7,8,1,39,46,1996
72404,72404,5CBB3BFC4ED61841A41A893768B01036,11261,18,21,3,36,46,1846
72405,72405,5CBB3BFC4ED61841A41A893768B01036,12211,21,22,1,41,44,2094
72406,72406,221F9C243AB84B9C492B5517A9CC71A3,43761,0,6,6,32,47,1647
72407,72407,221F9C243AB84B9C492B5517A9CC71A3,42541,20,21,1,25,47,1297
72408,72408,221F9C243AB84B9C492B5517A9CC71A3,43761,22,23,1,32,47,1647
72409,72409,A53907219614BC9E0FC05C0EC4AF6DC2,13911,0,6,6,39,46,1996
72410,72410,A53907219614BC9E0FC05C0EC4AF6DC2,13711,8,9,1,38,46,1946
72411,72411,A53907219614BC9E0FC05C0EC4AF6DC2,13911,12,13,1,39,46,1996
72412,72412,A53907219614BC9E0FC05C0EC4AF6DC2,13711,15,17,2,38,46,1946
72413,72413,A53907219614BC9E0FC05C0EC4AF6DC2,13911,21,22,1,39,46,1996
72414,72414,E603C5CE99E3FE3BB5D201DC1F4B77FD,13111,0,2,2,42,46,2146
72415,72415,E603C5CE99E3FE3BB5D201DC1F4B77FD,43061,2,3,1,43,46,2196
72416,72416,E603C5CE99E3FE3BB5D201DC1F4B77FD,13111,4,18,14,42,46,2146
72417,72417,E603C5CE99E3FE3BB5D201DC1F4B77FD,13791,18,19,1,42,47,2147
72418,72418,E603C5CE99E3FE3BB5D201DC1F4B77FD,13111,19,23,4,42,46,2146
72425,72425,2808B465D0CA5BE626B66BA705E41B68,42351,1,3,2,38,45,1945
72426,72426,2808B465D0CA5BE626B66BA705E41B68,42861,7,10,3,37,44,1894
72427,72427,2808B465D0CA5BE626B66BA705E41B68,42351,12,13,1,38,45,1945
72428,72428,2808B465D0CA5BE626B66BA705E41B68,11261,13,15,2,36,46,1846
72429,72429,2808B465D0CA5BE626B66BA705E41B68,42861,16,18,2,37,44,1894
72436,72436,DAFE070AC8164EB683B9455E05DD84E1,40833,1,6,5,41,47,2097
72437,72437,DAFE070AC8164EB683B9455E05DD84E1,13101,6,8,2,40,47,2047
72438,72438,DAFE070AC8164EB683B9455E05DD84E1,40833,12,13,1,41,47,2097
72439,72439,DAFE070AC8164EB683B9455E05DD84E1,11481,16,18,2,41,48,2098
72440,72440,DAFE070AC8164EB683B9455E05DD84E1,13101,20,22,2,40,47,2047
72444,72444,5832F798017EC944959971DE10E6C76B,13911,0,6,6,39,46,1996
72445,72445,5832F798017EC944959971DE10E6C76B,12211,7,8,1,41,44,2094
72446,72446,5832F798017EC944959971DE10E6C76B,13911,11,15,4,39,46,1996
72447,72447,5832F798017EC944959971DE10E6C76B,11261,16,17,1,36,46,1846
72448,72448,5832F798017EC944959971DE10E6C76B,13911,17,18,1,39,46,1996
72449,72449,5832F798017EC944959971DE10E6C76B,11261,19,20,1,36,46,1846
72450,72450,EA2E51FE5BFEA837766CD4C51A57785E,42071,8,9,1,31,49,1599
72451,72451,EA2E51FE5BFEA837766CD4C51A57785E,10451,11,16,5,25,48,1298
72452,72452,EA2E51FE5BFEA837766CD4C51A57785E,42071,17,18,1,31,49,1599
72453,72453,9B27AA39D08A4AD4F1A3555FC349C4D1,10292,0,7,7,30,47,1547
72454,72454,9B27AA39D08A4AD4F1A3555FC349C4D1,10341,10,12,2,31,47,1597
72455,72455,9B27AA39D08A4AD4F1A3555FC349C4D1,19021,17,19,2,10,45,545
72456,72456,9B27AA39D08A4AD4F1A3555FC349C4D1,10341,20,23,3,31,47,1597
72457,72457,3C02B5838EDEAB0B15A337805B269A42,13011,0,5,5,39,47,1997
72458,72458,3C02B5838EDEAB0B15A337805B269A42,10634,6,18,12,27,45,1395
72459,72459,3C02B5838EDEAB0B15A337805B269A42,13011,20,23,3,39,47,1997
72460,72460,E42ED8B8B8ABEC36971CD7FB702F959D,11381,0,8,8,30,47,1547
72461,72461,E42ED8B8B8ABEC36971CD7FB702F959D,12391,9,12,3,36,49,1849
72462,72462,E42ED8B8B8ABEC36971CD7FB702F959D,11381,14,23,9,30,47,1547
72463,72463,457B779D00720128DC52229000CD7309,15114,0,14,14,22,16,1116
72464,72464,457B779D00720128DC52229000CD7309,16441,17,18,1,15,17,767
72465,72465,457B779D00720128DC52229000CD7309,15114,19,23,4,22,16,1116
72472,72472,B8DCAC0FC6FA981D871032E55C240C8E,11914,1,11,10,37,48,1898
72473,72473,B8DCAC0FC6FA981D871032E55C240C8E,42581,11,13,2,38,48,1948
72474,72474,B8DCAC0FC6FA981D871032E55C240C8E,10471,14,18,4,37,48,1898
72475,72475,B8DCAC0FC6FA981D871032E55C240C8E,42581,18,21,3,38,48,1948
72476,72476,B8DCAC0FC6FA981D871032E55C240C8E,11914,22,23,1,37,48,1898
72487,72487,D278A78B03015D942733A0F36181B50F,42021,0,1,1,33,47,1697
72488,72488,D278A78B03015D942733A0F36181B50F,43041,2,8,6,41,46,2096
72489,72489,D278A78B03015D942733A0F36181B50F,10431,9,12,3,33,49,1699
72490,72490,D278A78B03015D942733A0F36181B50F,43041,13,14,1,41,46,2096
72491,72491,D278A78B03015D942733A0F36181B50F,10431,17,18,1,33,49,1699
72492,72492,D278A78B03015D942733A0F36181B50F,42471,19,21,2,35,49,1799
72493,72493,EF9C99EE076D9702EF73224BC1A91C21,43621,0,6,6,46,48,2348
72494,72494,EF9C99EE076D9702EF73224BC1A91C21,11701,6,10,4,43,48,2198
72495,72495,EF9C99EE076D9702EF73224BC1A91C21,43621,12,13,1,46,48,2348
72496,72496,EF9C99EE076D9702EF73224BC1A91C21,42321,16,18,2,43,47,2197
72497,72497,EF9C99EE076D9702EF73224BC1A91C21,43621,21,23,2,46,48,2348
72498,72498,39179060954ADF536A44D5CDC3D7ADA4,10921,0,5,5,43,48,2198
72499,72499,39179060954ADF536A44D5CDC3D7ADA4,11261,5,18,13,36,46,1846
72500,72500,39179060954ADF536A44D5CDC3D7ADA4,10921,20,23,3,43,48,2198
72501,72501,BE6556F4F32DDBE17FA5A6143CEC24DA,11811,0,2,2,38,49,1949
72502,72502,BE6556F4F32DDBE17FA5A6143CEC24DA,42921,3,18,15,33,47,1697
72503,72503,BE6556F4F32DDBE17FA5A6143CEC24DA,11811,21,22,1,38,49,1949
72504,72504,639EA486291B8A87A84D90343A87732A,10451,0,6,6,25,48,1298
72505,72505,639EA486291B8A87A84D90343A87732A,10661,7,8,1,37,49,1899
72506,72506,639EA486291B8A87A84D90343A87732A,11791,8,10,2,38,49,1949
72507,72507,639EA486291B8A87A84D90343A87732A,10661,11,12,1,37,49,1899
72508,72508,639EA486291B8A87A84D90343A87732A,41621,14,16,2,38,49,1949
72509,72509,639EA486291B8A87A84D90343A87732A,11111,20,23,3,26,48,1348
72513,72513,77806B76C9464C3352C73240356F598A,42971,1,13,12,43,49,2199
72514,72514,77806B76C9464C3352C73240356F598A,43181,17,19,2,39,48,1998
72515,72515,77806B76C9464C3352C73240356F598A,11791,19,20,1,38,49,1949
72516,72516,C94109F455448027CE60D8FE61F82261,42623,0,2,2,22,49,1149
72517,72517,C94109F455448027CE60D8FE61F82261,42121,8,10,2,26,49,1349
72518,72518,C94109F455448027CE60D8FE61F82261,42623,11,13,2,22,49,1149
72519,72519,C94109F455448027CE60D8FE61F82261,42071,14,20,6,31,49,1599
72523,72523,5A42B801B95BDD55ADE863E86C2FD0C5,12491,1,8,7,36,43,1843
72524,72524,5A42B801B95BDD55ADE863E86C2FD0C5,13551,12,14,2,45,38,2288
72525,72525,5A42B801B95BDD55ADE863E86C2FD0C5,43101,14,20,6,46,40,2340
72526,72526,5A42B801B95BDD55ADE863E86C2FD0C5,12491,21,23,2,36,43,1843
72533,72533,37C29D4674FBC06EF76342F2283F4E15,42031,0,6,6,40,46,2046
72534,72534,37C29D4674FBC06EF76342F2283F4E15,12731,8,10,2,22,40,1140
72535,72535,37C29D4674FBC06EF76342F2283F4E15,13671,10,11,1,27,43,1393
72536,72536,37C29D4674FBC06EF76342F2283F4E15,12731,12,13,1,22,40,1140
72537,72537,37C29D4674FBC06EF76342F2283F4E15,13671,14,16,2,27,43,1393
72538,72538,37C29D4674FBC06EF76342F2283F4E15,42031,18,19,1,40,46,2046
72539,72539,37C29D4674FBC06EF76342F2283F4E15,13561,19,21,2,37,49,1899
72543,72543,2BB5E6319C361908A67DD8509286CF7C,19031,0,6,6,1,42,92
72544,72544,2BB5E6319C361908A67DD8509286CF7C,12921,8,9,1,9,41,491
72545,72545,2BB5E6319C361908A67DD8509286CF7C,19031,10,23,13,1,42,92
72546,72546,29E682BF994B2ACA314777BEAEB90BB7,13911,1,7,6,39,46,1996
72547,72547,29E682BF994B2ACA314777BEAEB90BB7,42231,8,11,3,37,46,1896
72548,72548,29E682BF994B2ACA314777BEAEB90BB7,13911,12,13,1,39,46,1996
72549,72549,29E682BF994B2ACA314777BEAEB90BB7,42231,18,19,1,37,46,1896
72550,72550,29E682BF994B2ACA314777BEAEB90BB7,42351,19,20,1,38,45,1945
72551,72551,29E682BF994B2ACA314777BEAEB90BB7,42231,22,23,1,37,46,1896
72552,72552,3B9989389C2FB72384F3330F9A990AB0,13911,0,1,1,39,46,1996
72553,72553,3B9989389C2FB72384F3330F9A990AB0,42351,2,3,1,38,45,1945
72554,72554,3B9989389C2FB72384F3330F9A990AB0,13911,4,5,1,39,46,1996
72555,72555,3B9989389C2FB72384F3330F9A990AB0,42231,8,10,2,37,46,1896
72556,72556,3B9989389C2FB72384F3330F9A990AB0,42351,12,13,1,38,45,1945
72557,72557,3B9989389C2FB72384F3330F9A990AB0,42231,13,19,6,37,46,1896
72558,72558,E16566CAC1D2263C830A92E3D7A4B3A9,42351,7,9,2,38,45,1945
72559,72559,E16566CAC1D2263C830A92E3D7A4B3A9,13911,11,13,2,39,46,1996
72560,72560,E16566CAC1D2263C830A92E3D7A4B3A9,42351,14,16,2,38,45,1945
72561,72561,E16566CAC1D2263C830A92E3D7A4B3A9,42231,20,22,2,37,46,1896
72562,72562,E16566CAC1D2263C830A92E3D7A4B3A9,13911,22,23,1,39,46,1996
72579,72579,4E22CAE8774A9F064D48507CF8FECB20,11901,0,9,9,42,49,2149
72580,72580,4E22CAE8774A9F064D48507CF8FECB20,12391,11,18,7,36,49,1849
72581,72581,4E22CAE8774A9F064D48507CF8FECB20,11901,19,23,4,42,49,2149
72585,72585,FB55B20B748C0A1CF26B4BE2B509424A,12761,0,1,1,25,40,1290
72586,72586,FB55B20B748C0A1CF26B4BE2B509424A,13671,1,16,15,27,43,1393
72587,72587,FB55B20B748C0A1CF26B4BE2B509424A,12761,18,19,1,25,40,1290
72599,72599,882BF8BB430417240B4DD1B19642793C,10951,10,14,4,29,48,1498
72600,72600,882BF8BB430417240B4DD1B19642793C,12381,14,16,2,32,48,1648
72601,72601,882BF8BB430417240B4DD1B19642793C,10191,19,23,4,40,48,2048
72602,72602,5D77C455155C654440C1FABC6822DC8C,11301,0,6,6,41,49,2099
72603,72603,5D77C455155C654440C1FABC6822DC8C,10716,8,19,11,30,46,1546
72604,72604,5D77C455155C654440C1FABC6822DC8C,43361,19,21,2,38,48,1948
72605,72605,E6D049947968658F47DDC695A59302A1,42321,0,6,6,43,47,2197
72606,72606,E6D049947968658F47DDC695A59302A1,42461,6,10,4,45,47,2297
72607,72607,E6D049947968658F47DDC695A59302A1,42111,11,13,2,44,46,2246
72608,72608,E6D049947968658F47DDC695A59302A1,42461,13,14,1,45,47,2297
72609,72609,E6D049947968658F47DDC695A59302A1,42111,17,19,2,44,46,2246
72610,72610,E6D049947968658F47DDC695A59302A1,42204,19,22,3,43,46,2196
72611,72611,71AB304A084EB4095E1F705C48CB0E23,11901,0,6,6,42,49,2149
72612,72612,71AB304A084EB4095E1F705C48CB0E23,11914,7,18,11,37,48,1898
72613,72613,71AB304A084EB4095E1F705C48CB0E23,11901,18,23,5,42,49,2149
72620,72620,707301303914C53DDB5018F19439C132,11021,9,10,1,36,49,1849
72621,72621,707301303914C53DDB5018F19439C132,10471,13,17,4,37,48,1898
72622,72622,707301303914C53DDB5018F19439C132,11301,19,20,1,41,49,2099
72623,72623,707301303914C53DDB5018F19439C132,12481,22,23,1,37,49,1899
72630,72630,2D7ACF8AD7E4B49F2A7FD23DB75DC6F1,42971,0,6,6,43,49,2199
72631,72631,2D7ACF8AD7E4B49F2A7FD23DB75DC6F1,10921,6,8,2,43,48,2198
72632,72632,2D7ACF8AD7E4B49F2A7FD23DB75DC6F1,42971,12,13,1,43,49,2199
72633,72633,2D7ACF8AD7E4B49F2A7FD23DB75DC6F1,43191,17,18,1,40,49,2049
72634,72634,2D7ACF8AD7E4B49F2A7FD23DB75DC6F1,42341,19,23,4,43,49,2199
72646,72646,26D70945C43960D97DB289F7CCF774D8,19114,0,6,6,7,43,393
72647,72647,26D70945C43960D97DB289F7CCF774D8,12921,7,10,3,9,41,491
72648,72648,26D70945C43960D97DB289F7CCF774D8,19114,12,13,1,7,43,393
72649,72649,26D70945C43960D97DB289F7CCF774D8,12921,14,16,2,9,41,491
72650,72650,26D70945C43960D97DB289F7CCF774D8,19114,20,23,3,7,43,393
72658,72658,5ABC9E905F8F6D8C8CB5A05232E2F155,13511,0,1,1,34,48,1748
72659,72659,5ABC9E905F8F6D8C8CB5A05232E2F155,10251,2,4,2,35,47,1797
72660,72660,5ABC9E905F8F6D8C8CB5A05232E2F155,40637,5,12,7,36,47,1847
72661,72661,5ABC9E905F8F6D8C8CB5A05232E2F155,10251,14,18,4,35,47,1797
72662,72662,5ABC9E905F8F6D8C8CB5A05232E2F155,40636,20,23,3,35,48,1798
72663,72663,9FC39451E6DCCE94D942B7AE2584CFA7,41392,0,7,7,43,48,2198
72664,72664,9FC39451E6DCCE94D942B7AE2584CFA7,42321,8,9,1,43,47,2197
72665,72665,9FC39451E6DCCE94D942B7AE2584CFA7,10801,12,13,1,42,47,2147
72666,72666,9FC39451E6DCCE94D942B7AE2584CFA7,42321,13,14,1,43,47,2197
72667,72667,9FC39451E6DCCE94D942B7AE2584CFA7,41392,14,23,9,43,48,2198
72668,72668,84BFDA5775B1A36CF113618F1669E73C,42521,0,6,6,31,47,1597
72669,72669,84BFDA5775B1A36CF113618F1669E73C,13651,6,7,1,30,47,1547
72670,72670,84BFDA5775B1A36CF113618F1669E73C,42521,12,14,2,31,47,1597
72671,72671,84BFDA5775B1A36CF113618F1669E73C,13651,16,18,2,30,47,1547
72672,72672,84BFDA5775B1A36CF113618F1669E73C,42521,19,23,4,31,47,1597
72673,72673,D1348284A12247DBF7195CE953852CD8,43311,0,8,8,31,48,1598
72674,72674,D1348284A12247DBF7195CE953852CD8,11061,8,10,2,29,48,1498
72675,72675,D1348284A12247DBF7195CE953852CD8,11161,10,13,3,32,48,1648
72676,72676,D1348284A12247DBF7195CE953852CD8,43311,15,16,1,31,48,1598
72677,72677,D1348284A12247DBF7195CE953852CD8,11061,20,21,1,29,48,1498
72678,72678,D3A8E24567875F3C39102478CB1D4A49,42633,0,6,6,42,46,2146
72679,72679,D3A8E24567875F3C39102478CB1D4A49,11061,6,9,3,29,48,1498
72680,72680,D3A8E24567875F3C39102478CB1D4A49,42633,20,23,3,42,46,2146
72681,72681,69F41107244EDDE97DD1AAB2D554177A,19281,0,5,5,16,32,832
72682,72682,69F41107244EDDE97DD1AAB2D554177A,12871,7,18,11,22,33,1133
72683,72683,69F41107244EDDE97DD1AAB2D554177A,19281,18,20,2,16,32,832
72684,72684,69F41107244EDDE97DD1AAB2D554177A,12871,20,23,3,22,33,1133
72706,72706,BC3DA9BAF9B0A0C935A79D91ECBDA067,19441,0,8,8,8,46,446
72707,72707,BC3DA9BAF9B0A0C935A79D91ECBDA067,42151,8,16,8,35,45,1795
72708,72708,BC3DA9BAF9B0A0C935A79D91ECBDA067,12491,18,23,5,36,43,1843
72709,72709,AD3E6481838BF400FA98C1C2BDCD8C19,42681,3,9,6,24,48,1248
72710,72710,AD3E6481838BF400FA98C1C2BDCD8C19,10431,13,16,3,33,49,1699
72711,72711,AD3E6481838BF400FA98C1C2BDCD8C19,42681,21,23,2,24,48,1248
72712,72712,C187943D20D187183526E0228C45660E,11021,0,7,7,36,49,1849
72713,72713,C187943D20D187183526E0228C45660E,11081,9,15,6,35,46,1796
72714,72714,C187943D20D187183526E0228C45660E,10721,16,18,2,31,48,1598
72715,72715,C187943D20D187183526E0228C45660E,11021,19,23,4,36,49,1849
72716,72716,B27ACD37439FA0175615381A2A4522E0,15143,0,1,1,18,7,907
72717,72717,B27ACD37439FA0175615381A2A4522E0,16281,2,9,7,11,4,554
72718,72718,B27ACD37439FA0175615381A2A4522E0,15143,14,18,4,18,7,907
72719,72719,B27ACD37439FA0175615381A2A4522E0,16281,21,23,2,11,4,554
72723,72723,F4A5CE128B0276BA64A57CF9F5D60F74,42831,0,14,14,27,48,1398
72724,72724,F4A5CE128B0276BA64A57CF9F5D60F74,11271,18,19,1,37,48,1898
72725,72725,F4A5CE128B0276BA64A57CF9F5D60F74,42831,19,23,4,27,48,1398
72726,72726,4DEA0FD12DF0F5FFC5F59DA987C67C0B,10431,0,1,1,33,49,1699
72727,72727,4DEA0FD12DF0F5FFC5F59DA987C67C0B,11171,2,4,2,33,48,1698
72728,72728,4DEA0FD12DF0F5FFC5F59DA987C67C0B,10431,4,13,9,33,49,1699
72729,72729,4DEA0FD12DF0F5FFC5F59DA987C67C0B,42491,19,21,2,32,46,1646
72730,72730,4DEA0FD12DF0F5FFC5F59DA987C67C0B,10431,22,23,1,33,49,1699
72731,72731,64BD805F6D9361B926D90DA2610BBB4F,49201,0,6,6,7,41,391
72732,72732,64BD805F6D9361B926D90DA2610BBB4F,12921,7,8,1,9,41,491
72733,72733,64BD805F6D9361B926D90DA2610BBB4F,49201,8,10,2,7,41,391
72734,72734,64BD805F6D9361B926D90DA2610BBB4F,12921,11,12,1,9,41,491
72735,72735,64BD805F6D9361B926D90DA2610BBB4F,49201,14,21,7,7,41,391
72736,72736,64BD805F6D9361B926D90DA2610BBB4F,12921,22,23,1,9,41,491
72740,72740,09B258FCC1A04CEAAFFB93000EF42A6F,10811,0,1,1,38,46,1946
72741,72741,09B258FCC1A04CEAAFFB93000EF42A6F,42031,2,4,2,40,46,2046
72742,72742,09B258FCC1A04CEAAFFB93000EF42A6F,11074,7,8,1,37,47,1897
72743,72743,09B258FCC1A04CEAAFFB93000EF42A6F,10601,8,11,3,39,47,1997
72744,72744,09B258FCC1A04CEAAFFB93000EF42A6F,10811,13,14,1,38,46,1946
72745,72745,09B258FCC1A04CEAAFFB93000EF42A6F,10601,16,19,3,39,47,1997
72755,72755,3F2FE95AB24E5E71D935604E5158C97B,10924,0,9,9,43,49,2199
72756,72756,3F2FE95AB24E5E71D935604E5158C97B,41392,12,14,2,43,48,2198
72757,72757,3F2FE95AB24E5E71D935604E5158C97B,10924,19,20,1,43,49,2199
72758,72758,3F2FE95AB24E5E71D935604E5158C97B,42161,20,22,2,36,47,1847
72759,72759,7B7D796FA1F0073F7A8599ACB1FB2CF7,11954,1,5,4,32,49,1649
72760,72760,7B7D796FA1F0073F7A8599ACB1FB2CF7,42261,11,12,1,25,49,1299
72761,72761,7B7D796FA1F0073F7A8599ACB1FB2CF7,42623,14,16,2,22,49,1149
72762,72762,7B7D796FA1F0073F7A8599ACB1FB2CF7,42071,21,23,2,31,49,1599
72772,72772,7426FA2174BAA70B5B8830C85DC3AB87,43751,0,10,10,19,48,998
72773,72773,7426FA2174BAA70B5B8830C85DC3AB87,12581,12,16,4,24,48,1248
72774,72774,7426FA2174BAA70B5B8830C85DC3AB87,43751,18,22,4,19,48,998
72778,72778,2873DE93703B028193B7B9719DCFE691,12521,0,7,7,35,41,1791
72779,72779,2873DE93703B028193B7B9719DCFE691,43451,7,9,2,37,40,1890
72780,72780,2873DE93703B028193B7B9719DCFE691,12521,11,12,1,35,41,1791
72781,72781,2873DE93703B028193B7B9719DCFE691,43451,15,17,2,37,40,1890
72782,72782,2873DE93703B028193B7B9719DCFE691,12521,17,22,5,35,41,1791
72790,72790,6B614428F8D95ECFDE2207017437E97D,19281,0,5,5,16,32,832
72791,72791,6B614428F8D95ECFDE2207017437E97D,12871,5,18,13,22,33,1133
72792,72792,6B614428F8D95ECFDE2207017437E97D,19281,19,22,3,16,32,832
72793,72793,7861278735CDA91B9BABB196FBF7605C,43951,0,11,11,49,41,2491
72794,72794,7861278735CDA91B9BABB196FBF7605C,13951,12,16,4,47,45,2395
72795,72795,7861278735CDA91B9BABB196FBF7605C,43951,17,21,4,49,41,2491
72803,72803,A6882D1B4D4FE005554D613FCD3E129A,19114,2,5,3,7,43,393
72804,72804,A6882D1B4D4FE005554D613FCD3E129A,12641,6,8,2,10,43,543
72805,72805,A6882D1B4D4FE005554D613FCD3E129A,12921,9,10,1,9,41,491
72806,72806,A6882D1B4D4FE005554D613FCD3E129A,19744,14,17,3,6,43,343
72807,72807,A6882D1B4D4FE005554D613FCD3E129A,19931,18,19,1,7,43,393
72808,72808,733176FE0198F4C1A0E6DD3DFED27541,15051,4,9,5,19,4,954
72809,72809,733176FE0198F4C1A0E6DD3DFED27541,16281,12,14,2,11,4,554
72810,72810,733176FE0198F4C1A0E6DD3DFED27541,15481,14,16,2,24,5,1205
72811,72811,733176FE0198F4C1A0E6DD3DFED27541,15281,17,19,2,25,3,1253
72812,72812,733176FE0198F4C1A0E6DD3DFED27541,15051,20,21,1,19,4,954
72813,72813,733176FE0198F4C1A0E6DD3DFED27541,16281,22,23,1,11,4,554
72817,72817,335FD8782D4F531D88DAC06C84870767,13411,4,5,1,49,42,2492
72818,72818,335FD8782D4F531D88DAC06C84870767,43951,8,9,1,49,41,2491
72819,72819,335FD8782D4F531D88DAC06C84870767,13411,9,17,8,49,42,2492
72820,72820,335FD8782D4F531D88DAC06C84870767,43951,17,19,2,49,41,2491
72821,72821,335FD8782D4F531D88DAC06C84870767,13411,19,20,1,49,42,2492
72825,72825,879D40C6B1D97CFC721931429930806C,19901,0,7,7,7,44,394
72826,72826,879D40C6B1D97CFC721931429930806C,12921,11,15,4,9,41,491
72827,72827,879D40C6B1D97CFC721931429930806C,43021,16,18,2,16,43,843
72828,72828,0D36A1D24D5B2BD0DD4C9AB7DCC57AAE,10544,7,8,1,28,48,1448
72829,72829,0D36A1D24D5B2BD0DD4C9AB7DCC57AAE,13731,11,12,1,33,49,1699
72830,72830,0D36A1D24D5B2BD0DD4C9AB7DCC57AAE,42071,18,19,1,31,49,1599
72831,72831,0D36A1D24D5B2BD0DD4C9AB7DCC57AAE,10716,22,23,1,30,46,1546
72838,72838,AA9DDBAE747C0C61A76E689DD898E315,42301,0,6,6,36,47,1847
72839,72839,AA9DDBAE747C0C61A76E689DD898E315,11871,8,9,1,29,46,1496
72840,72840,AA9DDBAE747C0C61A76E689DD898E315,11875,10,12,2,30,46,1546
72841,72841,AA9DDBAE747C0C61A76E689DD898E315,12311,13,16,3,30,44,1544
72842,72842,AA9DDBAE747C0C61A76E689DD898E315,42301,18,20,2,36,47,1847
72843,72843,8671664FCEA72D44791A077CF27C82B3,12921,3,5,2,9,41,491
72844,72844,8671664FCEA72D44791A077CF27C82B3,43021,7,8,1,16,43,843
72845,72845,8671664FCEA72D44791A077CF27C82B3,12921,9,10,1,9,41,491
72846,72846,8671664FCEA72D44791A077CF27C82B3,43021,16,18,2,16,43,843
72847,72847,8671664FCEA72D44791A077CF27C82B3,12641,21,22,1,10,43,543
72857,72857,AE10E091EA2027CDBE5CBFBC2238F486,19244,0,5,5,1,43,93
72858,72858,AE10E091EA2027CDBE5CBFBC2238F486,12921,7,18,11,9,41,491
72859,72859,AE10E091EA2027CDBE5CBFBC2238F486,19114,20,22,2,7,43,393
72860,72860,400659CE2E6F8BFF6D95D6F52F73DF5B,42921,0,6,6,33,47,1697
72861,72861,400659CE2E6F8BFF6D95D6F52F73DF5B,11861,6,11,5,32,47,1647
72862,72862,400659CE2E6F8BFF6D95D6F52F73DF5B,42921,12,13,1,33,47,1697
72863,72863,400659CE2E6F8BFF6D95D6F52F73DF5B,11861,13,19,6,32,47,1647
72864,72864,400659CE2E6F8BFF6D95D6F52F73DF5B,42921,21,23,2,33,47,1697
72865,72865,3DE2EB2908618D68DBDCBDCDD1BB77DF,11861,5,8,3,32,47,1647
72866,72866,3DE2EB2908618D68DBDCBDCDD1BB77DF,11231,9,12,3,37,49,1899
72867,72867,3DE2EB2908618D68DBDCBDCDD1BB77DF,11861,12,17,5,32,47,1647
72868,72868,3DE2EB2908618D68DBDCBDCDD1BB77DF,10281,17,18,1,33,48,1698
72869,72869,3DE2EB2908618D68DBDCBDCDD1BB77DF,43241,19,20,1,36,46,1846
72870,72870,3DE2EB2908618D68DBDCBDCDD1BB77DF,11861,21,23,2,32,47,1647
72871,72871,7446641F73809A823733CBB6864B4050,43011,0,6,6,40,42,2042
72872,72872,7446641F73809A823733CBB6864B4050,42861,7,8,1,37,44,1894
72873,72873,7446641F73809A823733CBB6864B4050,11261,10,14,4,36,46,1846
72874,72874,7446641F73809A823733CBB6864B4050,42231,19,21,2,37,46,1896
72875,72875,7446641F73809A823733CBB6864B4050,42861,22,23,1,37,44,1894
72880,72880,B43514E97D3D5FCC7D5BD63E5AFB9616,13341,0,7,7,44,45,2245
72881,72881,B43514E97D3D5FCC7D5BD63E5AFB9616,42633,8,11,3,42,46,2146
72882,72882,B43514E97D3D5FCC7D5BD63E5AFB9616,43061,12,13,1,43,46,2196
72883,72883,B43514E97D3D5FCC7D5BD63E5AFB9616,13111,18,19,1,42,46,2146
72884,72884,B43514E97D3D5FCC7D5BD63E5AFB9616,42201,21,23,2,43,46,2196
72885,72885,D59A7D67E6A2D306517724C5A50D5385,10301,0,3,3,31,45,1595
72886,72886,D59A7D67E6A2D306517724C5A50D5385,10351,3,6,3,28,45,1445
72887,72887,D59A7D67E6A2D306517724C5A50D5385,42531,6,10,4,31,45,1595
72888,72888,D59A7D67E6A2D306517724C5A50D5385,10351,11,14,3,28,45,1445
72889,72889,D59A7D67E6A2D306517724C5A50D5385,10301,14,20,6,31,45,1595
72904,72904,F475546FA2D112D7D0EDED3FAB477F8E,40801,0,7,7,43,46,2196
72905,72905,F475546FA2D112D7D0EDED3FAB477F8E,10251,9,11,2,35,47,1797
72906,72906,F475546FA2D112D7D0EDED3FAB477F8E,40801,12,14,2,43,46,2196
72907,72907,F475546FA2D112D7D0EDED3FAB477F8E,10251,16,18,2,35,47,1797
72908,72908,F475546FA2D112D7D0EDED3FAB477F8E,10721,19,21,2,31,48,1598
72909,72909,F475546FA2D112D7D0EDED3FAB477F8E,40801,22,23,1,43,46,2196
72917,72917,97E4702F624CE098E267C7767A3602E0,11061,0,1,1,29,48,1498
72918,72918,97E4702F624CE098E267C7767A3602E0,10681,1,8,7,30,48,1548
72919,72919,97E4702F624CE098E267C7767A3602E0,11061,10,12,2,29,48,1498
72920,72920,97E4702F624CE098E267C7767A3602E0,10681,13,14,1,30,48,1548
72921,72921,97E4702F624CE098E267C7767A3602E0,11061,16,19,3,29,48,1498
72922,72922,0C653DC860B823A0FBD73915967D7A74,43051,0,2,2,46,45,2345
72923,72923,0C653DC860B823A0FBD73915967D7A74,10751,2,4,2,47,43,2393
72924,72924,0C653DC860B823A0FBD73915967D7A74,12221,6,8,2,43,44,2194
72925,72925,0C653DC860B823A0FBD73915967D7A74,43051,11,13,2,46,45,2345
72926,72926,0C653DC860B823A0FBD73915967D7A74,12221,14,17,3,43,44,2194
72927,72927,0C653DC860B823A0FBD73915967D7A74,42631,17,19,2,43,45,2195
72928,72928,8D188B1328CA03E5FCB5F80DC745FFDD,42523,0,13,13,31,47,1597
72929,72929,8D188B1328CA03E5FCB5F80DC745FFDD,10401,14,17,3,33,49,1699
72930,72930,8D188B1328CA03E5FCB5F80DC745FFDD,10221,19,20,1,34,49,1749
72931,72931,8D188B1328CA03E5FCB5F80DC745FFDD,42523,20,23,3,31,47,1597
72936,72936,C2155D5C42247E7E781AF1E5B78AF552,42531,3,6,3,31,45,1595
72937,72937,C2155D5C42247E7E781AF1E5B78AF552,12491,8,9,1,36,43,1843
72938,72938,C2155D5C42247E7E781AF1E5B78AF552,13671,12,14,2,27,43,1393
72939,72939,C2155D5C42247E7E781AF1E5B78AF552,42531,14,19,5,31,45,1595
72940,72940,C2155D5C42247E7E781AF1E5B78AF552,12491,21,22,1,36,43,1843
72941,72941,1607BA6A625F09858B43E48B2EC869F9,12311,0,6,6,30,44,1544
72942,72942,1607BA6A625F09858B43E48B2EC869F9,12381,7,13,6,32,48,1648
72943,72943,1607BA6A625F09858B43E48B2EC869F9,10295,14,17,3,30,47,1547
72944,72944,1607BA6A625F09858B43E48B2EC869F9,12381,18,19,1,32,48,1648
72945,72945,E75DBC8FF69066A482B9B403023F9E0C,42021,0,5,5,33,47,1697
72946,72946,E75DBC8FF69066A482B9B403023F9E0C,10191,7,18,11,40,48,2048
72947,72947,E75DBC8FF69066A482B9B403023F9E0C,11861,20,21,1,32,47,1647
72954,72954,E46021F2EBB1FF86CE07D74A4E5B9C9F,12921,0,12,12,9,41,491
72955,72955,E46021F2EBB1FF86CE07D74A4E5B9C9F,19901,13,14,1,7,44,394
72956,72956,E46021F2EBB1FF86CE07D74A4E5B9C9F,49201,19,22,3,7,41,391
72974,72974,1AA73B2A580265381F970F93A1691903,13471,10,13,3,47,49,2399
72975,72975,1AA73B2A580265381F970F93A1691903,40691,14,16,2,42,48,2148
72976,72976,1AA73B2A580265381F970F93A1691903,40341,19,22,3,23,49,1199
72977,72977,1B963B1C6FCFA0D8416B4DA4107D787E,13094,0,5,5,21,42,1092
72978,72978,1B963B1C6FCFA0D8416B4DA4107D787E,13091,5,7,2,20,42,1042
72979,72979,1B963B1C6FCFA0D8416B4DA4107D787E,10351,8,10,2,28,45,1445
72980,72980,1B963B1C6FCFA0D8416B4DA4107D787E,13091,12,16,4,20,42,1042
72981,72981,1B963B1C6FCFA0D8416B4DA4107D787E,12671,18,22,4,21,43,1093
72982,72982,CA5A17D561EB9E25269F629C4481540B,19441,0,1,1,8,46,446
72983,72983,CA5A17D561EB9E25269F629C4481540B,42041,2,9,7,10,47,547
72984,72984,CA5A17D561EB9E25269F629C4481540B,19441,12,13,1,8,46,446
72985,72985,CA5A17D561EB9E25269F629C4481540B,11571,14,16,2,13,46,696
72986,72986,CA5A17D561EB9E25269F629C4481540B,42041,21,23,2,10,47,547
72990,72990,7300FFB733BFFEA187DB110E4D4DC3D2,19181,0,6,6,8,40,440
72991,72991,7300FFB733BFFEA187DB110E4D4DC3D2,12921,8,12,4,9,41,491
72992,72992,7300FFB733BFFEA187DB110E4D4DC3D2,49201,12,13,1,7,41,391
72993,72993,7300FFB733BFFEA187DB110E4D4DC3D2,19114,19,20,1,7,43,393
72994,72994,7300FFB733BFFEA187DB110E4D4DC3D2,49201,22,23,1,7,41,391
72998,72998,27F132E818644D3933B7D51A13F3BE57,15561,1,5,4,32,22,1622
72999,72999,27F132E818644D3933B7D51A13F3BE57,15411,6,18,12,44,27,2227
73000,73000,27F132E818644D3933B7D51A13F3BE57,12611,18,19,1,41,29,2079
73001,73001,27F132E818644D3933B7D51A13F3BE57,15411,22,23,1,44,27,2227
73002,73002,0459FE58A4EB1359E727E484FA7F3444,10691,0,6,6,33,48,1698
73003,73003,0459FE58A4EB1359E727E484FA7F3444,42941,7,15,8,37,47,1897
73004,73004,0459FE58A4EB1359E727E484FA7F3444,43731,16,18,2,34,47,1747
73005,73005,0459FE58A4EB1359E727E484FA7F3444,10691,19,23,4,33,48,1698
73009,73009,853A16C8E6E154D13F9864F752CCB2E5,13101,0,2,2,40,47,2047
73010,73010,853A16C8E6E154D13F9864F752CCB2E5,13271,4,5,1,41,47,2097
73011,73011,853A16C8E6E154D13F9864F752CCB2E5,11481,6,10,4,41,48,2098
73012,73012,853A16C8E6E154D13F9864F752CCB2E5,13271,11,12,1,41,47,2097
73013,73013,853A16C8E6E154D13F9864F752CCB2E5,11481,12,14,2,41,48,2098
73014,73014,853A16C8E6E154D13F9864F752CCB2E5,13101,16,23,7,40,47,2047
73021,73021,BC6336594A40107DD601192ACE54A069,43041,0,8,8,41,46,2096
73022,73022,BC6336594A40107DD601192ACE54A069,10151,10,18,8,34,47,1747
73023,73023,BC6336594A40107DD601192ACE54A069,42633,19,23,4,42,46,2146
73027,73027,2BC714C204CBBFEE616B46CC493E087B,12641,2,5,3,10,43,543
73028,73028,2BC714C204CBBFEE616B46CC493E087B,12921,8,10,2,9,41,491
73029,73029,2BC714C204CBBFEE616B46CC493E087B,12641,12,13,1,10,43,543
73030,73030,2BC714C204CBBFEE616B46CC493E087B,12921,15,16,1,9,41,491
73031,73031,2BC714C204CBBFEE616B46CC493E087B,12641,20,23,3,10,43,543
73045,73045,39A12A7E8C423731CE90191A15A5C3F4,43021,0,5,5,16,43,843
73046,73046,39A12A7E8C423731CE90191A15A5C3F4,12921,5,11,6,9,41,491
73047,73047,39A12A7E8C423731CE90191A15A5C3F4,43021,13,14,1,16,43,843
73048,73048,39A12A7E8C423731CE90191A15A5C3F4,12921,14,19,5,9,41,491
73049,73049,746607B162E7EB25AA57FCC2A7B9163E,11861,0,8,8,32,47,1647
73050,73050,746607B162E7EB25AA57FCC2A7B9163E,11201,8,18,10,35,49,1799
73051,73051,746607B162E7EB25AA57FCC2A7B9163E,11861,19,23,4,32,47,1647
73052,73052,BEDA3F53DF178AFD4DE2A3B4D3458FDF,42271,0,7,7,40,47,2047
73053,73053,BEDA3F53DF178AFD4DE2A3B4D3458FDF,12514,8,10,2,38,47,1947
73054,73054,BEDA3F53DF178AFD4DE2A3B4D3458FDF,43481,10,12,2,39,48,1998
73055,73055,BEDA3F53DF178AFD4DE2A3B4D3458FDF,42271,19,20,1,40,47,2047
73056,73056,BEDA3F53DF178AFD4DE2A3B4D3458FDF,43481,21,23,2,39,48,1998
73057,73057,9582B0C41CE65E76B09E8491AC26676B,11875,0,5,5,30,46,1546
73058,73058,9582B0C41CE65E76B09E8491AC26676B,12311,8,10,2,30,44,1544
73059,73059,9582B0C41CE65E76B09E8491AC26676B,12661,10,11,1,32,45,1645
73060,73060,9582B0C41CE65E76B09E8491AC26676B,12311,17,18,1,30,44,1544
73061,73061,9582B0C41CE65E76B09E8491AC26676B,11875,20,23,3,30,46,1546
73062,73062,0A1386913DE713CBA72662A5149627A3,13711,0,9,9,38,46,1946
73063,73063,0A1386913DE713CBA72662A5149627A3,11941,10,11,1,37,46,1896
73064,73064,0A1386913DE713CBA72662A5149627A3,13711,11,14,3,38,46,1946
73065,73065,0A1386913DE713CBA72662A5149627A3,11941,16,17,1,37,46,1896
73066,73066,0A1386913DE713CBA72662A5149627A3,13711,21,23,2,38,46,1946
73070,73070,0FF23BFDB55A76F1FEA2FEA8A42CA80D,11061,0,1,1,29,48,1498
73071,73071,0FF23BFDB55A76F1FEA2FEA8A42CA80D,11381,2,4,2,30,47,1547
73072,73072,0FF23BFDB55A76F1FEA2FEA8A42CA80D,11061,4,10,6,29,48,1498
73073,73073,0FF23BFDB55A76F1FEA2FEA8A42CA80D,11381,11,12,1,30,47,1547
73074,73074,0FF23BFDB55A76F1FEA2FEA8A42CA80D,11061,14,17,3,29,48,1498
73075,73075,0FF23BFDB55A76F1FEA2FEA8A42CA80D,11381,20,22,2,30,47,1547
73080,73080,00ED2280FB2BEC22D8FB36F8A7AFB1A5,42791,0,7,7,35,45,1795
73081,73081,00ED2280FB2BEC22D8FB36F8A7AFB1A5,10271,9,13,4,37,46,1896
73082,73082,00ED2280FB2BEC22D8FB36F8A7AFB1A5,13121,14,16,2,38,46,1946
73083,73083,00ED2280FB2BEC22D8FB36F8A7AFB1A5,10271,17,18,1,37,46,1896
73084,73084,00ED2280FB2BEC22D8FB36F8A7AFB1A5,42151,21,23,2,35,45,1795
73085,73085,7B7EC78C492826B1A2F98257774A5C01,11061,1,10,9,29,48,1498
73086,73086,7B7EC78C492826B1A2F98257774A5C01,40171,12,14,2,38,48,1948
73087,73087,7B7EC78C492826B1A2F98257774A5C01,43971,18,20,2,30,48,1548
73088,73088,7B7EC78C492826B1A2F98257774A5C01,11061,20,21,1,29,48,1498
73089,73089,E43A1713BA9589398F5DEA7CD1BD08F1,13791,0,7,7,42,47,2147
73090,73090,E43A1713BA9589398F5DEA7CD1BD08F1,12971,16,21,5,32,48,1648
73091,73091,E43A1713BA9589398F5DEA7CD1BD08F1,10221,21,23,2,34,49,1749
73095,73095,E22A4CD2C9DFED011AA9FE184FF0E695,42401,0,14,14,36,47,1847
73096,73096,E22A4CD2C9DFED011AA9FE184FF0E695,10381,16,17,1,31,49,1599
73097,73097,E22A4CD2C9DFED011AA9FE184FF0E695,42401,18,23,5,36,47,1847
73098,73098,F9B50F8C0BC548F341BD45D3142A9731,10431,1,2,1,33,49,1699
73099,73099,F9B50F8C0BC548F341BD45D3142A9731,11531,3,17,14,34,49,1749
73100,73100,F9B50F8C0BC548F341BD45D3142A9731,42691,19,20,1,24,48,1248
73101,73101,F9B50F8C0BC548F341BD45D3142A9731,10721,21,23,2,31,48,1598
73108,73108,04EACEB9BF4D26D938B9521BAE262803,42801,0,8,8,40,49,2049
73109,73109,04EACEB9BF4D26D938B9521BAE262803,10221,8,10,2,34,49,1749
73110,73110,04EACEB9BF4D26D938B9521BAE262803,11271,14,20,6,37,48,1898
73111,73111,04EACEB9BF4D26D938B9521BAE262803,10221,20,22,2,34,49,1749
73118,73118,ABA306CA497592C3E24A3217BA4072DF,43041,4,5,1,41,46,2096
73119,73119,ABA306CA497592C3E24A3217BA4072DF,42221,8,10,2,38,48,1948
73120,73120,ABA306CA497592C3E24A3217BA4072DF,12514,14,16,2,38,47,1947
73121,73121,ABA306CA497592C3E24A3217BA4072DF,43041,20,23,3,41,46,2096
73128,73128,CC06B39421E630BF724D00DE65DABB6E,43751,0,7,7,19,48,998
73129,73129,CC06B39421E630BF724D00DE65DABB6E,12581,7,8,1,24,48,1248
73130,73130,CC06B39421E630BF724D00DE65DABB6E,43751,11,13,2,19,48,998
73131,73131,CC06B39421E630BF724D00DE65DABB6E,12581,15,17,2,24,48,1248
73132,73132,CC06B39421E630BF724D00DE65DABB6E,43751,22,23,1,19,48,998
73133,73133,1C27B3723865DD51848A2743C866805D,43051,0,5,5,46,45,2345
73134,73134,1C27B3723865DD51848A2743C866805D,13341,5,6,1,44,45,2245
73135,73135,1C27B3723865DD51848A2743C866805D,12561,8,10,2,45,43,2293
73136,73136,1C27B3723865DD51848A2743C866805D,43051,12,13,1,46,45,2345
73137,73137,1C27B3723865DD51848A2743C866805D,13341,13,16,3,44,45,2245
73138,73138,1C27B3723865DD51848A2743C866805D,43011,16,18,2,40,42,2042
73139,73139,1C27B3723865DD51848A2743C866805D,43051,21,23,2,46,45,2345
73155,73155,D7B4DEFCB86C55D027A1210EEC02063B,11231,0,2,2,37,49,1899
73156,73156,D7B4DEFCB86C55D027A1210EEC02063B,11201,2,8,6,35,49,1799
73157,73157,D7B4DEFCB86C55D027A1210EEC02063B,43311,17,19,2,31,48,1598
73158,73158,D7B4DEFCB86C55D027A1210EEC02063B,11231,19,23,4,37,49,1899
73159,73159,558A6887C0D5899B43E75BBD844A7C64,42461,0,5,5,45,47,2297
73160,73160,558A6887C0D5899B43E75BBD844A7C64,42321,7,9,2,43,47,2197
73161,73161,558A6887C0D5899B43E75BBD844A7C64,42201,13,14,1,43,46,2196
73162,73162,558A6887C0D5899B43E75BBD844A7C64,42461,19,21,2,45,47,2297
73163,73163,558A6887C0D5899B43E75BBD844A7C64,42321,22,23,1,43,47,2197
73167,73167,B24DFEF6BEA91CB0AE942579D8124FCB,10971,0,7,7,35,47,1797
73168,73168,B24DFEF6BEA91CB0AE942579D8124FCB,13711,8,10,2,38,46,1946
73169,73169,B24DFEF6BEA91CB0AE942579D8124FCB,10971,12,14,2,35,47,1797
73170,73170,B24DFEF6BEA91CB0AE942579D8124FCB,43731,15,16,1,34,47,1747
73171,73171,B24DFEF6BEA91CB0AE942579D8124FCB,42231,18,19,1,37,46,1896
73172,73172,11D0C3BFA1EEA48E71CAB72BD84A5D2F,13671,1,5,4,27,43,1393
73173,73173,11D0C3BFA1EEA48E71CAB72BD84A5D2F,10634,5,6,1,27,45,1395
73174,73174,11D0C3BFA1EEA48E71CAB72BD84A5D2F,10351,7,9,2,28,45,1445
73175,73175,11D0C3BFA1EEA48E71CAB72BD84A5D2F,10634,11,12,1,27,45,1395
73176,73176,11D0C3BFA1EEA48E71CAB72BD84A5D2F,10711,15,16,1,29,46,1496
73177,73177,11D0C3BFA1EEA48E71CAB72BD84A5D2F,10634,18,23,5,27,45,1395
73178,73178,D8B46FFCD15B641FB93B8219A29A7205,40673,1,8,7,36,48,1848
73179,73179,D8B46FFCD15B641FB93B8219A29A7205,10111,12,14,2,37,47,1897
73180,73180,D8B46FFCD15B641FB93B8219A29A7205,11751,17,18,1,35,48,1798
73181,73181,D8B46FFCD15B641FB93B8219A29A7205,10251,19,20,1,35,47,1797
73182,73182,D8B46FFCD15B641FB93B8219A29A7205,10111,20,23,3,37,47,1897
73186,73186,E962C3D0A8FC163364DD770DFBF0ADE9,12121,0,7,7,29,47,1497
73187,73187,E962C3D0A8FC163364DD770DFBF0ADE9,13651,7,8,1,30,47,1547
73188,73188,E962C3D0A8FC163364DD770DFBF0ADE9,11541,9,11,2,35,49,1799
73189,73189,E962C3D0A8FC163364DD770DFBF0ADE9,13651,12,20,8,30,47,1547
73193,73193,0E4B3B25FE0CAB1DCA768980553C13E7,42791,0,8,8,35,45,1795
73194,73194,0E4B3B25FE0CAB1DCA768980553C13E7,12661,12,21,9,32,45,1645
73195,73195,0E4B3B25FE0CAB1DCA768980553C13E7,10331,22,23,1,39,46,1996
73196,73196,1FEEB6DC56325E0480EF03F55B7C83AB,11261,0,1,1,36,46,1846
73197,73197,1FEEB6DC56325E0480EF03F55B7C83AB,13911,3,4,1,39,46,1996
73198,73198,1FEEB6DC56325E0480EF03F55B7C83AB,11261,9,14,5,36,46,1846
73199,73199,1FEEB6DC56325E0480EF03F55B7C83AB,10381,15,23,8,31,49,1599
73200,73200,BF5EFB3BDBF5437ACD467C87E9038A8B,43021,1,6,5,16,43,843
73201,73201,BF5EFB3BDBF5437ACD467C87E9038A8B,12921,10,11,1,9,41,491
73202,73202,BF5EFB3BDBF5437ACD467C87E9038A8B,43021,11,16,5,16,43,843
73203,73203,BF5EFB3BDBF5437ACD467C87E9038A8B,12921,17,18,1,9,41,491
73204,73204,BF5EFB3BDBF5437ACD467C87E9038A8B,43021,19,21,2,16,43,843
73205,73205,86663282C13F9BF91EBAA9A2AA818B18,16281,4,12,8,11,4,554
73206,73206,86663282C13F9BF91EBAA9A2AA818B18,15051,13,14,1,19,4,954
73207,73207,86663282C13F9BF91EBAA9A2AA818B18,16281,18,22,4,11,4,554
73208,73208,830067E97972F27E1AE4923131398E88,13651,0,4,4,30,47,1547
73209,73209,830067E97972F27E1AE4923131398E88,42491,4,6,2,32,46,1646
73210,73210,830067E97972F27E1AE4923131398E88,13651,6,8,2,30,47,1547
73211,73211,830067E97972F27E1AE4923131398E88,42523,9,12,3,31,47,1597
73212,73212,830067E97972F27E1AE4923131398E88,42491,14,18,4,32,46,1646
73213,73213,830067E97972F27E1AE4923131398E88,42523,18,23,5,31,47,1597
73214,73214,80A511C96F8F2F2D6C8AF8B25137C329,19244,2,17,15,1,43,93
73215,73215,80A511C96F8F2F2D6C8AF8B25137C329,19114,18,20,2,7,43,393
73216,73216,80A511C96F8F2F2D6C8AF8B25137C329,19901,20,22,2,7,44,394
73217,73217,BC5F5A048F874E8EDED6AF765E340D8C,11914,5,10,5,37,48,1898
73218,73218,BC5F5A048F874E8EDED6AF765E340D8C,42581,10,12,2,38,48,1948
73219,73219,BC5F5A048F874E8EDED6AF765E340D8C,11914,16,17,1,37,48,1898
73220,73220,BC5F5A048F874E8EDED6AF765E340D8C,42581,17,19,2,38,48,1948
73221,73221,BC5F5A048F874E8EDED6AF765E340D8C,11914,19,21,2,37,48,1898
73228,73228,1C0548F40841AD0870DAD8EC7BECCBC6,13314,0,13,13,31,39,1589
73229,73229,1C0548F40841AD0870DAD8EC7BECCBC6,12521,14,16,2,35,41,1791
73230,73230,1C0548F40841AD0870DAD8EC7BECCBC6,13314,20,23,3,31,39,1589
73234,73234,B93C16A242FE2C6BDA83A87AD4FAA434,10501,1,2,1,22,46,1146
73235,73235,B93C16A242FE2C6BDA83A87AD4FAA434,12601,2,8,6,25,47,1297
73236,73236,B93C16A242FE2C6BDA83A87AD4FAA434,10501,10,13,3,22,46,1146
73237,73237,B93C16A242FE2C6BDA83A87AD4FAA434,12601,14,17,3,25,47,1297
73238,73238,B93C16A242FE2C6BDA83A87AD4FAA434,10501,19,22,3,22,46,1146
73239,73239,E648A6F090A3BE85617E0ED54A73B4F0,12601,0,2,2,25,47,1297
73240,73240,E648A6F090A3BE85617E0ED54A73B4F0,12671,3,4,1,21,43,1093
73241,73241,E648A6F090A3BE85617E0ED54A73B4F0,13091,4,7,3,20,42,1042
73242,73242,E648A6F090A3BE85617E0ED54A73B4F0,12601,8,14,6,25,47,1297
73243,73243,E648A6F090A3BE85617E0ED54A73B4F0,12671,14,16,2,21,43,1093
73244,73244,E648A6F090A3BE85617E0ED54A73B4F0,12601,17,20,3,25,47,1297
73245,73245,E648A6F090A3BE85617E0ED54A73B4F0,12671,22,23,1,21,43,1093
73246,73246,4B127C7EA26458E507C53C5C29F3B661,10281,0,8,8,33,48,1698
73247,73247,4B127C7EA26458E507C53C5C29F3B661,11901,11,14,3,42,49,2149
73248,73248,4B127C7EA26458E507C53C5C29F3B661,10281,18,22,4,33,48,1698
73249,73249,3C07D1557002BF4F1AA6A6D7A8949EF2,42523,0,5,5,31,47,1597
73250,73250,3C07D1557002BF4F1AA6A6D7A8949EF2,12601,8,15,7,25,47,1297
73251,73251,3C07D1557002BF4F1AA6A6D7A8949EF2,42523,19,20,1,31,47,1597
73252,73252,3C07D1557002BF4F1AA6A6D7A8949EF2,43761,22,23,1,32,47,1647
73257,73257,25C74A8653DF312E561F8D84D2F56CE0,43061,0,11,11,43,46,2196
73258,73258,25C74A8653DF312E561F8D84D2F56CE0,40951,12,14,2,36,49,1849
73259,73259,25C74A8653DF312E561F8D84D2F56CE0,10841,17,23,6,37,47,1897
73260,73260,6B8EFEBEF5489C021016731A730F97CB,42371,0,6,6,34,46,1746
73261,73261,6B8EFEBEF5489C021016731A730F97CB,42511,11,14,3,37,47,1897
73262,73262,6B8EFEBEF5489C021016731A730F97CB,10271,15,17,2,37,46,1896
73263,73263,6B8EFEBEF5489C021016731A730F97CB,13121,17,18,1,38,46,1946
73264,73264,6B8EFEBEF5489C021016731A730F97CB,42151,20,21,1,35,45,1795
73265,73265,6B8EFEBEF5489C021016731A730F97CB,42371,22,23,1,34,46,1746
73269,73269,0F155161AC9A08ADA75BAA1BD7450976,43751,0,11,11,19,48,998
73270,73270,0F155161AC9A08ADA75BAA1BD7450976,42081,16,17,1,24,49,1249
73271,73271,0F155161AC9A08ADA75BAA1BD7450976,43751,20,23,3,19,48,998
73272,73272,2F66AC01887397A198C9CCA6611EA97B,12521,0,6,6,35,41,1791
73273,73273,2F66AC01887397A198C9CCA6611EA97B,13314,7,9,2,31,39,1589
73274,73274,2F66AC01887397A198C9CCA6611EA97B,12521,9,13,4,35,41,1791
73275,73275,2F66AC01887397A198C9CCA6611EA97B,13314,13,17,4,31,39,1589
73276,73276,2F66AC01887397A198C9CCA6611EA97B,12521,20,23,3,35,41,1791
73277,73277,08D9507E48A1AB894A32B8477F6EE759,40833,0,4,4,41,47,2097
73278,73278,08D9507E48A1AB894A32B8477F6EE759,10301,9,12,3,31,45,1595
73279,73279,08D9507E48A1AB894A32B8477F6EE759,10634,14,20,6,27,45,1395
73280,73280,08D9507E48A1AB894A32B8477F6EE759,12311,21,22,1,30,44,1544
73281,73281,A534FD7E51A551BE3196665029DD0400,19931,0,5,5,7,43,393
73282,73282,A534FD7E51A551BE3196665029DD0400,19031,8,17,9,1,42,92
73283,73283,A534FD7E51A551BE3196665029DD0400,12641,19,21,2,10,43,543
73284,73284,C91EDEC4832C8610497ADAA0406605AA,12031,0,6,6,33,48,1698
73285,73285,C91EDEC4832C8610497ADAA0406605AA,43731,9,10,1,34,47,1747
73286,73286,C91EDEC4832C8610497ADAA0406605AA,42941,12,14,2,37,47,1897
73287,73287,C91EDEC4832C8610497ADAA0406605AA,12031,19,23,4,33,48,1698
73291,73291,CC6A63734928B4CD8F414AAB01241B9F,10611,1,7,6,32,48,1648
73292,73292,CC6A63734928B4CD8F414AAB01241B9F,10721,7,8,1,31,48,1598
73293,73293,CC6A63734928B4CD8F414AAB01241B9F,12971,11,14,3,32,48,1648
73294,73294,CC6A63734928B4CD8F414AAB01241B9F,10221,14,17,3,34,49,1749
73295,73295,CC6A63734928B4CD8F414AAB01241B9F,42961,18,19,1,35,49,1799
73296,73296,CC6A63734928B4CD8F414AAB01241B9F,10611,20,23,3,32,48,1648
73297,73297,05C3A7EB5EF4E026B421540B8AC90475,42371,10,11,1,34,46,1746
73298,73298,05C3A7EB5EF4E026B421540B8AC90475,42151,14,16,2,35,45,1795
73299,73299,05C3A7EB5EF4E026B421540B8AC90475,12491,19,23,4,36,43,1843
73300,73300,0AC9ACC82EDADEC2B3583D25F9FB3BD5,19441,2,7,5,8,46,446
73301,73301,0AC9ACC82EDADEC2B3583D25F9FB3BD5,42041,8,16,8,10,47,547
73302,73302,0AC9ACC82EDADEC2B3583D25F9FB3BD5,11631,21,23,2,12,49,649
73303,73303,0623B3A7AE42C407C6CAD689F1EDE452,13094,0,6,6,21,42,1092
73304,73304,0623B3A7AE42C407C6CAD689F1EDE452,12921,9,10,1,9,41,491
73305,73305,0623B3A7AE42C407C6CAD689F1EDE452,43021,11,13,2,16,43,843
73306,73306,0623B3A7AE42C407C6CAD689F1EDE452,43641,16,18,2,16,38,838
73310,73310,649CA0B4C9C73F10630BCAC6C100E533,11381,0,6,6,30,47,1547
73311,73311,649CA0B4C9C73F10630BCAC6C100E533,42151,11,12,1,35,45,1795
73312,73312,649CA0B4C9C73F10630BCAC6C100E533,42531,15,18,3,31,45,1595
73313,73313,649CA0B4C9C73F10630BCAC6C100E533,42151,21,23,2,35,45,1795
73314,73314,76DA946F4DC1318DD46A32E1D303D6B7,12521,0,6,6,35,41,1791
73315,73315,76DA946F4DC1318DD46A32E1D303D6B7,13314,8,9,1,31,39,1589
73316,73316,76DA946F4DC1318DD46A32E1D303D6B7,12521,12,22,10,35,41,1791
73317,73317,0BF9081B921E7C1EC68F2248D31F0D32,16281,0,17,17,11,4,554
73318,73318,0BF9081B921E7C1EC68F2248D31F0D32,15143,18,19,1,18,7,907
73319,73319,0BF9081B921E7C1EC68F2248D31F0D32,16281,20,21,1,11,4,554
73320,73320,6268A79D87E3CFA4E65FA8A748F9969C,13271,0,7,7,41,47,2097
73321,73321,6268A79D87E3CFA4E65FA8A748F9969C,12381,10,16,6,32,48,1648
73322,73322,6268A79D87E3CFA4E65FA8A748F9969C,13271,18,19,1,41,47,2097
73323,73323,E886E5251030835554FC7C0727BBE348,43081,1,2,1,27,28,1378
73324,73324,E886E5251030835554FC7C0727BBE348,43121,6,9,3,25,27,1277
73325,73325,E886E5251030835554FC7C0727BBE348,12871,14,23,9,22,33,1133
73326,73326,68D66AC2F31097852E1113FCAC38B096,12311,0,5,5,30,44,1544
73327,73327,68D66AC2F31097852E1113FCAC38B096,42531,8,11,3,31,45,1595
73328,73328,68D66AC2F31097852E1113FCAC38B096,12311,13,16,3,30,44,1544
73329,73329,68D66AC2F31097852E1113FCAC38B096,42531,17,18,1,31,45,1595
73330,73330,68D66AC2F31097852E1113FCAC38B096,12311,18,22,4,30,44,1544
73331,73331,0DD51EE42A065AE9C7264B2B66A89D4A,19021,1,3,2,10,45,545
73332,73332,0DD51EE42A065AE9C7264B2B66A89D4A,12921,3,12,9,9,41,491
73333,73333,0DD51EE42A065AE9C7264B2B66A89D4A,19021,12,14,2,10,45,545
73334,73334,0DD51EE42A065AE9C7264B2B66A89D4A,12921,14,16,2,9,41,491
73335,73335,0DD51EE42A065AE9C7264B2B66A89D4A,19021,19,21,2,10,45,545
73336,73336,D9B08428B230A26F9D8108567961B570,13671,0,11,11,27,43,1393
73337,73337,D9B08428B230A26F9D8108567961B570,11281,14,16,2,27,40,1390
73338,73338,D9B08428B230A26F9D8108567961B570,12511,20,21,1,39,47,1997
73339,73339,8440D146B403BF29D12325D063ED4DAB,11481,0,9,9,41,48,2098
73340,73340,8440D146B403BF29D12325D063ED4DAB,10401,11,12,1,33,49,1699
73341,73341,8440D146B403BF29D12325D063ED4DAB,11481,12,23,11,41,48,2098
73342,73342,180CFA670233CC55937ED4D2C76E2806,11875,1,2,1,30,46,1546
73343,73343,180CFA670233CC55937ED4D2C76E2806,10634,2,4,2,27,45,1395
73344,73344,180CFA670233CC55937ED4D2C76E2806,11875,4,5,1,30,46,1546
73345,73345,180CFA670233CC55937ED4D2C76E2806,13671,8,16,8,27,43,1393
73346,73346,180CFA670233CC55937ED4D2C76E2806,10634,20,22,2,27,45,1395
73350,73350,8D86E284D185DE22084CD86C6BFE1A08,11875,0,6,6,30,46,1546
73351,73351,8D86E284D185DE22084CD86C6BFE1A08,12311,6,10,4,30,44,1544
73352,73352,8D86E284D185DE22084CD86C6BFE1A08,11871,11,13,2,29,46,1496
73353,73353,8D86E284D185DE22084CD86C6BFE1A08,12311,13,18,5,30,44,1544
73354,73354,8D86E284D185DE22084CD86C6BFE1A08,11875,21,23,2,30,46,1546
73355,73355,083E6F45CD758E55D59CE683A8831561,42381,0,6,6,39,41,1991
73356,73356,083E6F45CD758E55D59CE683A8831561,13071,6,10,4,41,41,2091
73357,73357,083E6F45CD758E55D59CE683A8831561,42381,11,13,2,39,41,1991
73358,73358,083E6F45CD758E55D59CE683A8831561,43011,20,21,1,40,42,2042
73359,73359,083E6F45CD758E55D59CE683A8831561,42381,22,23,1,39,41,1991
73360,73360,01308B72F71E3AACC045F922DA6CAE4D,43761,0,5,5,32,47,1647
73361,73361,01308B72F71E3AACC045F922DA6CAE4D,42491,8,9,1,32,46,1646
73362,73362,01308B72F71E3AACC045F922DA6CAE4D,43761,12,13,1,32,47,1647
73363,73363,01308B72F71E3AACC045F922DA6CAE4D,10341,15,16,1,31,47,1597
73364,73364,01308B72F71E3AACC045F922DA6CAE4D,43761,17,21,4,32,47,1647
73395,73395,35DAC6756C7F4B57C2B1C6F65896CD31,10351,0,1,1,28,45,1445
73396,73396,35DAC6756C7F4B57C2B1C6F65896CD31,12601,1,3,2,25,47,1297
73397,73397,35DAC6756C7F4B57C2B1C6F65896CD31,10634,7,10,3,27,45,1395
73398,73398,35DAC6756C7F4B57C2B1C6F65896CD31,12601,15,16,1,25,47,1297
73399,73399,35DAC6756C7F4B57C2B1C6F65896CD31,10351,18,19,1,28,45,1445
73400,73400,35DAC6756C7F4B57C2B1C6F65896CD31,12601,20,23,3,25,47,1297
73407,73407,403E4ED8501B3F3BFADB94D815ACA889,42401,0,7,7,36,47,1847
73408,73408,403E4ED8501B3F3BFADB94D815ACA889,11875,8,16,8,30,46,1546
73409,73409,403E4ED8501B3F3BFADB94D815ACA889,11871,17,18,1,29,46,1496
73410,73410,9ECA5557B94DDF8D494B58216329A377,42864,1,5,4,38,44,1944
73411,73411,9ECA5557B94DDF8D494B58216329A377,42861,9,10,1,37,44,1894
73412,73412,9ECA5557B94DDF8D494B58216329A377,11261,11,13,2,36,46,1846
73413,73413,9ECA5557B94DDF8D494B58216329A377,42861,14,18,4,37,44,1894
73414,73414,9ECA5557B94DDF8D494B58216329A377,11261,18,23,5,36,46,1846
73415,73415,C4AB9C8C7DB6B9AEDF6D35145F69C470,42521,0,6,6,31,47,1597
73416,73416,C4AB9C8C7DB6B9AEDF6D35145F69C470,42071,7,8,1,31,49,1599
73417,73417,C4AB9C8C7DB6B9AEDF6D35145F69C470,10451,10,15,5,25,48,1298
73418,73418,C4AB9C8C7DB6B9AEDF6D35145F69C470,42521,19,23,4,31,47,1597
73419,73419,3B37D2D3DC1F0A4843C3090AED9F2189,13141,2,3,1,23,30,1180
73420,73420,3B37D2D3DC1F0A4843C3090AED9F2189,19531,5,18,13,17,30,880
73421,73421,3B37D2D3DC1F0A4843C3090AED9F2189,13141,20,21,1,23,30,1180
73422,73422,3B37D2D3DC1F0A4843C3090AED9F2189,19531,21,23,2,17,30,880
73423,73423,F2E0A788EC41736380A7AB3495E7AB34,10411,2,6,4,36,48,1848
73424,73424,F2E0A788EC41736380A7AB3495E7AB34,10451,11,18,7,25,48,1298
73425,73425,F2E0A788EC41736380A7AB3495E7AB34,10251,19,21,2,35,47,1797
73426,73426,824CB1B1B23572593ECC1D95EF328196,42321,1,7,6,43,47,2197
73427,73427,824CB1B1B23572593ECC1D95EF328196,11074,9,10,1,37,47,1897
73428,73428,824CB1B1B23572593ECC1D95EF328196,13941,14,16,2,41,47,2097
73429,73429,824CB1B1B23572593ECC1D95EF328196,11001,19,21,2,42,47,2147
73430,73430,824CB1B1B23572593ECC1D95EF328196,42321,21,22,1,43,47,2197
73434,73434,BCCF2CDFD6C9D7A77ABBD1757075B8AB,11781,1,6,5,38,49,1949
73435,73435,BCCF2CDFD6C9D7A77ABBD1757075B8AB,11531,9,17,8,34,49,1749
73436,73436,BCCF2CDFD6C9D7A77ABBD1757075B8AB,10381,18,19,1,31,49,1599
73437,73437,BCCF2CDFD6C9D7A77ABBD1757075B8AB,11751,20,21,1,35,48,1798
73441,73441,3A8D54C72D079D286092BA0E91E1F6C4,10931,6,7,1,41,48,2098
73442,73442,3A8D54C72D079D286092BA0E91E1F6C4,13331,10,11,1,38,47,1947
73443,73443,3A8D54C72D079D286092BA0E91E1F6C4,42511,12,13,1,37,47,1897
73444,73444,3A8D54C72D079D286092BA0E91E1F6C4,13331,17,18,1,38,47,1947
73448,73448,88755E17FFF69DE5064C9C86A18E3FD7,10691,0,6,6,33,48,1698
73449,73449,88755E17FFF69DE5064C9C86A18E3FD7,42941,9,20,11,37,47,1897
73450,73450,88755E17FFF69DE5064C9C86A18E3FD7,10691,21,23,2,33,48,1698
73451,73451,1D51AC4BBFB933A632C5A69F521FA887,11861,0,9,9,32,47,1647
73452,73452,1D51AC4BBFB933A632C5A69F521FA887,11271,11,14,3,37,48,1898
73453,73453,1D51AC4BBFB933A632C5A69F521FA887,11861,16,23,7,32,47,1647
73457,73457,E3B088F7DEFCCE4BD4EB6ADB8F0E5950,12514,0,8,8,38,47,1947
73458,73458,E3B088F7DEFCCE4BD4EB6ADB8F0E5950,13651,10,11,1,30,47,1547
73459,73459,E3B088F7DEFCCE4BD4EB6ADB8F0E5950,11731,12,13,1,36,48,1848
73460,73460,E3B088F7DEFCCE4BD4EB6ADB8F0E5950,10731,18,21,3,33,47,1697
73461,73461,E3B088F7DEFCCE4BD4EB6ADB8F0E5950,41061,22,23,1,34,49,1749
73462,73462,656752102BA99654C7060CE5B2133D72,49201,0,2,2,7,41,391
73463,73463,656752102BA99654C7060CE5B2133D72,19114,3,5,2,7,43,393
73464,73464,656752102BA99654C7060CE5B2133D72,12921,6,11,5,9,41,491
73465,73465,656752102BA99654C7060CE5B2133D72,49201,11,13,2,7,41,391
73466,73466,656752102BA99654C7060CE5B2133D72,12921,13,20,7,9,41,491
73476,73476,D44EDEFE20C6E53FAD2290D9CECCD593,42041,0,2,2,10,47,547
73477,73477,D44EDEFE20C6E53FAD2290D9CECCD593,19441,4,5,1,8,46,446
73478,73478,D44EDEFE20C6E53FAD2290D9CECCD593,42041,6,8,2,10,47,547
73479,73479,D44EDEFE20C6E53FAD2290D9CECCD593,19441,10,12,2,8,46,446
73480,73480,D44EDEFE20C6E53FAD2290D9CECCD593,42041,14,17,3,10,47,547
73481,73481,D44EDEFE20C6E53FAD2290D9CECCD593,19441,21,23,2,8,46,446
73482,73482,FA0B4BCA98C32EBD0D8F13AD33E9CA40,11591,0,1,1,36,49,1849
73483,73483,FA0B4BCA98C32EBD0D8F13AD33E9CA40,12381,3,14,11,32,48,1648
73484,73484,FA0B4BCA98C32EBD0D8F13AD33E9CA40,42621,18,19,1,24,49,1249
73485,73485,FA0B4BCA98C32EBD0D8F13AD33E9CA40,10721,21,22,1,31,48,1598
73486,73486,499426AABDFB3A48AD7C69EA8E2B51C2,19621,0,11,11,5,46,296
73487,73487,499426AABDFB3A48AD7C69EA8E2B51C2,41591,13,15,2,34,49,1749
73488,73488,499426AABDFB3A48AD7C69EA8E2B51C2,10721,19,21,2,31,48,1598
73489,73489,499426AABDFB3A48AD7C69EA8E2B51C2,19621,22,23,1,5,46,296
73496,73496,5C43416A739D6997A74BBA50F19E82A3,42541,0,2,2,25,47,1297
73497,73497,5C43416A739D6997A74BBA50F19E82A3,10171,4,7,3,26,47,1347
73498,73498,5C43416A739D6997A74BBA50F19E82A3,12311,7,8,1,30,44,1544
73499,73499,5C43416A739D6997A74BBA50F19E82A3,11861,9,18,9,32,47,1647
73500,73500,89E5A7FBADD8F5F593AB966798D6300A,13121,0,14,14,38,46,1946
73501,73501,89E5A7FBADD8F5F593AB966798D6300A,10351,16,17,1,28,45,1445
73502,73502,89E5A7FBADD8F5F593AB966798D6300A,13121,22,23,1,38,46,1946
73506,73506,83953915152640EF3FD3F006516EAC9F,12641,0,4,4,10,43,543
73507,73507,83953915152640EF3FD3F006516EAC9F,19114,5,7,2,7,43,393
73508,73508,83953915152640EF3FD3F006516EAC9F,19901,10,11,1,7,44,394
73509,73509,83953915152640EF3FD3F006516EAC9F,12641,12,18,6,10,43,543
73510,73510,83953915152640EF3FD3F006516EAC9F,19021,18,19,1,10,45,545
73511,73511,83953915152640EF3FD3F006516EAC9F,12641,20,23,3,10,43,543
73518,73518,3A0C530634A1917DABE6F9CF2AE2EA77,43051,0,5,5,46,45,2345
73519,73519,3A0C530634A1917DABE6F9CF2AE2EA77,12211,8,10,2,41,44,2094
73520,73520,3A0C530634A1917DABE6F9CF2AE2EA77,43951,13,16,3,49,41,2491
73521,73521,3A0C530634A1917DABE6F9CF2AE2EA77,42491,20,21,1,32,46,1646
73522,73522,091DCC0237DDF0F056E1A7BFB1F57890,12641,0,2,2,10,43,543
73523,73523,091DCC0237DDF0F056E1A7BFB1F57890,43021,2,5,3,16,43,843
73524,73524,091DCC0237DDF0F056E1A7BFB1F57890,19021,9,21,12,10,45,545
73528,73528,0D9D2796ADDC0A82736E2A5CF0B90410,10107,0,7,7,38,49,1949
73529,73529,0D9D2796ADDC0A82736E2A5CF0B90410,11271,8,10,2,37,48,1898
73530,73530,0D9D2796ADDC0A82736E2A5CF0B90410,42121,10,12,2,26,49,1349
73531,73531,0D9D2796ADDC0A82736E2A5CF0B90410,11331,13,14,1,37,48,1898
73532,73532,0D9D2796ADDC0A82736E2A5CF0B90410,12521,16,18,2,35,41,1791
73533,73533,62FCB15297A7724012720DDE29CC0405,13111,0,8,8,42,46,2146
73534,73534,62FCB15297A7724012720DDE29CC0405,42541,12,18,6,25,47,1297
73535,73535,62FCB15297A7724012720DDE29CC0405,11201,19,21,2,35,49,1799
73536,73536,62FCB15297A7724012720DDE29CC0405,13111,22,23,1,42,46,2146
73537,73537,F7A05B3FECD253C9C578617425D22E9D,13351,0,6,6,48,48,2448
73538,73538,F7A05B3FECD253C9C578617425D22E9D,40302,8,9,1,40,49,2049
73539,73539,F7A05B3FECD253C9C578617425D22E9D,19114,10,14,4,7,43,393
73540,73540,F7A05B3FECD253C9C578617425D22E9D,19021,16,18,2,10,45,545
73541,73541,F7A05B3FECD253C9C578617425D22E9D,10901,21,23,2,35,48,1798
73542,73542,9C7035BFAAD4C6F5D72BF43A1A04FC14,42401,0,7,7,36,47,1847
73543,73543,9C7035BFAAD4C6F5D72BF43A1A04FC14,11061,8,9,1,29,48,1498
73544,73544,9C7035BFAAD4C6F5D72BF43A1A04FC14,10111,10,11,1,37,47,1897
73545,73545,9C7035BFAAD4C6F5D72BF43A1A04FC14,42301,11,14,3,36,47,1847
73546,73546,9C7035BFAAD4C6F5D72BF43A1A04FC14,10111,17,23,6,37,47,1897
73547,73547,EB8160F7B25CEA2E9880815B3ABC3689,11481,3,13,10,41,48,2098
73548,73548,EB8160F7B25CEA2E9880815B3ABC3689,11351,13,15,2,36,48,1848
73549,73549,EB8160F7B25CEA2E9880815B3ABC3689,11271,16,18,2,37,48,1898
73550,73550,EB8160F7B25CEA2E9880815B3ABC3689,11731,19,23,4,36,48,1848
73551,73551,8A4EE976F1E8BC4CA88390DFA08CB5DF,10621,1,13,12,41,49,2099
73552,73552,8A4EE976F1E8BC4CA88390DFA08CB5DF,11021,14,17,3,36,49,1849
73553,73553,8A4EE976F1E8BC4CA88390DFA08CB5DF,10621,22,23,1,41,49,2099
73562,73562,33984A316287D4F4BD9C4DD953F5F514,19061,0,5,5,3,43,193
73563,73563,33984A316287D4F4BD9C4DD953F5F514,12311,9,11,2,30,44,1544
73564,73564,33984A316287D4F4BD9C4DD953F5F514,19061,13,14,1,3,43,193
73565,73565,33984A316287D4F4BD9C4DD953F5F514,11871,16,18,2,29,46,1496
73566,73566,33984A316287D4F4BD9C4DD953F5F514,19061,22,23,1,3,43,193
73570,73570,CC04DF57CD476D56A9C2711AACC54374,11261,1,7,6,36,46,1846
73571,73571,CC04DF57CD476D56A9C2711AACC54374,42861,9,10,1,37,44,1894
73572,73572,CC04DF57CD476D56A9C2711AACC54374,11261,12,13,1,36,46,1846
73573,73573,CC04DF57CD476D56A9C2711AACC54374,42861,18,20,2,37,44,1894
73574,73574,CC04DF57CD476D56A9C2711AACC54374,11261,20,22,2,36,46,1846
73575,73575,D8FB972AAAC5DB0F06EEBA221E7E96BB,13821,0,7,7,49,45,2495
73576,73576,D8FB972AAAC5DB0F06EEBA221E7E96BB,12971,9,18,9,32,48,1648
73577,73577,D8FB972AAAC5DB0F06EEBA221E7E96BB,13651,18,20,2,30,47,1547
73578,73578,D8FB972AAAC5DB0F06EEBA221E7E96BB,42461,22,23,1,45,47,2297
73579,73579,D256AE34DD31744D7365602849D9C40A,10341,0,7,7,31,47,1597
73580,73580,D256AE34DD31744D7365602849D9C40A,12601,8,16,8,25,47,1297
73581,73581,D256AE34DD31744D7365602849D9C40A,42491,20,23,3,32,46,1646
73582,73582,09757EDFE7795D1E67DCE5C4439A4727,12521,0,16,16,35,41,1791
73583,73583,09757EDFE7795D1E67DCE5C4439A4727,13314,16,17,1,31,39,1589
73584,73584,09757EDFE7795D1E67DCE5C4439A4727,12521,19,23,4,35,41,1791
73585,73585,6AE77A399A63A8DDF88CC6FDD4441AB8,19441,0,5,5,8,46,446
73586,73586,6AE77A399A63A8DDF88CC6FDD4441AB8,42041,8,9,1,10,47,547
73587,73587,6AE77A399A63A8DDF88CC6FDD4441AB8,19441,9,11,2,8,46,446
73588,73588,6AE77A399A63A8DDF88CC6FDD4441AB8,42041,11,12,1,10,47,547
73589,73589,6AE77A399A63A8DDF88CC6FDD4441AB8,19441,15,21,6,8,46,446
73590,73590,22E0CD429C1B1E7AC6170F90C318BE33,19031,0,5,5,1,42,92
73591,73591,22E0CD429C1B1E7AC6170F90C318BE33,12641,7,8,1,10,43,543
73592,73592,22E0CD429C1B1E7AC6170F90C318BE33,19744,9,10,1,6,43,343
73593,73593,22E0CD429C1B1E7AC6170F90C318BE33,12641,16,17,1,10,43,543
73594,73594,22E0CD429C1B1E7AC6170F90C318BE33,40833,21,23,2,41,47,2097
73595,73595,4A7EF801268FA87DD49AA705DCA560E1,12514,0,7,7,38,47,1947
73596,73596,4A7EF801268FA87DD49AA705DCA560E1,42581,8,10,2,38,48,1948
73597,73597,4A7EF801268FA87DD49AA705DCA560E1,11914,11,12,1,37,48,1898
73598,73598,4A7EF801268FA87DD49AA705DCA560E1,42581,14,17,3,38,48,1948
73599,73599,4A7EF801268FA87DD49AA705DCA560E1,11914,17,19,2,37,48,1898
73600,73600,4A7EF801268FA87DD49AA705DCA560E1,42581,20,22,2,38,48,1948
73601,73601,5167DC1F4BFD1A0D0829AB5529153CCE,15361,0,6,6,33,25,1675
73602,73602,5167DC1F4BFD1A0D0829AB5529153CCE,12792,7,8,1,34,30,1730
73603,73603,5167DC1F4BFD1A0D0829AB5529153CCE,15361,11,18,7,33,25,1675
73604,73604,5167DC1F4BFD1A0D0829AB5529153CCE,12792,19,22,3,34,30,1730
73605,73605,58FF60972C1637520443DC5766A2AB67,13411,0,5,5,49,42,2492
73606,73606,58FF60972C1637520443DC5766A2AB67,43951,6,8,2,49,41,2491
73607,73607,58FF60972C1637520443DC5766A2AB67,13411,11,12,1,49,42,2492
73608,73608,58FF60972C1637520443DC5766A2AB67,43951,13,18,5,49,41,2491
73609,73609,58FF60972C1637520443DC5766A2AB67,13411,21,23,2,49,42,2492
73614,73614,AD5871AA9EAD75878C606AE9C3D0E3D8,12561,1,4,3,45,43,2293
73615,73615,AD5871AA9EAD75878C606AE9C3D0E3D8,43951,6,8,2,49,41,2491
73616,73616,AD5871AA9EAD75878C606AE9C3D0E3D8,13411,8,9,1,49,42,2492
73617,73617,AD5871AA9EAD75878C606AE9C3D0E3D8,43951,14,19,5,49,41,2491
73618,73618,AD5871AA9EAD75878C606AE9C3D0E3D8,12561,21,23,2,45,43,2293
73629,73629,85AF3F568DC121A84EF6CC84157293A0,12651,0,8,8,43,47,2197
73630,73630,85AF3F568DC121A84EF6CC84157293A0,19021,9,15,6,10,45,545
73631,73631,85AF3F568DC121A84EF6CC84157293A0,11541,19,20,1,35,49,1799
73632,73632,A0C13743AF441FE8099AA940DA71C612,42581,0,7,7,38,48,1948
73633,73633,A0C13743AF441FE8099AA940DA71C612,12511,9,10,1,39,47,1997
73634,73634,A0C13743AF441FE8099AA940DA71C612,42191,13,14,1,38,49,1949
73635,73635,A0C13743AF441FE8099AA940DA71C612,12511,19,20,1,39,47,1997
73636,73636,A0C13743AF441FE8099AA940DA71C612,42581,21,22,1,38,48,1948
73640,73640,4FA7E2AF35091649A8D61648BF92F5C0,42581,1,7,6,38,48,1948
73641,73641,4FA7E2AF35091649A8D61648BF92F5C0,10471,7,10,3,37,48,1898
73642,73642,4FA7E2AF35091649A8D61648BF92F5C0,42581,12,13,1,38,48,1948
73643,73643,4FA7E2AF35091649A8D61648BF92F5C0,10471,14,17,3,37,48,1898
73644,73644,4FA7E2AF35091649A8D61648BF92F5C0,42523,21,23,2,31,47,1597
73649,73649,802D06E8811CDC65FDAB61E1A1D233B3,12601,2,6,4,25,47,1297
73650,73650,802D06E8811CDC65FDAB61E1A1D233B3,10491,9,18,9,33,48,1698
73651,73651,802D06E8811CDC65FDAB61E1A1D233B3,12601,20,21,1,25,47,1297
73655,73655,110EB8ED5B33FF374638B480C238C00D,10271,0,5,5,37,46,1896
73656,73656,110EB8ED5B33FF374638B480C238C00D,19744,9,17,8,6,43,343
73657,73657,110EB8ED5B33FF374638B480C238C00D,10271,21,22,1,37,46,1896
73667,73667,A4CBFA774BBCB1E081978588796288CA,10681,0,7,7,30,48,1548
73668,73668,A4CBFA774BBCB1E081978588796288CA,11231,9,16,7,37,49,1899
73669,73669,A4CBFA774BBCB1E081978588796288CA,10681,19,23,4,30,48,1548
73670,73670,C274E980163D9B5AB7EB2F3B2E54C4BC,42151,0,10,10,35,45,1795
73671,73671,C274E980163D9B5AB7EB2F3B2E54C4BC,12311,13,16,3,30,44,1544
73672,73672,C274E980163D9B5AB7EB2F3B2E54C4BC,12491,19,20,1,36,43,1843
73673,73673,C274E980163D9B5AB7EB2F3B2E54C4BC,42151,21,22,1,35,45,1795
73674,73674,822752BBEE42503618273E785748F226,12514,7,9,2,38,47,1947
73675,73675,822752BBEE42503618273E785748F226,43471,10,16,6,31,49,1599
73676,73676,822752BBEE42503618273E785748F226,42191,20,21,1,38,49,1949
73677,73677,F584084BD0C4D0FD14EABE044AD44274,41392,0,7,7,43,48,2198
73678,73678,F584084BD0C4D0FD14EABE044AD44274,10292,8,17,9,30,47,1547
73679,73679,F584084BD0C4D0FD14EABE044AD44274,41392,19,23,4,43,48,2198
73680,73680,A02E7FCD783D3B9FF6BA938561F51C11,42161,0,9,9,36,47,1847
73681,73681,A02E7FCD783D3B9FF6BA938561F51C11,40951,12,13,1,36,49,1849
73682,73682,A02E7FCD783D3B9FF6BA938561F51C11,10401,16,19,3,33,49,1699
73683,73683,A02E7FCD783D3B9FF6BA938561F51C11,42161,20,23,3,36,47,1847
73684,73684,C9EB50C9F48491769B9A1D63D7A620E1,16233,0,1,1,5,15,265
73685,73685,C9EB50C9F48491769B9A1D63D7A620E1,16311,1,16,15,2,11,111
73686,73686,C9EB50C9F48491769B9A1D63D7A620E1,16233,16,18,2,5,15,265
73705,73705,10530AA3545BA3AAA2634E512B3F731F,11261,0,4,4,36,46,1846
73706,73706,10530AA3545BA3AAA2634E512B3F731F,42864,7,8,1,38,44,1944
73707,73707,10530AA3545BA3AAA2634E512B3F731F,13461,8,13,5,39,44,1994
73708,73708,10530AA3545BA3AAA2634E512B3F731F,42864,14,17,3,38,44,1944
73709,73709,10530AA3545BA3AAA2634E512B3F731F,11261,19,23,4,36,46,1846
73710,73710,BDE131E3985277A452A63ED13E5958AD,13441,10,12,2,39,39,1989
73711,73711,BDE131E3985277A452A63ED13E5958AD,13071,12,13,1,41,41,2091
73712,73712,BDE131E3985277A452A63ED13E5958AD,13441,14,17,3,39,39,1989
73713,73713,BDE131E3985277A452A63ED13E5958AD,11381,21,23,2,30,47,1547
73717,73717,4B5119258FB3482B746B53277561992F,12051,1,2,1,20,47,1047
73718,73718,4B5119258FB3482B746B53277561992F,12581,3,5,2,24,48,1248
73719,73719,4B5119258FB3482B746B53277561992F,12051,8,23,15,20,47,1047
73720,73720,E191A4A4FB39AEE62DAC5F9CA16A7F16,10721,0,14,14,31,48,1598
73721,73721,E191A4A4FB39AEE62DAC5F9CA16A7F16,10401,14,16,2,33,49,1699
73722,73722,E191A4A4FB39AEE62DAC5F9CA16A7F16,10721,17,19,2,31,48,1598
73723,73723,E191A4A4FB39AEE62DAC5F9CA16A7F16,11921,21,22,1,38,48,1948
73728,73728,2439AC86759645B3C3FF51E9B640AB2E,40611,0,8,8,35,47,1797
73729,73729,2439AC86759645B3C3FF51E9B640AB2E,11081,11,12,1,35,46,1796
73730,73730,2439AC86759645B3C3FF51E9B640AB2E,40341,13,14,1,23,49,1199
73731,73731,2439AC86759645B3C3FF51E9B640AB2E,10841,18,19,1,37,47,1897
73738,73738,753369D691B504B9F7186B2CDF290F06,15391,1,14,13,35,26,1776
73739,73739,753369D691B504B9F7186B2CDF290F06,12792,16,18,2,34,30,1730
73740,73740,753369D691B504B9F7186B2CDF290F06,15391,21,23,2,35,26,1776
73745,73745,4E44BBC9D86CBF4CC3EC68EEA6825DB2,12601,0,15,15,25,47,1297
73746,73746,4E44BBC9D86CBF4CC3EC68EEA6825DB2,12051,16,17,1,20,47,1047
73747,73747,4E44BBC9D86CBF4CC3EC68EEA6825DB2,12601,17,23,6,25,47,1297
73748,73748,5ED8949BAC5CDF05EDA1019FB7CA4B17,42941,0,6,6,37,47,1897
73749,73749,5ED8949BAC5CDF05EDA1019FB7CA4B17,42401,7,9,2,36,47,1847
73750,73750,5ED8949BAC5CDF05EDA1019FB7CA4B17,42491,10,14,4,32,46,1646
73751,73751,5ED8949BAC5CDF05EDA1019FB7CA4B17,10471,14,21,7,37,48,1898
73752,73752,5ED8949BAC5CDF05EDA1019FB7CA4B17,42161,21,23,2,36,47,1847
73753,73753,8AB561279CAFD673B81CFFF6F25401C3,43011,7,9,2,40,42,2042
73754,73754,8AB561279CAFD673B81CFFF6F25401C3,13951,12,17,5,47,45,2395
73755,73755,8AB561279CAFD673B81CFFF6F25401C3,43011,18,23,5,40,42,2042
73756,73756,2AEA8CD7C7441A2139369CE4AFCCE79A,40964,0,8,8,35,48,1798
73757,73757,2AEA8CD7C7441A2139369CE4AFCCE79A,41081,11,16,5,36,49,1849
73758,73758,2AEA8CD7C7441A2139369CE4AFCCE79A,11701,19,21,2,43,48,2198
73759,73759,978C0CFF80BE5323032978AAED91F75F,10601,0,7,7,39,47,1997
73760,73760,978C0CFF80BE5323032978AAED91F75F,42011,11,13,2,36,46,1846
73761,73761,978C0CFF80BE5323032978AAED91F75F,43451,14,16,2,37,40,1890
73762,73762,978C0CFF80BE5323032978AAED91F75F,10271,18,19,1,37,46,1896
73763,73763,978C0CFF80BE5323032978AAED91F75F,40322,19,20,1,38,46,1946
73768,73768,0860F43DE0BD08259313B4A1D065BB90,11351,0,7,7,36,48,1848
73769,73769,0860F43DE0BD08259313B4A1D065BB90,10401,9,11,2,33,49,1699
73770,73770,0860F43DE0BD08259313B4A1D065BB90,11351,12,14,2,36,48,1848
73771,73771,0860F43DE0BD08259313B4A1D065BB90,10401,15,18,3,33,49,1699
73772,73772,0860F43DE0BD08259313B4A1D065BB90,11351,21,23,2,36,48,1848
73779,73779,BB44A13BCAB0B022B18D7F4EDDEC4037,12083,0,1,1,36,49,1849
73780,73780,BB44A13BCAB0B022B18D7F4EDDEC4037,43671,2,3,1,35,48,1798
73781,73781,BB44A13BCAB0B022B18D7F4EDDEC4037,13511,4,5,1,34,48,1748
73782,73782,BB44A13BCAB0B022B18D7F4EDDEC4037,42301,6,15,9,36,47,1847
73783,73783,BB44A13BCAB0B022B18D7F4EDDEC4037,41007,16,17,1,37,47,1897
73784,73784,BB44A13BCAB0B022B18D7F4EDDEC4037,11231,20,23,3,37,49,1899
73785,73785,6D92EE52F600169319D34C49B1A602B3,11074,0,9,9,37,47,1897
73786,73786,6D92EE52F600169319D34C49B1A602B3,10281,12,17,5,33,48,1698
73787,73787,6D92EE52F600169319D34C49B1A602B3,42291,18,23,5,29,48,1498
73795,73795,B304D2AD98C7DE24CAE6DD0DA65095F0,10431,0,6,6,33,49,1699
73796,73796,B304D2AD98C7DE24CAE6DD0DA65095F0,42491,7,11,4,32,46,1646
73797,73797,B304D2AD98C7DE24CAE6DD0DA65095F0,10431,12,13,1,33,49,1699
73798,73798,B304D2AD98C7DE24CAE6DD0DA65095F0,43581,13,15,2,33,48,1698
73799,73799,B304D2AD98C7DE24CAE6DD0DA65095F0,42491,16,17,1,32,46,1646
73800,73800,B304D2AD98C7DE24CAE6DD0DA65095F0,43581,17,20,3,33,48,1698
73801,73801,B304D2AD98C7DE24CAE6DD0DA65095F0,10431,20,23,3,33,49,1699
73805,73805,8204652A3D7742C9538642482E893AC3,19031,5,6,1,1,42,92
73806,73806,8204652A3D7742C9538642482E893AC3,49201,9,12,3,7,41,391
73807,73807,8204652A3D7742C9538642482E893AC3,12921,12,13,1,9,41,491
73808,73808,8204652A3D7742C9538642482E893AC3,49201,15,16,1,7,41,391
73809,73809,8204652A3D7742C9538642482E893AC3,12921,19,21,2,9,41,491
73810,73810,8204652A3D7742C9538642482E893AC3,49201,22,23,1,7,41,391
73815,73815,29D06D73EAAE6A94E8397780C07DE916,13911,0,7,7,39,46,1996
73816,73816,29D06D73EAAE6A94E8397780C07DE916,42321,9,10,1,43,47,2197
73817,73817,29D06D73EAAE6A94E8397780C07DE916,42351,13,14,1,38,45,1945
73818,73818,29D06D73EAAE6A94E8397780C07DE916,13351,16,18,2,48,48,2448
73819,73819,29D06D73EAAE6A94E8397780C07DE916,13911,20,22,2,39,46,1996
73824,73824,E2D81C206764E3951071FC322019D398,12131,0,5,5,32,47,1647
73825,73825,E2D81C206764E3951071FC322019D398,11841,7,10,3,33,46,1696
73826,73826,E2D81C206764E3951071FC322019D398,12131,10,11,1,32,47,1647
73827,73827,E2D81C206764E3951071FC322019D398,11701,13,15,2,43,48,2198
73828,73828,E2D81C206764E3951071FC322019D398,12131,17,18,1,32,47,1647
73829,73829,E2D81C206764E3951071FC322019D398,11061,19,21,2,29,48,1498
73830,73830,10A422C047D598ECAC1912DEA262C9AA,11871,0,1,1,29,46,1496
73831,73831,10A422C047D598ECAC1912DEA262C9AA,13911,1,7,6,39,46,1996
73832,73832,10A422C047D598ECAC1912DEA262C9AA,11871,9,20,11,29,46,1496
73833,73833,C8790668F6CABE33884F6E2747515A56,19114,2,6,4,7,43,393
73834,73834,C8790668F6CABE33884F6E2747515A56,12641,6,8,2,10,43,543
73835,73835,C8790668F6CABE33884F6E2747515A56,12921,9,11,2,9,41,491
73836,73836,C8790668F6CABE33884F6E2747515A56,12641,11,12,1,10,43,543
73837,73837,C8790668F6CABE33884F6E2747515A56,19744,16,18,2,6,43,343
73842,73842,66AFBD9C113F67320652DF95B713C893,43011,7,12,5,40,42,2042
73843,73843,66AFBD9C113F67320652DF95B713C893,12221,12,14,2,43,44,2194
73844,73844,66AFBD9C113F67320652DF95B713C893,43011,19,22,3,40,42,2042
73848,73848,40332F05BDDE464A3027D1BB9B325A5D,12401,0,7,7,39,49,1999
73849,73849,40332F05BDDE464A3027D1BB9B325A5D,12121,9,13,4,29,47,1497
73850,73850,40332F05BDDE464A3027D1BB9B325A5D,12401,13,15,2,39,49,1999
73851,73851,40332F05BDDE464A3027D1BB9B325A5D,11074,19,21,2,37,47,1897
73852,73852,40332F05BDDE464A3027D1BB9B325A5D,10191,21,23,2,40,48,2048
73853,73853,48D09EA1E123F030FD71CF37426D4799,42151,0,1,1,35,45,1795
73854,73854,48D09EA1E123F030FD71CF37426D4799,43011,1,8,7,40,42,2042
73855,73855,48D09EA1E123F030FD71CF37426D4799,42151,9,12,3,35,45,1795
73856,73856,48D09EA1E123F030FD71CF37426D4799,43011,14,16,2,40,42,2042
73857,73857,48D09EA1E123F030FD71CF37426D4799,42151,17,19,2,35,45,1795
73861,73861,F933276E840F8E84214D3C6BDA6A4447,11061,0,18,18,29,48,1498
73862,73862,F933276E840F8E84214D3C6BDA6A4447,40951,19,20,1,36,49,1849
73863,73863,F933276E840F8E84214D3C6BDA6A4447,11061,22,23,1,29,48,1498
73868,73868,DB5F58C0BF92D33E406DDC1B3C9B82ED,10161,0,6,6,35,49,1799
73869,73869,DB5F58C0BF92D33E406DDC1B3C9B82ED,10716,8,9,1,30,46,1546
73870,73870,DB5F58C0BF92D33E406DDC1B3C9B82ED,10295,9,14,5,30,47,1547
73871,73871,DB5F58C0BF92D33E406DDC1B3C9B82ED,10161,17,23,6,35,49,1799
73878,73878,C38A2FBDADA545E6421F3EB66F4CD3D6,11021,0,7,7,36,49,1849
73879,73879,C38A2FBDADA545E6421F3EB66F4CD3D6,10351,10,12,2,28,45,1445
73880,73880,C38A2FBDADA545E6421F3EB66F4CD3D6,11021,13,23,10,36,49,1849
73881,73881,93C87ADE4FBD02048670A9DCD4C6ECEA,11261,0,2,2,36,46,1846
73882,73882,93C87ADE4FBD02048670A9DCD4C6ECEA,42861,6,9,3,37,44,1894
73883,73883,93C87ADE4FBD02048670A9DCD4C6ECEA,42864,12,13,1,38,44,1944
73884,73884,93C87ADE4FBD02048670A9DCD4C6ECEA,42861,14,18,4,37,44,1894
73885,73885,93C87ADE4FBD02048670A9DCD4C6ECEA,11261,19,22,3,36,46,1846
73896,73896,725F4DF1678770995D2853C4CA844B3D,10221,0,2,2,34,49,1749
73897,73897,725F4DF1678770995D2853C4CA844B3D,43761,3,11,8,32,47,1647
73898,73898,725F4DF1678770995D2853C4CA844B3D,11061,13,14,1,29,48,1498
73899,73899,725F4DF1678770995D2853C4CA844B3D,10295,18,19,1,30,47,1547
73900,73900,725F4DF1678770995D2853C4CA844B3D,43451,22,23,1,37,40,1890
73901,73901,3717F18D88C40095DBADE8C95C390E6F,42151,0,2,2,35,45,1795
73902,73902,3717F18D88C40095DBADE8C95C390E6F,13911,3,6,3,39,46,1996
73903,73903,3717F18D88C40095DBADE8C95C390E6F,42151,10,14,4,35,45,1795
73904,73904,3717F18D88C40095DBADE8C95C390E6F,42861,19,21,2,37,44,1894
73905,73905,3717F18D88C40095DBADE8C95C390E6F,42011,21,23,2,36,46,1846
73906,73906,01C251998711FB7F09226E56B9939B5F,42541,6,7,1,25,47,1297
73907,73907,01C251998711FB7F09226E56B9939B5F,43761,7,9,2,32,47,1647
73908,73908,01C251998711FB7F09226E56B9939B5F,42491,11,13,2,32,46,1646
73909,73909,01C251998711FB7F09226E56B9939B5F,12131,16,17,1,32,47,1647
73910,73910,01C251998711FB7F09226E56B9939B5F,42541,18,23,5,25,47,1297
73911,73911,AAC98D8EB5664A9B5DE56F266CB31991,15143,1,5,4,18,7,907
73912,73912,AAC98D8EB5664A9B5DE56F266CB31991,16281,6,7,1,11,4,554
73913,73913,AAC98D8EB5664A9B5DE56F266CB31991,15143,10,14,4,18,7,907
73914,73914,AAC98D8EB5664A9B5DE56F266CB31991,16281,17,19,2,11,4,554
73915,73915,AAC98D8EB5664A9B5DE56F266CB31991,15281,20,21,1,25,3,1253
73916,73916,AAC98D8EB5664A9B5DE56F266CB31991,16281,21,23,2,11,4,554
73917,73917,47370804777AD4D707AF8E3278755087,10661,0,7,7,37,49,1899
73918,73918,47370804777AD4D707AF8E3278755087,42291,9,10,1,29,48,1498
73919,73919,47370804777AD4D707AF8E3278755087,11381,11,23,12,30,47,1547
73920,73920,6CC24D921FE70D79D98FA5B7890BCB55,19441,4,11,7,8,46,446
73921,73921,6CC24D921FE70D79D98FA5B7890BCB55,19901,12,15,3,7,44,394
73922,73922,6CC24D921FE70D79D98FA5B7890BCB55,42041,16,18,2,10,47,547
73923,73923,6CC24D921FE70D79D98FA5B7890BCB55,12641,22,23,1,10,43,543
73924,73924,BFB5F99311B260572E316DE64B3EB913,11131,0,8,8,33,48,1698
73925,73925,BFB5F99311B260572E316DE64B3EB913,10901,9,16,7,35,48,1798
73926,73926,BFB5F99311B260572E316DE64B3EB913,42511,18,21,3,37,47,1897
73927,73927,BFB5F99311B260572E316DE64B3EB913,10901,22,23,1,35,48,1798
73928,73928,604AAF4555B85DE6F1339E606D4F2175,42111,0,6,6,44,46,2246
73929,73929,604AAF4555B85DE6F1339E606D4F2175,42523,7,18,11,31,47,1597
73930,73930,604AAF4555B85DE6F1339E606D4F2175,11081,18,20,2,35,46,1796
73934,73934,BCCA36AC6DE92B5D284204C1D312B82A,43161,0,6,6,35,47,1797
73935,73935,BCCA36AC6DE92B5D284204C1D312B82A,42801,9,14,5,40,49,2049
73936,73936,BCCA36AC6DE92B5D284204C1D312B82A,42161,18,23,5,36,47,1847
73937,73937,46624C7A7A05E81084BABC40FE8F937C,13314,0,7,7,31,39,1589
73938,73938,46624C7A7A05E81084BABC40FE8F937C,12521,7,9,2,35,41,1791
73939,73939,46624C7A7A05E81084BABC40FE8F937C,13314,9,23,14,31,39,1589
73944,73944,2F1F7798F5E8889B4080CA59D71F0274,11081,7,9,2,35,46,1796
73945,73945,2F1F7798F5E8889B4080CA59D71F0274,10271,10,14,4,37,46,1896
73946,73946,2F1F7798F5E8889B4080CA59D71F0274,13711,14,16,2,38,46,1946
73947,73947,2F1F7798F5E8889B4080CA59D71F0274,43241,17,18,1,36,46,1846
73948,73948,2F1F7798F5E8889B4080CA59D71F0274,10271,19,23,4,37,46,1896
73956,73956,B16AADC70667F1407A8020F9E0E0F89A,11921,0,5,5,38,48,1948
73957,73957,B16AADC70667F1407A8020F9E0E0F89A,43761,6,15,9,32,47,1647
73958,73958,B16AADC70667F1407A8020F9E0E0F89A,11921,16,17,1,38,48,1948
73959,73959,B16AADC70667F1407A8020F9E0E0F89A,11074,18,21,3,37,47,1897
73960,73960,B16AADC70667F1407A8020F9E0E0F89A,11921,21,23,2,38,48,1948
73961,73961,487315C9A10EA017D67B443311820F7A,11771,0,6,6,39,49,1999
73962,73962,487315C9A10EA017D67B443311820F7A,11914,10,16,6,37,48,1898
73963,73963,487315C9A10EA017D67B443311820F7A,10901,19,21,2,35,48,1798
73964,73964,84D09807769454188E86D49181B1B5D0,11331,2,4,2,37,48,1898
73965,73965,84D09807769454188E86D49181B1B5D0,43061,4,10,6,43,46,2196
73966,73966,84D09807769454188E86D49181B1B5D0,13111,10,13,3,42,46,2146
73967,73967,84D09807769454188E86D49181B1B5D0,10521,14,16,2,41,47,2097
73968,73968,84D09807769454188E86D49181B1B5D0,43061,17,18,1,43,46,2196
73969,73969,84D09807769454188E86D49181B1B5D0,42581,19,20,1,38,48,1948
73976,73976,51E47FDE51716EB36BE96125516194AB,11021,0,11,11,36,49,1849
73977,73977,51E47FDE51716EB36BE96125516194AB,40697,12,13,1,43,48,2198
73978,73978,51E47FDE51716EB36BE96125516194AB,11021,15,17,2,36,49,1849
73979,73979,51E47FDE51716EB36BE96125516194AB,40697,17,19,2,43,48,2198
73980,73980,51E47FDE51716EB36BE96125516194AB,11021,21,23,2,36,49,1849
73981,73981,C7B2C2AE2DF954A69981F5A4F94159CA,42231,2,3,1,37,46,1896
73982,73982,C7B2C2AE2DF954A69981F5A4F94159CA,42151,3,8,5,35,45,1795
73983,73983,C7B2C2AE2DF954A69981F5A4F94159CA,42351,11,13,2,38,45,1945
73984,73984,C7B2C2AE2DF954A69981F5A4F94159CA,12491,14,16,2,36,43,1843
73985,73985,C7B2C2AE2DF954A69981F5A4F94159CA,42351,19,20,1,38,45,1945
73986,73986,9B49BEB65E16F10DE8E30D5D01D652E3,10811,1,9,8,38,46,1946
73987,73987,9B49BEB65E16F10DE8E30D5D01D652E3,11261,11,13,2,36,46,1846
73988,73988,9B49BEB65E16F10DE8E30D5D01D652E3,12311,16,18,2,30,44,1544
73989,73989,9B49BEB65E16F10DE8E30D5D01D652E3,10811,21,22,1,38,46,1946
73993,73993,91BDEDAC648767D3A83A88B3F0D48C25,42351,0,2,2,38,45,1945
73994,73994,91BDEDAC648767D3A83A88B3F0D48C25,13911,2,8,6,39,46,1996
73995,73995,91BDEDAC648767D3A83A88B3F0D48C25,42351,8,10,2,38,45,1945
73996,73996,91BDEDAC648767D3A83A88B3F0D48C25,10811,12,15,3,38,46,1946
73997,73997,91BDEDAC648767D3A83A88B3F0D48C25,13231,17,19,2,39,46,1996
73998,73998,91BDEDAC648767D3A83A88B3F0D48C25,42231,21,23,2,37,46,1896
74015,74015,86D79D690C2F1F8AD0DA3D3F5AF4C54F,11061,0,6,6,29,48,1498
74016,74016,86D79D690C2F1F8AD0DA3D3F5AF4C54F,10521,6,9,3,41,47,2097
74017,74017,86D79D690C2F1F8AD0DA3D3F5AF4C54F,42161,14,21,7,36,47,1847
74018,74018,86D79D690C2F1F8AD0DA3D3F5AF4C54F,10521,22,23,1,41,47,2097
74022,74022,53B9F7992DB29A9E3000FDBC39A3F0DF,11074,0,5,5,37,47,1897
74023,74023,53B9F7992DB29A9E3000FDBC39A3F0DF,42221,6,7,1,38,48,1948
74024,74024,53B9F7992DB29A9E3000FDBC39A3F0DF,11074,8,13,5,37,47,1897
74025,74025,53B9F7992DB29A9E3000FDBC39A3F0DF,12514,15,16,1,38,47,1947
74026,74026,53B9F7992DB29A9E3000FDBC39A3F0DF,11074,18,20,2,37,47,1897
74027,74027,B9BA9C4A9A58FB97E9FBCEF8809D76A7,12921,1,6,5,9,41,491
74028,74028,B9BA9C4A9A58FB97E9FBCEF8809D76A7,10221,8,18,10,34,49,1749
74029,74029,B9BA9C4A9A58FB97E9FBCEF8809D76A7,42041,19,20,1,10,47,547
74030,74030,DB3C92167D7C02EAB46060E4569D1D1B,40833,2,6,4,41,47,2097
74031,74031,DB3C92167D7C02EAB46060E4569D1D1B,11231,8,18,10,37,49,1899
74032,74032,DB3C92167D7C02EAB46060E4569D1D1B,10421,19,20,1,41,48,2098
74037,74037,DAF070E37522449552E837969D087804,10491,0,6,6,33,48,1698
74038,74038,DAF070E37522449552E837969D087804,11231,6,11,5,37,49,1899
74039,74039,DAF070E37522449552E837969D087804,11171,12,13,1,33,48,1698
74040,74040,DAF070E37522449552E837969D087804,11231,14,17,3,37,49,1899
74041,74041,DAF070E37522449552E837969D087804,10471,18,19,1,37,48,1898
74042,74042,DAF070E37522449552E837969D087804,11171,19,23,4,33,48,1698
74046,74046,0DCD9EEA776860D0621554B5A42521A4,11061,0,9,9,29,48,1498
74047,74047,0DCD9EEA776860D0621554B5A42521A4,10681,12,13,1,30,48,1548
74048,74048,0DCD9EEA776860D0621554B5A42521A4,11061,14,16,2,29,48,1498
74049,74049,0DCD9EEA776860D0621554B5A42521A4,10681,19,20,1,30,48,1548
74050,74050,0DCD9EEA776860D0621554B5A42521A4,10401,21,23,2,33,49,1699
74057,74057,B8DB030E6F574F75DC469AA0B11A44D5,10151,0,7,7,34,47,1747
74058,74058,B8DB030E6F574F75DC469AA0B11A44D5,42921,9,11,2,33,47,1697
74059,74059,B8DB030E6F574F75DC469AA0B11A44D5,40637,12,13,1,36,47,1847
74060,74060,B8DB030E6F574F75DC469AA0B11A44D5,42921,16,17,1,33,47,1697
74061,74061,B8DB030E6F574F75DC469AA0B11A44D5,10151,19,23,4,34,47,1747
74065,74065,D14484DB6515E86DA2EC37443AB9F264,11261,0,6,6,36,46,1846
74066,74066,D14484DB6515E86DA2EC37443AB9F264,12601,8,11,3,25,47,1297
74067,74067,D14484DB6515E86DA2EC37443AB9F264,11261,13,19,6,36,46,1846
74077,74077,BD344F46B6AD9440696548FCEFE44E6E,10111,10,13,3,37,47,1897
74078,74078,BD344F46B6AD9440696548FCEFE44E6E,10281,14,16,2,33,48,1698
74079,74079,BD344F46B6AD9440696548FCEFE44E6E,10111,17,19,2,37,47,1897
74084,74084,57068447BEEE4D7969FF166D57966ECA,42541,0,5,5,25,47,1297
74085,74085,57068447BEEE4D7969FF166D57966ECA,11361,7,10,3,22,48,1148
74086,74086,57068447BEEE4D7969FF166D57966ECA,42541,12,13,1,25,47,1297
74087,74087,57068447BEEE4D7969FF166D57966ECA,11361,13,17,4,22,48,1148
74088,74088,57068447BEEE4D7969FF166D57966ECA,42541,22,23,1,25,47,1297
74089,74089,66E04FE458E7F0A691F219A1307BA20F,19441,0,6,6,8,46,446
74090,74090,66E04FE458E7F0A691F219A1307BA20F,12581,7,16,9,24,48,1248
74091,74091,66E04FE458E7F0A691F219A1307BA20F,11571,19,20,1,13,46,696
74092,74092,27F0B8622EC714A5E8C953242CC5B36B,42523,0,5,5,31,47,1597
74093,74093,27F0B8622EC714A5E8C953242CC5B36B,42871,8,9,1,30,45,1545
74094,74094,27F0B8622EC714A5E8C953242CC5B36B,11261,14,16,2,36,46,1846
74095,74095,27F0B8622EC714A5E8C953242CC5B36B,42523,18,23,5,31,47,1597
74096,74096,DB889186FEB7E9AF029B386FEDCE28A5,10971,0,2,2,35,47,1797
74097,74097,DB889186FEB7E9AF029B386FEDCE28A5,42161,2,4,2,36,47,1847
74098,74098,DB889186FEB7E9AF029B386FEDCE28A5,10971,6,18,12,35,47,1797
74099,74099,DB889186FEB7E9AF029B386FEDCE28A5,10151,19,20,1,34,47,1747
74100,74100,DB889186FEB7E9AF029B386FEDCE28A5,10971,21,23,2,35,47,1797
74114,74114,F725A3F859B25741A70E1B3AC0517A8A,42301,0,2,2,36,47,1847
74115,74115,F725A3F859B25741A70E1B3AC0517A8A,10111,2,11,9,37,47,1897
74116,74116,F725A3F859B25741A70E1B3AC0517A8A,11201,14,18,4,35,49,1799
74117,74117,F725A3F859B25741A70E1B3AC0517A8A,10111,21,22,1,37,47,1897
74118,74118,F725A3F859B25741A70E1B3AC0517A8A,42301,22,23,1,36,47,1847
74122,74122,4BCE8F3D44B6D775FF828315B62C8CD6,13371,0,8,8,41,47,2097
74123,74123,4BCE8F3D44B6D775FF828315B62C8CD6,11781,11,14,3,38,49,1949
74124,74124,4BCE8F3D44B6D775FF828315B62C8CD6,13371,18,20,2,41,47,2097
74125,74125,8B98AD14780EFE4A809080D8E1142428,10841,0,7,7,37,47,1897
74126,74126,8B98AD14780EFE4A809080D8E1142428,41271,8,17,9,38,48,1948
74127,74127,8B98AD14780EFE4A809080D8E1142428,42201,20,23,3,43,46,2196
74128,74128,BB3DB8BDA13F245F7DA1B278DE6D4FF0,43021,2,5,3,16,43,843
74129,74129,BB3DB8BDA13F245F7DA1B278DE6D4FF0,12641,6,7,1,10,43,543
74130,74130,BB3DB8BDA13F245F7DA1B278DE6D4FF0,12921,8,10,2,9,41,491
74131,74131,BB3DB8BDA13F245F7DA1B278DE6D4FF0,43021,11,23,12,16,43,843
74132,74132,8B162D826614AE6B0D3DB5A304485836,11771,0,6,6,39,49,1999
74133,74133,8B162D826614AE6B0D3DB5A304485836,11914,7,17,10,37,48,1898
74134,74134,8B162D826614AE6B0D3DB5A304485836,10901,19,21,2,35,48,1798
74135,74135,8B162D826614AE6B0D3DB5A304485836,10191,21,23,2,40,48,2048
74143,74143,711BE3DC1B779F061511011191B2AC90,13101,0,6,6,40,47,2047
74144,74144,711BE3DC1B779F061511011191B2AC90,11481,7,9,2,41,48,2098
74145,74145,711BE3DC1B779F061511011191B2AC90,40833,9,10,1,41,47,2097
74146,74146,711BE3DC1B779F061511011191B2AC90,13101,12,16,4,40,47,2047
74147,74147,711BE3DC1B779F061511011191B2AC90,10107,16,18,2,38,49,1949
74161,74161,CA7675D4504FF649E5D3C79C1D770D57,10901,0,6,6,35,48,1798
74162,74162,CA7675D4504FF649E5D3C79C1D770D57,11151,6,13,7,30,48,1548
74163,74163,CA7675D4504FF649E5D3C79C1D770D57,10381,13,16,3,31,49,1599
74164,74164,CA7675D4504FF649E5D3C79C1D770D57,11151,16,17,1,30,48,1548
74165,74165,CA7675D4504FF649E5D3C79C1D770D57,10881,19,20,1,34,48,1748
74166,74166,CA7675D4504FF649E5D3C79C1D770D57,10901,22,23,1,35,48,1798
74167,74167,9BE9B638A03223167AF819AA94751264,43121,0,14,14,25,27,1277
74168,74168,9BE9B638A03223167AF819AA94751264,15321,14,16,2,29,26,1476
74169,74169,9BE9B638A03223167AF819AA94751264,43121,17,23,6,25,27,1277
74180,74180,E908468A4151400394D5313058C7E35A,12601,0,6,6,25,47,1297
74181,74181,E908468A4151400394D5313058C7E35A,10501,6,7,1,22,46,1146
74182,74182,E908468A4151400394D5313058C7E35A,12601,9,15,6,25,47,1297
74183,74183,E908468A4151400394D5313058C7E35A,19114,19,23,4,7,43,393
74190,74190,EC861FE21AFD755213652562865FFBF9,43101,0,5,5,46,40,2340
74191,74191,EC861FE21AFD755213652562865FFBF9,13071,9,10,1,41,41,2091
74192,74192,EC861FE21AFD755213652562865FFBF9,43101,12,18,6,46,40,2340
74193,74193,B969FE7CA88FA294C8201CFC44CC669E,12121,0,7,7,29,47,1497
74194,74194,B969FE7CA88FA294C8201CFC44CC669E,42161,11,13,2,36,47,1847
74195,74195,B969FE7CA88FA294C8201CFC44CC669E,12121,17,23,6,29,47,1497
74196,74196,88182B8F0A08A7B6CD3790FE87C79F47,42351,0,2,2,38,45,1945
74197,74197,88182B8F0A08A7B6CD3790FE87C79F47,42231,7,8,1,37,46,1896
74198,74198,88182B8F0A08A7B6CD3790FE87C79F47,42351,9,17,8,38,45,1945
74199,74199,88182B8F0A08A7B6CD3790FE87C79F47,42231,17,19,2,37,46,1896
74200,74200,88182B8F0A08A7B6CD3790FE87C79F47,42351,19,22,3,38,45,1945
74201,74201,A9FAA4B4C51A5D14416D1899F40B6E9A,13481,0,8,8,26,31,1331
74202,74202,A9FAA4B4C51A5D14416D1899F40B6E9A,19801,11,18,7,19,26,976
74203,74203,A9FAA4B4C51A5D14416D1899F40B6E9A,13481,20,23,3,26,31,1331
74204,74204,9D369833089F92472FC6631700F511AB,12051,0,12,12,20,47,1047
74205,74205,9D369833089F92472FC6631700F511AB,42691,16,19,3,24,48,1248
74206,74206,9D369833089F92472FC6631700F511AB,12051,19,23,4,20,47,1047
74207,74207,566A98F570A1628E8F6EFD9CFCC9370E,13071,0,5,5,41,41,2091
74208,74208,566A98F570A1628E8F6EFD9CFCC9370E,12491,8,18,10,36,43,1843
74209,74209,566A98F570A1628E8F6EFD9CFCC9370E,11841,19,20,1,33,46,1696
74210,74210,566A98F570A1628E8F6EFD9CFCC9370E,12661,21,22,1,32,45,1645
74214,74214,B04440F57A2334689CE151EAF133623D,11771,1,7,6,39,49,1999
74215,74215,B04440F57A2334689CE151EAF133623D,10292,11,15,4,30,47,1547
74216,74216,B04440F57A2334689CE151EAF133623D,10951,17,18,1,29,48,1498
74217,74217,B04440F57A2334689CE151EAF133623D,11791,20,21,1,38,49,1949
74221,74221,795B19542A85BBCF6E0BEEABCE2E1262,10951,0,8,8,29,48,1498
74222,74222,795B19542A85BBCF6E0BEEABCE2E1262,11151,12,18,6,30,48,1548
74223,74223,795B19542A85BBCF6E0BEEABCE2E1262,10951,18,19,1,29,48,1498
74224,74224,795B19542A85BBCF6E0BEEABCE2E1262,11151,20,21,1,30,48,1548
74225,74225,795B19542A85BBCF6E0BEEABCE2E1262,10951,22,23,1,29,48,1498
74226,74226,B6D45CAD08DA6AF2E8E8E6A5F02AD4A8,11161,0,6,6,32,48,1648
74227,74227,B6D45CAD08DA6AF2E8E8E6A5F02AD4A8,12661,7,9,2,32,45,1645
74228,74228,B6D45CAD08DA6AF2E8E8E6A5F02AD4A8,42501,13,16,3,28,47,1447
74229,74229,B6D45CAD08DA6AF2E8E8E6A5F02AD4A8,11431,18,19,1,29,47,1497
74230,74230,B6D45CAD08DA6AF2E8E8E6A5F02AD4A8,11161,20,23,3,32,48,1648
74231,74231,A845F5E6E274947D69D978D433D48E69,11914,0,9,9,37,48,1898
74232,74232,A845F5E6E274947D69D978D433D48E69,12601,12,16,4,25,47,1297
74233,74233,A845F5E6E274947D69D978D433D48E69,11914,18,20,2,37,48,1898
74234,74234,A845F5E6E274947D69D978D433D48E69,42961,21,22,1,35,49,1799
74239,74239,40A3F567657A043546A2ED7A5DC91A85,12792,0,12,12,34,30,1730
74240,74240,40A3F567657A043546A2ED7A5DC91A85,15331,13,16,3,38,24,1924
74241,74241,40A3F567657A043546A2ED7A5DC91A85,12792,20,23,3,34,30,1730
74242,74242,CB6CE8B284764CB65EC4187E6FE5A3FF,11571,0,6,6,13,46,696
74243,74243,CB6CE8B284764CB65EC4187E6FE5A3FF,19021,6,8,2,10,45,545
74244,74244,CB6CE8B284764CB65EC4187E6FE5A3FF,11571,9,10,1,13,46,696
74245,74245,CB6CE8B284764CB65EC4187E6FE5A3FF,19021,13,14,1,10,45,545
74246,74246,CB6CE8B284764CB65EC4187E6FE5A3FF,43021,19,20,1,16,43,843
74247,74247,CB6CE8B284764CB65EC4187E6FE5A3FF,19021,21,22,1,10,45,545
74252,74252,AB57CFBC7FBBD1B4F46C04046F726522,15171,0,5,5,42,21,2121
74253,74253,AB57CFBC7FBBD1B4F46C04046F726522,12881,7,8,1,47,22,2372
74254,74254,AB57CFBC7FBBD1B4F46C04046F726522,15171,13,14,1,42,21,2121
74255,74255,AB57CFBC7FBBD1B4F46C04046F726522,15021,14,16,2,46,18,2318
74256,74256,AB57CFBC7FBBD1B4F46C04046F726522,12881,18,20,2,47,22,2372
74264,74264,8AAB036B09D3D2F76995D9AF3741FD6E,42071,4,5,1,31,49,1599
74265,74265,8AAB036B09D3D2F76995D9AF3741FD6E,42261,7,14,7,25,49,1299
74266,74266,8AAB036B09D3D2F76995D9AF3741FD6E,42071,14,16,2,31,49,1599
74267,74267,8AAB036B09D3D2F76995D9AF3741FD6E,42261,21,22,1,25,49,1299
74268,74268,54AF0735D887B9C0B8CEE7B0E8BAEF2D,11471,0,5,5,12,48,648
74269,74269,54AF0735D887B9C0B8CEE7B0E8BAEF2D,11571,7,8,1,13,46,696
74270,74270,54AF0735D887B9C0B8CEE7B0E8BAEF2D,19441,10,20,10,8,46,446
74271,74271,9787D91B276DE1EFD2EDC1A9D94218F5,12792,0,14,14,34,30,1730
74272,74272,9787D91B276DE1EFD2EDC1A9D94218F5,15391,14,17,3,35,26,1776
74273,74273,9787D91B276DE1EFD2EDC1A9D94218F5,12792,18,20,2,34,30,1730
74278,74278,5117C51B1073385BE9CAD291C267C88C,10351,0,6,6,28,45,1445
74279,74279,5117C51B1073385BE9CAD291C267C88C,42231,7,21,14,37,46,1896
74280,74280,5117C51B1073385BE9CAD291C267C88C,42351,22,23,1,38,45,1945
74285,74285,E675A65705B47E64E764764AA7201F3F,15561,0,5,5,32,22,1622
74286,74286,E675A65705B47E64E764764AA7201F3F,15411,6,8,2,44,27,2227
74287,74287,E675A65705B47E64E764764AA7201F3F,12611,10,12,2,41,29,2079
74288,74288,E675A65705B47E64E764764AA7201F3F,15561,16,21,5,32,22,1622
74296,74296,C9255107859C2FB6A49577C5ACBDC9FD,11061,0,7,7,29,48,1498
74297,74297,C9255107859C2FB6A49577C5ACBDC9FD,43971,10,12,2,30,48,1548
74298,74298,C9255107859C2FB6A49577C5ACBDC9FD,11061,12,14,2,29,48,1498
74299,74299,C9255107859C2FB6A49577C5ACBDC9FD,11381,18,19,1,30,47,1547
74300,74300,C9255107859C2FB6A49577C5ACBDC9FD,43971,19,21,2,30,48,1548
74301,74301,B3BE6447EFCA9BFD3ACA1DFDD3D3A6B8,11104,0,17,17,17,47,897
74302,74302,B3BE6447EFCA9BFD3ACA1DFDD3D3A6B8,42541,18,19,1,25,47,1297
74303,74303,B3BE6447EFCA9BFD3ACA1DFDD3D3A6B8,11104,19,23,4,17,47,897
74304,74304,92D731B11080166AE9677089A81E2175,10491,0,7,7,33,48,1698
74305,74305,92D731B11080166AE9677089A81E2175,12401,10,11,1,39,49,1999
74306,74306,92D731B11080166AE9677089A81E2175,10491,12,14,2,33,48,1698
74307,74307,92D731B11080166AE9677089A81E2175,11914,16,17,1,37,48,1898
74308,74308,92D731B11080166AE9677089A81E2175,10491,18,23,5,33,48,1698
74309,74309,84D5DD5743261CBA6220A6F1E627F47F,11061,0,18,18,29,48,1498
74310,74310,84D5DD5743261CBA6220A6F1E627F47F,40951,19,21,2,36,49,1849
74311,74311,84D5DD5743261CBA6220A6F1E627F47F,11061,22,23,1,29,48,1498
74312,74312,AF03CB6E19CFE236682919AFB51A6FD2,11861,0,7,7,32,47,1647
74313,74313,AF03CB6E19CFE236682919AFB51A6FD2,40171,11,13,2,38,48,1948
74314,74314,AF03CB6E19CFE236682919AFB51A6FD2,13121,13,16,3,38,46,1946
74315,74315,AF03CB6E19CFE236682919AFB51A6FD2,12381,19,23,4,32,48,1648
74333,74333,09C2A5500F5ABAEEAC932C07F5628EC4,11021,1,4,3,36,49,1849
74334,74334,09C2A5500F5ABAEEAC932C07F5628EC4,42161,8,12,4,36,47,1847
74335,74335,09C2A5500F5ABAEEAC932C07F5628EC4,11021,12,14,2,36,49,1849
74336,74336,09C2A5500F5ABAEEAC932C07F5628EC4,42161,14,19,5,36,47,1847
74337,74337,09C2A5500F5ABAEEAC932C07F5628EC4,11021,20,23,3,36,49,1849
74341,74341,BBCB9918D42B41DEDF16DD7F5A9BE26F,11861,0,9,9,32,47,1647
74342,74342,BBCB9918D42B41DEDF16DD7F5A9BE26F,11911,12,14,2,37,48,1898
74343,74343,BBCB9918D42B41DEDF16DD7F5A9BE26F,11861,17,23,6,32,47,1647
74344,74344,46248CD3AE5F02514CBE5AD511617E45,43641,0,8,8,16,38,838
74345,74345,46248CD3AE5F02514CBE5AD511617E45,11281,10,17,7,27,40,1390
74346,74346,46248CD3AE5F02514CBE5AD511617E45,13671,21,22,1,27,43,1393
74347,74347,D4FB6B465C87A5D763D7E62820C6F264,42041,0,3,3,10,47,547
74348,74348,D4FB6B465C87A5D763D7E62820C6F264,19441,4,14,10,8,46,446
74349,74349,D4FB6B465C87A5D763D7E62820C6F264,42041,14,16,2,10,47,547
74350,74350,D4FB6B465C87A5D763D7E62820C6F264,19441,18,19,1,8,46,446
74351,74351,D4FB6B465C87A5D763D7E62820C6F264,42041,21,23,2,10,47,547
74352,74352,BB7C6EB314DE90AA7B719978F8080B2E,43951,0,8,8,49,41,2491
74353,74353,BB7C6EB314DE90AA7B719978F8080B2E,13411,11,12,1,49,42,2492
74354,74354,BB7C6EB314DE90AA7B719978F8080B2E,43951,14,16,2,49,41,2491
74355,74355,BB7C6EB314DE90AA7B719978F8080B2E,13411,19,20,1,49,42,2492
74356,74356,BB7C6EB314DE90AA7B719978F8080B2E,43951,21,23,2,49,41,2491
74364,74364,FC7EB9622F9DA93D9292A2CD4A392CDA,13911,3,10,7,39,46,1996
74365,74365,FC7EB9622F9DA93D9292A2CD4A392CDA,12491,11,12,1,36,43,1843
74366,74366,FC7EB9622F9DA93D9292A2CD4A392CDA,13911,16,19,3,39,46,1996
74367,74367,81565F9704E60766FEFBB47B416D00DF,12581,0,13,13,24,48,1248
74368,74368,81565F9704E60766FEFBB47B416D00DF,12051,14,16,2,20,47,1047
74369,74369,81565F9704E60766FEFBB47B416D00DF,12581,19,23,4,24,48,1248
74373,74373,809D30997DBB6653E10DF33CB05A97F7,12601,2,3,1,25,47,1297
74374,74374,809D30997DBB6653E10DF33CB05A97F7,13094,6,8,2,21,42,1092
74375,74375,809D30997DBB6653E10DF33CB05A97F7,13771,9,23,14,21,45,1095
74382,74382,58A0AAD1597EB0CB45ED09B67FBFF92F,43041,2,9,7,41,46,2096
74383,74383,58A0AAD1597EB0CB45ED09B67FBFF92F,41601,17,19,2,39,49,1999
74384,74384,58A0AAD1597EB0CB45ED09B67FBFF92F,12083,22,23,1,36,49,1849
74385,74385,ED053B9DF009F514098109BA2ADE8DE5,10171,0,1,1,26,47,1347
74386,74386,ED053B9DF009F514098109BA2ADE8DE5,10951,2,4,2,29,48,1498
74387,74387,ED053B9DF009F514098109BA2ADE8DE5,10381,8,16,8,31,49,1599
74388,74388,ED053B9DF009F514098109BA2ADE8DE5,10171,20,22,2,26,47,1347
74392,74392,A4C8C00FA0A4D1520AC6B2AE48C6B569,11074,0,6,6,37,47,1897
74393,74393,A4C8C00FA0A4D1520AC6B2AE48C6B569,43761,7,15,8,32,47,1647
74394,74394,A4C8C00FA0A4D1520AC6B2AE48C6B569,42221,18,19,1,38,48,1948
74405,74405,23AF0CD150759767F43F957384A6F3F9,42401,0,8,8,36,47,1847
74406,74406,23AF0CD150759767F43F957384A6F3F9,11331,9,10,1,37,48,1898
74407,74407,23AF0CD150759767F43F957384A6F3F9,42401,10,16,6,36,47,1847
74408,74408,23AF0CD150759767F43F957384A6F3F9,10111,17,18,1,37,47,1897
74409,74409,23AF0CD150759767F43F957384A6F3F9,42771,19,23,4,36,47,1847
74410,74410,F3EBB57DA3A54FEC2068629888C9AD19,11941,0,7,7,37,46,1896
74411,74411,F3EBB57DA3A54FEC2068629888C9AD19,10841,12,13,1,37,47,1897
74412,74412,F3EBB57DA3A54FEC2068629888C9AD19,12511,13,16,3,39,47,1997
74413,74413,F3EBB57DA3A54FEC2068629888C9AD19,12514,16,18,2,38,47,1947
74414,74414,F3EBB57DA3A54FEC2068629888C9AD19,11941,20,23,3,37,46,1896
74421,74421,9DEBDE2E2D69C2706A0A4A87F4FADCFC,42091,0,14,14,43,46,2196
74422,74422,9DEBDE2E2D69C2706A0A4A87F4FADCFC,10191,16,18,2,40,48,2048
74423,74423,9DEBDE2E2D69C2706A0A4A87F4FADCFC,42091,20,23,3,43,46,2196
74432,74432,AB5660F5D6FCD0BA1F946638D1164083,12341,0,11,11,26,38,1338
74433,74433,AB5660F5D6FCD0BA1F946638D1164083,43101,12,16,4,46,40,2340
74434,74434,AB5660F5D6FCD0BA1F946638D1164083,12341,18,23,5,26,38,1338
74445,74445,0A06E26D4B63B311703019BBFB7FEF42,10471,0,7,7,37,48,1898
74446,74446,0A06E26D4B63B311703019BBFB7FEF42,11875,9,12,3,30,46,1546
74447,74447,0A06E26D4B63B311703019BBFB7FEF42,11871,14,19,5,29,46,1496
74448,74448,0A06E26D4B63B311703019BBFB7FEF42,10471,20,21,1,37,48,1898
74449,74449,0A06E26D4B63B311703019BBFB7FEF42,42941,22,23,1,37,47,1897
74450,74450,0D04AEE5D0D9747786113FB147421EF2,12921,0,3,3,9,41,491
74451,74451,0D04AEE5D0D9747786113FB147421EF2,12641,3,6,3,10,43,543
74452,74452,0D04AEE5D0D9747786113FB147421EF2,12921,7,8,1,9,41,491
74453,74453,0D04AEE5D0D9747786113FB147421EF2,49201,8,10,2,7,41,391
74454,74454,0D04AEE5D0D9747786113FB147421EF2,19114,12,13,1,7,43,393
74455,74455,0D04AEE5D0D9747786113FB147421EF2,49201,16,19,3,7,41,391
74495,74495,7072D45C58A4A94BABD1B710AD10F471,42351,1,5,4,38,45,1945
74496,74496,7072D45C58A4A94BABD1B710AD10F471,12311,7,14,7,30,44,1544
74497,74497,7072D45C58A4A94BABD1B710AD10F471,42871,16,18,2,30,45,1545
74504,74504,38BAD20AF3F1C2D76FC5AB52738907B1,10341,0,5,5,31,47,1597
74505,74505,38BAD20AF3F1C2D76FC5AB52738907B1,11861,6,8,2,32,47,1647
74506,74506,38BAD20AF3F1C2D76FC5AB52738907B1,10341,9,13,4,31,47,1597
74507,74507,38BAD20AF3F1C2D76FC5AB52738907B1,11861,17,18,1,32,47,1647
74508,74508,38BAD20AF3F1C2D76FC5AB52738907B1,10341,19,23,4,31,47,1597
74509,74509,414AA00EC00DAA3D830C87A4F3E4DD09,11861,0,9,9,32,47,1647
74510,74510,414AA00EC00DAA3D830C87A4F3E4DD09,43981,16,19,3,36,49,1849
74511,74511,414AA00EC00DAA3D830C87A4F3E4DD09,11861,21,23,2,32,47,1647
74516,74516,AF5FCE69716A02851718ECEFB7086EE8,13651,0,7,7,30,47,1547
74517,74517,AF5FCE69716A02851718ECEFB7086EE8,10971,11,17,6,35,47,1797
74518,74518,AF5FCE69716A02851718ECEFB7086EE8,13651,19,22,3,30,47,1547
74519,74519,A26526FCE25758DA240C3B314B205E8A,19024,0,6,6,9,45,495
74520,74520,A26526FCE25758DA240C3B314B205E8A,12641,7,8,1,10,43,543
74521,74521,A26526FCE25758DA240C3B314B205E8A,12921,9,10,1,9,41,491
74522,74522,A26526FCE25758DA240C3B314B205E8A,12641,14,17,3,10,43,543
74523,74523,A26526FCE25758DA240C3B314B205E8A,19024,20,23,3,9,45,495
74528,74528,89EC37A7B83D9B7D194154C37975BD9C,42521,0,3,3,31,47,1597
74529,74529,89EC37A7B83D9B7D194154C37975BD9C,40445,3,6,3,30,48,1548
74530,74530,89EC37A7B83D9B7D194154C37975BD9C,43311,8,10,2,31,48,1598
74531,74531,89EC37A7B83D9B7D194154C37975BD9C,11061,13,14,1,29,48,1498
74532,74532,89EC37A7B83D9B7D194154C37975BD9C,43311,14,16,2,31,48,1598
74533,74533,89EC37A7B83D9B7D194154C37975BD9C,11061,17,22,5,29,48,1498
74537,74537,CBCBC4EFD4DD5AB68824D0A95962A2BF,15411,0,3,3,44,27,2227
74538,74538,CBCBC4EFD4DD5AB68824D0A95962A2BF,12881,4,6,2,47,22,2372
74539,74539,CBCBC4EFD4DD5AB68824D0A95962A2BF,12541,7,8,1,37,35,1885
74540,74540,CBCBC4EFD4DD5AB68824D0A95962A2BF,13251,12,13,1,48,28,2428
74541,74541,CBCBC4EFD4DD5AB68824D0A95962A2BF,15411,13,18,5,44,27,2227
74542,74542,B9A979B9AE84E31BBBDD76774181BD28,13771,1,7,6,21,45,1095
74543,74543,B9A979B9AE84E31BBBDD76774181BD28,11151,10,11,1,30,48,1548
74544,74544,B9A979B9AE84E31BBBDD76774181BD28,13771,13,22,9,21,45,1095
74545,74545,69F62EC905965E951064324714771523,19114,0,8,8,7,43,393
74546,74546,69F62EC905965E951064324714771523,10221,12,13,1,34,49,1749
74547,74547,69F62EC905965E951064324714771523,19744,17,19,2,6,43,343
74548,74548,69F62EC905965E951064324714771523,19114,20,21,1,7,43,393
74549,74549,737EEA850139715BDA79A2EDECCDCA7A,42864,1,5,4,38,44,1944
74550,74550,737EEA850139715BDA79A2EDECCDCA7A,11261,6,18,12,36,46,1846
74551,74551,737EEA850139715BDA79A2EDECCDCA7A,10781,19,22,3,35,47,1797
74559,74559,A53907219614BC9E0FC05C0EC4AF6DC2,13911,0,6,6,39,46,1996
74560,74560,A53907219614BC9E0FC05C0EC4AF6DC2,42231,6,10,4,37,46,1896
74561,74561,A53907219614BC9E0FC05C0EC4AF6DC2,13911,12,13,1,39,46,1996
74562,74562,A53907219614BC9E0FC05C0EC4AF6DC2,42231,13,15,2,37,46,1896
74563,74563,A53907219614BC9E0FC05C0EC4AF6DC2,13911,18,23,5,39,46,1996
74564,74564,DE2C8AE58D9D029E6E1B669A29CC258E,13331,0,7,7,38,47,1947
74565,74565,DE2C8AE58D9D029E6E1B669A29CC258E,43161,7,9,2,35,47,1797
74566,74566,DE2C8AE58D9D029E6E1B669A29CC258E,13331,11,12,1,38,47,1947
74567,74567,DE2C8AE58D9D029E6E1B669A29CC258E,11381,14,18,4,30,47,1547
74574,74574,CAABA1D97EF07FAB2534C5DA8C514BC8,13511,0,2,2,34,48,1748
74575,74575,CAABA1D97EF07FAB2534C5DA8C514BC8,11171,2,8,6,33,48,1698
74576,74576,CAABA1D97EF07FAB2534C5DA8C514BC8,13511,8,9,1,34,48,1748
74577,74577,CAABA1D97EF07FAB2534C5DA8C514BC8,10491,11,15,4,33,48,1698
74578,74578,CAABA1D97EF07FAB2534C5DA8C514BC8,11231,20,23,3,37,49,1899
74586,74586,5832F798017EC944959971DE10E6C76B,13911,0,2,2,39,46,1996
74587,74587,5832F798017EC944959971DE10E6C76B,12211,3,5,2,41,44,2094
74588,74588,5832F798017EC944959971DE10E6C76B,13911,5,10,5,39,46,1996
74589,74589,5832F798017EC944959971DE10E6C76B,11261,10,11,1,36,46,1846
74590,74590,5832F798017EC944959971DE10E6C76B,13911,12,14,2,39,46,1996
74591,74591,5832F798017EC944959971DE10E6C76B,11261,16,21,5,36,46,1846
74592,74592,27D00A76D1F00346D7914B08DE57644D,10111,0,7,7,37,47,1897
74593,74593,27D00A76D1F00346D7914B08DE57644D,10107,8,18,10,38,49,1949
74594,74594,27D00A76D1F00346D7914B08DE57644D,43731,18,20,2,34,47,1747
74595,74595,27D00A76D1F00346D7914B08DE57644D,43011,20,21,1,40,42,2042
74599,74599,AB0CC897EE90F6C4CFD3376B715B47C5,43361,0,8,8,38,48,1948
74600,74600,AB0CC897EE90F6C4CFD3376B715B47C5,43621,8,10,2,46,48,2348
74601,74601,AB0CC897EE90F6C4CFD3376B715B47C5,43361,11,23,12,38,48,1948
74605,74605,35E2175E021CD04E6CF0361F38962323,10811,1,7,6,38,46,1946
74606,74606,35E2175E021CD04E6CF0361F38962323,10421,10,20,10,41,48,2098
74607,74607,35E2175E021CD04E6CF0361F38962323,10811,22,23,1,38,46,1946
74614,74614,3C02B5838EDEAB0B15A337805B269A42,13011,0,5,5,39,47,1997
74615,74615,3C02B5838EDEAB0B15A337805B269A42,42601,6,12,6,44,48,2248
74616,74616,3C02B5838EDEAB0B15A337805B269A42,42321,12,18,6,43,47,2197
74617,74617,3C02B5838EDEAB0B15A337805B269A42,13011,21,23,2,39,47,1997
74621,74621,457B779D00720128DC52229000CD7309,15114,0,12,12,22,16,1116
74622,74622,457B779D00720128DC52229000CD7309,16441,14,16,2,15,17,767
74623,74623,457B779D00720128DC52229000CD7309,15114,17,23,6,22,16,1116
74624,74624,7B63B781AF1E5C1909C9ECFED6946980,43761,0,6,6,32,47,1647
74625,74625,7B63B781AF1E5C1909C9ECFED6946980,42523,7,9,2,31,47,1597
74626,74626,7B63B781AF1E5C1909C9ECFED6946980,43761,10,14,4,32,47,1647
74627,74627,7B63B781AF1E5C1909C9ECFED6946980,42523,14,17,3,31,47,1597
74628,74628,7B63B781AF1E5C1909C9ECFED6946980,43761,18,19,1,32,47,1647
74629,74629,7B63B781AF1E5C1909C9ECFED6946980,10281,19,20,1,33,48,1698
74640,74640,DC736499F15CC90E33F3F344F148EB89,40833,0,9,9,41,47,2097
74641,74641,DC736499F15CC90E33F3F344F148EB89,11751,12,13,1,35,48,1798
74642,74642,DC736499F15CC90E33F3F344F148EB89,40833,14,23,9,41,47,2097
74650,74650,EF9C99EE076D9702EF73224BC1A91C21,43621,0,5,5,46,48,2348
74651,74651,EF9C99EE076D9702EF73224BC1A91C21,11701,6,8,2,43,48,2198
74652,74652,EF9C99EE076D9702EF73224BC1A91C21,43621,8,11,3,46,48,2348
74653,74653,EF9C99EE076D9702EF73224BC1A91C21,11701,13,14,1,43,48,2198
74654,74654,EF9C99EE076D9702EF73224BC1A91C21,43621,17,23,6,46,48,2348
74655,74655,52AF30FEB5018BE5CDE8FC88E330A516,10331,0,6,6,39,46,1996
74656,74656,52AF30FEB5018BE5CDE8FC88E330A516,11791,7,9,2,38,49,1949
74657,74657,52AF30FEB5018BE5CDE8FC88E330A516,42351,13,14,1,38,45,1945
74658,74658,52AF30FEB5018BE5CDE8FC88E330A516,11791,16,18,2,38,49,1949
74659,74659,52AF30FEB5018BE5CDE8FC88E330A516,13231,19,23,4,39,46,1996
74660,74660,39179060954ADF536A44D5CDC3D7ADA4,10921,0,4,4,43,48,2198
74661,74661,39179060954ADF536A44D5CDC3D7ADA4,13911,5,9,4,39,46,1996
74662,74662,39179060954ADF536A44D5CDC3D7ADA4,11261,10,12,2,36,46,1846
74663,74663,39179060954ADF536A44D5CDC3D7ADA4,13911,14,18,4,39,46,1996
74664,74664,39179060954ADF536A44D5CDC3D7ADA4,12491,21,23,2,36,43,1843
74665,74665,59C9891991D18AB42F5CA2A676EAFEE0,42501,0,7,7,28,47,1447
74666,74666,59C9891991D18AB42F5CA2A676EAFEE0,19441,8,14,6,8,46,446
74667,74667,59C9891991D18AB42F5CA2A676EAFEE0,42501,19,23,4,28,47,1447
74668,74668,4F218B591484142BCC1168E4506477B5,12971,0,7,7,32,48,1648
74669,74669,4F218B591484142BCC1168E4506477B5,13671,11,18,7,27,43,1393
74670,74670,4F218B591484142BCC1168E4506477B5,10171,18,20,2,26,47,1347
74671,74671,4F218B591484142BCC1168E4506477B5,42511,20,22,2,37,47,1897
74672,74672,CFB5B91AB0CD7543884ADBE535AD19D6,43021,0,6,6,16,43,843
74673,74673,CFB5B91AB0CD7543884ADBE535AD19D6,12641,6,10,4,10,43,543
74674,74674,CFB5B91AB0CD7543884ADBE535AD19D6,12921,10,11,1,9,41,491
74675,74675,CFB5B91AB0CD7543884ADBE535AD19D6,12641,14,19,5,10,43,543
74676,74676,CFB5B91AB0CD7543884ADBE535AD19D6,43021,21,23,2,16,43,843
74680,74680,535C86A9CB4A74A74FDFADB22C0A9F21,11321,0,8,8,31,46,1596
74681,74681,535C86A9CB4A74A74FDFADB22C0A9F21,19021,9,13,4,10,45,545
74682,74682,535C86A9CB4A74A74FDFADB22C0A9F21,10351,13,14,1,28,45,1445
74683,74683,535C86A9CB4A74A74FDFADB22C0A9F21,11321,19,23,4,31,46,1596
74688,74688,BBADFE545D160853FAE68DD7ED4984D1,43501,0,2,2,27,48,1398
74689,74689,BBADFE545D160853FAE68DD7ED4984D1,10751,4,5,1,47,43,2393
74690,74690,BBADFE545D160853FAE68DD7ED4984D1,43501,14,21,7,27,48,1398
74694,74694,2AB1E00AE324EB01DB00242758B61F8A,11001,0,7,7,42,47,2147
74695,74695,2AB1E00AE324EB01DB00242758B61F8A,11531,10,13,3,34,49,1749
74696,74696,2AB1E00AE324EB01DB00242758B61F8A,11231,16,17,1,37,49,1899
74697,74697,2AB1E00AE324EB01DB00242758B61F8A,11001,19,23,4,42,47,2147
74698,74698,DEE5888BD7E461DD868275DE6FB19D26,10921,0,5,5,43,48,2198
74699,74699,DEE5888BD7E461DD868275DE6FB19D26,42091,8,9,1,43,46,2196
74700,74700,DEE5888BD7E461DD868275DE6FB19D26,10921,12,13,1,43,48,2198
74701,74701,DEE5888BD7E461DD868275DE6FB19D26,42091,14,15,1,43,46,2196
74702,74702,DEE5888BD7E461DD868275DE6FB19D26,10921,18,23,5,43,48,2198
74706,74706,2BB5E6319C361908A67DD8509286CF7C,19031,0,15,15,1,42,92
74707,74707,2BB5E6319C361908A67DD8509286CF7C,12641,18,20,2,10,43,543
74708,74708,2BB5E6319C361908A67DD8509286CF7C,19031,21,23,2,1,42,92
74712,74712,36B9A094E8D22C518990766A8F925428,19114,1,5,4,7,43,393
74713,74713,36B9A094E8D22C518990766A8F925428,12641,6,10,4,10,43,543
74714,74714,36B9A094E8D22C518990766A8F925428,19741,11,12,1,5,44,294
74715,74715,36B9A094E8D22C518990766A8F925428,12641,14,15,1,10,43,543
74716,74716,36B9A094E8D22C518990766A8F925428,19114,19,23,4,7,43,393
74717,74717,E1DD7EC86E7282DDD85335B7F6FA4A39,10841,2,3,1,37,47,1897
74718,74718,E1DD7EC86E7282DDD85335B7F6FA4A39,12514,4,7,3,38,47,1947
74719,74719,E1DD7EC86E7282DDD85335B7F6FA4A39,42511,9,13,4,37,47,1897
74720,74720,E1DD7EC86E7282DDD85335B7F6FA4A39,19114,14,23,9,7,43,393
74728,74728,E16566CAC1D2263C830A92E3D7A4B3A9,13911,1,2,1,39,46,1996
74729,74729,E16566CAC1D2263C830A92E3D7A4B3A9,42231,7,8,1,37,46,1896
74730,74730,E16566CAC1D2263C830A92E3D7A4B3A9,42351,10,15,5,38,45,1945
74731,74731,E16566CAC1D2263C830A92E3D7A4B3A9,42231,20,21,1,37,46,1896
74732,74732,E16566CAC1D2263C830A92E3D7A4B3A9,42351,21,23,2,38,45,1945
74733,74733,47C439CCDB64ED25CC847E4AB6F5434E,13341,0,6,6,44,45,2245
74734,74734,47C439CCDB64ED25CC847E4AB6F5434E,43971,8,10,2,30,48,1548
74735,74735,47C439CCDB64ED25CC847E4AB6F5434E,13341,15,23,8,44,45,2245
74736,74736,FB55B20B748C0A1CF26B4BE2B509424A,12761,0,4,4,25,40,1290
74737,74737,FB55B20B748C0A1CF26B4BE2B509424A,13671,7,18,11,27,43,1393
74738,74738,FB55B20B748C0A1CF26B4BE2B509424A,12341,19,20,1,26,38,1338
74739,74739,FB55B20B748C0A1CF26B4BE2B509424A,13311,21,22,1,27,39,1389
74744,74744,990F89A555478F97C2E0E123BB133187,19181,1,4,3,8,40,440
74745,74745,990F89A555478F97C2E0E123BB133187,49201,4,5,1,7,41,391
74746,74746,990F89A555478F97C2E0E123BB133187,19181,7,8,1,8,40,440
74747,74747,990F89A555478F97C2E0E123BB133187,49201,12,14,2,7,41,391
74748,74748,990F89A555478F97C2E0E123BB133187,19181,17,20,3,8,40,440
74761,74761,DF965A38DDB8FB71DC3B4D9EF4A884D3,13141,0,7,7,23,30,1180
74762,74762,DF965A38DDB8FB71DC3B4D9EF4A884D3,43121,8,10,2,25,27,1277
74763,74763,DF965A38DDB8FB71DC3B4D9EF4A884D3,15321,12,15,3,29,26,1476
74764,74764,DF965A38DDB8FB71DC3B4D9EF4A884D3,12661,16,17,1,32,45,1645
74765,74765,DF965A38DDB8FB71DC3B4D9EF4A884D3,13141,21,23,2,23,30,1180
74766,74766,8901C834A10BBD863479FEA29CB07080,13911,0,1,1,39,46,1996
74767,74767,8901C834A10BBD863479FEA29CB07080,12491,3,4,1,36,43,1843
74768,74768,8901C834A10BBD863479FEA29CB07080,13911,4,5,1,39,46,1996
74769,74769,8901C834A10BBD863479FEA29CB07080,10107,9,11,2,38,49,1949
74770,74770,8901C834A10BBD863479FEA29CB07080,13911,14,19,5,39,46,1996
74771,74771,F0C853BC0C5214D6B512154041EF8C01,11701,0,5,5,43,48,2198
74772,74772,F0C853BC0C5214D6B512154041EF8C01,10841,9,11,2,37,47,1897
74773,74773,F0C853BC0C5214D6B512154041EF8C01,12651,13,14,1,43,47,2197
74774,74774,F0C853BC0C5214D6B512154041EF8C01,11701,17,23,6,43,48,2198
74784,74784,4CA7727345FE5410FF8669E86CE37E32,19031,0,1,1,1,42,92
74785,74785,4CA7727345FE5410FF8669E86CE37E32,19181,1,2,1,8,40,440
74786,74786,4CA7727345FE5410FF8669E86CE37E32,12641,3,8,5,10,43,543
74787,74787,4CA7727345FE5410FF8669E86CE37E32,19031,11,14,3,1,42,92
74788,74788,4CA7727345FE5410FF8669E86CE37E32,12641,15,22,7,10,43,543
74793,74793,71C7D3BEB879651EE771977BC4EF34E5,10341,0,5,5,31,47,1597
74794,74794,71C7D3BEB879651EE771977BC4EF34E5,10634,9,10,1,27,45,1395
74795,74795,71C7D3BEB879651EE771977BC4EF34E5,12661,12,13,1,32,45,1645
74796,74796,71C7D3BEB879651EE771977BC4EF34E5,10351,15,18,3,28,45,1445
74797,74797,71C7D3BEB879651EE771977BC4EF34E5,10341,20,23,3,31,47,1597
74801,74801,E752BE8C76D89879B74771E0026F6236,42461,0,6,6,45,47,2297
74802,74802,E752BE8C76D89879B74771E0026F6236,42091,8,10,2,43,46,2196
74803,74803,E752BE8C76D89879B74771E0026F6236,13951,10,12,2,47,45,2395
74804,74804,E752BE8C76D89879B74771E0026F6236,10381,15,17,2,31,49,1599
74805,74805,E752BE8C76D89879B74771E0026F6236,10901,18,19,1,35,48,1798
74806,74806,E752BE8C76D89879B74771E0026F6236,42091,22,23,1,43,46,2196
74807,74807,A655C67D52402CE056E16AFA14815F89,10711,9,10,1,29,46,1496
74808,74808,A655C67D52402CE056E16AFA14815F89,11481,12,16,4,41,48,2098
74809,74809,A655C67D52402CE056E16AFA14815F89,13271,18,23,5,41,47,2097
74820,74820,ED765AC07D21387339B2A29ECDD013E0,40637,0,7,7,36,47,1847
74821,74821,ED765AC07D21387339B2A29ECDD013E0,11531,7,10,3,34,49,1749
74822,74822,ED765AC07D21387339B2A29ECDD013E0,11541,14,16,2,35,49,1799
74823,74823,ED765AC07D21387339B2A29ECDD013E0,11531,16,18,2,34,49,1749
74824,74824,ED765AC07D21387339B2A29ECDD013E0,12401,20,21,1,39,49,1999
74825,74825,4ABA99D6A62884CB0B8CB2A0246467C6,13121,0,7,7,38,46,1946
74826,74826,4ABA99D6A62884CB0B8CB2A0246467C6,11081,8,9,1,35,46,1796
74827,74827,4ABA99D6A62884CB0B8CB2A0246467C6,10911,11,13,2,39,46,1996
74828,74828,4ABA99D6A62884CB0B8CB2A0246467C6,11081,14,16,2,35,46,1796
74829,74829,4ABA99D6A62884CB0B8CB2A0246467C6,13121,19,21,2,38,46,1946
74830,74830,4ABA99D6A62884CB0B8CB2A0246467C6,42204,21,23,2,43,46,2196
74834,74834,84BFDA5775B1A36CF113618F1669E73C,42521,0,6,6,31,47,1597
74835,74835,84BFDA5775B1A36CF113618F1669E73C,11381,6,10,4,30,47,1547
74836,74836,84BFDA5775B1A36CF113618F1669E73C,42521,11,14,3,31,47,1597
74837,74837,84BFDA5775B1A36CF113618F1669E73C,13651,15,18,3,30,47,1547
74838,74838,84BFDA5775B1A36CF113618F1669E73C,42521,19,23,4,31,47,1597
74843,74843,D1348284A12247DBF7195CE953852CD8,43311,1,8,7,31,48,1598
74844,74844,D1348284A12247DBF7195CE953852CD8,11161,12,13,1,32,48,1648
74845,74845,D1348284A12247DBF7195CE953852CD8,43311,16,17,1,31,48,1598
74846,74846,D1348284A12247DBF7195CE953852CD8,11061,17,19,2,29,48,1498
74847,74847,D1348284A12247DBF7195CE953852CD8,11381,20,23,3,30,47,1547
74856,74856,A0E829F4319BFCF37BA7414AFCB09FF1,42221,4,5,1,38,48,1948
74857,74857,A0E829F4319BFCF37BA7414AFCB09FF1,41005,9,11,2,38,47,1947
74858,74858,A0E829F4319BFCF37BA7414AFCB09FF1,11074,13,15,2,37,47,1897
74859,74859,A0E829F4319BFCF37BA7414AFCB09FF1,41005,15,16,1,38,47,1947
74860,74860,A0E829F4319BFCF37BA7414AFCB09FF1,42221,17,19,2,38,48,1948
74861,74861,A0E829F4319BFCF37BA7414AFCB09FF1,11074,20,21,1,37,47,1897
74862,74862,0576900C4D0FA559C4C3ACF6E9F4048D,13841,0,9,9,40,46,2046
74863,74863,0576900C4D0FA559C4C3ACF6E9F4048D,11461,9,10,1,37,49,1899
74864,74864,0576900C4D0FA559C4C3ACF6E9F4048D,10901,11,17,6,35,48,1798
74865,74865,0576900C4D0FA559C4C3ACF6E9F4048D,12021,19,20,1,37,49,1899
74866,74866,0576900C4D0FA559C4C3ACF6E9F4048D,43341,22,23,1,41,46,2096
74867,74867,D53608326657C140C9801171477BB48D,12031,0,8,8,33,48,1698
74868,74868,D53608326657C140C9801171477BB48D,11481,12,13,1,41,48,2098
74869,74869,D53608326657C140C9801171477BB48D,13271,16,18,2,41,47,2097
74870,74870,D53608326657C140C9801171477BB48D,12031,19,20,1,33,48,1698
74871,74871,4BBC62AA839BB03DF1DA1A42D59E3988,10511,0,9,9,35,46,1796
74872,74872,4BBC62AA839BB03DF1DA1A42D59E3988,42511,19,20,1,37,47,1897
74873,74873,4BBC62AA839BB03DF1DA1A42D59E3988,43191,21,22,1,40,49,2049
74878,74878,6DFA48F81EF42083077B44FC80706865,43161,0,7,7,35,47,1797
74879,74879,6DFA48F81EF42083077B44FC80706865,10161,10,17,7,35,49,1799
74880,74880,6DFA48F81EF42083077B44FC80706865,10271,18,19,1,37,46,1896
74881,74881,6DFA48F81EF42083077B44FC80706865,43731,19,21,2,34,47,1747
74882,74882,6DFA48F81EF42083077B44FC80706865,43161,22,23,1,35,47,1797
74886,74886,775614B649ED7B2CA0ED6030686EC5AB,12521,1,13,12,35,41,1791
74887,74887,775614B649ED7B2CA0ED6030686EC5AB,43451,14,17,3,37,40,1890
74888,74888,775614B649ED7B2CA0ED6030686EC5AB,12521,18,19,1,35,41,1791
74889,74889,775614B649ED7B2CA0ED6030686EC5AB,13071,20,22,2,41,41,2091
74890,74890,D8DCFF78BA67097F4D9471927F4813FD,43751,0,5,5,19,48,998
74891,74891,D8DCFF78BA67097F4D9471927F4813FD,12581,6,19,13,24,48,1248
74892,74892,D8DCFF78BA67097F4D9471927F4813FD,43751,21,22,1,19,48,998
74893,74893,58DD29620A36856900D278AA525EEA23,16281,0,9,9,11,4,554
74894,74894,58DD29620A36856900D278AA525EEA23,15143,11,16,5,18,7,907
74895,74895,58DD29620A36856900D278AA525EEA23,16281,18,21,3,11,4,554
74896,74896,981FF39DB0050476FC5E5BA7D49F90F5,42864,0,4,4,38,44,1944
74897,74897,981FF39DB0050476FC5E5BA7D49F90F5,10811,7,8,1,38,46,1946
74898,74898,981FF39DB0050476FC5E5BA7D49F90F5,11261,8,15,7,36,46,1846
74899,74899,981FF39DB0050476FC5E5BA7D49F90F5,42864,17,18,1,38,44,1944
74900,74900,981FF39DB0050476FC5E5BA7D49F90F5,11261,18,20,2,36,46,1846
74901,74901,981FF39DB0050476FC5E5BA7D49F90F5,42864,20,23,3,38,44,1944
74908,74908,94FC77F00991540C9F5213AB48A96717,10161,0,13,13,35,49,1799
74909,74909,94FC77F00991540C9F5213AB48A96717,11381,15,19,4,30,47,1547
74910,74910,94FC77F00991540C9F5213AB48A96717,11061,19,22,3,29,48,1498
74918,74918,132DCF25B9397E4F14B57C16A20887C2,13951,0,1,1,47,45,2395
74919,74919,132DCF25B9397E4F14B57C16A20887C2,42111,4,11,7,44,46,2246
74920,74920,132DCF25B9397E4F14B57C16A20887C2,11171,12,13,1,33,48,1698
74921,74921,132DCF25B9397E4F14B57C16A20887C2,42111,15,17,2,44,46,2246
74922,74922,132DCF25B9397E4F14B57C16A20887C2,11801,20,22,2,42,48,2148
74927,74927,AD3E6481838BF400FA98C1C2BDCD8C19,42681,0,1,1,24,48,1248
74928,74928,AD3E6481838BF400FA98C1C2BDCD8C19,11641,2,3,1,22,49,1149
74929,74929,AD3E6481838BF400FA98C1C2BDCD8C19,42681,5,7,2,24,48,1248
74930,74930,AD3E6481838BF400FA98C1C2BDCD8C19,10431,12,15,3,33,49,1699
74931,74931,AD3E6481838BF400FA98C1C2BDCD8C19,10451,18,21,3,25,48,1298
74932,74932,AD3E6481838BF400FA98C1C2BDCD8C19,11641,22,23,1,22,49,1149
74933,74933,C187943D20D187183526E0228C45660E,11021,0,7,7,36,49,1849
74934,74934,C187943D20D187183526E0228C45660E,10107,12,14,2,38,49,1949
74935,74935,C187943D20D187183526E0228C45660E,40034,18,20,2,32,48,1648
74936,74936,C187943D20D187183526E0228C45660E,11021,21,23,2,36,49,1849
74937,74937,CD62F8FE0C3390F5DF44E21F5F57FF3E,12121,0,14,14,29,47,1497
74938,74938,CD62F8FE0C3390F5DF44E21F5F57FF3E,10951,16,17,1,29,48,1498
74939,74939,CD62F8FE0C3390F5DF44E21F5F57FF3E,10971,18,20,2,35,47,1797
74940,74940,CD62F8FE0C3390F5DF44E21F5F57FF3E,12121,22,23,1,29,47,1497
74944,74944,F4A5CE128B0276BA64A57CF9F5D60F74,42831,0,14,14,27,48,1398
74945,74945,F4A5CE128B0276BA64A57CF9F5D60F74,11331,17,18,1,37,48,1898
74946,74946,F4A5CE128B0276BA64A57CF9F5D60F74,11074,19,21,2,37,47,1897
74947,74947,F4A5CE128B0276BA64A57CF9F5D60F74,42831,22,23,1,27,48,1398
74954,74954,26DECA4A496D5594EA57F7546CECA764,13351,1,2,1,48,48,2448
74955,74955,26DECA4A496D5594EA57F7546CECA764,42601,3,4,1,44,48,2248
74956,74956,26DECA4A496D5594EA57F7546CECA764,13351,5,6,1,48,48,2448
74957,74957,26DECA4A496D5594EA57F7546CECA764,11701,16,21,5,43,48,2198
74958,74958,26DECA4A496D5594EA57F7546CECA764,11021,21,23,2,36,49,1849
74959,74959,D8EFA03C1EE0BE85B535592D1F876B5A,43751,0,7,7,19,48,998
74960,74960,D8EFA03C1EE0BE85B535592D1F876B5A,40697,8,19,11,43,48,2198
74961,74961,D8EFA03C1EE0BE85B535592D1F876B5A,43751,20,23,3,19,48,998
74962,74962,F681B79833B44C7DE260E9A55ED030A3,19741,0,7,7,5,44,294
74963,74963,F681B79833B44C7DE260E9A55ED030A3,12641,10,11,1,10,43,543
74964,74964,F681B79833B44C7DE260E9A55ED030A3,19741,12,23,11,5,44,294
74965,74965,50AD8ACDABF8BBC007C0D64420D91B51,11861,0,8,8,32,47,1647
74966,74966,50AD8ACDABF8BBC007C0D64420D91B51,12381,8,11,3,32,48,1648
74967,74967,50AD8ACDABF8BBC007C0D64420D91B51,11861,12,14,2,32,47,1647
74968,74968,50AD8ACDABF8BBC007C0D64420D91B51,12381,14,18,4,32,48,1648
74969,74969,50AD8ACDABF8BBC007C0D64420D91B51,11861,18,23,5,32,47,1647
74970,74970,3F2FE95AB24E5E71D935604E5158C97B,10924,2,8,6,43,49,2199
74971,74971,3F2FE95AB24E5E71D935604E5158C97B,41392,12,15,3,43,48,2198
74972,74972,3F2FE95AB24E5E71D935604E5158C97B,11481,15,16,1,41,48,2098
74973,74973,3F2FE95AB24E5E71D935604E5158C97B,11901,17,18,1,42,49,2149
74974,74974,3F2FE95AB24E5E71D935604E5158C97B,11301,19,20,1,41,49,2099
74975,74975,3F2FE95AB24E5E71D935604E5158C97B,10924,20,22,2,43,49,2199
74983,74983,BA285F01E6926591864F1F3184565800,42581,0,2,2,38,48,1948
74984,74984,BA285F01E6926591864F1F3184565800,11914,5,7,2,37,48,1898
74985,74985,BA285F01E6926591864F1F3184565800,42581,11,12,1,38,48,1948
74986,74986,BA285F01E6926591864F1F3184565800,10107,15,16,1,38,49,1949
74987,74987,BA285F01E6926591864F1F3184565800,42221,20,21,1,38,48,1948
74991,74991,9D5FAD2D946916458AB09D98B7F6CB85,13601,0,5,5,34,47,1747
74992,74992,9D5FAD2D946916458AB09D98B7F6CB85,11641,6,16,10,22,49,1149
74993,74993,9D5FAD2D946916458AB09D98B7F6CB85,40341,17,19,2,23,49,1199
74997,74997,537D82A817A1381A8BFD833A3BEC4C9C,12491,0,1,1,36,43,1843
74998,74998,537D82A817A1381A8BFD833A3BEC4C9C,12211,2,4,2,41,44,2094
74999,74999,537D82A817A1381A8BFD833A3BEC4C9C,12491,5,6,1,36,43,1843
75000,75000,537D82A817A1381A8BFD833A3BEC4C9C,11261,9,10,1,36,46,1846
75001,75001,537D82A817A1381A8BFD833A3BEC4C9C,13911,13,15,2,39,46,1996
75002,75002,537D82A817A1381A8BFD833A3BEC4C9C,11261,15,22,7,36,46,1846
75003,75003,E51EE41655D386174398555E16D6604B,12381,0,9,9,32,48,1648
75004,75004,E51EE41655D386174398555E16D6604B,12131,10,12,2,32,47,1647
75005,75005,E51EE41655D386174398555E16D6604B,12381,12,14,2,32,48,1648
75006,75006,E51EE41655D386174398555E16D6604B,10661,18,19,1,37,49,1899
75007,75007,E51EE41655D386174398555E16D6604B,40637,21,22,1,36,47,1847
75014,75014,8B809398ACCC273974413530038384A4,42201,0,8,8,43,46,2196
75015,75015,8B809398ACCC273974413530038384A4,10411,14,16,2,36,48,1848
75016,75016,8B809398ACCC273974413530038384A4,10111,17,20,3,37,47,1897
75017,75017,8B809398ACCC273974413530038384A4,10811,20,21,1,38,46,1946
75018,75018,8B809398ACCC273974413530038384A4,42201,22,23,1,43,46,2196
75019,75019,7861278735CDA91B9BABB196FBF7605C,13411,4,5,1,49,42,2492
75020,75020,7861278735CDA91B9BABB196FBF7605C,13951,12,15,3,47,45,2395
75021,75021,7861278735CDA91B9BABB196FBF7605C,43951,18,22,4,49,41,2491
75026,75026,99215A6EE9EE45501EC0F8414BE04C65,11571,0,5,5,13,46,696
75027,75027,99215A6EE9EE45501EC0F8414BE04C65,19441,6,15,9,8,46,446
75028,75028,99215A6EE9EE45501EC0F8414BE04C65,42041,16,17,1,10,47,547
75029,75029,99215A6EE9EE45501EC0F8414BE04C65,19441,19,21,2,8,46,446
75030,75030,E969EC1FA6E19F3F5A602F2FE47F2E7D,13231,3,10,7,39,46,1996
75031,75031,E969EC1FA6E19F3F5A602F2FE47F2E7D,11381,13,14,1,30,47,1547
75032,75032,E969EC1FA6E19F3F5A602F2FE47F2E7D,11261,19,23,4,36,46,1846
75036,75036,50B8E4460C6E38DE46F5A7F7239C0140,43751,0,5,5,19,48,998
75037,75037,50B8E4460C6E38DE46F5A7F7239C0140,42691,8,9,1,24,48,1248
75038,75038,50B8E4460C6E38DE46F5A7F7239C0140,43751,12,19,7,19,48,998
75039,75039,15AF53FBA0C13FBD61024895398ED2FD,19441,0,5,5,8,46,446
75040,75040,15AF53FBA0C13FBD61024895398ED2FD,42041,10,12,2,10,47,547
75041,75041,15AF53FBA0C13FBD61024895398ED2FD,11471,13,16,3,12,48,648
75042,75042,15AF53FBA0C13FBD61024895398ED2FD,19441,19,22,3,8,46,446
75046,75046,F6947486712885EDC02BCA122A5A6DB5,15061,0,5,5,41,25,2075
75047,75047,F6947486712885EDC02BCA122A5A6DB5,12881,5,9,4,47,22,2372
75048,75048,F6947486712885EDC02BCA122A5A6DB5,15061,12,23,11,41,25,2075
75059,75059,43857F135F7541B4685E34097E43A46E,19021,1,6,5,10,45,545
75060,75060,43857F135F7541B4685E34097E43A46E,12921,10,17,7,9,41,491
75061,75061,43857F135F7541B4685E34097E43A46E,43021,22,23,1,16,43,843
75065,75065,9B16C8FF79CD32EF97A08ADCC08A0C98,19031,4,5,1,1,42,92
75066,75066,9B16C8FF79CD32EF97A08ADCC08A0C98,12641,6,11,5,10,43,543
75067,75067,9B16C8FF79CD32EF97A08ADCC08A0C98,12921,13,16,3,9,41,491
75068,75068,9B16C8FF79CD32EF97A08ADCC08A0C98,12641,16,18,2,10,43,543
75069,75069,9B16C8FF79CD32EF97A08ADCC08A0C98,12921,18,20,2,9,41,491
75070,75070,9B16C8FF79CD32EF97A08ADCC08A0C98,12641,21,23,2,10,43,543
75071,75071,AA9DDBAE747C0C61A76E689DD898E315,42301,0,6,6,36,47,1847
75072,75072,AA9DDBAE747C0C61A76E689DD898E315,12311,7,17,10,30,44,1544
75073,75073,AA9DDBAE747C0C61A76E689DD898E315,42301,18,23,5,36,47,1847
75074,75074,8671664FCEA72D44791A077CF27C82B3,12641,1,4,3,10,43,543
75075,75075,8671664FCEA72D44791A077CF27C82B3,43021,6,8,2,16,43,843
75076,75076,8671664FCEA72D44791A077CF27C82B3,12641,8,17,9,10,43,543
75077,75077,8671664FCEA72D44791A077CF27C82B3,12921,17,19,2,9,41,491
75081,75081,226AFD4773355BB338E7A89DC25C5FDB,19441,1,7,6,8,46,446
75082,75082,226AFD4773355BB338E7A89DC25C5FDB,42041,9,10,1,10,47,547
75083,75083,226AFD4773355BB338E7A89DC25C5FDB,19441,11,18,7,8,46,446
75084,75084,226AFD4773355BB338E7A89DC25C5FDB,19024,19,20,1,9,45,495
75085,75085,226AFD4773355BB338E7A89DC25C5FDB,19441,21,22,1,8,46,446
75089,75089,8772B4FEA43B5FFE21AC466A21FA5EF1,10351,0,6,6,28,45,1445
75090,75090,8772B4FEA43B5FFE21AC466A21FA5EF1,42531,7,14,7,31,45,1595
75091,75091,8772B4FEA43B5FFE21AC466A21FA5EF1,12311,16,18,2,30,44,1544
75092,75092,8772B4FEA43B5FFE21AC466A21FA5EF1,12661,20,21,1,32,45,1645
75093,75093,8772B4FEA43B5FFE21AC466A21FA5EF1,10351,22,23,1,28,45,1445
75094,75094,AE10E091EA2027CDBE5CBFBC2238F486,19244,0,3,3,1,43,93
75095,75095,AE10E091EA2027CDBE5CBFBC2238F486,12921,6,15,9,9,41,491
75096,75096,AE10E091EA2027CDBE5CBFBC2238F486,19114,20,23,3,7,43,393
75097,75097,A6555ADD1FDD22671BB225447AB03AF9,19744,1,4,3,6,43,343
75098,75098,A6555ADD1FDD22671BB225447AB03AF9,12641,6,9,3,10,43,543
75099,75099,A6555ADD1FDD22671BB225447AB03AF9,19744,11,12,1,6,43,343
75100,75100,A6555ADD1FDD22671BB225447AB03AF9,12641,14,15,1,10,43,543
75101,75101,A6555ADD1FDD22671BB225447AB03AF9,19744,17,19,2,6,43,343
75102,75102,A6555ADD1FDD22671BB225447AB03AF9,12641,21,22,1,10,43,543
75103,75103,CCE6FF71F1C58ADC8D7C29AFD1955DDD,12601,0,8,8,25,47,1297
75104,75104,CCE6FF71F1C58ADC8D7C29AFD1955DDD,10634,8,15,7,27,45,1395
75105,75105,CCE6FF71F1C58ADC8D7C29AFD1955DDD,10351,15,16,1,28,45,1445
75106,75106,CCE6FF71F1C58ADC8D7C29AFD1955DDD,12601,19,22,3,25,47,1297
75107,75107,400659CE2E6F8BFF6D95D6F52F73DF5B,42921,0,5,5,33,47,1697
75108,75108,400659CE2E6F8BFF6D95D6F52F73DF5B,11861,6,11,5,32,47,1647
75109,75109,400659CE2E6F8BFF6D95D6F52F73DF5B,42921,12,13,1,33,47,1697
75110,75110,400659CE2E6F8BFF6D95D6F52F73DF5B,11861,14,19,5,32,47,1647
75111,75111,400659CE2E6F8BFF6D95D6F52F73DF5B,42921,19,23,4,33,47,1697
75112,75112,DF6451E86EE4B7B98BCA60FC558F51EE,11151,0,7,7,30,48,1548
75113,75113,DF6451E86EE4B7B98BCA60FC558F51EE,11061,10,11,1,29,48,1498
75114,75114,DF6451E86EE4B7B98BCA60FC558F51EE,12121,12,14,2,29,47,1497
75115,75115,DF6451E86EE4B7B98BCA60FC558F51EE,10951,14,16,2,29,48,1498
75116,75116,DF6451E86EE4B7B98BCA60FC558F51EE,11151,17,21,4,30,48,1548
75132,75132,2E18E8DF093288689E2805A1F3FB2A40,12921,0,4,4,9,41,491
75133,75133,2E18E8DF093288689E2805A1F3FB2A40,12641,6,7,1,10,43,543
75134,75134,2E18E8DF093288689E2805A1F3FB2A40,12921,10,12,2,9,41,491
75135,75135,2E18E8DF093288689E2805A1F3FB2A40,12641,15,17,2,10,43,543
75136,75136,2E18E8DF093288689E2805A1F3FB2A40,12921,21,22,1,9,41,491
75137,75137,BB319F0C56CCFD402B9E23834D6F064C,11151,0,2,2,30,48,1548
75138,75138,BB319F0C56CCFD402B9E23834D6F064C,42623,17,18,1,22,49,1149
75139,75139,BB319F0C56CCFD402B9E23834D6F064C,11151,20,21,1,30,48,1548
75140,75140,983EA22EAF93FBE9F0372A832926CF52,10801,0,6,6,42,47,2147
75141,75141,983EA22EAF93FBE9F0372A832926CF52,11061,7,9,2,29,48,1498
75142,75142,983EA22EAF93FBE9F0372A832926CF52,11381,10,20,10,30,47,1547
75143,75143,983EA22EAF93FBE9F0372A832926CF52,10951,21,23,2,29,48,1498
75144,75144,8C020980563395E613630C621BFF673F,42151,1,4,3,35,45,1795
75145,75145,8C020980563395E613630C621BFF673F,11261,5,7,2,36,46,1846
75146,75146,8C020980563395E613630C621BFF673F,42861,8,9,1,37,44,1894
75147,75147,8C020980563395E613630C621BFF673F,42151,15,16,1,35,45,1795
75148,75148,8C020980563395E613630C621BFF673F,11261,21,23,2,36,46,1846
75159,75159,6E048AFDA448F88ECF5A7F8BD92DF758,13481,0,10,10,26,31,1331
75160,75160,6E048AFDA448F88ECF5A7F8BD92DF758,40463,14,15,1,38,49,1949
75161,75161,6E048AFDA448F88ECF5A7F8BD92DF758,40341,16,20,4,23,49,1199
75162,75162,17B310C5C0CD98D91D2EAE008E1E6775,42491,0,13,13,32,46,1646
75163,75163,17B310C5C0CD98D91D2EAE008E1E6775,11751,14,15,1,35,48,1798
75164,75164,17B310C5C0CD98D91D2EAE008E1E6775,42491,16,19,3,32,46,1646
75165,75165,17B310C5C0CD98D91D2EAE008E1E6775,11201,20,23,3,35,49,1799
75172,75172,69E543DFF7ABD4903EB302CAAC6962DA,11921,0,7,7,38,48,1948
75173,75173,69E543DFF7ABD4903EB302CAAC6962DA,11591,10,12,2,36,49,1849
75174,75174,69E543DFF7ABD4903EB302CAAC6962DA,42471,12,13,1,35,49,1799
75175,75175,69E543DFF7ABD4903EB302CAAC6962DA,11591,14,17,3,36,49,1849
75176,75176,69E543DFF7ABD4903EB302CAAC6962DA,42471,17,18,1,35,49,1799
75189,75189,CEA501FA7BDE5D84B551C94F16C00DA1,11021,0,7,7,36,49,1849
75190,75190,CEA501FA7BDE5D84B551C94F16C00DA1,13791,8,12,4,42,47,2147
75191,75191,CEA501FA7BDE5D84B551C94F16C00DA1,13561,18,22,4,37,49,1899
75203,75203,0FFA2B76C33E86D096275A1457C5D54A,10411,0,7,7,36,48,1848
75204,75204,0FFA2B76C33E86D096275A1457C5D54A,42151,7,9,2,35,45,1795
75205,75205,0FFA2B76C33E86D096275A1457C5D54A,10841,10,13,3,37,47,1897
75206,75206,0FFA2B76C33E86D096275A1457C5D54A,10531,16,17,1,34,46,1746
75207,75207,0FFA2B76C33E86D096275A1457C5D54A,10411,18,23,5,36,48,1848
75208,75208,27F132E818644D3933B7D51A13F3BE57,15561,4,5,1,32,22,1622
75209,75209,27F132E818644D3933B7D51A13F3BE57,15411,6,8,2,44,27,2227
75210,75210,27F132E818644D3933B7D51A13F3BE57,13361,12,13,1,42,31,2131
75211,75211,27F132E818644D3933B7D51A13F3BE57,15411,13,21,8,44,27,2227
75212,75212,5883690A11B4E8D3FF47397C6C50CA14,11551,0,7,7,39,49,1999
75213,75213,5883690A11B4E8D3FF47397C6C50CA14,40691,8,10,2,42,48,2148
75214,75214,5883690A11B4E8D3FF47397C6C50CA14,11701,11,13,2,43,48,2198
75215,75215,5883690A11B4E8D3FF47397C6C50CA14,40341,16,20,4,23,49,1199
75216,75216,5883690A11B4E8D3FF47397C6C50CA14,11151,20,21,1,30,48,1548
75217,75217,504467700DDD1C036193CD82D6D3619F,42521,0,7,7,31,47,1597
75218,75218,504467700DDD1C036193CD82D6D3619F,43761,10,11,1,32,47,1647
75219,75219,504467700DDD1C036193CD82D6D3619F,42521,12,14,2,31,47,1597
75220,75220,504467700DDD1C036193CD82D6D3619F,13671,15,18,3,27,43,1393
75221,75221,E35E4C8F6DC94562A0B0155EFE748DD3,11131,0,6,6,33,48,1698
75222,75222,E35E4C8F6DC94562A0B0155EFE748DD3,11231,7,11,4,37,49,1899
75223,75223,E35E4C8F6DC94562A0B0155EFE748DD3,11261,13,14,1,36,46,1846
75224,75224,E35E4C8F6DC94562A0B0155EFE748DD3,11941,14,16,2,37,46,1896
75225,75225,E35E4C8F6DC94562A0B0155EFE748DD3,11461,20,21,1,37,49,1899
75226,75226,C77C8812EE3DBDBAFF1246F561D23EE6,19031,0,4,4,1,42,92
75227,75227,C77C8812EE3DBDBAFF1246F561D23EE6,12921,6,7,1,9,41,491
75228,75228,C77C8812EE3DBDBAFF1246F561D23EE6,19031,9,10,1,1,42,92
75229,75229,C77C8812EE3DBDBAFF1246F561D23EE6,12641,10,12,2,10,43,543
75230,75230,C77C8812EE3DBDBAFF1246F561D23EE6,19031,14,21,7,1,42,92
75237,75237,BDBB21AEE3790F9ACB8B206867A4B001,13314,0,4,4,31,39,1589
75238,75238,BDBB21AEE3790F9ACB8B206867A4B001,12521,4,11,7,35,41,1791
75239,75239,BDBB21AEE3790F9ACB8B206867A4B001,13314,13,18,5,31,39,1589
75240,75240,BDBB21AEE3790F9ACB8B206867A4B001,12521,18,22,4,35,41,1791
75248,75248,2BB131B28919DD39B3A1FF3FB84AF680,40891,0,13,13,37,47,1897
75249,75249,2BB131B28919DD39B3A1FF3FB84AF680,10681,14,16,2,30,48,1548
75250,75250,2BB131B28919DD39B3A1FF3FB84AF680,10841,20,23,3,37,47,1897
75255,75255,16D740AE27D92BE968DE244652195181,13671,0,2,2,27,43,1393
75256,75256,16D740AE27D92BE968DE244652195181,12731,2,5,3,22,40,1140
75257,75257,16D740AE27D92BE968DE244652195181,13671,9,12,3,27,43,1393
75258,75258,16D740AE27D92BE968DE244652195181,12761,13,14,1,25,40,1290
75259,75259,16D740AE27D92BE968DE244652195181,13671,15,18,3,27,43,1393
75260,75260,16D740AE27D92BE968DE244652195181,12761,19,20,1,25,40,1290
75261,75261,16D740AE27D92BE968DE244652195181,13671,21,23,2,27,43,1393
75266,75266,D95A28764726FBD023AFF95817B54BCD,12874,0,5,5,20,34,1034
75267,75267,D95A28764726FBD023AFF95817B54BCD,19281,6,7,1,16,32,832
75268,75268,D95A28764726FBD023AFF95817B54BCD,19811,8,9,1,10,34,534
75269,75269,D95A28764726FBD023AFF95817B54BCD,19281,12,14,2,16,32,832
75270,75270,D95A28764726FBD023AFF95817B54BCD,19531,17,18,1,17,30,880
75271,75271,14623A512CD5F9FC89FE6B8EBDABADFA,42381,0,7,7,39,41,1991
75272,75272,14623A512CD5F9FC89FE6B8EBDABADFA,42501,9,12,3,28,47,1447
75273,75273,14623A512CD5F9FC89FE6B8EBDABADFA,42381,15,19,4,39,41,1991
75274,75274,14623A512CD5F9FC89FE6B8EBDABADFA,13121,19,22,3,38,46,1946
75285,75285,B3D330CB8F1681F4BBCB951D5F414D22,42021,2,6,4,33,47,1697
75286,75286,B3D330CB8F1681F4BBCB951D5F414D22,10111,7,10,3,37,47,1897
75287,75287,B3D330CB8F1681F4BBCB951D5F414D22,10411,12,14,2,36,48,1848
75288,75288,B3D330CB8F1681F4BBCB951D5F414D22,10111,14,18,4,37,47,1897
75289,75289,B3D330CB8F1681F4BBCB951D5F414D22,10411,19,20,1,36,48,1848
75294,75294,79ECDBFD9F8DB955B9E7401C30EDA30D,40401,0,8,8,40,46,2046
75295,75295,79ECDBFD9F8DB955B9E7401C30EDA30D,11074,8,9,1,37,47,1897
75296,75296,79ECDBFD9F8DB955B9E7401C30EDA30D,40302,14,15,1,40,49,2049
75297,75297,79ECDBFD9F8DB955B9E7401C30EDA30D,11074,16,19,3,37,47,1897
75298,75298,79ECDBFD9F8DB955B9E7401C30EDA30D,11631,21,22,1,12,49,649
75303,75303,024AB2D90319DF57F94996854D076E3D,13271,0,7,7,41,47,2097
75304,75304,024AB2D90319DF57F94996854D076E3D,11531,8,12,4,34,49,1749
75305,75305,024AB2D90319DF57F94996854D076E3D,11541,15,20,5,35,49,1799
75306,75306,024AB2D90319DF57F94996854D076E3D,13271,20,23,3,41,47,2097
75314,75314,EC4330687AFAD23F392FAEF4FB4107B7,10781,0,18,18,35,47,1797
75315,75315,EC4330687AFAD23F392FAEF4FB4107B7,11151,18,19,1,30,48,1548
75316,75316,EC4330687AFAD23F392FAEF4FB4107B7,40431,21,23,2,36,47,1847
75317,75317,42450E4607B078BD3F39C67BF93F8737,11111,0,8,8,26,48,1348
75318,75318,42450E4607B078BD3F39C67BF93F8737,10451,9,19,10,25,48,1298
75319,75319,42450E4607B078BD3F39C67BF93F8737,10661,21,23,2,37,49,1899
75326,75326,72C5552B5CC502F78E4F3CBA69FD162F,19441,10,12,2,8,46,446
75327,75327,72C5552B5CC502F78E4F3CBA69FD162F,11541,13,15,2,35,49,1799
75328,75328,72C5552B5CC502F78E4F3CBA69FD162F,10841,18,21,3,37,47,1897
75329,75329,C179CB04DCCFC26C27C5F20AF0844F96,19441,0,2,2,8,46,446
75330,75330,C179CB04DCCFC26C27C5F20AF0844F96,11571,2,5,3,13,46,696
75331,75331,C179CB04DCCFC26C27C5F20AF0844F96,19441,6,7,1,8,46,446
75332,75332,C179CB04DCCFC26C27C5F20AF0844F96,19621,10,13,3,5,46,296
75333,75333,C179CB04DCCFC26C27C5F20AF0844F96,19441,17,19,2,8,46,446
75334,75334,4D8845F56E5D019BAEC5CD8646817913,11951,0,14,14,31,49,1599
75335,75335,4D8845F56E5D019BAEC5CD8646817913,12514,15,17,2,38,47,1947
75336,75336,4D8845F56E5D019BAEC5CD8646817913,10471,18,20,2,37,48,1898
75337,75337,4D8845F56E5D019BAEC5CD8646817913,11951,21,23,2,31,49,1599
75341,75341,C3FB4EE105B7861A50BF03BC1584CA1D,13111,0,7,7,42,46,2146
75342,75342,C3FB4EE105B7861A50BF03BC1584CA1D,42201,7,11,4,43,46,2196
75343,75343,C3FB4EE105B7861A50BF03BC1584CA1D,13111,11,13,2,42,46,2146
75344,75344,C3FB4EE105B7861A50BF03BC1584CA1D,42201,14,16,2,43,46,2196
75345,75345,C3FB4EE105B7861A50BF03BC1584CA1D,13111,18,23,5,42,46,2146
75349,75349,7179E8D23C9EF0FE56A034B0F52DF3EB,42623,2,3,1,22,49,1149
75350,75350,7179E8D23C9EF0FE56A034B0F52DF3EB,42071,4,8,4,31,49,1599
75351,75351,7179E8D23C9EF0FE56A034B0F52DF3EB,42623,9,21,12,22,49,1149
75352,75352,66A1757BF5A4116BA4BCC483D90F56EF,42351,0,8,8,38,45,1945
75353,75353,66A1757BF5A4116BA4BCC483D90F56EF,42231,10,12,2,37,46,1896
75354,75354,66A1757BF5A4116BA4BCC483D90F56EF,11074,15,17,2,37,47,1897
75355,75355,66A1757BF5A4116BA4BCC483D90F56EF,42231,17,20,3,37,46,1896
75356,75356,66A1757BF5A4116BA4BCC483D90F56EF,13911,21,23,2,39,46,1996
75357,75357,00ED2280FB2BEC22D8FB36F8A7AFB1A5,42151,0,8,8,35,45,1795
75358,75358,00ED2280FB2BEC22D8FB36F8A7AFB1A5,10271,9,11,2,37,46,1896
75359,75359,00ED2280FB2BEC22D8FB36F8A7AFB1A5,13121,11,13,2,38,46,1946
75360,75360,00ED2280FB2BEC22D8FB36F8A7AFB1A5,10271,14,16,2,37,46,1896
75361,75361,00ED2280FB2BEC22D8FB36F8A7AFB1A5,13121,16,18,2,38,46,1946
75362,75362,11199AC9322CB1D62821B7265EEE1673,11914,0,5,5,37,48,1898
75363,75363,11199AC9322CB1D62821B7265EEE1673,13731,17,19,2,33,49,1699
75364,75364,11199AC9322CB1D62821B7265EEE1673,42161,19,23,4,36,47,1847
75365,75365,76B5A35D98B8893850740B68B6528B2B,10801,0,1,1,42,47,2147
75366,75366,76B5A35D98B8893850740B68B6528B2B,42321,2,4,2,43,47,2197
75367,75367,76B5A35D98B8893850740B68B6528B2B,13671,7,17,10,27,43,1393
75368,75368,76B5A35D98B8893850740B68B6528B2B,42321,20,22,2,43,47,2197
75372,75372,46FBB102C6B8DD3727737A749B2D8106,42921,0,6,6,33,47,1697
75373,75373,46FBB102C6B8DD3727737A749B2D8106,10151,9,11,2,34,47,1747
75374,75374,46FBB102C6B8DD3727737A749B2D8106,42371,11,13,2,34,46,1746
75375,75375,46FBB102C6B8DD3727737A749B2D8106,10151,15,16,1,34,47,1747
75376,75376,46FBB102C6B8DD3727737A749B2D8106,42371,17,22,5,34,46,1746
75380,75380,B6B689E20BBAED2670EB9BE2B4C9BDC7,43061,4,5,1,43,46,2196
75381,75381,B6B689E20BBAED2670EB9BE2B4C9BDC7,13791,5,6,1,42,47,2147
75382,75382,B6B689E20BBAED2670EB9BE2B4C9BDC7,11481,10,12,2,41,48,2098
75383,75383,B6B689E20BBAED2670EB9BE2B4C9BDC7,13371,16,20,4,41,47,2097
75384,75384,B6B689E20BBAED2670EB9BE2B4C9BDC7,42321,21,23,2,43,47,2197
75397,75397,E61CE1847A71020A0ADF20081F3113FE,11231,0,18,18,37,49,1899
75398,75398,E61CE1847A71020A0ADF20081F3113FE,12131,20,21,1,32,47,1647
75399,75399,E61CE1847A71020A0ADF20081F3113FE,11231,22,23,1,37,49,1899
75403,75403,D7349708A10855AEF98FEB8D22C33E59,13271,0,7,7,41,47,2097
75404,75404,D7349708A10855AEF98FEB8D22C33E59,11231,9,16,7,37,49,1899
75405,75405,D7349708A10855AEF98FEB8D22C33E59,40833,20,23,3,41,47,2097
75417,75417,9D7E28E179E5F5D009F8D277D0F434A8,11861,0,10,10,32,47,1647
75418,75418,9D7E28E179E5F5D009F8D277D0F434A8,10281,11,13,2,33,48,1698
75419,75419,9D7E28E179E5F5D009F8D277D0F434A8,11861,14,16,2,32,47,1647
75420,75420,9D7E28E179E5F5D009F8D277D0F434A8,10281,17,20,3,33,48,1698
75421,75421,9D7E28E179E5F5D009F8D277D0F434A8,11861,20,23,3,32,47,1647
75422,75422,9561ABDECCD36C7236B43D7186F9954F,10191,0,1,1,40,48,2048
75423,75423,9561ABDECCD36C7236B43D7186F9954F,10681,4,7,3,30,48,1548
75424,75424,9561ABDECCD36C7236B43D7186F9954F,11061,10,11,1,29,48,1498
75425,75425,9561ABDECCD36C7236B43D7186F9954F,10681,12,22,10,30,48,1548
75432,75432,372AC5E17DC933B5F7F7F7004AF199EF,11381,0,19,19,30,47,1547
75433,75433,372AC5E17DC933B5F7F7F7004AF199EF,40341,19,21,2,23,49,1199
75434,75434,372AC5E17DC933B5F7F7F7004AF199EF,11381,21,23,2,30,47,1547
75459,75459,FB55907415A7C0538398712A9BE0B78E,12661,3,4,1,32,45,1645
75460,75460,FB55907415A7C0538398712A9BE0B78E,42371,5,7,2,34,46,1746
75461,75461,FB55907415A7C0538398712A9BE0B78E,42151,8,11,3,35,45,1795
75462,75462,FB55907415A7C0538398712A9BE0B78E,12661,12,17,5,32,45,1645
75463,75463,FB55907415A7C0538398712A9BE0B78E,40073,19,21,2,37,48,1898
75464,75464,BF5EFB3BDBF5437ACD467C87E9038A8B,43021,3,13,10,16,43,843
75465,75465,BF5EFB3BDBF5437ACD467C87E9038A8B,12921,17,18,1,9,41,491
75466,75466,BF5EFB3BDBF5437ACD467C87E9038A8B,43021,18,19,1,16,43,843
75470,75470,B28C2EF2DEAFF4BC7D4CB76BDAE2C77D,43471,0,8,8,31,49,1599
75471,75471,B28C2EF2DEAFF4BC7D4CB76BDAE2C77D,43581,9,10,1,33,48,1698
75472,75472,B28C2EF2DEAFF4BC7D4CB76BDAE2C77D,10841,11,12,1,37,47,1897
75473,75473,B28C2EF2DEAFF4BC7D4CB76BDAE2C77D,10401,12,15,3,33,49,1699
75474,75474,B28C2EF2DEAFF4BC7D4CB76BDAE2C77D,43581,19,21,2,33,48,1698
75475,75475,B28C2EF2DEAFF4BC7D4CB76BDAE2C77D,40051,21,23,2,32,49,1649
75482,75482,1C0548F40841AD0870DAD8EC7BECCBC6,13314,0,6,6,31,39,1589
75483,75483,1C0548F40841AD0870DAD8EC7BECCBC6,12521,7,10,3,35,41,1791
75484,75484,1C0548F40841AD0870DAD8EC7BECCBC6,13314,14,16,2,31,39,1589
75485,75485,1C0548F40841AD0870DAD8EC7BECCBC6,12521,17,18,1,35,41,1791
75486,75486,1C0548F40841AD0870DAD8EC7BECCBC6,13314,20,23,3,31,39,1589
75490,75490,4C479F308A99C28A9312A97B8F351EC7,16421,0,16,16,8,2,402
75491,75491,4C479F308A99C28A9312A97B8F351EC7,16071,17,20,3,3,3,153
75492,75492,4C479F308A99C28A9312A97B8F351EC7,16421,20,23,3,8,2,402
75493,75493,E648A6F090A3BE85617E0ED54A73B4F0,12671,0,5,5,21,43,1093
75494,75494,E648A6F090A3BE85617E0ED54A73B4F0,12601,8,20,12,25,47,1297
75495,75495,E648A6F090A3BE85617E0ED54A73B4F0,13771,21,22,1,21,45,1095
75496,75496,4D0ED6C01EC55D2BA8CCC5E44CD25B70,11941,2,5,3,37,46,1896
75497,75497,4D0ED6C01EC55D2BA8CCC5E44CD25B70,12381,7,19,12,32,48,1648
75498,75498,4D0ED6C01EC55D2BA8CCC5E44CD25B70,11941,21,22,1,37,46,1896
75499,75499,3C07D1557002BF4F1AA6A6D7A8949EF2,42523,0,5,5,31,47,1597
75500,75500,3C07D1557002BF4F1AA6A6D7A8949EF2,12601,8,16,8,25,47,1297
75501,75501,3C07D1557002BF4F1AA6A6D7A8949EF2,42523,18,22,4,31,47,1597
75502,75502,0F155161AC9A08ADA75BAA1BD7450976,43751,0,6,6,19,48,998
75503,75503,0F155161AC9A08ADA75BAA1BD7450976,42081,6,15,9,24,49,1249
75504,75504,0F155161AC9A08ADA75BAA1BD7450976,43751,19,23,4,19,48,998
75509,75509,1089C0BE5216A591F3582EF7A99E7609,13711,3,4,1,38,46,1946
75510,75510,1089C0BE5216A591F3582EF7A99E7609,11831,8,12,4,32,45,1645
75511,75511,1089C0BE5216A591F3582EF7A99E7609,42151,13,14,1,35,45,1795
75512,75512,1089C0BE5216A591F3582EF7A99E7609,10271,17,19,2,37,46,1896
75513,75513,1089C0BE5216A591F3582EF7A99E7609,43161,22,23,1,35,47,1797
75514,75514,99A24879ECB2B435F68696FC7F63DBB9,11171,10,14,4,33,48,1698
75515,75515,99A24879ECB2B435F68696FC7F63DBB9,10711,15,19,4,29,46,1496
75516,75516,99A24879ECB2B435F68696FC7F63DBB9,42221,20,21,1,38,48,1948
75517,75517,3AB35E62E3464B5074E82DE69E9DD0D9,42501,0,1,1,28,47,1447
75518,75518,3AB35E62E3464B5074E82DE69E9DD0D9,42541,2,6,4,25,47,1297
75519,75519,3AB35E62E3464B5074E82DE69E9DD0D9,19441,8,14,6,8,46,446
75520,75520,3AB35E62E3464B5074E82DE69E9DD0D9,42501,19,23,4,28,47,1447
75531,75531,9442AAEA05C831A2075E8352FC15EF6E,43361,0,8,8,38,48,1948
75532,75532,9442AAEA05C831A2075E8352FC15EF6E,10351,10,14,4,28,45,1445
75533,75533,9442AAEA05C831A2075E8352FC15EF6E,43361,18,20,2,38,48,1948
75534,75534,066E3B290AAC556F650E56DD0F693AB2,10191,0,8,8,40,48,2048
75535,75535,066E3B290AAC556F650E56DD0F693AB2,11074,8,16,8,37,47,1897
75536,75536,066E3B290AAC556F650E56DD0F693AB2,11531,18,19,1,34,49,1749
75537,75537,066E3B290AAC556F650E56DD0F693AB2,10191,20,23,3,40,48,2048
75545,75545,8AA4A8CCD104CA281FD495C84503BAAA,13681,1,5,4,38,47,1947
75546,75546,8AA4A8CCD104CA281FD495C84503BAAA,12511,8,10,2,39,47,1997
75547,75547,8AA4A8CCD104CA281FD495C84503BAAA,13331,10,16,6,38,47,1947
75548,75548,8AA4A8CCD104CA281FD495C84503BAAA,40341,16,18,2,23,49,1199
75549,75549,8AA4A8CCD104CA281FD495C84503BAAA,10971,20,21,1,35,47,1797
75550,75550,8AA4A8CCD104CA281FD495C84503BAAA,40123,22,23,1,38,47,1947
75551,75551,A9E35DAA672EF1C26FA7995FBBE067C5,11701,0,15,15,43,48,2198
75552,75552,A9E35DAA672EF1C26FA7995FBBE067C5,10231,19,20,1,39,49,1999
75553,75553,A9E35DAA672EF1C26FA7995FBBE067C5,11231,20,23,3,37,49,1899
75558,75558,CC6A63734928B4CD8F414AAB01241B9F,10611,0,7,7,32,48,1648
75559,75559,CC6A63734928B4CD8F414AAB01241B9F,11211,9,10,1,34,49,1749
75560,75560,CC6A63734928B4CD8F414AAB01241B9F,10611,13,14,1,32,48,1648
75561,75561,CC6A63734928B4CD8F414AAB01241B9F,11211,15,16,1,34,49,1749
75562,75562,CC6A63734928B4CD8F414AAB01241B9F,42301,18,20,2,36,47,1847
75563,75563,8F73236152C8063BFF3D92B22F15FEBF,10841,2,7,5,37,47,1897
75564,75564,8F73236152C8063BFF3D92B22F15FEBF,42201,8,16,8,43,46,2196
75565,75565,8F73236152C8063BFF3D92B22F15FEBF,10841,18,23,5,37,47,1897
75566,75566,5DC656AE1F755A21D4CE0049D29039D4,12491,0,6,6,36,43,1843
75567,75567,5DC656AE1F755A21D4CE0049D29039D4,11261,7,9,2,36,46,1846
75568,75568,5DC656AE1F755A21D4CE0049D29039D4,12491,11,14,3,36,43,1843
75569,75569,5DC656AE1F755A21D4CE0049D29039D4,11201,19,20,1,35,49,1799
75570,75570,0AC9ACC82EDADEC2B3583D25F9FB3BD5,11471,0,2,2,12,48,648
75571,75571,0AC9ACC82EDADEC2B3583D25F9FB3BD5,19441,4,9,5,8,46,446
75572,75572,0AC9ACC82EDADEC2B3583D25F9FB3BD5,42041,13,20,7,10,47,547
75573,75573,19520219413B0560C0BDE6534C7F0AD0,13561,0,6,6,37,49,1899
75574,75574,19520219413B0560C0BDE6534C7F0AD0,42151,10,18,8,35,45,1795
75575,75575,19520219413B0560C0BDE6534C7F0AD0,13561,20,23,3,37,49,1899
75584,75584,458EBC255B183BF22B23CE89879E2CC9,13471,0,11,11,47,49,2399
75585,75585,458EBC255B183BF22B23CE89879E2CC9,40691,12,16,4,42,48,2148
75586,75586,458EBC255B183BF22B23CE89879E2CC9,13471,18,20,2,47,49,2399
75591,75591,A2E834D310B55F9EA0A1B4DBD80E9D3B,11861,3,6,3,32,47,1647
75592,75592,A2E834D310B55F9EA0A1B4DBD80E9D3B,10611,7,9,2,32,48,1648
75593,75593,A2E834D310B55F9EA0A1B4DBD80E9D3B,11861,9,16,7,32,47,1647
75594,75594,A2E834D310B55F9EA0A1B4DBD80E9D3B,10611,17,18,1,32,48,1648
75595,75595,A2E834D310B55F9EA0A1B4DBD80E9D3B,11861,19,23,4,32,47,1647
75600,75600,04D73C3CD00D40CB611F6BA5801F802C,13314,0,7,7,31,39,1589
75601,75601,04D73C3CD00D40CB611F6BA5801F802C,12521,7,11,4,35,41,1791
75602,75602,04D73C3CD00D40CB611F6BA5801F802C,13314,12,13,1,31,39,1589
75603,75603,04D73C3CD00D40CB611F6BA5801F802C,12521,13,14,1,35,41,1791
75604,75604,04D73C3CD00D40CB611F6BA5801F802C,13314,19,23,4,31,39,1589
75619,75619,0781E535CBB143640477269330BEC7EE,11201,0,1,1,35,49,1799
75620,75620,0781E535CBB143640477269330BEC7EE,42161,2,5,3,36,47,1847
75621,75621,0781E535CBB143640477269330BEC7EE,40411,6,7,1,34,48,1748
75622,75622,0781E535CBB143640477269330BEC7EE,11081,9,10,1,35,46,1796
75623,75623,0781E535CBB143640477269330BEC7EE,10881,16,22,6,34,48,1748
75627,75627,8D86E284D185DE22084CD86C6BFE1A08,11875,0,6,6,30,46,1546
75628,75628,8D86E284D185DE22084CD86C6BFE1A08,12311,7,9,2,30,44,1544
75629,75629,8D86E284D185DE22084CD86C6BFE1A08,12661,10,11,1,32,45,1645
75630,75630,8D86E284D185DE22084CD86C6BFE1A08,12311,14,17,3,30,44,1544
75631,75631,8D86E284D185DE22084CD86C6BFE1A08,11875,18,23,5,30,46,1546
75632,75632,8827A35309A216F0F6E4CBB2FFAC456D,42471,0,2,2,35,49,1799
75633,75633,8827A35309A216F0F6E4CBB2FFAC456D,11751,18,20,2,35,48,1798
75634,75634,8827A35309A216F0F6E4CBB2FFAC456D,40691,20,22,2,42,48,2148
75638,75638,6A457FC295BEABB4E7455CBB04B50835,43021,0,5,5,16,43,843
75639,75639,6A457FC295BEABB4E7455CBB04B50835,43644,5,6,1,14,38,738
75640,75640,6A457FC295BEABB4E7455CBB04B50835,43021,7,10,3,16,43,843
75641,75641,6A457FC295BEABB4E7455CBB04B50835,12641,12,23,11,10,43,543
75642,75642,BA7790206F7A9D882153D611026997C3,11801,0,5,5,42,48,2148
75643,75643,BA7790206F7A9D882153D611026997C3,40833,6,7,1,41,47,2097
75644,75644,BA7790206F7A9D882153D611026997C3,11074,11,12,1,37,47,1897
75645,75645,BA7790206F7A9D882153D611026997C3,42271,14,16,2,40,47,2047
75646,75646,BA7790206F7A9D882153D611026997C3,40833,20,21,1,41,47,2097
75647,75647,7B4CE5C29FDE9D686A69DBA50B685421,42511,0,7,7,37,47,1897
75648,75648,7B4CE5C29FDE9D686A69DBA50B685421,12661,11,13,2,32,45,1645
75649,75649,7B4CE5C29FDE9D686A69DBA50B685421,12161,13,14,1,32,46,1646
75650,75650,7B4CE5C29FDE9D686A69DBA50B685421,42511,18,20,2,37,47,1897
75651,75651,7B4CE5C29FDE9D686A69DBA50B685421,13121,20,21,1,38,46,1946
75652,75652,7B4CE5C29FDE9D686A69DBA50B685421,40124,22,23,1,38,47,1947
75660,75660,39E9477CFB7A739ED25E5621F7D2A965,10821,0,6,6,40,47,2047
75661,75661,39E9477CFB7A739ED25E5621F7D2A965,12571,8,10,2,48,39,2439
75662,75662,39E9477CFB7A739ED25E5621F7D2A965,10841,12,14,2,37,47,1897
75663,75663,39E9477CFB7A739ED25E5621F7D2A965,12651,14,16,2,43,47,2197
75664,75664,39E9477CFB7A739ED25E5621F7D2A965,10821,17,23,6,40,47,2047
75665,75665,44C1643D7FB55423B3F2C35843AAE7BE,43951,0,18,18,49,41,2491
75666,75666,44C1643D7FB55423B3F2C35843AAE7BE,13951,20,21,1,47,45,2395
75667,75667,44C1643D7FB55423B3F2C35843AAE7BE,43951,22,23,1,49,41,2491
75675,75675,AC9A35D001464E087369411DD671E08D,42301,0,6,6,36,47,1847
75676,75676,AC9A35D001464E087369411DD671E08D,13481,14,19,5,26,31,1331
75677,75677,AC9A35D001464E087369411DD671E08D,42301,20,23,3,36,47,1847
75678,75678,0F46DC97ADBFE439A39C7E4B11BD9162,42201,0,1,1,43,46,2196
75679,75679,0F46DC97ADBFE439A39C7E4B11BD9162,13341,3,5,2,44,45,2245
75680,75680,0F46DC97ADBFE439A39C7E4B11BD9162,11061,8,10,2,29,48,1498
75681,75681,0F46DC97ADBFE439A39C7E4B11BD9162,13341,15,17,2,44,45,2245
75682,75682,0F46DC97ADBFE439A39C7E4B11BD9162,42201,22,23,1,43,46,2196
75683,75683,0E91A13D0E931F32EE1FFD96FA252798,43011,0,4,4,40,42,2042
75684,75684,0E91A13D0E931F32EE1FFD96FA252798,13071,4,6,2,41,41,2091
75685,75685,0E91A13D0E931F32EE1FFD96FA252798,43451,6,22,16,37,40,1890
75689,75689,08B22EEE6E957330DAD27E7217103ACF,43011,0,6,6,40,42,2042
75690,75690,08B22EEE6E957330DAD27E7217103ACF,11921,9,21,12,38,48,1948
75691,75691,08B22EEE6E957330DAD27E7217103ACF,43011,22,23,1,40,42,2042
75713,75713,7FBC8EE4EAF538E2F5C357E9E39087FD,12381,0,7,7,32,48,1648
75714,75714,7FBC8EE4EAF538E2F5C357E9E39087FD,42864,8,10,2,38,44,1944
75715,75715,7FBC8EE4EAF538E2F5C357E9E39087FD,12381,12,23,11,32,48,1648
75716,75716,9D2F8B673CF5A851F245B3DD21FD08F4,10251,0,7,7,35,47,1797
75717,75717,9D2F8B673CF5A851F245B3DD21FD08F4,19744,12,17,5,6,43,343
75718,75718,9D2F8B673CF5A851F245B3DD21FD08F4,41612,19,23,4,36,47,1847
75719,75719,DA8EF7789DD15D64E4CB91A60A838933,43731,1,5,4,34,47,1747
75720,75720,DA8EF7789DD15D64E4CB91A60A838933,42921,5,6,1,33,47,1697
75721,75721,DA8EF7789DD15D64E4CB91A60A838933,11061,11,13,2,29,48,1498
75722,75722,DA8EF7789DD15D64E4CB91A60A838933,11161,14,17,3,32,48,1648
75723,75723,DA8EF7789DD15D64E4CB91A60A838933,43731,21,22,1,34,47,1747
75724,75724,831CEF471029417D091D2BE9F78234DD,10801,1,2,1,42,47,2147
75725,75725,831CEF471029417D091D2BE9F78234DD,42321,5,10,5,43,47,2197
75726,75726,831CEF471029417D091D2BE9F78234DD,10601,13,16,3,39,47,1997
75727,75727,831CEF471029417D091D2BE9F78234DD,10801,19,21,2,42,47,2147
75728,75728,831CEF471029417D091D2BE9F78234DD,13371,21,23,2,41,47,2097
75729,75729,651721D54721A857048444C1110F4D0E,15401,0,6,6,39,25,1975
75730,75730,651721D54721A857048444C1110F4D0E,12514,10,11,1,38,47,1947
75731,75731,651721D54721A857048444C1110F4D0E,42221,14,16,2,38,48,1948
75732,75732,651721D54721A857048444C1110F4D0E,11914,16,17,1,37,48,1898
75733,75733,651721D54721A857048444C1110F4D0E,15653,20,23,3,40,25,2025
75734,75734,705DFE0F0CF99753368D655C68C21E78,12221,1,5,4,43,44,2194
75735,75735,705DFE0F0CF99753368D655C68C21E78,12211,6,9,3,41,44,2094
75736,75736,705DFE0F0CF99753368D655C68C21E78,12221,12,15,3,43,44,2194
75737,75737,705DFE0F0CF99753368D655C68C21E78,12561,16,17,1,45,43,2293
75738,75738,705DFE0F0CF99753368D655C68C21E78,12221,18,23,5,43,44,2194
75757,75757,080A7E68516AFB93F81B8B822F3BB6C4,42971,0,6,6,43,49,2199
75758,75758,080A7E68516AFB93F81B8B822F3BB6C4,42531,7,8,1,31,45,1595
75759,75759,080A7E68516AFB93F81B8B822F3BB6C4,12661,9,10,1,32,45,1645
75760,75760,080A7E68516AFB93F81B8B822F3BB6C4,12221,14,16,2,43,44,2194
75761,75761,080A7E68516AFB93F81B8B822F3BB6C4,42971,19,23,4,43,49,2199
75762,75762,D44EDEFE20C6E53FAD2290D9CECCD593,19441,0,1,1,8,46,446
75763,75763,D44EDEFE20C6E53FAD2290D9CECCD593,42041,3,8,5,10,47,547
75764,75764,D44EDEFE20C6E53FAD2290D9CECCD593,19441,8,10,2,8,46,446
75765,75765,D44EDEFE20C6E53FAD2290D9CECCD593,42041,12,17,5,10,47,547
75766,75766,D44EDEFE20C6E53FAD2290D9CECCD593,19441,17,21,4,8,46,446
75767,75767,D44EDEFE20C6E53FAD2290D9CECCD593,42041,22,23,1,10,47,547
75768,75768,CF556E7EE09434C2F24BD36020B24B4F,12661,5,9,4,32,45,1645
75769,75769,CF556E7EE09434C2F24BD36020B24B4F,12601,11,12,1,25,47,1297
75770,75770,CF556E7EE09434C2F24BD36020B24B4F,42491,15,17,2,32,46,1646
75771,75771,CF556E7EE09434C2F24BD36020B24B4F,42523,17,18,1,31,47,1597
75772,75772,CF556E7EE09434C2F24BD36020B24B4F,11324,21,22,1,31,46,1596
75773,75773,EB7EB6074C1F2A07A41462E31EDA6629,42401,0,8,8,36,47,1847
75774,75774,EB7EB6074C1F2A07A41462E31EDA6629,10111,10,14,4,37,47,1897
75775,75775,EB7EB6074C1F2A07A41462E31EDA6629,42161,16,18,2,36,47,1847
75776,75776,EB7EB6074C1F2A07A41462E31EDA6629,11074,19,20,1,37,47,1897
75777,75777,EB7EB6074C1F2A07A41462E31EDA6629,42161,21,23,2,36,47,1847
75778,75778,583602182C31C8E2D985404EA5592339,12921,6,10,4,9,41,491
75779,75779,583602182C31C8E2D985404EA5592339,12641,10,12,2,10,43,543
75780,75780,583602182C31C8E2D985404EA5592339,19181,15,16,1,8,40,440
75781,75781,583602182C31C8E2D985404EA5592339,43021,18,19,1,16,43,843
75782,75782,583602182C31C8E2D985404EA5592339,12641,22,23,1,10,43,543
75783,75783,B324CCFCD3F5330D2BA1EBE28CA2A657,13101,0,8,8,40,47,2047
75784,75784,B324CCFCD3F5330D2BA1EBE28CA2A657,11481,8,11,3,41,48,2098
75785,75785,B324CCFCD3F5330D2BA1EBE28CA2A657,40833,11,13,2,41,47,2097
75786,75786,B324CCFCD3F5330D2BA1EBE28CA2A657,13101,14,19,5,40,47,2047
75787,75787,B324CCFCD3F5330D2BA1EBE28CA2A657,13271,20,21,1,41,47,2097
75788,75788,B324CCFCD3F5330D2BA1EBE28CA2A657,13101,21,23,2,40,47,2047
75789,75789,A9C7C982C0FE909A6964C3A66CB3BD62,13671,0,9,9,27,43,1393
75790,75790,A9C7C982C0FE909A6964C3A66CB3BD62,10634,14,17,3,27,45,1395
75791,75791,A9C7C982C0FE909A6964C3A66CB3BD62,10351,19,20,1,28,45,1445
75792,75792,A9C7C982C0FE909A6964C3A66CB3BD62,11531,21,23,2,34,49,1749
75793,75793,D792958A885111DD79E8B20301AB4FBB,12792,0,5,5,34,30,1730
75794,75794,D792958A885111DD79E8B20301AB4FBB,15391,9,10,1,35,26,1776
75795,75795,D792958A885111DD79E8B20301AB4FBB,12792,12,20,8,34,30,1730
75802,75802,FFBC58051995801B38096066EDE55DF5,42311,0,9,9,41,46,2096
75803,75803,FFBC58051995801B38096066EDE55DF5,43101,12,15,3,46,40,2340
75804,75804,FFBC58051995801B38096066EDE55DF5,42311,18,20,2,41,46,2096
75805,75805,FFBC58051995801B38096066EDE55DF5,11001,21,23,2,42,47,2147
75806,75806,5C43416A739D6997A74BBA50F19E82A3,10171,0,7,7,26,47,1347
75807,75807,5C43416A739D6997A74BBA50F19E82A3,11861,7,18,11,32,47,1647
75808,75808,5C43416A739D6997A74BBA50F19E82A3,10171,21,23,2,26,47,1347
75816,75816,B34E4E0338EEF369F9BEB0AE27717CC8,11324,0,8,8,31,46,1596
75817,75817,B34E4E0338EEF369F9BEB0AE27717CC8,13351,13,16,3,48,48,2448
75818,75818,B34E4E0338EEF369F9BEB0AE27717CC8,42523,17,19,2,31,47,1597
75823,75823,B7C33B5C4F6E6D84F66DE44CC367A266,42861,0,6,6,37,44,1894
75824,75824,B7C33B5C4F6E6D84F66DE44CC367A266,12601,7,17,10,25,47,1297
75825,75825,B7C33B5C4F6E6D84F66DE44CC367A266,42861,20,21,1,37,44,1894
75826,75826,BE9C7D5970EDB149C920B55BDA903F43,13951,0,12,12,47,45,2395
75827,75827,BE9C7D5970EDB149C920B55BDA903F43,12211,14,18,4,41,44,2094
75828,75828,BE9C7D5970EDB149C920B55BDA903F43,13951,19,20,1,47,45,2395
75829,75829,19D4232A10BC42336172D84FDB4B36F4,42031,1,5,4,40,46,2046
75830,75830,19D4232A10BC42336172D84FDB4B36F4,13711,6,7,1,38,46,1946
75831,75831,19D4232A10BC42336172D84FDB4B36F4,11231,16,18,2,37,49,1899
75832,75832,19D4232A10BC42336172D84FDB4B36F4,11491,18,19,1,36,47,1847
75833,75833,19D4232A10BC42336172D84FDB4B36F4,42031,21,23,2,40,46,2046
75837,75837,994BA369046D8B99F80604E02227FCEB,42581,6,8,2,38,48,1948
75838,75838,994BA369046D8B99F80604E02227FCEB,10471,12,13,1,37,48,1898
75839,75839,994BA369046D8B99F80604E02227FCEB,10251,15,16,1,35,47,1797
75840,75840,994BA369046D8B99F80604E02227FCEB,11231,17,21,4,37,49,1899
75841,75841,994BA369046D8B99F80604E02227FCEB,42581,21,23,2,38,48,1948
75848,75848,3E3400E81F33727D0845365703B2CDF7,10221,0,8,8,34,49,1749
75849,75849,3E3400E81F33727D0845365703B2CDF7,41393,9,17,8,43,49,2199
75850,75850,3E3400E81F33727D0845365703B2CDF7,10161,18,20,2,35,49,1799
75855,75855,04DA073551B2B36368829872415CFF4C,19441,3,4,1,8,46,446
75856,75856,04DA073551B2B36368829872415CFF4C,42041,6,7,1,10,47,547
75857,75857,04DA073551B2B36368829872415CFF4C,12641,8,19,11,10,43,543
75858,75858,0B33559CDE995CCD90C9E87EB6E98B9E,42091,10,14,4,43,46,2196
75859,75859,0B33559CDE995CCD90C9E87EB6E98B9E,10401,17,18,1,33,49,1699
75860,75860,0B33559CDE995CCD90C9E87EB6E98B9E,42091,21,23,2,43,46,2196
75861,75861,7B4E6126570CADEFC5C95EC455FF20E3,11914,3,4,1,37,48,1898
75862,75862,7B4E6126570CADEFC5C95EC455FF20E3,43361,8,9,1,38,48,1948
75863,75863,7B4E6126570CADEFC5C95EC455FF20E3,11914,11,13,2,37,48,1898
75864,75864,7B4E6126570CADEFC5C95EC455FF20E3,11921,15,17,2,38,48,1948
75865,75865,7B4E6126570CADEFC5C95EC455FF20E3,11914,19,23,4,37,48,1898
75869,75869,F0C7EDE2A4789958616B0A004CA8540F,40833,0,5,5,41,47,2097
75870,75870,F0C7EDE2A4789958616B0A004CA8540F,10281,6,16,10,33,48,1698
75871,75871,F0C7EDE2A4789958616B0A004CA8540F,13271,17,20,3,41,47,2097
75872,75872,F0C7EDE2A4789958616B0A004CA8540F,11161,21,22,1,32,48,1648
75876,75876,5DAE8FB10D3FBEF5B02F98DB4BFD46E9,42861,0,6,6,37,44,1894
75877,75877,5DAE8FB10D3FBEF5B02F98DB4BFD46E9,42231,8,9,1,37,46,1896
75878,75878,5DAE8FB10D3FBEF5B02F98DB4BFD46E9,11261,11,12,1,36,46,1846
75879,75879,5DAE8FB10D3FBEF5B02F98DB4BFD46E9,42231,14,17,3,37,46,1896
75880,75880,5DAE8FB10D3FBEF5B02F98DB4BFD46E9,11261,18,19,1,36,46,1846
75881,75881,5DAE8FB10D3FBEF5B02F98DB4BFD46E9,13711,20,22,2,38,46,1946
75882,75882,091DCC0237DDF0F056E1A7BFB1F57890,43021,0,1,1,16,43,843
75883,75883,091DCC0237DDF0F056E1A7BFB1F57890,12641,3,11,8,10,43,543
75884,75884,091DCC0237DDF0F056E1A7BFB1F57890,43021,16,17,1,16,43,843
75885,75885,091DCC0237DDF0F056E1A7BFB1F57890,19021,20,23,3,10,45,545
75889,75889,C919A8058ECB429BE0036BE26BF6A160,10251,0,16,16,35,47,1797
75890,75890,C919A8058ECB429BE0036BE26BF6A160,11231,16,17,1,37,49,1899
75891,75891,C919A8058ECB429BE0036BE26BF6A160,10231,19,20,1,39,49,1999
75892,75892,C919A8058ECB429BE0036BE26BF6A160,10251,21,23,2,35,47,1797
75893,75893,702A499FD39D0BCD3CFB88CB328366DB,13111,1,7,6,42,46,2146
75894,75894,702A499FD39D0BCD3CFB88CB328366DB,42461,7,8,1,45,47,2297
75895,75895,702A499FD39D0BCD3CFB88CB328366DB,42601,9,12,3,44,48,2248
75896,75896,702A499FD39D0BCD3CFB88CB328366DB,42321,12,16,4,43,47,2197
75897,75897,702A499FD39D0BCD3CFB88CB328366DB,13111,20,22,2,42,46,2146
75898,75898,9738C6A76A80AF0AD95E39C886F58A1A,10295,0,8,8,30,47,1547
75899,75899,9738C6A76A80AF0AD95E39C886F58A1A,12381,8,10,2,32,48,1648
75900,75900,9738C6A76A80AF0AD95E39C886F58A1A,10292,11,13,2,30,47,1547
75901,75901,9738C6A76A80AF0AD95E39C886F58A1A,12381,13,15,2,32,48,1648
75902,75902,9738C6A76A80AF0AD95E39C886F58A1A,10381,17,19,2,31,49,1599
75903,75903,B20D4CCCBBF9B534BB9F26A35B371E4C,11261,1,7,6,36,46,1846
75904,75904,B20D4CCCBBF9B534BB9F26A35B371E4C,42351,7,9,2,38,45,1945
75905,75905,B20D4CCCBBF9B534BB9F26A35B371E4C,11261,12,14,2,36,46,1846
75906,75906,B20D4CCCBBF9B534BB9F26A35B371E4C,42351,15,17,2,38,45,1945
75907,75907,B20D4CCCBBF9B534BB9F26A35B371E4C,11261,18,19,1,36,46,1846
75908,75908,4C8E92DBB85921608C1C92929A7A8C92,42521,0,6,6,31,47,1597
75909,75909,4C8E92DBB85921608C1C92929A7A8C92,13651,9,11,2,30,47,1547
75910,75910,4C8E92DBB85921608C1C92929A7A8C92,42521,12,13,1,31,47,1597
75911,75911,4C8E92DBB85921608C1C92929A7A8C92,13651,15,18,3,30,47,1547
75912,75912,4C8E92DBB85921608C1C92929A7A8C92,42521,21,23,2,31,47,1597
75913,75913,F7A05B3FECD253C9C578617425D22E9D,13351,0,7,7,48,48,2448
75914,75914,F7A05B3FECD253C9C578617425D22E9D,11801,7,9,2,42,48,2148
75915,75915,F7A05B3FECD253C9C578617425D22E9D,19114,12,14,2,7,43,393
75916,75916,F7A05B3FECD253C9C578617425D22E9D,40302,17,20,3,40,49,2049
75917,75917,F7A05B3FECD253C9C578617425D22E9D,13351,20,23,3,48,48,2448
75918,75918,87A579BD8EB5C5CE5240DDB8F2C166E2,13671,0,6,6,27,43,1393
75919,75919,87A579BD8EB5C5CE5240DDB8F2C166E2,12521,10,15,5,35,41,1791
75920,75920,87A579BD8EB5C5CE5240DDB8F2C166E2,13671,19,21,2,27,43,1393
75921,75921,87A579BD8EB5C5CE5240DDB8F2C166E2,13314,21,23,2,31,39,1589
75922,75922,4DA21EF09DE00955AFF28F16D2698178,12792,2,5,3,34,30,1730
75923,75923,4DA21EF09DE00955AFF28F16D2698178,15391,6,7,1,35,26,1776
75924,75924,4DA21EF09DE00955AFF28F16D2698178,15191,8,10,2,36,27,1827
75925,75925,4DA21EF09DE00955AFF28F16D2698178,12792,10,11,1,34,30,1730
75926,75926,4DA21EF09DE00955AFF28F16D2698178,15091,12,23,11,35,26,1776
75927,75927,1C7DBF9E53F65ED639E90C6178E9F4A9,42151,0,7,7,35,45,1795
75928,75928,1C7DBF9E53F65ED639E90C6178E9F4A9,13671,7,9,2,27,43,1393
75929,75929,1C7DBF9E53F65ED639E90C6178E9F4A9,42351,11,12,1,38,45,1945
75930,75930,1C7DBF9E53F65ED639E90C6178E9F4A9,11491,14,16,2,36,47,1847
75931,75931,1C7DBF9E53F65ED639E90C6178E9F4A9,11261,18,19,1,36,46,1846
75932,75932,1C7DBF9E53F65ED639E90C6178E9F4A9,13911,20,21,1,39,46,1996
75936,75936,CAFD76C380AFDC0FEC510F56BF3B1C8D,11841,0,9,9,33,46,1696
75937,75937,CAFD76C380AFDC0FEC510F56BF3B1C8D,42633,10,11,1,42,46,2146
75938,75938,CAFD76C380AFDC0FEC510F56BF3B1C8D,11841,19,23,4,33,46,1696
75942,75942,D429753EEB35077FBB0F7FD7B24671DA,13071,2,4,2,41,41,2091
75943,75943,D429753EEB35077FBB0F7FD7B24671DA,43451,7,10,3,37,40,1890
75944,75944,D429753EEB35077FBB0F7FD7B24671DA,42381,12,13,1,39,41,1991
75945,75945,D429753EEB35077FBB0F7FD7B24671DA,43451,14,18,4,37,40,1890
75946,75946,AB6EA8E0EB921375D4ACF50883707DA2,42461,0,1,1,45,47,2297
75947,75947,AB6EA8E0EB921375D4ACF50883707DA2,10681,2,8,6,30,48,1548
75948,75948,AB6EA8E0EB921375D4ACF50883707DA2,10401,12,22,10,33,49,1699
75952,75952,04D04C3BC4AF64B8094E4E37ECF39C84,42831,0,8,8,27,48,1398
75953,75953,04D04C3BC4AF64B8094E4E37ECF39C84,43971,9,10,1,30,48,1548
75954,75954,04D04C3BC4AF64B8094E4E37ECF39C84,40341,13,15,2,23,49,1199
75955,75955,04D04C3BC4AF64B8094E4E37ECF39C84,10544,18,19,1,28,48,1448
75956,75956,04D04C3BC4AF64B8094E4E37ECF39C84,42831,21,23,2,27,48,1398
75957,75957,D256AE34DD31744D7365602849D9C40A,42491,0,8,8,32,46,1646
75958,75958,D256AE34DD31744D7365602849D9C40A,12601,8,14,6,25,47,1297
75959,75959,D256AE34DD31744D7365602849D9C40A,42491,19,22,3,32,46,1646
75960,75960,F6CF1C41F7C41D5A8B55D9B98830D394,11701,0,7,7,43,48,2198
75961,75961,F6CF1C41F7C41D5A8B55D9B98830D394,42341,9,10,1,43,49,2199
75962,75962,F6CF1C41F7C41D5A8B55D9B98830D394,11701,10,14,4,43,48,2198
75963,75963,F6CF1C41F7C41D5A8B55D9B98830D394,40691,15,16,1,42,48,2148
75964,75964,F6CF1C41F7C41D5A8B55D9B98830D394,11231,20,23,3,37,49,1899
75969,75969,C4C98DA3205A9459DEF69764F0BB2EEE,11161,0,1,1,32,48,1648
75970,75970,C4C98DA3205A9459DEF69764F0BB2EEE,42501,2,7,5,28,47,1447
75971,75971,C4C98DA3205A9459DEF69764F0BB2EEE,10221,11,15,4,34,49,1749
75972,75972,C4C98DA3205A9459DEF69764F0BB2EEE,10151,16,19,3,34,47,1747
75973,75973,C4C98DA3205A9459DEF69764F0BB2EEE,42501,19,21,2,28,47,1447
75974,75974,C4C98DA3205A9459DEF69764F0BB2EEE,10107,22,23,1,38,49,1949
75975,75975,09757EDFE7795D1E67DCE5C4439A4727,12521,0,9,9,35,41,1791
75976,75976,09757EDFE7795D1E67DCE5C4439A4727,13314,10,11,1,31,39,1589
75977,75977,09757EDFE7795D1E67DCE5C4439A4727,12521,12,23,11,35,41,1791
75978,75978,F700EF62D4263F0AD807A0B192F0AD96,13711,5,6,1,38,46,1946
75979,75979,F700EF62D4263F0AD807A0B192F0AD96,42523,8,9,1,31,47,1597
75980,75980,F700EF62D4263F0AD807A0B192F0AD96,11381,10,11,1,30,47,1547
75981,75981,F700EF62D4263F0AD807A0B192F0AD96,19261,16,17,1,6,37,337
75982,75982,F700EF62D4263F0AD807A0B192F0AD96,11481,21,23,2,41,48,2098
75983,75983,06435553033E863666762C6687A7904E,10781,0,7,7,35,47,1797
75984,75984,06435553033E863666762C6687A7904E,10681,10,13,3,30,48,1548
75985,75985,06435553033E863666762C6687A7904E,11061,14,16,2,29,48,1498
75986,75986,06435553033E863666762C6687A7904E,10781,17,22,5,35,47,1797
75997,75997,6D63FF8A3FC1EAB372239FB0BF4A8ABC,41392,0,9,9,43,48,2198
75998,75998,6D63FF8A3FC1EAB372239FB0BF4A8ABC,12481,18,20,2,37,49,1899
75999,75999,6D63FF8A3FC1EAB372239FB0BF4A8ABC,42801,20,22,2,40,49,2049
76003,76003,22E0CD429C1B1E7AC6170F90C318BE33,40833,0,5,5,41,47,2097
76004,76004,22E0CD429C1B1E7AC6170F90C318BE33,12641,7,9,2,10,43,543
76005,76005,22E0CD429C1B1E7AC6170F90C318BE33,19031,13,21,8,1,42,92
76006,76006,22E0CD429C1B1E7AC6170F90C318BE33,12641,21,23,2,10,43,543
76010,76010,2B18BEA2FBBC80F82CFB75E581EF2F20,11861,0,8,8,32,47,1647
76011,76011,2B18BEA2FBBC80F82CFB75E581EF2F20,11461,11,17,6,37,49,1899
76012,76012,2B18BEA2FBBC80F82CFB75E581EF2F20,11861,18,22,4,32,47,1647
76013,76013,C6F078264A4011D72ABD6DE75DA6F035,43361,0,8,8,38,48,1948
76014,76014,C6F078264A4011D72ABD6DE75DA6F035,10351,8,10,2,28,45,1445
76015,76015,C6F078264A4011D72ABD6DE75DA6F035,10811,13,14,1,38,46,1946
76016,76016,C6F078264A4011D72ABD6DE75DA6F035,43361,16,23,7,38,48,1948
76017,76017,59DD864F885A1198596CE438972B3DE8,43751,0,6,6,19,48,998
76018,76018,59DD864F885A1198596CE438972B3DE8,42691,6,10,4,24,48,1248
76019,76019,59DD864F885A1198596CE438972B3DE8,43751,13,23,10,19,48,998
76020,76020,AD5871AA9EAD75878C606AE9C3D0E3D8,12561,0,5,5,45,43,2293
76021,76021,AD5871AA9EAD75878C606AE9C3D0E3D8,43951,6,9,3,49,41,2491
76022,76022,AD5871AA9EAD75878C606AE9C3D0E3D8,12561,11,21,10,45,43,2293
76027,76027,C587B8BBA49D2BF4E222CE1A0182D385,42051,0,6,6,42,48,2148
76028,76028,C587B8BBA49D2BF4E222CE1A0182D385,10421,9,10,1,41,48,2098
76029,76029,C587B8BBA49D2BF4E222CE1A0182D385,40171,13,14,1,38,48,1948
76030,76030,C587B8BBA49D2BF4E222CE1A0182D385,11481,17,18,1,41,48,2098
76031,76031,C587B8BBA49D2BF4E222CE1A0182D385,11781,20,22,2,38,49,1949
76048,76048,73C431267E9D15126DD630F092950C8C,13821,0,13,13,49,45,2495
76049,76049,73C431267E9D15126DD630F092950C8C,42111,15,18,3,44,46,2246
76050,76050,73C431267E9D15126DD630F092950C8C,13821,19,21,2,49,45,2495
76054,76054,649D537EAF2002D83012C69B3CA759A0,11161,1,14,13,32,48,1648
76055,76055,649D537EAF2002D83012C69B3CA759A0,11074,15,17,2,37,47,1897
76056,76056,649D537EAF2002D83012C69B3CA759A0,11161,17,19,2,32,48,1648
76057,76057,D28E5E78DFC1F96DF4D6C3C735439CA9,43181,0,5,5,39,48,1998
76058,76058,D28E5E78DFC1F96DF4D6C3C735439CA9,42021,9,15,6,33,47,1697
76059,76059,D28E5E78DFC1F96DF4D6C3C735439CA9,11771,19,21,2,39,49,1999
76060,76060,4FA7E2AF35091649A8D61648BF92F5C0,42581,2,7,5,38,48,1948
76061,76061,4FA7E2AF35091649A8D61648BF92F5C0,10471,7,10,3,37,48,1898
76062,76062,4FA7E2AF35091649A8D61648BF92F5C0,42581,12,14,2,38,48,1948
76063,76063,4FA7E2AF35091649A8D61648BF92F5C0,10471,14,18,4,37,48,1898
76064,76064,4FA7E2AF35091649A8D61648BF92F5C0,42581,20,23,3,38,48,1948
76065,76065,704CAE69DA3E87A500C909E44567E239,12221,0,1,1,43,44,2194
76066,76066,704CAE69DA3E87A500C909E44567E239,43011,4,5,1,40,42,2042
76067,76067,704CAE69DA3E87A500C909E44567E239,11061,8,21,13,29,48,1498
76081,76081,6EF85D0B1F24FCF6EFE8BDB01F9D1904,12121,0,13,13,29,47,1497
76082,76082,6EF85D0B1F24FCF6EFE8BDB01F9D1904,10161,14,16,2,35,49,1799
76083,76083,6EF85D0B1F24FCF6EFE8BDB01F9D1904,12121,18,20,2,29,47,1497
76084,76084,6EF85D0B1F24FCF6EFE8BDB01F9D1904,11751,21,22,1,35,48,1798
76085,76085,7EA63201A47B68AA085BD7B8AF1F7767,10721,0,7,7,31,48,1598
76086,76086,7EA63201A47B68AA085BD7B8AF1F7767,11231,8,10,2,37,49,1899
76087,76087,7EA63201A47B68AA085BD7B8AF1F7767,10121,14,15,1,36,49,1849
76088,76088,7EA63201A47B68AA085BD7B8AF1F7767,10251,18,22,4,35,47,1797
76093,76093,E9A3CD274E59D02E58C670C705BBAC42,43451,0,3,3,37,40,1890
76094,76094,E9A3CD274E59D02E58C670C705BBAC42,42554,5,15,10,14,46,746
76095,76095,E9A3CD274E59D02E58C670C705BBAC42,13671,19,20,1,27,43,1393
76096,76096,3CCBE70656D275FF49A3428C509A1713,42231,0,6,6,37,46,1896
76097,76097,3CCBE70656D275FF49A3428C509A1713,11631,8,17,9,12,49,649
76098,76098,3CCBE70656D275FF49A3428C509A1713,42231,20,23,3,37,46,1896
76099,76099,21B656E93C25F88D6CD1C23ADB7656C7,10295,0,11,11,30,47,1547
76100,76100,21B656E93C25F88D6CD1C23ADB7656C7,16211,14,20,6,4,3,203
76101,76101,21B656E93C25F88D6CD1C23ADB7656C7,16241,21,23,2,3,3,153
76102,76102,41A6C8E34EA0693C5F034A18C8C1F295,10421,0,7,7,41,48,2098
76103,76103,41A6C8E34EA0693C5F034A18C8C1F295,11701,7,9,2,43,48,2198
76104,76104,41A6C8E34EA0693C5F034A18C8C1F295,10151,10,11,1,34,47,1747
76105,76105,41A6C8E34EA0693C5F034A18C8C1F295,10421,12,15,3,41,48,2098
76106,76106,41A6C8E34EA0693C5F034A18C8C1F295,13351,17,18,1,48,48,2448
76107,76107,41A6C8E34EA0693C5F034A18C8C1F295,11531,20,21,1,34,49,1749
76112,76112,052C0C5B952087BC3A6E16B04C98FAAC,42523,8,9,1,31,47,1597
76113,76113,052C0C5B952087BC3A6E16B04C98FAAC,11324,12,13,1,31,46,1596
76114,76114,052C0C5B952087BC3A6E16B04C98FAAC,10716,13,14,1,30,46,1546
76115,76115,052C0C5B952087BC3A6E16B04C98FAAC,11324,15,17,2,31,46,1596
76116,76116,052C0C5B952087BC3A6E16B04C98FAAC,10381,18,19,1,31,49,1599
76117,76117,205F6EF0C79CA59441E655E7DAF83277,43311,9,11,2,31,48,1598
76118,76118,205F6EF0C79CA59441E655E7DAF83277,12381,16,18,2,32,48,1648
76119,76119,205F6EF0C79CA59441E655E7DAF83277,10771,19,20,1,41,46,2096
76126,76126,A4CBFA774BBCB1E081978588796288CA,10681,0,7,7,30,48,1548
76127,76127,A4CBFA774BBCB1E081978588796288CA,11231,8,17,9,37,49,1899
76128,76128,A4CBFA774BBCB1E081978588796288CA,10681,19,23,4,30,48,1548
76129,76129,AF3BB2EB266D8BDC31553ED7C05B56FE,13671,0,6,6,27,43,1393
76130,76130,AF3BB2EB266D8BDC31553ED7C05B56FE,12491,6,8,2,36,43,1843
76131,76131,AF3BB2EB266D8BDC31553ED7C05B56FE,13671,8,9,1,27,43,1393
76132,76132,AF3BB2EB266D8BDC31553ED7C05B56FE,12491,14,17,3,36,43,1843
76133,76133,AF3BB2EB266D8BDC31553ED7C05B56FE,13671,18,20,2,27,43,1393
76134,76134,AF3BB2EB266D8BDC31553ED7C05B56FE,12731,20,22,2,22,40,1140
76135,76135,5D5E5A73B7C318A198B2EC2211DE6D58,10841,0,12,12,37,47,1897
76136,76136,5D5E5A73B7C318A198B2EC2211DE6D58,40341,14,16,2,23,49,1199
76137,76137,5D5E5A73B7C318A198B2EC2211DE6D58,10841,18,23,5,37,47,1897
76154,76154,DEB632549C00DBE1E148C1A64F029789,11161,4,10,6,32,48,1648
76155,76155,DEB632549C00DBE1E148C1A64F029789,10231,13,14,1,39,49,1999
76156,76156,DEB632549C00DBE1E148C1A64F029789,12381,16,19,3,32,48,1648
76157,76157,DEB632549C00DBE1E148C1A64F029789,10691,20,22,2,33,48,1698
76158,76158,C11958CA68DCC24D143388B1E6ECEAA7,11151,0,12,12,30,48,1548
76159,76159,C11958CA68DCC24D143388B1E6ECEAA7,40094,12,14,2,29,48,1498
76160,76160,C11958CA68DCC24D143388B1E6ECEAA7,11151,15,17,2,30,48,1548
76161,76161,C11958CA68DCC24D143388B1E6ECEAA7,43391,18,20,2,29,48,1498
76162,76162,C11958CA68DCC24D143388B1E6ECEAA7,11151,20,23,3,30,48,1548
76163,76163,466786D54A3236A0CA1395E1CA33DFC4,11381,0,15,15,30,47,1547
76164,76164,466786D54A3236A0CA1395E1CA33DFC4,10971,20,21,1,35,47,1797
76165,76165,466786D54A3236A0CA1395E1CA33DFC4,11381,22,23,1,30,47,1547
76170,76170,4507A6AA40E86D001FA56149FC45CD13,19741,4,5,1,5,44,294
76171,76171,4507A6AA40E86D001FA56149FC45CD13,43644,7,15,8,14,38,738
76172,76172,4507A6AA40E86D001FA56149FC45CD13,19181,16,19,3,8,40,440
76173,76173,4507A6AA40E86D001FA56149FC45CD13,19244,22,23,1,1,43,93
76174,76174,E191A4A4FB39AEE62DAC5F9CA16A7F16,12381,0,15,15,32,48,1648
76175,76175,E191A4A4FB39AEE62DAC5F9CA16A7F16,10221,18,20,2,34,49,1749
76176,76176,E191A4A4FB39AEE62DAC5F9CA16A7F16,43481,21,22,1,39,48,1998
76180,76180,05986B1809FB5416951C16256229A152,42871,0,1,1,30,45,1545
76181,76181,05986B1809FB5416951C16256229A152,11875,2,7,5,30,46,1546
76182,76182,05986B1809FB5416951C16256229A152,42871,7,8,1,30,45,1545
76183,76183,05986B1809FB5416951C16256229A152,11531,15,18,3,34,49,1749
76184,76184,05986B1809FB5416951C16256229A152,42871,20,23,3,30,45,1545
76185,76185,257D574C2D2A51DCF616358CC1671E46,42321,0,4,4,43,47,2197
76186,76186,257D574C2D2A51DCF616358CC1671E46,42351,6,7,1,38,45,1945
76187,76187,257D574C2D2A51DCF616358CC1671E46,13711,10,11,1,38,46,1946
76188,76188,257D574C2D2A51DCF616358CC1671E46,42511,13,15,2,37,47,1897
76189,76189,257D574C2D2A51DCF616358CC1671E46,41401,17,18,1,37,46,1896
76190,76190,257D574C2D2A51DCF616358CC1671E46,42351,20,23,3,38,45,1945
76203,76203,14909CB01CC7902DACA46E64F89B4A03,42864,0,16,16,38,44,1944
76204,76204,14909CB01CC7902DACA46E64F89B4A03,42321,18,19,1,43,47,2197
76205,76205,14909CB01CC7902DACA46E64F89B4A03,42864,20,23,3,38,44,1944
76206,76206,198F13224A4C889E12ED1D538BD7168E,15391,0,5,5,35,26,1776
76207,76207,198F13224A4C889E12ED1D538BD7168E,15321,6,13,7,29,26,1476
76208,76208,198F13224A4C889E12ED1D538BD7168E,15391,14,23,9,35,26,1776
76209,76209,249945D8BC225A84B9C0C3C523B07C14,43011,2,3,1,40,42,2042
76210,76210,249945D8BC225A84B9C0C3C523B07C14,43451,7,11,4,37,40,1890
76211,76211,249945D8BC225A84B9C0C3C523B07C14,42381,12,13,1,39,41,1991
76212,76212,249945D8BC225A84B9C0C3C523B07C14,43451,14,17,3,37,40,1890
76213,76213,249945D8BC225A84B9C0C3C523B07C14,42381,19,23,4,39,41,1991
76227,76227,753369D691B504B9F7186B2CDF290F06,12792,3,4,1,34,30,1730
76228,76228,753369D691B504B9F7186B2CDF290F06,15391,5,15,10,35,26,1776
76229,76229,753369D691B504B9F7186B2CDF290F06,15661,19,20,1,36,26,1826
76230,76230,E8C2391DA6D45D7659D6871A0F1C6C82,13671,0,7,7,27,43,1393
76231,76231,E8C2391DA6D45D7659D6871A0F1C6C82,42531,9,13,4,31,45,1595
76232,76232,E8C2391DA6D45D7659D6871A0F1C6C82,13671,13,15,2,27,43,1393
76233,76233,E8C2391DA6D45D7659D6871A0F1C6C82,11834,20,21,1,32,45,1645
76234,76234,766BC3D8559311F5E9DDF96963F61382,11231,0,2,2,37,49,1899
76235,76235,766BC3D8559311F5E9DDF96963F61382,11491,3,8,5,36,47,1847
76236,76236,766BC3D8559311F5E9DDF96963F61382,10901,10,12,2,35,48,1798
76237,76237,766BC3D8559311F5E9DDF96963F61382,40951,12,13,1,36,49,1849
76238,76238,766BC3D8559311F5E9DDF96963F61382,11491,14,15,1,36,47,1847
76239,76239,766BC3D8559311F5E9DDF96963F61382,10901,16,17,1,35,48,1798
76240,76240,766BC3D8559311F5E9DDF96963F61382,10191,19,21,2,40,48,2048
76241,76241,766BC3D8559311F5E9DDF96963F61382,11491,22,23,1,36,47,1847
76245,76245,5AB06890D1F02153F5E7416054C280D9,43581,0,6,6,33,48,1698
76246,76246,5AB06890D1F02153F5E7416054C280D9,42941,9,15,6,37,47,1897
76247,76247,5AB06890D1F02153F5E7416054C280D9,13601,16,17,1,34,47,1747
76248,76248,5AB06890D1F02153F5E7416054C280D9,43581,21,22,1,33,48,1698
76249,76249,64C1CB497D14413252AF92C04E32AD9F,10841,0,10,10,37,47,1897
76250,76250,64C1CB497D14413252AF92C04E32AD9F,11301,12,13,1,41,49,2099
76251,76251,64C1CB497D14413252AF92C04E32AD9F,11074,13,15,2,37,47,1897
76252,76252,64C1CB497D14413252AF92C04E32AD9F,42341,18,19,1,43,49,2199
76253,76253,64C1CB497D14413252AF92C04E32AD9F,10841,19,23,4,37,47,1897
76254,76254,8AB561279CAFD673B81CFFF6F25401C3,12221,5,6,1,43,44,2194
76255,76255,8AB561279CAFD673B81CFFF6F25401C3,43011,8,9,1,40,42,2042
76256,76256,8AB561279CAFD673B81CFFF6F25401C3,13951,11,16,5,47,45,2395
76257,76257,8AB561279CAFD673B81CFFF6F25401C3,43011,21,23,2,40,42,2042
76258,76258,DD4D28FDBCFFE930AF28BD3956ED9308,11381,0,16,16,30,47,1547
76259,76259,DD4D28FDBCFFE930AF28BD3956ED9308,13371,17,18,1,41,47,2097
76260,76260,DD4D28FDBCFFE930AF28BD3956ED9308,11381,22,23,1,30,47,1547
76264,76264,42B28AE3CCE12BA9A899758E7A189C34,42271,1,7,6,40,47,2047
76265,76265,42B28AE3CCE12BA9A899758E7A189C34,10121,8,12,4,36,49,1849
76266,76266,42B28AE3CCE12BA9A899758E7A189C34,11806,12,14,2,41,48,2098
76267,76267,42B28AE3CCE12BA9A899758E7A189C34,10121,15,17,2,36,49,1849
76268,76268,42B28AE3CCE12BA9A899758E7A189C34,42271,19,20,1,40,47,2047
76269,76269,42B28AE3CCE12BA9A899758E7A189C34,11806,21,23,2,41,48,2098
76270,76270,BC71A128CC1D1FD204F1FA3A371EA53A,43021,0,6,6,16,43,843
76271,76271,BC71A128CC1D1FD204F1FA3A371EA53A,12921,6,19,13,9,41,491
76272,76272,BC71A128CC1D1FD204F1FA3A371EA53A,43021,19,23,4,16,43,843
76277,76277,12CF5F0E019282F2BF2076B3C77B6607,19441,0,6,6,8,46,446
76278,76278,12CF5F0E019282F2BF2076B3C77B6607,42041,8,9,1,10,47,547
76279,76279,12CF5F0E019282F2BF2076B3C77B6607,19441,12,14,2,8,46,446
76280,76280,12CF5F0E019282F2BF2076B3C77B6607,42041,15,17,2,10,47,547
76281,76281,12CF5F0E019282F2BF2076B3C77B6607,19441,18,23,5,8,46,446
76282,76282,C1664BA564BC8FF7C20F47733006D06C,40302,1,7,6,40,49,2049
76283,76283,C1664BA564BC8FF7C20F47733006D06C,40101,9,16,7,34,49,1749
76284,76284,C1664BA564BC8FF7C20F47733006D06C,40302,20,23,3,40,49,2049
76291,76291,6D92EE52F600169319D34C49B1A602B3,11074,0,6,6,37,47,1897
76292,76292,6D92EE52F600169319D34C49B1A602B3,10281,7,18,11,33,48,1698
76293,76293,6D92EE52F600169319D34C49B1A602B3,10841,19,20,1,37,47,1897
76294,76294,53493041487B5321836147FAAD536213,13101,4,5,1,40,47,2047
76295,76295,53493041487B5321836147FAAD536213,13941,6,8,2,41,47,2097
76296,76296,53493041487B5321836147FAAD536213,13101,11,14,3,40,47,2047
76297,76297,53493041487B5321836147FAAD536213,13941,17,18,1,41,47,2097
76298,76298,53493041487B5321836147FAAD536213,13101,18,23,5,40,47,2047
76307,76307,E368078C59121EE7A89865E85A806516,11541,0,7,7,35,49,1799
76308,76308,E368078C59121EE7A89865E85A806516,13561,7,8,1,37,49,1899
76309,76309,E368078C59121EE7A89865E85A806516,41061,9,13,4,34,49,1749
76310,76310,E368078C59121EE7A89865E85A806516,13561,13,14,1,37,49,1899
76311,76311,E368078C59121EE7A89865E85A806516,11541,16,22,6,35,49,1799
76312,76312,4C0B4AC61D24A3A943FEC75230408343,10381,0,6,6,31,49,1599
76313,76313,4C0B4AC61D24A3A943FEC75230408343,42831,10,16,6,27,48,1398
76314,76314,4C0B4AC61D24A3A943FEC75230408343,11151,20,23,3,30,48,1548
76315,76315,EA4346C82B2DB28BABC4E2B816D4C45D,15351,0,5,5,24,22,1222
76316,76316,EA4346C82B2DB28BABC4E2B816D4C45D,15121,7,16,9,27,19,1369
76317,76317,EA4346C82B2DB28BABC4E2B816D4C45D,15351,19,20,1,24,22,1222
76318,76318,34FB5BF239A7B5016E3CA81F47968839,40961,7,8,1,35,47,1797
76319,76319,34FB5BF239A7B5016E3CA81F47968839,11201,12,13,1,35,49,1799
76320,76320,34FB5BF239A7B5016E3CA81F47968839,40961,16,20,4,35,47,1797
76321,76321,34FB5BF239A7B5016E3CA81F47968839,42161,20,22,2,36,47,1847
76322,76322,34FB5BF239A7B5016E3CA81F47968839,10251,22,23,1,35,47,1797
76323,76323,CEDA8772FC2EAD62D9580766048C42F4,13311,0,6,6,27,39,1389
76324,76324,CEDA8772FC2EAD62D9580766048C42F4,13671,7,12,5,27,43,1393
76325,76325,CEDA8772FC2EAD62D9580766048C42F4,11281,13,14,1,27,40,1390
76326,76326,CEDA8772FC2EAD62D9580766048C42F4,13671,14,19,5,27,43,1393
76327,76327,CEDA8772FC2EAD62D9580766048C42F4,13311,19,23,4,27,39,1389
76328,76328,C50F95F31F14C0EC9A55706C3B181C1C,12792,0,6,6,34,30,1730
76329,76329,C50F95F31F14C0EC9A55706C3B181C1C,15391,6,7,1,35,26,1776
76330,76330,C50F95F31F14C0EC9A55706C3B181C1C,12792,9,11,2,34,30,1730
76331,76331,C50F95F31F14C0EC9A55706C3B181C1C,15391,15,23,8,35,26,1776
76332,76332,401DBF9291C70DB6E3FE8385830F996E,13791,0,7,7,42,47,2147
76333,76333,401DBF9291C70DB6E3FE8385830F996E,10221,8,12,4,34,49,1749
76334,76334,401DBF9291C70DB6E3FE8385830F996E,11021,12,21,9,36,49,1849
76335,76335,0A252836FA6DFCFDFC50B5267919BF05,43021,0,5,5,16,43,843
76336,76336,0A252836FA6DFCFDFC50B5267919BF05,12921,5,15,10,9,41,491
76337,76337,0A252836FA6DFCFDFC50B5267919BF05,43021,19,21,2,16,43,843
76338,76338,D157376C3B3C86905830B8BD99123913,11941,2,8,6,37,46,1896
76339,76339,D157376C3B3C86905830B8BD99123913,12131,11,13,2,32,47,1647
76340,76340,D157376C3B3C86905830B8BD99123913,13711,14,16,2,38,46,1946
76341,76341,D157376C3B3C86905830B8BD99123913,11861,19,21,2,32,47,1647
76342,76342,D157376C3B3C86905830B8BD99123913,11151,22,23,1,30,48,1548
76343,76343,35DE934E09014E3A56964C528E95BB57,10951,0,8,8,29,48,1498
76344,76344,35DE934E09014E3A56964C528E95BB57,11651,9,16,7,33,47,1697
76345,76345,35DE934E09014E3A56964C528E95BB57,10901,20,22,2,35,48,1798
76346,76346,D5D027DEC2E15CD439B6E37A42DFD8C1,43021,0,1,1,16,43,843
76347,76347,D5D027DEC2E15CD439B6E37A42DFD8C1,12921,1,6,5,9,41,491
76348,76348,D5D027DEC2E15CD439B6E37A42DFD8C1,43021,8,18,10,16,43,843
76349,76349,D5D027DEC2E15CD439B6E37A42DFD8C1,12921,20,21,1,9,41,491
76350,76350,D5D027DEC2E15CD439B6E37A42DFD8C1,19114,21,23,2,7,43,393
76354,76354,3473FA09F0017B3BD24476C962AE1520,13314,0,6,6,31,39,1589
76355,76355,3473FA09F0017B3BD24476C962AE1520,43451,8,10,2,37,40,1890
76356,76356,3473FA09F0017B3BD24476C962AE1520,12521,12,20,8,35,41,1791
76363,76363,4A7359FA7BA64B1676D02C2D6D6849EE,43041,0,7,7,41,46,2096
76364,76364,4A7359FA7BA64B1676D02C2D6D6849EE,40081,8,14,6,40,49,2049
76365,76365,4A7359FA7BA64B1676D02C2D6D6849EE,11081,15,17,2,35,46,1796
76366,76366,4A7359FA7BA64B1676D02C2D6D6849EE,10771,18,23,5,41,46,2096
76367,76367,E2D81C206764E3951071FC322019D398,12131,1,11,10,32,47,1647
76368,76368,E2D81C206764E3951071FC322019D398,42381,13,16,3,39,41,1991
76369,76369,E2D81C206764E3951071FC322019D398,12131,20,23,3,32,47,1647
76370,76370,CA601ED32D4DA950EA12F7A37DA37141,12221,0,8,8,43,44,2194
76371,76371,CA601ED32D4DA950EA12F7A37DA37141,10471,9,18,9,37,48,1898
76372,76372,CA601ED32D4DA950EA12F7A37DA37141,13341,18,23,5,44,45,2245
76377,76377,74D199B008B21C845B9F2DAD3116D917,43011,4,6,2,40,42,2042
76378,76378,74D199B008B21C845B9F2DAD3116D917,11481,10,11,1,41,48,2098
76379,76379,74D199B008B21C845B9F2DAD3116D917,42461,12,13,1,45,47,2297
76380,76380,74D199B008B21C845B9F2DAD3116D917,40401,15,17,2,40,46,2046
76381,76381,74D199B008B21C845B9F2DAD3116D917,11261,21,23,2,36,46,1846
76382,76382,10A422C047D598ECAC1912DEA262C9AA,42351,0,7,7,38,45,1945
76383,76383,10A422C047D598ECAC1912DEA262C9AA,11871,9,11,2,29,46,1496
76384,76384,10A422C047D598ECAC1912DEA262C9AA,13231,12,13,1,39,46,1996
76385,76385,10A422C047D598ECAC1912DEA262C9AA,11871,14,15,1,29,46,1496
76386,76386,10A422C047D598ECAC1912DEA262C9AA,10401,17,18,1,33,49,1699
76387,76387,10A422C047D598ECAC1912DEA262C9AA,42351,20,21,1,38,45,1945
76388,76388,3C5D029D57650D7A9CE83503042F1003,11261,0,2,2,36,46,1846
76389,76389,3C5D029D57650D7A9CE83503042F1003,43041,2,5,3,41,46,2096
76390,76390,3C5D029D57650D7A9CE83503042F1003,11261,6,20,14,36,46,1846
76391,76391,87B1169D5A9BB025C6A10231CEED2118,19621,1,8,7,5,46,296
76392,76392,87B1169D5A9BB025C6A10231CEED2118,11871,12,14,2,29,46,1496
76393,76393,87B1169D5A9BB025C6A10231CEED2118,11861,16,23,7,32,47,1647
76397,76397,FB4E60A8066EF2E620BED152D48328FE,11074,0,3,3,37,47,1897
76398,76398,FB4E60A8066EF2E620BED152D48328FE,42301,3,7,4,36,47,1847
76399,76399,FB4E60A8066EF2E620BED152D48328FE,11074,12,15,3,37,47,1897
76400,76400,FB4E60A8066EF2E620BED152D48328FE,42301,15,17,2,36,47,1847
76401,76401,FB4E60A8066EF2E620BED152D48328FE,11231,19,23,4,37,49,1899
76402,76402,F6265BE8D5B1D90F759154EDAB63EA2C,15191,0,15,15,36,27,1827
76403,76403,F6265BE8D5B1D90F759154EDAB63EA2C,12792,15,18,3,34,30,1730
76404,76404,F6265BE8D5B1D90F759154EDAB63EA2C,15191,19,23,4,36,27,1827
76412,76412,2FC430E1448F290A8E229F5C2301E320,49201,4,7,3,7,41,391
76413,76413,2FC430E1448F290A8E229F5C2301E320,12921,7,9,2,9,41,491
76414,76414,2FC430E1448F290A8E229F5C2301E320,49201,9,10,1,7,41,391
76415,76415,2FC430E1448F290A8E229F5C2301E320,12921,14,20,6,9,41,491
76416,76416,2FC430E1448F290A8E229F5C2301E320,12641,20,23,3,10,43,543
76417,76417,7BC2DF75D2B26EC2B866E065C8DEDCF9,10281,1,6,5,33,48,1698
76418,76418,7BC2DF75D2B26EC2B866E065C8DEDCF9,11861,11,12,1,32,47,1647
76419,76419,7BC2DF75D2B26EC2B866E065C8DEDCF9,10631,15,16,1,28,46,1446
76420,76420,7BC2DF75D2B26EC2B866E065C8DEDCF9,11861,19,23,4,32,47,1647
76424,76424,F7F6E311089E545E2ADE21E1CFF4D206,42523,2,4,2,31,47,1597
76425,76425,F7F6E311089E545E2ADE21E1CFF4D206,43761,5,8,3,32,47,1647
76426,76426,F7F6E311089E545E2ADE21E1CFF4D206,42523,8,9,1,31,47,1597
76427,76427,F7F6E311089E545E2ADE21E1CFF4D206,42921,11,12,1,33,47,1697
76428,76428,F7F6E311089E545E2ADE21E1CFF4D206,42523,14,15,1,31,47,1597
76429,76429,F7F6E311089E545E2ADE21E1CFF4D206,43761,16,17,1,32,47,1647
76430,76430,F7F6E311089E545E2ADE21E1CFF4D206,42523,17,18,1,31,47,1597
76431,76431,F7F6E311089E545E2ADE21E1CFF4D206,43761,19,21,2,32,47,1647
76435,76435,1658E318B68367B87E9D322B1062FD51,11021,0,3,3,36,49,1849
76436,76436,1658E318B68367B87E9D322B1062FD51,42961,3,4,1,35,49,1799
76437,76437,1658E318B68367B87E9D322B1062FD51,11021,4,16,12,36,49,1849
76438,76438,1658E318B68367B87E9D322B1062FD51,10401,17,18,1,33,49,1699
76439,76439,1658E318B68367B87E9D322B1062FD51,11021,19,23,4,36,49,1849
76446,76446,0CEB068CD8F6DE0F248818A089746305,42961,0,7,7,35,49,1799
76447,76447,0CEB068CD8F6DE0F248818A089746305,11021,9,11,2,36,49,1849
76448,76448,0CEB068CD8F6DE0F248818A089746305,13561,12,13,1,37,49,1899
76449,76449,0CEB068CD8F6DE0F248818A089746305,11021,13,18,5,36,49,1849
76450,76450,0CEB068CD8F6DE0F248818A089746305,42961,19,23,4,35,49,1799
76451,76451,45375B2FC2B675D0C3BEBD094547B8BA,11111,1,2,1,26,48,1348
76452,76452,45375B2FC2B675D0C3BEBD094547B8BA,42541,6,7,1,25,47,1297
76453,76453,45375B2FC2B675D0C3BEBD094547B8BA,11111,9,10,1,26,48,1348
76454,76454,45375B2FC2B675D0C3BEBD094547B8BA,10471,12,17,5,37,48,1898
76455,76455,45375B2FC2B675D0C3BEBD094547B8BA,11231,18,20,2,37,49,1899
76456,76456,45375B2FC2B675D0C3BEBD094547B8BA,10471,20,23,3,37,48,1898
76466,76466,DF9AD5AC0E4BE326A72BA327D1A40B9F,42401,0,7,7,36,47,1847
76467,76467,DF9AD5AC0E4BE326A72BA327D1A40B9F,42691,8,17,9,24,48,1248
76468,76468,DF9AD5AC0E4BE326A72BA327D1A40B9F,43161,19,20,1,35,47,1797
76469,76469,DF9AD5AC0E4BE326A72BA327D1A40B9F,42161,21,23,2,36,47,1847
76470,76470,DB5F58C0BF92D33E406DDC1B3C9B82ED,10161,0,6,6,35,49,1799
76471,76471,DB5F58C0BF92D33E406DDC1B3C9B82ED,10716,8,16,8,30,46,1546
76472,76472,DB5F58C0BF92D33E406DDC1B3C9B82ED,10161,18,23,5,35,49,1799
76473,76473,DF5678A2D82F170D018446CB4502486B,12083,0,8,8,36,49,1849
76474,76474,DF5678A2D82F170D018446CB4502486B,12971,12,17,5,32,48,1648
76475,76475,DF5678A2D82F170D018446CB4502486B,12083,18,23,5,36,49,1849
76479,76479,47C1473BA4462B22BD05E79B53CFA190,11471,0,3,3,12,48,648
76480,76480,47C1473BA4462B22BD05E79B53CFA190,42041,5,10,5,10,47,547
76481,76481,47C1473BA4462B22BD05E79B53CFA190,19441,11,13,2,8,46,446
76482,76482,47C1473BA4462B22BD05E79B53CFA190,11571,15,20,5,13,46,696
76489,76489,918239D4EE1CD24F89734D8227B4B571,42161,0,15,15,36,47,1847
76490,76490,918239D4EE1CD24F89734D8227B4B571,12121,16,19,3,29,47,1497
76491,76491,918239D4EE1CD24F89734D8227B4B571,42161,21,23,2,36,47,1847
76492,76492,D96201B04F49DA8FE5B344343C2EC845,10281,1,2,1,33,48,1698
76493,76493,D96201B04F49DA8FE5B344343C2EC845,11861,3,7,4,32,47,1647
76494,76494,D96201B04F49DA8FE5B344343C2EC845,42151,8,10,2,35,45,1795
76495,76495,D96201B04F49DA8FE5B344343C2EC845,11941,16,18,2,37,46,1896
76496,76496,D96201B04F49DA8FE5B344343C2EC845,11861,19,22,3,32,47,1647
76497,76497,C173E680DFAEC165B5B7AE7346539D93,10621,0,8,8,41,49,2099
76498,76498,C173E680DFAEC165B5B7AE7346539D93,11201,12,15,3,35,49,1799
76499,76499,C173E680DFAEC165B5B7AE7346539D93,10221,15,16,1,34,49,1749
76500,76500,C173E680DFAEC165B5B7AE7346539D93,10621,21,23,2,41,49,2099
76505,76505,2916241B5CF00CB7D0E32D04803F7949,11061,3,9,6,29,48,1498
76506,76506,2916241B5CF00CB7D0E32D04803F7949,40341,11,15,4,23,49,1199
76507,76507,2916241B5CF00CB7D0E32D04803F7949,11151,15,18,3,30,48,1548
76508,76508,2916241B5CF00CB7D0E32D04803F7949,40094,18,20,2,29,48,1498
76509,76509,2916241B5CF00CB7D0E32D04803F7949,11151,20,23,3,30,48,1548
76510,76510,9397083C419903E30A62F5C06D299D5C,42381,0,5,5,39,41,1991
76511,76511,9397083C419903E30A62F5C06D299D5C,42151,7,10,3,35,45,1795
76512,76512,9397083C419903E30A62F5C06D299D5C,13071,12,14,2,41,41,2091
76513,76513,9397083C419903E30A62F5C06D299D5C,42151,14,16,2,35,45,1795
76514,76514,9397083C419903E30A62F5C06D299D5C,43451,18,20,2,37,40,1890
76524,76524,7C2E283820C8F80F7B539E1DEA95DAFD,40833,0,2,2,41,47,2097
76525,76525,7C2E283820C8F80F7B539E1DEA95DAFD,13101,3,7,4,40,47,2047
76526,76526,7C2E283820C8F80F7B539E1DEA95DAFD,11021,9,22,13,36,49,1849
76527,76527,CADE9ADEC7B1B2F6454293174DEADF86,10681,0,7,7,30,48,1548
76528,76528,CADE9ADEC7B1B2F6454293174DEADF86,10151,11,12,1,34,47,1747
76529,76529,CADE9ADEC7B1B2F6454293174DEADF86,11151,12,14,2,30,48,1548
76530,76530,CADE9ADEC7B1B2F6454293174DEADF86,11531,15,17,2,34,49,1749
76531,76531,CADE9ADEC7B1B2F6454293174DEADF86,11151,18,23,5,30,48,1548
76535,76535,119B132FD4B5F51AE9D240B79199620C,11021,0,6,6,36,49,1849
76536,76536,119B132FD4B5F51AE9D240B79199620C,16261,10,13,3,3,3,153
76537,76537,119B132FD4B5F51AE9D240B79199620C,11541,16,17,1,35,49,1799
76538,76538,119B132FD4B5F51AE9D240B79199620C,42511,18,20,2,37,47,1897
76539,76539,119B132FD4B5F51AE9D240B79199620C,11541,21,23,2,35,49,1799
76540,76540,AAED9BE930876CCFBFDFA351B63D61EF,40891,0,10,10,37,47,1897
76541,76541,AAED9BE930876CCFBFDFA351B63D61EF,42091,11,15,4,43,46,2196
76542,76542,AAED9BE930876CCFBFDFA351B63D61EF,11801,15,17,2,42,48,2148
76543,76543,AAED9BE930876CCFBFDFA351B63D61EF,12481,18,22,4,37,49,1899
76547,76547,DE7A331A2ADB65AF4D6289538234B91E,12514,0,1,1,38,47,1947
76548,76548,DE7A331A2ADB65AF4D6289538234B91E,42941,2,9,7,37,47,1897
76549,76549,DE7A331A2ADB65AF4D6289538234B91E,11794,10,12,2,38,49,1949
76550,76550,DE7A331A2ADB65AF4D6289538234B91E,13231,19,20,1,39,46,1996
76551,76551,DE7A331A2ADB65AF4D6289538234B91E,42631,21,22,1,43,45,2195
76552,76552,FAA2A83085DED75B2B76B1A263011697,11061,0,9,9,29,48,1498
76553,76553,FAA2A83085DED75B2B76B1A263011697,11381,9,12,3,30,47,1547
76554,76554,FAA2A83085DED75B2B76B1A263011697,10951,12,13,1,29,48,1498
76555,76555,FAA2A83085DED75B2B76B1A263011697,11381,13,15,2,30,47,1547
76556,76556,FAA2A83085DED75B2B76B1A263011697,10951,16,23,7,29,48,1498
76563,76563,A53DAA006542212C0F792E33874BF547,11661,1,12,11,40,49,2049
76564,76564,A53DAA006542212C0F792E33874BF547,42161,14,18,4,36,47,1847
76565,76565,A53DAA006542212C0F792E33874BF547,11331,21,22,1,37,48,1898
76566,76566,4568F4CB3839A063AA85BE5AD656F1DE,10901,0,1,1,35,48,1798
76567,76567,4568F4CB3839A063AA85BE5AD656F1DE,12161,10,17,7,32,46,1646
76568,76568,4568F4CB3839A063AA85BE5AD656F1DE,11201,19,22,3,35,49,1799
76569,76569,05F5E1C40665B68C77ECAABF0F951B28,11751,0,6,6,35,48,1798
76570,76570,05F5E1C40665B68C77ECAABF0F951B28,11231,7,8,1,37,49,1899
76571,76571,05F5E1C40665B68C77ECAABF0F951B28,11751,12,15,3,35,48,1798
76572,76572,05F5E1C40665B68C77ECAABF0F951B28,42981,17,18,1,36,49,1849
76573,76573,05F5E1C40665B68C77ECAABF0F951B28,11753,21,22,1,35,48,1798
76588,76588,D8190C5AEF802F660361781E1849508A,42021,2,9,7,33,47,1697
76589,76589,D8190C5AEF802F660361781E1849508A,12021,12,16,4,37,49,1899
76590,76590,D8190C5AEF802F660361781E1849508A,11861,18,21,3,32,47,1647
76591,76591,B16AADC70667F1407A8020F9E0E0F89A,11921,0,5,5,38,48,1948
76592,76592,B16AADC70667F1407A8020F9E0E0F89A,43761,5,16,11,32,47,1647
76593,76593,B16AADC70667F1407A8020F9E0E0F89A,11921,18,23,5,38,48,1948
76601,76601,C2B92341A150D31E9AED29A86CE688BB,40801,6,14,8,43,46,2196
76602,76602,C2B92341A150D31E9AED29A86CE688BB,11861,15,16,1,32,47,1647
76603,76603,C2B92341A150D31E9AED29A86CE688BB,42204,18,20,2,43,46,2196
76614,76614,5262ABE790766FD3345CF84BDACCA78B,43391,0,8,8,29,48,1498
76615,76615,5262ABE790766FD3345CF84BDACCA78B,10211,8,10,2,16,49,849
76616,76616,5262ABE790766FD3345CF84BDACCA78B,11061,12,19,7,29,48,1498
76617,76617,181802B57A29F4FAE1E7EF60B334A9D5,13911,0,6,6,39,46,1996
76618,76618,181802B57A29F4FAE1E7EF60B334A9D5,42231,10,11,1,37,46,1896
76619,76619,181802B57A29F4FAE1E7EF60B334A9D5,13911,12,13,1,39,46,1996
76620,76620,181802B57A29F4FAE1E7EF60B334A9D5,10601,15,16,1,39,47,1997
76621,76621,181802B57A29F4FAE1E7EF60B334A9D5,13911,17,23,6,39,46,1996
76628,76628,33DCEB99733F5490EC3E4641096F98E9,11861,0,8,8,32,47,1647
76629,76629,33DCEB99733F5490EC3E4641096F98E9,42861,9,15,6,37,44,1894
76630,76630,33DCEB99733F5490EC3E4641096F98E9,13491,19,23,4,48,39,2439
76631,76631,3BE46C14B2CA2CE1D859CAF16A631486,13341,0,6,6,44,45,2245
76632,76632,3BE46C14B2CA2CE1D859CAF16A631486,43951,8,9,1,49,41,2491
76633,76633,3BE46C14B2CA2CE1D859CAF16A631486,13341,12,23,11,44,45,2245
76634,76634,454A0AB6A7ADBC9F5D76E05824AC7428,13331,0,15,15,38,47,1947
76635,76635,454A0AB6A7ADBC9F5D76E05824AC7428,40341,16,18,2,23,49,1199
76636,76636,454A0AB6A7ADBC9F5D76E05824AC7428,10841,19,23,4,37,47,1897
76637,76637,BF3354E7653978B437BDBF5412A04932,12871,1,3,2,22,33,1133
76638,76638,BF3354E7653978B437BDBF5412A04932,19281,6,16,10,16,32,832
76639,76639,BF3354E7653978B437BDBF5412A04932,12871,17,22,5,22,33,1133
76643,76643,B9BA9C4A9A58FB97E9FBCEF8809D76A7,12921,0,6,6,9,41,491
76644,76644,B9BA9C4A9A58FB97E9FBCEF8809D76A7,10221,10,18,8,34,49,1749
76645,76645,B9BA9C4A9A58FB97E9FBCEF8809D76A7,42041,20,21,1,10,47,547
76650,76650,DAF070E37522449552E837969D087804,11171,0,6,6,33,48,1698
76651,76651,DAF070E37522449552E837969D087804,11231,6,10,4,37,49,1899
76652,76652,DAF070E37522449552E837969D087804,10691,12,13,1,33,48,1698
76653,76653,DAF070E37522449552E837969D087804,11231,14,18,4,37,49,1899
76654,76654,DAF070E37522449552E837969D087804,10491,19,23,4,33,48,1698
76659,76659,0DCD9EEA776860D0621554B5A42521A4,11061,2,9,7,29,48,1498
76660,76660,0DCD9EEA776860D0621554B5A42521A4,10681,9,11,2,30,48,1548
76661,76661,0DCD9EEA776860D0621554B5A42521A4,42381,13,14,1,39,41,1991
76662,76662,0DCD9EEA776860D0621554B5A42521A4,11061,15,19,4,29,48,1498
76663,76663,0DCD9EEA776860D0621554B5A42521A4,10681,20,22,2,30,48,1548
76664,76664,9729C2FE4690399ACEF479C94EF132C8,42204,0,16,16,43,46,2196
76665,76665,9729C2FE4690399ACEF479C94EF132C8,10221,18,20,2,34,49,1749
76666,76666,9729C2FE4690399ACEF479C94EF132C8,13601,20,21,1,34,47,1747
76673,76673,280A825D237E9CE7CB403628403E758B,42351,4,8,4,38,45,1945
76674,76674,280A825D237E9CE7CB403628403E758B,11261,8,9,1,36,46,1846
76675,76675,280A825D237E9CE7CB403628403E758B,13911,9,11,2,39,46,1996
76676,76676,280A825D237E9CE7CB403628403E758B,42351,14,15,1,38,45,1945
76677,76677,280A825D237E9CE7CB403628403E758B,13911,19,20,1,39,46,1996
76678,76678,6CBBEE1C450344F3879ED38C16F213C4,12051,1,6,5,20,47,1047
76679,76679,6CBBEE1C450344F3879ED38C16F213C4,43751,8,10,2,19,48,998
76680,76680,6CBBEE1C450344F3879ED38C16F213C4,12051,11,14,3,20,47,1047
76681,76681,6CBBEE1C450344F3879ED38C16F213C4,42481,14,19,5,22,49,1149
76682,76682,6CBBEE1C450344F3879ED38C16F213C4,12581,20,21,1,24,48,1248
76683,76683,FD9B51E8CCBFA50A0161A8BE1570DE0A,12491,0,5,5,36,43,1843
76684,76684,FD9B51E8CCBFA50A0161A8BE1570DE0A,43451,7,10,3,37,40,1890
76685,76685,FD9B51E8CCBFA50A0161A8BE1570DE0A,42864,14,18,4,38,44,1944
76686,76686,FD9B51E8CCBFA50A0161A8BE1570DE0A,43011,21,22,1,40,42,2042
76687,76687,DC55487259997B32C5BA24A9732036BD,42204,0,1,1,43,46,2196
76688,76688,DC55487259997B32C5BA24A9732036BD,13681,3,11,8,38,47,1947
76689,76689,DC55487259997B32C5BA24A9732036BD,42031,12,13,1,40,46,2046
76690,76690,DC55487259997B32C5BA24A9732036BD,13711,15,23,8,38,46,1946
76691,76691,518D5FA443BE4CD4AC0BE1EE454FCBAE,12661,0,10,10,32,45,1645
76692,76692,518D5FA443BE4CD4AC0BE1EE454FCBAE,10251,13,16,3,35,47,1797
76693,76693,518D5FA443BE4CD4AC0BE1EE454FCBAE,12661,19,23,4,32,45,1645
76697,76697,DAA52A1FF1BAD1BE2A77C6FAB2A03510,42201,0,12,12,43,46,2196
76698,76698,DAA52A1FF1BAD1BE2A77C6FAB2A03510,13341,15,17,2,44,45,2245
76699,76699,DAA52A1FF1BAD1BE2A77C6FAB2A03510,10107,18,19,1,38,49,1949
76700,76700,B07F9654999A27B565B093B7A4D6A968,13651,0,7,7,30,47,1547
76701,76701,B07F9654999A27B565B093B7A4D6A968,11021,8,16,8,36,49,1849
76702,76702,B07F9654999A27B565B093B7A4D6A968,11384,21,23,2,30,47,1547
76707,76707,D26FC6705F51E1D0FCC95F0A302B25B6,42161,0,8,8,36,47,1847
76708,76708,D26FC6705F51E1D0FCC95F0A302B25B6,42204,8,10,2,43,46,2196
76709,76709,D26FC6705F51E1D0FCC95F0A302B25B6,13111,10,18,8,42,46,2146
76710,76710,D26FC6705F51E1D0FCC95F0A302B25B6,42161,18,23,5,36,47,1847
76711,76711,4939079DBC41D72C03B48C02C72AD37E,43021,0,13,13,16,43,843
76712,76712,4939079DBC41D72C03B48C02C72AD37E,12921,15,17,2,9,41,491
76713,76713,4939079DBC41D72C03B48C02C72AD37E,43021,18,19,1,16,43,843
76714,76714,81C892F4C735FEF892157743AFC50956,43241,4,5,1,36,46,1846
76715,76715,81C892F4C735FEF892157743AFC50956,10221,8,17,9,34,49,1749
76716,76716,81C892F4C735FEF892157743AFC50956,13711,21,23,2,38,46,1946
76717,76717,37385E5852F0E8B9BD379DD12A67AD23,10491,0,7,7,33,48,1698
76718,76718,37385E5852F0E8B9BD379DD12A67AD23,43621,13,14,1,46,48,2348
76719,76719,37385E5852F0E8B9BD379DD12A67AD23,11201,15,19,4,35,49,1799
76720,76720,37385E5852F0E8B9BD379DD12A67AD23,10491,20,23,3,33,48,1698
76724,76724,29ED7585A7C0FD6B2E71E72A2B2372DE,12311,0,5,5,30,44,1544
76725,76725,29ED7585A7C0FD6B2E71E72A2B2372DE,11081,8,17,9,35,46,1796
76726,76726,29ED7585A7C0FD6B2E71E72A2B2372DE,12311,22,23,1,30,44,1544
76727,76727,57068447BEEE4D7969FF166D57966ECA,42541,0,6,6,25,47,1297
76728,76728,57068447BEEE4D7969FF166D57966ECA,12581,7,8,1,24,48,1248
76729,76729,57068447BEEE4D7969FF166D57966ECA,11361,8,11,3,22,48,1148
76730,76730,57068447BEEE4D7969FF166D57966ECA,42541,12,13,1,25,47,1297
76731,76731,57068447BEEE4D7969FF166D57966ECA,11361,13,16,3,22,48,1148
76732,76732,57068447BEEE4D7969FF166D57966ECA,10171,18,19,1,26,47,1347
76733,76733,57068447BEEE4D7969FF166D57966ECA,42541,21,23,2,25,47,1297
76734,76734,78520B675436202D640A52F7BAC3D2C7,12792,0,4,4,34,30,1730
76735,76735,78520B675436202D640A52F7BAC3D2C7,15391,8,9,1,35,26,1776
76736,76736,78520B675436202D640A52F7BAC3D2C7,12792,11,12,1,34,30,1730
76737,76737,78520B675436202D640A52F7BAC3D2C7,15391,16,17,1,35,26,1776
76738,76738,78520B675436202D640A52F7BAC3D2C7,12792,18,19,1,34,30,1730
76739,76739,78520B675436202D640A52F7BAC3D2C7,15391,20,21,1,35,26,1776
76740,76740,78520B675436202D640A52F7BAC3D2C7,12792,21,23,2,34,30,1730
76765,76765,A0281A3586AC38676D52E3E8F717115A,11271,2,3,1,37,48,1898
76766,76766,A0281A3586AC38676D52E3E8F717115A,42491,4,17,13,32,46,1646
76767,76767,A0281A3586AC38676D52E3E8F717115A,11861,18,22,4,32,47,1647
76774,76774,ABB6F382C5C4E9BFCDB8D523D5E35622,42971,0,5,5,43,49,2199
76775,76775,ABB6F382C5C4E9BFCDB8D523D5E35622,11201,10,15,5,35,49,1799
76776,76776,ABB6F382C5C4E9BFCDB8D523D5E35622,42341,18,21,3,43,49,2199
76777,76777,CEC0FA05C5F96A3EF0FB11FE437A9A15,11741,3,5,2,42,49,2149
76778,76778,CEC0FA05C5F96A3EF0FB11FE437A9A15,10621,5,7,2,41,49,2099
76779,76779,CEC0FA05C5F96A3EF0FB11FE437A9A15,42201,8,16,8,43,46,2196
76780,76780,CEC0FA05C5F96A3EF0FB11FE437A9A15,13341,17,18,1,44,45,2245
76781,76781,CEC0FA05C5F96A3EF0FB11FE437A9A15,10921,19,23,4,43,48,2198
76782,76782,1419ED0D7B939F71AB44434138AF6A2B,11701,0,7,7,43,48,2198
76783,76783,1419ED0D7B939F71AB44434138AF6A2B,11081,9,10,1,35,46,1796
76784,76784,1419ED0D7B939F71AB44434138AF6A2B,11841,13,16,3,33,46,1696
76785,76785,1419ED0D7B939F71AB44434138AF6A2B,11741,20,22,2,42,49,2149
76789,76789,EC587A8D735A15FBFAB055D919B57FFC,43181,0,8,8,39,48,1998
76790,76790,EC587A8D735A15FBFAB055D919B57FFC,11324,13,14,1,31,46,1596
76791,76791,EC587A8D735A15FBFAB055D919B57FFC,43181,21,23,2,39,48,1998
76792,76792,1439D71C3B1C0FF45CC1AED4C666D5BA,43101,0,7,7,46,40,2340
76793,76793,1439D71C3B1C0FF45CC1AED4C666D5BA,13071,7,8,1,41,41,2091
76794,76794,1439D71C3B1C0FF45CC1AED4C666D5BA,43101,10,23,13,46,40,2340
76795,76795,F2EFFFB227AE40B8769C3DBFA6BE9264,10211,0,5,5,16,49,849
76796,76796,F2EFFFB227AE40B8769C3DBFA6BE9264,12641,8,18,10,10,43,543
76797,76797,F2EFFFB227AE40B8769C3DBFA6BE9264,10211,21,23,2,16,49,849
76798,76798,BB3DB8BDA13F245F7DA1B278DE6D4FF0,43021,0,5,5,16,43,843
76799,76799,BB3DB8BDA13F245F7DA1B278DE6D4FF0,12641,6,8,2,10,43,543
76800,76800,BB3DB8BDA13F245F7DA1B278DE6D4FF0,19741,11,12,1,5,44,294
76801,76801,BB3DB8BDA13F245F7DA1B278DE6D4FF0,12921,14,16,2,9,41,491
76802,76802,BB3DB8BDA13F245F7DA1B278DE6D4FF0,43021,20,23,3,16,43,843
76803,76803,990529BE48C6A8DFFA6A404F72B17A5A,42861,5,6,1,37,44,1894
76804,76804,990529BE48C6A8DFFA6A404F72B17A5A,11261,11,12,1,36,46,1846
76805,76805,990529BE48C6A8DFFA6A404F72B17A5A,42861,14,17,3,37,44,1894
76806,76806,990529BE48C6A8DFFA6A404F72B17A5A,11261,18,19,1,36,46,1846
76807,76807,990529BE48C6A8DFFA6A404F72B17A5A,42861,21,22,1,37,44,1894
76808,76808,6C7DE4B4696563CBDA9D3C6E4FCAB652,10341,0,7,7,31,47,1597
76809,76809,6C7DE4B4696563CBDA9D3C6E4FCAB652,10292,8,9,1,30,47,1547
76810,76810,6C7DE4B4696563CBDA9D3C6E4FCAB652,10431,12,14,2,33,49,1699
76811,76811,6C7DE4B4696563CBDA9D3C6E4FCAB652,10292,15,19,4,30,47,1547
76812,76812,6C7DE4B4696563CBDA9D3C6E4FCAB652,10341,19,23,4,31,47,1597
76813,76813,8B162D826614AE6B0D3DB5A304485836,11771,0,7,7,39,49,1999
76814,76814,8B162D826614AE6B0D3DB5A304485836,42581,8,11,3,38,48,1948
76815,76815,8B162D826614AE6B0D3DB5A304485836,11914,16,17,1,37,48,1898
76816,76816,8B162D826614AE6B0D3DB5A304485836,42581,17,19,2,38,48,1948
76817,76817,8B162D826614AE6B0D3DB5A304485836,40951,22,23,1,36,49,1849
76818,76818,466DCF1406EFBC3DC226AF4CB46068CC,19181,2,3,1,8,40,440
76819,76819,466DCF1406EFBC3DC226AF4CB46068CC,12921,4,5,1,9,41,491
76820,76820,466DCF1406EFBC3DC226AF4CB46068CC,12641,6,11,5,10,43,543
76821,76821,466DCF1406EFBC3DC226AF4CB46068CC,12921,14,15,1,9,41,491
76822,76822,466DCF1406EFBC3DC226AF4CB46068CC,12641,18,19,1,10,43,543
76823,76823,466DCF1406EFBC3DC226AF4CB46068CC,19181,21,22,1,8,40,440
76827,76827,C415343168773013C92CA13C873C9F99,15441,0,6,6,44,20,2220
76828,76828,C415343168773013C92CA13C873C9F99,12881,8,10,2,47,22,2372
76829,76829,C415343168773013C92CA13C873C9F99,15441,10,16,6,44,20,2220
76830,76830,C415343168773013C92CA13C873C9F99,10301,20,21,1,31,45,1595
76831,76831,16C2E43A00B37B1C1161B5674AF5103F,11151,0,5,5,30,48,1548
76832,76832,16C2E43A00B37B1C1161B5674AF5103F,42831,5,8,3,27,48,1398
76833,76833,16C2E43A00B37B1C1161B5674AF5103F,11151,10,18,8,30,48,1548
76834,76834,16C2E43A00B37B1C1161B5674AF5103F,10381,19,21,2,31,49,1599
76835,76835,16C2E43A00B37B1C1161B5674AF5103F,42831,21,22,1,27,48,1398
76839,76839,4668498322059FDBAD6E4D56B28B3D41,42204,0,2,2,43,46,2196
76840,76840,4668498322059FDBAD6E4D56B28B3D41,42461,2,5,3,45,47,2297
76841,76841,4668498322059FDBAD6E4D56B28B3D41,12211,7,8,1,41,44,2094
76842,76842,4668498322059FDBAD6E4D56B28B3D41,13341,11,16,5,44,45,2245
76843,76843,4668498322059FDBAD6E4D56B28B3D41,12141,20,23,3,42,45,2145
76844,76844,AFC788C6238BB87E2DB00138DF78071F,11061,10,12,2,29,48,1498
76845,76845,AFC788C6238BB87E2DB00138DF78071F,11381,13,16,3,30,47,1547
76846,76846,AFC788C6238BB87E2DB00138DF78071F,11631,19,20,1,12,49,649
76847,76847,035C706F54B01406243EA0D88773BC39,42071,4,5,1,31,49,1599
76848,76848,035C706F54B01406243EA0D88773BC39,42151,6,11,5,35,45,1795
76849,76849,035C706F54B01406243EA0D88773BC39,11834,12,17,5,32,45,1645
76850,76850,035C706F54B01406243EA0D88773BC39,42623,18,21,3,22,49,1149
76851,76851,035C706F54B01406243EA0D88773BC39,11834,22,23,1,32,45,1645
76855,76855,0C6F299849FC2AE726FA95F83B756CC5,12311,1,6,5,30,44,1544
76856,76856,0C6F299849FC2AE726FA95F83B756CC5,10531,11,16,5,34,46,1746
76857,76857,0C6F299849FC2AE726FA95F83B756CC5,12311,20,22,2,30,44,1544
76858,76858,C1A86408F22C4A96CA9DED3C9439B426,10721,0,8,8,31,48,1598
76859,76859,C1A86408F22C4A96CA9DED3C9439B426,10621,9,12,3,41,49,2099
76860,76860,C1A86408F22C4A96CA9DED3C9439B426,10721,16,23,7,31,48,1598
76861,76861,8BA18E97407504A64FBC0BC02C038518,11861,0,10,10,32,47,1647
76862,76862,8BA18E97407504A64FBC0BC02C038518,10634,12,13,1,27,45,1395
76863,76863,8BA18E97407504A64FBC0BC02C038518,11861,14,17,3,32,47,1647
76864,76864,8BA18E97407504A64FBC0BC02C038518,40341,19,22,3,23,49,1199
76865,76865,6C0E63633E14241C90D0D6963F271BA0,10451,1,5,4,25,48,1298
76866,76866,6C0E63633E14241C90D0D6963F271BA0,42261,9,16,7,25,49,1299
76867,76867,6C0E63633E14241C90D0D6963F271BA0,42321,18,20,2,43,47,2197
76868,76868,CA7675D4504FF649E5D3C79C1D770D57,10161,0,6,6,35,49,1799
76869,76869,CA7675D4504FF649E5D3C79C1D770D57,11151,6,17,11,30,48,1548
76870,76870,CA7675D4504FF649E5D3C79C1D770D57,10901,19,23,4,35,48,1798
76871,76871,EF7EE9F0825E500C83748044E0BD2521,13651,0,7,7,30,47,1547
76872,76872,EF7EE9F0825E500C83748044E0BD2521,19021,9,13,4,10,45,545
76873,76873,EF7EE9F0825E500C83748044E0BD2521,13651,15,23,8,30,47,1547
76874,76874,370BEBFAF0F07D0E48A05EAAA57C2ED7,42141,0,6,6,32,47,1647
76875,76875,370BEBFAF0F07D0E48A05EAAA57C2ED7,10634,10,11,1,27,45,1395
76876,76876,370BEBFAF0F07D0E48A05EAAA57C2ED7,11841,16,17,1,33,46,1696
76877,76877,370BEBFAF0F07D0E48A05EAAA57C2ED7,42141,18,20,2,32,47,1647
76888,76888,A50768F5EA25A7EF3C7F0188FC3F5CF0,42864,0,5,5,38,44,1944
76889,76889,A50768F5EA25A7EF3C7F0188FC3F5CF0,11261,9,12,3,36,46,1846
76890,76890,A50768F5EA25A7EF3C7F0188FC3F5CF0,42864,12,17,5,38,44,1944
76891,76891,A50768F5EA25A7EF3C7F0188FC3F5CF0,10951,18,20,2,29,48,1498
76892,76892,A50768F5EA25A7EF3C7F0188FC3F5CF0,42864,21,23,2,38,44,1944
76910,76910,3ADB299BD8D4131EBFB9A6797BFD5FC4,40891,0,8,8,37,47,1897
76911,76911,3ADB299BD8D4131EBFB9A6797BFD5FC4,41101,9,10,1,32,48,1648
76912,76912,3ADB299BD8D4131EBFB9A6797BFD5FC4,10841,13,21,8,37,47,1897
76916,76916,566A98F570A1628E8F6EFD9CFCC9370E,12491,0,6,6,36,43,1843
76917,76917,566A98F570A1628E8F6EFD9CFCC9370E,12661,8,9,1,32,45,1645
76918,76918,566A98F570A1628E8F6EFD9CFCC9370E,13911,10,12,2,39,46,1996
76919,76919,566A98F570A1628E8F6EFD9CFCC9370E,12661,13,15,2,32,45,1645
76920,76920,566A98F570A1628E8F6EFD9CFCC9370E,12491,16,18,2,36,43,1843
76930,76930,97EED02186157B67ACCA35C5CC13851D,10531,1,3,2,34,46,1746
76931,76931,97EED02186157B67ACCA35C5CC13851D,10781,5,7,2,35,47,1797
76932,76932,97EED02186157B67ACCA35C5CC13851D,13561,9,11,2,37,49,1899
76933,76933,97EED02186157B67ACCA35C5CC13851D,42161,13,14,1,36,47,1847
76934,76934,97EED02186157B67ACCA35C5CC13851D,10511,15,20,5,35,46,1796
76935,76935,94208362745F4CC8136A1624AA480486,10161,0,8,8,35,49,1799
76936,76936,94208362745F4CC8136A1624AA480486,10901,8,12,4,35,48,1798
76937,76937,94208362745F4CC8136A1624AA480486,42961,13,15,2,35,49,1799
76938,76938,94208362745F4CC8136A1624AA480486,10901,17,18,1,35,48,1798
76939,76939,94208362745F4CC8136A1624AA480486,10161,20,23,3,35,49,1799
76940,76940,B2E9EB4FBE28B9C5A56B880AF4AAF8A4,13941,0,8,8,41,47,2097
76941,76941,B2E9EB4FBE28B9C5A56B880AF4AAF8A4,12514,12,14,2,38,47,1947
76942,76942,B2E9EB4FBE28B9C5A56B880AF4AAF8A4,43341,14,16,2,41,46,2096
76943,76943,B2E9EB4FBE28B9C5A56B880AF4AAF8A4,43061,17,19,2,43,46,2196
76944,76944,B2E9EB4FBE28B9C5A56B880AF4AAF8A4,43341,20,22,2,41,46,2096
76961,76961,CFD93627421704B95BA6C178AD3FAE72,13314,0,8,8,31,39,1589
76962,76962,CFD93627421704B95BA6C178AD3FAE72,42851,9,20,11,35,41,1791
76963,76963,CFD93627421704B95BA6C178AD3FAE72,43451,20,22,2,37,40,1890
76964,76964,AB57CFBC7FBBD1B4F46C04046F726522,15021,6,8,2,46,18,2318
76965,76965,AB57CFBC7FBBD1B4F46C04046F726522,12881,10,20,10,47,22,2372
76966,76966,AB57CFBC7FBBD1B4F46C04046F726522,15171,21,23,2,42,21,2121
76973,76973,9F589AB01E58B6B2CA9FB997F96CB7F3,13071,0,5,5,41,41,2091
76974,76974,9F589AB01E58B6B2CA9FB997F96CB7F3,43451,7,9,2,37,40,1890
76975,76975,9F589AB01E58B6B2CA9FB997F96CB7F3,42381,11,13,2,39,41,1991
76976,76976,9F589AB01E58B6B2CA9FB997F96CB7F3,43451,13,20,7,37,40,1890
76991,76991,33803892E5EBC88C51949944D928CD97,42531,2,17,15,31,45,1595
76992,76992,33803892E5EBC88C51949944D928CD97,11011,19,20,1,39,49,1999
76993,76993,33803892E5EBC88C51949944D928CD97,11231,20,23,3,37,49,1899
77001,77001,D7D53B57483FC76EE9BE7304C6EB5CA5,42221,4,5,1,38,48,1948
77002,77002,D7D53B57483FC76EE9BE7304C6EB5CA5,42541,8,16,8,25,47,1297
77003,77003,D7D53B57483FC76EE9BE7304C6EB5CA5,11074,19,23,4,37,47,1897
77007,77007,A0CBA1B5D44CEC79D38275A8B2F36826,15551,0,7,7,24,1,1201
77008,77008,A0CBA1B5D44CEC79D38275A8B2F36826,10471,12,15,3,37,48,1898
77009,77009,A0CBA1B5D44CEC79D38275A8B2F36826,10111,17,20,3,37,47,1897
77010,77010,36E4D456967ADF7C503C23EAE8460AAD,13651,4,5,1,30,47,1547
77011,77011,36E4D456967ADF7C503C23EAE8460AAD,42523,7,8,1,31,47,1597
77012,77012,36E4D456967ADF7C503C23EAE8460AAD,13651,8,9,1,30,47,1547
77013,77013,36E4D456967ADF7C503C23EAE8460AAD,42523,9,15,6,31,47,1597
77014,77014,36E4D456967ADF7C503C23EAE8460AAD,13651,16,17,1,30,47,1547
77015,77015,36E4D456967ADF7C503C23EAE8460AAD,42521,18,22,4,31,47,1597
77016,77016,470BE60325DA2FBBD1F75F1607157E14,12521,0,15,15,35,41,1791
77017,77017,470BE60325DA2FBBD1F75F1607157E14,13314,15,17,2,31,39,1589
77018,77018,470BE60325DA2FBBD1F75F1607157E14,12521,17,23,6,35,41,1791
77023,77023,C4A46EA5408AA16A0ED0D09924B79885,10221,0,8,8,34,49,1749
77024,77024,C4A46EA5408AA16A0ED0D09924B79885,13511,12,14,2,34,48,1748
77025,77025,C4A46EA5408AA16A0ED0D09924B79885,12841,19,21,2,37,47,1897
77026,77026,C4A46EA5408AA16A0ED0D09924B79885,10221,22,23,1,34,49,1749
77033,77033,05DB08AFAEA6B1FFF1B9BBD7B1A29A93,10411,0,7,7,36,48,1848
77034,77034,05DB08AFAEA6B1FFF1B9BBD7B1A29A93,43671,8,9,1,35,48,1798
77035,77035,05DB08AFAEA6B1FFF1B9BBD7B1A29A93,13371,13,17,4,41,47,2097
77036,77036,05DB08AFAEA6B1FFF1B9BBD7B1A29A93,10411,20,21,1,36,48,1848
77037,77037,81A0883CA81DEC4574101FE202DF4E6A,10107,0,11,11,38,49,1949
77038,77038,81A0883CA81DEC4574101FE202DF4E6A,12921,14,16,2,9,41,491
77039,77039,81A0883CA81DEC4574101FE202DF4E6A,10691,20,21,1,33,48,1698
77057,77057,7FC20F0A7A8C59E7754FF95E5BEB796B,42301,0,5,5,36,47,1847
77058,77058,7FC20F0A7A8C59E7754FF95E5BEB796B,11261,6,16,10,36,46,1846
77059,77059,7FC20F0A7A8C59E7754FF95E5BEB796B,13911,16,18,2,39,46,1996
77060,77060,7FC20F0A7A8C59E7754FF95E5BEB796B,11261,18,20,2,36,46,1846
77061,77061,7FC20F0A7A8C59E7754FF95E5BEB796B,42301,21,23,2,36,47,1847
77062,77062,76FF38FC27F3BB794CD370CF611CF8FB,13094,0,5,5,21,42,1092
77063,77063,76FF38FC27F3BB794CD370CF611CF8FB,10351,7,8,1,28,45,1445
77064,77064,76FF38FC27F3BB794CD370CF611CF8FB,10634,11,12,1,27,45,1395
77065,77065,76FF38FC27F3BB794CD370CF611CF8FB,10351,17,18,1,28,45,1445
77066,77066,76FF38FC27F3BB794CD370CF611CF8FB,12601,18,19,1,25,47,1297
77067,77067,76FF38FC27F3BB794CD370CF611CF8FB,10351,19,23,4,28,45,1445
77068,77068,DFA44588B9F7612E59AB24A1351E5F4F,12921,1,3,2,9,41,491
77069,77069,DFA44588B9F7612E59AB24A1351E5F4F,49201,4,7,3,7,41,391
77070,77070,DFA44588B9F7612E59AB24A1351E5F4F,12921,11,13,2,9,41,491
77071,77071,DFA44588B9F7612E59AB24A1351E5F4F,49201,14,18,4,7,41,391
77072,77072,DFA44588B9F7612E59AB24A1351E5F4F,11631,21,23,2,12,49,649
77086,77086,3B843905DBA028028A69F37DCACAA60A,11571,0,4,4,13,46,696
77087,77087,3B843905DBA028028A69F37DCACAA60A,19441,4,5,1,8,46,446
77088,77088,3B843905DBA028028A69F37DCACAA60A,10211,6,7,1,16,49,849
77089,77089,3B843905DBA028028A69F37DCACAA60A,19441,8,23,15,8,46,446
77090,77090,5CBF1A96FBD01E1BC7D10DDBD646A0C6,10371,0,15,15,37,49,1899
77091,77091,5CBF1A96FBD01E1BC7D10DDBD646A0C6,40341,18,21,3,23,49,1199
77092,77092,5CBF1A96FBD01E1BC7D10DDBD646A0C6,10371,21,23,2,37,49,1899
77100,77100,09C2A5500F5ABAEEAC932C07F5628EC4,11021,1,8,7,36,49,1849
77101,77101,09C2A5500F5ABAEEAC932C07F5628EC4,43161,8,12,4,35,47,1797
77102,77102,09C2A5500F5ABAEEAC932C07F5628EC4,11021,12,13,1,36,49,1849
77103,77103,09C2A5500F5ABAEEAC932C07F5628EC4,42161,14,19,5,36,47,1847
77104,77104,09C2A5500F5ABAEEAC932C07F5628EC4,11021,22,23,1,36,49,1849
77105,77105,6570D32D680E059EAEF7C538F249C69D,11091,5,13,8,29,47,1497
77106,77106,6570D32D680E059EAEF7C538F249C69D,19441,17,18,1,8,46,446
77107,77107,6570D32D680E059EAEF7C538F249C69D,10711,19,21,2,29,46,1496
77111,77111,ABA29477C5849D32F91EDC9B625AB9A2,11381,10,11,1,30,47,1547
77112,77112,ABA29477C5849D32F91EDC9B625AB9A2,42381,15,16,1,39,41,1991
77113,77113,ABA29477C5849D32F91EDC9B625AB9A2,11381,18,23,5,30,47,1547
77114,77114,BBCB9918D42B41DEDF16DD7F5A9BE26F,11861,0,10,10,32,47,1647
77115,77115,BBCB9918D42B41DEDF16DD7F5A9BE26F,42161,10,13,3,36,47,1847
77116,77116,BBCB9918D42B41DEDF16DD7F5A9BE26F,11911,14,17,3,37,48,1898
77117,77117,BBCB9918D42B41DEDF16DD7F5A9BE26F,11861,18,23,5,32,47,1647
77122,77122,6D9BFD2903528361DFCF3B804B6A82D1,10491,0,14,14,33,48,1698
77123,77123,6D9BFD2903528361DFCF3B804B6A82D1,43481,16,17,1,39,48,1998
77124,77124,6D9BFD2903528361DFCF3B804B6A82D1,10491,18,21,3,33,48,1698
77125,77125,38B4DBFFD58FD8FF57AA781F974B31D4,11231,0,7,7,37,49,1899
77126,77126,38B4DBFFD58FD8FF57AA781F974B31D4,43471,8,17,9,31,49,1599
77127,77127,38B4DBFFD58FD8FF57AA781F974B31D4,11231,20,23,3,37,49,1899
77128,77128,AD235EE6A83CA7956AB86E8BC887D3C7,11541,0,5,5,35,49,1799
77129,77129,AD235EE6A83CA7956AB86E8BC887D3C7,11021,6,15,9,36,49,1849
77130,77130,AD235EE6A83CA7956AB86E8BC887D3C7,13561,16,17,1,37,49,1899
77131,77131,AD235EE6A83CA7956AB86E8BC887D3C7,11021,17,18,1,36,49,1849
77132,77132,AD235EE6A83CA7956AB86E8BC887D3C7,10691,19,21,2,33,48,1698
77133,77133,AD235EE6A83CA7956AB86E8BC887D3C7,11541,22,23,1,35,49,1799
77137,77137,DDC302F1F99EDC922514CC6D6B327E3E,12211,0,15,15,41,44,2094
77138,77138,DDC302F1F99EDC922514CC6D6B327E3E,43051,15,18,3,46,45,2345
77139,77139,DDC302F1F99EDC922514CC6D6B327E3E,12211,19,23,4,41,44,2094
77146,77146,34460EAE07C3CF26D59119C1F819471C,12131,0,7,7,32,47,1647
77147,77147,34460EAE07C3CF26D59119C1F819471C,11381,7,18,11,30,47,1547
77148,77148,34460EAE07C3CF26D59119C1F819471C,41401,19,20,1,37,46,1896
77149,77149,34460EAE07C3CF26D59119C1F819471C,12131,22,23,1,32,47,1647
77160,77160,48E1EF89F9F5FB7D8FE3ECCC4E0F80C1,16071,0,7,7,3,3,153
77161,77161,48E1EF89F9F5FB7D8FE3ECCC4E0F80C1,16281,8,11,3,11,4,554
77162,77162,48E1EF89F9F5FB7D8FE3ECCC4E0F80C1,12131,13,14,1,32,47,1647
77163,77163,48E1EF89F9F5FB7D8FE3ECCC4E0F80C1,16211,18,23,5,4,3,203
77164,77164,A4C8C00FA0A4D1520AC6B2AE48C6B569,11921,0,6,6,38,48,1948
77165,77165,A4C8C00FA0A4D1520AC6B2AE48C6B569,43761,8,12,4,32,47,1647
77166,77166,A4C8C00FA0A4D1520AC6B2AE48C6B569,42021,15,17,2,33,47,1697
77167,77167,A4C8C00FA0A4D1520AC6B2AE48C6B569,11861,18,19,1,32,47,1647
77168,77168,9388301F513BC41E37A6659FAF52DB20,43061,0,11,11,43,46,2196
77169,77169,9388301F513BC41E37A6659FAF52DB20,13111,13,14,1,42,46,2146
77170,77170,9388301F513BC41E37A6659FAF52DB20,43061,15,16,1,43,46,2196
77171,77171,9388301F513BC41E37A6659FAF52DB20,43971,17,21,4,30,48,1548
77172,77172,F2812FE3AA21CE45A5EFD1D980E36D0B,10721,0,11,11,31,48,1598
77173,77173,F2812FE3AA21CE45A5EFD1D980E36D0B,40341,15,16,1,23,49,1199
77174,77174,F2812FE3AA21CE45A5EFD1D980E36D0B,10721,17,20,3,31,48,1598
77175,77175,F2812FE3AA21CE45A5EFD1D980E36D0B,11231,20,23,3,37,49,1899
77190,77190,66F421352C22D8571066F0AF8EA7BD0D,10251,0,7,7,35,47,1797
77191,77191,66F421352C22D8571066F0AF8EA7BD0D,42161,7,8,1,36,47,1847
77192,77192,66F421352C22D8571066F0AF8EA7BD0D,10251,9,10,1,35,47,1797
77193,77193,66F421352C22D8571066F0AF8EA7BD0D,10281,12,17,5,33,48,1698
77194,77194,66F421352C22D8571066F0AF8EA7BD0D,10251,20,22,2,35,47,1797
77195,77195,CE5CE74F07F0F10F32C8BE27184D5FD9,11481,0,7,7,41,48,2098
77196,77196,CE5CE74F07F0F10F32C8BE27184D5FD9,40697,8,11,3,43,48,2198
77197,77197,CE5CE74F07F0F10F32C8BE27184D5FD9,11481,13,15,2,41,48,2098
77198,77198,CE5CE74F07F0F10F32C8BE27184D5FD9,11801,15,18,3,42,48,2148
77199,77199,CE5CE74F07F0F10F32C8BE27184D5FD9,11481,19,23,4,41,48,2098
77200,77200,CEB438666719FF78831F75A6CA75D9E9,11021,0,6,6,36,49,1849
77201,77201,CEB438666719FF78831F75A6CA75D9E9,12311,9,13,4,30,44,1544
77202,77202,CEB438666719FF78831F75A6CA75D9E9,42531,15,17,2,31,45,1595
77203,77203,CEB438666719FF78831F75A6CA75D9E9,11021,21,23,2,36,49,1849
77212,77212,E7A499EFF2705CCA8F4C4AD8B684EDF4,11201,0,7,7,35,49,1799
77213,77213,E7A499EFF2705CCA8F4C4AD8B684EDF4,11651,9,11,2,33,47,1697
77214,77214,E7A499EFF2705CCA8F4C4AD8B684EDF4,42141,15,17,2,32,47,1647
77215,77215,E7A499EFF2705CCA8F4C4AD8B684EDF4,10731,18,22,4,33,47,1697
77223,77223,93022BFF14153A652A7F3F93AE1E520A,13601,2,15,13,34,47,1747
77224,77224,93022BFF14153A652A7F3F93AE1E520A,12481,15,17,2,37,49,1899
77225,77225,93022BFF14153A652A7F3F93AE1E520A,10731,17,19,2,33,47,1697
77226,77226,93022BFF14153A652A7F3F93AE1E520A,13601,19,23,4,34,47,1747
77241,77241,B33429D7A00DB66721EA07FF9AC9AB45,11861,0,9,9,32,47,1647
77242,77242,B33429D7A00DB66721EA07FF9AC9AB45,40077,10,21,11,37,49,1899
77243,77243,B33429D7A00DB66721EA07FF9AC9AB45,11861,22,23,1,32,47,1647
77244,77244,72B28316E77049B3B3D9EC9BDF710CF6,42523,0,6,6,31,47,1597
77245,77245,72B28316E77049B3B3D9EC9BDF710CF6,43761,6,10,4,32,47,1647
77246,77246,72B28316E77049B3B3D9EC9BDF710CF6,42523,11,13,2,31,47,1597
77247,77247,72B28316E77049B3B3D9EC9BDF710CF6,43761,15,16,1,32,47,1647
77248,77248,72B28316E77049B3B3D9EC9BDF710CF6,42523,17,19,2,31,47,1597
77252,77252,B5F39D13F6C5569149EE5FC76B988FFF,10531,0,1,1,34,46,1746
77253,77253,B5F39D13F6C5569149EE5FC76B988FFF,13601,2,6,4,34,47,1747
77254,77254,B5F39D13F6C5569149EE5FC76B988FFF,42461,9,19,10,45,47,2297
77258,77258,C668C12BF7C4F8112CB5FCDD5C0B4F1B,10421,7,8,1,41,48,2098
77259,77259,C668C12BF7C4F8112CB5FCDD5C0B4F1B,10295,8,10,2,30,47,1547
77260,77260,C668C12BF7C4F8112CB5FCDD5C0B4F1B,10491,10,11,1,33,48,1698
77261,77261,C668C12BF7C4F8112CB5FCDD5C0B4F1B,43471,12,13,1,31,49,1599
77262,77262,C668C12BF7C4F8112CB5FCDD5C0B4F1B,10901,14,15,1,35,48,1798
77263,77263,C668C12BF7C4F8112CB5FCDD5C0B4F1B,11151,17,21,4,30,48,1548
77264,77264,C668C12BF7C4F8112CB5FCDD5C0B4F1B,10881,21,23,2,34,48,1748
77265,77265,E7EC6E138D54F5092F2DB01DB4F64219,42461,7,8,1,45,47,2297
77266,77266,E7EC6E138D54F5092F2DB01DB4F64219,42204,12,13,1,43,46,2196
77267,77267,E7EC6E138D54F5092F2DB01DB4F64219,42461,15,16,1,45,47,2297
77268,77268,E7EC6E138D54F5092F2DB01DB4F64219,42204,18,20,2,43,46,2196
77269,77269,E7EC6E138D54F5092F2DB01DB4F64219,13111,21,23,2,42,46,2146
77270,77270,CEF1E24EB6DE8D3601A93286A0518B66,13511,1,2,1,34,48,1748
77271,77271,CEF1E24EB6DE8D3601A93286A0518B66,11301,3,11,8,41,49,2099
77272,77272,CEF1E24EB6DE8D3601A93286A0518B66,10191,12,18,6,40,48,2048
77273,77273,CEF1E24EB6DE8D3601A93286A0518B66,10221,19,21,2,34,49,1749
77274,77274,DC066CD0495E31C3328CCF0DC4172A03,13314,0,4,4,31,39,1589
77275,77275,DC066CD0495E31C3328CCF0DC4172A03,12521,4,11,7,35,41,1791
77276,77276,DC066CD0495E31C3328CCF0DC4172A03,13314,12,23,11,31,39,1589
77280,77280,EC8D784C19C185B8F2C30A9ECA831652,12211,0,1,1,41,44,2094
77281,77281,EC8D784C19C185B8F2C30A9ECA831652,13911,1,2,1,39,46,1996
77282,77282,EC8D784C19C185B8F2C30A9ECA831652,12211,3,4,1,41,44,2094
77283,77283,EC8D784C19C185B8F2C30A9ECA831652,11261,6,19,13,36,46,1846
77284,77284,EC8D784C19C185B8F2C30A9ECA831652,12491,22,23,1,36,43,1843
77294,77294,04FC279D8763FD0D52EBF8F599CB8F45,11021,0,8,8,36,49,1849
77295,77295,04FC279D8763FD0D52EBF8F599CB8F45,13121,9,10,1,38,46,1946
77296,77296,04FC279D8763FD0D52EBF8F599CB8F45,10781,11,16,5,35,47,1797
77297,77297,04FC279D8763FD0D52EBF8F599CB8F45,11021,20,22,2,36,49,1849
77298,77298,C8886154F373877089A89790BB3295C2,15261,0,13,13,39,13,1963
77299,77299,C8886154F373877089A89790BB3295C2,15023,14,16,2,46,17,2317
77300,77300,C8886154F373877089A89790BB3295C2,11531,19,21,2,34,49,1749
77301,77301,9410BE71939CF3988D6550B9FE96B941,19621,0,8,8,5,46,296
77302,77302,9410BE71939CF3988D6550B9FE96B941,19744,10,14,4,6,43,343
77303,77303,9410BE71939CF3988D6550B9FE96B941,11211,15,20,5,34,49,1749
77304,77304,9410BE71939CF3988D6550B9FE96B941,19744,22,23,1,6,43,343
77309,77309,5094EF8F1C475513036C68175706D08F,42151,0,1,1,35,45,1795
77310,77310,5094EF8F1C475513036C68175706D08F,13911,1,2,1,39,46,1996
77311,77311,5094EF8F1C475513036C68175706D08F,42151,3,4,1,35,45,1795
77312,77312,5094EF8F1C475513036C68175706D08F,13911,5,7,2,39,46,1996
77313,77313,5094EF8F1C475513036C68175706D08F,42151,9,22,13,35,45,1795
77323,77323,7072D45C58A4A94BABD1B710AD10F471,42351,0,5,5,38,45,1945
77324,77324,7072D45C58A4A94BABD1B710AD10F471,12311,6,8,2,30,44,1544
77325,77325,7072D45C58A4A94BABD1B710AD10F471,42871,8,11,3,30,45,1545
77326,77326,7072D45C58A4A94BABD1B710AD10F471,12311,12,15,3,30,44,1544
77327,77327,7072D45C58A4A94BABD1B710AD10F471,13911,18,22,4,39,46,1996
77328,77328,93DD2C863C5AA53C83002ED6F1D5AEBB,12921,0,5,5,9,41,491
77329,77329,93DD2C863C5AA53C83002ED6F1D5AEBB,19181,7,9,2,8,40,440
77330,77330,93DD2C863C5AA53C83002ED6F1D5AEBB,12921,13,14,1,9,41,491
77331,77331,93DD2C863C5AA53C83002ED6F1D5AEBB,19031,18,19,1,1,42,92
77332,77332,93DD2C863C5AA53C83002ED6F1D5AEBB,12641,20,21,1,10,43,543
77333,77333,5F14E1A15EFA1C13F8B10CBC543F107C,11481,0,9,9,41,48,2098
77334,77334,5F14E1A15EFA1C13F8B10CBC543F107C,12581,10,11,1,24,48,1248
77335,77335,5F14E1A15EFA1C13F8B10CBC543F107C,43361,12,13,1,38,48,1948
77336,77336,5F14E1A15EFA1C13F8B10CBC543F107C,12581,14,16,2,24,48,1248
77337,77337,5F14E1A15EFA1C13F8B10CBC543F107C,10191,18,23,5,40,48,2048
77338,77338,C8236143E8B93D5FDE499177CF2B28F7,11381,0,5,5,30,47,1547
77339,77339,C8236143E8B93D5FDE499177CF2B28F7,42301,7,9,2,36,47,1847
77340,77340,C8236143E8B93D5FDE499177CF2B28F7,42861,12,14,2,37,44,1894
77341,77341,C8236143E8B93D5FDE499177CF2B28F7,11261,14,16,2,36,46,1846
77342,77342,C8236143E8B93D5FDE499177CF2B28F7,11381,19,23,4,30,47,1547
77346,77346,CE26B8570DA2E6BAF7525A9993322910,42051,0,8,8,42,48,2148
77347,77347,CE26B8570DA2E6BAF7525A9993322910,42121,12,13,1,26,49,1349
77348,77348,CE26B8570DA2E6BAF7525A9993322910,10107,14,16,2,38,49,1949
77349,77349,CE26B8570DA2E6BAF7525A9993322910,41271,17,19,2,38,48,1948
77353,77353,0BE6D4AFC80D9EB63E9D1C0C2A62879B,10661,10,13,3,37,49,1899
77354,77354,0BE6D4AFC80D9EB63E9D1C0C2A62879B,10191,16,18,2,40,48,2048
77355,77355,0BE6D4AFC80D9EB63E9D1C0C2A62879B,11741,18,20,2,42,49,2149
77356,77356,414AA00EC00DAA3D830C87A4F3E4DD09,11861,0,8,8,32,47,1647
77357,77357,414AA00EC00DAA3D830C87A4F3E4DD09,43981,11,14,3,36,49,1849
77358,77358,414AA00EC00DAA3D830C87A4F3E4DD09,10151,16,23,7,34,47,1747
77359,77359,EAEFCB977DEDF23C1346736B36A6F67B,13911,1,5,4,39,46,1996
77360,77360,EAEFCB977DEDF23C1346736B36A6F67B,11261,6,7,1,36,46,1846
77361,77361,EAEFCB977DEDF23C1346736B36A6F67B,42231,10,16,6,37,46,1896
77362,77362,EAEFCB977DEDF23C1346736B36A6F67B,11261,19,21,2,36,46,1846
77363,77363,EAEFCB977DEDF23C1346736B36A6F67B,13911,21,22,1,39,46,1996
77364,77364,1D20B498D42204F7DA0BA75047AF3620,11271,0,8,8,37,48,1898
77365,77365,1D20B498D42204F7DA0BA75047AF3620,13671,10,14,4,27,43,1393
77366,77366,1D20B498D42204F7DA0BA75047AF3620,11211,14,17,3,34,49,1749
77367,77367,1D20B498D42204F7DA0BA75047AF3620,10471,18,20,2,37,48,1898
77368,77368,1D20B498D42204F7DA0BA75047AF3620,10111,20,22,2,37,47,1897
77369,77369,7FC90A7046789407FE1CCFF00DDA96C6,40343,0,8,8,24,49,1249
77370,77370,7FC90A7046789407FE1CCFF00DDA96C6,12661,15,16,1,32,45,1645
77371,77371,7FC90A7046789407FE1CCFF00DDA96C6,40347,17,23,6,25,49,1299
77382,77382,C5E43FB7922ADA98C2BAC66B96E59D94,19744,0,8,8,6,43,343
77383,77383,C5E43FB7922ADA98C2BAC66B96E59D94,10151,9,10,1,34,47,1747
77384,77384,C5E43FB7922ADA98C2BAC66B96E59D94,19744,11,12,1,6,43,343
77385,77385,C5E43FB7922ADA98C2BAC66B96E59D94,11531,13,17,4,34,49,1749
77386,77386,C5E43FB7922ADA98C2BAC66B96E59D94,19744,18,20,2,6,43,343
77390,77390,621EE723701B1C2822F12413396AAE68,11431,0,7,7,29,47,1497
77391,77391,621EE723701B1C2822F12413396AAE68,10951,8,11,3,29,48,1498
77392,77392,621EE723701B1C2822F12413396AAE68,11431,12,15,3,29,47,1497
77393,77393,621EE723701B1C2822F12413396AAE68,11381,15,17,2,30,47,1547
77394,77394,621EE723701B1C2822F12413396AAE68,11431,18,23,5,29,47,1497
77395,77395,92AA74C025DCC8E1B6F69E40B85D2713,43971,0,7,7,30,48,1548
77396,77396,92AA74C025DCC8E1B6F69E40B85D2713,11074,8,12,4,37,47,1897
77397,77397,92AA74C025DCC8E1B6F69E40B85D2713,10221,14,21,7,34,49,1749
77408,77408,292C54710FB21A50B273EFB2F0804791,42081,0,6,6,24,49,1249
77409,77409,292C54710FB21A50B273EFB2F0804791,42623,6,12,6,22,49,1149
77410,77410,292C54710FB21A50B273EFB2F0804791,42081,12,14,2,24,49,1249
77411,77411,292C54710FB21A50B273EFB2F0804791,42623,16,17,1,22,49,1149
77412,77412,292C54710FB21A50B273EFB2F0804791,42081,19,23,4,24,49,1249
77416,77416,A53907219614BC9E0FC05C0EC4AF6DC2,13911,0,6,6,39,46,1996
77417,77417,A53907219614BC9E0FC05C0EC4AF6DC2,42231,6,10,4,37,46,1896
77418,77418,A53907219614BC9E0FC05C0EC4AF6DC2,13911,11,13,2,39,46,1996
77419,77419,A53907219614BC9E0FC05C0EC4AF6DC2,13711,15,19,4,38,46,1946
77420,77420,A53907219614BC9E0FC05C0EC4AF6DC2,13911,19,22,3,39,46,1996
77424,77424,2089CCBC2F855C8416A68A67F03D7345,11954,2,7,5,32,49,1649
77425,77425,2089CCBC2F855C8416A68A67F03D7345,10161,7,11,4,35,49,1799
77426,77426,2089CCBC2F855C8416A68A67F03D7345,10881,11,14,3,34,48,1748
77427,77427,2089CCBC2F855C8416A68A67F03D7345,12391,14,16,2,36,49,1849
77428,77428,2089CCBC2F855C8416A68A67F03D7345,11753,18,19,1,35,48,1798
77429,77429,9A219F455A59EABA0B2D26C152ACDCFB,13111,2,12,10,42,46,2146
77430,77430,9A219F455A59EABA0B2D26C152ACDCFB,13791,13,14,1,42,47,2147
77431,77431,9A219F455A59EABA0B2D26C152ACDCFB,13111,14,15,1,42,46,2146
77432,77432,9A219F455A59EABA0B2D26C152ACDCFB,42204,17,18,1,43,46,2196
77433,77433,9A219F455A59EABA0B2D26C152ACDCFB,13111,21,23,2,42,46,2146
77434,77434,6F6BFA140B8F0D41AE13D3CFA2E32A87,12921,0,2,2,9,41,491
77435,77435,6F6BFA140B8F0D41AE13D3CFA2E32A87,19114,3,5,2,7,43,393
77436,77436,6F6BFA140B8F0D41AE13D3CFA2E32A87,12641,7,11,4,10,43,543
77437,77437,6F6BFA140B8F0D41AE13D3CFA2E32A87,10211,16,18,2,16,49,849
77438,77438,6F6BFA140B8F0D41AE13D3CFA2E32A87,19114,19,22,3,7,43,393
77439,77439,16306C4EF4EF15900FD611CAB01E32B2,13231,0,1,1,39,46,1996
77440,77440,16306C4EF4EF15900FD611CAB01E32B2,42231,1,17,16,37,46,1896
77441,77441,16306C4EF4EF15900FD611CAB01E32B2,13911,18,19,1,39,46,1996
77442,77442,16306C4EF4EF15900FD611CAB01E32B2,42351,19,20,1,38,45,1945
77443,77443,16306C4EF4EF15900FD611CAB01E32B2,13911,21,23,2,39,46,1996
77447,77447,E1ADA5D6F54060F04D34C1A2CB8FE108,13381,2,5,3,39,47,1997
77448,77448,E1ADA5D6F54060F04D34C1A2CB8FE108,42221,5,6,1,38,48,1948
77449,77449,E1ADA5D6F54060F04D34C1A2CB8FE108,11074,8,9,1,37,47,1897
77450,77450,E1ADA5D6F54060F04D34C1A2CB8FE108,13381,13,15,2,39,47,1997
77451,77451,E1ADA5D6F54060F04D34C1A2CB8FE108,11074,16,18,2,37,47,1897
77452,77452,E1ADA5D6F54060F04D34C1A2CB8FE108,13381,22,23,1,39,47,1997
77453,77453,596353D0D3BC20785C568E9889E43F87,11381,0,6,6,30,47,1547
77454,77454,596353D0D3BC20785C568E9889E43F87,11281,7,13,6,27,40,1390
77455,77455,596353D0D3BC20785C568E9889E43F87,13671,14,16,2,27,43,1393
77456,77456,596353D0D3BC20785C568E9889E43F87,11381,18,23,5,30,47,1547
77457,77457,487A62E76A99728DF0C08197456F9487,10191,0,8,8,40,48,2048
77458,77458,487A62E76A99728DF0C08197456F9487,11021,8,11,3,36,49,1849
77459,77459,487A62E76A99728DF0C08197456F9487,11641,13,17,4,22,49,1149
77460,77460,487A62E76A99728DF0C08197456F9487,42021,19,21,2,33,47,1697
77461,77461,487A62E76A99728DF0C08197456F9487,41721,22,23,1,39,48,1998
77465,77465,FC3B8910035FE6AFFCEFAAF1A5BD46D7,10471,0,10,10,37,48,1898
77466,77466,FC3B8910035FE6AFFCEFAAF1A5BD46D7,42191,12,13,1,38,49,1949
77467,77467,FC3B8910035FE6AFFCEFAAF1A5BD46D7,11271,15,17,2,37,48,1898
77468,77468,FC3B8910035FE6AFFCEFAAF1A5BD46D7,42191,19,20,1,38,49,1949
77469,77469,FC3B8910035FE6AFFCEFAAF1A5BD46D7,10471,20,22,2,37,48,1898
77470,77470,3C5BF8354C7B22C00BFA5438C070BC0F,13711,0,8,8,38,46,1946
77471,77471,3C5BF8354C7B22C00BFA5438C070BC0F,43241,8,10,2,36,46,1846
77472,77472,3C5BF8354C7B22C00BFA5438C070BC0F,13711,13,17,4,38,46,1946
77473,77473,3C5BF8354C7B22C00BFA5438C070BC0F,43241,17,19,2,36,46,1846
77474,77474,3C5BF8354C7B22C00BFA5438C070BC0F,10271,20,21,1,37,46,1896
77475,77475,3C5BF8354C7B22C00BFA5438C070BC0F,13711,21,23,2,38,46,1946
77482,77482,BBED2FFAE46770F0D73304C008766B5A,13651,0,9,9,30,47,1547
77483,77483,BBED2FFAE46770F0D73304C008766B5A,42521,13,18,5,31,47,1597
77484,77484,BBED2FFAE46770F0D73304C008766B5A,10107,19,21,2,38,49,1949
77485,77485,BBED2FFAE46770F0D73304C008766B5A,10295,21,23,2,30,47,1547
77486,77486,CEC2557E73B99D59943BE56AF1337C99,10271,0,5,5,37,46,1896
77487,77487,CEC2557E73B99D59943BE56AF1337C99,13121,6,7,1,38,46,1946
77488,77488,CEC2557E73B99D59943BE56AF1337C99,10271,8,11,3,37,46,1896
77489,77489,CEC2557E73B99D59943BE56AF1337C99,13121,12,15,3,38,46,1946
77490,77490,CEC2557E73B99D59943BE56AF1337C99,10271,16,19,3,37,46,1896
77491,77491,CEC2557E73B99D59943BE56AF1337C99,13121,20,21,1,38,46,1946
77492,77492,E40FF661B4F3DA89AB28D734DF463F41,12671,0,7,7,21,43,1093
77493,77493,E40FF661B4F3DA89AB28D734DF463F41,12921,8,15,7,9,41,491
77494,77494,E40FF661B4F3DA89AB28D734DF463F41,12641,19,21,2,10,43,543
77495,77495,DC84219A18D205A834F01D7743EEEE79,42921,5,6,1,33,47,1697
77496,77496,DC84219A18D205A834F01D7743EEEE79,11231,8,20,12,37,49,1899
77497,77497,DC84219A18D205A834F01D7743EEEE79,42921,20,23,3,33,47,1697
77514,77514,09F64A9A641B3F2B92615DE97B925264,10631,0,2,2,28,46,1446
77515,77515,09F64A9A641B3F2B92615DE97B925264,11875,3,6,3,30,46,1546
77516,77516,09F64A9A641B3F2B92615DE97B925264,10634,9,11,2,27,45,1395
77517,77517,09F64A9A641B3F2B92615DE97B925264,10351,12,17,5,28,45,1445
77518,77518,09F64A9A641B3F2B92615DE97B925264,10631,22,23,1,28,46,1446
77519,77519,7A0F6F4C02EDA49D93E118AA34A8B715,43321,0,14,14,36,49,1849
77520,77520,7A0F6F4C02EDA49D93E118AA34A8B715,42461,15,16,1,45,47,2297
77521,77521,7A0F6F4C02EDA49D93E118AA34A8B715,11021,17,22,5,36,49,1849
77525,77525,B8DCAC0FC6FA981D871032E55C240C8E,42581,0,3,3,38,48,1948
77526,77526,B8DCAC0FC6FA981D871032E55C240C8E,11914,5,10,5,37,48,1898
77527,77527,B8DCAC0FC6FA981D871032E55C240C8E,42581,11,12,1,38,48,1948
77528,77528,B8DCAC0FC6FA981D871032E55C240C8E,11914,12,14,2,37,48,1898
77529,77529,B8DCAC0FC6FA981D871032E55C240C8E,42581,18,20,2,38,48,1948
77530,77530,B8DCAC0FC6FA981D871032E55C240C8E,11914,20,22,2,37,48,1898
77531,77531,793DC4BC4E2928DCDBFB7B36F78CD36B,42161,0,9,9,36,47,1847
77532,77532,793DC4BC4E2928DCDBFB7B36F78CD36B,10231,10,17,7,39,49,1999
77533,77533,793DC4BC4E2928DCDBFB7B36F78CD36B,40637,19,20,1,36,47,1847
77534,77534,793DC4BC4E2928DCDBFB7B36F78CD36B,11061,22,23,1,29,48,1498
77535,77535,946768BFA72752D5660750415178C67F,11131,1,3,2,33,48,1698
77536,77536,946768BFA72752D5660750415178C67F,10251,6,8,2,35,47,1797
77537,77537,946768BFA72752D5660750415178C67F,10511,8,12,4,35,46,1796
77538,77538,946768BFA72752D5660750415178C67F,10781,13,15,2,35,47,1797
77539,77539,946768BFA72752D5660750415178C67F,11081,15,17,2,35,46,1796
77540,77540,946768BFA72752D5660750415178C67F,12971,20,21,1,32,48,1648
77541,77541,0CFE988ACC4C875C64FD106BD1BAEAD4,11081,0,8,8,35,46,1796
77542,77542,0CFE988ACC4C875C64FD106BD1BAEAD4,13951,9,12,3,47,45,2395
77543,77543,0CFE988ACC4C875C64FD106BD1BAEAD4,43051,14,16,2,46,45,2345
77544,77544,0CFE988ACC4C875C64FD106BD1BAEAD4,13651,19,21,2,30,47,1547
77549,77549,D278A78B03015D942733A0F36181B50F,43041,0,7,7,41,46,2096
77550,77550,D278A78B03015D942733A0F36181B50F,10431,8,17,9,33,49,1699
77551,77551,D278A78B03015D942733A0F36181B50F,43041,21,23,2,41,46,2096
77552,77552,1DC3A3A4FE9D63C37AD1D2C313E3354F,42191,0,9,9,38,49,1949
77553,77553,1DC3A3A4FE9D63C37AD1D2C313E3354F,10471,9,11,2,37,48,1898
77554,77554,1DC3A3A4FE9D63C37AD1D2C313E3354F,10107,12,13,1,38,49,1949
77555,77555,1DC3A3A4FE9D63C37AD1D2C313E3354F,11271,15,17,2,37,48,1898
77556,77556,1DC3A3A4FE9D63C37AD1D2C313E3354F,10107,19,23,4,38,49,1949
77557,77557,572FC1924B3D406C6B95088F85214228,42041,0,5,5,10,47,547
77558,77558,572FC1924B3D406C6B95088F85214228,19441,6,7,1,8,46,446
77559,77559,572FC1924B3D406C6B95088F85214228,42041,11,13,2,10,47,547
77560,77560,572FC1924B3D406C6B95088F85214228,19441,13,15,2,8,46,446
77561,77561,572FC1924B3D406C6B95088F85214228,42041,19,23,4,10,47,547
77565,77565,39179060954ADF536A44D5CDC3D7ADA4,12491,0,1,1,36,43,1843
77566,77566,39179060954ADF536A44D5CDC3D7ADA4,13911,5,11,6,39,46,1996
77567,77567,39179060954ADF536A44D5CDC3D7ADA4,12491,11,13,2,36,43,1843
77568,77568,39179060954ADF536A44D5CDC3D7ADA4,13911,13,18,5,39,46,1996
77569,77569,39179060954ADF536A44D5CDC3D7ADA4,11261,18,20,2,36,46,1846
77570,77570,39179060954ADF536A44D5CDC3D7ADA4,13911,20,22,2,39,46,1996
77571,77571,EACB94785D7D8588CB35DC947218B89F,11161,0,7,7,32,48,1648
77572,77572,EACB94785D7D8588CB35DC947218B89F,42021,8,9,1,33,47,1697
77573,77573,EACB94785D7D8588CB35DC947218B89F,43311,10,16,6,31,48,1598
77574,77574,EACB94785D7D8588CB35DC947218B89F,12381,18,20,2,32,48,1648
77575,77575,EACB94785D7D8588CB35DC947218B89F,43311,21,22,1,31,48,1598
77579,77579,59C9891991D18AB42F5CA2A676EAFEE0,42541,1,7,6,25,47,1297
77580,77580,59C9891991D18AB42F5CA2A676EAFEE0,19441,11,14,3,8,46,446
77581,77581,59C9891991D18AB42F5CA2A676EAFEE0,42501,17,23,6,28,47,1447
77582,77582,BA6D45213D52989026A398B5D7995374,43644,0,7,7,14,38,738
77583,77583,BA6D45213D52989026A398B5D7995374,12641,7,15,8,10,43,543
77584,77584,BA6D45213D52989026A398B5D7995374,19181,18,20,2,8,40,440
77585,77585,B951A84BF3E51B5B64B6D49456081EFD,10191,3,9,6,40,48,2048
77586,77586,B951A84BF3E51B5B64B6D49456081EFD,16071,10,14,4,3,3,153
77587,77587,B951A84BF3E51B5B64B6D49456081EFD,16181,15,17,2,4,2,202
77588,77588,B951A84BF3E51B5B64B6D49456081EFD,16261,18,21,3,3,3,153
77589,77589,B951A84BF3E51B5B64B6D49456081EFD,16181,21,23,2,4,2,202
77590,77590,639EA486291B8A87A84D90343A87732A,10451,0,6,6,25,48,1298
77591,77591,639EA486291B8A87A84D90343A87732A,10661,7,9,2,37,49,1899
77592,77592,639EA486291B8A87A84D90343A87732A,10107,9,11,2,38,49,1949
77593,77593,639EA486291B8A87A84D90343A87732A,11771,14,15,1,39,49,1999
77594,77594,639EA486291B8A87A84D90343A87732A,10661,15,18,3,37,49,1899
77595,77595,639EA486291B8A87A84D90343A87732A,10451,20,23,3,25,48,1298
77596,77596,176F4E967E986DAF00C74DDD3BF2A8FE,11806,0,6,6,41,48,2098
77597,77597,176F4E967E986DAF00C74DDD3BF2A8FE,12514,11,13,2,38,47,1947
77598,77598,176F4E967E986DAF00C74DDD3BF2A8FE,13711,15,17,2,38,46,1946
77599,77599,176F4E967E986DAF00C74DDD3BF2A8FE,11806,18,19,1,41,48,2098
77600,77600,72B30F68977E5196E3B8F60740103681,19441,1,7,6,8,46,446
77601,77601,72B30F68977E5196E3B8F60740103681,42041,8,10,2,10,47,547
77602,77602,72B30F68977E5196E3B8F60740103681,12641,14,15,1,10,43,543
77603,77603,72B30F68977E5196E3B8F60740103681,19441,16,18,2,8,46,446
77604,77604,72B30F68977E5196E3B8F60740103681,40341,19,21,2,23,49,1199
77605,77605,CFB5B91AB0CD7543884ADBE535AD19D6,43021,0,6,6,16,43,843
77606,77606,CFB5B91AB0CD7543884ADBE535AD19D6,12921,9,11,2,9,41,491
77607,77607,CFB5B91AB0CD7543884ADBE535AD19D6,43021,12,13,1,16,43,843
77608,77608,CFB5B91AB0CD7543884ADBE535AD19D6,12921,14,15,1,9,41,491
77609,77609,CFB5B91AB0CD7543884ADBE535AD19D6,12641,15,18,3,10,43,543
77610,77610,9059F012B6333EE6127670A64AEB2ACB,40872,2,9,7,30,49,1549
77611,77611,9059F012B6333EE6127670A64AEB2ACB,12661,10,14,4,32,45,1645
77612,77612,9059F012B6333EE6127670A64AEB2ACB,40872,15,19,4,30,49,1549
77617,77617,A5A342C5B79B8AEE00BA80AE678B8EC5,10331,0,14,14,39,46,1996
77618,77618,A5A342C5B79B8AEE00BA80AE678B8EC5,11151,15,18,3,30,48,1548
77619,77619,A5A342C5B79B8AEE00BA80AE678B8EC5,10331,20,23,3,39,46,1996
77620,77620,9C819019C9FBB04766CC6EE29C66CE0E,10111,0,7,7,37,47,1897
77621,77621,9C819019C9FBB04766CC6EE29C66CE0E,12514,11,12,1,38,47,1947
77622,77622,9C819019C9FBB04766CC6EE29C66CE0E,11074,13,16,3,37,47,1897
77623,77623,9C819019C9FBB04766CC6EE29C66CE0E,12514,17,18,1,38,47,1947
77624,77624,9C819019C9FBB04766CC6EE29C66CE0E,10841,21,23,2,37,47,1897
77628,77628,37C29D4674FBC06EF76342F2283F4E15,42031,0,6,6,40,46,2046
77629,77629,37C29D4674FBC06EF76342F2283F4E15,12731,9,11,2,22,40,1140
77630,77630,37C29D4674FBC06EF76342F2283F4E15,42031,12,14,2,40,46,2046
77631,77631,37C29D4674FBC06EF76342F2283F4E15,13671,17,18,1,27,43,1393
77632,77632,37C29D4674FBC06EF76342F2283F4E15,42031,18,23,5,40,46,2046
77639,77639,2BB5E6319C361908A67DD8509286CF7C,19031,0,6,6,1,42,92
77640,77640,2BB5E6319C361908A67DD8509286CF7C,12641,6,11,5,10,43,543
77641,77641,2BB5E6319C361908A67DD8509286CF7C,19031,12,14,2,1,42,92
77642,77642,2BB5E6319C361908A67DD8509286CF7C,12641,15,17,2,10,43,543
77643,77643,2BB5E6319C361908A67DD8509286CF7C,19031,19,23,4,1,42,92
77650,77650,751637010376FF10A15374FA98F99F38,13601,0,1,1,34,47,1747
77651,77651,751637010376FF10A15374FA98F99F38,11861,1,9,8,32,47,1647
77652,77652,751637010376FF10A15374FA98F99F38,10221,11,13,2,34,49,1749
77653,77653,751637010376FF10A15374FA98F99F38,42521,18,20,2,31,47,1597
77654,77654,751637010376FF10A15374FA98F99F38,13601,22,23,1,34,47,1747
77655,77655,A910A64B88EF93AE4B4F67D39EA167CE,40171,0,9,9,38,48,1948
77656,77656,A910A64B88EF93AE4B4F67D39EA167CE,11914,10,11,1,37,48,1898
77657,77657,A910A64B88EF93AE4B4F67D39EA167CE,42581,12,13,1,38,48,1948
77658,77658,A910A64B88EF93AE4B4F67D39EA167CE,10471,18,21,3,37,48,1898
77659,77659,A910A64B88EF93AE4B4F67D39EA167CE,40171,22,23,1,38,48,1948
77660,77660,ACB823DB33D22CC4344D979C1DDF92F4,11261,0,3,3,36,46,1846
77661,77661,ACB823DB33D22CC4344D979C1DDF92F4,42861,6,10,4,37,44,1894
77662,77662,ACB823DB33D22CC4344D979C1DDF92F4,11261,13,14,1,36,46,1846
77663,77663,ACB823DB33D22CC4344D979C1DDF92F4,42861,17,20,3,37,44,1894
77664,77664,ACB823DB33D22CC4344D979C1DDF92F4,11261,21,23,2,36,46,1846
77665,77665,1217F53A8996F8B9AC1C89745896C7AE,10121,0,6,6,36,49,1849
77666,77666,1217F53A8996F8B9AC1C89745896C7AE,43041,7,9,2,41,46,2096
77667,77667,1217F53A8996F8B9AC1C89745896C7AE,12391,10,19,9,36,49,1849
77668,77668,1217F53A8996F8B9AC1C89745896C7AE,42961,21,23,2,35,49,1799
77669,77669,C6A8E88AF4FAB8E3B900B709C1644500,10411,0,7,7,36,48,1848
77670,77670,C6A8E88AF4FAB8E3B900B709C1644500,10221,12,13,1,34,49,1749
77671,77671,C6A8E88AF4FAB8E3B900B709C1644500,11954,14,16,2,32,49,1649
77672,77672,C6A8E88AF4FAB8E3B900B709C1644500,11201,18,23,5,35,49,1799
77673,77673,19A29A27E6506D34C07A04E6E9F52A03,12491,0,7,7,36,43,1843
77674,77674,19A29A27E6506D34C07A04E6E9F52A03,42151,7,14,7,35,45,1795
77675,77675,19A29A27E6506D34C07A04E6E9F52A03,12491,14,16,2,36,43,1843
77676,77676,19A29A27E6506D34C07A04E6E9F52A03,42151,17,18,1,35,45,1795
77677,77677,19A29A27E6506D34C07A04E6E9F52A03,11841,19,20,1,33,46,1696
77678,77678,19A29A27E6506D34C07A04E6E9F52A03,12491,20,22,2,36,43,1843
77682,77682,056A2A39171466102F8DD26786FF2135,12921,1,4,3,9,41,491
77683,77683,056A2A39171466102F8DD26786FF2135,19744,9,14,5,6,43,343
77684,77684,056A2A39171466102F8DD26786FF2135,11914,18,19,1,37,48,1898
77685,77685,056A2A39171466102F8DD26786FF2135,13231,21,23,2,39,46,1996
77686,77686,E6D049947968658F47DDC695A59302A1,42321,0,5,5,43,47,2197
77687,77687,E6D049947968658F47DDC695A59302A1,42461,6,9,3,45,47,2297
77688,77688,E6D049947968658F47DDC695A59302A1,13951,11,12,1,47,45,2395
77689,77689,E6D049947968658F47DDC695A59302A1,42461,13,14,1,45,47,2297
77690,77690,E6D049947968658F47DDC695A59302A1,42111,15,16,1,44,46,2246
77691,77691,E6D049947968658F47DDC695A59302A1,42461,16,18,2,45,47,2297
77692,77692,E6D049947968658F47DDC695A59302A1,42204,21,23,2,43,46,2196
77693,77693,71AB304A084EB4095E1F705C48CB0E23,11901,0,7,7,42,49,2149
77694,77694,71AB304A084EB4095E1F705C48CB0E23,11914,7,19,12,37,48,1898
77695,77695,71AB304A084EB4095E1F705C48CB0E23,11901,20,23,3,42,49,2149
77696,77696,F74E1805BD471CD67AFEC7E33078A7FE,11914,0,4,4,37,48,1898
77697,77697,F74E1805BD471CD67AFEC7E33078A7FE,43361,7,8,1,38,48,1948
77698,77698,F74E1805BD471CD67AFEC7E33078A7FE,11914,10,14,4,37,48,1898
77699,77699,F74E1805BD471CD67AFEC7E33078A7FE,43361,14,15,1,38,48,1948
77700,77700,F74E1805BD471CD67AFEC7E33078A7FE,11914,19,21,2,37,48,1898
77701,77701,AA51DE94270AE4663B2578A38D4EECC9,13961,0,7,7,42,48,2148
77702,77702,AA51DE94270AE4663B2578A38D4EECC9,11914,9,11,2,37,48,1898
77703,77703,AA51DE94270AE4663B2578A38D4EECC9,13961,12,14,2,42,48,2148
77704,77704,AA51DE94270AE4663B2578A38D4EECC9,42581,16,17,1,38,48,1948
77705,77705,AA51DE94270AE4663B2578A38D4EECC9,13961,18,23,5,42,48,2148
77709,77709,4CA7727345FE5410FF8669E86CE37E32,19031,0,6,6,1,42,92
77710,77710,4CA7727345FE5410FF8669E86CE37E32,12921,8,9,1,9,41,491
77711,77711,4CA7727345FE5410FF8669E86CE37E32,12641,13,15,2,10,43,543
77712,77712,4CA7727345FE5410FF8669E86CE37E32,19024,19,20,1,9,45,495
77713,77713,BB72FBDB509C0EDC7CB7986BE504F263,12661,0,7,7,32,45,1645
77714,77714,BB72FBDB509C0EDC7CB7986BE504F263,11914,7,12,5,37,48,1898
77715,77715,BB72FBDB509C0EDC7CB7986BE504F263,12661,13,19,6,32,45,1645
77719,77719,A655C67D52402CE056E16AFA14815F89,13271,0,5,5,41,47,2097
77720,77720,A655C67D52402CE056E16AFA14815F89,10634,10,11,1,27,45,1395
77721,77721,A655C67D52402CE056E16AFA14815F89,11091,12,14,2,29,47,1497
77722,77722,A655C67D52402CE056E16AFA14815F89,13101,19,21,2,40,47,2047
77723,77723,A655C67D52402CE056E16AFA14815F89,13271,21,22,1,41,47,2097
77733,77733,F3355C7CE640AE85292C2A8D8E7E2415,13271,0,6,6,41,47,2097
77734,77734,F3355C7CE640AE85292C2A8D8E7E2415,10292,8,12,4,30,47,1547
77735,77735,F3355C7CE640AE85292C2A8D8E7E2415,10161,12,23,11,35,49,1799
77743,77743,9FC853D14B199D9AE09B3905110E90BD,12514,0,7,7,38,47,1947
77744,77744,9FC853D14B199D9AE09B3905110E90BD,42221,8,11,3,38,48,1948
77745,77745,9FC853D14B199D9AE09B3905110E90BD,12514,12,13,1,38,47,1947
77746,77746,9FC853D14B199D9AE09B3905110E90BD,42221,13,18,5,38,48,1948
77747,77747,9FC853D14B199D9AE09B3905110E90BD,12514,19,23,4,38,47,1947
77748,77748,4B092DC1F29A37B0C9B62BC92967DF2D,10691,0,6,6,33,48,1698
77749,77749,4B092DC1F29A37B0C9B62BC92967DF2D,11561,11,12,1,32,49,1649
77750,77750,4B092DC1F29A37B0C9B62BC92967DF2D,42941,16,18,2,37,47,1897
77751,77751,4B092DC1F29A37B0C9B62BC92967DF2D,12031,19,23,4,33,48,1698
77752,77752,3C20A4FB5A5B0FD7EA7A50D0F5C8CA66,43021,0,5,5,16,43,843
77753,77753,3C20A4FB5A5B0FD7EA7A50D0F5C8CA66,12921,6,19,13,9,41,491
77754,77754,3C20A4FB5A5B0FD7EA7A50D0F5C8CA66,11381,19,20,1,30,47,1547
77761,77761,720B1030F9AA451F5DB7F94C393FD381,11701,2,9,7,43,48,2198
77762,77762,720B1030F9AA451F5DB7F94C393FD381,40101,11,12,1,34,49,1749
77763,77763,720B1030F9AA451F5DB7F94C393FD381,12083,13,15,2,36,49,1849
77764,77764,720B1030F9AA451F5DB7F94C393FD381,10221,15,17,2,34,49,1749
77765,77765,720B1030F9AA451F5DB7F94C393FD381,11271,20,23,3,37,48,1898
77766,77766,BF5242715718EEF665EE93EC69F552EB,13271,0,3,3,41,47,2097
77767,77767,BF5242715718EEF665EE93EC69F552EB,13101,7,12,5,40,47,2047
77768,77768,BF5242715718EEF665EE93EC69F552EB,13271,13,14,1,41,47,2097
77769,77769,BF5242715718EEF665EE93EC69F552EB,13101,15,16,1,40,47,2047
77770,77770,BF5242715718EEF665EE93EC69F552EB,11804,20,21,1,41,48,2098
77778,77778,498933A0A78BE724C2946DC12B0E907A,13111,0,15,15,42,46,2146
77779,77779,498933A0A78BE724C2946DC12B0E907A,11231,17,19,2,37,49,1899
77780,77780,498933A0A78BE724C2946DC12B0E907A,43761,20,22,2,32,47,1647
77781,77781,58DD29620A36856900D278AA525EEA23,15143,1,2,1,18,7,907
77782,77782,58DD29620A36856900D278AA525EEA23,16281,6,16,10,11,4,554
77783,77783,58DD29620A36856900D278AA525EEA23,15143,17,18,1,18,7,907
77784,77784,6164F469738A30A14CD373EB73D02471,11801,0,7,7,42,48,2148
77785,77785,6164F469738A30A14CD373EB73D02471,11541,10,11,1,35,49,1799
77786,77786,6164F469738A30A14CD373EB73D02471,10331,12,14,2,39,46,1996
77787,77787,6164F469738A30A14CD373EB73D02471,11211,15,23,8,34,49,1749
77788,77788,981A108DF07EE24FA84EC23588DA45B3,12491,1,10,9,36,43,1843
77789,77789,981A108DF07EE24FA84EC23588DA45B3,11941,12,14,2,37,46,1896
77790,77790,981A108DF07EE24FA84EC23588DA45B3,11794,18,19,1,38,49,1949
77794,77794,132DCF25B9397E4F14B57C16A20887C2,42111,1,5,4,44,46,2246
77795,77795,132DCF25B9397E4F14B57C16A20887C2,13821,5,9,4,49,45,2495
77796,77796,132DCF25B9397E4F14B57C16A20887C2,42111,10,11,1,44,46,2246
77797,77797,132DCF25B9397E4F14B57C16A20887C2,11771,20,21,1,39,49,1999
77798,77798,132DCF25B9397E4F14B57C16A20887C2,11021,21,22,1,36,49,1849
77799,77799,A923C41770F47C64367C4A31C06C83C7,40925,0,2,2,35,49,1799
77800,77800,A923C41770F47C64367C4A31C06C83C7,11231,2,4,2,37,49,1899
77801,77801,A923C41770F47C64367C4A31C06C83C7,42523,4,6,2,31,47,1597
77802,77802,A923C41770F47C64367C4A31C06C83C7,11431,9,11,2,29,47,1497
77803,77803,A923C41770F47C64367C4A31C06C83C7,10292,13,14,1,30,47,1547
77804,77804,A923C41770F47C64367C4A31C06C83C7,10341,15,20,5,31,47,1597
77808,77808,AD3E6481838BF400FA98C1C2BDCD8C19,42681,1,4,3,24,48,1248
77809,77809,AD3E6481838BF400FA98C1C2BDCD8C19,10211,8,9,1,16,49,849
77810,77810,AD3E6481838BF400FA98C1C2BDCD8C19,42681,13,23,10,24,48,1248
77818,77818,67E463A97F2732907F7B14F7E69E6FDD,11861,0,8,8,32,47,1647
77819,77819,67E463A97F2732907F7B14F7E69E6FDD,13321,13,16,3,41,37,2087
77820,77820,67E463A97F2732907F7B14F7E69E6FDD,11861,20,23,3,32,47,1647
77834,77834,F4A5CE128B0276BA64A57CF9F5D60F74,42831,0,14,14,27,48,1398
77835,77835,F4A5CE128B0276BA64A57CF9F5D60F74,40951,15,17,2,36,49,1849
77836,77836,F4A5CE128B0276BA64A57CF9F5D60F74,42831,18,23,5,27,48,1398
77841,77841,581E72A8FA6DD89C033B1582E57E82BB,13471,0,3,3,47,49,2399
77842,77842,581E72A8FA6DD89C033B1582E57E82BB,10801,4,5,1,42,47,2147
77843,77843,581E72A8FA6DD89C033B1582E57E82BB,42461,6,13,7,45,47,2297
77844,77844,581E72A8FA6DD89C033B1582E57E82BB,13121,18,20,2,38,46,1946
77849,77849,A7B47D86EDC54D750D3985FD16D6CF0C,43951,0,4,4,49,41,2491
77850,77850,A7B47D86EDC54D750D3985FD16D6CF0C,43101,5,7,2,46,40,2340
77851,77851,A7B47D86EDC54D750D3985FD16D6CF0C,43951,9,11,2,49,41,2491
77852,77852,A7B47D86EDC54D750D3985FD16D6CF0C,12311,15,16,1,30,44,1544
77853,77853,A7B47D86EDC54D750D3985FD16D6CF0C,43951,19,21,2,49,41,2491
77854,77854,7A69176949A6F3CD56C41411DF7AEF2C,43161,2,6,4,35,47,1797
77855,77855,7A69176949A6F3CD56C41411DF7AEF2C,40673,10,12,2,36,48,1848
77856,77856,7A69176949A6F3CD56C41411DF7AEF2C,10231,21,22,1,39,49,1999
77857,77857,5B51BC643A26489396AC90A6305DBADE,11271,0,1,1,37,48,1898
77858,77858,5B51BC643A26489396AC90A6305DBADE,11231,1,19,18,37,49,1899
77859,77859,5B51BC643A26489396AC90A6305DBADE,13731,21,23,2,33,49,1699
77864,77864,A4568B18E470D509060E9E98454BE847,12601,1,2,1,25,47,1297
77865,77865,A4568B18E470D509060E9E98454BE847,12671,3,6,3,21,43,1093
77866,77866,A4568B18E470D509060E9E98454BE847,12601,7,22,15,25,47,1297
77871,77871,394B81CC36B31D897120A6153D7C1457,11061,0,4,4,29,48,1498
77872,77872,394B81CC36B31D897120A6153D7C1457,12121,6,15,9,29,47,1497
77873,77873,394B81CC36B31D897120A6153D7C1457,11061,18,19,1,29,48,1498
77874,77874,394B81CC36B31D897120A6153D7C1457,11151,20,21,1,30,48,1548
77875,77875,394B81CC36B31D897120A6153D7C1457,11061,21,23,2,29,48,1498
77879,77879,9EA3EA8859CCFDBBC3EA113778C9DE0B,10881,0,8,8,34,48,1748
77880,77880,9EA3EA8859CCFDBBC3EA113778C9DE0B,42623,11,12,1,22,49,1149
77881,77881,9EA3EA8859CCFDBBC3EA113778C9DE0B,10881,19,22,3,34,48,1748
77882,77882,591CB3E93BA04B4E9A44FA30E9D2B534,42531,0,2,2,31,45,1595
77883,77883,591CB3E93BA04B4E9A44FA30E9D2B534,12661,2,6,4,32,45,1645
77884,77884,591CB3E93BA04B4E9A44FA30E9D2B534,11551,8,13,5,39,49,1999
77885,77885,591CB3E93BA04B4E9A44FA30E9D2B534,10251,13,17,4,35,47,1797
77886,77886,591CB3E93BA04B4E9A44FA30E9D2B534,11771,19,23,4,39,49,1999
77887,77887,9E3E758D6B4A550CE6D4227B72B6F4A8,11861,0,17,17,32,47,1647
77888,77888,9E3E758D6B4A550CE6D4227B72B6F4A8,11541,17,20,3,35,49,1799
77889,77889,9E3E758D6B4A550CE6D4227B72B6F4A8,11861,20,23,3,32,47,1647
77890,77890,9B3CEEB5258D8C7EE02AB18106A0FB98,13911,3,5,2,39,46,1996
77891,77891,9B3CEEB5258D8C7EE02AB18106A0FB98,42861,7,9,2,37,44,1894
77892,77892,9B3CEEB5258D8C7EE02AB18106A0FB98,42864,9,16,7,38,44,1944
77893,77893,9B3CEEB5258D8C7EE02AB18106A0FB98,11261,17,18,1,36,46,1846
77894,77894,9B3CEEB5258D8C7EE02AB18106A0FB98,42864,19,22,3,38,44,1944
77902,77902,95F1C7EF7702B59694E8AD4B99F8B838,11151,0,7,7,30,48,1548
77903,77903,95F1C7EF7702B59694E8AD4B99F8B838,43471,9,15,6,31,49,1599
77904,77904,95F1C7EF7702B59694E8AD4B99F8B838,11074,19,20,1,37,47,1897
77905,77905,537D82A817A1381A8BFD833A3BEC4C9C,13911,2,4,2,39,46,1996
77906,77906,537D82A817A1381A8BFD833A3BEC4C9C,12211,5,6,1,41,44,2094
77907,77907,537D82A817A1381A8BFD833A3BEC4C9C,11261,7,8,1,36,46,1846
77908,77908,537D82A817A1381A8BFD833A3BEC4C9C,12491,12,19,7,36,43,1843
77909,77909,784B731FB48DA266D31BFD4ACBDB8A39,11021,0,7,7,36,49,1849
77910,77910,784B731FB48DA266D31BFD4ACBDB8A39,13101,8,11,3,40,47,2047
77911,77911,784B731FB48DA266D31BFD4ACBDB8A39,11021,12,23,11,36,49,1849
77912,77912,6B614428F8D95ECFDE2207017437E97D,19281,0,2,2,16,32,832
77913,77913,6B614428F8D95ECFDE2207017437E97D,12871,5,16,11,22,33,1133
77914,77914,6B614428F8D95ECFDE2207017437E97D,19281,20,22,2,16,32,832
77915,77915,8B809398ACCC273974413530038384A4,42201,0,3,3,43,46,2196
77916,77916,8B809398ACCC273974413530038384A4,42321,3,6,3,43,47,2197
77917,77917,8B809398ACCC273974413530038384A4,10841,14,16,2,37,47,1897
77918,77918,8B809398ACCC273974413530038384A4,10411,18,21,3,36,48,1848
77919,77919,EDAB0C0B8195ECBA5ACF0AFE7CCDE2D3,13461,0,3,3,39,44,1994
77920,77920,EDAB0C0B8195ECBA5ACF0AFE7CCDE2D3,11261,8,13,5,36,46,1846
77921,77921,EDAB0C0B8195ECBA5ACF0AFE7CCDE2D3,13911,13,15,2,39,46,1996
77922,77922,EDAB0C0B8195ECBA5ACF0AFE7CCDE2D3,11261,18,22,4,36,46,1846
77926,77926,868B26941956847000190FB51DDB9544,11231,0,18,18,37,49,1899
77927,77927,868B26941956847000190FB51DDB9544,42191,18,20,2,38,49,1949
77928,77928,868B26941956847000190FB51DDB9544,11481,20,23,3,41,48,2098
77935,77935,D57B4F47C17DAF70D7DF257462476687,12601,8,15,7,25,47,1297
77936,77936,D57B4F47C17DAF70D7DF257462476687,10501,15,16,1,22,46,1146
77937,77937,D57B4F47C17DAF70D7DF257462476687,11871,18,23,5,29,46,1496
77938,77938,8F0DB5319866C8E59D99F7AC9A3D3B2B,10661,0,18,18,37,49,1899
77939,77939,8F0DB5319866C8E59D99F7AC9A3D3B2B,11521,19,20,1,41,48,2098
77940,77940,8F0DB5319866C8E59D99F7AC9A3D3B2B,10661,20,23,3,37,49,1899
77954,77954,7F683BD350227B09C7ECC1328A0C4739,42011,0,6,6,36,46,1846
77955,77955,7F683BD350227B09C7ECC1328A0C4739,11941,8,9,1,37,46,1896
77956,77956,7F683BD350227B09C7ECC1328A0C4739,13711,11,12,1,38,46,1946
77957,77957,7F683BD350227B09C7ECC1328A0C4739,42011,12,15,3,36,46,1846
77958,77958,7F683BD350227B09C7ECC1328A0C4739,13711,16,17,1,38,46,1946
77959,77959,7F683BD350227B09C7ECC1328A0C4739,11941,17,20,3,37,46,1896
77960,77960,A7889E15E0F93853EAB5CF324793B9C0,12611,2,7,5,41,29,2079
77961,77961,A7889E15E0F93853EAB5CF324793B9C0,12792,10,12,2,34,30,1730
77962,77962,A7889E15E0F93853EAB5CF324793B9C0,15411,13,15,2,44,27,2227
77963,77963,A7889E15E0F93853EAB5CF324793B9C0,12611,15,16,1,41,29,2079
77964,77964,A7889E15E0F93853EAB5CF324793B9C0,12792,19,21,2,34,30,1730
77965,77965,A7889E15E0F93853EAB5CF324793B9C0,15411,21,23,2,44,27,2227
77966,77966,139418494564D0CB98B32E2BC13FF394,11541,1,10,9,35,49,1799
77967,77967,139418494564D0CB98B32E2BC13FF394,11151,12,14,2,30,48,1548
77968,77968,139418494564D0CB98B32E2BC13FF394,11201,21,23,2,35,49,1799
77969,77969,DC15358175A492C6F21AAEFAD4CD0BB7,42401,0,8,8,36,47,1847
77970,77970,DC15358175A492C6F21AAEFAD4CD0BB7,42261,14,15,1,25,49,1299
77971,77971,DC15358175A492C6F21AAEFAD4CD0BB7,10111,17,23,6,37,47,1897
77975,77975,DE6709015B79F307E57CED7DDDF807DA,12491,0,6,6,36,43,1843
77976,77976,DE6709015B79F307E57CED7DDDF807DA,42861,7,10,3,37,44,1894
77977,77977,DE6709015B79F307E57CED7DDDF807DA,42151,11,13,2,35,45,1795
77978,77978,DE6709015B79F307E57CED7DDDF807DA,42861,15,18,3,37,44,1894
77979,77979,DE6709015B79F307E57CED7DDDF807DA,12491,20,23,3,36,43,1843
77980,77980,4F6A6D6BDB1CA40A8AF45B87F3BE9E9C,43471,0,14,14,31,49,1599
77981,77981,4F6A6D6BDB1CA40A8AF45B87F3BE9E9C,11491,15,17,2,36,47,1847
77982,77982,4F6A6D6BDB1CA40A8AF45B87F3BE9E9C,10721,18,19,1,31,48,1598
77983,77983,4F6A6D6BDB1CA40A8AF45B87F3BE9E9C,40872,20,21,1,30,49,1549
77990,77990,AA9DDBAE747C0C61A76E689DD898E315,42301,0,6,6,36,47,1847
77991,77991,AA9DDBAE747C0C61A76E689DD898E315,11871,8,10,2,29,46,1496
77992,77992,AA9DDBAE747C0C61A76E689DD898E315,12311,10,12,2,30,44,1544
77993,77993,AA9DDBAE747C0C61A76E689DD898E315,42871,13,15,2,30,45,1545
77994,77994,AA9DDBAE747C0C61A76E689DD898E315,12661,15,18,3,32,45,1645
77995,77995,AA9DDBAE747C0C61A76E689DD898E315,42301,18,23,5,36,47,1847
78003,78003,27859AED055E6592BF98FF3D8A7131BA,42981,0,1,1,36,49,1849
78004,78004,27859AED055E6592BF98FF3D8A7131BA,43361,1,5,4,38,48,1948
78005,78005,27859AED055E6592BF98FF3D8A7131BA,11914,8,19,11,37,48,1898
78006,78006,27859AED055E6592BF98FF3D8A7131BA,13231,20,23,3,39,46,1996
78007,78007,AE10E091EA2027CDBE5CBFBC2238F486,19244,0,5,5,1,43,93
78008,78008,AE10E091EA2027CDBE5CBFBC2238F486,12921,6,16,10,9,41,491
78009,78009,AE10E091EA2027CDBE5CBFBC2238F486,19114,20,21,1,7,43,393
78010,78010,C6AC8895632679A119F682F1B4D03E3B,11901,0,10,10,42,49,2149
78011,78011,C6AC8895632679A119F682F1B4D03E3B,10107,16,19,3,38,49,1949
78012,78012,C6AC8895632679A119F682F1B4D03E3B,19114,20,23,3,7,43,393
78013,78013,5FD5A52981B886C374F4B8129B6638FC,11631,0,6,6,12,49,649
78014,78014,5FD5A52981B886C374F4B8129B6638FC,19021,8,10,2,10,45,545
78015,78015,5FD5A52981B886C374F4B8129B6638FC,43021,11,13,2,16,43,843
78016,78016,5FD5A52981B886C374F4B8129B6638FC,12641,14,15,1,10,43,543
78017,78017,5FD5A52981B886C374F4B8129B6638FC,19021,15,17,2,10,45,545
78018,78018,5FD5A52981B886C374F4B8129B6638FC,11631,18,23,5,12,49,649
78022,78022,7446641F73809A823733CBB6864B4050,42861,0,14,14,37,44,1894
78023,78023,7446641F73809A823733CBB6864B4050,11261,14,17,3,36,46,1846
78024,78024,7446641F73809A823733CBB6864B4050,10151,19,21,2,34,47,1747
78025,78025,ED7C25E7896481A849F3519215667780,42941,0,4,4,37,47,1897
78026,78026,ED7C25E7896481A849F3519215667780,11491,4,6,2,36,47,1847
78027,78027,ED7C25E7896481A849F3519215667780,43161,9,12,3,35,47,1797
78028,78028,ED7C25E7896481A849F3519215667780,42161,15,19,4,36,47,1847
78029,78029,ED7C25E7896481A849F3519215667780,12561,20,21,1,45,43,2293
78030,78030,ED7C25E7896481A849F3519215667780,11491,22,23,1,36,47,1847
78041,78041,32EC0F36441544FE0077B62E357B89B9,43021,1,5,4,16,43,843
78042,78042,32EC0F36441544FE0077B62E357B89B9,12921,7,16,9,9,41,491
78043,78043,32EC0F36441544FE0077B62E357B89B9,43021,16,18,2,16,43,843
78044,78044,32EC0F36441544FE0077B62E357B89B9,12921,19,21,2,9,41,491
78045,78045,DFBD81ACA1F50E6A22C2192D17AE2751,13314,0,16,16,31,39,1589
78046,78046,DFBD81ACA1F50E6A22C2192D17AE2751,13091,18,19,1,20,42,1042
78047,78047,DFBD81ACA1F50E6A22C2192D17AE2751,42381,19,22,3,39,41,1991
78048,78048,7169FA01502782C069FB888C1FC19962,10681,0,5,5,30,48,1548
78049,78049,7169FA01502782C069FB888C1FC19962,43311,6,7,1,31,48,1598
78050,78050,7169FA01502782C069FB888C1FC19962,10681,7,8,1,30,48,1548
78051,78051,7169FA01502782C069FB888C1FC19962,10351,15,16,1,28,45,1445
78052,78052,7169FA01502782C069FB888C1FC19962,10634,17,18,1,27,45,1395
78053,78053,7169FA01502782C069FB888C1FC19962,10351,18,19,1,28,45,1445
78054,78054,D2BE734582180DAAF2896780F67C646E,15301,0,6,6,35,16,1766
78055,78055,D2BE734582180DAAF2896780F67C646E,15671,7,17,10,37,26,1876
78056,78056,D2BE734582180DAAF2896780F67C646E,15301,18,23,5,35,16,1766
78057,78057,33BB1FBC807A18D7B763AE4B57056758,13314,3,4,1,31,39,1589
78058,78058,33BB1FBC807A18D7B763AE4B57056758,12521,5,10,5,35,41,1791
78059,78059,33BB1FBC807A18D7B763AE4B57056758,13671,14,15,1,27,43,1393
78060,78060,33BB1FBC807A18D7B763AE4B57056758,12521,19,21,2,35,41,1791
78068,78068,F94E5CCB50337D3F418291F67EA7B8C3,40343,1,2,1,24,49,1249
78069,78069,F94E5CCB50337D3F418291F67EA7B8C3,42121,6,9,3,26,49,1349
78070,78070,F94E5CCB50337D3F418291F67EA7B8C3,42071,14,15,1,31,49,1599
78071,78071,F94E5CCB50337D3F418291F67EA7B8C3,42261,15,17,2,25,49,1299
78072,78072,F94E5CCB50337D3F418291F67EA7B8C3,42071,17,23,6,31,49,1599
78077,78077,0C653DC860B823A0FBD73915967D7A74,43051,0,4,4,46,45,2345
78078,78078,0C653DC860B823A0FBD73915967D7A74,12221,6,8,2,43,44,2194
78079,78079,0C653DC860B823A0FBD73915967D7A74,42631,8,10,2,43,45,2195
78080,78080,0C653DC860B823A0FBD73915967D7A74,12221,15,16,1,43,44,2194
78081,78081,0C653DC860B823A0FBD73915967D7A74,43051,19,20,1,46,45,2345
78082,78082,4BD400D7F597B681CE3C274F3ADB197C,16311,0,1,1,2,11,111
78083,78083,4BD400D7F597B681CE3C274F3ADB197C,16233,1,13,12,5,15,265
78084,78084,4BD400D7F597B681CE3C274F3ADB197C,16311,20,22,2,2,11,111
78089,78089,E68938B769BE3082CBE1F99A60593DDB,13111,0,2,2,42,46,2146
78090,78090,E68938B769BE3082CBE1F99A60593DDB,13791,5,11,6,42,47,2147
78091,78091,E68938B769BE3082CBE1F99A60593DDB,42204,11,12,1,43,46,2196
78092,78092,E68938B769BE3082CBE1F99A60593DDB,13221,13,15,2,40,47,2047
78093,78093,E68938B769BE3082CBE1F99A60593DDB,13111,18,22,4,42,46,2146
78098,78098,4A7DB4C98C495CBE39929E4AF5856114,11271,0,7,7,37,48,1898
78099,78099,4A7DB4C98C495CBE39929E4AF5856114,11521,13,14,1,41,48,2098
78100,78100,4A7DB4C98C495CBE39929E4AF5856114,11301,19,23,4,41,49,2099
78101,78101,0933B06061F8F3536F06AEF0D300106F,11941,0,6,6,37,46,1896
78102,78102,0933B06061F8F3536F06AEF0D300106F,13711,9,13,4,38,46,1946
78103,78103,0933B06061F8F3536F06AEF0D300106F,11941,15,17,2,37,46,1896
78104,78104,0933B06061F8F3536F06AEF0D300106F,13711,17,19,2,38,46,1946
78105,78105,0933B06061F8F3536F06AEF0D300106F,11941,20,21,1,37,46,1896
78106,78106,0933B06061F8F3536F06AEF0D300106F,13711,21,22,1,38,46,1946
78107,78107,17B310C5C0CD98D91D2EAE008E1E6775,42491,0,11,11,32,46,1646
78108,78108,17B310C5C0CD98D91D2EAE008E1E6775,10161,11,14,3,35,49,1799
78109,78109,17B310C5C0CD98D91D2EAE008E1E6775,42491,14,15,1,32,46,1646
78110,78110,17B310C5C0CD98D91D2EAE008E1E6775,42583,17,21,4,40,48,2048
78111,78111,17B310C5C0CD98D91D2EAE008E1E6775,42491,22,23,1,32,46,1646
78112,78112,1607BA6A625F09858B43E48B2EC869F9,12311,0,7,7,30,44,1544
78113,78113,1607BA6A625F09858B43E48B2EC869F9,12381,12,14,2,32,48,1648
78114,78114,1607BA6A625F09858B43E48B2EC869F9,42523,16,17,1,31,47,1597
78115,78115,1607BA6A625F09858B43E48B2EC869F9,12161,18,19,1,32,46,1646
78116,78116,1607BA6A625F09858B43E48B2EC869F9,43671,19,21,2,35,48,1798
78117,78117,1607BA6A625F09858B43E48B2EC869F9,40981,22,23,1,34,47,1747
78122,78122,C1E5BCC1C7F8ECB908A80076B478386E,10691,0,6,6,33,48,1698
78123,78123,C1E5BCC1C7F8ECB908A80076B478386E,11561,7,9,2,32,49,1649
78124,78124,C1E5BCC1C7F8ECB908A80076B478386E,42021,13,14,1,33,47,1697
78125,78125,C1E5BCC1C7F8ECB908A80076B478386E,11861,16,18,2,32,47,1647
78126,78126,C1E5BCC1C7F8ECB908A80076B478386E,10691,19,23,4,33,48,1698
78142,78142,3EA40228978481F4003A0E14EC2DCF1C,10231,0,6,6,39,49,1999
78143,78143,3EA40228978481F4003A0E14EC2DCF1C,12491,10,12,2,36,43,1843
78144,78144,3EA40228978481F4003A0E14EC2DCF1C,11021,15,17,2,36,49,1849
78145,78145,3EA40228978481F4003A0E14EC2DCF1C,10231,17,22,5,39,49,1999
78149,78149,21F01E243FB4E67DFB5975A1225F7042,11861,0,10,10,32,47,1647
78150,78150,21F01E243FB4E67DFB5975A1225F7042,42191,13,15,2,38,49,1949
78151,78151,21F01E243FB4E67DFB5975A1225F7042,11861,17,23,6,32,47,1647
78158,78158,27F132E818644D3933B7D51A13F3BE57,15411,0,1,1,44,27,2227
78159,78159,27F132E818644D3933B7D51A13F3BE57,15561,4,5,1,32,22,1622
78160,78160,27F132E818644D3933B7D51A13F3BE57,15391,8,10,2,35,26,1776
78161,78161,27F132E818644D3933B7D51A13F3BE57,15411,13,23,10,44,27,2227
78166,78166,823BB637426A4B64F4A56D087D45C241,12641,0,6,6,10,43,543
78167,78167,823BB637426A4B64F4A56D087D45C241,12921,11,18,7,9,41,491
78168,78168,823BB637426A4B64F4A56D087D45C241,49201,19,20,1,7,41,391
78169,78169,823BB637426A4B64F4A56D087D45C241,12921,20,22,2,9,41,491
78170,78170,823BB637426A4B64F4A56D087D45C241,12641,22,23,1,10,43,543
78175,78175,2C3E302154C3535ED9B8593F94CE546C,16251,1,18,17,15,13,763
78176,78176,2C3E302154C3535ED9B8593F94CE546C,15145,19,20,1,22,9,1109
78177,78177,2C3E302154C3535ED9B8593F94CE546C,16251,21,22,1,15,13,763
78178,78178,FE5BD9848E0FBBF0629F9C0576D0DEBF,13231,0,16,16,39,46,1996
78179,78179,FE5BD9848E0FBBF0629F9C0576D0DEBF,42321,19,20,1,43,47,2197
78180,78180,FE5BD9848E0FBBF0629F9C0576D0DEBF,10801,21,23,2,42,47,2147
78181,78181,E01ED90AD50B751B77DE5D3D5EA35C57,43391,0,1,1,29,48,1498
78182,78182,E01ED90AD50B751B77DE5D3D5EA35C57,11151,1,7,6,30,48,1548
78183,78183,E01ED90AD50B751B77DE5D3D5EA35C57,11061,10,13,3,29,48,1498
78184,78184,E01ED90AD50B751B77DE5D3D5EA35C57,11151,13,17,4,30,48,1548
78185,78185,E01ED90AD50B751B77DE5D3D5EA35C57,11061,18,23,5,29,48,1498
78206,78206,2BB131B28919DD39B3A1FF3FB84AF680,40891,0,11,11,37,47,1897
78207,78207,2BB131B28919DD39B3A1FF3FB84AF680,11021,11,13,2,36,49,1849
78208,78208,2BB131B28919DD39B3A1FF3FB84AF680,10716,14,15,1,30,46,1546
78209,78209,2BB131B28919DD39B3A1FF3FB84AF680,40891,16,23,7,37,47,1897
78214,78214,8D7DFE0A5762A527D2CD7BF7D14A4EE7,11331,0,7,7,37,48,1898
78215,78215,8D7DFE0A5762A527D2CD7BF7D14A4EE7,13121,8,10,2,38,46,1946
78216,78216,8D7DFE0A5762A527D2CD7BF7D14A4EE7,40124,13,15,2,38,47,1947
78217,78217,8D7DFE0A5762A527D2CD7BF7D14A4EE7,13121,16,17,1,38,46,1946
78218,78218,8D7DFE0A5762A527D2CD7BF7D14A4EE7,11331,18,22,4,37,48,1898
78222,78222,42D3CDA79183A10C5E8F87BAA8FFC143,43391,1,6,5,29,48,1498
78223,78223,42D3CDA79183A10C5E8F87BAA8FFC143,10381,10,11,1,31,49,1599
78224,78224,42D3CDA79183A10C5E8F87BAA8FFC143,42121,13,14,1,26,49,1349
78225,78225,42D3CDA79183A10C5E8F87BAA8FFC143,42081,14,16,2,24,49,1249
78226,78226,42D3CDA79183A10C5E8F87BAA8FFC143,42261,17,19,2,25,49,1299
78227,78227,42D3CDA79183A10C5E8F87BAA8FFC143,42081,19,20,1,24,49,1249
78228,78228,42D3CDA79183A10C5E8F87BAA8FFC143,11061,21,22,1,29,48,1498
78229,78229,2BC714C204CBBFEE616B46CC493E087B,12641,0,6,6,10,43,543
78230,78230,2BC714C204CBBFEE616B46CC493E087B,12921,7,8,1,9,41,491
78231,78231,2BC714C204CBBFEE616B46CC493E087B,12641,11,14,3,10,43,543
78232,78232,2BC714C204CBBFEE616B46CC493E087B,12921,15,16,1,9,41,491
78233,78233,2BC714C204CBBFEE616B46CC493E087B,12641,18,22,4,10,43,543
78234,78234,7C5210855A5DFB6ACF7A087ADA0E2F3D,13911,0,5,5,39,46,1996
78235,78235,7C5210855A5DFB6ACF7A087ADA0E2F3D,42231,6,11,5,37,46,1896
78236,78236,7C5210855A5DFB6ACF7A087ADA0E2F3D,13911,14,15,1,39,46,1996
78237,78237,7C5210855A5DFB6ACF7A087ADA0E2F3D,42231,15,18,3,37,46,1896
78238,78238,7C5210855A5DFB6ACF7A087ADA0E2F3D,13911,19,23,4,39,46,1996
78239,78239,2C34D27A5CF6AB5C160CBF93022831FF,42071,1,4,3,31,49,1599
78240,78240,2C34D27A5CF6AB5C160CBF93022831FF,13731,4,7,3,33,49,1699
78241,78241,2C34D27A5CF6AB5C160CBF93022831FF,42071,8,11,3,31,49,1599
78242,78242,2C34D27A5CF6AB5C160CBF93022831FF,11061,19,20,1,29,48,1498
78243,78243,2C34D27A5CF6AB5C160CBF93022831FF,42071,20,23,3,31,49,1599
78250,78250,024AB2D90319DF57F94996854D076E3D,13271,0,7,7,41,47,2097
78251,78251,024AB2D90319DF57F94996854D076E3D,11531,8,9,1,34,49,1749
78252,78252,024AB2D90319DF57F94996854D076E3D,40271,13,17,4,35,49,1799
78253,78253,024AB2D90319DF57F94996854D076E3D,13271,18,23,5,41,47,2097
78254,78254,91193F64C9CD116E72503459E9F5B05D,12521,6,8,2,35,41,1791
78255,78255,91193F64C9CD116E72503459E9F5B05D,13314,11,15,4,31,39,1589
78256,78256,91193F64C9CD116E72503459E9F5B05D,12521,19,21,2,35,41,1791
78257,78257,91193F64C9CD116E72503459E9F5B05D,13314,21,22,1,31,39,1589
78258,78258,446AC7E279C6659F3E40FC9C0B9B7F45,43061,0,5,5,43,46,2196
78259,78259,446AC7E279C6659F3E40FC9C0B9B7F45,13341,6,9,3,44,45,2245
78260,78260,446AC7E279C6659F3E40FC9C0B9B7F45,42631,9,10,1,43,45,2195
78261,78261,446AC7E279C6659F3E40FC9C0B9B7F45,13341,11,16,5,44,45,2245
78262,78262,446AC7E279C6659F3E40FC9C0B9B7F45,42631,16,17,1,43,45,2195
78263,78263,446AC7E279C6659F3E40FC9C0B9B7F45,13341,19,21,2,44,45,2245
78264,78264,A0A1552B510BA8E646CC715FB0ED34DE,11361,9,11,2,22,48,1148
78265,78265,A0A1552B510BA8E646CC715FB0ED34DE,10951,16,17,1,29,48,1498
78266,78266,A0A1552B510BA8E646CC715FB0ED34DE,11361,19,20,1,22,48,1148
78273,78273,C179CB04DCCFC26C27C5F20AF0844F96,11571,0,2,2,13,46,696
78274,78274,C179CB04DCCFC26C27C5F20AF0844F96,19441,3,4,1,8,46,446
78275,78275,C179CB04DCCFC26C27C5F20AF0844F96,11571,5,6,1,13,46,696
78276,78276,C179CB04DCCFC26C27C5F20AF0844F96,19441,17,18,1,8,46,446
78277,78277,C179CB04DCCFC26C27C5F20AF0844F96,11571,21,22,1,13,46,696
78288,78288,C3FB4EE105B7861A50BF03BC1584CA1D,13111,0,7,7,42,46,2146
78289,78289,C3FB4EE105B7861A50BF03BC1584CA1D,42201,7,10,3,43,46,2196
78290,78290,C3FB4EE105B7861A50BF03BC1584CA1D,13111,11,13,2,42,46,2146
78291,78291,C3FB4EE105B7861A50BF03BC1584CA1D,42201,13,16,3,43,46,2196
78292,78292,C3FB4EE105B7861A50BF03BC1584CA1D,13111,17,23,6,42,46,2146
78293,78293,7C1C18B2AA547D48FF7F85CDEF33402E,13561,0,7,7,37,49,1899
78294,78294,7C1C18B2AA547D48FF7F85CDEF33402E,13821,12,13,1,49,45,2495
78295,78295,7C1C18B2AA547D48FF7F85CDEF33402E,13951,16,17,1,47,45,2395
78296,78296,7C1C18B2AA547D48FF7F85CDEF33402E,12083,19,21,2,36,49,1849
78297,78297,120368F7CD3E20C4A5CFEF1F75B84608,11381,1,8,7,30,47,1547
78298,78298,120368F7CD3E20C4A5CFEF1F75B84608,41631,8,11,3,28,47,1447
78299,78299,120368F7CD3E20C4A5CFEF1F75B84608,11381,13,14,1,30,47,1547
78300,78300,120368F7CD3E20C4A5CFEF1F75B84608,10471,19,21,2,37,48,1898
78304,78304,00ED2280FB2BEC22D8FB36F8A7AFB1A5,42791,0,7,7,35,45,1795
78305,78305,00ED2280FB2BEC22D8FB36F8A7AFB1A5,10271,9,13,4,37,46,1896
78306,78306,00ED2280FB2BEC22D8FB36F8A7AFB1A5,13121,14,18,4,38,46,1946
78307,78307,00ED2280FB2BEC22D8FB36F8A7AFB1A5,10251,20,21,1,35,47,1797
78308,78308,00ED2280FB2BEC22D8FB36F8A7AFB1A5,13121,21,23,2,38,46,1946
78319,78319,B6B689E20BBAED2670EB9BE2B4C9BDC7,42321,0,1,1,43,47,2197
78320,78320,B6B689E20BBAED2670EB9BE2B4C9BDC7,13791,3,8,5,42,47,2147
78321,78321,B6B689E20BBAED2670EB9BE2B4C9BDC7,13101,9,10,1,40,47,2047
78322,78322,B6B689E20BBAED2670EB9BE2B4C9BDC7,12381,12,13,1,32,48,1648
78323,78323,B6B689E20BBAED2670EB9BE2B4C9BDC7,11481,15,16,1,41,48,2098
78324,78324,B6B689E20BBAED2670EB9BE2B4C9BDC7,13791,21,23,2,42,47,2147
78329,78329,3668A484BABF64A24B33B58BBBC417A2,42491,1,8,7,32,46,1646
78330,78330,3668A484BABF64A24B33B58BBBC417A2,42633,9,11,2,42,46,2146
78331,78331,3668A484BABF64A24B33B58BBBC417A2,42491,11,12,1,32,46,1646
78332,78332,3668A484BABF64A24B33B58BBBC417A2,42633,16,17,1,42,46,2146
78333,78333,3668A484BABF64A24B33B58BBBC417A2,42491,18,23,5,32,46,1646
78334,78334,8CD5156CF883DA15618BAFE58DDCF2A7,42581,0,10,10,38,48,1948
78335,78335,8CD5156CF883DA15618BAFE58DDCF2A7,11914,10,11,1,37,48,1898
78336,78336,8CD5156CF883DA15618BAFE58DDCF2A7,42581,12,14,2,38,48,1948
78337,78337,8CD5156CF883DA15618BAFE58DDCF2A7,11914,16,17,1,37,48,1898
78338,78338,8CD5156CF883DA15618BAFE58DDCF2A7,42581,20,22,2,38,48,1948
78339,78339,D7349708A10855AEF98FEB8D22C33E59,40833,0,7,7,41,47,2097
78340,78340,D7349708A10855AEF98FEB8D22C33E59,11231,11,17,6,37,49,1899
78341,78341,D7349708A10855AEF98FEB8D22C33E59,13271,19,23,4,41,47,2097
78359,78359,02520C980C83C228272F82E550C0374E,11151,3,8,5,30,48,1548
78360,78360,02520C980C83C228272F82E550C0374E,11061,10,14,4,29,48,1498
78361,78361,02520C980C83C228272F82E550C0374E,10901,18,20,2,35,48,1798
78362,78362,02520C980C83C228272F82E550C0374E,41382,20,22,2,38,49,1949
78363,78363,2917A11EB625CB868E9962150273A0D4,13671,0,5,5,27,43,1393
78364,78364,2917A11EB625CB868E9962150273A0D4,10301,5,7,2,31,45,1595
78365,78365,2917A11EB625CB868E9962150273A0D4,10431,7,16,9,33,49,1699
78366,78366,2917A11EB625CB868E9962150273A0D4,12161,20,21,1,32,46,1646
78367,78367,2917A11EB625CB868E9962150273A0D4,13671,22,23,1,27,43,1393
78368,78368,92E1BAA88B052422B820ED36A9E8F107,41392,0,14,14,43,48,2198
78369,78369,92E1BAA88B052422B820ED36A9E8F107,11271,15,16,1,37,48,1898
78370,78370,92E1BAA88B052422B820ED36A9E8F107,41392,18,23,5,43,48,2198
78371,78371,8A0FE8743DF9AE08FEBD9B6E7DEB27AA,10351,4,6,2,28,45,1445
78372,78372,8A0FE8743DF9AE08FEBD9B6E7DEB27AA,10631,8,16,8,28,46,1446
78373,78373,8A0FE8743DF9AE08FEBD9B6E7DEB27AA,12601,19,20,1,25,47,1297
78400,78400,F06696253146EEBB7842F43A19CD992F,19801,4,5,1,19,26,976
78401,78401,F06696253146EEBB7842F43A19CD992F,43121,6,8,2,25,27,1277
78402,78402,F06696253146EEBB7842F43A19CD992F,12871,11,12,1,22,33,1133
78403,78403,F06696253146EEBB7842F43A19CD992F,19801,12,17,5,19,26,976
78404,78404,F06696253146EEBB7842F43A19CD992F,12871,18,19,1,22,33,1133
78405,78405,F06696253146EEBB7842F43A19CD992F,19801,20,22,2,19,26,976
78409,78409,BED0ECABE31BE6050710942A02B0A484,13911,0,6,6,39,46,1996
78410,78410,BED0ECABE31BE6050710942A02B0A484,42231,9,13,4,37,46,1896
78411,78411,BED0ECABE31BE6050710942A02B0A484,13911,14,16,2,39,46,1996
78412,78412,BED0ECABE31BE6050710942A02B0A484,42231,16,19,3,37,46,1896
78413,78413,BED0ECABE31BE6050710942A02B0A484,13911,22,23,1,39,46,1996
78414,78414,32E472ABE1AC8EE5712784968711993D,42623,0,7,7,22,49,1149
78415,78415,32E472ABE1AC8EE5712784968711993D,10721,10,11,1,31,48,1598
78416,78416,32E472ABE1AC8EE5712784968711993D,42623,12,13,1,22,49,1149
78417,78417,32E472ABE1AC8EE5712784968711993D,10721,14,22,8,31,48,1598
78433,78433,1C0548F40841AD0870DAD8EC7BECCBC6,13314,0,6,6,31,39,1589
78434,78434,1C0548F40841AD0870DAD8EC7BECCBC6,12521,9,11,2,35,41,1791
78435,78435,1C0548F40841AD0870DAD8EC7BECCBC6,13314,11,13,2,31,39,1589
78436,78436,1C0548F40841AD0870DAD8EC7BECCBC6,12521,14,16,2,35,41,1791
78437,78437,1C0548F40841AD0870DAD8EC7BECCBC6,13314,16,23,7,31,39,1589
78442,78442,14626FF97257934EB932E8E843AFE8E1,42864,0,8,8,38,44,1944
78443,78443,14626FF97257934EB932E8E843AFE8E1,11261,11,13,2,36,46,1846
78444,78444,14626FF97257934EB932E8E843AFE8E1,12051,15,20,5,20,47,1047
78448,78448,4C479F308A99C28A9312A97B8F351EC7,16421,0,8,8,8,2,402
78449,78449,4C479F308A99C28A9312A97B8F351EC7,10221,12,15,3,34,49,1749
78450,78450,4C479F308A99C28A9312A97B8F351EC7,10161,18,22,4,35,49,1799
78451,78451,E648A6F090A3BE85617E0ED54A73B4F0,12671,0,7,7,21,43,1093
78452,78452,E648A6F090A3BE85617E0ED54A73B4F0,13091,8,11,3,20,42,1042
78453,78453,E648A6F090A3BE85617E0ED54A73B4F0,12601,12,20,8,25,47,1297
78454,78454,E648A6F090A3BE85617E0ED54A73B4F0,12671,21,23,2,21,43,1093
78455,78455,3C07D1557002BF4F1AA6A6D7A8949EF2,43761,0,5,5,32,47,1647
78456,78456,3C07D1557002BF4F1AA6A6D7A8949EF2,12601,8,17,9,25,47,1297
78457,78457,3C07D1557002BF4F1AA6A6D7A8949EF2,43761,20,21,1,32,47,1647
78458,78458,3C07D1557002BF4F1AA6A6D7A8949EF2,42523,21,23,2,31,47,1597
78459,78459,BC762705693ED76C5598B7A650C2A519,19441,0,9,9,8,46,446
78460,78460,BC762705693ED76C5598B7A650C2A519,12641,14,15,1,10,43,543
78461,78461,BC762705693ED76C5598B7A650C2A519,42623,19,21,2,22,49,1149
78465,78465,90AEF58BB4CABDF543DA1FFF777671DC,11381,0,15,15,30,47,1547
78466,78466,90AEF58BB4CABDF543DA1FFF777671DC,10221,17,18,1,34,49,1749
78467,78467,90AEF58BB4CABDF543DA1FFF777671DC,11381,18,22,4,30,47,1547
78482,78482,72792027F53A660AD4A0C2CB3A15F1BE,42151,1,13,12,35,45,1795
78483,78483,72792027F53A660AD4A0C2CB3A15F1BE,13094,17,19,2,21,42,1092
78484,78484,72792027F53A660AD4A0C2CB3A15F1BE,42861,21,23,2,37,44,1894
78485,78485,D9419B851F8839F5D675C951F631DB8E,10921,0,11,11,43,48,2198
78486,78486,D9419B851F8839F5D675C951F631DB8E,43621,13,15,2,46,48,2348
78487,78487,D9419B851F8839F5D675C951F631DB8E,13951,17,18,1,47,45,2395
78488,78488,D9419B851F8839F5D675C951F631DB8E,10921,19,23,4,43,48,2198
78489,78489,2F66AC01887397A198C9CCA6611EA97B,12521,0,8,8,35,41,1791
78490,78490,2F66AC01887397A198C9CCA6611EA97B,13314,8,10,2,31,39,1589
78491,78491,2F66AC01887397A198C9CCA6611EA97B,12521,10,23,13,35,41,1791
78492,78492,C91EDEC4832C8610497ADAA0406605AA,10691,0,6,6,33,48,1698
78493,78493,C91EDEC4832C8610497ADAA0406605AA,10401,7,9,2,33,49,1699
78494,78494,C91EDEC4832C8610497ADAA0406605AA,42941,13,16,3,37,47,1897
78495,78495,C91EDEC4832C8610497ADAA0406605AA,43731,16,17,1,34,47,1747
78496,78496,C91EDEC4832C8610497ADAA0406605AA,12031,19,22,3,33,48,1698
78509,78509,290CF9B7E8E39B2A6D619522168B66C7,19441,1,5,4,8,46,446
78510,78510,290CF9B7E8E39B2A6D619522168B66C7,19621,5,7,2,5,46,296
78511,78511,290CF9B7E8E39B2A6D619522168B66C7,10221,8,18,10,34,49,1749
78512,78512,290CF9B7E8E39B2A6D619522168B66C7,19441,20,21,1,8,46,446
78513,78513,290CF9B7E8E39B2A6D619522168B66C7,19621,21,23,2,5,46,296
78520,78520,034BF108F7447DC54755E0BD15E86728,42351,0,8,8,38,45,1945
78521,78521,034BF108F7447DC54755E0BD15E86728,11261,8,11,3,36,46,1846
78522,78522,034BF108F7447DC54755E0BD15E86728,42351,11,14,3,38,45,1945
78523,78523,034BF108F7447DC54755E0BD15E86728,42864,16,17,1,38,44,1944
78524,78524,034BF108F7447DC54755E0BD15E86728,42351,18,20,2,38,45,1945
78525,78525,9BBBC00C93BA6A3176E2B008E6F8A88E,13911,0,5,5,39,46,1996
78526,78526,9BBBC00C93BA6A3176E2B008E6F8A88E,11261,6,11,5,36,46,1846
78527,78527,9BBBC00C93BA6A3176E2B008E6F8A88E,13911,12,14,2,39,46,1996
78528,78528,9BBBC00C93BA6A3176E2B008E6F8A88E,11261,14,16,2,36,46,1846
78529,78529,9BBBC00C93BA6A3176E2B008E6F8A88E,13911,16,18,2,39,46,1996
78530,78530,01067BD464140B42D6F1D4D82F8B8EE7,43481,3,4,1,39,48,1998
78531,78531,01067BD464140B42D6F1D4D82F8B8EE7,13381,6,7,1,39,47,1997
78532,78532,01067BD464140B42D6F1D4D82F8B8EE7,11231,9,14,5,37,49,1899
78533,78533,01067BD464140B42D6F1D4D82F8B8EE7,10251,14,16,2,35,47,1797
78534,78534,01067BD464140B42D6F1D4D82F8B8EE7,43481,18,20,2,39,48,1998
78535,78535,3D3D55F62FCD53D49599BD49C1B88F92,10471,0,7,7,37,48,1898
78536,78536,3D3D55F62FCD53D49599BD49C1B88F92,11231,8,9,1,37,49,1899
78537,78537,3D3D55F62FCD53D49599BD49C1B88F92,40341,13,15,2,23,49,1199
78538,78538,3D3D55F62FCD53D49599BD49C1B88F92,13121,17,21,4,38,46,1946
78539,78539,3D3D55F62FCD53D49599BD49C1B88F92,10471,21,22,1,37,48,1898
78543,78543,5139F018CB8230A84A9CE2C47CA0A1D0,43951,0,13,13,49,41,2491
78544,78544,5139F018CB8230A84A9CE2C47CA0A1D0,12561,14,15,1,45,43,2293
78545,78545,5139F018CB8230A84A9CE2C47CA0A1D0,43951,17,23,6,49,41,2491
78549,78549,8A524E85431660319A09E8D071AC107B,10801,0,4,4,42,47,2147
78550,78550,8A524E85431660319A09E8D071AC107B,42321,4,5,1,43,47,2197
78551,78551,8A524E85431660319A09E8D071AC107B,10801,8,9,1,42,47,2147
78552,78552,8A524E85431660319A09E8D071AC107B,10601,12,16,4,39,47,1997
78553,78553,8A524E85431660319A09E8D071AC107B,42321,21,23,2,43,47,2197
78554,78554,7D5000772E957DD3A483CE8963A15A13,42501,10,11,1,28,47,1447
78555,78555,7D5000772E957DD3A483CE8963A15A13,42161,14,19,5,36,47,1847
78556,78556,7D5000772E957DD3A483CE8963A15A13,12121,19,23,4,29,47,1497
78568,78568,89CA2603AB460CC5371CFF262CF45064,43161,2,8,6,35,47,1797
78569,78569,89CA2603AB460CC5371CFF262CF45064,12581,9,11,2,24,48,1248
78570,78570,89CA2603AB460CC5371CFF262CF45064,42161,15,23,8,36,47,1847
78581,78581,A2E834D310B55F9EA0A1B4DBD80E9D3B,11861,0,6,6,32,47,1647
78582,78582,A2E834D310B55F9EA0A1B4DBD80E9D3B,10611,7,11,4,32,48,1648
78583,78583,A2E834D310B55F9EA0A1B4DBD80E9D3B,11861,12,16,4,32,47,1647
78584,78584,A2E834D310B55F9EA0A1B4DBD80E9D3B,10611,17,19,2,32,48,1648
78585,78585,A2E834D310B55F9EA0A1B4DBD80E9D3B,11861,19,23,4,32,47,1647
78586,78586,EF83B220ED016CD5B34F5509FEC2D2B8,11061,0,6,6,29,48,1498
78587,78587,EF83B220ED016CD5B34F5509FEC2D2B8,13941,7,17,10,41,47,2097
78588,78588,EF83B220ED016CD5B34F5509FEC2D2B8,11381,19,22,3,30,47,1547
78589,78589,FF16D1104349162E539969031BE39A02,43481,0,7,7,39,48,1998
78590,78590,FF16D1104349162E539969031BE39A02,12514,8,11,3,38,47,1947
78591,78591,FF16D1104349162E539969031BE39A02,43481,12,14,2,39,48,1998
78592,78592,FF16D1104349162E539969031BE39A02,12511,14,16,2,39,47,1997
78593,78593,FF16D1104349162E539969031BE39A02,43481,21,22,1,39,48,1998
78594,78594,68D66AC2F31097852E1113FCAC38B096,12311,0,1,1,30,44,1544
78595,78595,68D66AC2F31097852E1113FCAC38B096,42531,2,4,2,31,45,1595
78596,78596,68D66AC2F31097852E1113FCAC38B096,12311,7,9,2,30,44,1544
78597,78597,68D66AC2F31097852E1113FCAC38B096,42531,13,14,1,31,45,1595
78598,78598,68D66AC2F31097852E1113FCAC38B096,12311,15,21,6,30,44,1544
78607,78607,22300DEAB3F7A20A2F8DD7892A11C5B7,13271,0,5,5,41,47,2097
78608,78608,22300DEAB3F7A20A2F8DD7892A11C5B7,40691,6,8,2,42,48,2148
78609,78609,22300DEAB3F7A20A2F8DD7892A11C5B7,13271,9,16,7,41,47,2097
78610,78610,22300DEAB3F7A20A2F8DD7892A11C5B7,11806,19,20,1,41,48,2098
78611,78611,22300DEAB3F7A20A2F8DD7892A11C5B7,13101,21,23,2,40,47,2047
78619,78619,2E9ACB5217DEAC635E911A6AAEF6DCF5,11261,0,13,13,36,46,1846
78620,78620,2E9ACB5217DEAC635E911A6AAEF6DCF5,12021,15,17,2,37,49,1899
78621,78621,2E9ACB5217DEAC635E911A6AAEF6DCF5,10681,19,20,1,30,48,1548
78622,78622,2E9ACB5217DEAC635E911A6AAEF6DCF5,11261,22,23,1,36,46,1846
78635,78635,D1D4F1B4017FEA89A042CB8ED8E15110,40343,0,15,15,24,49,1249
78636,78636,D1D4F1B4017FEA89A042CB8ED8E15110,40925,16,18,2,35,49,1799
78637,78637,D1D4F1B4017FEA89A042CB8ED8E15110,42081,19,21,2,24,49,1249
78641,78641,FB6D357AE6E744B7566081ADA8598AEB,43731,0,6,6,34,47,1747
78642,78642,FB6D357AE6E744B7566081ADA8598AEB,40463,8,12,4,38,49,1949
78643,78643,FB6D357AE6E744B7566081ADA8598AEB,43731,12,14,2,34,47,1747
78644,78644,FB6D357AE6E744B7566081ADA8598AEB,10881,15,19,4,34,48,1748
78645,78645,FB6D357AE6E744B7566081ADA8598AEB,43731,20,22,2,34,47,1747
78646,78646,1B1AA14FCBEAAD141CA6FAC7B338917E,42864,0,1,1,38,44,1944
78647,78647,1B1AA14FCBEAAD141CA6FAC7B338917E,11261,5,6,1,36,46,1846
78648,78648,1B1AA14FCBEAAD141CA6FAC7B338917E,42861,7,10,3,37,44,1894
78649,78649,1B1AA14FCBEAAD141CA6FAC7B338917E,11261,11,12,1,36,46,1846
78650,78650,1B1AA14FCBEAAD141CA6FAC7B338917E,42861,14,18,4,37,44,1894
78651,78651,1B1AA14FCBEAAD141CA6FAC7B338917E,42864,19,23,4,38,44,1944
78652,78652,2D914C2EB253165A5763D18FAE5FB6D2,13561,10,12,2,37,49,1899
78653,78653,2D914C2EB253165A5763D18FAE5FB6D2,13791,13,14,1,42,47,2147
78654,78654,2D914C2EB253165A5763D18FAE5FB6D2,10661,15,17,2,37,49,1899
78655,78655,2D914C2EB253165A5763D18FAE5FB6D2,43061,22,23,1,43,46,2196
78659,78659,90B13C1A71DF735753681820FCEBD200,11261,0,6,6,36,46,1846
78660,78660,90B13C1A71DF735753681820FCEBD200,12491,6,8,2,36,43,1843
78661,78661,90B13C1A71DF735753681820FCEBD200,11261,8,11,3,36,46,1846
78662,78662,90B13C1A71DF735753681820FCEBD200,12491,13,15,2,36,43,1843
78663,78663,90B13C1A71DF735753681820FCEBD200,11261,16,23,7,36,46,1846
78664,78664,30EE4ED515D97FFC1B2D380D08A1F01B,11074,1,8,7,37,47,1897
78665,78665,30EE4ED515D97FFC1B2D380D08A1F01B,11561,9,11,2,32,49,1649
78666,78666,30EE4ED515D97FFC1B2D380D08A1F01B,11074,12,13,1,37,47,1897
78667,78667,30EE4ED515D97FFC1B2D380D08A1F01B,11561,16,19,3,32,49,1649
78668,78668,30EE4ED515D97FFC1B2D380D08A1F01B,11074,19,22,3,37,47,1897
78669,78669,FCA3C665B5BF337F331669EDB597A6AC,42791,0,7,7,35,45,1795
78670,78670,FCA3C665B5BF337F331669EDB597A6AC,10271,11,13,2,37,46,1896
78671,78671,FCA3C665B5BF337F331669EDB597A6AC,13121,14,16,2,38,46,1946
78672,78672,FCA3C665B5BF337F331669EDB597A6AC,10251,20,21,1,35,47,1797
78673,78673,FCA3C665B5BF337F331669EDB597A6AC,13121,21,23,2,38,46,1946
78677,78677,EF513E7C00BFDF832A0C526F0CB25E65,13461,0,2,2,39,44,1994
78678,78678,EF513E7C00BFDF832A0C526F0CB25E65,43011,3,6,3,40,42,2042
78679,78679,EF513E7C00BFDF832A0C526F0CB25E65,12561,6,19,13,45,43,2293
78680,78680,EF513E7C00BFDF832A0C526F0CB25E65,43011,21,22,1,40,42,2042
78690,78690,6D7E7D83809F09E3C9AFF977E8089BFE,43341,0,7,7,41,46,2096
78691,78691,6D7E7D83809F09E3C9AFF977E8089BFE,11954,15,19,4,32,49,1649
78692,78692,6D7E7D83809F09E3C9AFF977E8089BFE,42633,21,23,2,42,46,2146
78693,78693,9ECA5557B94DDF8D494B58216329A377,42864,2,6,4,38,44,1944
78694,78694,9ECA5557B94DDF8D494B58216329A377,42861,8,9,1,37,44,1894
78695,78695,9ECA5557B94DDF8D494B58216329A377,11261,12,13,1,36,46,1846
78696,78696,9ECA5557B94DDF8D494B58216329A377,42864,19,21,2,38,44,1944
78697,78697,9ECA5557B94DDF8D494B58216329A377,11261,21,23,2,36,46,1846
78698,78698,100DE6A998B4F1F0C18DB93147EBCDA7,42623,2,8,6,22,49,1149
78699,78699,100DE6A998B4F1F0C18DB93147EBCDA7,41271,15,18,3,38,48,1948
78700,78700,100DE6A998B4F1F0C18DB93147EBCDA7,11231,18,22,4,37,49,1899
78701,78701,97E0C342F9800742D205D827005E4E2C,42071,0,1,1,31,49,1599
78702,78702,97E0C342F9800742D205D827005E4E2C,42081,4,5,1,24,49,1249
78703,78703,97E0C342F9800742D205D827005E4E2C,42623,7,8,1,22,49,1149
78704,78704,97E0C342F9800742D205D827005E4E2C,42071,14,22,8,31,49,1599
78705,78705,97E0C342F9800742D205D827005E4E2C,42623,22,23,1,22,49,1149
78709,78709,824CB1B1B23572593ECC1D95EF328196,42321,0,8,8,43,47,2197
78710,78710,824CB1B1B23572593ECC1D95EF328196,11074,8,16,8,37,47,1897
78711,78711,824CB1B1B23572593ECC1D95EF328196,11001,17,18,1,42,47,2147
78712,78712,824CB1B1B23572593ECC1D95EF328196,13941,19,21,2,41,47,2097
78716,78716,94DF6D416CC5B92A0E5062ABBAC5B786,12514,0,1,1,38,47,1947
78717,78717,94DF6D416CC5B92A0E5062ABBAC5B786,11074,2,6,4,37,47,1897
78718,78718,94DF6D416CC5B92A0E5062ABBAC5B786,42071,8,12,4,31,49,1599
78719,78719,94DF6D416CC5B92A0E5062ABBAC5B786,11151,12,17,5,30,48,1548
78720,78720,94DF6D416CC5B92A0E5062ABBAC5B786,11201,19,21,2,35,49,1799
78734,78734,B0E1B0D26C40402293513B661D1B71BA,42961,0,7,7,35,49,1799
78735,78735,B0E1B0D26C40402293513B661D1B71BA,10121,8,9,1,36,49,1849
78736,78736,B0E1B0D26C40402293513B661D1B71BA,10721,14,17,3,31,48,1598
78737,78737,B0E1B0D26C40402293513B661D1B71BA,11231,18,21,3,37,49,1899
78741,78741,D6932FB45D03368B8FD3FCD5E6F4054F,10107,0,1,1,38,49,1949
78742,78742,D6932FB45D03368B8FD3FCD5E6F4054F,11481,1,7,6,41,48,2098
78743,78743,D6932FB45D03368B8FD3FCD5E6F4054F,13561,8,10,2,37,49,1899
78744,78744,D6932FB45D03368B8FD3FCD5E6F4054F,10221,12,14,2,34,49,1749
78745,78745,D6932FB45D03368B8FD3FCD5E6F4054F,10121,16,18,2,36,49,1849
78746,78746,D6932FB45D03368B8FD3FCD5E6F4054F,11381,20,22,2,30,47,1547
78754,78754,C679B78CC6D72C84BDF54659808494C3,15241,0,15,15,33,2,1652
78755,78755,C679B78CC6D72C84BDF54659808494C3,10107,17,19,2,38,49,1949
78756,78756,C679B78CC6D72C84BDF54659808494C3,42531,21,23,2,31,45,1595
78769,78769,DEA13AE4E25C1F5535D501BC3C7ECF55,19111,0,6,6,9,45,495
78770,78770,DEA13AE4E25C1F5535D501BC3C7ECF55,11954,7,17,10,32,49,1649
78771,78771,DEA13AE4E25C1F5535D501BC3C7ECF55,42641,18,21,3,33,49,1699
78772,78772,C1CF59B64EE7642E956AF0C2EBE03CC9,11351,0,7,7,36,48,1848
78773,78773,C1CF59B64EE7642E956AF0C2EBE03CC9,11301,8,14,6,41,49,2099
78774,78774,C1CF59B64EE7642E956AF0C2EBE03CC9,10971,19,20,1,35,47,1797
78775,78775,C1CF59B64EE7642E956AF0C2EBE03CC9,13381,21,23,2,39,47,1997
78776,78776,C132E4C242B7EC12A7123616F55E9237,42461,2,13,11,45,47,2297
78777,78777,C132E4C242B7EC12A7123616F55E9237,10107,16,19,3,38,49,1949
78778,78778,C132E4C242B7EC12A7123616F55E9237,11701,22,23,1,43,48,2198
78782,78782,E0873B864715C11E68FD45D481B5484B,13941,1,6,5,41,47,2097
78783,78783,E0873B864715C11E68FD45D481B5484B,13821,9,12,3,49,45,2495
78784,78784,E0873B864715C11E68FD45D481B5484B,10921,12,15,3,43,48,2198
78785,78785,E0873B864715C11E68FD45D481B5484B,13941,19,23,4,41,47,2097
78792,78792,1F87CA1D778B027B6DE06AC8BD5FBD25,13314,0,8,8,31,39,1589
78793,78793,1F87CA1D778B027B6DE06AC8BD5FBD25,42851,12,16,4,35,41,1791
78794,78794,1F87CA1D778B027B6DE06AC8BD5FBD25,42961,19,21,2,35,49,1799
78795,78795,1F87CA1D778B027B6DE06AC8BD5FBD25,13314,21,23,2,31,39,1589
78799,78799,CDA1EB7B89E47C48A7CAC823B0773234,12661,0,8,8,32,45,1645
78800,78800,CDA1EB7B89E47C48A7CAC823B0773234,10421,12,13,1,41,48,2098
78801,78801,CDA1EB7B89E47C48A7CAC823B0773234,40171,14,15,1,38,48,1948
78802,78802,CDA1EB7B89E47C48A7CAC823B0773234,10191,18,19,1,40,48,2048
78820,78820,3E3400E81F33727D0845365703B2CDF7,42471,0,7,7,35,49,1799
78821,78821,3E3400E81F33727D0845365703B2CDF7,41393,7,17,10,43,49,2199
78822,78822,3E3400E81F33727D0845365703B2CDF7,10161,21,23,2,35,49,1799
78826,78826,BA979D9F10C45773D87C6020227AF4F7,10471,0,8,8,37,48,1898
78827,78827,BA979D9F10C45773D87C6020227AF4F7,12381,11,13,2,32,48,1648
78828,78828,BA979D9F10C45773D87C6020227AF4F7,10471,13,23,10,37,48,1898
78839,78839,975688BDD7D3B41B53C460B57B5AC58A,43751,0,5,5,19,48,998
78840,78840,975688BDD7D3B41B53C460B57B5AC58A,10451,7,18,11,25,48,1298
78841,78841,975688BDD7D3B41B53C460B57B5AC58A,43751,19,22,3,19,48,998
78842,78842,F627DABA7942D76C058F442593F2CF12,12731,7,8,1,22,40,1140
78843,78843,F627DABA7942D76C058F442593F2CF12,43021,8,10,2,16,43,843
78844,78844,F627DABA7942D76C058F442593F2CF12,12731,13,14,1,22,40,1140
78845,78845,F627DABA7942D76C058F442593F2CF12,11101,16,22,6,18,48,948
78856,78856,87A579BD8EB5C5CE5240DDB8F2C166E2,13671,0,5,5,27,43,1393
78857,78857,87A579BD8EB5C5CE5240DDB8F2C166E2,13314,8,10,2,31,39,1589
78858,78858,87A579BD8EB5C5CE5240DDB8F2C166E2,12521,12,13,1,35,41,1791
78859,78859,87A579BD8EB5C5CE5240DDB8F2C166E2,13041,15,16,1,30,37,1537
78860,78860,87A579BD8EB5C5CE5240DDB8F2C166E2,13671,19,20,1,27,43,1393
78861,78861,87A579BD8EB5C5CE5240DDB8F2C166E2,13314,21,22,1,31,39,1589
78862,78862,1F49E26C341B3738FA1E54F232E557D3,12514,0,8,8,38,47,1947
78863,78863,1F49E26C341B3738FA1E54F232E557D3,12511,12,19,7,39,47,1997
78864,78864,1F49E26C341B3738FA1E54F232E557D3,10221,20,21,1,34,49,1749
78865,78865,1F49E26C341B3738FA1E54F232E557D3,12514,22,23,1,38,47,1947
78866,78866,3F458F6ABA1F2A91C8D3DACF4A48895B,11381,0,8,8,30,47,1547
78867,78867,3F458F6ABA1F2A91C8D3DACF4A48895B,11061,9,16,7,29,48,1498
78868,78868,3F458F6ABA1F2A91C8D3DACF4A48895B,11381,16,17,1,30,47,1547
78869,78869,3F458F6ABA1F2A91C8D3DACF4A48895B,11061,18,19,1,29,48,1498
78870,78870,3F458F6ABA1F2A91C8D3DACF4A48895B,11571,20,22,2,13,46,696
78875,78875,CC63EA7467D4A1FC7EF1BC76C9DAF092,43011,0,1,1,40,42,2042
78876,78876,CC63EA7467D4A1FC7EF1BC76C9DAF092,42864,3,5,2,38,44,1944
78877,78877,CC63EA7467D4A1FC7EF1BC76C9DAF092,11261,6,21,15,36,46,1846
78878,78878,CC63EA7467D4A1FC7EF1BC76C9DAF092,12211,22,23,1,41,44,2094
78882,78882,732CCF1BC496C93C41B70E7FF8357762,10634,1,10,9,27,45,1395
78883,78883,732CCF1BC496C93C41B70E7FF8357762,11861,13,16,3,32,47,1647
78884,78884,732CCF1BC496C93C41B70E7FF8357762,10634,17,22,5,27,45,1395
78885,78885,148468EF4E9422A16464E72732D761DD,42071,0,4,4,31,49,1599
78886,78886,148468EF4E9422A16464E72732D761DD,42081,5,8,3,24,49,1249
78887,78887,148468EF4E9422A16464E72732D761DD,42071,8,10,2,31,49,1599
78888,78888,148468EF4E9422A16464E72732D761DD,42623,12,13,1,22,49,1149
78889,78889,148468EF4E9422A16464E72732D761DD,42071,14,21,7,31,49,1599
78896,78896,691D67A032E65E82F40137DDC8A198BA,40361,0,4,4,42,48,2148
78897,78897,691D67A032E65E82F40137DDC8A198BA,13271,4,6,2,41,47,2097
78898,78898,691D67A032E65E82F40137DDC8A198BA,11074,7,13,6,37,47,1897
78899,78899,691D67A032E65E82F40137DDC8A198BA,12221,15,16,1,43,44,2194
78900,78900,691D67A032E65E82F40137DDC8A198BA,11805,21,23,2,41,48,2098
78901,78901,952D9993D6EC0FC8746CC84C9CE1D71A,11091,0,7,7,29,47,1497
78902,78902,952D9993D6EC0FC8746CC84C9CE1D71A,11591,12,13,1,36,49,1849
78903,78903,952D9993D6EC0FC8746CC84C9CE1D71A,42471,16,19,3,35,49,1799
78904,78904,952D9993D6EC0FC8746CC84C9CE1D71A,11591,19,21,2,36,49,1849
78905,78905,952D9993D6EC0FC8746CC84C9CE1D71A,42471,21,23,2,35,49,1799
78910,78910,D429753EEB35077FBB0F7FD7B24671DA,43011,2,3,1,40,42,2042
78911,78911,D429753EEB35077FBB0F7FD7B24671DA,42381,3,5,2,39,41,1991
78912,78912,D429753EEB35077FBB0F7FD7B24671DA,43451,6,15,9,37,40,1890
78913,78913,D429753EEB35077FBB0F7FD7B24671DA,42381,18,20,2,39,41,1991
78914,78914,D429753EEB35077FBB0F7FD7B24671DA,13071,21,22,1,41,41,2091
78925,78925,D256AE34DD31744D7365602849D9C40A,10341,0,7,7,31,47,1597
78926,78926,D256AE34DD31744D7365602849D9C40A,12601,11,17,6,25,47,1297
78927,78927,D256AE34DD31744D7365602849D9C40A,42491,19,22,3,32,46,1646
78928,78928,09757EDFE7795D1E67DCE5C4439A4727,12521,0,15,15,35,41,1791
78929,78929,09757EDFE7795D1E67DCE5C4439A4727,13314,15,16,1,31,39,1589
78930,78930,09757EDFE7795D1E67DCE5C4439A4727,12521,17,23,6,35,41,1791
78931,78931,59E8BD2B3B6F40BDD7AA0B26E7BC6262,13351,1,6,5,48,48,2448
78932,78932,59E8BD2B3B6F40BDD7AA0B26E7BC6262,43621,7,9,2,46,48,2348
78933,78933,59E8BD2B3B6F40BDD7AA0B26E7BC6262,13471,10,11,1,47,49,2399
78934,78934,59E8BD2B3B6F40BDD7AA0B26E7BC6262,13351,11,13,2,48,48,2448
78935,78935,59E8BD2B3B6F40BDD7AA0B26E7BC6262,13471,13,14,1,47,49,2399
78936,78936,59E8BD2B3B6F40BDD7AA0B26E7BC6262,11701,16,18,2,43,48,2198
78937,78937,59E8BD2B3B6F40BDD7AA0B26E7BC6262,13471,21,22,1,47,49,2399
78946,78946,C74A2DEA95A242856AF537883E9B4E00,10061,0,8,8,20,46,1046
78947,78947,C74A2DEA95A242856AF537883E9B4E00,12514,10,11,1,38,47,1947
78948,78948,C74A2DEA95A242856AF537883E9B4E00,12601,13,15,2,25,47,1297
78949,78949,C74A2DEA95A242856AF537883E9B4E00,10171,19,20,1,26,47,1347
78950,78950,C74A2DEA95A242856AF537883E9B4E00,10061,21,23,2,20,46,1046
78957,78957,FDDADD1F7A9F71305F208A2BCF191E55,11231,0,5,5,37,49,1899
78958,78958,FDDADD1F7A9F71305F208A2BCF191E55,10121,7,8,1,36,49,1849
78959,78959,FDDADD1F7A9F71305F208A2BCF191E55,10221,12,15,3,34,49,1749
78960,78960,FDDADD1F7A9F71305F208A2BCF191E55,13121,18,19,1,38,46,1946
78961,78961,FDDADD1F7A9F71305F208A2BCF191E55,10161,20,23,3,35,49,1799
78968,78968,F6A80B70A7B4E1F09B04A57B617622B1,11541,10,11,1,35,49,1799
78969,78969,F6A80B70A7B4E1F09B04A57B617622B1,10431,12,14,2,33,49,1699
78970,78970,F6A80B70A7B4E1F09B04A57B617622B1,11291,14,16,2,40,49,2049
78971,78971,F6A80B70A7B4E1F09B04A57B617622B1,10107,18,23,5,38,49,1949
78972,78972,FB78D5322DE89BC4ACBA0A9E43B4FF54,10924,0,6,6,43,49,2199
78973,78973,FB78D5322DE89BC4ACBA0A9E43B4FF54,11491,8,17,9,36,47,1847
78974,78974,FB78D5322DE89BC4ACBA0A9E43B4FF54,41392,18,20,2,43,48,2198
78975,78975,FB78D5322DE89BC4ACBA0A9E43B4FF54,11231,20,22,2,37,49,1899
78994,78994,3F558062FED8D455694E306F67D6AF09,43011,0,13,13,40,42,2042
78995,78995,3F558062FED8D455694E306F67D6AF09,12221,16,17,1,43,44,2194
78996,78996,3F558062FED8D455694E306F67D6AF09,13341,18,19,1,44,45,2245
78997,78997,CF045BB51AB834592F0FA9268C200D5E,40431,0,9,9,36,47,1847
78998,78998,CF045BB51AB834592F0FA9268C200D5E,10781,11,15,4,35,47,1797
78999,78999,CF045BB51AB834592F0FA9268C200D5E,40691,18,20,2,42,48,2148
79000,79000,CF045BB51AB834592F0FA9268C200D5E,11491,22,23,1,36,47,1847
79001,79001,A0C13743AF441FE8099AA940DA71C612,42581,0,5,5,38,48,1948
79002,79002,A0C13743AF441FE8099AA940DA71C612,43481,7,8,1,39,48,1998
79003,79003,A0C13743AF441FE8099AA940DA71C612,12511,8,9,1,39,47,1997
79004,79004,A0C13743AF441FE8099AA940DA71C612,42581,11,21,10,38,48,1948
79005,79005,A0C13743AF441FE8099AA940DA71C612,43181,22,23,1,39,48,1998
79013,79013,3FFAC3F99B451D0208FE1C282ECAF5E9,12651,0,7,7,43,47,2197
79014,79014,3FFAC3F99B451D0208FE1C282ECAF5E9,11061,8,9,1,29,48,1498
79015,79015,3FFAC3F99B451D0208FE1C282ECAF5E9,11161,9,11,2,32,48,1648
79016,79016,3FFAC3F99B451D0208FE1C282ECAF5E9,12651,12,16,4,43,47,2197
79017,79017,3FFAC3F99B451D0208FE1C282ECAF5E9,42301,20,23,3,36,47,1847
79021,79021,51898DE5E0965BE533E51C9BF9FEF431,42501,0,7,7,28,47,1447
79022,79022,51898DE5E0965BE533E51C9BF9FEF431,10381,8,9,1,31,49,1599
79023,79023,51898DE5E0965BE533E51C9BF9FEF431,43391,9,10,1,29,48,1498
79024,79024,51898DE5E0965BE533E51C9BF9FEF431,12391,12,14,2,36,49,1849
79025,79025,51898DE5E0965BE533E51C9BF9FEF431,10951,16,20,4,29,48,1498
79032,79032,802D06E8811CDC65FDAB61E1A1D233B3,10501,1,6,5,22,46,1146
79033,79033,802D06E8811CDC65FDAB61E1A1D233B3,10691,9,19,10,33,48,1698
79034,79034,802D06E8811CDC65FDAB61E1A1D233B3,12601,20,21,1,25,47,1297
79041,79041,A8DFAF39A5A26AE1BCD9E9DE060BB315,11091,0,6,6,29,47,1497
79042,79042,A8DFAF39A5A26AE1BCD9E9DE060BB315,13651,9,10,1,30,47,1547
79043,79043,A8DFAF39A5A26AE1BCD9E9DE060BB315,11091,11,13,2,29,47,1497
79044,79044,A8DFAF39A5A26AE1BCD9E9DE060BB315,13651,14,16,2,30,47,1547
79045,79045,A8DFAF39A5A26AE1BCD9E9DE060BB315,11091,18,23,5,29,47,1497
79046,79046,549B8A34E419FBD57213E9641A5E14A7,11061,0,8,8,29,48,1498
79047,79047,549B8A34E419FBD57213E9641A5E14A7,10681,8,9,1,30,48,1548
79048,79048,549B8A34E419FBD57213E9641A5E14A7,11061,10,12,2,29,48,1498
79049,79049,549B8A34E419FBD57213E9641A5E14A7,10681,13,20,7,30,48,1548
79050,79050,549B8A34E419FBD57213E9641A5E14A7,11061,20,22,2,29,48,1498
79058,79058,C89529DCFA7F41DFC598DE45605F620D,13341,0,14,14,44,45,2245
79059,79059,C89529DCFA7F41DFC598DE45605F620D,12083,17,18,1,36,49,1849
79060,79060,C89529DCFA7F41DFC598DE45605F620D,13341,21,23,2,44,45,2245
79064,79064,2CB194F5C88F15739C3E83AF93DF02DF,11161,0,8,8,32,48,1648
79065,79065,2CB194F5C88F15739C3E83AF93DF02DF,43471,11,13,2,31,49,1599
79066,79066,2CB194F5C88F15739C3E83AF93DF02DF,12221,14,15,1,43,44,2194
79067,79067,2CB194F5C88F15739C3E83AF93DF02DF,10281,19,23,4,33,48,1698
79071,79071,2A5526AFC39BFDBDB096D99CD55E6092,42261,0,6,6,25,49,1299
79072,79072,2A5526AFC39BFDBDB096D99CD55E6092,42071,8,16,8,31,49,1599
79073,79073,2A5526AFC39BFDBDB096D99CD55E6092,42081,16,17,1,24,49,1249
79074,79074,2A5526AFC39BFDBDB096D99CD55E6092,42071,19,22,3,31,49,1599
79075,79075,A4CBFA774BBCB1E081978588796288CA,10681,0,8,8,30,48,1548
79076,79076,A4CBFA774BBCB1E081978588796288CA,11231,8,12,4,37,49,1899
79077,79077,A4CBFA774BBCB1E081978588796288CA,12083,14,17,3,36,49,1849
79078,79078,A4CBFA774BBCB1E081978588796288CA,10681,18,23,5,30,48,1548
79085,79085,EF947DBF346CA71F5A1F90CCD5D75617,11641,0,5,5,22,49,1149
79086,79086,EF947DBF346CA71F5A1F90CCD5D75617,42081,5,6,1,24,49,1249
79087,79087,EF947DBF346CA71F5A1F90CCD5D75617,19441,7,9,2,8,46,446
79088,79088,EF947DBF346CA71F5A1F90CCD5D75617,11641,13,23,10,22,49,1149
79096,79096,9B0029B8EC10075CDAF45ECCAC0C932E,11231,0,9,9,37,49,1899
79097,79097,9B0029B8EC10075CDAF45ECCAC0C932E,11781,11,13,2,38,49,1949
79098,79098,9B0029B8EC10075CDAF45ECCAC0C932E,11231,14,18,4,37,49,1899
79099,79099,9B0029B8EC10075CDAF45ECCAC0C932E,40171,19,20,1,38,48,1948
79100,79100,9B0029B8EC10075CDAF45ECCAC0C932E,13101,21,23,2,40,47,2047
79120,79120,474FFA09EED2908FC53360D0633D492E,13111,0,10,10,42,46,2146
79121,79121,474FFA09EED2908FC53360D0633D492E,10221,10,14,4,34,49,1749
79122,79122,474FFA09EED2908FC53360D0633D492E,10544,14,16,2,28,48,1448
79123,79123,474FFA09EED2908FC53360D0633D492E,11701,19,22,3,43,48,2198
79124,79124,474FFA09EED2908FC53360D0633D492E,13111,22,23,1,42,46,2146
79128,79128,719A214F7F0A3FE9CAAEAFFA2D7D7DDF,42161,0,9,9,36,47,1847
79129,79129,719A214F7F0A3FE9CAAEAFFA2D7D7DDF,40421,10,13,3,37,48,1898
79130,79130,719A214F7F0A3FE9CAAEAFFA2D7D7DDF,42161,14,16,2,36,47,1847
79131,79131,719A214F7F0A3FE9CAAEAFFA2D7D7DDF,40421,16,18,2,37,48,1898
79132,79132,719A214F7F0A3FE9CAAEAFFA2D7D7DDF,42161,18,19,1,36,47,1847
79143,79143,4B5119258FB3482B746B53277561992F,12581,6,16,10,24,48,1248
79144,79144,4B5119258FB3482B746B53277561992F,12051,16,20,4,20,47,1047
79145,79145,4B5119258FB3482B746B53277561992F,10061,21,23,2,20,46,1046
79154,79154,2645F5142573386C77064AFA8147E7B9,11861,0,2,2,32,47,1647
79155,79155,2645F5142573386C77064AFA8147E7B9,40331,5,6,1,30,47,1547
79156,79156,2645F5142573386C77064AFA8147E7B9,13271,10,17,7,41,47,2097
79157,79157,2645F5142573386C77064AFA8147E7B9,11805,19,21,2,41,48,2098
79161,79161,787E2D15898542A785C91CF72E674285,13911,0,4,4,39,46,1996
79162,79162,787E2D15898542A785C91CF72E674285,11261,8,9,1,36,46,1846
79163,79163,787E2D15898542A785C91CF72E674285,13911,13,14,1,39,46,1996
79164,79164,787E2D15898542A785C91CF72E674285,11261,16,18,2,36,46,1846
79165,79165,787E2D15898542A785C91CF72E674285,10811,19,20,1,38,46,1946
79166,79166,ABA31A886DA5135F00BAFC3DAD048D98,41551,0,6,6,37,46,1896
79167,79167,ABA31A886DA5135F00BAFC3DAD048D98,12391,7,11,4,36,49,1849
79168,79168,ABA31A886DA5135F00BAFC3DAD048D98,11231,12,13,1,37,49,1899
79169,79169,ABA31A886DA5135F00BAFC3DAD048D98,12391,14,17,3,36,49,1849
79170,79170,ABA31A886DA5135F00BAFC3DAD048D98,41551,21,23,2,37,46,1896
79180,79180,E93D8B02977789FF5BDAF0EE317471D5,10451,0,7,7,25,48,1298
79181,79181,E93D8B02977789FF5BDAF0EE317471D5,12311,8,10,2,30,44,1544
79182,79182,E93D8B02977789FF5BDAF0EE317471D5,12021,12,13,1,37,49,1899
79183,79183,E93D8B02977789FF5BDAF0EE317471D5,11871,14,17,3,29,46,1496
79184,79184,E93D8B02977789FF5BDAF0EE317471D5,42921,18,20,2,33,47,1697
79185,79185,E93D8B02977789FF5BDAF0EE317471D5,10451,20,23,3,25,48,1298
79186,79186,7F73A642AA11134206C46BA15C785E40,13651,8,9,1,30,47,1547
79187,79187,7F73A642AA11134206C46BA15C785E40,42521,9,11,2,31,47,1597
79188,79188,7F73A642AA11134206C46BA15C785E40,13651,11,12,1,30,47,1547
79189,79189,7F73A642AA11134206C46BA15C785E40,42491,16,18,2,32,46,1646
79190,79190,7F73A642AA11134206C46BA15C785E40,42521,20,23,3,31,47,1597
79194,79194,753369D691B504B9F7186B2CDF290F06,12792,3,11,8,34,30,1730
79195,79195,753369D691B504B9F7186B2CDF290F06,15391,12,14,2,35,26,1776
79196,79196,753369D691B504B9F7186B2CDF290F06,12792,15,18,3,34,30,1730
79197,79197,753369D691B504B9F7186B2CDF290F06,15391,18,23,5,35,26,1776
79201,79201,EEE3AE7ABA4C03B6F4B079A7B52295B8,11651,0,7,7,33,47,1697
79202,79202,EEE3AE7ABA4C03B6F4B079A7B52295B8,10107,8,18,10,38,49,1949
79203,79203,EEE3AE7ABA4C03B6F4B079A7B52295B8,10731,20,22,2,33,47,1697
79204,79204,F934A070299A0C2535F9C55A84D4AE40,19441,2,8,6,8,46,446
79205,79205,F934A070299A0C2535F9C55A84D4AE40,11471,9,16,7,12,48,648
79206,79206,F934A070299A0C2535F9C55A84D4AE40,19441,17,18,1,8,46,446
79207,79207,33C6B9D0BF26C79B6F85136317A2BE6E,40673,0,8,8,36,48,1848
79208,79208,33C6B9D0BF26C79B6F85136317A2BE6E,43391,11,14,3,29,48,1498
79209,79209,33C6B9D0BF26C79B6F85136317A2BE6E,40673,19,23,4,36,48,1848
79210,79210,3ACC8BF8C4DFF8F069BDD805025DF41D,12921,1,5,4,9,41,491
79211,79211,3ACC8BF8C4DFF8F069BDD805025DF41D,43021,5,19,14,16,43,843
79212,79212,3ACC8BF8C4DFF8F069BDD805025DF41D,19114,21,22,1,7,43,393
79213,79213,C4D6D6893D15A40EF6C21B7CBC7CED3E,11861,0,8,8,32,47,1647
79214,79214,C4D6D6893D15A40EF6C21B7CBC7CED3E,11541,9,20,11,35,49,1799
79215,79215,C4D6D6893D15A40EF6C21B7CBC7CED3E,42021,22,23,1,33,47,1697
79216,79216,D1EDBC8A7CBCF315A3398D0F851335FF,42521,0,7,7,31,47,1597
79217,79217,D1EDBC8A7CBCF315A3398D0F851335FF,11381,8,10,2,30,47,1547
79218,79218,D1EDBC8A7CBCF315A3398D0F851335FF,42521,10,11,1,31,47,1597
79219,79219,D1EDBC8A7CBCF315A3398D0F851335FF,11381,11,12,1,30,47,1547
79220,79220,D1EDBC8A7CBCF315A3398D0F851335FF,43731,18,19,1,34,47,1747
79221,79221,D1EDBC8A7CBCF315A3398D0F851335FF,42521,21,22,1,31,47,1597
79234,79234,42B28AE3CCE12BA9A899758E7A189C34,11806,3,6,3,41,48,2098
79235,79235,42B28AE3CCE12BA9A899758E7A189C34,10121,8,12,4,36,49,1849
79236,79236,42B28AE3CCE12BA9A899758E7A189C34,10661,14,15,1,37,49,1899
79237,79237,42B28AE3CCE12BA9A899758E7A189C34,10121,15,18,3,36,49,1849
79238,79238,42B28AE3CCE12BA9A899758E7A189C34,11806,21,23,2,41,48,2098
79239,79239,BC71A128CC1D1FD204F1FA3A371EA53A,43021,0,6,6,16,43,843
79240,79240,BC71A128CC1D1FD204F1FA3A371EA53A,12921,8,17,9,9,41,491
79241,79241,BC71A128CC1D1FD204F1FA3A371EA53A,43021,19,23,4,16,43,843
79242,79242,C4D6F0BF53BD9BD92C93EF2AD0B56F39,11921,1,3,2,38,48,1948
79243,79243,C4D6F0BF53BD9BD92C93EF2AD0B56F39,11074,3,13,10,37,47,1897
79244,79244,C4D6F0BF53BD9BD92C93EF2AD0B56F39,42191,13,14,1,38,49,1949
79245,79245,C4D6F0BF53BD9BD92C93EF2AD0B56F39,11921,15,16,1,38,48,1948
79246,79246,C4D6F0BF53BD9BD92C93EF2AD0B56F39,11074,17,18,1,37,47,1897
79254,79254,B407E10E40F14F417BB48241B7C62C97,40833,0,7,7,41,47,2097
79255,79255,B407E10E40F14F417BB48241B7C62C97,10107,10,11,1,38,49,1949
79256,79256,B407E10E40F14F417BB48241B7C62C97,13271,13,15,2,41,47,2097
79257,79257,B407E10E40F14F417BB48241B7C62C97,10107,15,17,2,38,49,1949
79258,79258,B407E10E40F14F417BB48241B7C62C97,42583,19,21,2,40,48,2048
79259,79259,B407E10E40F14F417BB48241B7C62C97,40833,22,23,1,41,47,2097
79266,79266,C5C866B840AB1E710A19532E1F1DAD43,42523,0,7,7,31,47,1597
79267,79267,C5C866B840AB1E710A19532E1F1DAD43,43361,8,9,1,38,48,1948
79268,79268,C5C866B840AB1E710A19532E1F1DAD43,11271,9,10,1,37,48,1898
79269,79269,C5C866B840AB1E710A19532E1F1DAD43,43181,18,20,2,39,48,1998
79270,79270,C5C866B840AB1E710A19532E1F1DAD43,42523,22,23,1,31,47,1597
79280,79280,4C0B4AC61D24A3A943FEC75230408343,10381,0,7,7,31,49,1599
79281,79281,4C0B4AC61D24A3A943FEC75230408343,11151,9,10,1,30,48,1548
79282,79282,4C0B4AC61D24A3A943FEC75230408343,10381,11,14,3,31,49,1599
79283,79283,4C0B4AC61D24A3A943FEC75230408343,43391,15,16,1,29,48,1498
79284,79284,4C0B4AC61D24A3A943FEC75230408343,12121,21,23,2,29,47,1497
79289,79289,13DE110B29312DE3F10077CC7E65B863,15331,0,9,9,38,24,1924
79290,79290,13DE110B29312DE3F10077CC7E65B863,40341,12,14,2,23,49,1199
79291,79291,13DE110B29312DE3F10077CC7E65B863,15331,17,23,6,38,24,1924
79295,79295,C50F95F31F14C0EC9A55706C3B181C1C,12792,2,4,2,34,30,1730
79296,79296,C50F95F31F14C0EC9A55706C3B181C1C,15391,4,6,2,35,26,1776
79297,79297,C50F95F31F14C0EC9A55706C3B181C1C,12792,8,12,4,34,30,1730
79298,79298,C50F95F31F14C0EC9A55706C3B181C1C,15091,14,17,3,35,26,1776
79299,79299,C50F95F31F14C0EC9A55706C3B181C1C,12792,18,19,1,34,30,1730
79300,79300,C50F95F31F14C0EC9A55706C3B181C1C,15391,20,23,3,35,26,1776
79301,79301,F98D332FEC49EACBB061C3B06630BFBF,13511,0,6,6,34,48,1748
79302,79302,F98D332FEC49EACBB061C3B06630BFBF,11631,8,16,8,12,49,649
79303,79303,F98D332FEC49EACBB061C3B06630BFBF,42021,18,19,1,33,47,1697
79311,79311,D5D027DEC2E15CD439B6E37A42DFD8C1,12921,5,12,7,9,41,491
79312,79312,D5D027DEC2E15CD439B6E37A42DFD8C1,43021,14,17,3,16,43,843
79313,79313,D5D027DEC2E15CD439B6E37A42DFD8C1,19114,21,22,1,7,43,393
79320,79320,3473FA09F0017B3BD24476C962AE1520,13314,0,6,6,31,39,1589
79321,79321,3473FA09F0017B3BD24476C962AE1520,12521,8,18,10,35,41,1791
79322,79322,3473FA09F0017B3BD24476C962AE1520,13314,20,21,1,31,39,1589
79323,79323,CA601ED32D4DA950EA12F7A37DA37141,13341,0,2,2,44,45,2245
79324,79324,CA601ED32D4DA950EA12F7A37DA37141,12221,2,8,6,43,44,2194
79325,79325,CA601ED32D4DA950EA12F7A37DA37141,10471,9,18,9,37,48,1898
79326,79326,CA601ED32D4DA950EA12F7A37DA37141,13341,21,22,1,44,45,2245
79333,79333,EE6DF71211BB23F075331DC20CF97B7B,15651,0,8,8,39,25,1975
79334,79334,EE6DF71211BB23F075331DC20CF97B7B,42271,13,14,1,40,47,2047
79335,79335,EE6DF71211BB23F075331DC20CF97B7B,15651,16,23,7,39,25,1975
79336,79336,87B1169D5A9BB025C6A10231CEED2118,19621,3,10,7,5,46,296
79337,79337,87B1169D5A9BB025C6A10231CEED2118,11875,11,13,2,30,46,1546
79338,79338,87B1169D5A9BB025C6A10231CEED2118,10681,14,15,1,30,48,1548
79339,79339,87B1169D5A9BB025C6A10231CEED2118,11861,18,22,4,32,47,1647
79343,79343,F8584A5277683398A2423E9367C858A2,40833,0,7,7,41,47,2097
79344,79344,F8584A5277683398A2423E9367C858A2,19744,9,18,9,6,43,343
79345,79345,F8584A5277683398A2423E9367C858A2,40302,18,20,2,40,49,2049
79346,79346,F8584A5277683398A2423E9367C858A2,40833,20,22,2,41,47,2097
79350,79350,27278737D09D5670A3F233313E8FF2D1,10341,1,7,6,31,47,1597
79351,79351,27278737D09D5670A3F233313E8FF2D1,10471,10,16,6,37,48,1898
79352,79352,27278737D09D5670A3F233313E8FF2D1,11861,20,21,1,32,47,1647
79363,79363,FCB3F67711CEBAA3447F5F56A47CDE2C,10431,0,7,7,33,49,1699
79364,79364,FCB3F67711CEBAA3447F5F56A47CDE2C,11021,8,18,10,36,49,1849
79365,79365,FCB3F67711CEBAA3447F5F56A47CDE2C,11771,18,20,2,39,49,1999
79366,79366,FCB3F67711CEBAA3447F5F56A47CDE2C,10431,22,23,1,33,49,1699
79367,79367,00E9B2979D0B278CE796C04A60C34141,19244,0,11,11,1,43,93
79368,79368,00E9B2979D0B278CE796C04A60C34141,10151,14,15,1,34,47,1747
79369,79369,00E9B2979D0B278CE796C04A60C34141,19244,17,23,6,1,43,93
79370,79370,36391605FB1091601145BE09BDC65544,11271,0,1,1,37,48,1898
79371,79371,36391605FB1091601145BE09BDC65544,11461,2,3,1,37,49,1899
79372,79372,36391605FB1091601145BE09BDC65544,11794,4,9,5,38,49,1949
79373,79373,36391605FB1091601145BE09BDC65544,40181,10,20,10,37,49,1899
79374,79374,36391605FB1091601145BE09BDC65544,11271,21,22,1,37,48,1898
79375,79375,B7628782B204D4F413106C5BD3361A40,42961,0,17,17,35,49,1799
79376,79376,B7628782B204D4F413106C5BD3361A40,40341,18,19,1,23,49,1199
79377,79377,B7628782B204D4F413106C5BD3361A40,42961,20,23,3,35,49,1799
79381,79381,4D5D3F015222D9A4A636663FE67FCAD4,10171,0,7,7,26,47,1347
79382,79382,4D5D3F015222D9A4A636663FE67FCAD4,42271,9,10,1,40,47,2047
79383,79383,4D5D3F015222D9A4A636663FE67FCAD4,41591,15,19,4,34,49,1749
79384,79384,4D5D3F015222D9A4A636663FE67FCAD4,10171,21,23,2,26,47,1347
79385,79385,72E3711AB2F1551FB5E5D7BBFCDF93B2,11841,1,7,6,33,46,1696
79386,79386,72E3711AB2F1551FB5E5D7BBFCDF93B2,11541,8,13,5,35,49,1799
79387,79387,72E3711AB2F1551FB5E5D7BBFCDF93B2,10531,18,23,5,34,46,1746
79391,79391,DF9AD5AC0E4BE326A72BA327D1A40B9F,42161,0,7,7,36,47,1847
79392,79392,DF9AD5AC0E4BE326A72BA327D1A40B9F,42623,9,12,3,22,49,1149
79393,79393,DF9AD5AC0E4BE326A72BA327D1A40B9F,42691,15,17,2,24,48,1248
79394,79394,DF9AD5AC0E4BE326A72BA327D1A40B9F,42401,18,23,5,36,47,1847
79395,79395,DB5F58C0BF92D33E406DDC1B3C9B82ED,10161,0,12,12,35,49,1799
79396,79396,DB5F58C0BF92D33E406DDC1B3C9B82ED,10716,13,15,2,30,46,1546
79397,79397,DB5F58C0BF92D33E406DDC1B3C9B82ED,11541,19,20,1,35,49,1799
79407,79407,6E1E442DA8316A4138A997DD8721F188,10801,3,9,6,42,47,2147
79408,79408,6E1E442DA8316A4138A997DD8721F188,11074,11,16,5,37,47,1897
79409,79409,6E1E442DA8316A4138A997DD8721F188,40697,19,21,2,43,48,2198
79410,79410,5BBCD63F1FDBD49661B51EE642BD2472,43311,0,12,12,31,48,1598
79411,79411,5BBCD63F1FDBD49661B51EE642BD2472,19281,14,17,3,16,32,832
79412,79412,5BBCD63F1FDBD49661B51EE642BD2472,43311,19,23,4,31,48,1598
79413,79413,396139B659AB08CB26B980747DF8644A,10121,2,6,4,36,49,1849
79414,79414,396139B659AB08CB26B980747DF8644A,43161,8,12,4,35,47,1797
79415,79415,396139B659AB08CB26B980747DF8644A,42161,14,18,4,36,47,1847
79416,79416,396139B659AB08CB26B980747DF8644A,10121,20,21,1,36,49,1849
79417,79417,396139B659AB08CB26B980747DF8644A,10661,22,23,1,37,49,1899
79418,79418,21709F7FFA433548AE3C0AA8A76FE0E7,11151,0,5,5,30,48,1548
79419,79419,21709F7FFA433548AE3C0AA8A76FE0E7,10381,5,7,2,31,49,1599
79420,79420,21709F7FFA433548AE3C0AA8A76FE0E7,11151,7,14,7,30,48,1548
79421,79421,21709F7FFA433548AE3C0AA8A76FE0E7,10381,14,16,2,31,49,1599
79422,79422,21709F7FFA433548AE3C0AA8A76FE0E7,42831,16,17,1,27,48,1398
79423,79423,21709F7FFA433548AE3C0AA8A76FE0E7,10381,17,21,4,31,49,1599
79424,79424,21709F7FFA433548AE3C0AA8A76FE0E7,42831,21,23,2,27,48,1398
79425,79425,B8989CFFC223BB64D623BE9489BA8A6F,11074,5,6,1,37,47,1897
79426,79426,B8989CFFC223BB64D623BE9489BA8A6F,10631,11,15,4,28,46,1446
79427,79427,B8989CFFC223BB64D623BE9489BA8A6F,12083,18,19,1,36,49,1849
79428,79428,3717F18D88C40095DBADE8C95C390E6F,42151,0,2,2,35,45,1795
79429,79429,3717F18D88C40095DBADE8C95C390E6F,42861,2,4,2,37,44,1894
79430,79430,3717F18D88C40095DBADE8C95C390E6F,42151,5,7,2,35,45,1795
79431,79431,3717F18D88C40095DBADE8C95C390E6F,42861,8,15,7,37,44,1894
79432,79432,3717F18D88C40095DBADE8C95C390E6F,42151,17,18,1,35,45,1795
79437,79437,1D9B3BEAA73444A543D0673D1FBABCFF,10251,0,8,8,35,47,1797
79438,79438,1D9B3BEAA73444A543D0673D1FBABCFF,42511,8,9,1,37,47,1897
79439,79439,1D9B3BEAA73444A543D0673D1FBABCFF,10251,11,14,3,35,47,1797
79440,79440,1D9B3BEAA73444A543D0673D1FBABCFF,42511,15,18,3,37,47,1897
79441,79441,1D9B3BEAA73444A543D0673D1FBABCFF,42161,18,23,5,36,47,1847
79442,79442,AAC98D8EB5664A9B5DE56F266CB31991,16281,0,7,7,11,4,554
79443,79443,AAC98D8EB5664A9B5DE56F266CB31991,15281,9,10,1,25,3,1253
79444,79444,AAC98D8EB5664A9B5DE56F266CB31991,15143,15,16,1,18,7,907
79445,79445,AAC98D8EB5664A9B5DE56F266CB31991,16281,16,22,6,11,4,554
79446,79446,397EFE76601EBED853A017531C67A0B3,12731,1,2,1,22,40,1140
79447,79447,397EFE76601EBED853A017531C67A0B3,43021,3,4,1,16,43,843
79448,79448,397EFE76601EBED853A017531C67A0B3,12921,5,23,18,9,41,491
79449,79449,6CC24D921FE70D79D98FA5B7890BCB55,19441,9,11,2,8,46,446
79450,79450,6CC24D921FE70D79D98FA5B7890BCB55,42041,11,12,1,10,47,547
79451,79451,6CC24D921FE70D79D98FA5B7890BCB55,19441,12,13,1,8,46,446
79452,79452,6CC24D921FE70D79D98FA5B7890BCB55,42041,14,15,1,10,47,547
79453,79453,6CC24D921FE70D79D98FA5B7890BCB55,11571,18,19,1,13,46,696
79454,79454,6CC24D921FE70D79D98FA5B7890BCB55,11471,20,23,3,12,48,648
79461,79461,1C461F1E440C54F9A8141510311D9FF7,10151,0,16,16,34,47,1747
79462,79462,1C461F1E440C54F9A8141510311D9FF7,11061,19,20,1,29,48,1498
79463,79463,1C461F1E440C54F9A8141510311D9FF7,11701,21,23,2,43,48,2198
79464,79464,92C829C196D69D1F6785C73B9B016B15,10221,1,6,5,34,49,1749
79465,79465,92C829C196D69D1F6785C73B9B016B15,11871,9,13,4,29,46,1496
79466,79466,92C829C196D69D1F6785C73B9B016B15,12311,13,16,3,30,44,1544
79467,79467,92C829C196D69D1F6785C73B9B016B15,11074,19,20,1,37,47,1897
79468,79468,CD8F8ECD6C484214361C94940E3BD476,42581,0,7,7,38,48,1948
79469,79469,CD8F8ECD6C484214361C94940E3BD476,10471,7,10,3,37,48,1898
79470,79470,CD8F8ECD6C484214361C94940E3BD476,42581,12,13,1,38,48,1948
79471,79471,CD8F8ECD6C484214361C94940E3BD476,10471,14,18,4,37,48,1898
79472,79472,CD8F8ECD6C484214361C94940E3BD476,42581,18,23,5,38,48,1948
79473,79473,A61D0F5D6E4730E77483BB5A83F54B2C,13841,0,8,8,40,46,2046
79474,79474,A61D0F5D6E4730E77483BB5A83F54B2C,10841,9,12,3,37,47,1897
79475,79475,A61D0F5D6E4730E77483BB5A83F54B2C,13841,12,13,1,40,46,2046
79476,79476,A61D0F5D6E4730E77483BB5A83F54B2C,42511,14,17,3,37,47,1897
79477,79477,A61D0F5D6E4730E77483BB5A83F54B2C,42401,17,18,1,36,47,1847
79478,79478,A61D0F5D6E4730E77483BB5A83F54B2C,40463,21,22,1,38,49,1949
79479,79479,A53DAA006542212C0F792E33874BF547,10231,2,7,5,39,49,1999
79480,79480,A53DAA006542212C0F792E33874BF547,42471,10,14,4,35,49,1799
79481,79481,A53DAA006542212C0F792E33874BF547,43161,15,22,7,35,47,1797
79482,79482,BCCA36AC6DE92B5D284204C1D312B82A,43161,0,7,7,35,47,1797
79483,79483,BCCA36AC6DE92B5D284204C1D312B82A,11291,9,16,7,40,49,2049
79484,79484,BCCA36AC6DE92B5D284204C1D312B82A,42523,18,19,1,31,47,1597
79485,79485,BCCA36AC6DE92B5D284204C1D312B82A,43161,20,23,3,35,47,1797
79492,79492,FE22E158CBE96C4E9BAEDD270BA1E9A4,11361,0,2,2,22,48,1148
79493,79493,FE22E158CBE96C4E9BAEDD270BA1E9A4,12601,3,4,1,25,47,1297
79494,79494,FE22E158CBE96C4E9BAEDD270BA1E9A4,11361,4,5,1,22,48,1148
79495,79495,FE22E158CBE96C4E9BAEDD270BA1E9A4,12601,5,7,2,25,47,1297
79496,79496,FE22E158CBE96C4E9BAEDD270BA1E9A4,10501,9,11,2,22,46,1146
79497,79497,FE22E158CBE96C4E9BAEDD270BA1E9A4,12601,18,19,1,25,47,1297
79498,79498,FE22E158CBE96C4E9BAEDD270BA1E9A4,12051,21,22,1,20,47,1047
79499,79499,406EDA02B30F2BAE6E77943EDDABB841,42461,0,5,5,45,47,2297
79500,79500,406EDA02B30F2BAE6E77943EDDABB841,42801,7,11,4,40,49,2049
79501,79501,406EDA02B30F2BAE6E77943EDDABB841,43061,11,12,1,43,46,2196
79502,79502,406EDA02B30F2BAE6E77943EDDABB841,11291,13,17,4,40,49,2049
79503,79503,406EDA02B30F2BAE6E77943EDDABB841,42204,21,23,2,43,46,2196
79504,79504,A4492F7AAEAC4303C146DD403022B550,10271,0,16,16,37,46,1896
79505,79505,A4492F7AAEAC4303C146DD403022B550,40302,16,17,1,40,49,2049
79506,79506,A4492F7AAEAC4303C146DD403022B550,10271,20,23,3,37,46,1896
79513,79513,1A5BED51D45595E1322F7C9DAB1FCF2D,13341,0,8,8,44,45,2245
79514,79514,1A5BED51D45595E1322F7C9DAB1FCF2D,43321,10,16,6,36,49,1849
79515,79515,1A5BED51D45595E1322F7C9DAB1FCF2D,43061,19,23,4,43,46,2196
79516,79516,9918FEABB0433C4402810CC88ACF5496,12311,0,13,13,30,44,1544
79517,79517,9918FEABB0433C4402810CC88ACF5496,42151,14,15,1,35,45,1795
79518,79518,9918FEABB0433C4402810CC88ACF5496,12311,18,23,5,30,44,1544
79519,79519,20A7975366758E3C48A8CB4E3CD0626C,40343,2,4,2,24,49,1249
79520,79520,20A7975366758E3C48A8CB4E3CD0626C,42121,4,9,5,26,49,1349
79521,79521,20A7975366758E3C48A8CB4E3CD0626C,43761,11,12,1,32,47,1647
79522,79522,20A7975366758E3C48A8CB4E3CD0626C,40343,16,22,6,24,49,1249
79532,79532,FEA371B99B04FC8CCEB8F07D4D5C7BA2,42941,0,2,2,37,47,1897
79533,79533,FEA371B99B04FC8CCEB8F07D4D5C7BA2,10151,2,7,5,34,47,1747
79534,79534,FEA371B99B04FC8CCEB8F07D4D5C7BA2,10631,8,9,1,28,46,1446
79535,79535,FEA371B99B04FC8CCEB8F07D4D5C7BA2,10471,15,17,2,37,48,1898
79536,79536,FEA371B99B04FC8CCEB8F07D4D5C7BA2,43161,17,19,2,35,47,1797
79537,79537,FEA371B99B04FC8CCEB8F07D4D5C7BA2,10292,20,23,3,30,47,1547
79538,79538,4DA57F9F33C37E2CA21407DE781C18AF,42351,0,3,3,38,45,1945
79539,79539,4DA57F9F33C37E2CA21407DE781C18AF,12211,3,5,2,41,44,2094
79540,79540,4DA57F9F33C37E2CA21407DE781C18AF,13911,5,7,2,39,46,1996
79541,79541,4DA57F9F33C37E2CA21407DE781C18AF,11261,16,18,2,36,46,1846
79542,79542,4DA57F9F33C37E2CA21407DE781C18AF,12211,22,23,1,41,44,2094
79546,79546,51E47FDE51716EB36BE96125516194AB,11591,0,10,10,36,49,1849
79547,79547,51E47FDE51716EB36BE96125516194AB,40697,12,14,2,43,48,2198
79548,79548,51E47FDE51716EB36BE96125516194AB,11021,14,17,3,36,49,1849
79549,79549,51E47FDE51716EB36BE96125516194AB,40697,18,19,1,43,48,2198
79550,79550,51E47FDE51716EB36BE96125516194AB,11021,21,23,2,36,49,1849
79551,79551,40257793138059A0D6A37EE6DF34B737,42961,0,9,9,35,49,1799
79552,79552,40257793138059A0D6A37EE6DF34B737,40571,13,16,3,35,48,1798
79553,79553,40257793138059A0D6A37EE6DF34B737,40341,18,19,1,23,49,1199
79554,79554,40257793138059A0D6A37EE6DF34B737,42961,20,23,3,35,49,1799
79555,79555,1522BDE7E05C3ADAA9D8391F632D7715,11361,0,5,5,22,48,1148
79556,79556,1522BDE7E05C3ADAA9D8391F632D7715,12051,7,8,1,20,47,1047
79557,79557,1522BDE7E05C3ADAA9D8391F632D7715,12581,10,12,2,24,48,1248
79558,79558,1522BDE7E05C3ADAA9D8391F632D7715,11361,12,14,2,22,48,1148
79559,79559,1522BDE7E05C3ADAA9D8391F632D7715,12581,15,17,2,24,48,1248
79560,79560,1522BDE7E05C3ADAA9D8391F632D7715,11361,18,22,4,22,48,1148
79567,79567,91BDEDAC648767D3A83A88B3F0D48C25,42351,0,6,6,38,45,1945
79568,79568,91BDEDAC648767D3A83A88B3F0D48C25,13911,6,7,1,39,46,1996
79569,79569,91BDEDAC648767D3A83A88B3F0D48C25,42231,7,11,4,37,46,1896
79570,79570,91BDEDAC648767D3A83A88B3F0D48C25,42351,11,14,3,38,45,1945
79571,79571,91BDEDAC648767D3A83A88B3F0D48C25,13911,14,19,5,39,46,1996
79572,79572,91BDEDAC648767D3A83A88B3F0D48C25,42351,19,20,1,38,45,1945
79573,79573,91BDEDAC648767D3A83A88B3F0D48C25,13911,21,22,1,39,46,1996
79584,79584,B3CFC91900289E4712994EEECA76310E,11861,0,9,9,32,47,1647
79585,79585,B3CFC91900289E4712994EEECA76310E,10107,13,15,2,38,49,1949
79586,79586,B3CFC91900289E4712994EEECA76310E,40341,16,18,2,23,49,1199
79587,79587,B3CFC91900289E4712994EEECA76310E,11861,20,23,3,32,47,1647
79588,79588,0113038D97A9C8509BD9AEFD7B175D37,13461,0,4,4,39,44,1994
79589,79589,0113038D97A9C8509BD9AEFD7B175D37,42864,5,6,1,38,44,1944
79590,79590,0113038D97A9C8509BD9AEFD7B175D37,42861,6,9,3,37,44,1894
79591,79591,0113038D97A9C8509BD9AEFD7B175D37,11261,17,18,1,36,46,1846
79592,79592,0113038D97A9C8509BD9AEFD7B175D37,42864,22,23,1,38,44,1944
79599,79599,F93D646A1BCE1AFF390EB78A01863C9E,40171,2,6,4,38,48,1948
79600,79600,F93D646A1BCE1AFF390EB78A01863C9E,10471,7,9,2,37,48,1898
79601,79601,F93D646A1BCE1AFF390EB78A01863C9E,40171,12,13,1,38,48,1948
79602,79602,F93D646A1BCE1AFF390EB78A01863C9E,10471,13,18,5,37,48,1898
79603,79603,F93D646A1BCE1AFF390EB78A01863C9E,40171,19,22,3,38,48,1948
79604,79604,DAF070E37522449552E837969D087804,11171,0,6,6,33,48,1698
79605,79605,DAF070E37522449552E837969D087804,11231,7,11,4,37,49,1899
79606,79606,DAF070E37522449552E837969D087804,11171,12,13,1,33,48,1698
79607,79607,DAF070E37522449552E837969D087804,11231,14,18,4,37,49,1899
79608,79608,DAF070E37522449552E837969D087804,10491,19,23,4,33,48,1698
79609,79609,DD41A5B37253F8BC5CA4FE0D3117DB9E,12521,7,8,1,35,41,1791
79610,79610,DD41A5B37253F8BC5CA4FE0D3117DB9E,43451,10,11,1,37,40,1890
79611,79611,DD41A5B37253F8BC5CA4FE0D3117DB9E,12521,12,14,2,35,41,1791
79612,79612,DD41A5B37253F8BC5CA4FE0D3117DB9E,13314,19,22,3,31,39,1589
79613,79613,0DCD9EEA776860D0621554B5A42521A4,10681,0,6,6,30,48,1548
79614,79614,0DCD9EEA776860D0621554B5A42521A4,11061,8,10,2,29,48,1498
79615,79615,0DCD9EEA776860D0621554B5A42521A4,10681,15,16,1,30,48,1548
79616,79616,0DCD9EEA776860D0621554B5A42521A4,11061,16,18,2,29,48,1498
79617,79617,0DCD9EEA776860D0621554B5A42521A4,10681,19,23,4,30,48,1548
79622,79622,6CBBEE1C450344F3879ED38C16F213C4,43751,3,5,2,19,48,998
79623,79623,6CBBEE1C450344F3879ED38C16F213C4,12581,7,8,1,24,48,1248
79624,79624,6CBBEE1C450344F3879ED38C16F213C4,12051,12,13,1,20,47,1047
79625,79625,6CBBEE1C450344F3879ED38C16F213C4,12581,14,21,7,24,48,1248
79626,79626,5097D28E1C98454DC0C0BA1FE079F027,13094,0,6,6,21,42,1092
79627,79627,5097D28E1C98454DC0C0BA1FE079F027,12601,9,10,1,25,47,1297
79628,79628,5097D28E1C98454DC0C0BA1FE079F027,11381,12,14,2,30,47,1547
79629,79629,5097D28E1C98454DC0C0BA1FE079F027,12601,17,19,2,25,47,1297
79630,79630,6CCC61A9625A927B2737EBF2AFFA9FFC,13331,0,8,8,38,47,1947
79631,79631,6CCC61A9625A927B2737EBF2AFFA9FFC,40341,10,13,3,23,49,1199
79632,79632,6CCC61A9625A927B2737EBF2AFFA9FFC,11701,14,15,1,43,48,2198
79633,79633,6CCC61A9625A927B2737EBF2AFFA9FFC,12514,16,23,7,38,47,1947
79634,79634,3D97CD40EAC505910D95CCB4A74CAE65,42864,0,6,6,38,44,1944
79635,79635,3D97CD40EAC505910D95CCB4A74CAE65,42861,6,10,4,37,44,1894
79636,79636,3D97CD40EAC505910D95CCB4A74CAE65,42864,14,16,2,38,44,1944
79637,79637,3D97CD40EAC505910D95CCB4A74CAE65,11261,17,20,3,36,46,1846
79638,79638,3D97CD40EAC505910D95CCB4A74CAE65,42864,21,22,1,38,44,1944
79639,79639,1549AC9E11F1BF9B748BBE867E46CA41,10301,5,6,1,31,45,1595
79640,79640,1549AC9E11F1BF9B748BBE867E46CA41,11871,9,21,12,29,46,1496
79641,79641,1549AC9E11F1BF9B748BBE867E46CA41,13671,21,23,2,27,43,1393
79645,79645,720E0747D5CFEEA7ABCF987512B0DAB4,40271,7,8,1,35,49,1799
79646,79646,720E0747D5CFEEA7ABCF987512B0DAB4,11301,10,12,2,41,49,2099
79647,79647,720E0747D5CFEEA7ABCF987512B0DAB4,40271,12,23,11,35,49,1799
79648,79648,EF4100B4391F55DDFFFFBAE9F0BF0EC4,10621,2,13,11,41,49,2099
79649,79649,EF4100B4391F55DDFFFFBAE9F0BF0EC4,42401,13,17,4,36,47,1847
79650,79650,EF4100B4391F55DDFFFFBAE9F0BF0EC4,10621,19,20,1,41,49,2099
79651,79651,EF4100B4391F55DDFFFFBAE9F0BF0EC4,42401,21,23,2,36,47,1847
79652,79652,8DCBE913047A4EFA5302E4AB5EEAE30F,41392,0,15,15,43,48,2198
79653,79653,8DCBE913047A4EFA5302E4AB5EEAE30F,10161,16,19,3,35,49,1799
79654,79654,8DCBE913047A4EFA5302E4AB5EEAE30F,10191,20,22,2,40,48,2048
79659,79659,4939079DBC41D72C03B48C02C72AD37E,43021,0,7,7,16,43,843
79660,79660,4939079DBC41D72C03B48C02C72AD37E,12921,8,9,1,9,41,491
79661,79661,4939079DBC41D72C03B48C02C72AD37E,43021,9,16,7,16,43,843
79662,79662,4939079DBC41D72C03B48C02C72AD37E,12921,18,20,2,9,41,491
79663,79663,004D26DDA49F4E295E56D0D4EFA58427,11731,0,1,1,36,48,1848
79664,79664,004D26DDA49F4E295E56D0D4EFA58427,11231,1,2,1,37,49,1899
79665,79665,004D26DDA49F4E295E56D0D4EFA58427,16121,5,8,3,3,0,150
79666,79666,004D26DDA49F4E295E56D0D4EFA58427,16241,14,16,2,3,3,153
79667,79667,004D26DDA49F4E295E56D0D4EFA58427,16041,20,21,1,1,5,55
79668,79668,9259900CF1484CEAFCB0BE9321BC8694,10691,0,7,7,33,48,1698
79669,79669,9259900CF1484CEAFCB0BE9321BC8694,11231,8,9,1,37,49,1899
79670,79670,9259900CF1484CEAFCB0BE9321BC8694,10471,9,11,2,37,48,1898
79671,79671,9259900CF1484CEAFCB0BE9321BC8694,10911,12,13,1,39,46,1996
79672,79672,9259900CF1484CEAFCB0BE9321BC8694,11231,14,17,3,37,49,1899
79673,79673,9259900CF1484CEAFCB0BE9321BC8694,10691,20,22,2,33,48,1698
79681,79681,A8DE1C05EB2F39F034CE522120B1C25D,43471,1,11,10,31,49,1599
79682,79682,A8DE1C05EB2F39F034CE522120B1C25D,43981,13,15,2,36,49,1849
79683,79683,A8DE1C05EB2F39F034CE522120B1C25D,42461,19,20,1,45,47,2297
79684,79684,A8DE1C05EB2F39F034CE522120B1C25D,13561,22,23,1,37,49,1899
79688,79688,78520B675436202D640A52F7BAC3D2C7,12792,0,11,11,34,30,1730
79689,79689,78520B675436202D640A52F7BAC3D2C7,43081,12,14,2,27,28,1378
79690,79690,78520B675436202D640A52F7BAC3D2C7,15391,15,16,1,35,26,1776
79691,79691,78520B675436202D640A52F7BAC3D2C7,12792,16,22,6,34,30,1730
79692,79692,DBE56CF804EFF98F06EBBF480586FC01,12921,1,9,8,9,41,491
79693,79693,DBE56CF804EFF98F06EBBF480586FC01,43021,10,12,2,16,43,843
79694,79694,DBE56CF804EFF98F06EBBF480586FC01,12921,14,16,2,9,41,491
79695,79695,DBE56CF804EFF98F06EBBF480586FC01,43021,18,20,2,16,43,843
79699,79699,04618E39CCC1E5047B065A0EFB16FDCC,11954,2,10,8,32,49,1649
79700,79700,04618E39CCC1E5047B065A0EFB16FDCC,13091,12,14,2,20,42,1042
79701,79701,04618E39CCC1E5047B065A0EFB16FDCC,19114,17,18,1,7,43,393
79702,79702,04618E39CCC1E5047B065A0EFB16FDCC,41031,19,23,4,32,49,1649
79713,79713,5CE5B38C43463AB4DE2D4D106DC3D232,13111,1,8,7,42,46,2146
79714,79714,5CE5B38C43463AB4DE2D4D106DC3D232,42204,9,10,1,43,46,2196
79715,79715,5CE5B38C43463AB4DE2D4D106DC3D232,43161,11,13,2,35,47,1797
79716,79716,5CE5B38C43463AB4DE2D4D106DC3D232,10771,14,18,4,41,46,2096
79717,79717,5CE5B38C43463AB4DE2D4D106DC3D232,13371,19,21,2,41,47,2097
79718,79718,5CE5B38C43463AB4DE2D4D106DC3D232,40171,22,23,1,38,48,1948
79725,79725,83032CC6A0DAD180410F046AB9CA56B4,11381,0,15,15,30,47,1547
79726,79726,83032CC6A0DAD180410F046AB9CA56B4,11531,15,17,2,34,49,1749
79727,79727,83032CC6A0DAD180410F046AB9CA56B4,43971,18,20,2,30,48,1548
79728,79728,83032CC6A0DAD180410F046AB9CA56B4,11381,20,21,1,30,47,1547
79733,79733,60F7F4881031002766F8A8E2FAB27EDD,10041,0,13,13,39,49,1999
79734,79734,60F7F4881031002766F8A8E2FAB27EDD,11111,15,17,2,26,48,1348
79735,79735,60F7F4881031002766F8A8E2FAB27EDD,10041,18,22,4,39,49,1999
79736,79736,22599EC0273FE364099D04FF5FDC0C09,11801,2,5,3,42,48,2148
79737,79737,22599EC0273FE364099D04FF5FDC0C09,11701,6,9,3,43,48,2198
79738,79738,22599EC0273FE364099D04FF5FDC0C09,12521,16,18,2,35,41,1791
79742,79742,44BC803EBEEB9A2CCD6FCA94BE7F6A5D,11061,0,8,8,29,48,1498
79743,79743,44BC803EBEEB9A2CCD6FCA94BE7F6A5D,12601,9,10,1,25,47,1297
79744,79744,44BC803EBEEB9A2CCD6FCA94BE7F6A5D,11061,12,13,1,29,48,1498
79745,79745,44BC803EBEEB9A2CCD6FCA94BE7F6A5D,11291,15,16,1,40,49,2049
79746,79746,44BC803EBEEB9A2CCD6FCA94BE7F6A5D,10681,20,22,2,30,48,1548
79750,79750,7D0B5FCD22D145BBE916FD977FC9A1B6,10111,0,8,8,37,47,1897
79751,79751,7D0B5FCD22D145BBE916FD977FC9A1B6,40733,9,12,3,32,48,1648
79752,79752,7D0B5FCD22D145BBE916FD977FC9A1B6,10111,13,23,10,37,47,1897
79759,79759,9F4FE5C66D1FE88FA924255DF3CD2B31,10411,0,9,9,36,48,1848
79760,79760,9F4FE5C66D1FE88FA924255DF3CD2B31,13651,13,14,1,30,47,1547
79761,79761,9F4FE5C66D1FE88FA924255DF3CD2B31,11911,15,23,8,37,48,1898
79765,79765,1482B7A55B8E55DF5157551064F6B705,13471,0,7,7,47,49,2399
79766,79766,1482B7A55B8E55DF5157551064F6B705,10111,8,15,7,37,47,1897
79767,79767,1482B7A55B8E55DF5157551064F6B705,11001,16,19,3,42,47,2147
79768,79768,1482B7A55B8E55DF5157551064F6B705,13471,20,23,3,47,49,2399
79769,79769,67C51402BBE69AA4B2460EAE686580B0,11081,0,6,6,35,46,1796
79770,79770,67C51402BBE69AA4B2460EAE686580B0,10351,8,15,7,28,45,1445
79771,79771,67C51402BBE69AA4B2460EAE686580B0,11081,18,23,5,35,46,1796
79778,79778,DF189E83BAB7254002D11C89D4F2D51F,10341,0,5,5,31,47,1597
79779,79779,DF189E83BAB7254002D11C89D4F2D51F,42501,7,10,3,28,47,1447
79780,79780,DF189E83BAB7254002D11C89D4F2D51F,10341,11,14,3,31,47,1597
79781,79781,DF189E83BAB7254002D11C89D4F2D51F,41631,15,17,2,28,47,1447
79782,79782,DF189E83BAB7254002D11C89D4F2D51F,10341,21,23,2,31,47,1597
79783,79783,7E462EDE1988B5E44137C4D723C792D0,11921,2,7,5,38,48,1948
79784,79784,7E462EDE1988B5E44137C4D723C792D0,11151,9,17,8,30,48,1548
79785,79785,7E462EDE1988B5E44137C4D723C792D0,10161,18,20,2,35,49,1799
79786,79786,7E462EDE1988B5E44137C4D723C792D0,11331,20,22,2,37,48,1898
79787,79787,CA7675D4504FF649E5D3C79C1D770D57,10901,0,5,5,35,48,1798
79788,79788,CA7675D4504FF649E5D3C79C1D770D57,11151,9,17,8,30,48,1548
79789,79789,CA7675D4504FF649E5D3C79C1D770D57,10901,20,23,3,35,48,1798
79790,79790,D500A33E5EBF4610FFE1DAD30674EBEB,42281,0,6,6,40,48,2048
79791,79791,D500A33E5EBF4610FFE1DAD30674EBEB,13271,8,9,1,41,47,2097
79792,79792,D500A33E5EBF4610FFE1DAD30674EBEB,42281,13,14,1,40,48,2048
79793,79793,D500A33E5EBF4610FFE1DAD30674EBEB,42411,15,18,3,40,49,2049
79794,79794,D500A33E5EBF4610FFE1DAD30674EBEB,42281,19,23,4,40,48,2048
79795,79795,9C47145209ECFC40DF20CE0BFE35E37E,43761,0,6,6,32,47,1647
79796,79796,9C47145209ECFC40DF20CE0BFE35E37E,42523,6,10,4,31,47,1597
79797,79797,9C47145209ECFC40DF20CE0BFE35E37E,43761,10,13,3,32,47,1647
79798,79798,9C47145209ECFC40DF20CE0BFE35E37E,42523,13,19,6,31,47,1597
79799,79799,9C47145209ECFC40DF20CE0BFE35E37E,43761,19,23,4,32,47,1647
79803,79803,A60E51B2BB36D63F6E34260285BCBDB6,42531,0,2,2,31,45,1595
79804,79804,A60E51B2BB36D63F6E34260285BCBDB6,12661,3,11,8,32,45,1645
79805,79805,A60E51B2BB36D63F6E34260285BCBDB6,42531,14,16,2,31,45,1595
79806,79806,A60E51B2BB36D63F6E34260285BCBDB6,12661,19,20,1,32,45,1645
79807,79807,A60E51B2BB36D63F6E34260285BCBDB6,42531,21,22,1,31,45,1595
79808,79808,800FED50F2F7737DBE05BF1B7626336F,12121,0,13,13,29,47,1497
79809,79809,800FED50F2F7737DBE05BF1B7626336F,12481,13,14,1,37,49,1899
79810,79810,800FED50F2F7737DBE05BF1B7626336F,10107,16,20,4,38,49,1949
79811,79811,4C4BFC6596FD3FEC2B91BC1C914BF8BF,19281,4,11,7,16,32,832
79812,79812,4C4BFC6596FD3FEC2B91BC1C914BF8BF,13511,14,19,5,34,48,1748
79813,79813,4C4BFC6596FD3FEC2B91BC1C914BF8BF,13601,20,21,1,34,47,1747
79814,79814,4C4BFC6596FD3FEC2B91BC1C914BF8BF,13511,21,23,2,34,48,1748
79815,79815,39E8EC68B5351FA08172ACDD9F93F15C,15023,1,2,1,46,17,2317
79816,79816,39E8EC68B5351FA08172ACDD9F93F15C,15261,3,5,2,39,13,1963
79817,79817,39E8EC68B5351FA08172ACDD9F93F15C,12131,18,20,2,32,47,1647
79829,79829,A63D605A72631A6DDAE7BAAAC6A30961,43051,1,8,7,46,45,2345
79830,79830,A63D605A72631A6DDAE7BAAAC6A30961,43061,10,12,2,43,46,2196
79831,79831,A63D605A72631A6DDAE7BAAAC6A30961,43051,13,16,3,46,45,2345
79832,79832,A63D605A72631A6DDAE7BAAAC6A30961,43061,18,19,1,43,46,2196
79833,79833,A63D605A72631A6DDAE7BAAAC6A30961,43051,22,23,1,46,45,2345
79834,79834,88B9ED484BFC88A3E18D812526B753D0,13231,0,3,3,39,46,1996
79835,79835,88B9ED484BFC88A3E18D812526B753D0,42864,6,10,4,38,44,1944
79836,79836,88B9ED484BFC88A3E18D812526B753D0,11261,11,12,1,36,46,1846
79837,79837,88B9ED484BFC88A3E18D812526B753D0,42864,13,18,5,38,44,1944
79838,79838,88B9ED484BFC88A3E18D812526B753D0,11261,18,20,2,36,46,1846
79839,79839,88B9ED484BFC88A3E18D812526B753D0,42351,21,22,1,38,45,1945
79840,79840,5E9E9D1FAC44023D304EE7B18B4556F6,11324,0,7,7,31,46,1596
79841,79841,5E9E9D1FAC44023D304EE7B18B4556F6,40341,12,13,1,23,49,1199
79842,79842,5E9E9D1FAC44023D304EE7B18B4556F6,11381,14,16,2,30,47,1547
79843,79843,5E9E9D1FAC44023D304EE7B18B4556F6,11324,18,23,5,31,46,1596
79848,79848,2ABF878D3351AC21016A2AF7920DA191,40302,10,11,1,40,49,2049
79849,79849,2ABF878D3351AC21016A2AF7920DA191,11061,14,16,2,29,48,1498
79850,79850,2ABF878D3351AC21016A2AF7920DA191,10491,20,21,1,33,48,1698
79851,79851,7944D6B1B6923CA6204E81B4E837FA2D,19744,0,7,7,6,43,343
79852,79852,7944D6B1B6923CA6204E81B4E837FA2D,12641,9,12,3,10,43,543
79853,79853,7944D6B1B6923CA6204E81B4E837FA2D,19741,12,13,1,5,44,294
79854,79854,7944D6B1B6923CA6204E81B4E837FA2D,12641,13,15,2,10,43,543
79855,79855,7944D6B1B6923CA6204E81B4E837FA2D,19744,18,23,5,6,43,343
79856,79856,27B6DDFE3A356062F221ABD7AD70BB14,11061,0,6,6,29,48,1498
79857,79857,27B6DDFE3A356062F221ABD7AD70BB14,10681,7,8,1,30,48,1548
79858,79858,27B6DDFE3A356062F221ABD7AD70BB14,11061,11,16,5,29,48,1498
79859,79859,27B6DDFE3A356062F221ABD7AD70BB14,10681,16,17,1,30,48,1548
79860,79860,27B6DDFE3A356062F221ABD7AD70BB14,11061,18,23,5,29,48,1498
79864,79864,69E733DE4C2A7A294CFA07F4F32678A0,42231,1,15,14,37,46,1896
79865,79865,69E733DE4C2A7A294CFA07F4F32678A0,42021,19,20,1,33,47,1697
79866,79866,69E733DE4C2A7A294CFA07F4F32678A0,42521,21,22,1,31,47,1597
79867,79867,A2DD7BA75FCE1B5306A377D198F94491,15391,0,15,15,35,26,1776
79868,79868,A2DD7BA75FCE1B5306A377D198F94491,12792,15,19,4,34,30,1730
79869,79869,A2DD7BA75FCE1B5306A377D198F94491,15391,19,22,3,35,26,1776
79873,79873,94208362745F4CC8136A1624AA480486,10161,0,9,9,35,49,1799
79874,79874,94208362745F4CC8136A1624AA480486,10901,10,11,1,35,48,1798
79875,79875,94208362745F4CC8136A1624AA480486,40951,14,16,2,36,49,1849
79876,79876,94208362745F4CC8136A1624AA480486,10901,16,18,2,35,48,1798
79877,79877,94208362745F4CC8136A1624AA480486,10161,19,23,4,35,49,1799
79881,79881,8CFC03EC88C1AC21AA2B3EEF824D5E2A,11381,0,7,7,30,47,1547
79882,79882,8CFC03EC88C1AC21AA2B3EEF824D5E2A,11751,9,12,3,35,48,1798
79883,79883,8CFC03EC88C1AC21AA2B3EEF824D5E2A,13651,14,23,9,30,47,1547
79884,79884,40A3F567657A043546A2ED7A5DC91A85,15331,0,5,5,38,24,1924
79885,79885,40A3F567657A043546A2ED7A5DC91A85,12792,5,21,16,34,30,1730
79886,79886,40A3F567657A043546A2ED7A5DC91A85,15331,21,23,2,38,24,1924
79887,79887,E8104506048C66FE75BF1793EB9DB3FE,15321,6,7,1,29,26,1476
79888,79888,E8104506048C66FE75BF1793EB9DB3FE,43121,9,10,1,25,27,1277
79889,79889,E8104506048C66FE75BF1793EB9DB3FE,15561,13,14,1,32,22,1622
79890,79890,E8104506048C66FE75BF1793EB9DB3FE,15411,15,21,6,44,27,2227
79891,79891,E5C174D2FF195FD116006ADE577A953D,11061,0,6,6,29,48,1498
79892,79892,E5C174D2FF195FD116006ADE577A953D,11151,9,15,6,30,48,1548
79893,79893,E5C174D2FF195FD116006ADE577A953D,42831,15,16,1,27,48,1398
79894,79894,E5C174D2FF195FD116006ADE577A953D,11151,17,19,2,30,48,1548
79895,79895,E5C174D2FF195FD116006ADE577A953D,12121,21,22,1,29,47,1497
79896,79896,CB6CE8B284764CB65EC4187E6FE5A3FF,43021,0,8,8,16,43,843
79897,79897,CB6CE8B284764CB65EC4187E6FE5A3FF,19021,13,15,2,10,45,545
79898,79898,CB6CE8B284764CB65EC4187E6FE5A3FF,43021,15,17,2,16,43,843
79899,79899,CB6CE8B284764CB65EC4187E6FE5A3FF,19021,18,22,4,10,45,545
79900,79900,0A15402BF50F336CD996C3C85D01B359,10471,0,7,7,37,48,1898
79901,79901,0A15402BF50F336CD996C3C85D01B359,43061,8,9,1,43,46,2196
79902,79902,0A15402BF50F336CD996C3C85D01B359,10471,12,15,3,37,48,1898
79903,79903,0A15402BF50F336CD996C3C85D01B359,11231,16,17,1,37,49,1899
79904,79904,0A15402BF50F336CD996C3C85D01B359,10471,18,23,5,37,48,1898
79905,79905,ACFFCEADC3F589A8F690FE2669E3730D,42041,0,6,6,10,47,547
79906,79906,ACFFCEADC3F589A8F690FE2669E3730D,19441,9,11,2,8,46,446
79907,79907,ACFFCEADC3F589A8F690FE2669E3730D,19621,13,18,5,5,46,296
79908,79908,ACFFCEADC3F589A8F690FE2669E3730D,42041,19,20,1,10,47,547
79909,79909,B90520ED7BDDE423CEFE3ED6913620C9,10841,3,4,1,37,47,1897
79910,79910,B90520ED7BDDE423CEFE3ED6913620C9,12514,4,5,1,38,47,1947
79911,79911,B90520ED7BDDE423CEFE3ED6913620C9,10271,8,14,6,37,46,1896
79912,79912,B90520ED7BDDE423CEFE3ED6913620C9,11631,19,20,1,12,49,649
79920,79920,48DCE60D429B0B1E7F2F1B7A462BF9BF,42523,8,9,1,31,47,1597
79921,79921,48DCE60D429B0B1E7F2F1B7A462BF9BF,11101,14,15,1,18,48,948
79922,79922,48DCE60D429B0B1E7F2F1B7A462BF9BF,42523,18,20,2,31,47,1597
79923,79923,D19CCADD05AE7D38BD327DD3B3A1E602,42861,0,1,1,37,44,1894
79924,79924,D19CCADD05AE7D38BD327DD3B3A1E602,42351,1,3,2,38,45,1945
79925,79925,D19CCADD05AE7D38BD327DD3B3A1E602,42861,5,6,1,37,44,1894
79926,79926,D19CCADD05AE7D38BD327DD3B3A1E602,42231,9,10,1,37,46,1896
79927,79927,D19CCADD05AE7D38BD327DD3B3A1E602,42351,11,13,2,38,45,1945
79928,79928,D19CCADD05AE7D38BD327DD3B3A1E602,42231,13,18,5,37,46,1896
79929,79929,D19CCADD05AE7D38BD327DD3B3A1E602,13911,19,20,1,39,46,1996
79930,79930,65D4345A2D3576315A5C944F8DDA0CFE,42864,0,5,5,38,44,1944
79931,79931,65D4345A2D3576315A5C944F8DDA0CFE,11261,5,6,1,36,46,1846
79932,79932,65D4345A2D3576315A5C944F8DDA0CFE,42864,7,13,6,38,44,1944
79933,79933,65D4345A2D3576315A5C944F8DDA0CFE,11261,18,20,2,36,46,1846
79934,79934,65D4345A2D3576315A5C944F8DDA0CFE,42864,21,23,2,38,44,1944
79935,79935,4CEF2D9D71549E955305B2DC8309A78D,12641,3,5,2,10,43,543
79936,79936,4CEF2D9D71549E955305B2DC8309A78D,12921,6,9,3,9,41,491
79937,79937,4CEF2D9D71549E955305B2DC8309A78D,12641,9,11,2,10,43,543
79938,79938,4CEF2D9D71549E955305B2DC8309A78D,12921,13,17,4,9,41,491
79939,79939,4CEF2D9D71549E955305B2DC8309A78D,12641,21,23,2,10,43,543
79943,79943,F3B16B9F2FE5D66DD896BE8E61C1FA80,10351,5,6,1,28,45,1445
79944,79944,F3B16B9F2FE5D66DD896BE8E61C1FA80,10301,7,8,1,31,45,1595
79945,79945,F3B16B9F2FE5D66DD896BE8E61C1FA80,10351,8,10,2,28,45,1445
79946,79946,F3B16B9F2FE5D66DD896BE8E61C1FA80,10301,10,15,5,31,45,1595
79947,79947,F3B16B9F2FE5D66DD896BE8E61C1FA80,10351,16,18,2,28,45,1445
79948,79948,DBE824B61173F6DDC9B93492DF44D2A0,43191,0,7,7,40,49,2049
79949,79949,DBE824B61173F6DDC9B93492DF44D2A0,11011,15,18,3,39,49,1999
79950,79950,DBE824B61173F6DDC9B93492DF44D2A0,10681,19,20,1,30,48,1548
79951,79951,DBE824B61173F6DDC9B93492DF44D2A0,43191,20,23,3,40,49,2049
79952,79952,84F67B4B3C17ACCABE2B7DC342CF0E8C,16011,0,8,8,3,4,154
79953,79953,84F67B4B3C17ACCABE2B7DC342CF0E8C,16151,13,14,1,13,11,661
79954,79954,84F67B4B3C17ACCABE2B7DC342CF0E8C,15114,17,18,1,22,16,1116
79955,79955,84F67B4B3C17ACCABE2B7DC342CF0E8C,16151,20,22,2,13,11,661
79956,79956,09803726F3C2A40BEF93389F75159E93,10281,0,7,7,33,48,1698
79957,79957,09803726F3C2A40BEF93389F75159E93,42161,7,9,2,36,47,1847
79958,79958,09803726F3C2A40BEF93389F75159E93,10281,12,14,2,33,48,1698
79959,79959,09803726F3C2A40BEF93389F75159E93,10251,14,17,3,35,47,1797
79960,79960,09803726F3C2A40BEF93389F75159E93,10711,18,20,2,29,46,1496
79961,79961,09803726F3C2A40BEF93389F75159E93,10281,20,23,3,33,48,1698
79966,79966,8049096DB6E5C0F675A6330BE2C2C072,43501,9,17,8,27,48,1398
79967,79967,8049096DB6E5C0F675A6330BE2C2C072,12381,18,20,2,32,48,1648
79968,79968,8049096DB6E5C0F675A6330BE2C2C072,42921,21,22,1,33,47,1697
79979,79979,9845393D5587F26D61829383E21B97FC,10691,0,10,10,33,48,1698
79980,79980,9845393D5587F26D61829383E21B97FC,40341,12,14,2,23,49,1199
79981,79981,9845393D5587F26D61829383E21B97FC,10691,15,23,8,33,48,1698
79982,79982,3E7942CC71D03F103F23ED151D419DA7,12921,0,5,5,9,41,491
79983,79983,3E7942CC71D03F103F23ED151D419DA7,49201,5,6,1,7,41,391
79984,79984,3E7942CC71D03F103F23ED151D419DA7,19114,7,8,1,7,43,393
79985,79985,3E7942CC71D03F103F23ED151D419DA7,12921,11,13,2,9,41,491
79986,79986,3E7942CC71D03F103F23ED151D419DA7,49201,13,18,5,7,41,391
79987,79987,E10FF2F73D11F0845B527BA830C6A6BB,42523,0,2,2,31,47,1597
79988,79988,E10FF2F73D11F0845B527BA830C6A6BB,13651,2,3,1,30,47,1547
79989,79989,E10FF2F73D11F0845B527BA830C6A6BB,11324,5,12,7,31,46,1596
79990,79990,E10FF2F73D11F0845B527BA830C6A6BB,13651,13,14,1,30,47,1547
79991,79991,E10FF2F73D11F0845B527BA830C6A6BB,42523,17,18,1,31,47,1597
79992,79992,E10FF2F73D11F0845B527BA830C6A6BB,11324,18,19,1,31,46,1596
79993,79993,E10FF2F73D11F0845B527BA830C6A6BB,10716,21,23,2,30,46,1546
79994,79994,6CD008CBF5332727B7FB0E79DB4BAD66,11861,0,6,6,32,47,1647
79995,79995,6CD008CBF5332727B7FB0E79DB4BAD66,10901,6,10,4,35,48,1798
79996,79996,6CD008CBF5332727B7FB0E79DB4BAD66,10161,11,19,8,35,49,1799
79997,79997,6CD008CBF5332727B7FB0E79DB4BAD66,43761,21,23,2,32,47,1647
80004,80004,F90313BC40FFD1908C2B8D9FAFC50C6B,11261,0,6,6,36,46,1846
80005,80005,F90313BC40FFD1908C2B8D9FAFC50C6B,12601,9,10,1,25,47,1297
80006,80006,F90313BC40FFD1908C2B8D9FAFC50C6B,11261,14,23,9,36,46,1846
80007,80007,E090AE745FE0157CE235544725EE3E3A,12514,0,5,5,38,47,1947
80008,80008,E090AE745FE0157CE235544725EE3E3A,12511,6,7,1,39,47,1997
80009,80009,E090AE745FE0157CE235544725EE3E3A,11021,10,11,1,36,49,1849
80010,80010,E090AE745FE0157CE235544725EE3E3A,13561,13,18,5,37,49,1899
80011,80011,E090AE745FE0157CE235544725EE3E3A,42641,18,21,3,33,49,1699
80012,80012,E7F0BEFEB527574747952B709C847F2A,15051,0,6,6,19,4,954
80013,80013,E7F0BEFEB527574747952B709C847F2A,16281,8,10,2,11,4,554
80014,80014,E7F0BEFEB527574747952B709C847F2A,15051,12,23,11,19,4,954
80027,80027,0A7DFA85A264C36C549C104CEFE1DA8F,13371,0,10,10,41,47,2097
80028,80028,0A7DFA85A264C36C549C104CEFE1DA8F,11231,10,12,2,37,49,1899
80029,80029,0A7DFA85A264C36C549C104CEFE1DA8F,13371,13,19,6,41,47,2097
80030,80030,0A7DFA85A264C36C549C104CEFE1DA8F,13221,20,21,1,40,47,2047
80031,80031,09C2A5500F5ABAEEAC932C07F5628EC4,11021,0,8,8,36,49,1849
80032,80032,09C2A5500F5ABAEEAC932C07F5628EC4,42161,8,11,3,36,47,1847
80033,80033,09C2A5500F5ABAEEAC932C07F5628EC4,11021,12,14,2,36,49,1849
80034,80034,09C2A5500F5ABAEEAC932C07F5628EC4,42161,14,19,5,36,47,1847
80035,80035,09C2A5500F5ABAEEAC932C07F5628EC4,11021,21,22,1,36,49,1849
80036,80036,BBCB9918D42B41DEDF16DD7F5A9BE26F,11861,0,11,11,32,47,1647
80037,80037,BBCB9918D42B41DEDF16DD7F5A9BE26F,11911,13,16,3,37,48,1898
80038,80038,BBCB9918D42B41DEDF16DD7F5A9BE26F,11861,17,23,6,32,47,1647
80043,80043,52885050E80DA80FB3437A699501E8B9,19114,0,8,8,7,43,393
80044,80044,52885050E80DA80FB3437A699501E8B9,10491,13,17,4,33,48,1698
80045,80045,52885050E80DA80FB3437A699501E8B9,19114,20,23,3,7,43,393
80046,80046,059B87DD900F673EB560CCF4473E4A1C,10151,0,5,5,34,47,1747
80047,80047,059B87DD900F673EB560CCF4473E4A1C,10107,8,11,3,38,49,1949
80048,80048,059B87DD900F673EB560CCF4473E4A1C,13601,11,13,2,34,47,1747
80049,80049,059B87DD900F673EB560CCF4473E4A1C,10107,14,15,1,38,49,1949
80050,80050,059B87DD900F673EB560CCF4473E4A1C,10151,17,23,6,34,47,1747
80054,80054,E38BACB91CF25ECCABC03D838D11F6E2,19051,1,4,3,16,23,823
80055,80055,E38BACB91CF25ECCABC03D838D11F6E2,15641,6,17,11,9,21,471
80056,80056,E38BACB91CF25ECCABC03D838D11F6E2,19051,19,23,4,16,23,823
80057,80057,E02CD60D6C638A1FFBB91D3A09F33CDE,13371,0,10,10,41,47,2097
80058,80058,E02CD60D6C638A1FFBB91D3A09F33CDE,41091,12,17,5,35,49,1799
80059,80059,E02CD60D6C638A1FFBB91D3A09F33CDE,40951,18,20,2,36,49,1849
80063,80063,520C7CBC821664A98A49926C91FE5529,13911,0,8,8,39,46,1996
80064,80064,520C7CBC821664A98A49926C91FE5529,42231,8,11,3,37,46,1896
80065,80065,520C7CBC821664A98A49926C91FE5529,13911,11,15,4,39,46,1996
80066,80066,520C7CBC821664A98A49926C91FE5529,42231,15,17,2,37,46,1896
80067,80067,520C7CBC821664A98A49926C91FE5529,13911,20,21,1,39,46,1996
80068,80068,A5267560F8241F40BFCB325C4ADBB18D,13771,0,4,4,21,45,1095
80069,80069,A5267560F8241F40BFCB325C4ADBB18D,10351,7,8,1,28,45,1445
80070,80070,A5267560F8241F40BFCB325C4ADBB18D,12601,10,12,2,25,47,1297
80071,80071,A5267560F8241F40BFCB325C4ADBB18D,10351,16,18,2,28,45,1445
80072,80072,A5267560F8241F40BFCB325C4ADBB18D,12601,19,23,4,25,47,1297
80077,80077,997BFEBA92CD497FD716B4642C256F51,42071,6,7,1,31,49,1599
80078,80078,997BFEBA92CD497FD716B4642C256F51,42121,8,9,1,26,49,1349
80079,80079,997BFEBA92CD497FD716B4642C256F51,42071,12,22,10,31,49,1599
80080,80080,2FA6B0403E72F0FA91FFC7A71FC53030,16261,0,12,12,3,3,153
80081,80081,2FA6B0403E72F0FA91FFC7A71FC53030,10221,14,20,6,34,49,1749
80082,80082,2FA6B0403E72F0FA91FFC7A71FC53030,42161,20,23,3,36,47,1847
80083,80083,DDC302F1F99EDC922514CC6D6B327E3E,12211,0,6,6,41,44,2094
80084,80084,DDC302F1F99EDC922514CC6D6B327E3E,43051,7,9,2,46,45,2345
80085,80085,DDC302F1F99EDC922514CC6D6B327E3E,12211,10,11,1,41,44,2094
80086,80086,DDC302F1F99EDC922514CC6D6B327E3E,43051,12,16,4,46,45,2345
80087,80087,DDC302F1F99EDC922514CC6D6B327E3E,12211,17,23,6,41,44,2094
80088,80088,58A0AAD1597EB0CB45ED09B67FBFF92F,43341,0,9,9,41,46,2096
80089,80089,58A0AAD1597EB0CB45ED09B67FBFF92F,40041,10,12,2,40,49,2049
80090,80090,58A0AAD1597EB0CB45ED09B67FBFF92F,43181,12,15,3,39,48,1998
80091,80091,58A0AAD1597EB0CB45ED09B67FBFF92F,10221,16,17,1,34,49,1749
80092,80092,58A0AAD1597EB0CB45ED09B67FBFF92F,42641,19,21,2,33,49,1699
80093,80093,A633655235449D63DF9FCC21A84BEF59,12381,0,8,8,32,48,1648
80094,80094,A633655235449D63DF9FCC21A84BEF59,10191,8,10,2,40,48,2048
80095,80095,A633655235449D63DF9FCC21A84BEF59,12381,12,14,2,32,48,1648
80096,80096,A633655235449D63DF9FCC21A84BEF59,10811,16,17,1,38,46,1946
80097,80097,A633655235449D63DF9FCC21A84BEF59,12381,19,23,4,32,48,1648
80104,80104,E2FC80C995A3EFA4B2AF01BAD4B24C1C,12083,0,8,8,36,49,1849
80105,80105,E2FC80C995A3EFA4B2AF01BAD4B24C1C,10901,8,9,1,35,48,1798
80106,80106,E2FC80C995A3EFA4B2AF01BAD4B24C1C,12083,11,14,3,36,49,1849
80107,80107,E2FC80C995A3EFA4B2AF01BAD4B24C1C,10901,14,16,2,35,48,1798
80108,80108,E2FC80C995A3EFA4B2AF01BAD4B24C1C,11231,16,18,2,37,49,1899
80109,80109,E2FC80C995A3EFA4B2AF01BAD4B24C1C,12083,21,23,2,36,49,1849
80114,80114,AD40D82D2B78FE36B2F14AD5CC26A994,12381,0,8,8,32,48,1648
80115,80115,AD40D82D2B78FE36B2F14AD5CC26A994,11231,9,16,7,37,49,1899
80116,80116,AD40D82D2B78FE36B2F14AD5CC26A994,11271,18,19,1,37,48,1898
80117,80117,AD40D82D2B78FE36B2F14AD5CC26A994,40101,21,22,1,34,49,1749
80121,80121,D97F93CB7946C1399F01BAA588B11A0C,42351,0,6,6,38,45,1945
80122,80122,D97F93CB7946C1399F01BAA588B11A0C,11261,7,9,2,36,46,1846
80123,80123,D97F93CB7946C1399F01BAA588B11A0C,42351,13,14,1,38,45,1945
80124,80124,D97F93CB7946C1399F01BAA588B11A0C,11261,15,16,1,36,46,1846
80125,80125,D97F93CB7946C1399F01BAA588B11A0C,42351,19,23,4,38,45,1945
80126,80126,D0D24C7F1A65A68DAA38891FB1757B47,19031,8,11,3,1,42,92
80127,80127,D0D24C7F1A65A68DAA38891FB1757B47,19441,14,15,1,8,46,446
80128,80128,D0D24C7F1A65A68DAA38891FB1757B47,42041,20,21,1,10,47,547
80142,80142,D5BF4144E5AF9CE716209DF96F347242,40445,0,7,7,30,48,1548
80143,80143,D5BF4144E5AF9CE716209DF96F347242,11061,8,10,2,29,48,1498
80144,80144,D5BF4144E5AF9CE716209DF96F347242,43971,10,17,7,30,48,1548
80145,80145,D5BF4144E5AF9CE716209DF96F347242,42521,18,21,3,31,47,1597
80146,80146,D5BF4144E5AF9CE716209DF96F347242,43971,22,23,1,30,48,1548
80150,80150,2A299573B8ADE5EDDBBA5F82D87A0B34,43161,2,7,5,35,47,1797
80151,80151,2A299573B8ADE5EDDBBA5F82D87A0B34,10281,8,9,1,33,48,1698
80152,80152,2A299573B8ADE5EDDBBA5F82D87A0B34,13601,10,13,3,34,47,1747
80153,80153,2A299573B8ADE5EDDBBA5F82D87A0B34,42921,14,17,3,33,47,1697
80154,80154,2A299573B8ADE5EDDBBA5F82D87A0B34,13601,19,23,4,34,47,1747
80161,80161,23473E2E03D0A65C4003DD5C7AD8CFFA,11771,0,8,8,39,49,1999
80162,80162,23473E2E03D0A65C4003DD5C7AD8CFFA,11161,9,11,2,32,48,1648
80163,80163,23473E2E03D0A65C4003DD5C7AD8CFFA,42371,12,13,1,34,46,1746
80164,80164,23473E2E03D0A65C4003DD5C7AD8CFFA,12131,19,20,1,32,47,1647
80165,80165,23473E2E03D0A65C4003DD5C7AD8CFFA,40171,20,23,3,38,48,1948
80166,80166,0FD66F23349FEB00AD893343601C4D25,13311,0,1,1,27,39,1389
80167,80167,0FD66F23349FEB00AD893343601C4D25,11281,2,3,1,27,40,1390
80168,80168,0FD66F23349FEB00AD893343601C4D25,13311,4,11,7,27,39,1389
80169,80169,0FD66F23349FEB00AD893343601C4D25,13381,14,15,1,39,47,1997
80170,80170,0FD66F23349FEB00AD893343601C4D25,13221,18,19,1,40,47,2047
80171,80171,0FD66F23349FEB00AD893343601C4D25,11061,20,21,1,29,48,1498
80172,80172,F8705AE7C3FC0FABF3ABD491431BFEC4,10491,0,12,12,33,48,1698
80173,80173,F8705AE7C3FC0FABF3ABD491431BFEC4,13094,14,15,1,21,42,1092
80174,80174,F8705AE7C3FC0FABF3ABD491431BFEC4,10491,22,23,1,33,48,1698
80181,80181,C30BEEA9CA254D53A7149F2D7023764F,11301,0,4,4,41,49,2099
80182,80182,C30BEEA9CA254D53A7149F2D7023764F,11781,5,12,7,38,49,1949
80183,80183,C30BEEA9CA254D53A7149F2D7023764F,13961,14,15,1,42,48,2148
80184,80184,C30BEEA9CA254D53A7149F2D7023764F,10191,16,17,1,40,48,2048
80185,80185,C30BEEA9CA254D53A7149F2D7023764F,11781,18,20,2,38,49,1949
80186,80186,F599BD40004701EFC1748D458DE1C7F2,11201,0,2,2,35,49,1799
80187,80187,F599BD40004701EFC1748D458DE1C7F2,10731,3,6,3,33,47,1697
80188,80188,F599BD40004701EFC1748D458DE1C7F2,11461,15,16,1,37,49,1899
80189,80189,F599BD40004701EFC1748D458DE1C7F2,10221,18,19,1,34,49,1749
80190,80190,F599BD40004701EFC1748D458DE1C7F2,10151,22,23,1,34,47,1747
80197,80197,FF0C11254BA355CCA708C36EE5C4353D,11381,0,7,7,30,47,1547
80198,80198,FF0C11254BA355CCA708C36EE5C4353D,11261,7,14,7,36,46,1846
80199,80199,FF0C11254BA355CCA708C36EE5C4353D,11381,19,23,4,30,47,1547
80200,80200,138FF279D92615D61A668B43E45A706D,42221,0,7,7,38,48,1948
80201,80201,138FF279D92615D61A668B43E45A706D,43731,8,12,4,34,47,1747
80202,80202,138FF279D92615D61A668B43E45A706D,42221,13,15,2,38,48,1948
80203,80203,138FF279D92615D61A668B43E45A706D,13111,15,17,2,42,46,2146
80204,80204,138FF279D92615D61A668B43E45A706D,42221,18,23,5,38,48,1948
80205,80205,C89DD497B3E25F408D5F4E0FF457EA4C,42581,5,8,3,38,48,1948
80206,80206,C89DD497B3E25F408D5F4E0FF457EA4C,11914,8,10,2,37,48,1898
80207,80207,C89DD497B3E25F408D5F4E0FF457EA4C,42581,10,11,1,38,48,1948
80208,80208,C89DD497B3E25F408D5F4E0FF457EA4C,11914,11,12,1,37,48,1898
80209,80209,C89DD497B3E25F408D5F4E0FF457EA4C,42581,15,21,6,38,48,1948
80210,80210,7A880FE847C48EF3051E04A866E8ED9A,42971,1,15,14,43,49,2199
80211,80211,7A880FE847C48EF3051E04A866E8ED9A,13221,16,17,1,40,47,2047
80212,80212,7A880FE847C48EF3051E04A866E8ED9A,11551,21,22,1,39,49,1999
80213,80213,9DA4BB2C882A7F80C23A8CE3C669C4E5,12971,0,8,8,32,48,1648
80214,80214,9DA4BB2C882A7F80C23A8CE3C669C4E5,11741,11,13,2,42,49,2149
80215,80215,9DA4BB2C882A7F80C23A8CE3C669C4E5,11111,17,19,2,26,48,1348
80216,80216,9DA4BB2C882A7F80C23A8CE3C669C4E5,12971,21,23,2,32,48,1648
80217,80217,345D4029BCC33DBFE6D7841DB885E7B2,42491,0,4,4,32,46,1646
80218,80218,345D4029BCC33DBFE6D7841DB885E7B2,12131,5,6,1,32,47,1647
80219,80219,345D4029BCC33DBFE6D7841DB885E7B2,11741,9,11,2,42,49,2149
80220,80220,345D4029BCC33DBFE6D7841DB885E7B2,12083,15,16,1,36,49,1849
80221,80221,345D4029BCC33DBFE6D7841DB885E7B2,42491,19,23,4,32,46,1646
80238,80238,079D8B606B741550F5C3182CF58367EA,11061,0,11,11,29,48,1498
80239,80239,079D8B606B741550F5C3182CF58367EA,11271,14,16,2,37,48,1898
80240,80240,079D8B606B741550F5C3182CF58367EA,11061,17,19,2,29,48,1498
80241,80241,079D8B606B741550F5C3182CF58367EA,10107,20,21,1,38,49,1949
80242,80242,675E14475BB1E43D277D9A5E27CBF03A,19114,3,12,9,7,43,393
80243,80243,675E14475BB1E43D277D9A5E27CBF03A,42041,17,18,1,10,47,547
80244,80244,675E14475BB1E43D277D9A5E27CBF03A,19021,18,19,1,10,45,545
80255,80255,7691C829AB1912AD1A6AF5EBCE15167D,11111,0,15,15,26,48,1348
80256,80256,7691C829AB1912AD1A6AF5EBCE15167D,12514,19,21,2,38,47,1947
80257,80257,7691C829AB1912AD1A6AF5EBCE15167D,42281,22,23,1,40,48,2048
80268,80268,ECC55A41DE7DF4FF6A356DE1634B0C55,19264,0,14,14,10,36,536
80269,80269,ECC55A41DE7DF4FF6A356DE1634B0C55,43644,15,18,3,14,38,738
80270,80270,ECC55A41DE7DF4FF6A356DE1634B0C55,19264,20,23,3,10,36,536
80280,80280,EAEFCB977DEDF23C1346736B36A6F67B,13911,3,8,5,39,46,1996
80281,80281,EAEFCB977DEDF23C1346736B36A6F67B,42231,8,13,5,37,46,1896
80282,80282,EAEFCB977DEDF23C1346736B36A6F67B,13911,13,15,2,39,46,1996
80283,80283,EAEFCB977DEDF23C1346736B36A6F67B,11261,15,16,1,36,46,1846
80284,80284,EAEFCB977DEDF23C1346736B36A6F67B,10811,18,20,2,38,46,1946
80285,80285,EAEFCB977DEDF23C1346736B36A6F67B,42231,21,23,2,37,46,1896
80289,80289,29106623FF38C4E2789F6F7F15E27375,42551,0,8,8,14,48,748
80290,80290,29106623FF38C4E2789F6F7F15E27375,19114,10,13,3,7,43,393
80291,80291,29106623FF38C4E2789F6F7F15E27375,11061,13,15,2,29,48,1498
80292,80292,29106623FF38C4E2789F6F7F15E27375,42551,19,23,4,14,48,748
80296,80296,FD6F3D9CFB531FE01A1AEA9CDBE73454,13601,9,10,1,34,47,1747
80297,80297,FD6F3D9CFB531FE01A1AEA9CDBE73454,42231,14,15,1,37,46,1896
80298,80298,FD6F3D9CFB531FE01A1AEA9CDBE73454,42351,15,17,2,38,45,1945
80299,80299,FD6F3D9CFB531FE01A1AEA9CDBE73454,42231,20,21,1,37,46,1896
80300,80300,A0A00D4FFCF39B121347488247DF3626,12311,2,5,3,30,44,1544
80301,80301,A0A00D4FFCF39B121347488247DF3626,11875,6,14,8,30,46,1546
80302,80302,A0A00D4FFCF39B121347488247DF3626,13111,18,21,3,42,46,2146
80303,80303,F99A8100651870B148C78FDDEF8AD69E,42231,1,3,2,37,46,1896
80304,80304,F99A8100651870B148C78FDDEF8AD69E,42351,6,11,5,38,45,1945
80305,80305,F99A8100651870B148C78FDDEF8AD69E,13911,12,14,2,39,46,1996
80306,80306,F99A8100651870B148C78FDDEF8AD69E,42231,16,18,2,37,46,1896
80307,80307,F99A8100651870B148C78FDDEF8AD69E,42351,22,23,1,38,45,1945
80311,80311,89EC37A7B83D9B7D194154C37975BD9C,42521,0,4,4,31,47,1597
80312,80312,89EC37A7B83D9B7D194154C37975BD9C,43311,8,10,2,31,48,1598
80313,80313,89EC37A7B83D9B7D194154C37975BD9C,11061,11,12,1,29,48,1498
80314,80314,89EC37A7B83D9B7D194154C37975BD9C,43311,14,17,3,31,48,1598
80315,80315,89EC37A7B83D9B7D194154C37975BD9C,11061,20,21,1,29,48,1498
80316,80316,BA383EADBFC7399436EC9A36DFB1408F,10471,8,16,8,37,48,1898
80317,80317,BA383EADBFC7399436EC9A36DFB1408F,11061,17,19,2,29,48,1498
80318,80318,BA383EADBFC7399436EC9A36DFB1408F,40445,22,23,1,30,48,1548
80319,80319,F38AB0098BE65E711BE711E13E868DCB,13561,0,7,7,37,49,1899
80320,80320,F38AB0098BE65E711BE711E13E868DCB,13221,9,10,1,40,47,2047
80321,80321,F38AB0098BE65E711BE711E13E868DCB,13561,11,15,4,37,49,1899
80322,80322,F38AB0098BE65E711BE711E13E868DCB,11074,16,18,2,37,47,1897
80323,80323,FEF1B208BFBEDDE7B3E7A77BB07513A4,10924,0,6,6,43,49,2199
80324,80324,FEF1B208BFBEDDE7B3E7A77BB07513A4,10107,8,10,2,38,49,1949
80325,80325,FEF1B208BFBEDDE7B3E7A77BB07513A4,42091,11,15,4,43,46,2196
80326,80326,FEF1B208BFBEDDE7B3E7A77BB07513A4,42341,19,21,2,43,49,2199
80327,80327,B9A979B9AE84E31BBBDD76774181BD28,13771,0,8,8,21,45,1095
80328,80328,B9A979B9AE84E31BBBDD76774181BD28,12601,10,12,2,25,47,1297
80329,80329,B9A979B9AE84E31BBBDD76774181BD28,13771,13,18,5,21,45,1095
80330,80330,B9A979B9AE84E31BBBDD76774181BD28,40094,20,23,3,29,48,1498
80331,80331,D5A1F589AD5A8A456E0D23A90489837D,43761,0,7,7,32,47,1647
80332,80332,D5A1F589AD5A8A456E0D23A90489837D,11231,9,17,8,37,49,1899
80333,80333,D5A1F589AD5A8A456E0D23A90489837D,43761,19,23,4,32,47,1647
80334,80334,966EF37DD81DE2F009202B5BDDCFCE29,13911,0,2,2,39,46,1996
80335,80335,966EF37DD81DE2F009202B5BDDCFCE29,42351,3,5,2,38,45,1945
80336,80336,966EF37DD81DE2F009202B5BDDCFCE29,42231,6,10,4,37,46,1896
80337,80337,966EF37DD81DE2F009202B5BDDCFCE29,42351,10,12,2,38,45,1945
80338,80338,966EF37DD81DE2F009202B5BDDCFCE29,42231,14,20,6,37,46,1896
80339,80339,966EF37DD81DE2F009202B5BDDCFCE29,42351,20,23,3,38,45,1945
80340,80340,7BD16D9EF5C5077CE8F4CC83518C6287,42861,0,8,8,37,44,1894
80341,80341,7BD16D9EF5C5077CE8F4CC83518C6287,40341,10,13,3,23,49,1199
80342,80342,7BD16D9EF5C5077CE8F4CC83518C6287,13231,15,19,4,39,46,1996
80343,80343,7BD16D9EF5C5077CE8F4CC83518C6287,42861,20,23,3,37,44,1894
80350,80350,A33710B1F53807B293E564AA3801F46F,15281,0,6,6,25,3,1253
80351,80351,A33710B1F53807B293E564AA3801F46F,15331,8,9,1,38,24,1924
80352,80352,A33710B1F53807B293E564AA3801F46F,15281,21,23,2,25,3,1253
80356,80356,6F6BFA140B8F0D41AE13D3CFA2E32A87,19114,0,2,2,7,43,393
80357,80357,6F6BFA140B8F0D41AE13D3CFA2E32A87,12921,3,4,1,9,41,491
80358,80358,6F6BFA140B8F0D41AE13D3CFA2E32A87,19114,5,6,1,7,43,393
80359,80359,6F6BFA140B8F0D41AE13D3CFA2E32A87,10351,6,7,1,28,45,1445
80360,80360,6F6BFA140B8F0D41AE13D3CFA2E32A87,19114,11,23,12,7,43,393
80368,80368,DAFE070AC8164EB683B9455E05DD84E1,13101,1,7,6,40,47,2047
80369,80369,DAFE070AC8164EB683B9455E05DD84E1,13271,7,9,2,41,47,2097
80370,80370,DAFE070AC8164EB683B9455E05DD84E1,13101,11,13,2,40,47,2047
80371,80371,DAFE070AC8164EB683B9455E05DD84E1,42501,15,18,3,28,47,1447
80372,80372,DAFE070AC8164EB683B9455E05DD84E1,11481,21,23,2,41,48,2098
80379,80379,3C5BF8354C7B22C00BFA5438C070BC0F,13711,0,7,7,38,46,1946
80380,80380,3C5BF8354C7B22C00BFA5438C070BC0F,43241,7,11,4,36,46,1846
80381,80381,3C5BF8354C7B22C00BFA5438C070BC0F,13711,11,13,2,38,46,1946
80382,80382,3C5BF8354C7B22C00BFA5438C070BC0F,43241,13,17,4,36,46,1846
80383,80383,3C5BF8354C7B22C00BFA5438C070BC0F,13711,17,23,6,38,46,1946
80384,80384,B080ED838F3410C3979E5CE8BD74503A,19441,0,14,14,8,46,446
80385,80385,B080ED838F3410C3979E5CE8BD74503A,42151,16,17,1,35,45,1795
80386,80386,B080ED838F3410C3979E5CE8BD74503A,19114,21,23,2,7,43,393
80387,80387,17A6D2A092121A27FDCB1E978538D50A,13371,0,9,9,41,47,2097
80388,80388,17A6D2A092121A27FDCB1E978538D50A,11941,9,11,2,37,46,1896
80389,80389,17A6D2A092121A27FDCB1E978538D50A,13941,14,23,9,41,47,2097
80390,80390,9BB9C98E1AB8749E67A40911C866F183,10231,0,9,9,39,49,1999
80391,80391,9BB9C98E1AB8749E67A40911C866F183,12311,12,14,2,30,44,1544
80392,80392,9BB9C98E1AB8749E67A40911C866F183,12661,17,18,1,32,45,1645
80393,80393,9BB9C98E1AB8749E67A40911C866F183,12311,19,23,4,30,44,1544
80404,80404,47118B88DBE5B682DCB473A3B5BBB281,13821,0,13,13,49,45,2495
80405,80405,47118B88DBE5B682DCB473A3B5BBB281,13841,16,17,1,40,46,2046
80406,80406,47118B88DBE5B682DCB473A3B5BBB281,13821,19,23,4,49,45,2495
80407,80407,DC84219A18D205A834F01D7743EEEE79,42021,0,8,8,33,47,1697
80408,80408,DC84219A18D205A834F01D7743EEEE79,11231,9,10,1,37,49,1899
80409,80409,DC84219A18D205A834F01D7743EEEE79,42921,12,13,1,33,47,1697
80410,80410,DC84219A18D205A834F01D7743EEEE79,13941,14,22,8,41,47,2097
80422,80422,09F64A9A641B3F2B92615DE97B925264,10351,4,9,5,28,45,1445
80423,80423,09F64A9A641B3F2B92615DE97B925264,10634,11,14,3,27,45,1395
80424,80424,09F64A9A641B3F2B92615DE97B925264,10351,14,15,1,28,45,1445
80425,80425,09F64A9A641B3F2B92615DE97B925264,10634,16,19,3,27,45,1395
80426,80426,09F64A9A641B3F2B92615DE97B925264,10351,21,23,2,28,45,1445
80433,80433,08FDCDF9080273C1119027E8D5BFFABF,11491,0,14,14,36,47,1847
80434,80434,08FDCDF9080273C1119027E8D5BFFABF,42523,14,16,2,31,47,1597
80435,80435,08FDCDF9080273C1119027E8D5BFFABF,10971,16,17,1,35,47,1797
80436,80436,08FDCDF9080273C1119027E8D5BFFABF,11491,18,23,5,36,47,1847
80437,80437,EDBEDCDD3729803D79956D4495DD48D8,13231,1,5,4,39,46,1996
80438,80438,EDBEDCDD3729803D79956D4495DD48D8,42864,6,7,1,38,44,1944
80439,80439,EDBEDCDD3729803D79956D4495DD48D8,42861,12,17,5,37,44,1894
80440,80440,EDBEDCDD3729803D79956D4495DD48D8,11261,18,20,2,36,46,1846
80441,80441,EDBEDCDD3729803D79956D4495DD48D8,42351,21,22,1,38,45,1945
80442,80442,946768BFA72752D5660750415178C67F,10251,1,2,1,35,47,1797
80443,80443,946768BFA72752D5660750415178C67F,11131,3,4,1,33,48,1698
80444,80444,946768BFA72752D5660750415178C67F,10511,8,9,1,35,46,1796
80445,80445,946768BFA72752D5660750415178C67F,40611,13,14,1,35,47,1797
80446,80446,946768BFA72752D5660750415178C67F,10511,15,17,2,35,46,1796
80447,80447,946768BFA72752D5660750415178C67F,43731,21,23,2,34,47,1747
80448,80448,1EA8BF9574A34874DC898823F22BF44F,11151,0,4,4,30,48,1548
80449,80449,1EA8BF9574A34874DC898823F22BF44F,11061,4,6,2,29,48,1498
80450,80450,1EA8BF9574A34874DC898823F22BF44F,11151,6,8,2,30,48,1548
80451,80451,1EA8BF9574A34874DC898823F22BF44F,10634,9,10,1,27,45,1395
80452,80452,1EA8BF9574A34874DC898823F22BF44F,10351,11,13,2,28,45,1445
80453,80453,1EA8BF9574A34874DC898823F22BF44F,11061,13,19,6,29,48,1498
80454,80454,1EA8BF9574A34874DC898823F22BF44F,10381,20,23,3,31,49,1599
80455,80455,12915B7CE801D56C12C57B7092EB877D,42581,0,2,2,38,48,1948
80456,80456,12915B7CE801D56C12C57B7092EB877D,11914,5,6,1,37,48,1898
80457,80457,12915B7CE801D56C12C57B7092EB877D,42581,7,9,2,38,48,1948
80458,80458,12915B7CE801D56C12C57B7092EB877D,11914,11,12,1,37,48,1898
80459,80459,12915B7CE801D56C12C57B7092EB877D,42581,14,18,4,38,48,1948
80460,80460,12915B7CE801D56C12C57B7092EB877D,11914,20,22,2,37,48,1898
80461,80461,0E002027D741B8AED4EE58E469659344,12601,9,11,2,25,47,1297
80462,80462,0E002027D741B8AED4EE58E469659344,11381,12,14,2,30,47,1547
80463,80463,0E002027D741B8AED4EE58E469659344,12601,17,18,1,25,47,1297
80464,80464,0E002027D741B8AED4EE58E469659344,10501,20,23,3,22,46,1146
80465,80465,39179060954ADF536A44D5CDC3D7ADA4,10921,0,5,5,43,48,2198
80466,80466,39179060954ADF536A44D5CDC3D7ADA4,13911,5,15,10,39,46,1996
80467,80467,39179060954ADF536A44D5CDC3D7ADA4,11261,16,19,3,36,46,1846
80468,80468,39179060954ADF536A44D5CDC3D7ADA4,10921,21,23,2,43,48,2198
80472,80472,59C9891991D18AB42F5CA2A676EAFEE0,42501,0,2,2,28,47,1447
80473,80473,59C9891991D18AB42F5CA2A676EAFEE0,42541,3,7,4,25,47,1297
80474,80474,59C9891991D18AB42F5CA2A676EAFEE0,19441,9,16,7,8,46,446
80475,80475,59C9891991D18AB42F5CA2A676EAFEE0,42501,18,23,5,28,47,1447
80479,80479,CFB5B91AB0CD7543884ADBE535AD19D6,43021,0,6,6,16,43,843
80480,80480,CFB5B91AB0CD7543884ADBE535AD19D6,12641,6,16,10,10,43,543
80481,80481,CFB5B91AB0CD7543884ADBE535AD19D6,43021,19,21,2,16,43,843
80490,80490,58DF107986367FA88C1D627635A20D98,42521,2,5,3,31,47,1597
80491,80491,58DF107986367FA88C1D627635A20D98,42011,8,10,2,36,46,1846
80492,80492,58DF107986367FA88C1D627635A20D98,40073,12,14,2,37,48,1898
80493,80493,58DF107986367FA88C1D627635A20D98,10661,15,16,1,37,49,1899
80494,80494,58DF107986367FA88C1D627635A20D98,11861,20,22,2,32,47,1647
80495,80495,2AB1E00AE324EB01DB00242758B61F8A,11001,0,7,7,42,47,2147
80496,80496,2AB1E00AE324EB01DB00242758B61F8A,11021,11,12,1,36,49,1849
80497,80497,2AB1E00AE324EB01DB00242758B61F8A,11531,13,15,2,34,49,1749
80498,80498,2AB1E00AE324EB01DB00242758B61F8A,11271,18,20,2,37,48,1898
80499,80499,2AB1E00AE324EB01DB00242758B61F8A,11001,21,23,2,42,47,2147
80500,80500,C94109F455448027CE60D8FE61F82261,10451,2,4,2,25,48,1298
80501,80501,C94109F455448027CE60D8FE61F82261,42623,5,11,6,22,49,1149
80502,80502,C94109F455448027CE60D8FE61F82261,10951,13,16,3,29,48,1498
80503,80503,C94109F455448027CE60D8FE61F82261,10451,17,19,2,25,48,1298
80504,80504,C94109F455448027CE60D8FE61F82261,42623,21,23,2,22,49,1149
80505,80505,6DFBF28C4BB1FC2BFED5E053C4C14307,19441,0,6,6,8,46,446
80506,80506,6DFBF28C4BB1FC2BFED5E053C4C14307,43581,7,16,9,33,48,1698
80507,80507,6DFBF28C4BB1FC2BFED5E053C4C14307,19441,21,23,2,8,46,446
80508,80508,F975FA2F77D199F7EBCE95860CC19E04,15651,0,9,9,39,25,1975
80509,80509,F975FA2F77D199F7EBCE95860CC19E04,40341,12,16,4,23,49,1199
80510,80510,F975FA2F77D199F7EBCE95860CC19E04,15651,20,23,3,39,25,1975
80514,80514,E859A0BF6FB37F9B42DF06EC7EE8FF9D,42461,0,5,5,45,47,2297
80515,80515,E859A0BF6FB37F9B42DF06EC7EE8FF9D,42321,8,9,1,43,47,2197
80516,80516,E859A0BF6FB37F9B42DF06EC7EE8FF9D,42461,9,11,2,45,47,2297
80517,80517,E859A0BF6FB37F9B42DF06EC7EE8FF9D,42321,15,17,2,43,47,2197
80518,80518,E859A0BF6FB37F9B42DF06EC7EE8FF9D,40691,18,19,1,42,48,2148
80519,80519,E859A0BF6FB37F9B42DF06EC7EE8FF9D,42461,21,23,2,45,47,2297
80520,80520,D3B77B24DF5EC6CEA013C69B5AA71FE2,13911,0,12,12,39,46,1996
80521,80521,D3B77B24DF5EC6CEA013C69B5AA71FE2,42151,15,17,2,35,45,1795
80522,80522,D3B77B24DF5EC6CEA013C69B5AA71FE2,13911,20,23,3,39,46,1996
80526,80526,292AD485DA7AE4FB3CFCA1190DC036DF,42351,0,1,1,38,45,1945
80527,80527,292AD485DA7AE4FB3CFCA1190DC036DF,13911,1,5,4,39,46,1996
80528,80528,292AD485DA7AE4FB3CFCA1190DC036DF,42231,5,10,5,37,46,1896
80529,80529,292AD485DA7AE4FB3CFCA1190DC036DF,13911,11,13,2,39,46,1996
80530,80530,292AD485DA7AE4FB3CFCA1190DC036DF,42231,14,19,5,37,46,1896
80531,80531,292AD485DA7AE4FB3CFCA1190DC036DF,42351,20,21,1,38,45,1945
80532,80532,292AD485DA7AE4FB3CFCA1190DC036DF,13911,21,23,2,39,46,1996
80533,80533,2BB5E6319C361908A67DD8509286CF7C,19031,0,6,6,1,42,92
80534,80534,2BB5E6319C361908A67DD8509286CF7C,12641,7,11,4,10,43,543
80535,80535,2BB5E6319C361908A67DD8509286CF7C,19031,12,15,3,1,42,92
80536,80536,2BB5E6319C361908A67DD8509286CF7C,12641,15,17,2,10,43,543
80537,80537,2BB5E6319C361908A67DD8509286CF7C,19031,18,23,5,1,42,92
80542,80542,E16566CAC1D2263C830A92E3D7A4B3A9,42351,0,4,4,38,45,1945
80543,80543,E16566CAC1D2263C830A92E3D7A4B3A9,42231,7,9,2,37,46,1896
80544,80544,E16566CAC1D2263C830A92E3D7A4B3A9,13911,10,11,1,39,46,1996
80545,80545,E16566CAC1D2263C830A92E3D7A4B3A9,42351,14,18,4,38,45,1945
80546,80546,E16566CAC1D2263C830A92E3D7A4B3A9,42231,18,20,2,37,46,1896
80547,80547,E16566CAC1D2263C830A92E3D7A4B3A9,42351,22,23,1,38,45,1945
80561,80561,AAC6347FC04E27D4907410C8A855C3EF,10841,0,8,8,37,47,1897
80562,80562,AAC6347FC04E27D4907410C8A855C3EF,40302,12,17,5,40,49,2049
80563,80563,AAC6347FC04E27D4907410C8A855C3EF,10716,19,21,2,30,46,1546
80564,80564,98029F333AC5519D4BA1B7A7F8079304,41721,0,8,8,39,48,1998
80565,80565,98029F333AC5519D4BA1B7A7F8079304,40733,9,11,2,32,48,1648
80566,80566,98029F333AC5519D4BA1B7A7F8079304,11771,12,15,3,39,49,1999
80567,80567,98029F333AC5519D4BA1B7A7F8079304,12971,15,17,2,32,48,1648
80568,80568,98029F333AC5519D4BA1B7A7F8079304,10971,18,20,2,35,47,1797
80569,80569,98029F333AC5519D4BA1B7A7F8079304,43361,21,23,2,38,48,1948
80570,80570,19A29A27E6506D34C07A04E6E9F52A03,12491,0,7,7,36,43,1843
80571,80571,19A29A27E6506D34C07A04E6E9F52A03,42151,8,9,1,35,45,1795
80572,80572,19A29A27E6506D34C07A04E6E9F52A03,12491,13,14,1,36,43,1843
80573,80573,19A29A27E6506D34C07A04E6E9F52A03,42151,15,16,1,35,45,1795
80574,80574,19A29A27E6506D34C07A04E6E9F52A03,12491,17,22,5,36,43,1843
80579,80579,87563B55F2C858B1A30D9ECB8EED9C7F,11291,0,6,6,40,49,2049
80580,80580,87563B55F2C858B1A30D9ECB8EED9C7F,42961,7,17,10,35,49,1799
80581,80581,87563B55F2C858B1A30D9ECB8EED9C7F,11291,22,23,1,40,49,2049
80586,80586,30235638FB9CE1C6C1AC72496820ADFE,10681,4,10,6,30,48,1548
80587,80587,30235638FB9CE1C6C1AC72496820ADFE,19744,13,14,1,6,43,343
80588,80588,30235638FB9CE1C6C1AC72496820ADFE,19741,15,20,5,5,44,294
80598,80598,71AB304A084EB4095E1F705C48CB0E23,11901,0,7,7,42,49,2149
80599,80599,71AB304A084EB4095E1F705C48CB0E23,11914,8,16,8,37,48,1898
80600,80600,71AB304A084EB4095E1F705C48CB0E23,11901,19,23,4,42,49,2149
80607,80607,D39EC0F218F0EB31F4548F618B00F1FB,10381,9,11,2,31,49,1599
80608,80608,D39EC0F218F0EB31F4548F618B00F1FB,42261,13,14,1,25,49,1299
80609,80609,D39EC0F218F0EB31F4548F618B00F1FB,10381,16,18,2,31,49,1599
80613,80613,AA51DE94270AE4663B2578A38D4EECC9,13961,0,7,7,42,48,2148
80614,80614,AA51DE94270AE4663B2578A38D4EECC9,11914,9,10,1,37,48,1898
80615,80615,AA51DE94270AE4663B2578A38D4EECC9,13961,12,23,11,42,48,2148
80625,80625,4CA7727345FE5410FF8669E86CE37E32,12641,1,2,1,10,43,543
80626,80626,4CA7727345FE5410FF8669E86CE37E32,19031,3,6,3,1,42,92
80627,80627,4CA7727345FE5410FF8669E86CE37E32,12641,7,14,7,10,43,543
80628,80628,4CA7727345FE5410FF8669E86CE37E32,19024,17,19,2,9,45,495
80635,80635,2D7ACF8AD7E4B49F2A7FD23DB75DC6F1,42971,0,6,6,43,49,2199
80636,80636,2D7ACF8AD7E4B49F2A7FD23DB75DC6F1,13741,9,11,2,37,49,1899
80637,80637,2D7ACF8AD7E4B49F2A7FD23DB75DC6F1,42971,13,23,10,43,49,2199
80638,80638,E752BE8C76D89879B74771E0026F6236,42091,0,1,1,43,46,2196
80639,80639,E752BE8C76D89879B74771E0026F6236,42461,1,3,2,45,47,2297
80640,80640,E752BE8C76D89879B74771E0026F6236,42091,7,8,1,43,46,2196
80641,80641,E752BE8C76D89879B74771E0026F6236,42111,10,12,2,44,46,2246
80642,80642,E752BE8C76D89879B74771E0026F6236,42204,12,13,1,43,46,2196
80643,80643,E752BE8C76D89879B74771E0026F6236,42111,16,19,3,44,46,2246
80644,80644,E752BE8C76D89879B74771E0026F6236,42091,21,23,2,43,46,2196
80654,80654,30C840E59D52F56DCBAA00DFCF462EC0,11061,8,11,3,29,48,1498
80655,80655,30C840E59D52F56DCBAA00DFCF462EC0,19744,13,14,1,6,43,343
80656,80656,30C840E59D52F56DCBAA00DFCF462EC0,19621,18,23,5,5,46,296
80657,80657,D4C0B14A8C5AFDF18EDBA8F997AA9ED9,15061,0,4,4,41,25,2075
80658,80658,D4C0B14A8C5AFDF18EDBA8F997AA9ED9,12881,5,10,5,47,22,2372
80659,80659,D4C0B14A8C5AFDF18EDBA8F997AA9ED9,15061,10,12,2,41,25,2075
80660,80660,D4C0B14A8C5AFDF18EDBA8F997AA9ED9,12881,13,15,2,47,22,2372
80661,80661,D4C0B14A8C5AFDF18EDBA8F997AA9ED9,15061,19,23,4,41,25,2075
80662,80662,5601C1A44CC85C7B09354B38FD0628D1,12311,0,14,14,30,44,1544
80663,80663,5601C1A44CC85C7B09354B38FD0628D1,13731,16,18,2,33,49,1699
80664,80664,5601C1A44CC85C7B09354B38FD0628D1,12311,19,23,4,30,44,1544
80682,80682,69F41107244EDDE97DD1AAB2D554177A,19281,0,7,7,16,32,832
80683,80683,69F41107244EDDE97DD1AAB2D554177A,12874,9,10,1,20,34,1034
80684,80684,69F41107244EDDE97DD1AAB2D554177A,19281,13,23,10,16,32,832
80685,80685,ECBC886277109C0582E65AB313F27C1C,13314,0,7,7,31,39,1589
80686,80686,ECBC886277109C0582E65AB313F27C1C,12521,10,19,9,35,41,1791
80687,80687,ECBC886277109C0582E65AB313F27C1C,13314,19,23,4,31,39,1589
80688,80688,2D408F32CC4CD45CDF430A23DE2FCE4B,43391,0,6,6,29,48,1498
80689,80689,2D408F32CC4CD45CDF430A23DE2FCE4B,42541,9,10,1,25,47,1297
80690,80690,2D408F32CC4CD45CDF430A23DE2FCE4B,12381,12,13,1,32,48,1648
80691,80691,2D408F32CC4CD45CDF430A23DE2FCE4B,43391,13,20,7,29,48,1498
80692,80692,2D408F32CC4CD45CDF430A23DE2FCE4B,11151,21,23,2,30,48,1548
80693,80693,3457AFD1000C37A689F1A73ADB9321A9,12521,0,8,8,35,41,1791
80694,80694,3457AFD1000C37A689F1A73ADB9321A9,13041,8,9,1,30,37,1537
80695,80695,3457AFD1000C37A689F1A73ADB9321A9,12521,10,22,12,35,41,1791
80696,80696,770F568809FC0D1A34238F0D2CC0B790,15261,0,2,2,39,13,1963
80697,80697,770F568809FC0D1A34238F0D2CC0B790,15341,2,7,5,34,14,1714
80698,80698,770F568809FC0D1A34238F0D2CC0B790,42161,12,19,7,36,47,1847
80699,80699,770F568809FC0D1A34238F0D2CC0B790,43151,20,21,1,40,49,2049
80700,80700,90BCA1E699A4AF00C99EE1911F838B0C,10231,1,12,11,39,49,1999
80701,80701,90BCA1E699A4AF00C99EE1911F838B0C,42231,14,17,3,37,46,1896
80702,80702,90BCA1E699A4AF00C99EE1911F838B0C,10231,18,23,5,39,49,1999
80703,80703,AD3E6481838BF400FA98C1C2BDCD8C19,11641,0,7,7,22,49,1149
80704,80704,AD3E6481838BF400FA98C1C2BDCD8C19,10451,9,10,1,25,48,1298
80705,80705,AD3E6481838BF400FA98C1C2BDCD8C19,11381,14,16,2,30,47,1547
80706,80706,AD3E6481838BF400FA98C1C2BDCD8C19,11641,20,21,1,22,49,1149
80707,80707,03CA57D5FC79FD2D96E283F89DF4F307,42523,1,2,1,31,47,1597
80708,80708,03CA57D5FC79FD2D96E283F89DF4F307,19571,7,8,1,1,36,86
80709,80709,03CA57D5FC79FD2D96E283F89DF4F307,19811,12,14,2,10,34,534
80710,80710,03CA57D5FC79FD2D96E283F89DF4F307,10681,21,22,1,30,48,1548
80711,80711,64BD805F6D9361B926D90DA2610BBB4F,19031,1,2,1,1,42,92
80712,80712,64BD805F6D9361B926D90DA2610BBB4F,49201,4,18,14,7,41,391
80713,80713,64BD805F6D9361B926D90DA2610BBB4F,19114,19,20,1,7,43,393
80714,80714,BF9E834ADBD45ACFC7CBA43EC76B674D,10971,0,8,8,35,47,1797
80715,80715,BF9E834ADBD45ACFC7CBA43EC76B674D,13911,20,21,1,39,46,1996
80716,80716,BF9E834ADBD45ACFC7CBA43EC76B674D,10971,21,23,2,35,47,1797
80717,80717,5767E0EE50B7CB3B0CFBFCA7463471BC,11806,0,6,6,41,48,2098
80718,80718,5767E0EE50B7CB3B0CFBFCA7463471BC,10221,7,18,11,34,49,1749
80719,80719,5767E0EE50B7CB3B0CFBFCA7463471BC,11806,19,23,4,41,48,2098
80726,80726,50AD8ACDABF8BBC007C0D64420D91B51,11861,0,7,7,32,47,1647
80727,80727,50AD8ACDABF8BBC007C0D64420D91B51,12381,9,12,3,32,48,1648
80728,80728,50AD8ACDABF8BBC007C0D64420D91B51,11861,12,16,4,32,47,1647
80729,80729,50AD8ACDABF8BBC007C0D64420D91B51,12381,16,17,1,32,48,1648
80730,80730,50AD8ACDABF8BBC007C0D64420D91B51,11861,19,23,4,32,47,1647
80731,80731,62DDFD12FD80957CA0268CDDC1A48DA2,11061,2,3,1,29,48,1498
80732,80732,62DDFD12FD80957CA0268CDDC1A48DA2,11151,6,11,5,30,48,1548
80733,80733,62DDFD12FD80957CA0268CDDC1A48DA2,43391,12,16,4,29,48,1498
80734,80734,62DDFD12FD80957CA0268CDDC1A48DA2,11151,16,17,1,30,48,1548
80735,80735,62DDFD12FD80957CA0268CDDC1A48DA2,11061,18,20,2,29,48,1498
80736,80736,62DDFD12FD80957CA0268CDDC1A48DA2,11151,20,22,2,30,48,1548
80737,80737,A937BD42DF3D9D7237FA71511D7398B8,43581,0,8,8,33,48,1698
80738,80738,A937BD42DF3D9D7237FA71511D7398B8,11231,8,12,4,37,49,1899
80739,80739,A937BD42DF3D9D7237FA71511D7398B8,43581,12,14,2,33,48,1698
80740,80740,A937BD42DF3D9D7237FA71511D7398B8,12083,15,17,2,36,49,1849
80741,80741,A937BD42DF3D9D7237FA71511D7398B8,11201,18,20,2,35,49,1799
80742,80742,A937BD42DF3D9D7237FA71511D7398B8,43581,21,23,2,33,48,1698
80743,80743,25F1B1F901DD17A5CCAEC6EC47760B2D,11211,0,6,6,34,49,1749
80744,80744,25F1B1F901DD17A5CCAEC6EC47760B2D,13561,6,9,3,37,49,1899
80745,80745,25F1B1F901DD17A5CCAEC6EC47760B2D,10401,11,12,1,33,49,1699
80746,80746,25F1B1F901DD17A5CCAEC6EC47760B2D,13561,15,16,1,37,49,1899
80747,80747,25F1B1F901DD17A5CCAEC6EC47760B2D,11541,19,20,1,35,49,1799
80748,80748,0E44B8203565C08C4FE28AB9B72AEA81,40637,0,6,6,36,47,1847
80749,80749,0E44B8203565C08C4FE28AB9B72AEA81,11351,9,10,1,36,48,1848
80750,80750,0E44B8203565C08C4FE28AB9B72AEA81,11231,11,12,1,37,49,1899
80751,80751,0E44B8203565C08C4FE28AB9B72AEA81,11351,15,18,3,36,48,1848
80752,80752,0E44B8203565C08C4FE28AB9B72AEA81,43731,19,21,2,34,47,1747
80753,80753,AFB83B245E30F3051A42272B92833F59,10431,9,10,1,33,49,1699
80754,80754,AFB83B245E30F3051A42272B92833F59,10781,12,17,5,35,47,1797
80755,80755,AFB83B245E30F3051A42272B92833F59,42511,19,20,1,37,47,1897
80756,80756,AFB83B245E30F3051A42272B92833F59,10191,20,23,3,40,48,2048
80757,80757,079871E9AF6039695E64910046159E20,42921,9,15,6,33,47,1697
80758,80758,079871E9AF6039695E64910046159E20,11521,19,20,1,41,48,2098
80759,80759,079871E9AF6039695E64910046159E20,10731,21,22,1,33,47,1697
80763,80763,B51991AF4ACE325C0342855E568A0491,12051,0,4,4,20,47,1047
80764,80764,B51991AF4ACE325C0342855E568A0491,43751,8,13,5,19,48,998
80765,80765,B51991AF4ACE325C0342855E568A0491,12581,17,19,2,24,48,1248
80769,80769,6B614428F8D95ECFDE2207017437E97D,19281,0,7,7,16,32,832
80770,80770,6B614428F8D95ECFDE2207017437E97D,12871,9,12,3,22,33,1133
80771,80771,6B614428F8D95ECFDE2207017437E97D,19281,12,14,2,16,32,832
80772,80772,6B614428F8D95ECFDE2207017437E97D,13481,15,17,2,26,31,1331
80773,80773,6B614428F8D95ECFDE2207017437E97D,12871,18,19,1,22,33,1133
80774,80774,6B614428F8D95ECFDE2207017437E97D,19281,20,23,3,16,32,832
80775,80775,7861278735CDA91B9BABB196FBF7605C,43951,1,5,4,49,41,2491
80776,80776,7861278735CDA91B9BABB196FBF7605C,13951,12,17,5,47,45,2395
80777,80777,7861278735CDA91B9BABB196FBF7605C,43951,18,21,3,49,41,2491
80778,80778,09E35A3086ED2C100882D697DC471A83,42231,0,9,9,37,46,1896
80779,80779,09E35A3086ED2C100882D697DC471A83,11861,12,14,2,32,47,1647
80780,80780,09E35A3086ED2C100882D697DC471A83,11231,17,18,1,37,49,1899
80781,80781,09E35A3086ED2C100882D697DC471A83,42231,20,22,2,37,46,1896
80788,80788,FFB3479DBC5892BFCD0F3230DF4E38AA,11061,5,10,5,29,48,1498
80789,80789,FFB3479DBC5892BFCD0F3230DF4E38AA,19744,13,15,2,6,43,343
80790,80790,FFB3479DBC5892BFCD0F3230DF4E38AA,19741,16,23,7,5,44,294
80794,80794,15AF53FBA0C13FBD61024895398ED2FD,19441,0,1,1,8,46,446
80795,80795,15AF53FBA0C13FBD61024895398ED2FD,11471,3,4,1,12,48,648
80796,80796,15AF53FBA0C13FBD61024895398ED2FD,42041,4,6,2,10,47,547
80797,80797,15AF53FBA0C13FBD61024895398ED2FD,19441,13,15,2,8,46,446
80798,80798,15AF53FBA0C13FBD61024895398ED2FD,42041,15,16,1,10,47,547
80799,80799,15AF53FBA0C13FBD61024895398ED2FD,19441,19,22,3,8,46,446
80800,80800,BA5B86AF2CFEF031053067483BA2F996,15651,0,10,10,39,25,1975
80801,80801,BA5B86AF2CFEF031053067483BA2F996,40341,12,16,4,23,49,1199
80802,80802,BA5B86AF2CFEF031053067483BA2F996,15651,19,23,4,39,25,1975
80803,80803,A7889E15E0F93853EAB5CF324793B9C0,15411,0,3,3,44,27,2227
80804,80804,A7889E15E0F93853EAB5CF324793B9C0,12611,4,9,5,41,29,2079
80805,80805,A7889E15E0F93853EAB5CF324793B9C0,15411,11,16,5,44,27,2227
80806,80806,A7889E15E0F93853EAB5CF324793B9C0,12611,17,18,1,41,29,2079
80807,80807,A7889E15E0F93853EAB5CF324793B9C0,15411,21,23,2,44,27,2227
80808,80808,DC15358175A492C6F21AAEFAD4CD0BB7,10111,0,14,14,37,47,1897
80809,80809,DC15358175A492C6F21AAEFAD4CD0BB7,11061,15,16,1,29,48,1498
80810,80810,DC15358175A492C6F21AAEFAD4CD0BB7,42401,17,23,6,36,47,1847
80823,80823,AA9DDBAE747C0C61A76E689DD898E315,42301,0,7,7,36,47,1847
80824,80824,AA9DDBAE747C0C61A76E689DD898E315,42871,7,18,11,30,45,1545
80825,80825,AA9DDBAE747C0C61A76E689DD898E315,42301,18,23,5,36,47,1847
80826,80826,34C2C19E72E3A8BD954F8F220235C379,10211,0,8,8,16,49,849
80827,80827,34C2C19E72E3A8BD954F8F220235C379,11061,12,14,2,29,48,1498
80828,80828,34C2C19E72E3A8BD954F8F220235C379,12581,14,16,2,24,48,1248
80829,80829,34C2C19E72E3A8BD954F8F220235C379,11751,19,20,1,35,48,1798
80830,80830,34C2C19E72E3A8BD954F8F220235C379,11111,21,23,2,26,48,1348
80838,80838,AE10E091EA2027CDBE5CBFBC2238F486,19244,0,5,5,1,43,93
80839,80839,AE10E091EA2027CDBE5CBFBC2238F486,12921,6,18,12,9,41,491
80840,80840,AE10E091EA2027CDBE5CBFBC2238F486,19114,20,21,1,7,43,393
80841,80841,7446641F73809A823733CBB6864B4050,42861,0,8,8,37,44,1894
80842,80842,7446641F73809A823733CBB6864B4050,11261,9,10,1,36,46,1846
80843,80843,7446641F73809A823733CBB6864B4050,42861,12,13,1,37,44,1894
80844,80844,7446641F73809A823733CBB6864B4050,11261,13,15,2,36,46,1846
80845,80845,7446641F73809A823733CBB6864B4050,42861,17,18,1,37,44,1894
80846,80846,0F784CBCB73AEA2648D885974B30C4FB,42371,0,7,7,34,46,1746
80847,80847,0F784CBCB73AEA2648D885974B30C4FB,12601,9,11,2,25,47,1297
80848,80848,0F784CBCB73AEA2648D885974B30C4FB,42371,12,18,6,34,46,1746
80849,80849,0F784CBCB73AEA2648D885974B30C4FB,11921,19,21,2,38,48,1948
80868,80868,F3F669BF3F25EDDF3578796A649F045C,12971,0,7,7,32,48,1648
80869,80869,F3F669BF3F25EDDF3578796A649F045C,10221,7,9,2,34,49,1749
80870,80870,F3F669BF3F25EDDF3578796A649F045C,43671,11,19,8,35,48,1798
80871,80871,F3F669BF3F25EDDF3578796A649F045C,13771,19,21,2,21,45,1095
80872,80872,0385C28017F72DE7651B108C3631DDE9,11061,5,11,6,29,48,1498
80873,80873,0385C28017F72DE7651B108C3631DDE9,19744,13,14,1,6,43,343
80874,80874,0385C28017F72DE7651B108C3631DDE9,19741,15,23,8,5,44,294
80883,80883,F94E5CCB50337D3F418291F67EA7B8C3,42071,7,9,2,31,49,1599
80884,80884,F94E5CCB50337D3F418291F67EA7B8C3,42261,9,14,5,25,49,1299
80885,80885,F94E5CCB50337D3F418291F67EA7B8C3,42071,15,20,5,31,49,1599
80894,80894,1A71FA18AA428C4DDAD1FCB8BD6DCCEA,42281,0,5,5,40,48,2048
80895,80895,1A71FA18AA428C4DDAD1FCB8BD6DCCEA,11211,7,9,2,34,49,1749
80896,80896,1A71FA18AA428C4DDAD1FCB8BD6DCCEA,10401,11,15,4,33,49,1699
80897,80897,1A71FA18AA428C4DDAD1FCB8BD6DCCEA,10971,19,20,1,35,47,1797
80898,80898,1A71FA18AA428C4DDAD1FCB8BD6DCCEA,11271,22,23,1,37,48,1898
80899,80899,027C3A3C09B88FB3AEF492C3DD4629B7,13671,0,7,7,27,43,1393
80900,80900,027C3A3C09B88FB3AEF492C3DD4629B7,42531,7,8,1,31,45,1595
80901,80901,027C3A3C09B88FB3AEF492C3DD4629B7,12311,13,17,4,30,44,1544
80902,80902,027C3A3C09B88FB3AEF492C3DD4629B7,42531,19,20,1,31,45,1595
80903,80903,2FE05B04A8F74E0841B2C5D8901D73C1,11753,2,13,11,35,48,1798
80904,80904,2FE05B04A8F74E0841B2C5D8901D73C1,42531,17,20,3,31,45,1595
80905,80905,2FE05B04A8F74E0841B2C5D8901D73C1,11151,21,23,2,30,48,1548
80906,80906,7779D5C4E5073D864A9050EB76A5AC64,43341,1,7,6,41,46,2096
80907,80907,7779D5C4E5073D864A9050EB76A5AC64,11261,9,10,1,36,46,1846
80908,80908,7779D5C4E5073D864A9050EB76A5AC64,12521,11,13,2,35,41,1791
80909,80909,7779D5C4E5073D864A9050EB76A5AC64,11261,13,23,10,36,46,1846
80910,80910,1B9C773F750DA44F51C2F1FB8BF9543C,42301,0,6,6,36,47,1847
80911,80911,1B9C773F750DA44F51C2F1FB8BF9543C,13314,9,10,1,31,39,1589
80912,80912,1B9C773F750DA44F51C2F1FB8BF9543C,13671,12,16,4,27,43,1393
80913,80913,1B9C773F750DA44F51C2F1FB8BF9543C,42301,20,23,3,36,47,1847
80914,80914,4728D5A73A2EFDE289935E01180F11D6,43761,7,9,2,32,47,1647
80915,80915,4728D5A73A2EFDE289935E01180F11D6,42523,11,13,2,31,47,1597
80916,80916,4728D5A73A2EFDE289935E01180F11D6,42801,15,16,1,40,49,2049
80917,80917,4728D5A73A2EFDE289935E01180F11D6,10041,17,20,3,39,49,1999
80918,80918,641C859EE2F1D414BC3BD88280CA45F9,11861,0,13,13,32,47,1647
80919,80919,641C859EE2F1D414BC3BD88280CA45F9,10471,14,17,3,37,48,1898
80920,80920,641C859EE2F1D414BC3BD88280CA45F9,11861,18,23,5,32,47,1647
80925,80925,F1E70F2375C6C4024530AF795D70170C,13511,0,11,11,34,48,1748
80926,80926,F1E70F2375C6C4024530AF795D70170C,42531,16,20,4,31,45,1595
80927,80927,F1E70F2375C6C4024530AF795D70170C,11151,21,23,2,30,48,1548
80932,80932,CEEEE12D961020D889C4958F8C670187,42861,2,3,1,37,44,1894
80933,80933,CEEEE12D961020D889C4958F8C670187,42151,5,6,1,35,45,1795
80934,80934,CEEEE12D961020D889C4958F8C670187,42861,6,15,9,37,44,1894
80935,80935,CEEEE12D961020D889C4958F8C670187,43341,20,22,2,41,46,2096
80940,80940,CEA501FA7BDE5D84B551C94F16C00DA1,11591,0,7,7,36,49,1849
80941,80941,CEA501FA7BDE5D84B551C94F16C00DA1,13791,8,18,10,42,47,2147
80942,80942,CEA501FA7BDE5D84B551C94F16C00DA1,11751,19,23,4,35,48,1798
80943,80943,51E79D88F03D2AA1A256DD1FA70D766A,40833,1,6,5,41,47,2097
80944,80944,51E79D88F03D2AA1A256DD1FA70D766A,13101,8,9,1,40,47,2047
80945,80945,51E79D88F03D2AA1A256DD1FA70D766A,11481,9,12,3,41,48,2098
80946,80946,51E79D88F03D2AA1A256DD1FA70D766A,11291,13,15,2,40,49,2049
80947,80947,51E79D88F03D2AA1A256DD1FA70D766A,13101,17,18,1,40,47,2047
80948,80948,51E79D88F03D2AA1A256DD1FA70D766A,40833,22,23,1,41,47,2097
80956,80956,11FECEE7865049CDA55CAB34FACD3089,42871,1,7,6,30,45,1545
80957,80957,11FECEE7865049CDA55CAB34FACD3089,11061,8,10,2,29,48,1498
80958,80958,11FECEE7865049CDA55CAB34FACD3089,11871,10,16,6,29,46,1496
80959,80959,11FECEE7865049CDA55CAB34FACD3089,11211,17,18,1,34,49,1749
80960,80960,11FECEE7865049CDA55CAB34FACD3089,11871,19,23,4,29,46,1496
80961,80961,C6CE1BC9B69267948B78869F2B1A69E1,10731,0,8,8,33,47,1697
80962,80962,C6CE1BC9B69267948B78869F2B1A69E1,42341,10,12,2,43,49,2199
80963,80963,C6CE1BC9B69267948B78869F2B1A69E1,10731,13,14,1,33,47,1697
80964,80964,C6CE1BC9B69267948B78869F2B1A69E1,10924,18,21,3,43,49,2199
80968,80968,BA6468A84C81B4949B332F392AF7BE2D,40833,2,5,3,41,47,2097
80969,80969,BA6468A84C81B4949B332F392AF7BE2D,13101,6,7,1,40,47,2047
80970,80970,BA6468A84C81B4949B332F392AF7BE2D,40833,8,9,1,41,47,2097
80971,80971,BA6468A84C81B4949B332F392AF7BE2D,13101,17,18,1,40,47,2047
80972,80972,BA6468A84C81B4949B332F392AF7BE2D,11806,20,21,1,41,48,2098
80973,80973,BA6468A84C81B4949B332F392AF7BE2D,13101,22,23,1,40,47,2047
80998,80998,024AB2D90319DF57F94996854D076E3D,13271,0,8,8,41,47,2097
80999,80999,024AB2D90319DF57F94996854D076E3D,11531,10,16,6,34,49,1749
81000,81000,024AB2D90319DF57F94996854D076E3D,13271,18,23,5,41,47,2097
81001,81001,B5DB8394AD4BE868B7460D5CD9F228A6,15651,0,9,9,39,25,1975
81002,81002,B5DB8394AD4BE868B7460D5CD9F228A6,40341,12,16,4,23,49,1199
81003,81003,B5DB8394AD4BE868B7460D5CD9F228A6,15651,19,23,4,39,25,1975
81004,81004,164E1CF906F1BF9B01D278DF700B93F7,10544,0,13,13,28,48,1448
81005,81005,164E1CF906F1BF9B01D278DF700B93F7,11201,15,16,1,35,49,1799
81006,81006,164E1CF906F1BF9B01D278DF700B93F7,10901,16,19,3,35,48,1798
81007,81007,746607B162E7EB25AA57FCC2A7B9163E,11861,0,8,8,32,47,1647
81008,81008,746607B162E7EB25AA57FCC2A7B9163E,11301,12,13,1,41,49,2099
81009,81009,746607B162E7EB25AA57FCC2A7B9163E,12391,14,16,2,36,49,1849
81010,81010,746607B162E7EB25AA57FCC2A7B9163E,11861,19,23,4,32,47,1647
81030,81030,D523B4CC9C9CF3421E66C004792D242D,11381,10,12,2,30,47,1547
81031,81031,D523B4CC9C9CF3421E66C004792D242D,13841,12,14,2,40,46,2046
81032,81032,D523B4CC9C9CF3421E66C004792D242D,11781,22,23,1,38,49,1949
81033,81033,E43A1713BA9589398F5DEA7CD1BD08F1,42204,0,7,7,43,46,2196
81034,81034,E43A1713BA9589398F5DEA7CD1BD08F1,11011,8,16,8,39,49,1999
81035,81035,E43A1713BA9589398F5DEA7CD1BD08F1,11751,18,20,2,35,48,1798
81036,81036,E43A1713BA9589398F5DEA7CD1BD08F1,42204,21,23,2,43,46,2196
81037,81037,C70FF977FA3BD2286D57535D98EFE336,10111,0,8,8,37,47,1897
81038,81038,C70FF977FA3BD2286D57535D98EFE336,10231,9,11,2,39,49,1999
81039,81039,C70FF977FA3BD2286D57535D98EFE336,10111,13,16,3,37,47,1897
81040,81040,C70FF977FA3BD2286D57535D98EFE336,42161,17,19,2,36,47,1847
81041,81041,C70FF977FA3BD2286D57535D98EFE336,10111,19,23,4,37,47,1897
81053,81053,81A0A832750D87F13BE469519DF7D944,12311,0,2,2,30,44,1544
81054,81054,81A0A832750D87F13BE469519DF7D944,42151,4,5,1,35,45,1795
81055,81055,81A0A832750D87F13BE469519DF7D944,12311,5,23,18,30,44,1544
81065,81065,EA84EDCB7C9475F6273168934FDD6476,19441,0,9,9,8,46,446
81066,81066,EA84EDCB7C9475F6273168934FDD6476,42041,9,10,1,10,47,547
81067,81067,EA84EDCB7C9475F6273168934FDD6476,19441,14,15,1,8,46,446
81068,81068,EA84EDCB7C9475F6273168934FDD6476,11571,18,19,1,13,46,696
81069,81069,EA84EDCB7C9475F6273168934FDD6476,19441,20,22,2,8,46,446
81070,81070,C79E0ABB02DE1A9FB5B4E2D7657A2B28,43061,4,6,2,43,46,2196
81071,81071,C79E0ABB02DE1A9FB5B4E2D7657A2B28,11861,11,13,2,32,47,1647
81072,81072,C79E0ABB02DE1A9FB5B4E2D7657A2B28,42921,13,20,7,33,47,1697
81079,81079,92E1BAA88B052422B820ED36A9E8F107,41392,0,6,6,43,48,2198
81080,81080,92E1BAA88B052422B820ED36A9E8F107,11271,7,8,1,37,48,1898
81081,81081,92E1BAA88B052422B820ED36A9E8F107,41392,11,13,2,43,48,2198
81082,81082,92E1BAA88B052422B820ED36A9E8F107,10471,14,15,1,37,48,1898
81083,81083,92E1BAA88B052422B820ED36A9E8F107,11701,20,23,3,43,48,2198
81084,81084,8A0FE8743DF9AE08FEBD9B6E7DEB27AA,13671,2,5,3,27,43,1393
81085,81085,8A0FE8743DF9AE08FEBD9B6E7DEB27AA,10631,8,17,9,28,46,1446
81086,81086,8A0FE8743DF9AE08FEBD9B6E7DEB27AA,11001,19,23,4,42,47,2147
81090,81090,2C8D86692AE365367C699CBAAA0C190E,12792,0,6,6,34,30,1730
81091,81091,2C8D86692AE365367C699CBAAA0C190E,15411,7,11,4,44,27,2227
81092,81092,2C8D86692AE365367C699CBAAA0C190E,12151,12,14,2,41,33,2083
81093,81093,2C8D86692AE365367C699CBAAA0C190E,15411,14,18,4,44,27,2227
81094,81094,2C8D86692AE365367C699CBAAA0C190E,12792,19,21,2,34,30,1730
81095,81095,2C8D86692AE365367C699CBAAA0C190E,15411,21,23,2,44,27,2227
81096,81096,42C74C72D35B339ED05BC27A3DEC0690,19031,1,5,4,1,42,92
81097,81097,42C74C72D35B339ED05BC27A3DEC0690,12641,8,10,2,10,43,543
81098,81098,42C74C72D35B339ED05BC27A3DEC0690,19031,11,14,3,1,42,92
81099,81099,42C74C72D35B339ED05BC27A3DEC0690,12641,16,17,1,10,43,543
81100,81100,42C74C72D35B339ED05BC27A3DEC0690,19031,20,23,3,1,42,92
81104,81104,3B29886A6F86362AF63E47D84A299A41,43501,1,2,1,27,48,1398
81105,81105,3B29886A6F86362AF63E47D84A299A41,42501,2,6,4,28,47,1447
81106,81106,3B29886A6F86362AF63E47D84A299A41,12921,8,9,1,9,41,491
81107,81107,3B29886A6F86362AF63E47D84A299A41,12641,10,12,2,10,43,543
81108,81108,3B29886A6F86362AF63E47D84A299A41,19931,14,16,2,7,43,393
81109,81109,3B29886A6F86362AF63E47D84A299A41,42541,17,19,2,25,47,1297
81116,81116,BED0ECABE31BE6050710942A02B0A484,13911,0,5,5,39,46,1996
81117,81117,BED0ECABE31BE6050710942A02B0A484,42231,6,12,6,37,46,1896
81118,81118,BED0ECABE31BE6050710942A02B0A484,42351,12,13,1,38,45,1945
81119,81119,BED0ECABE31BE6050710942A02B0A484,42231,13,15,2,37,46,1896
81120,81120,BED0ECABE31BE6050710942A02B0A484,13911,15,19,4,39,46,1996
81121,81121,FB55907415A7C0538398712A9BE0B78E,12661,0,7,7,32,45,1645
81122,81122,FB55907415A7C0538398712A9BE0B78E,42151,9,10,1,35,45,1795
81123,81123,FB55907415A7C0538398712A9BE0B78E,42861,11,12,1,37,44,1894
81124,81124,FB55907415A7C0538398712A9BE0B78E,42151,16,18,2,35,45,1795
81125,81125,FB55907415A7C0538398712A9BE0B78E,12661,19,23,4,32,45,1645
81126,81126,7F78752A70A41E260D80D552F245436B,42501,6,7,1,28,47,1447
81127,81127,7F78752A70A41E260D80D552F245436B,12311,9,15,6,30,44,1544
81128,81128,7F78752A70A41E260D80D552F245436B,11875,19,21,2,30,46,1546
81129,81129,E962C3D0A8FC163364DD770DFBF0ADE9,11381,0,6,6,30,47,1547
81130,81130,E962C3D0A8FC163364DD770DFBF0ADE9,41591,9,16,7,34,49,1749
81131,81131,E962C3D0A8FC163364DD770DFBF0ADE9,12121,19,22,3,29,47,1497
81132,81132,B5049B35726618F14389B8B6E85E624E,11921,0,8,8,38,48,1948
81133,81133,B5049B35726618F14389B8B6E85E624E,11061,11,18,7,29,48,1498
81134,81134,B5049B35726618F14389B8B6E85E624E,11921,19,23,4,38,48,1948
81135,81135,830067E97972F27E1AE4923131398E88,42523,0,7,7,31,47,1597
81136,81136,830067E97972F27E1AE4923131398E88,42491,10,11,1,32,46,1646
81137,81137,830067E97972F27E1AE4923131398E88,42523,11,17,6,31,47,1597
81138,81138,830067E97972F27E1AE4923131398E88,42501,19,20,1,28,47,1447
81139,81139,830067E97972F27E1AE4923131398E88,42523,20,22,2,31,47,1597
81144,81144,2CB91117B8C0592A65F2A476D7776E07,13111,0,9,9,42,46,2146
81145,81145,2CB91117B8C0592A65F2A476D7776E07,12561,12,14,2,45,43,2293
81146,81146,2CB91117B8C0592A65F2A476D7776E07,13341,14,16,2,44,45,2245
81147,81147,2CB91117B8C0592A65F2A476D7776E07,10107,19,21,2,38,49,1949
81148,81148,4F074A5B39BAE29FDE781A996B1B99C0,11021,0,9,9,36,49,1849
81149,81149,4F074A5B39BAE29FDE781A996B1B99C0,10331,13,15,2,39,46,1996
81150,81150,4F074A5B39BAE29FDE781A996B1B99C0,11021,18,23,5,36,49,1849
81151,81151,3D50CF8DA80A4761FAF974D4CBB0A177,43751,0,13,13,19,48,998
81152,81152,3D50CF8DA80A4761FAF974D4CBB0A177,10351,14,17,3,28,45,1445
81153,81153,3D50CF8DA80A4761FAF974D4CBB0A177,43751,18,23,5,19,48,998
81154,81154,082B69FE27233ED93EF55B765B884E7B,12831,1,5,4,34,38,1738
81155,81155,082B69FE27233ED93EF55B765B884E7B,12521,5,8,3,35,41,1791
81156,81156,082B69FE27233ED93EF55B765B884E7B,11061,12,23,11,29,48,1498
81161,81161,1C0548F40841AD0870DAD8EC7BECCBC6,13314,0,7,7,31,39,1589
81162,81162,1C0548F40841AD0870DAD8EC7BECCBC6,12521,8,9,1,35,41,1791
81163,81163,1C0548F40841AD0870DAD8EC7BECCBC6,13314,10,13,3,31,39,1589
81164,81164,1C0548F40841AD0870DAD8EC7BECCBC6,12521,14,16,2,35,41,1791
81165,81165,1C0548F40841AD0870DAD8EC7BECCBC6,13314,16,23,7,31,39,1589
81173,81173,3C07D1557002BF4F1AA6A6D7A8949EF2,42523,0,5,5,31,47,1597
81174,81174,3C07D1557002BF4F1AA6A6D7A8949EF2,12601,8,17,9,25,47,1297
81175,81175,3C07D1557002BF4F1AA6A6D7A8949EF2,42523,18,20,2,31,47,1597
81179,81179,C91EDEC4832C8610497ADAA0406605AA,10691,0,6,6,33,48,1698
81180,81180,C91EDEC4832C8610497ADAA0406605AA,43731,7,8,1,34,47,1747
81181,81181,C91EDEC4832C8610497ADAA0406605AA,42941,11,13,2,37,47,1897
81182,81182,C91EDEC4832C8610497ADAA0406605AA,11561,14,16,2,32,49,1649
81183,81183,C91EDEC4832C8610497ADAA0406605AA,10881,19,23,4,34,48,1748
81184,81184,62A4DF59E8BCEC0DCF6C971E2D9209AC,13711,0,4,4,38,46,1946
81185,81185,62A4DF59E8BCEC0DCF6C971E2D9209AC,11491,5,6,1,36,47,1847
81186,81186,62A4DF59E8BCEC0DCF6C971E2D9209AC,11021,9,16,7,36,49,1849
81187,81187,62A4DF59E8BCEC0DCF6C971E2D9209AC,13711,19,21,2,38,46,1946
81188,81188,62A4DF59E8BCEC0DCF6C971E2D9209AC,10271,21,22,1,37,46,1896
81189,81189,290CF9B7E8E39B2A6D619522168B66C7,19621,0,7,7,5,46,296
81190,81190,290CF9B7E8E39B2A6D619522168B66C7,10221,10,14,4,34,49,1749
81191,81191,290CF9B7E8E39B2A6D619522168B66C7,10901,14,17,3,35,48,1798
81192,81192,290CF9B7E8E39B2A6D619522168B66C7,19441,19,23,4,8,46,446
81193,81193,9C1255EB3506932E14B113644E6BCAC2,13371,0,11,11,41,47,2097
81194,81194,9C1255EB3506932E14B113644E6BCAC2,10611,12,15,3,32,48,1648
81195,81195,9C1255EB3506932E14B113644E6BCAC2,11171,17,18,1,33,48,1698
81196,81196,9C1255EB3506932E14B113644E6BCAC2,40261,19,23,4,35,49,1799
81197,81197,C3385B266A5088A7FA48BCC62DFDD003,11914,0,6,6,37,48,1898
81198,81198,C3385B266A5088A7FA48BCC62DFDD003,42221,7,8,1,38,48,1948
81199,81199,C3385B266A5088A7FA48BCC62DFDD003,11914,11,13,2,37,48,1898
81200,81200,C3385B266A5088A7FA48BCC62DFDD003,43181,14,15,1,39,48,1998
81201,81201,C3385B266A5088A7FA48BCC62DFDD003,11914,18,23,5,37,48,1898
81202,81202,9442AAEA05C831A2075E8352FC15EF6E,43361,0,8,8,38,48,1948
81203,81203,9442AAEA05C831A2075E8352FC15EF6E,10351,9,11,2,28,45,1445
81204,81204,9442AAEA05C831A2075E8352FC15EF6E,43061,12,13,1,43,46,2196
81205,81205,9442AAEA05C831A2075E8352FC15EF6E,10351,17,18,1,28,45,1445
81206,81206,9442AAEA05C831A2075E8352FC15EF6E,11151,19,20,1,30,48,1548
81210,81210,5DC656AE1F755A21D4CE0049D29039D4,12521,3,4,1,35,41,1791
81211,81211,5DC656AE1F755A21D4CE0049D29039D4,11261,7,9,2,36,46,1846
81212,81212,5DC656AE1F755A21D4CE0049D29039D4,12491,13,15,2,36,43,1843
81213,81213,5DC656AE1F755A21D4CE0049D29039D4,11261,16,23,7,36,46,1846
81222,81222,E2FFCD903537CA9133DA72817E931FE4,11531,0,7,7,34,49,1749
81223,81223,E2FFCD903537CA9133DA72817E931FE4,11541,9,10,1,35,49,1799
81224,81224,E2FFCD903537CA9133DA72817E931FE4,11481,13,15,2,41,48,2098
81225,81225,E2FFCD903537CA9133DA72817E931FE4,11531,20,23,3,34,49,1749
81226,81226,76DA946F4DC1318DD46A32E1D303D6B7,12521,0,14,14,35,41,1791
81227,81227,76DA946F4DC1318DD46A32E1D303D6B7,13314,14,16,2,31,39,1589
81228,81228,76DA946F4DC1318DD46A32E1D303D6B7,12521,17,23,6,35,41,1791
81236,81236,863F31104B3FB6C118488312C191E6EB,42081,0,10,10,24,49,1249
81237,81237,863F31104B3FB6C118488312C191E6EB,42261,13,14,1,25,49,1299
81238,81238,863F31104B3FB6C118488312C191E6EB,42071,15,18,3,31,49,1599
81246,81246,458EBC255B183BF22B23CE89879E2CC9,13471,1,11,10,47,49,2399
81247,81247,458EBC255B183BF22B23CE89879E2CC9,40691,12,17,5,42,48,2148
81248,81248,458EBC255B183BF22B23CE89879E2CC9,13471,19,23,4,47,49,2399
81252,81252,658F12866DF04DEFD1752C8716ACBB95,42551,0,6,6,14,48,748
81253,81253,658F12866DF04DEFD1752C8716ACBB95,19441,9,17,8,8,46,446
81254,81254,658F12866DF04DEFD1752C8716ACBB95,42551,21,23,2,14,48,748
81263,81263,6B5F89BF09EA72A624639E30B47831CE,11381,0,6,6,30,47,1547
81264,81264,6B5F89BF09EA72A624639E30B47831CE,10951,11,12,1,29,48,1498
81265,81265,6B5F89BF09EA72A624639E30B47831CE,11381,16,17,1,30,47,1547
81266,81266,6B5F89BF09EA72A624639E30B47831CE,10951,20,21,1,29,48,1498
81267,81267,6B5F89BF09EA72A624639E30B47831CE,11381,22,23,1,30,47,1547
81268,81268,42B2BDACA7D5527221C19ADB1F60CEFD,13511,0,12,12,34,48,1748
81269,81269,42B2BDACA7D5527221C19ADB1F60CEFD,12391,12,15,3,36,49,1849
81270,81270,42B2BDACA7D5527221C19ADB1F60CEFD,19531,16,17,1,17,30,880
81271,81271,42B2BDACA7D5527221C19ADB1F60CEFD,10661,19,21,2,37,49,1899
81272,81272,42B2BDACA7D5527221C19ADB1F60CEFD,13511,22,23,1,34,48,1748
81276,81276,22300DEAB3F7A20A2F8DD7892A11C5B7,13271,0,4,4,41,47,2097
81277,81277,22300DEAB3F7A20A2F8DD7892A11C5B7,11481,6,7,1,41,48,2098
81278,81278,22300DEAB3F7A20A2F8DD7892A11C5B7,12401,10,12,2,39,49,1999
81279,81279,22300DEAB3F7A20A2F8DD7892A11C5B7,13271,14,16,2,41,47,2097
81280,81280,22300DEAB3F7A20A2F8DD7892A11C5B7,13101,17,20,3,40,47,2047
81281,81281,E8CD5DA0A8ECA00765CB7C96C7EBC2F9,43731,0,1,1,34,47,1747
81282,81282,E8CD5DA0A8ECA00765CB7C96C7EBC2F9,43161,5,7,2,35,47,1797
81283,81283,E8CD5DA0A8ECA00765CB7C96C7EBC2F9,42161,8,12,4,36,47,1847
81284,81284,E8CD5DA0A8ECA00765CB7C96C7EBC2F9,43161,13,14,1,35,47,1797
81285,81285,E8CD5DA0A8ECA00765CB7C96C7EBC2F9,42161,19,20,1,36,47,1847
81286,81286,E8CD5DA0A8ECA00765CB7C96C7EBC2F9,43161,21,22,1,35,47,1797
81287,81287,3C98F7394473AF286503765E077D8C3A,49201,0,2,2,7,41,391
81288,81288,3C98F7394473AF286503765E077D8C3A,19181,5,6,1,8,40,440
81289,81289,3C98F7394473AF286503765E077D8C3A,12921,8,9,1,9,41,491
81290,81290,3C98F7394473AF286503765E077D8C3A,49201,15,16,1,7,41,391
81291,81291,3C98F7394473AF286503765E077D8C3A,12921,17,18,1,9,41,491
81292,81292,3C98F7394473AF286503765E077D8C3A,49201,21,22,1,7,41,391
81302,81302,6A457FC295BEABB4E7455CBB04B50835,43021,1,9,8,16,43,843
81303,81303,6A457FC295BEABB4E7455CBB04B50835,12641,12,13,1,10,43,543
81304,81304,6A457FC295BEABB4E7455CBB04B50835,43021,17,18,1,16,43,843
81305,81305,0B929ACA970011AFF649AD1CE667839A,43021,1,6,5,16,43,843
81306,81306,0B929ACA970011AFF649AD1CE667839A,12921,7,8,1,9,41,491
81307,81307,0B929ACA970011AFF649AD1CE667839A,43021,8,18,10,16,43,843
81308,81308,0B929ACA970011AFF649AD1CE667839A,10161,20,23,3,35,49,1799
81309,81309,8827A35309A216F0F6E4CBB2FFAC456D,41031,1,11,10,32,49,1649
81310,81310,8827A35309A216F0F6E4CBB2FFAC456D,10221,16,18,2,34,49,1749
81311,81311,8827A35309A216F0F6E4CBB2FFAC456D,11551,18,19,1,39,49,1999
81312,81312,8827A35309A216F0F6E4CBB2FFAC456D,10951,21,23,2,29,48,1498
81320,81320,D1D4F1B4017FEA89A042CB8ED8E15110,40343,0,16,16,24,49,1249
81321,81321,D1D4F1B4017FEA89A042CB8ED8E15110,40925,16,18,2,35,49,1799
81322,81322,D1D4F1B4017FEA89A042CB8ED8E15110,40343,19,23,4,24,49,1249
81323,81323,B6674F6BB1F07CBF5417C9023D07052B,12651,0,8,8,43,47,2197
81324,81324,B6674F6BB1F07CBF5417C9023D07052B,11061,12,18,6,29,48,1498
81325,81325,B6674F6BB1F07CBF5417C9023D07052B,12651,20,23,3,43,47,2197
81326,81326,083E6F45CD758E55D59CE683A8831561,43011,0,1,1,40,42,2042
81327,81327,083E6F45CD758E55D59CE683A8831561,42381,1,5,4,39,41,1991
81328,81328,083E6F45CD758E55D59CE683A8831561,13071,8,9,1,41,41,2091
81329,81329,083E6F45CD758E55D59CE683A8831561,42381,11,13,2,39,41,1991
81330,81330,083E6F45CD758E55D59CE683A8831561,42151,18,19,1,35,45,1795
81331,81331,AF48B8274EF204750841FA6014372B51,42471,0,11,11,35,49,1799
81332,81332,AF48B8274EF204750841FA6014372B51,11531,15,17,2,34,49,1749
81333,81333,AF48B8274EF204750841FA6014372B51,43971,19,23,4,30,48,1548
81337,81337,30EE4ED515D97FFC1B2D380D08A1F01B,11074,0,12,12,37,47,1897
81338,81338,30EE4ED515D97FFC1B2D380D08A1F01B,11561,16,17,1,32,49,1649
81339,81339,30EE4ED515D97FFC1B2D380D08A1F01B,11074,18,20,2,37,47,1897
81340,81340,4C222710DF7DDF41C93194BB9F0B40E3,10621,0,6,6,41,49,2099
81341,81341,4C222710DF7DDF41C93194BB9F0B40E3,13711,8,12,4,38,46,1946
81342,81342,4C222710DF7DDF41C93194BB9F0B40E3,42231,12,13,1,37,46,1896
81343,81343,4C222710DF7DDF41C93194BB9F0B40E3,13711,14,17,3,38,46,1946
81344,81344,4C222710DF7DDF41C93194BB9F0B40E3,10621,21,23,2,41,49,2099
81348,81348,2DF55C2584719A60978A4B87BCCC14A1,42523,0,2,2,31,47,1597
81349,81349,2DF55C2584719A60978A4B87BCCC14A1,10292,4,10,6,30,47,1547
81350,81350,2DF55C2584719A60978A4B87BCCC14A1,42523,10,11,1,31,47,1597
81351,81351,2DF55C2584719A60978A4B87BCCC14A1,43761,18,20,2,32,47,1647
81352,81352,2DF55C2584719A60978A4B87BCCC14A1,42523,21,23,2,31,47,1597
81353,81353,323D4177D0D22193C91552166ADC43E4,10341,0,7,7,31,47,1597
81354,81354,323D4177D0D22193C91552166ADC43E4,40271,8,13,5,35,49,1799
81355,81355,323D4177D0D22193C91552166ADC43E4,11021,13,14,1,36,49,1849
81356,81356,323D4177D0D22193C91552166ADC43E4,42961,15,18,3,35,49,1799
81357,81357,323D4177D0D22193C91552166ADC43E4,42521,21,22,1,31,47,1597
81358,81358,0E91A13D0E931F32EE1FFD96FA252798,13071,0,4,4,41,41,2091
81359,81359,0E91A13D0E931F32EE1FFD96FA252798,43451,6,9,3,37,40,1890
81360,81360,0E91A13D0E931F32EE1FFD96FA252798,42381,12,13,1,39,41,1991
81361,81361,0E91A13D0E931F32EE1FFD96FA252798,43451,14,17,3,37,40,1890
81362,81362,0E91A13D0E931F32EE1FFD96FA252798,42381,19,20,1,39,41,1991
81363,81363,C029826C5BB7E45FB7F0BA61E1CA759A,12381,0,6,6,32,48,1648
81364,81364,C029826C5BB7E45FB7F0BA61E1CA759A,42601,7,8,1,44,48,2248
81365,81365,C029826C5BB7E45FB7F0BA61E1CA759A,12381,18,19,1,32,48,1648
81366,81366,7C4A30E2F49A7BD15CB265C29054416E,43241,0,7,7,36,46,1846
81367,81367,7C4A30E2F49A7BD15CB265C29054416E,10231,9,12,3,39,49,1999
81368,81368,7C4A30E2F49A7BD15CB265C29054416E,11291,12,14,2,40,49,2049
81369,81369,7C4A30E2F49A7BD15CB265C29054416E,10231,15,17,2,39,49,1999
81370,81370,7C4A30E2F49A7BD15CB265C29054416E,43241,20,22,2,36,46,1846
81377,81377,4D7F9A766459E315716EA1D053BCDCF8,13671,0,3,3,27,43,1393
81378,81378,4D7F9A766459E315716EA1D053BCDCF8,10061,4,6,2,20,46,1046
81379,81379,4D7F9A766459E315716EA1D053BCDCF8,13671,11,20,9,27,43,1393
81380,81380,66BF2E4899B4E57AFD9485A7423B59AE,11531,7,9,2,34,49,1749
81381,81381,66BF2E4899B4E57AFD9485A7423B59AE,11481,12,17,5,41,48,2098
81382,81382,66BF2E4899B4E57AFD9485A7423B59AE,40691,20,21,1,42,48,2148
81383,81383,66BF2E4899B4E57AFD9485A7423B59AE,13101,22,23,1,40,47,2047
81384,81384,08B22EEE6E957330DAD27E7217103ACF,42381,0,7,7,39,41,1991
81385,81385,08B22EEE6E957330DAD27E7217103ACF,12514,12,20,8,38,47,1947
81386,81386,08B22EEE6E957330DAD27E7217103ACF,11914,20,22,2,37,48,1898
81387,81387,F2E0A788EC41736380A7AB3495E7AB34,42161,0,6,6,36,47,1847
81388,81388,F2E0A788EC41736380A7AB3495E7AB34,10451,8,17,9,25,48,1298
81389,81389,F2E0A788EC41736380A7AB3495E7AB34,42401,19,21,2,36,47,1847
81390,81390,87C604056176038C74265E8D7F317AC6,42141,0,9,9,32,47,1647
81391,81391,87C604056176038C74265E8D7F317AC6,10521,14,15,1,41,47,2097
81392,81392,87C604056176038C74265E8D7F317AC6,42141,20,23,3,32,47,1647
81393,81393,6CA2209D62B6706E5E59A4258E6B7718,42351,0,6,6,38,45,1945
81394,81394,6CA2209D62B6706E5E59A4258E6B7718,13561,10,16,6,37,49,1899
81395,81395,6CA2209D62B6706E5E59A4258E6B7718,42091,18,21,3,43,46,2196
81396,81396,94DF6D416CC5B92A0E5062ABBAC5B786,12514,0,1,1,38,47,1947
81397,81397,94DF6D416CC5B92A0E5062ABBAC5B786,11074,2,7,5,37,47,1897
81398,81398,94DF6D416CC5B92A0E5062ABBAC5B786,42071,10,18,8,31,49,1599
81402,81402,2D6BB08D0028E1950DC24BE69D8E3BA3,10811,1,4,3,38,46,1946
81403,81403,2D6BB08D0028E1950DC24BE69D8E3BA3,10451,6,11,5,25,48,1298
81404,81404,2D6BB08D0028E1950DC24BE69D8E3BA3,42711,13,16,3,26,48,1348
81405,81405,2D6BB08D0028E1950DC24BE69D8E3BA3,10716,18,20,2,30,46,1546
81406,81406,2D6BB08D0028E1950DC24BE69D8E3BA3,10451,21,23,2,25,48,1298
81411,81411,5655612953640FEF8E6F10B722F330F6,10751,0,4,4,47,43,2393
81412,81412,5655612953640FEF8E6F10B722F330F6,12211,5,10,5,41,44,2094
81413,81413,5655612953640FEF8E6F10B722F330F6,10751,11,22,11,47,43,2393
81414,81414,BCCF2CDFD6C9D7A77ABBD1757075B8AB,11081,7,8,1,35,46,1796
81415,81415,BCCF2CDFD6C9D7A77ABBD1757075B8AB,11531,10,15,5,34,49,1749
81416,81416,BCCF2CDFD6C9D7A77ABBD1757075B8AB,10107,21,23,2,38,49,1949
81417,81417,EDC6874ABD6F7BEFD833FD9685C8AB3C,40691,0,8,8,42,48,2148
81418,81418,EDC6874ABD6F7BEFD833FD9685C8AB3C,11351,9,11,2,36,48,1848
81419,81419,EDC6874ABD6F7BEFD833FD9685C8AB3C,11301,12,15,3,41,49,2099
81420,81420,EDC6874ABD6F7BEFD833FD9685C8AB3C,11351,15,17,2,36,48,1848
81421,81421,EDC6874ABD6F7BEFD833FD9685C8AB3C,42981,22,23,1,36,49,1849
81422,81422,7FBC8EE4EAF538E2F5C357E9E39087FD,12381,0,7,7,32,48,1648
81423,81423,7FBC8EE4EAF538E2F5C357E9E39087FD,42021,11,12,1,33,47,1697
81424,81424,7FBC8EE4EAF538E2F5C357E9E39087FD,10221,13,15,2,34,49,1749
81425,81425,7FBC8EE4EAF538E2F5C357E9E39087FD,12083,19,21,2,36,49,1849
81432,81432,1D51AC4BBFB933A632C5A69F521FA887,11861,0,11,11,32,47,1647
81433,81433,1D51AC4BBFB933A632C5A69F521FA887,11271,13,14,1,37,48,1898
81434,81434,1D51AC4BBFB933A632C5A69F521FA887,11861,16,23,7,32,47,1647
81435,81435,C679B78CC6D72C84BDF54659808494C3,15081,0,8,8,27,1,1351
81436,81436,C679B78CC6D72C84BDF54659808494C3,15241,8,13,5,33,2,1652
81437,81437,C679B78CC6D72C84BDF54659808494C3,10781,16,18,2,35,47,1797
81438,81438,C679B78CC6D72C84BDF54659808494C3,10301,20,23,3,31,45,1595
81439,81439,E3B088F7DEFCCE4BD4EB6ADB8F0E5950,10841,1,3,2,37,47,1897
81440,81440,E3B088F7DEFCCE4BD4EB6ADB8F0E5950,10591,6,7,1,39,48,1998
81441,81441,E3B088F7DEFCCE4BD4EB6ADB8F0E5950,10841,12,13,1,37,47,1897
81442,81442,E3B088F7DEFCCE4BD4EB6ADB8F0E5950,10591,15,17,2,39,48,1998
81443,81443,E3B088F7DEFCCE4BD4EB6ADB8F0E5950,10841,19,22,3,37,47,1897
81447,81447,E3F6BEAC53881C33A9632EFCBC166461,11271,0,8,8,37,48,1898
81448,81448,E3F6BEAC53881C33A9632EFCBC166461,11541,9,11,2,35,49,1799
81449,81449,E3F6BEAC53881C33A9632EFCBC166461,10251,14,16,2,35,47,1797
81450,81450,E3F6BEAC53881C33A9632EFCBC166461,11201,18,19,1,35,49,1799
81451,81451,E3F6BEAC53881C33A9632EFCBC166461,11731,21,23,2,36,48,1848
81456,81456,99165E654E4A5840EA37FC83361CE61B,42581,0,8,8,38,48,1948
81457,81457,99165E654E4A5840EA37FC83361CE61B,11914,10,11,1,37,48,1898
81458,81458,99165E654E4A5840EA37FC83361CE61B,42581,12,16,4,38,48,1948
81459,81459,99165E654E4A5840EA37FC83361CE61B,11914,18,19,1,37,48,1898
81460,81460,99165E654E4A5840EA37FC83361CE61B,42581,22,23,1,38,48,1948
81461,81461,C6ECE5EEB3C55F11FF8684D918998C95,11571,0,6,6,13,46,696
81462,81462,C6ECE5EEB3C55F11FF8684D918998C95,19021,7,9,2,10,45,545
81463,81463,C6ECE5EEB3C55F11FF8684D918998C95,43021,9,11,2,16,43,843
81464,81464,C6ECE5EEB3C55F11FF8684D918998C95,11571,12,13,1,13,46,696
81465,81465,C6ECE5EEB3C55F11FF8684D918998C95,43021,14,19,5,16,43,843
81470,81470,DEA13AE4E25C1F5535D501BC3C7ECF55,19111,0,7,7,9,45,495
81471,81471,DEA13AE4E25C1F5535D501BC3C7ECF55,11631,10,14,4,12,49,649
81472,81472,DEA13AE4E25C1F5535D501BC3C7ECF55,42471,17,23,6,35,49,1799
81482,81482,CDA1EB7B89E47C48A7CAC823B0773234,43241,1,2,1,36,46,1846
81483,81483,CDA1EB7B89E47C48A7CAC823B0773234,12661,2,16,14,32,45,1645
81484,81484,CDA1EB7B89E47C48A7CAC823B0773234,10107,19,21,2,38,49,1949
81485,81485,CDA1EB7B89E47C48A7CAC823B0773234,10221,21,23,2,34,49,1749
81489,81489,DD628D137A372FD9F2379158E8EE3966,12921,0,3,3,9,41,491
81490,81490,DD628D137A372FD9F2379158E8EE3966,12641,3,4,1,10,43,543
81491,81491,DD628D137A372FD9F2379158E8EE3966,49201,6,8,2,7,41,391
81492,81492,DD628D137A372FD9F2379158E8EE3966,12921,11,12,1,9,41,491
81493,81493,DD628D137A372FD9F2379158E8EE3966,49201,16,18,2,7,41,391
81494,81494,DD628D137A372FD9F2379158E8EE3966,12921,18,23,5,9,41,491
81499,81499,5ED7982BF35A6EABA38759108284E59F,13951,0,6,6,47,45,2395
81500,81500,5ED7982BF35A6EABA38759108284E59F,11701,9,10,1,43,48,2198
81501,81501,5ED7982BF35A6EABA38759108284E59F,13951,11,13,2,47,45,2395
81502,81502,5ED7982BF35A6EABA38759108284E59F,11701,17,18,1,43,48,2198
81503,81503,5ED7982BF35A6EABA38759108284E59F,43051,19,23,4,46,45,2345
81512,81512,8868A050B2675F1D16135ACF47FD7E3C,12641,1,6,5,10,43,543
81513,81513,8868A050B2675F1D16135ACF47FD7E3C,10151,9,10,1,34,47,1747
81514,81514,8868A050B2675F1D16135ACF47FD7E3C,12641,12,14,2,10,43,543
81515,81515,8868A050B2675F1D16135ACF47FD7E3C,19114,15,16,1,7,43,393
81516,81516,8868A050B2675F1D16135ACF47FD7E3C,12641,16,19,3,10,43,543
81517,81517,8868A050B2675F1D16135ACF47FD7E3C,19114,19,20,1,7,43,393
81518,81518,8868A050B2675F1D16135ACF47FD7E3C,12641,22,23,1,10,43,543
81519,81519,F0C7EDE2A4789958616B0A004CA8540F,13271,0,5,5,41,47,2097
81520,81520,F0C7EDE2A4789958616B0A004CA8540F,10631,8,10,2,28,46,1446
81521,81521,F0C7EDE2A4789958616B0A004CA8540F,13271,14,23,9,41,47,2097
81522,81522,5D20910F370368DA9B7807A8789204C0,19901,0,7,7,7,44,394
81523,81523,5D20910F370368DA9B7807A8789204C0,12641,7,10,3,10,43,543
81524,81524,5D20910F370368DA9B7807A8789204C0,19114,10,12,2,7,43,393
81525,81525,5D20910F370368DA9B7807A8789204C0,12641,13,16,3,10,43,543
81526,81526,5D20910F370368DA9B7807A8789204C0,19901,18,19,1,7,44,394
81530,81530,16B2F0D78BEB849442A93B3F29FB7F4E,11806,0,2,2,41,48,2098
81531,81531,16B2F0D78BEB849442A93B3F29FB7F4E,42271,5,6,1,40,47,2047
81532,81532,16B2F0D78BEB849442A93B3F29FB7F4E,42321,8,9,1,43,47,2197
81533,81533,16B2F0D78BEB849442A93B3F29FB7F4E,11806,13,16,3,41,48,2098
81534,81534,16B2F0D78BEB849442A93B3F29FB7F4E,42271,19,20,1,40,47,2047
81535,81535,16B2F0D78BEB849442A93B3F29FB7F4E,11806,20,23,3,41,48,2098
81536,81536,576B01C43A9F86D222730FAFCEED6223,42691,0,18,18,24,48,1248
81537,81537,576B01C43A9F86D222730FAFCEED6223,43751,20,21,1,19,48,998
81538,81538,576B01C43A9F86D222730FAFCEED6223,12581,21,23,2,24,48,1248
81549,81549,586D3412322F83F403EF1DE57025AE48,10634,0,6,6,27,45,1395
81550,81550,586D3412322F83F403EF1DE57025AE48,40381,8,13,5,32,46,1646
81551,81551,586D3412322F83F403EF1DE57025AE48,12311,16,18,2,30,44,1544
81552,81552,586D3412322F83F403EF1DE57025AE48,40381,21,23,2,32,46,1646
81556,81556,0102436000D6EFDA91A3939751E37135,15411,0,6,6,44,27,2227
81557,81557,0102436000D6EFDA91A3939751E37135,12221,8,12,4,43,44,2194
81558,81558,0102436000D6EFDA91A3939751E37135,42631,13,14,1,43,45,2195
81559,81559,0102436000D6EFDA91A3939751E37135,12611,18,20,2,41,29,2079
81564,81564,6A0394A16431C3763362EDB77E0D6861,42071,0,10,10,31,49,1599
81565,81565,6A0394A16431C3763362EDB77E0D6861,42831,10,12,2,27,48,1398
81566,81566,6A0394A16431C3763362EDB77E0D6861,42071,12,14,2,31,49,1599
81567,81567,6A0394A16431C3763362EDB77E0D6861,42831,14,16,2,27,48,1398
81568,81568,6A0394A16431C3763362EDB77E0D6861,42071,16,18,2,31,49,1599
81569,81569,6A0394A16431C3763362EDB77E0D6861,42831,18,19,1,27,48,1398
81570,81570,6A0394A16431C3763362EDB77E0D6861,42071,20,22,2,31,49,1599
81571,81571,1EBBCD8E69FE78528B9DC42AA21044CE,12391,5,6,1,36,49,1849
81572,81572,1EBBCD8E69FE78528B9DC42AA21044CE,11481,10,19,9,41,48,2098
81573,81573,1EBBCD8E69FE78528B9DC42AA21044CE,12391,20,22,2,36,49,1849
81574,81574,07118431508F96EE4149B934B6D92DC5,13271,0,7,7,41,47,2097
81575,81575,07118431508F96EE4149B934B6D92DC5,43731,10,11,1,34,47,1747
81576,81576,07118431508F96EE4149B934B6D92DC5,13271,13,20,7,41,47,2097
81580,81580,AB6EA8E0EB921375D4ACF50883707DA2,10681,0,8,8,30,48,1548
81581,81581,AB6EA8E0EB921375D4ACF50883707DA2,10401,9,17,8,33,49,1699
81582,81582,AB6EA8E0EB921375D4ACF50883707DA2,10107,19,23,4,38,49,1949
81583,81583,2C992222ACB93CD1B2234E4466A7A38C,11331,0,1,1,37,48,1898
81584,81584,2C992222ACB93CD1B2234E4466A7A38C,12651,2,9,7,43,47,2197
81585,81585,2C992222ACB93CD1B2234E4466A7A38C,11541,12,14,2,35,49,1799
81586,81586,2C992222ACB93CD1B2234E4466A7A38C,11481,18,20,2,41,48,2098
81587,81587,D256AE34DD31744D7365602849D9C40A,10341,0,7,7,31,47,1597
81588,81588,D256AE34DD31744D7365602849D9C40A,10351,11,13,2,28,45,1445
81589,81589,D256AE34DD31744D7365602849D9C40A,12601,15,17,2,25,47,1297
81590,81590,D256AE34DD31744D7365602849D9C40A,42491,18,22,4,32,46,1646
81595,81595,05286C4B5017A260B39768783F7D4555,42581,0,6,6,38,48,1948
81596,81596,05286C4B5017A260B39768783F7D4555,11914,9,10,1,37,48,1898
81597,81597,05286C4B5017A260B39768783F7D4555,42581,11,12,1,38,48,1948
81598,81598,05286C4B5017A260B39768783F7D4555,11914,17,22,5,37,48,1898
81599,81599,05286C4B5017A260B39768783F7D4555,42581,22,23,1,38,48,1948
81600,81600,8A2B6A3BBB67F4CA1B157F83176E3E9B,42831,8,9,1,27,48,1398
81601,81601,8A2B6A3BBB67F4CA1B157F83176E3E9B,11151,12,13,1,30,48,1548
81602,81602,8A2B6A3BBB67F4CA1B157F83176E3E9B,42831,16,17,1,27,48,1398
81603,81603,8A2B6A3BBB67F4CA1B157F83176E3E9B,10381,19,23,4,31,49,1599
81604,81604,CD5F8D7604C7020A19DDE3C48998E9F5,13314,0,2,2,31,39,1589
81605,81605,CD5F8D7604C7020A19DDE3C48998E9F5,12521,6,17,11,35,41,1791
81606,81606,CD5F8D7604C7020A19DDE3C48998E9F5,13314,21,22,1,31,39,1589
81607,81607,E2F2F4143F844EB76521711717E3F1F1,43644,0,5,5,14,38,738
81608,81608,E2F2F4143F844EB76521711717E3F1F1,42041,7,9,2,10,47,547
81609,81609,E2F2F4143F844EB76521711717E3F1F1,12641,9,15,6,10,43,543
81610,81610,E2F2F4143F844EB76521711717E3F1F1,12921,19,20,1,9,41,491
81614,81614,B3B9E7CAA281FDC11E6B1AB8159D5D86,11941,1,8,7,37,46,1896
81615,81615,B3B9E7CAA281FDC11E6B1AB8159D5D86,43751,12,13,1,19,48,998
81616,81616,B3B9E7CAA281FDC11E6B1AB8159D5D86,42711,14,15,1,26,48,1348
81617,81617,B3B9E7CAA281FDC11E6B1AB8159D5D86,11941,16,17,1,37,46,1896
81618,81618,B3B9E7CAA281FDC11E6B1AB8159D5D86,43751,19,20,1,19,48,998
81634,81634,85AF3F568DC121A84EF6CC84157293A0,12651,0,7,7,43,47,2197
81635,81635,85AF3F568DC121A84EF6CC84157293A0,19021,8,17,9,10,45,545
81636,81636,85AF3F568DC121A84EF6CC84157293A0,13111,18,19,1,42,46,2146
81637,81637,85AF3F568DC121A84EF6CC84157293A0,42201,20,21,1,43,46,2196
81644,81644,4FA7E2AF35091649A8D61648BF92F5C0,42581,0,6,6,38,48,1948
81645,81645,4FA7E2AF35091649A8D61648BF92F5C0,10471,7,11,4,37,48,1898
81646,81646,4FA7E2AF35091649A8D61648BF92F5C0,42581,12,14,2,38,48,1948
81647,81647,4FA7E2AF35091649A8D61648BF92F5C0,10471,14,18,4,37,48,1898
81648,81648,4FA7E2AF35091649A8D61648BF92F5C0,42581,19,22,3,38,48,1948
81652,81652,7EA63201A47B68AA085BD7B8AF1F7767,10721,0,7,7,31,48,1598
81653,81653,7EA63201A47B68AA085BD7B8AF1F7767,12083,9,10,1,36,49,1849
81654,81654,7EA63201A47B68AA085BD7B8AF1F7767,11231,13,18,5,37,49,1899
81655,81655,7EA63201A47B68AA085BD7B8AF1F7767,10721,19,23,4,31,48,1598
81659,81659,110EB8ED5B33FF374638B480C238C00D,10271,1,7,6,37,46,1896
81660,81660,110EB8ED5B33FF374638B480C238C00D,19744,9,18,9,6,43,343
81661,81661,110EB8ED5B33FF374638B480C238C00D,10271,19,21,2,37,46,1896
81674,81674,E88F39A65DCBFC647F6F44FF9039942F,12601,0,5,5,25,47,1297
81675,81675,E88F39A65DCBFC647F6F44FF9039942F,10634,6,11,5,27,45,1395
81676,81676,E88F39A65DCBFC647F6F44FF9039942F,12601,13,14,1,25,47,1297
81677,81677,E88F39A65DCBFC647F6F44FF9039942F,10634,15,19,4,27,45,1395
81678,81678,E88F39A65DCBFC647F6F44FF9039942F,12601,20,21,1,25,47,1297
81683,81683,C89529DCFA7F41DFC598DE45605F620D,13341,0,8,8,44,45,2245
81684,81684,C89529DCFA7F41DFC598DE45605F620D,42201,8,9,1,43,46,2196
81685,81685,C89529DCFA7F41DFC598DE45605F620D,40951,13,14,1,36,49,1849
81686,81686,C89529DCFA7F41DFC598DE45605F620D,13341,18,20,2,44,45,2245
81687,81687,2CB194F5C88F15739C3E83AF93DF02DF,10281,0,8,8,33,48,1698
81688,81688,2CB194F5C88F15739C3E83AF93DF02DF,12561,13,15,2,45,43,2293
81689,81689,2CB194F5C88F15739C3E83AF93DF02DF,12221,19,21,2,43,44,2194
81693,81693,A4CBFA774BBCB1E081978588796288CA,10681,0,7,7,30,48,1548
81694,81694,A4CBFA774BBCB1E081978588796288CA,11231,9,15,6,37,49,1899
81695,81695,A4CBFA774BBCB1E081978588796288CA,12083,16,22,6,36,49,1849
81696,81696,D077683FA4E525522EF198AE164E27B4,10521,0,2,2,41,47,2097
81697,81697,D077683FA4E525522EF198AE164E27B4,10771,3,12,9,41,46,2096
81698,81698,D077683FA4E525522EF198AE164E27B4,42271,14,15,1,40,47,2047
81699,81699,D077683FA4E525522EF198AE164E27B4,10921,17,19,2,43,48,2198
81700,81700,D077683FA4E525522EF198AE164E27B4,42271,19,21,2,40,47,2047
81707,81707,FCF6425DA3F542476DF1F93935C075D8,42581,0,4,4,38,48,1948
81708,81708,FCF6425DA3F542476DF1F93935C075D8,11914,5,9,4,37,48,1898
81709,81709,FCF6425DA3F542476DF1F93935C075D8,42581,9,17,8,38,48,1948
81710,81710,FCF6425DA3F542476DF1F93935C075D8,11914,18,19,1,37,48,1898
81711,81711,FCF6425DA3F542476DF1F93935C075D8,42581,20,23,3,38,48,1948
81715,81715,41CDD9856306F7413F05E4DB9E6A842C,12021,3,8,5,37,49,1899
81716,81716,41CDD9856306F7413F05E4DB9E6A842C,10544,10,12,2,28,48,1448
81717,81717,41CDD9856306F7413F05E4DB9E6A842C,12021,13,18,5,37,49,1899
81718,81718,41CDD9856306F7413F05E4DB9E6A842C,11324,19,20,1,31,46,1596
81722,81722,474FFA09EED2908FC53360D0633D492E,13111,0,9,9,42,46,2146
81723,81723,474FFA09EED2908FC53360D0633D492E,43061,9,10,1,43,46,2196
81724,81724,474FFA09EED2908FC53360D0633D492E,13111,13,14,1,42,46,2146
81725,81725,474FFA09EED2908FC53360D0633D492E,10221,15,17,2,34,49,1749
81726,81726,474FFA09EED2908FC53360D0633D492E,11751,17,23,6,35,48,1798
81730,81730,10530AA3545BA3AAA2634E512B3F731F,11261,0,4,4,36,46,1846
81731,81731,10530AA3545BA3AAA2634E512B3F731F,42864,8,9,1,38,44,1944
81732,81732,10530AA3545BA3AAA2634E512B3F731F,42861,10,12,2,37,44,1894
81733,81733,10530AA3545BA3AAA2634E512B3F731F,10911,18,20,2,39,46,1996
81734,81734,10530AA3545BA3AAA2634E512B3F731F,10601,21,22,1,39,47,1997
81735,81735,FEB10E9619CCB09DA2455DDE3043904C,41612,0,8,8,36,47,1847
81736,81736,FEB10E9619CCB09DA2455DDE3043904C,40234,9,11,2,35,49,1799
81737,81737,FEB10E9619CCB09DA2455DDE3043904C,40637,11,14,3,36,47,1847
81738,81738,FEB10E9619CCB09DA2455DDE3043904C,40234,14,16,2,35,49,1799
81739,81739,FEB10E9619CCB09DA2455DDE3043904C,40637,22,23,1,36,47,1847
81747,81747,312060B326A149D1F0009EDC937831B5,42161,0,7,7,36,47,1847
81748,81748,312060B326A149D1F0009EDC937831B5,13071,11,13,2,41,41,2091
81749,81749,312060B326A149D1F0009EDC937831B5,10111,14,17,3,37,47,1897
81750,81750,312060B326A149D1F0009EDC937831B5,42161,17,23,6,36,47,1847
81755,81755,0A8F7479198CE1702D41784AD33AF3BC,13941,0,15,15,41,47,2097
81756,81756,0A8F7479198CE1702D41784AD33AF3BC,10271,16,18,2,37,46,1896
81757,81757,0A8F7479198CE1702D41784AD33AF3BC,10121,20,22,2,36,49,1849
81761,81761,B10E0FAD5DA7B2DD77F8CA308FB212E8,42491,0,12,12,32,46,1646
81762,81762,B10E0FAD5DA7B2DD77F8CA308FB212E8,11211,13,14,1,34,49,1749
81763,81763,B10E0FAD5DA7B2DD77F8CA308FB212E8,11324,16,20,4,31,46,1596
81764,81764,705FC253DE711424F67961503BCC9FD5,42151,2,13,11,35,45,1795
81765,81765,705FC253DE711424F67961503BCC9FD5,12311,15,16,1,30,44,1544
81766,81766,705FC253DE711424F67961503BCC9FD5,42151,18,22,4,35,45,1795
81770,81770,249945D8BC225A84B9C0C3C523B07C14,42381,0,13,13,39,41,1991
81771,81771,249945D8BC225A84B9C0C3C523B07C14,42151,14,18,4,35,45,1795
81772,81772,249945D8BC225A84B9C0C3C523B07C14,10911,20,23,3,39,46,1996
81776,81776,8D1F636D6A89C4DB732A73204358DDD7,13121,9,10,1,38,46,1946
81777,81777,8D1F636D6A89C4DB732A73204358DDD7,43391,12,13,1,29,48,1498
81778,81778,8D1F636D6A89C4DB732A73204358DDD7,11151,13,21,8,30,48,1548
81779,81779,753369D691B504B9F7186B2CDF290F06,12792,0,4,4,34,30,1730
81780,81780,753369D691B504B9F7186B2CDF290F06,15391,5,9,4,35,26,1776
81781,81781,753369D691B504B9F7186B2CDF290F06,15191,13,14,1,36,27,1827
81782,81782,753369D691B504B9F7186B2CDF290F06,15391,18,20,2,35,26,1776
81783,81783,753369D691B504B9F7186B2CDF290F06,12792,20,23,3,34,30,1730
81787,81787,C5EC1C5776C1A9B72B91A4CB02601B74,10681,1,12,11,30,48,1548
81788,81788,C5EC1C5776C1A9B72B91A4CB02601B74,40341,13,15,2,23,49,1199
81789,81789,C5EC1C5776C1A9B72B91A4CB02601B74,10681,15,23,8,30,48,1548
81790,81790,F934A070299A0C2535F9C55A84D4AE40,11471,0,1,1,12,48,648
81791,81791,F934A070299A0C2535F9C55A84D4AE40,42041,4,8,4,10,47,547
81792,81792,F934A070299A0C2535F9C55A84D4AE40,19441,9,11,2,8,46,446
81793,81793,F934A070299A0C2535F9C55A84D4AE40,11471,13,15,2,12,48,648
81794,81794,F934A070299A0C2535F9C55A84D4AE40,19441,17,18,1,8,46,446
81795,81795,F934A070299A0C2535F9C55A84D4AE40,11471,18,20,2,12,48,648
81799,81799,3ACC8BF8C4DFF8F069BDD805025DF41D,12921,0,7,7,9,41,491
81800,81800,3ACC8BF8C4DFF8F069BDD805025DF41D,10107,12,14,2,38,49,1949
81801,81801,3ACC8BF8C4DFF8F069BDD805025DF41D,43021,15,18,3,16,43,843
81802,81802,3ACC8BF8C4DFF8F069BDD805025DF41D,12921,19,22,3,9,41,491
81803,81803,C4D6D6893D15A40EF6C21B7CBC7CED3E,11861,0,6,6,32,47,1647
81804,81804,C4D6D6893D15A40EF6C21B7CBC7CED3E,42021,6,8,2,33,47,1697
81805,81805,C4D6D6893D15A40EF6C21B7CBC7CED3E,11541,8,14,6,35,49,1799
81806,81806,C4D6D6893D15A40EF6C21B7CBC7CED3E,11211,15,16,1,34,49,1749
81807,81807,C4D6D6893D15A40EF6C21B7CBC7CED3E,11861,18,23,5,32,47,1647
81816,81816,8AB561279CAFD673B81CFFF6F25401C3,12221,0,1,1,43,44,2194
81817,81817,8AB561279CAFD673B81CFFF6F25401C3,43011,1,9,8,40,42,2042
81818,81818,8AB561279CAFD673B81CFFF6F25401C3,13951,12,16,4,47,45,2395
81819,81819,8AB561279CAFD673B81CFFF6F25401C3,43011,19,23,4,40,42,2042
81820,81820,E25E1285A7A60234C9FCE15CA921BDB1,11061,0,11,11,29,48,1498
81821,81821,E25E1285A7A60234C9FCE15CA921BDB1,42021,11,16,5,33,47,1697
81822,81822,E25E1285A7A60234C9FCE15CA921BDB1,43391,16,23,7,29,48,1498
81823,81823,6F91EC02135E83E6781F5652531EDC5E,42161,0,12,12,36,47,1847
81824,81824,6F91EC02135E83E6781F5652531EDC5E,42381,14,15,1,39,41,1991
81825,81825,6F91EC02135E83E6781F5652531EDC5E,42301,16,23,7,36,47,1847
81830,81830,3A1B49B490CA109FD4D5251F0C86C9CB,43581,0,13,13,33,48,1698
81831,81831,3A1B49B490CA109FD4D5251F0C86C9CB,12601,14,15,1,25,47,1297
81832,81832,3A1B49B490CA109FD4D5251F0C86C9CB,43581,18,23,5,33,48,1698
81836,81836,B51CF68BE97808727E238A35594EB565,15391,0,9,9,35,26,1776
81837,81837,B51CF68BE97808727E238A35594EB565,15401,10,12,2,39,25,1975
81838,81838,B51CF68BE97808727E238A35594EB565,12881,14,18,4,47,22,2372
81842,81842,1B550A18B0397F926248F9A2C7B0A9DE,42341,0,8,8,43,49,2199
81843,81843,1B550A18B0397F926248F9A2C7B0A9DE,10411,9,10,1,36,48,1848
81844,81844,1B550A18B0397F926248F9A2C7B0A9DE,43671,12,13,1,35,48,1798
81845,81845,1B550A18B0397F926248F9A2C7B0A9DE,42341,13,15,2,43,49,2199
81846,81846,1B550A18B0397F926248F9A2C7B0A9DE,40302,18,21,3,40,49,2049
81861,81861,401DBF9291C70DB6E3FE8385830F996E,13791,0,7,7,42,47,2147
81862,81862,401DBF9291C70DB6E3FE8385830F996E,10221,9,12,3,34,49,1749
81863,81863,401DBF9291C70DB6E3FE8385830F996E,11591,12,13,1,36,49,1849
81864,81864,401DBF9291C70DB6E3FE8385830F996E,42471,13,14,1,35,49,1799
81865,81865,401DBF9291C70DB6E3FE8385830F996E,19744,15,16,1,6,43,343
81866,81866,401DBF9291C70DB6E3FE8385830F996E,11021,18,20,2,36,49,1849
81867,81867,EF7FF0709933B50F4D00C87C477FCE93,43061,0,4,4,43,46,2196
81868,81868,EF7FF0709933B50F4D00C87C477FCE93,13111,7,8,1,42,46,2146
81869,81869,EF7FF0709933B50F4D00C87C477FCE93,42271,9,12,3,40,47,2047
81870,81870,EF7FF0709933B50F4D00C87C477FCE93,42461,13,14,1,45,47,2297
81871,81871,EF7FF0709933B50F4D00C87C477FCE93,42271,15,19,4,40,47,2047
81872,81872,6F947024A8B73B97F8430A4C48FA1DF6,13741,1,7,6,37,49,1899
81873,81873,6F947024A8B73B97F8430A4C48FA1DF6,10107,8,10,2,38,49,1949
81874,81874,6F947024A8B73B97F8430A4C48FA1DF6,13561,10,13,3,37,49,1899
81875,81875,6F947024A8B73B97F8430A4C48FA1DF6,10107,14,17,3,38,49,1949
81876,81876,6F947024A8B73B97F8430A4C48FA1DF6,12083,20,23,3,36,49,1849
81877,81877,D0C0DA106ECAAAC8A4CA44A17BA4860C,13671,4,5,1,27,43,1393
81878,81878,D0C0DA106ECAAAC8A4CA44A17BA4860C,11875,9,10,1,30,46,1546
81879,81879,D0C0DA106ECAAAC8A4CA44A17BA4860C,12311,11,19,8,30,44,1544
81883,81883,AF85AB0F84B58F4A12483525349C1572,43121,0,7,7,25,27,1277
81884,81884,AF85AB0F84B58F4A12483525349C1572,15191,8,9,1,36,27,1827
81885,81885,AF85AB0F84B58F4A12483525349C1572,43121,10,23,13,25,27,1277
81886,81886,CA601ED32D4DA950EA12F7A37DA37141,13341,0,8,8,44,45,2245
81887,81887,CA601ED32D4DA950EA12F7A37DA37141,10471,9,18,9,37,48,1898
81888,81888,CA601ED32D4DA950EA12F7A37DA37141,13341,19,23,4,44,45,2245
81893,81893,A27203DC664657DF4BBDCCF4AC9D93B1,19181,0,2,2,8,40,440
81894,81894,A27203DC664657DF4BBDCCF4AC9D93B1,49201,2,6,4,7,41,391
81895,81895,A27203DC664657DF4BBDCCF4AC9D93B1,12641,9,11,2,10,43,543
81896,81896,A27203DC664657DF4BBDCCF4AC9D93B1,12921,11,21,10,9,41,491
81897,81897,89A29DA093E55F037F89890FCC2F6E32,43101,0,6,6,46,40,2340
81898,81898,89A29DA093E55F037F89890FCC2F6E32,13071,8,9,1,41,41,2091
81899,81899,89A29DA093E55F037F89890FCC2F6E32,43101,14,20,6,46,40,2340
81900,81900,89A29DA093E55F037F89890FCC2F6E32,43951,21,22,1,49,41,2491
81901,81901,4509CA6F4F6AE506CFF527F6805D5251,12641,6,10,4,10,43,543
81902,81902,4509CA6F4F6AE506CFF527F6805D5251,19181,15,18,3,8,40,440
81903,81903,4509CA6F4F6AE506CFF527F6805D5251,12921,21,22,1,9,41,491
81907,81907,EF2E66853800FD0F0FDF1A24C24F87DD,12514,0,1,1,38,47,1947
81908,81908,EF2E66853800FD0F0FDF1A24C24F87DD,11921,5,8,3,38,48,1948
81909,81909,EF2E66853800FD0F0FDF1A24C24F87DD,12514,8,13,5,38,47,1947
81910,81910,EF2E66853800FD0F0FDF1A24C24F87DD,13511,18,23,5,34,48,1748
81911,81911,12F431E93EB57B81BD6191BC47B68160,42771,0,7,7,36,47,1847
81912,81912,12F431E93EB57B81BD6191BC47B68160,10251,11,17,6,35,47,1797
81913,81913,12F431E93EB57B81BD6191BC47B68160,40302,17,23,6,40,49,2049
81914,81914,2FC430E1448F290A8E229F5C2301E320,12921,1,8,7,9,41,491
81915,81915,2FC430E1448F290A8E229F5C2301E320,12641,12,14,2,10,43,543
81916,81916,2FC430E1448F290A8E229F5C2301E320,49201,14,16,2,7,41,391
81917,81917,2FC430E1448F290A8E229F5C2301E320,12921,18,20,2,9,41,491
81918,81918,2FC430E1448F290A8E229F5C2301E320,49201,21,23,2,7,41,391
81919,81919,60C0E1F44E371FF235E24C0663005E74,13341,0,7,7,44,45,2245
81920,81920,60C0E1F44E371FF235E24C0663005E74,13651,8,11,3,30,47,1547
81921,81921,60C0E1F44E371FF235E24C0663005E74,13341,14,23,9,44,45,2245
81932,81932,36391605FB1091601145BE09BDC65544,11271,3,4,1,37,48,1898
81933,81933,36391605FB1091601145BE09BDC65544,11794,4,8,4,38,49,1949
81934,81934,36391605FB1091601145BE09BDC65544,11461,11,12,1,37,49,1899
81935,81935,36391605FB1091601145BE09BDC65544,10901,13,14,1,35,48,1798
81936,81936,36391605FB1091601145BE09BDC65544,11231,14,23,9,37,49,1899
81937,81937,A553D674E6ADCEEE9DF6E0981719FE7C,43341,0,17,17,41,46,2096
81938,81938,A553D674E6ADCEEE9DF6E0981719FE7C,10841,19,21,2,37,47,1897
81939,81939,A553D674E6ADCEEE9DF6E0981719FE7C,43341,22,23,1,41,46,2096
81944,81944,E9C5D67F82A2CCBA27E905D3F4A2B0C8,10221,0,7,7,34,49,1749
81945,81945,E9C5D67F82A2CCBA27E905D3F4A2B0C8,43751,9,12,3,19,48,998
81946,81946,E9C5D67F82A2CCBA27E905D3F4A2B0C8,11351,13,14,1,36,48,1848
81947,81947,E9C5D67F82A2CCBA27E905D3F4A2B0C8,11491,14,16,2,36,47,1847
81948,81948,E9C5D67F82A2CCBA27E905D3F4A2B0C8,10221,18,19,1,34,49,1749
81949,81949,E9C5D67F82A2CCBA27E905D3F4A2B0C8,11551,19,21,2,39,49,1999
81950,81950,4D5D3F015222D9A4A636663FE67FCAD4,10171,0,6,6,26,47,1347
81951,81951,4D5D3F015222D9A4A636663FE67FCAD4,41591,7,18,11,34,49,1749
81952,81952,4D5D3F015222D9A4A636663FE67FCAD4,10171,20,23,3,26,47,1347
81953,81953,3CE371BB76BE2DC6A8C42D4A13AFBD2A,43311,0,8,8,31,48,1598
81954,81954,3CE371BB76BE2DC6A8C42D4A13AFBD2A,42231,11,18,7,37,46,1896
81955,81955,3CE371BB76BE2DC6A8C42D4A13AFBD2A,43311,20,22,2,31,48,1598
81956,81956,DB5F58C0BF92D33E406DDC1B3C9B82ED,10161,0,6,6,35,49,1799
81957,81957,DB5F58C0BF92D33E406DDC1B3C9B82ED,10716,8,9,1,30,46,1546
81958,81958,DB5F58C0BF92D33E406DDC1B3C9B82ED,42523,9,14,5,31,47,1597
81959,81959,DB5F58C0BF92D33E406DDC1B3C9B82ED,10716,15,17,2,30,46,1546
81960,81960,DB5F58C0BF92D33E406DDC1B3C9B82ED,10161,18,23,5,35,49,1799
81961,81961,EED10CB844C83DEAB3F20FBC910D00CC,11541,0,6,6,35,49,1799
81962,81962,EED10CB844C83DEAB3F20FBC910D00CC,11021,6,8,2,36,49,1849
81963,81963,EED10CB844C83DEAB3F20FBC910D00CC,13561,8,10,2,37,49,1899
81964,81964,EED10CB844C83DEAB3F20FBC910D00CC,11541,11,12,1,35,49,1799
81965,81965,EED10CB844C83DEAB3F20FBC910D00CC,13561,15,17,2,37,49,1899
81966,81966,EED10CB844C83DEAB3F20FBC910D00CC,11541,19,23,4,35,49,1799
81967,81967,97F87E25D267410278E74FDFD0CF66D1,42801,9,11,2,40,49,2049
81968,81968,97F87E25D267410278E74FDFD0CF66D1,10231,12,13,1,39,49,1999
81969,81969,97F87E25D267410278E74FDFD0CF66D1,11201,21,23,2,35,49,1799
81970,81970,DF5678A2D82F170D018446CB4502486B,12083,0,8,8,36,49,1849
81971,81971,DF5678A2D82F170D018446CB4502486B,11271,16,17,1,37,48,1898
81972,81972,DF5678A2D82F170D018446CB4502486B,12671,20,22,2,21,43,1093
81976,81976,4EBC9B07118637077DF7845F128B6611,13111,0,9,9,42,46,2146
81977,81977,4EBC9B07118637077DF7845F128B6611,40341,11,17,6,23,49,1199
81978,81978,4EBC9B07118637077DF7845F128B6611,13111,20,23,3,42,46,2146
81987,81987,7C2E283820C8F80F7B539E1DEA95DAFD,12391,0,6,6,36,49,1849
81988,81988,7C2E283820C8F80F7B539E1DEA95DAFD,11231,8,10,2,37,49,1899
81989,81989,7C2E283820C8F80F7B539E1DEA95DAFD,11481,13,17,4,41,48,2098
81990,81990,7C2E283820C8F80F7B539E1DEA95DAFD,12391,18,19,1,36,49,1849
81991,81991,7C2E283820C8F80F7B539E1DEA95DAFD,13101,22,23,1,40,47,2047
81992,81992,AAC98D8EB5664A9B5DE56F266CB31991,16281,0,13,13,11,4,554
81993,81993,AAC98D8EB5664A9B5DE56F266CB31991,15143,13,16,3,18,7,907
81994,81994,AAC98D8EB5664A9B5DE56F266CB31991,16281,17,22,5,11,4,554
81998,81998,8F2DCDB1E6ACA3D4E7FFFCA1E99BF72D,11431,3,7,4,29,47,1497
81999,81999,8F2DCDB1E6ACA3D4E7FFFCA1E99BF72D,42021,9,10,1,33,47,1697
82000,82000,8F2DCDB1E6ACA3D4E7FFFCA1E99BF72D,43161,10,17,7,35,47,1797
82001,82001,8F2DCDB1E6ACA3D4E7FFFCA1E99BF72D,10731,20,23,3,33,47,1697
82002,82002,4BEB96C1A6F8B99181CDADEF48D75275,42501,0,6,6,28,47,1447
82003,82003,4BEB96C1A6F8B99181CDADEF48D75275,42081,8,17,9,24,49,1249
82004,82004,4BEB96C1A6F8B99181CDADEF48D75275,42501,18,23,5,28,47,1447
82009,82009,A61D0F5D6E4730E77483BB5A83F54B2C,10251,0,8,8,35,47,1797
82010,82010,A61D0F5D6E4730E77483BB5A83F54B2C,42511,10,14,4,37,47,1897
82011,82011,A61D0F5D6E4730E77483BB5A83F54B2C,10221,15,16,1,34,49,1749
82012,82012,A61D0F5D6E4730E77483BB5A83F54B2C,10107,19,20,1,38,49,1949
82013,82013,A61D0F5D6E4730E77483BB5A83F54B2C,11901,21,22,1,42,49,2149
82017,82017,1A5BED51D45595E1322F7C9DAB1FCF2D,43061,1,5,4,43,46,2196
82018,82018,1A5BED51D45595E1322F7C9DAB1FCF2D,11021,9,17,8,36,49,1849
82019,82019,1A5BED51D45595E1322F7C9DAB1FCF2D,13341,21,23,2,44,45,2245
82020,82020,9918FEABB0433C4402810CC88ACF5496,12311,0,13,13,30,44,1544
82021,82021,9918FEABB0433C4402810CC88ACF5496,42151,13,14,1,35,45,1795
82022,82022,9918FEABB0433C4402810CC88ACF5496,12311,15,16,1,30,44,1544
82023,82023,9918FEABB0433C4402810CC88ACF5496,19744,17,18,1,6,43,343
82024,82024,9918FEABB0433C4402810CC88ACF5496,12311,20,23,3,30,44,1544
82034,82034,6606CC80A620FB56A8D3818C167DB7F4,11951,8,11,3,31,49,1599
82035,82035,6606CC80A620FB56A8D3818C167DB7F4,10711,13,15,2,29,46,1496
82036,82036,6606CC80A620FB56A8D3818C167DB7F4,10381,18,20,2,31,49,1599
82037,82037,6606CC80A620FB56A8D3818C167DB7F4,10711,20,23,3,29,46,1496
82041,82041,00AF64C30DD1AF7B063E67637E648889,10271,0,7,7,37,46,1896
82042,82042,00AF64C30DD1AF7B063E67637E648889,12221,8,11,3,43,44,2194
82043,82043,00AF64C30DD1AF7B063E67637E648889,42301,15,17,2,36,47,1847
82044,82044,00AF64C30DD1AF7B063E67637E648889,10271,19,20,1,37,46,1896
82045,82045,B6F80668987D76AE8AEC48092E44D3BD,10511,0,6,6,35,46,1796
82046,82046,B6F80668987D76AE8AEC48092E44D3BD,10547,9,17,8,27,48,1398
82047,82047,B6F80668987D76AE8AEC48092E44D3BD,10271,17,19,2,37,46,1896
82048,82048,B6F80668987D76AE8AEC48092E44D3BD,13121,19,23,4,38,46,1946
82053,82053,4DA57F9F33C37E2CA21407DE781C18AF,12211,0,1,1,41,44,2094
82054,82054,4DA57F9F33C37E2CA21407DE781C18AF,13911,3,12,9,39,46,1996
82055,82055,4DA57F9F33C37E2CA21407DE781C18AF,11261,14,15,1,36,46,1846
82056,82056,4DA57F9F33C37E2CA21407DE781C18AF,13911,19,23,4,39,46,1996
82060,82060,51E47FDE51716EB36BE96125516194AB,11021,0,10,10,36,49,1849
82061,82061,51E47FDE51716EB36BE96125516194AB,40697,12,13,1,43,48,2198
82062,82062,51E47FDE51716EB36BE96125516194AB,11021,15,17,2,36,49,1849
82063,82063,51E47FDE51716EB36BE96125516194AB,40697,17,21,4,43,48,2198
82064,82064,51E47FDE51716EB36BE96125516194AB,11021,21,23,2,36,49,1849
82069,82069,C7B2C2AE2DF954A69981F5A4F94159CA,12731,3,4,1,22,40,1140
82070,82070,C7B2C2AE2DF954A69981F5A4F94159CA,13671,5,9,4,27,43,1393
82071,82071,C7B2C2AE2DF954A69981F5A4F94159CA,13231,13,14,1,39,46,1996
82072,82072,C7B2C2AE2DF954A69981F5A4F94159CA,13671,15,16,1,27,43,1393
82073,82073,C7B2C2AE2DF954A69981F5A4F94159CA,42351,19,20,1,38,45,1945
82074,82074,9B49BEB65E16F10DE8E30D5D01D652E3,10811,0,8,8,38,46,1946
82075,82075,9B49BEB65E16F10DE8E30D5D01D652E3,11261,9,10,1,36,46,1846
82076,82076,9B49BEB65E16F10DE8E30D5D01D652E3,42351,12,13,1,38,45,1945
82077,82077,9B49BEB65E16F10DE8E30D5D01D652E3,12311,14,16,2,30,44,1544
82078,82078,9B49BEB65E16F10DE8E30D5D01D652E3,43341,18,19,1,41,46,2096
82079,82079,9B49BEB65E16F10DE8E30D5D01D652E3,10331,21,23,2,39,46,1996
82080,82080,366A0DB50799C9E748C33F0454278B43,11806,4,7,3,41,48,2098
82081,82081,366A0DB50799C9E748C33F0454278B43,42271,9,10,1,40,47,2047
82082,82082,366A0DB50799C9E748C33F0454278B43,13381,13,15,2,39,47,1997
82083,82083,366A0DB50799C9E748C33F0454278B43,42501,19,21,2,28,47,1447
82084,82084,71BB6FC70D40EF532E3D8E169ED69645,40277,9,15,6,35,49,1799
82085,82085,71BB6FC70D40EF532E3D8E169ED69645,11771,17,19,2,39,49,1999
82086,82086,71BB6FC70D40EF532E3D8E169ED69645,42801,20,21,1,40,49,2049
82098,82098,512965DC7E2584D886D6B5F50766448D,10281,0,7,7,33,48,1698
82099,82099,512965DC7E2584D886D6B5F50766448D,42623,9,10,1,22,49,1149
82100,82100,512965DC7E2584D886D6B5F50766448D,42141,19,20,1,32,47,1647
82101,82101,512965DC7E2584D886D6B5F50766448D,12083,21,23,2,36,49,1849
82102,82102,4034674068B3C97F9C5DD807E7BD5A8D,10381,0,9,9,31,49,1599
82103,82103,4034674068B3C97F9C5DD807E7BD5A8D,42121,10,11,1,26,49,1349
82104,82104,4034674068B3C97F9C5DD807E7BD5A8D,10381,13,23,10,31,49,1599
82108,82108,63AAB4E2754CD06C7A024CF5DB6B083C,11951,0,6,6,31,49,1599
82109,82109,63AAB4E2754CD06C7A024CF5DB6B083C,11914,9,18,9,37,48,1898
82110,82110,63AAB4E2754CD06C7A024CF5DB6B083C,11951,21,23,2,31,49,1599
82111,82111,9CC4CBB12A26930D20974F5533F887C8,42691,0,5,5,24,48,1248
82112,82112,9CC4CBB12A26930D20974F5533F887C8,12051,7,8,1,20,47,1047
82113,82113,9CC4CBB12A26930D20974F5533F887C8,12581,9,23,14,24,48,1248
82114,82114,A1E88710F597AD993ACF1C23AEB06926,43481,0,8,8,39,48,1998
82115,82115,A1E88710F597AD993ACF1C23AEB06926,42271,8,12,4,40,47,2047
82116,82116,A1E88710F597AD993ACF1C23AEB06926,10061,14,17,3,20,46,1046
82117,82117,A1E88710F597AD993ACF1C23AEB06926,42271,18,23,5,40,47,2047
82121,82121,826B40817E61853148AFBFECB1C48C70,11261,0,5,5,36,46,1846
82122,82122,826B40817E61853148AFBFECB1C48C70,42861,7,12,5,37,44,1894
82123,82123,826B40817E61853148AFBFECB1C48C70,11261,13,14,1,36,46,1846
82124,82124,826B40817E61853148AFBFECB1C48C70,10911,18,20,2,39,46,1996
82125,82125,826B40817E61853148AFBFECB1C48C70,10601,21,22,1,39,47,1997
82129,82129,6CBBEE1C450344F3879ED38C16F213C4,12581,9,10,1,24,48,1248
82130,82130,6CBBEE1C450344F3879ED38C16F213C4,43751,12,14,2,19,48,998
82131,82131,6CBBEE1C450344F3879ED38C16F213C4,12581,18,19,1,24,48,1248
82132,82132,1AE2200F23825E6FDA6F0DA6992B0AF9,11531,0,2,2,34,49,1749
82133,82133,1AE2200F23825E6FDA6F0DA6992B0AF9,11101,3,11,8,18,48,948
82134,82134,1AE2200F23825E6FDA6F0DA6992B0AF9,11061,14,16,2,29,48,1498
82135,82135,1AE2200F23825E6FDA6F0DA6992B0AF9,10061,17,20,3,20,46,1046
82136,82136,1AE2200F23825E6FDA6F0DA6992B0AF9,11271,21,23,2,37,48,1898
82137,82137,9EB7D688ABAAF3BA20D07B88C9AB0761,11571,0,9,9,13,46,696
82138,82138,9EB7D688ABAAF3BA20D07B88C9AB0761,19441,11,20,9,8,46,446
82139,82139,9EB7D688ABAAF3BA20D07B88C9AB0761,11571,20,23,3,13,46,696
82144,82144,E03B05F0FB01917EEB19D58711FDBCBD,13071,0,7,7,41,41,2091
82145,82145,E03B05F0FB01917EEB19D58711FDBCBD,43101,7,9,2,46,40,2340
82146,82146,E03B05F0FB01917EEB19D58711FDBCBD,13071,13,16,3,41,41,2091
82147,82147,E03B05F0FB01917EEB19D58711FDBCBD,10811,21,23,2,38,46,1946
82152,82152,B07F9654999A27B565B093B7A4D6A968,13651,0,7,7,30,47,1547
82153,82153,B07F9654999A27B565B093B7A4D6A968,11751,8,10,2,35,48,1798
82154,82154,B07F9654999A27B565B093B7A4D6A968,11021,10,15,5,36,49,1849
82155,82155,B07F9654999A27B565B093B7A4D6A968,11481,17,20,3,41,48,2098
82159,82159,EF4100B4391F55DDFFFFBAE9F0BF0EC4,10621,1,12,11,41,49,2099
82160,82160,EF4100B4391F55DDFFFFBAE9F0BF0EC4,42401,13,17,4,36,47,1847
82161,82161,EF4100B4391F55DDFFFFBAE9F0BF0EC4,10621,19,23,4,41,49,2099
82162,82162,81C892F4C735FEF892157743AFC50956,43241,1,6,5,36,46,1846
82163,82163,81C892F4C735FEF892157743AFC50956,10221,8,17,9,34,49,1749
82164,82164,81C892F4C735FEF892157743AFC50956,10271,19,21,2,37,46,1896
82165,82165,004D26DDA49F4E295E56D0D4EFA58427,42523,2,12,10,31,47,1597
82166,82166,004D26DDA49F4E295E56D0D4EFA58427,11321,13,15,2,31,46,1596
82167,82167,004D26DDA49F4E295E56D0D4EFA58427,16261,18,23,5,3,3,153
82168,82168,A36A27382F119D22AFBE4444170D00B7,12211,0,5,5,41,44,2094
82169,82169,A36A27382F119D22AFBE4444170D00B7,13341,7,18,11,44,45,2245
82170,82170,A36A27382F119D22AFBE4444170D00B7,13951,19,20,1,47,45,2395
82171,82171,A36A27382F119D22AFBE4444170D00B7,13341,21,22,1,44,45,2245
82172,82172,9259900CF1484CEAFCB0BE9321BC8694,10691,0,7,7,33,48,1698
82173,82173,9259900CF1484CEAFCB0BE9321BC8694,10471,9,10,1,37,48,1898
82174,82174,9259900CF1484CEAFCB0BE9321BC8694,11231,10,14,4,37,49,1899
82175,82175,9259900CF1484CEAFCB0BE9321BC8694,10471,15,18,3,37,48,1898
82176,82176,9259900CF1484CEAFCB0BE9321BC8694,10691,21,23,2,33,48,1698
82177,82177,57068447BEEE4D7969FF166D57966ECA,42541,0,5,5,25,47,1297
82178,82178,57068447BEEE4D7969FF166D57966ECA,11361,6,8,2,22,48,1148
82179,82179,57068447BEEE4D7969FF166D57966ECA,12581,8,10,2,24,48,1248
82180,82180,57068447BEEE4D7969FF166D57966ECA,11361,13,16,3,22,48,1148
82181,82181,57068447BEEE4D7969FF166D57966ECA,42541,20,23,3,25,47,1297
82196,82196,5EF4CC4B01A87C595F8F267A8C51CB7F,10681,4,5,1,30,48,1548
82197,82197,5EF4CC4B01A87C595F8F267A8C51CB7F,11061,6,10,4,29,48,1498
82198,82198,5EF4CC4B01A87C595F8F267A8C51CB7F,19744,13,14,1,6,43,343
82199,82199,5EF4CC4B01A87C595F8F267A8C51CB7F,19741,15,23,8,5,44,294
82200,82200,04618E39CCC1E5047B065A0EFB16FDCC,41031,0,13,13,32,49,1649
82201,82201,04618E39CCC1E5047B065A0EFB16FDCC,19261,15,16,1,6,37,337
82202,82202,04618E39CCC1E5047B065A0EFB16FDCC,10161,18,20,2,35,49,1799
82203,82203,04618E39CCC1E5047B065A0EFB16FDCC,11954,20,23,3,32,49,1649
82204,82204,8EA53D8E1525E5DC764AA8B750C1926A,40124,0,3,3,38,47,1947
82205,82205,8EA53D8E1525E5DC764AA8B750C1926A,42511,4,15,11,37,47,1897
82206,82206,8EA53D8E1525E5DC764AA8B750C1926A,43951,18,23,5,49,41,2491
82214,82214,5AF26FD3EDD59D73F20E2AE7E3BEDAFF,49201,0,7,7,7,41,391
82215,82215,5AF26FD3EDD59D73F20E2AE7E3BEDAFF,12641,10,11,1,10,43,543
82216,82216,5AF26FD3EDD59D73F20E2AE7E3BEDAFF,10681,15,22,7,30,48,1548
82217,82217,E2204D6E32AC09E78AF98F20C9465FA5,10121,0,13,13,36,49,1849
82218,82218,E2204D6E32AC09E78AF98F20C9465FA5,10634,14,17,3,27,45,1395
82219,82219,E2204D6E32AC09E78AF98F20C9465FA5,10121,18,23,5,36,49,1849
82220,82220,60F7F4881031002766F8A8E2FAB27EDD,10041,0,7,7,39,49,1999
82221,82221,60F7F4881031002766F8A8E2FAB27EDD,11531,10,12,2,34,49,1749
82222,82222,60F7F4881031002766F8A8E2FAB27EDD,10041,12,13,1,39,49,1999
82223,82223,60F7F4881031002766F8A8E2FAB27EDD,43321,15,17,2,36,49,1849
82224,82224,60F7F4881031002766F8A8E2FAB27EDD,11794,19,20,1,38,49,1949
82225,82225,60F7F4881031002766F8A8E2FAB27EDD,10041,20,23,3,39,49,1999
82229,82229,0D753CC6181FC64E07F668A618F8F0BC,13071,0,6,6,41,41,2091
82230,82230,0D753CC6181FC64E07F668A618F8F0BC,43101,6,9,3,46,40,2340
82231,82231,0D753CC6181FC64E07F668A618F8F0BC,13071,12,23,11,41,41,2091
82236,82236,BB3DB8BDA13F245F7DA1B278DE6D4FF0,43021,0,5,5,16,43,843
82237,82237,BB3DB8BDA13F245F7DA1B278DE6D4FF0,12641,6,7,1,10,43,543
82238,82238,BB3DB8BDA13F245F7DA1B278DE6D4FF0,12921,10,17,7,9,41,491
82239,82239,BB3DB8BDA13F245F7DA1B278DE6D4FF0,43021,19,23,4,16,43,843
82240,82240,75219378BBB10FFE07C7301517B53FE1,11806,0,7,7,41,48,2098
82241,82241,75219378BBB10FFE07C7301517B53FE1,11231,8,19,11,37,49,1899
82242,82242,75219378BBB10FFE07C7301517B53FE1,42271,20,23,3,40,47,2047
82246,82246,3601FDEFB6D75DF133571064E56ECAF1,10711,0,15,15,29,46,1496
82247,82247,3601FDEFB6D75DF133571064E56ECAF1,11161,16,17,1,32,48,1648
82248,82248,3601FDEFB6D75DF133571064E56ECAF1,10711,19,21,2,29,46,1496
82255,82255,07371D92249265FE55F9673D8539D18E,42301,0,13,13,36,47,1847
82256,82256,07371D92249265FE55F9673D8539D18E,15561,14,15,1,32,22,1622
82257,82257,07371D92249265FE55F9673D8539D18E,42301,19,22,3,36,47,1847
82268,82268,9220114563F56D806676CE0B5F5D1C56,43011,0,1,1,40,42,2042
82269,82269,9220114563F56D806676CE0B5F5D1C56,13341,2,5,3,44,45,2245
82270,82270,9220114563F56D806676CE0B5F5D1C56,43011,7,15,8,40,42,2042
82271,82271,9220114563F56D806676CE0B5F5D1C56,13341,17,19,2,44,45,2245
82272,82272,9220114563F56D806676CE0B5F5D1C56,43011,20,21,1,40,42,2042
82273,82273,9220114563F56D806676CE0B5F5D1C56,10801,22,23,1,42,47,2147
82274,82274,9F4FE5C66D1FE88FA924255DF3CD2B31,11911,0,8,8,37,48,1898
82275,82275,9F4FE5C66D1FE88FA924255DF3CD2B31,13651,10,12,2,30,47,1547
82276,82276,9F4FE5C66D1FE88FA924255DF3CD2B31,11911,13,23,10,37,48,1898
82277,82277,03FE0D0BD52A528C1B4DF1F3C44F085B,42231,2,9,7,37,46,1896
82278,82278,03FE0D0BD52A528C1B4DF1F3C44F085B,42351,9,15,6,38,45,1945
82279,82279,03FE0D0BD52A528C1B4DF1F3C44F085B,11261,15,16,1,36,46,1846
82280,82280,03FE0D0BD52A528C1B4DF1F3C44F085B,42351,16,20,4,38,45,1945
82281,82281,03FE0D0BD52A528C1B4DF1F3C44F085B,11261,20,21,1,36,46,1846
82282,82282,03FE0D0BD52A528C1B4DF1F3C44F085B,42351,21,23,2,38,45,1945
82283,82283,95F5650709CACF923AC8764BA8D78995,42531,2,16,14,31,45,1595
82284,82284,95F5650709CACF923AC8764BA8D78995,42471,20,21,1,35,49,1799
82285,82285,95F5650709CACF923AC8764BA8D78995,10221,21,22,1,34,49,1749
82286,82286,DF189E83BAB7254002D11C89D4F2D51F,10341,0,9,9,31,47,1597
82287,82287,DF189E83BAB7254002D11C89D4F2D51F,12121,10,11,1,29,47,1497
82288,82288,DF189E83BAB7254002D11C89D4F2D51F,10341,11,14,3,31,47,1597
82289,82289,DF189E83BAB7254002D11C89D4F2D51F,12121,14,16,2,29,47,1497
82290,82290,DF189E83BAB7254002D11C89D4F2D51F,10341,18,20,2,31,47,1597
82291,82291,617CDCBB763C8E42460705E2218A65BF,42141,0,5,5,32,47,1647
82292,82292,617CDCBB763C8E42460705E2218A65BF,42523,6,7,1,31,47,1597
82293,82293,617CDCBB763C8E42460705E2218A65BF,42491,7,10,3,32,46,1646
82294,82294,617CDCBB763C8E42460705E2218A65BF,43761,13,14,1,32,47,1647
82295,82295,617CDCBB763C8E42460705E2218A65BF,42523,14,16,2,31,47,1597
82296,82296,617CDCBB763C8E42460705E2218A65BF,43761,16,18,2,32,47,1647
82297,82297,7E462EDE1988B5E44137C4D723C792D0,11921,1,12,11,38,48,1948
82298,82298,7E462EDE1988B5E44137C4D723C792D0,10731,12,14,2,33,47,1697
82299,82299,7E462EDE1988B5E44137C4D723C792D0,43731,14,16,2,34,47,1747
82300,82300,7E462EDE1988B5E44137C4D723C792D0,11331,18,19,1,37,48,1898
82304,82304,BAF8CBAEABDF4063FF5ED369E100E588,12083,0,10,10,36,49,1849
82305,82305,BAF8CBAEABDF4063FF5ED369E100E588,13221,11,13,2,40,47,2047
82306,82306,BAF8CBAEABDF4063FF5ED369E100E588,12083,13,18,5,36,49,1849
82307,82307,BAF8CBAEABDF4063FF5ED369E100E588,11161,20,23,3,32,48,1648
82308,82308,EF7EE9F0825E500C83748044E0BD2521,13651,0,10,10,30,47,1547
82309,82309,EF7EE9F0825E500C83748044E0BD2521,19021,13,15,2,10,45,545
82310,82310,EF7EE9F0825E500C83748044E0BD2521,11381,18,19,1,30,47,1547
82311,82311,EF7EE9F0825E500C83748044E0BD2521,40341,19,20,1,23,49,1199
82312,82312,EF7EE9F0825E500C83748044E0BD2521,13651,20,22,2,30,47,1547
82320,82320,91FEB877F35205B45D1C6BC32E092FE0,13101,0,4,4,40,47,2047
82321,82321,91FEB877F35205B45D1C6BC32E092FE0,10801,7,8,1,42,47,2147
82322,82322,91FEB877F35205B45D1C6BC32E092FE0,42321,11,13,2,43,47,2197
82323,82323,91FEB877F35205B45D1C6BC32E092FE0,10801,16,18,2,42,47,2147
82324,82324,91FEB877F35205B45D1C6BC32E092FE0,40365,20,21,1,42,48,2148
82325,82325,91FEB877F35205B45D1C6BC32E092FE0,13271,21,23,2,41,47,2097
82337,82337,A81638617545A61CA275F98CB5E7FC67,12051,5,13,8,20,47,1047
82338,82338,A81638617545A61CA275F98CB5E7FC67,12601,13,14,1,25,47,1297
82339,82339,A81638617545A61CA275F98CB5E7FC67,10681,16,21,5,30,48,1548
82340,82340,D3BD56A91B629CB820A9599473E8A9CF,10221,0,7,7,34,49,1749
82341,82341,D3BD56A91B629CB820A9599473E8A9CF,41271,7,18,11,38,48,1948
82342,82342,D3BD56A91B629CB820A9599473E8A9CF,11201,19,21,2,35,49,1799
82343,82343,D3BD56A91B629CB820A9599473E8A9CF,10221,21,23,2,34,49,1749
82344,82344,7B1780D02DBAB86C859055603E266F6B,10251,0,10,10,35,47,1797
82345,82345,7B1780D02DBAB86C859055603E266F6B,40094,13,14,1,29,48,1498
82346,82346,7B1780D02DBAB86C859055603E266F6B,13671,15,19,4,27,43,1393
82347,82347,EB723F2604EF7AE7C37A9459E67C1BA0,10171,0,17,17,26,47,1347
82348,82348,EB723F2604EF7AE7C37A9459E67C1BA0,19441,18,19,1,8,46,446
82349,82349,EB723F2604EF7AE7C37A9459E67C1BA0,42041,20,21,1,10,47,547
82350,82350,EB723F2604EF7AE7C37A9459E67C1BA0,19441,21,22,1,8,46,446
82357,82357,27B6DDFE3A356062F221ABD7AD70BB14,11061,0,6,6,29,48,1498
82358,82358,27B6DDFE3A356062F221ABD7AD70BB14,10681,10,11,1,30,48,1548
82359,82359,27B6DDFE3A356062F221ABD7AD70BB14,11061,12,15,3,29,48,1498
82360,82360,27B6DDFE3A356062F221ABD7AD70BB14,10681,18,19,1,30,48,1548
82361,82361,27B6DDFE3A356062F221ABD7AD70BB14,11061,21,23,2,29,48,1498
82362,82362,A2DD7BA75FCE1B5306A377D198F94491,12792,0,2,2,34,30,1730
82363,82363,A2DD7BA75FCE1B5306A377D198F94491,15391,3,14,11,35,26,1776
82364,82364,A2DD7BA75FCE1B5306A377D198F94491,12792,15,18,3,34,30,1730
82365,82365,30262A94D4F59A9D0C4A06975DD2A4EF,11531,7,8,1,34,49,1749
82366,82366,30262A94D4F59A9D0C4A06975DD2A4EF,19021,12,16,4,10,45,545
82367,82367,30262A94D4F59A9D0C4A06975DD2A4EF,13951,18,21,3,47,45,2395
82368,82368,8EBB95E9E256AA88E48FC39B09C04C22,40101,0,3,3,34,49,1749
82369,82369,8EBB95E9E256AA88E48FC39B09C04C22,11231,5,17,12,37,49,1899
82370,82370,8EBB95E9E256AA88E48FC39B09C04C22,10111,21,22,1,37,47,1897
82377,82377,40A3F567657A043546A2ED7A5DC91A85,12792,1,5,4,34,30,1730
82378,82378,40A3F567657A043546A2ED7A5DC91A85,15331,5,11,6,38,24,1924
82379,82379,40A3F567657A043546A2ED7A5DC91A85,12792,11,23,12,34,30,1730
82380,82380,E8104506048C66FE75BF1793EB9DB3FE,12611,1,2,1,41,29,2079
82381,82381,E8104506048C66FE75BF1793EB9DB3FE,15561,3,4,1,32,22,1622
82382,82382,E8104506048C66FE75BF1793EB9DB3FE,43121,8,18,10,25,27,1277
82383,82383,E8104506048C66FE75BF1793EB9DB3FE,13691,22,23,1,47,30,2380
82384,82384,409A27121CD9E6BC90762C45B277F54C,42141,0,6,6,32,47,1647
82385,82385,409A27121CD9E6BC90762C45B277F54C,43281,7,11,4,37,48,1898
82386,82386,409A27121CD9E6BC90762C45B277F54C,11461,11,13,2,37,49,1899
82387,82387,409A27121CD9E6BC90762C45B277F54C,43281,14,17,3,37,48,1898
82388,82388,409A27121CD9E6BC90762C45B277F54C,11861,19,22,3,32,47,1647
82395,82395,ACFFCEADC3F589A8F690FE2669E3730D,42041,10,12,2,10,47,547
82396,82396,ACFFCEADC3F589A8F690FE2669E3730D,19621,15,16,1,5,46,296
82397,82397,ACFFCEADC3F589A8F690FE2669E3730D,42041,21,22,1,10,47,547
82398,82398,ACFFCEADC3F589A8F690FE2669E3730D,19441,22,23,1,8,46,446
82399,82399,37F1D2311F2383134D9A7BD374E33133,13651,0,9,9,30,47,1547
82400,82400,37F1D2311F2383134D9A7BD374E33133,12051,11,15,4,20,47,1047
82401,82401,37F1D2311F2383134D9A7BD374E33133,43751,18,21,3,19,48,998
82406,82406,859846C23309918FCF7E37DF9FD45D9F,42351,0,6,6,38,45,1945
82407,82407,859846C23309918FCF7E37DF9FD45D9F,13911,6,8,2,39,46,1996
82408,82408,859846C23309918FCF7E37DF9FD45D9F,42231,8,11,3,37,46,1896
82409,82409,859846C23309918FCF7E37DF9FD45D9F,13911,14,17,3,39,46,1996
82410,82410,859846C23309918FCF7E37DF9FD45D9F,42231,17,19,2,37,46,1896
82411,82411,859846C23309918FCF7E37DF9FD45D9F,13911,21,23,2,39,46,1996
82412,82412,54AF0735D887B9C0B8CEE7B0E8BAEF2D,11471,0,3,3,12,48,648
82413,82413,54AF0735D887B9C0B8CEE7B0E8BAEF2D,19441,8,15,7,8,46,446
82414,82414,54AF0735D887B9C0B8CEE7B0E8BAEF2D,11851,15,17,2,13,47,697
82415,82415,54AF0735D887B9C0B8CEE7B0E8BAEF2D,19441,18,20,2,8,46,446
82422,82422,4CEF2D9D71549E955305B2DC8309A78D,12641,0,5,5,10,43,543
82423,82423,4CEF2D9D71549E955305B2DC8309A78D,12921,5,10,5,9,41,491
82424,82424,4CEF2D9D71549E955305B2DC8309A78D,12641,10,13,3,10,43,543
82425,82425,4CEF2D9D71549E955305B2DC8309A78D,12921,13,16,3,9,41,491
82426,82426,4CEF2D9D71549E955305B2DC8309A78D,12641,17,23,6,10,43,543
82427,82427,A5F3C0D19512502CA824E2F3864BAA43,10341,0,8,8,31,47,1597
82428,82428,A5F3C0D19512502CA824E2F3864BAA43,11011,13,14,1,39,49,1999
82429,82429,A5F3C0D19512502CA824E2F3864BAA43,43731,16,18,2,34,47,1747
82430,82430,A5F3C0D19512502CA824E2F3864BAA43,10341,20,23,3,31,47,1597
82431,82431,F3B16B9F2FE5D66DD896BE8E61C1FA80,12311,3,4,1,30,44,1544
82432,82432,F3B16B9F2FE5D66DD896BE8E61C1FA80,10301,5,8,3,31,45,1595
82433,82433,F3B16B9F2FE5D66DD896BE8E61C1FA80,10351,10,11,1,28,45,1445
82434,82434,F3B16B9F2FE5D66DD896BE8E61C1FA80,10301,14,18,4,31,45,1595
82435,82435,F3B16B9F2FE5D66DD896BE8E61C1FA80,12311,21,22,1,30,44,1544
82453,82453,1228A94EA6C2D4622CFEAC816DA2851D,12083,8,15,7,36,49,1849
82454,82454,1228A94EA6C2D4622CFEAC816DA2851D,10901,15,18,3,35,48,1798
82455,82455,1228A94EA6C2D4622CFEAC816DA2851D,13221,19,21,2,40,47,2047
82459,82459,6B2E238C2A4978AFB452986609DB74C2,42523,0,4,4,31,47,1597
82460,82460,6B2E238C2A4978AFB452986609DB74C2,10841,11,14,3,37,47,1897
82461,82461,6B2E238C2A4978AFB452986609DB74C2,43761,21,22,1,32,47,1647
82466,82466,84F67B4B3C17ACCABE2B7DC342CF0E8C,16151,0,1,1,13,11,661
82467,82467,84F67B4B3C17ACCABE2B7DC342CF0E8C,15114,2,7,5,22,16,1116
82468,82468,84F67B4B3C17ACCABE2B7DC342CF0E8C,16151,9,22,13,13,11,661
82480,82480,FD176442EBAC53C369FFC23BA871222B,11061,6,8,2,29,48,1498
82481,82481,FD176442EBAC53C369FFC23BA871222B,43971,10,11,1,30,48,1548
82482,82482,FD176442EBAC53C369FFC23BA871222B,19744,13,14,1,6,43,343
82483,82483,FD176442EBAC53C369FFC23BA871222B,19741,15,22,7,5,44,294
82487,82487,775D2A8F104041B3D53BA2721A326EFF,42861,0,12,12,37,44,1894
82488,82488,775D2A8F104041B3D53BA2721A326EFF,42151,12,13,1,35,45,1795
82489,82489,775D2A8F104041B3D53BA2721A326EFF,13951,15,23,8,47,45,2395
82490,82490,3E7942CC71D03F103F23ED151D419DA7,49201,10,13,3,7,41,391
82491,82491,3E7942CC71D03F103F23ED151D419DA7,12921,16,17,1,9,41,491
82492,82492,3E7942CC71D03F103F23ED151D419DA7,19111,20,21,1,9,45,495
82493,82493,3E7942CC71D03F103F23ED151D419DA7,49201,22,23,1,7,41,391
82494,82494,D9346822EE5C3D4AF470325E06B3E3F9,13711,0,1,1,38,46,1946
82495,82495,D9346822EE5C3D4AF470325E06B3E3F9,42351,2,8,6,38,45,1945
82496,82496,D9346822EE5C3D4AF470325E06B3E3F9,42621,15,19,4,24,49,1249
82497,82497,D9346822EE5C3D4AF470325E06B3E3F9,11201,20,21,1,35,49,1799
82498,82498,4FEDDE4724DDA61E19979F6B8E0B84B5,42511,0,1,1,37,47,1897
82499,82499,4FEDDE4724DDA61E19979F6B8E0B84B5,42301,1,7,6,36,47,1847
82500,82500,4FEDDE4724DDA61E19979F6B8E0B84B5,13121,10,12,2,38,46,1946
82501,82501,4FEDDE4724DDA61E19979F6B8E0B84B5,10271,15,18,3,37,46,1896
82502,82502,4FEDDE4724DDA61E19979F6B8E0B84B5,42301,20,22,2,36,47,1847
82506,82506,F48ACAB7B5EF56D0353333EBE84295B8,42381,0,2,2,39,41,1991
82507,82507,F48ACAB7B5EF56D0353333EBE84295B8,43011,3,5,2,40,42,2042
82508,82508,F48ACAB7B5EF56D0353333EBE84295B8,12221,7,16,9,43,44,2194
82509,82509,F48ACAB7B5EF56D0353333EBE84295B8,41591,20,21,1,34,49,1749
82510,82510,0D3CD827A1181C3C1B665AF25454E6A9,12971,0,8,8,32,48,1648
82511,82511,0D3CD827A1181C3C1B665AF25454E6A9,10431,11,15,4,33,49,1699
82512,82512,0D3CD827A1181C3C1B665AF25454E6A9,42581,18,19,1,38,48,1948
82513,82513,0D3CD827A1181C3C1B665AF25454E6A9,10431,20,23,3,33,49,1699
82523,82523,AB1E27033ABBCFEAE4B83A799FB358FD,19744,0,5,5,6,43,343
82524,82524,AB1E27033ABBCFEAE4B83A799FB358FD,12311,6,9,3,30,44,1544
82525,82525,AB1E27033ABBCFEAE4B83A799FB358FD,42531,11,13,2,31,45,1595
82526,82526,AB1E27033ABBCFEAE4B83A799FB358FD,12311,15,18,3,30,44,1544
82527,82527,AB1E27033ABBCFEAE4B83A799FB358FD,19744,19,22,3,6,43,343
82528,82528,BBCB9918D42B41DEDF16DD7F5A9BE26F,11861,0,9,9,32,47,1647
82529,82529,BBCB9918D42B41DEDF16DD7F5A9BE26F,42161,9,12,3,36,47,1847
82530,82530,BBCB9918D42B41DEDF16DD7F5A9BE26F,11911,13,16,3,37,48,1898
82531,82531,BBCB9918D42B41DEDF16DD7F5A9BE26F,11861,17,23,6,32,47,1647
82532,82532,665D84DE00719CFBCFE85E60D38EDE84,13331,10,12,2,38,47,1947
82533,82533,665D84DE00719CFBCFE85E60D38EDE84,11074,15,16,1,37,47,1897
82534,82534,665D84DE00719CFBCFE85E60D38EDE84,11541,21,23,2,35,49,1799
82535,82535,086873B6FDDAA95F5D97B0E7D1FDE099,12514,0,9,9,38,47,1947
82536,82536,086873B6FDDAA95F5D97B0E7D1FDE099,12651,12,13,1,43,47,2197
82537,82537,086873B6FDDAA95F5D97B0E7D1FDE099,12514,14,16,2,38,47,1947
82538,82538,086873B6FDDAA95F5D97B0E7D1FDE099,13381,19,20,1,39,47,1997
82539,82539,AAE32F7F7BC1DB54B5A7606079B9E082,10841,0,3,3,37,47,1897
82540,82540,AAE32F7F7BC1DB54B5A7606079B9E082,13941,4,7,3,41,47,2097
82541,82541,AAE32F7F7BC1DB54B5A7606079B9E082,10841,9,11,2,37,47,1897
82542,82542,AAE32F7F7BC1DB54B5A7606079B9E082,13941,13,15,2,41,47,2097
82543,82543,AAE32F7F7BC1DB54B5A7606079B9E082,10841,17,20,3,37,47,1897
82544,82544,AAE32F7F7BC1DB54B5A7606079B9E082,42523,20,22,2,31,47,1597
82558,82558,95CCF589A9220F3D300E82C46D963125,13111,0,6,6,42,46,2146
82559,82559,95CCF589A9220F3D300E82C46D963125,11231,6,12,6,37,49,1899
82560,82560,95CCF589A9220F3D300E82C46D963125,11201,13,14,1,35,49,1799
82561,82561,95CCF589A9220F3D300E82C46D963125,13111,16,23,7,42,46,2146
82565,82565,809D30997DBB6653E10DF33CB05A97F7,12601,1,2,1,25,47,1297
82566,82566,809D30997DBB6653E10DF33CB05A97F7,13771,2,5,3,21,45,1095
82567,82567,809D30997DBB6653E10DF33CB05A97F7,13094,6,8,2,21,42,1092
82568,82568,809D30997DBB6653E10DF33CB05A97F7,13771,8,23,15,21,45,1095
82569,82569,FC32FCDE5EA162E6A3931CE10EF22190,11021,0,7,7,36,49,1849
82570,82570,FC32FCDE5EA162E6A3931CE10EF22190,11231,7,9,2,37,49,1899
82571,82571,FC32FCDE5EA162E6A3931CE10EF22190,11875,10,11,1,30,46,1546
82572,82572,FC32FCDE5EA162E6A3931CE10EF22190,11231,16,17,1,37,49,1899
82573,82573,FC32FCDE5EA162E6A3931CE10EF22190,11021,18,22,4,36,49,1849
82577,82577,53946D7B52F82D7242CF3E035F861D8E,43471,0,8,8,31,49,1599
82578,82578,53946D7B52F82D7242CF3E035F861D8E,42461,10,12,2,45,47,2297
82579,82579,53946D7B52F82D7242CF3E035F861D8E,42321,16,18,2,43,47,2197
82580,82580,53946D7B52F82D7242CF3E035F861D8E,13731,18,21,3,33,49,1699
82581,82581,52DE1B5B29EB088C4F7CC0D4865B38F5,42151,2,3,1,35,45,1795
82582,82582,52DE1B5B29EB088C4F7CC0D4865B38F5,42861,3,6,3,37,44,1894
82583,82583,52DE1B5B29EB088C4F7CC0D4865B38F5,42151,7,12,5,35,45,1795
82584,82584,52DE1B5B29EB088C4F7CC0D4865B38F5,42861,15,18,3,37,44,1894
82585,82585,52DE1B5B29EB088C4F7CC0D4865B38F5,42151,18,20,2,35,45,1795
82586,82586,B1886EF8F5487F8E8F1A6E89D17F4DF6,12311,0,5,5,30,44,1544
82587,82587,B1886EF8F5487F8E8F1A6E89D17F4DF6,42531,6,7,1,31,45,1595
82588,82588,B1886EF8F5487F8E8F1A6E89D17F4DF6,12311,9,13,4,30,44,1544
82589,82589,B1886EF8F5487F8E8F1A6E89D17F4DF6,42531,15,18,3,31,45,1595
82590,82590,B1886EF8F5487F8E8F1A6E89D17F4DF6,12311,19,21,2,30,44,1544
82594,82594,DC3AF11F1738146F2EAA8C1ED775B312,43751,1,2,1,19,48,998
82595,82595,DC3AF11F1738146F2EAA8C1ED775B312,10061,3,7,4,20,46,1046
82596,82596,DC3AF11F1738146F2EAA8C1ED775B312,10211,9,11,2,16,49,849
82597,82597,DC3AF11F1738146F2EAA8C1ED775B312,42481,13,14,1,22,49,1149
82598,82598,DC3AF11F1738146F2EAA8C1ED775B312,10211,15,17,2,16,49,849
82599,82599,DC3AF11F1738146F2EAA8C1ED775B312,43751,20,23,3,19,48,998
82600,82600,BA7C0D0905AD7B2A4C37AC9B433E8493,11211,2,11,9,34,49,1749
82601,82601,BA7C0D0905AD7B2A4C37AC9B433E8493,10901,16,21,5,35,48,1798
82602,82602,BA7C0D0905AD7B2A4C37AC9B433E8493,13941,22,23,1,41,47,2097
82603,82603,4C6EBE1C4B2FAAFACD17B57BF7692986,10971,1,2,1,35,47,1797
82604,82604,4C6EBE1C4B2FAAFACD17B57BF7692986,10531,3,6,3,34,46,1746
82605,82605,4C6EBE1C4B2FAAFACD17B57BF7692986,43731,9,12,3,34,47,1747
82606,82606,4C6EBE1C4B2FAAFACD17B57BF7692986,42161,14,18,4,36,47,1847
82607,82607,4C6EBE1C4B2FAAFACD17B57BF7692986,43731,20,23,3,34,47,1747
82608,82608,78B9DCFA4CFE02297486B374939C4654,11261,0,7,7,36,46,1846
82609,82609,78B9DCFA4CFE02297486B374939C4654,11061,8,9,1,29,48,1498
82610,82610,78B9DCFA4CFE02297486B374939C4654,11261,10,14,4,36,46,1846
82611,82611,78B9DCFA4CFE02297486B374939C4654,13911,14,15,1,39,46,1996
82612,82612,78B9DCFA4CFE02297486B374939C4654,11261,19,23,4,36,46,1846
82630,82630,2CA7F7242E76579D7DF2C857A1AA360C,12971,0,1,1,32,48,1648
82631,82631,2CA7F7242E76579D7DF2C857A1AA360C,10221,2,11,9,34,49,1749
82632,82632,2CA7F7242E76579D7DF2C857A1AA360C,10511,16,17,1,35,46,1796
82633,82633,2CA7F7242E76579D7DF2C857A1AA360C,10431,17,18,1,33,49,1699
82634,82634,2CA7F7242E76579D7DF2C857A1AA360C,12971,20,23,3,32,48,1648
82642,82642,E47CB0187F3B455859004C1EF3FEE89C,42321,2,4,2,43,47,2197
82643,82643,E47CB0187F3B455859004C1EF3FEE89C,42601,5,17,12,44,48,2248
82644,82644,E47CB0187F3B455859004C1EF3FEE89C,12083,19,20,1,36,49,1849
82645,82645,E47CB0187F3B455859004C1EF3FEE89C,42971,22,23,1,43,49,2199
82646,82646,2898255842570985047C3D77FE88DD08,11541,0,6,6,35,49,1799
82647,82647,2898255842570985047C3D77FE88DD08,11861,9,10,1,32,47,1647
82648,82648,2898255842570985047C3D77FE88DD08,11541,11,21,10,35,49,1799
82649,82649,3577C85A730E9BA639A1091A13B08DEB,43761,1,7,6,32,47,1647
82650,82650,3577C85A730E9BA639A1091A13B08DEB,42523,7,9,2,31,47,1597
82651,82651,3577C85A730E9BA639A1091A13B08DEB,43761,10,17,7,32,47,1647
82652,82652,3577C85A730E9BA639A1091A13B08DEB,42523,17,18,1,31,47,1597
82653,82653,3577C85A730E9BA639A1091A13B08DEB,43761,19,20,1,32,47,1647
82658,82658,8C7DCF60D5A91C4294A8C14ABFA5CFBF,42581,0,1,1,38,48,1948
82659,82659,8C7DCF60D5A91C4294A8C14ABFA5CFBF,43181,2,5,3,39,48,1998
82660,82660,8C7DCF60D5A91C4294A8C14ABFA5CFBF,11271,6,15,9,37,48,1898
82661,82661,8C7DCF60D5A91C4294A8C14ABFA5CFBF,42191,15,16,1,38,49,1949
82662,82662,8C7DCF60D5A91C4294A8C14ABFA5CFBF,11914,17,19,2,37,48,1898
82663,82663,8C7DCF60D5A91C4294A8C14ABFA5CFBF,40077,20,22,2,37,49,1899
82664,82664,41DD0A6027648481BFEC7812042262C9,42351,0,12,12,38,45,1945
82665,82665,41DD0A6027648481BFEC7812042262C9,11231,15,17,2,37,49,1899
82666,82666,41DD0A6027648481BFEC7812042262C9,11171,19,23,4,33,48,1698
82667,82667,C820DFB6DCDFEDB4A3C8495D7C1B9B2F,11021,0,4,4,36,49,1849
82668,82668,C820DFB6DCDFEDB4A3C8495D7C1B9B2F,40341,5,6,1,23,49,1199
82669,82669,C820DFB6DCDFEDB4A3C8495D7C1B9B2F,11021,9,22,13,36,49,1849
82673,82673,34B0487DA91675A6216B605C367EE35D,11061,2,7,5,29,48,1498
82674,82674,34B0487DA91675A6216B605C367EE35D,43581,9,15,6,33,48,1698
82675,82675,34B0487DA91675A6216B605C367EE35D,10221,16,19,3,34,49,1749
82680,82680,EA1B5999CB4B3791BA146422C325007C,10301,9,11,2,31,45,1595
82681,82681,EA1B5999CB4B3791BA146422C325007C,13331,13,14,1,38,47,1947
82682,82682,EA1B5999CB4B3791BA146422C325007C,13121,15,18,3,38,46,1946
82683,82683,87B06393AF137E9C231337A8B047BC19,10471,0,10,10,37,48,1898
82684,82684,87B06393AF137E9C231337A8B047BC19,13094,12,13,1,21,42,1092
82685,82685,87B06393AF137E9C231337A8B047BC19,10471,18,23,5,37,48,1898
82686,82686,27FD8A6CDE751A5F2BC12F75826C7985,12921,6,7,1,9,41,491
82687,82687,27FD8A6CDE751A5F2BC12F75826C7985,43021,7,18,11,16,43,843
82688,82688,27FD8A6CDE751A5F2BC12F75826C7985,12921,19,22,3,9,41,491
82693,82693,A4F650955D0F2E8B3DBCA61C267939BC,10295,0,8,8,30,47,1547
82694,82694,A4F650955D0F2E8B3DBCA61C267939BC,42161,9,17,8,36,47,1847
82695,82695,A4F650955D0F2E8B3DBCA61C267939BC,13651,19,23,4,30,47,1547
82696,82696,346BF3F539A4C5C04EF0491F7207CF76,19931,0,5,5,7,43,393
82697,82697,346BF3F539A4C5C04EF0491F7207CF76,19021,7,16,9,10,45,545
82698,82698,346BF3F539A4C5C04EF0491F7207CF76,19114,20,22,2,7,43,393
82699,82699,9BBFD694A7238D40E5873264958E0503,12131,0,1,1,32,47,1647
82700,82700,9BBFD694A7238D40E5873264958E0503,11461,2,3,1,37,49,1899
82701,82701,9BBFD694A7238D40E5873264958E0503,10491,18,20,2,33,48,1698
82702,82702,257BF4C677D186CA9927857F5C748DC1,43751,0,6,6,19,48,998
82703,82703,257BF4C677D186CA9927857F5C748DC1,42681,7,8,1,24,48,1248
82704,82704,257BF4C677D186CA9927857F5C748DC1,43751,11,23,12,19,48,998
82708,82708,CB51EA3DFBAD71C46F446085843381F3,12792,0,5,5,34,30,1730
82709,82709,CB51EA3DFBAD71C46F446085843381F3,43121,8,9,1,25,27,1277
82710,82710,CB51EA3DFBAD71C46F446085843381F3,15091,13,22,9,35,26,1776
82711,82711,51191F2B77C58517E91204763FB88F68,11381,7,10,3,30,47,1547
82712,82712,51191F2B77C58517E91204763FB88F68,11201,12,13,1,35,49,1799
82713,82713,51191F2B77C58517E91204763FB88F68,40331,14,22,8,30,47,1547
82714,82714,FF0C11254BA355CCA708C36EE5C4353D,11381,0,7,7,30,47,1547
82715,82715,FF0C11254BA355CCA708C36EE5C4353D,42111,8,17,9,44,46,2246
82716,82716,FF0C11254BA355CCA708C36EE5C4353D,11381,18,23,5,30,47,1547
82720,82720,8820D655222FFDC13E2E08EC252AACD5,10971,0,8,8,35,47,1797
82721,82721,8820D655222FFDC13E2E08EC252AACD5,42401,9,10,1,36,47,1847
82722,82722,8820D655222FFDC13E2E08EC252AACD5,10971,14,17,3,35,47,1797
82723,82723,8820D655222FFDC13E2E08EC252AACD5,43731,17,18,1,34,47,1747
82724,82724,8820D655222FFDC13E2E08EC252AACD5,13961,20,22,2,42,48,2148
82729,82729,DC066CD0495E31C3328CCF0DC4172A03,13314,0,6,6,31,39,1589
82730,82730,DC066CD0495E31C3328CCF0DC4172A03,12521,7,16,9,35,41,1791
82731,82731,DC066CD0495E31C3328CCF0DC4172A03,13314,17,23,6,31,39,1589
82732,82732,142B83D2ED91FF08D6AE8FB7B025F33A,42523,0,2,2,31,47,1597
82733,82733,142B83D2ED91FF08D6AE8FB7B025F33A,13651,2,18,16,30,47,1547
82734,82734,142B83D2ED91FF08D6AE8FB7B025F33A,11201,19,21,2,35,49,1799
82735,82735,142B83D2ED91FF08D6AE8FB7B025F33A,13651,22,23,1,30,47,1547
82743,82743,82FCE03B08B3E7EB3B40C06C3C550C7A,10292,0,8,8,30,47,1547
82744,82744,82FCE03B08B3E7EB3B40C06C3C550C7A,42161,10,12,2,36,47,1847
82745,82745,82FCE03B08B3E7EB3B40C06C3C550C7A,10681,14,17,3,30,48,1548
82746,82746,82FCE03B08B3E7EB3B40C06C3C550C7A,10292,18,23,5,30,47,1547
82747,82747,2E5B93B6FE04610C56A0B33EE6E9E88D,43751,0,11,11,19,48,998
82748,82748,2E5B93B6FE04610C56A0B33EE6E9E88D,42691,12,19,7,24,48,1248
82749,82749,2E5B93B6FE04610C56A0B33EE6E9E88D,43751,22,23,1,19,48,998
82750,82750,38EAD9C71E0631172BE43F523D61F0B8,42971,0,8,8,43,49,2199
82751,82751,38EAD9C71E0631172BE43F523D61F0B8,42521,12,15,3,31,47,1597
82752,82752,38EAD9C71E0631172BE43F523D61F0B8,43971,19,21,2,30,48,1548
82756,82756,7691C829AB1912AD1A6AF5EBCE15167D,42281,0,2,2,40,48,2048
82757,82757,7691C829AB1912AD1A6AF5EBCE15167D,10591,2,7,5,39,48,1998
82758,82758,7691C829AB1912AD1A6AF5EBCE15167D,12161,10,12,2,32,46,1646
82759,82759,7691C829AB1912AD1A6AF5EBCE15167D,12131,12,13,1,32,47,1647
82760,82760,7691C829AB1912AD1A6AF5EBCE15167D,12514,16,17,1,38,47,1947
82761,82761,7691C829AB1912AD1A6AF5EBCE15167D,10591,18,23,5,39,48,1998
82762,82762,4EE960BFBECD856B4B08E2C89C467744,19441,0,5,5,8,46,446
82763,82763,4EE960BFBECD856B4B08E2C89C467744,42041,10,11,1,10,47,547
82764,82764,4EE960BFBECD856B4B08E2C89C467744,10951,13,14,1,29,48,1498
82765,82765,4EE960BFBECD856B4B08E2C89C467744,42041,19,20,1,10,47,547
82766,82766,1277ACA424D6A91D4C363B632562549C,12601,0,7,7,25,47,1297
82767,82767,1277ACA424D6A91D4C363B632562549C,11381,7,8,1,30,47,1547
82768,82768,1277ACA424D6A91D4C363B632562549C,10501,9,11,2,22,46,1146
82769,82769,1277ACA424D6A91D4C363B632562549C,12601,12,18,6,25,47,1297
82770,82770,1277ACA424D6A91D4C363B632562549C,10501,18,21,3,22,46,1146
82774,82774,FBC11E52B07B4E171A8F851408C7FBC4,11171,0,8,8,33,48,1698
82775,82775,FBC11E52B07B4E171A8F851408C7FBC4,11231,12,16,4,37,49,1899
82776,82776,FBC11E52B07B4E171A8F851408C7FBC4,10491,17,23,6,33,48,1698
82777,82777,5F14E1A15EFA1C13F8B10CBC543F107C,10191,0,7,7,40,48,2048
82778,82778,5F14E1A15EFA1C13F8B10CBC543F107C,12921,11,12,1,9,41,491
82779,82779,5F14E1A15EFA1C13F8B10CBC543F107C,11531,14,16,2,34,49,1749
82780,82780,5F14E1A15EFA1C13F8B10CBC543F107C,11541,20,23,3,35,49,1799
82781,82781,C8236143E8B93D5FDE499177CF2B28F7,11381,0,5,5,30,47,1547
82782,82782,C8236143E8B93D5FDE499177CF2B28F7,10751,6,18,12,47,43,2393
82783,82783,C8236143E8B93D5FDE499177CF2B28F7,11381,19,23,4,30,47,1547
82784,82784,BBA244405FCBF580331CF1C7DC28986A,12521,1,2,1,35,41,1791
82785,82785,BBA244405FCBF580331CF1C7DC28986A,13671,5,8,3,27,43,1393
82786,82786,BBA244405FCBF580331CF1C7DC28986A,13314,12,23,11,31,39,1589
82787,82787,7C975D0C88EA67D672EB56E3A3056887,13671,0,5,5,27,43,1393
82788,82788,7C975D0C88EA67D672EB56E3A3056887,13314,5,8,3,31,39,1589
82789,82789,7C975D0C88EA67D672EB56E3A3056887,12761,12,14,2,25,40,1290
82790,82790,7C975D0C88EA67D672EB56E3A3056887,13671,18,20,2,27,43,1393
82791,82791,7C975D0C88EA67D672EB56E3A3056887,13314,21,23,2,31,39,1589
82792,82792,CE26B8570DA2E6BAF7525A9993322910,13791,1,8,7,42,47,2147
82793,82793,CE26B8570DA2E6BAF7525A9993322910,41271,10,11,1,38,48,1948
82794,82794,CE26B8570DA2E6BAF7525A9993322910,11781,12,14,2,38,49,1949
82795,82795,CE26B8570DA2E6BAF7525A9993322910,11901,18,19,1,42,49,2149
82796,82796,CE26B8570DA2E6BAF7525A9993322910,42051,20,23,3,42,48,2148
82809,82809,1B8098C9CC4CCB97EDA8DD0174233607,42071,0,1,1,31,49,1599
82810,82810,1B8098C9CC4CCB97EDA8DD0174233607,42081,2,3,1,24,49,1249
82811,82811,1B8098C9CC4CCB97EDA8DD0174233607,42071,4,20,16,31,49,1599
82815,82815,8E7E1D3BA1392AF853A6068E181E9940,12971,0,8,8,32,48,1648
82816,82816,8E7E1D3BA1392AF853A6068E181E9940,10191,10,14,4,40,48,2048
82817,82817,8E7E1D3BA1392AF853A6068E181E9940,12401,18,19,1,39,49,1999
82818,82818,8E7E1D3BA1392AF853A6068E181E9940,10191,21,22,1,40,48,2048
82819,82819,966EF37DD81DE2F009202B5BDDCFCE29,12211,1,2,1,41,44,2094
82820,82820,966EF37DD81DE2F009202B5BDDCFCE29,42351,3,4,1,38,45,1945
82821,82821,966EF37DD81DE2F009202B5BDDCFCE29,42231,8,11,3,37,46,1896
82822,82822,966EF37DD81DE2F009202B5BDDCFCE29,42351,15,16,1,38,45,1945
82823,82823,966EF37DD81DE2F009202B5BDDCFCE29,42231,16,18,2,37,46,1896
82824,82824,0E7D30DBCBD6D42E6B92CA51481CFCBD,42204,1,14,13,43,46,2196
82825,82825,0E7D30DBCBD6D42E6B92CA51481CFCBD,10841,15,16,1,37,47,1897
82826,82826,0E7D30DBCBD6D42E6B92CA51481CFCBD,42204,17,19,2,43,46,2196
82830,82830,DE2C8AE58D9D029E6E1B669A29CC258E,11381,0,13,13,30,47,1547
82831,82831,DE2C8AE58D9D029E6E1B669A29CC258E,10971,13,21,8,35,47,1797
82832,82832,DE2C8AE58D9D029E6E1B669A29CC258E,13331,21,23,2,38,47,1947
82837,82837,6F6BFA140B8F0D41AE13D3CFA2E32A87,19114,0,4,4,7,43,393
82838,82838,6F6BFA140B8F0D41AE13D3CFA2E32A87,11101,6,10,4,18,48,948
82839,82839,6F6BFA140B8F0D41AE13D3CFA2E32A87,19441,12,13,1,8,46,446
82840,82840,6F6BFA140B8F0D41AE13D3CFA2E32A87,12641,16,18,2,10,43,543
82841,82841,6F6BFA140B8F0D41AE13D3CFA2E32A87,19114,21,23,2,7,43,393
82842,82842,F4465124506363C0A3C08E1CA11D8A74,42921,0,1,1,33,47,1697
82843,82843,F4465124506363C0A3C08E1CA11D8A74,11291,2,6,4,40,49,2049
82844,82844,F4465124506363C0A3C08E1CA11D8A74,42921,15,23,8,33,47,1697
82845,82845,6D411464E8569334C6217011CDDAB47B,10281,0,7,7,33,48,1698
82846,82846,6D411464E8569334C6217011CDDAB47B,12311,8,16,8,30,44,1544
82847,82847,6D411464E8569334C6217011CDDAB47B,10281,19,23,4,33,48,1698
82848,82848,2808B465D0CA5BE626B66BA705E41B68,42351,0,1,1,38,45,1945
82849,82849,2808B465D0CA5BE626B66BA705E41B68,13461,3,4,1,39,44,1994
82850,82850,2808B465D0CA5BE626B66BA705E41B68,11261,6,12,6,36,46,1846
82851,82851,2808B465D0CA5BE626B66BA705E41B68,13461,12,13,1,39,44,1994
82852,82852,2808B465D0CA5BE626B66BA705E41B68,11261,18,19,1,36,46,1846
82853,82853,2808B465D0CA5BE626B66BA705E41B68,42351,21,22,1,38,45,1945
82860,82860,4C47EC0C39C9F28EDC8DC5BCBFE753A1,43391,0,6,6,29,48,1498
82861,82861,4C47EC0C39C9F28EDC8DC5BCBFE753A1,40343,8,11,3,24,49,1249
82862,82862,4C47EC0C39C9F28EDC8DC5BCBFE753A1,11061,14,23,9,29,48,1498
82870,82870,3C5BF8354C7B22C00BFA5438C070BC0F,13711,0,14,14,38,46,1946
82871,82871,3C5BF8354C7B22C00BFA5438C070BC0F,43241,15,16,1,36,46,1846
82872,82872,3C5BF8354C7B22C00BFA5438C070BC0F,13711,17,18,1,38,46,1946
82873,82873,3C5BF8354C7B22C00BFA5438C070BC0F,13511,20,23,3,34,48,1748
82874,82874,1DC1D23EFA88D11ECF55784467AE4AA0,42161,1,13,12,36,47,1847
82875,82875,1DC1D23EFA88D11ECF55784467AE4AA0,12601,15,16,1,25,47,1297
82876,82876,1DC1D23EFA88D11ECF55784467AE4AA0,42161,19,20,1,36,47,1847
82877,82877,1DC1D23EFA88D11ECF55784467AE4AA0,40636,21,23,2,35,48,1798
82881,82881,8FEFE64E889EE61DE15E2F7250654F30,11151,5,7,2,30,48,1548
82882,82882,8FEFE64E889EE61DE15E2F7250654F30,10951,9,10,1,29,48,1498
82883,82883,8FEFE64E889EE61DE15E2F7250654F30,11151,13,15,2,30,48,1548
82884,82884,8FEFE64E889EE61DE15E2F7250654F30,11211,16,18,2,34,49,1749
82888,82888,FDA9D6C3558498784AFFBE22F15784BA,12031,0,7,7,33,48,1698
82889,82889,FDA9D6C3558498784AFFBE22F15784BA,42204,9,11,2,43,46,2196
82890,82890,FDA9D6C3558498784AFFBE22F15784BA,12031,13,15,2,33,48,1698
82891,82891,FDA9D6C3558498784AFFBE22F15784BA,11211,15,16,1,34,49,1749
82892,82892,FDA9D6C3558498784AFFBE22F15784BA,12031,17,23,6,33,48,1698
82906,82906,FDBD25E1EECE5A6DDE23321AFCF6ED9A,42331,1,9,8,39,46,1996
82907,82907,FDBD25E1EECE5A6DDE23321AFCF6ED9A,13101,10,11,1,40,47,2047
82908,82908,FDBD25E1EECE5A6DDE23321AFCF6ED9A,42331,13,14,1,39,46,1996
82909,82909,FDBD25E1EECE5A6DDE23321AFCF6ED9A,12514,19,21,2,38,47,1947
82910,82910,FDBD25E1EECE5A6DDE23321AFCF6ED9A,42331,22,23,1,39,46,1996
82911,82911,E42ED8B8B8ABEC36971CD7FB702F959D,11381,0,14,14,30,47,1547
82912,82912,E42ED8B8B8ABEC36971CD7FB702F959D,12601,15,19,4,25,47,1297
82913,82913,E42ED8B8B8ABEC36971CD7FB702F959D,10107,20,23,3,38,49,1949
82914,82914,457B779D00720128DC52229000CD7309,15114,0,6,6,22,16,1116
82915,82915,457B779D00720128DC52229000CD7309,16441,7,8,1,15,17,767
82916,82916,457B779D00720128DC52229000CD7309,15114,11,23,12,22,16,1116
82920,82920,7B63B781AF1E5C1909C9ECFED6946980,10281,0,5,5,33,48,1698
82921,82921,7B63B781AF1E5C1909C9ECFED6946980,43761,5,6,1,32,47,1647
82922,82922,7B63B781AF1E5C1909C9ECFED6946980,42523,6,10,4,31,47,1597
82923,82923,7B63B781AF1E5C1909C9ECFED6946980,43761,10,11,1,32,47,1647
82924,82924,7B63B781AF1E5C1909C9ECFED6946980,42523,15,16,1,31,47,1597
82925,82925,7B63B781AF1E5C1909C9ECFED6946980,43761,17,20,3,32,47,1647
82926,82926,988754F4ACB1FFB14F8ADCC3660BA4EF,13911,0,1,1,39,46,1996
82927,82927,988754F4ACB1FFB14F8ADCC3660BA4EF,12491,2,6,4,36,43,1843
82928,82928,988754F4ACB1FFB14F8ADCC3660BA4EF,11261,6,22,16,36,46,1846
82929,82929,EEF61311F1EBFDE30970AB5D36788DF9,40094,0,3,3,29,48,1498
82930,82930,EEF61311F1EBFDE30970AB5D36788DF9,11151,3,8,5,30,48,1548
82931,82931,EEF61311F1EBFDE30970AB5D36788DF9,40094,12,16,4,29,48,1498
82932,82932,EEF61311F1EBFDE30970AB5D36788DF9,11151,16,17,1,30,48,1548
82933,82933,EEF61311F1EBFDE30970AB5D36788DF9,10381,18,19,1,31,49,1599
82937,82937,946768BFA72752D5660750415178C67F,11131,5,7,2,33,48,1698
82938,82938,946768BFA72752D5660750415178C67F,11021,10,12,2,36,49,1849
82939,82939,946768BFA72752D5660750415178C67F,11491,17,18,1,36,47,1847
82940,82940,946768BFA72752D5660750415178C67F,10271,20,21,1,37,46,1896
82941,82941,6B301C33659FC7DDF1FEBEFD22E1FEA8,42931,1,9,8,41,49,2099
82942,82942,6B301C33659FC7DDF1FEBEFD22E1FEA8,42523,14,15,1,31,47,1597
82943,82943,6B301C33659FC7DDF1FEBEFD22E1FEA8,43761,15,21,6,32,47,1647
82944,82944,B0DB1916CBE4951CF5091A191DB66ADA,13271,0,2,2,41,47,2097
82945,82945,B0DB1916CBE4951CF5091A191DB66ADA,13101,3,4,1,40,47,2047
82946,82946,B0DB1916CBE4951CF5091A191DB66ADA,13271,5,6,1,41,47,2097
82947,82947,B0DB1916CBE4951CF5091A191DB66ADA,13101,7,8,1,40,47,2047
82948,82948,B0DB1916CBE4951CF5091A191DB66ADA,40833,13,20,7,41,47,2097
82949,82949,3E43826B2F3C90E1974FF5F797EBAA40,42581,2,3,1,38,48,1948
82950,82950,3E43826B2F3C90E1974FF5F797EBAA40,13731,17,18,1,33,49,1699
82951,82951,3E43826B2F3C90E1974FF5F797EBAA40,42581,22,23,1,38,48,1948
82956,82956,8FB396EBB8080CBF505403788B4290EA,11381,1,5,4,30,47,1547
82957,82957,8FB396EBB8080CBF505403788B4290EA,19031,7,9,2,1,42,92
82958,82958,8FB396EBB8080CBF505403788B4290EA,11061,11,13,2,29,48,1498
82959,82959,8FB396EBB8080CBF505403788B4290EA,11381,14,15,1,30,47,1547
82960,82960,8FB396EBB8080CBF505403788B4290EA,10107,19,21,2,38,49,1949
82965,82965,39179060954ADF536A44D5CDC3D7ADA4,10921,0,4,4,43,48,2198
82966,82966,39179060954ADF536A44D5CDC3D7ADA4,13911,5,16,11,39,46,1996
82967,82967,39179060954ADF536A44D5CDC3D7ADA4,10921,21,23,2,43,48,2198
82968,82968,6F56DCCCA49704FE0EF89D218610398B,43061,2,6,4,43,46,2196
82969,82969,6F56DCCCA49704FE0EF89D218610398B,13341,7,16,9,44,45,2245
82970,82970,6F56DCCCA49704FE0EF89D218610398B,40171,18,19,1,38,48,1948
82971,82971,6F56DCCCA49704FE0EF89D218610398B,13341,21,22,1,44,45,2245
82972,82972,BA6D45213D52989026A398B5D7995374,43021,0,4,4,16,43,843
82973,82973,BA6D45213D52989026A398B5D7995374,12921,6,13,7,9,41,491
82974,82974,BA6D45213D52989026A398B5D7995374,19181,15,16,1,8,40,440
82975,82975,BA6D45213D52989026A398B5D7995374,43021,17,20,3,16,43,843
82976,82976,639EA486291B8A87A84D90343A87732A,11111,0,7,7,26,48,1348
82977,82977,639EA486291B8A87A84D90343A87732A,10661,9,10,1,37,49,1899
82978,82978,639EA486291B8A87A84D90343A87732A,11811,15,19,4,38,49,1949
82979,82979,639EA486291B8A87A84D90343A87732A,11111,22,23,1,26,48,1348
82984,82984,37BD03DA3640C8FC43CC9AEC3929D65F,15391,3,4,1,35,26,1776
82985,82985,37BD03DA3640C8FC43CC9AEC3929D65F,12792,7,18,11,34,30,1730
82986,82986,37BD03DA3640C8FC43CC9AEC3929D65F,15391,19,20,1,35,26,1776
82987,82987,5F5D54734B085794361A6D766F7F8809,43471,0,9,9,31,49,1599
82988,82988,5F5D54734B085794361A6D766F7F8809,15401,11,13,2,39,25,1975
82989,82989,5F5D54734B085794361A6D766F7F8809,15391,13,15,2,35,26,1776
82990,82990,5F5D54734B085794361A6D766F7F8809,15661,15,16,1,36,26,1826
82991,82991,5F5D54734B085794361A6D766F7F8809,43471,21,23,2,31,49,1599
82998,82998,C94109F455448027CE60D8FE61F82261,42071,0,6,6,31,49,1599
82999,82999,C94109F455448027CE60D8FE61F82261,11021,7,9,2,36,49,1849
83000,83000,C94109F455448027CE60D8FE61F82261,42071,11,13,2,31,49,1599
83001,83001,C94109F455448027CE60D8FE61F82261,42121,17,18,1,26,49,1349
83002,83002,6616443CB107D4E473B237D1BF50DC9E,10901,0,2,2,35,48,1798
83003,83003,6616443CB107D4E473B237D1BF50DC9E,10421,15,18,3,41,48,2098
83004,83004,6616443CB107D4E473B237D1BF50DC9E,10901,18,23,5,35,48,1798
83008,83008,9DF75BD4336800A216E8A9FB4E5FA693,43751,5,10,5,19,48,998
83009,83009,9DF75BD4336800A216E8A9FB4E5FA693,12581,15,16,1,24,48,1248
83010,83010,9DF75BD4336800A216E8A9FB4E5FA693,43751,17,19,2,19,48,998
83014,83014,1EE2B4662D91A666115765FFC90D9A2E,43311,0,6,6,31,48,1598
83015,83015,1EE2B4662D91A666115765FFC90D9A2E,11061,7,8,1,29,48,1498
83016,83016,1EE2B4662D91A666115765FFC90D9A2E,11381,11,13,2,30,47,1547
83017,83017,1EE2B4662D91A666115765FFC90D9A2E,11061,16,18,2,29,48,1498
83018,83018,1EE2B4662D91A666115765FFC90D9A2E,43311,21,22,1,31,48,1598
83022,83022,1B79EB886A5576DB94A20A87F2358771,43751,0,13,13,19,48,998
83023,83023,1B79EB886A5576DB94A20A87F2358771,42681,15,16,1,24,48,1248
83024,83024,1B79EB886A5576DB94A20A87F2358771,43751,17,23,6,19,48,998
83031,83031,292AD485DA7AE4FB3CFCA1190DC036DF,13911,0,1,1,39,46,1996
83032,83032,292AD485DA7AE4FB3CFCA1190DC036DF,42351,2,5,3,38,45,1945
83033,83033,292AD485DA7AE4FB3CFCA1190DC036DF,42231,6,11,5,37,46,1896
83034,83034,292AD485DA7AE4FB3CFCA1190DC036DF,13911,14,16,2,39,46,1996
83035,83035,292AD485DA7AE4FB3CFCA1190DC036DF,42231,17,19,2,37,46,1896
83036,83036,292AD485DA7AE4FB3CFCA1190DC036DF,42351,21,23,2,38,45,1945
83037,83037,2BB5E6319C361908A67DD8509286CF7C,19031,0,6,6,1,42,92
83038,83038,2BB5E6319C361908A67DD8509286CF7C,12641,7,10,3,10,43,543
83039,83039,2BB5E6319C361908A67DD8509286CF7C,19031,10,23,13,1,42,92
83043,83043,1FBAD7CACF10B61EB546D98E0D7B2D7B,12031,0,8,8,33,48,1698
83044,83044,1FBAD7CACF10B61EB546D98E0D7B2D7B,13111,9,11,2,42,46,2146
83045,83045,1FBAD7CACF10B61EB546D98E0D7B2D7B,12031,13,15,2,33,48,1698
83046,83046,1FBAD7CACF10B61EB546D98E0D7B2D7B,11211,16,17,1,34,49,1749
83047,83047,1FBAD7CACF10B61EB546D98E0D7B2D7B,12031,18,23,5,33,48,1698
83048,83048,980FD4871A5FBB4200B84A7CE63A3AD6,42491,2,6,4,32,46,1646
83049,83049,980FD4871A5FBB4200B84A7CE63A3AD6,42523,7,11,4,31,47,1597
83050,83050,980FD4871A5FBB4200B84A7CE63A3AD6,11324,14,15,1,31,46,1596
83051,83051,980FD4871A5FBB4200B84A7CE63A3AD6,42523,15,16,1,31,47,1597
83052,83052,980FD4871A5FBB4200B84A7CE63A3AD6,42491,19,20,1,32,46,1646
83061,83061,755A1FA6C962DCA1F0C6C27EDC12A160,13371,0,7,7,41,47,2097
83062,83062,755A1FA6C962DCA1F0C6C27EDC12A160,12601,8,10,2,25,47,1297
83063,83063,755A1FA6C962DCA1F0C6C27EDC12A160,13371,12,17,5,41,47,2097
83064,83064,755A1FA6C962DCA1F0C6C27EDC12A160,10107,17,20,3,38,49,1949
83065,83065,755A1FA6C962DCA1F0C6C27EDC12A160,13371,21,23,2,41,47,2097
83089,83089,AA71E9A6AEA764D2564D532D0321512B,11571,2,4,2,13,46,696
83090,83090,AA71E9A6AEA764D2564D532D0321512B,42041,5,6,1,10,47,547
83091,83091,AA71E9A6AEA764D2564D532D0321512B,11471,6,8,2,12,48,648
83092,83092,AA71E9A6AEA764D2564D532D0321512B,19441,9,18,9,8,46,446
83096,83096,71AB304A084EB4095E1F705C48CB0E23,11901,0,6,6,42,49,2149
83097,83097,71AB304A084EB4095E1F705C48CB0E23,11914,7,16,9,37,48,1898
83098,83098,71AB304A084EB4095E1F705C48CB0E23,11901,19,23,4,42,49,2149
83099,83099,F74E1805BD471CD67AFEC7E33078A7FE,11914,0,4,4,37,48,1898
83100,83100,F74E1805BD471CD67AFEC7E33078A7FE,43361,7,10,3,38,48,1948
83101,83101,F74E1805BD471CD67AFEC7E33078A7FE,11914,10,13,3,37,48,1898
83102,83102,F74E1805BD471CD67AFEC7E33078A7FE,43361,16,18,2,38,48,1948
83103,83103,F74E1805BD471CD67AFEC7E33078A7FE,11914,19,21,2,37,48,1898
83104,83104,56ED2D2B5AA3633303FE9BBB79BC00A1,12311,0,8,8,30,44,1544
83105,83105,56ED2D2B5AA3633303FE9BBB79BC00A1,11875,10,15,5,30,46,1546
83106,83106,56ED2D2B5AA3633303FE9BBB79BC00A1,12311,19,20,1,30,44,1544
83107,83107,56ED2D2B5AA3633303FE9BBB79BC00A1,11861,20,22,2,32,47,1647
83108,83108,B8BEE4316240369D7D9EFEDD287F001E,42021,0,8,8,33,47,1697
83109,83109,B8BEE4316240369D7D9EFEDD287F001E,11861,11,15,4,32,47,1647
83110,83110,B8BEE4316240369D7D9EFEDD287F001E,43281,15,16,1,37,48,1898
83111,83111,B8BEE4316240369D7D9EFEDD287F001E,42921,18,23,5,33,47,1697
83120,83120,4CA7727345FE5410FF8669E86CE37E32,19031,0,4,4,1,42,92
83121,83121,4CA7727345FE5410FF8669E86CE37E32,12641,5,17,12,10,43,543
83122,83122,4CA7727345FE5410FF8669E86CE37E32,19181,17,18,1,8,40,440
83123,83123,BB72FBDB509C0EDC7CB7986BE504F263,12661,0,7,7,32,45,1645
83124,83124,BB72FBDB509C0EDC7CB7986BE504F263,13341,11,12,1,44,45,2245
83125,83125,BB72FBDB509C0EDC7CB7986BE504F263,42201,15,17,2,43,46,2196
83126,83126,BB72FBDB509C0EDC7CB7986BE504F263,12661,22,23,1,32,45,1645
83127,83127,71C7D3BEB879651EE771977BC4EF34E5,10341,0,6,6,31,47,1597
83128,83128,71C7D3BEB879651EE771977BC4EF34E5,12311,8,10,2,30,44,1544
83129,83129,71C7D3BEB879651EE771977BC4EF34E5,12661,12,13,1,32,45,1645
83130,83130,71C7D3BEB879651EE771977BC4EF34E5,10351,15,17,2,28,45,1445
83131,83131,71C7D3BEB879651EE771977BC4EF34E5,12311,18,19,1,30,44,1544
83132,83132,71C7D3BEB879651EE771977BC4EF34E5,10341,20,23,3,31,47,1597
83143,83143,A3BFED7EBC8273A150663075EB9361B2,11271,2,6,4,37,48,1898
83144,83144,A3BFED7EBC8273A150663075EB9361B2,40181,6,7,1,37,49,1899
83145,83145,A3BFED7EBC8273A150663075EB9361B2,12391,8,9,1,36,49,1849
83146,83146,A3BFED7EBC8273A150663075EB9361B2,11271,9,11,2,37,48,1898
83147,83147,A3BFED7EBC8273A150663075EB9361B2,12391,11,13,2,36,49,1849
83148,83148,A3BFED7EBC8273A150663075EB9361B2,40181,15,16,1,37,49,1899
83149,83149,A3BFED7EBC8273A150663075EB9361B2,11271,19,20,1,37,48,1898
83150,83150,A3BFED7EBC8273A150663075EB9361B2,10661,20,22,2,37,49,1899
83157,83157,D5B8C5235ADB84B7998BAE6507D2CE64,10381,7,11,4,31,49,1599
83158,83158,D5B8C5235ADB84B7998BAE6507D2CE64,10544,13,18,5,28,48,1448
83159,83159,D5B8C5235ADB84B7998BAE6507D2CE64,42501,18,19,1,28,47,1447
83160,83160,D5B8C5235ADB84B7998BAE6507D2CE64,10381,20,21,1,31,49,1599
83161,83161,419CA953287F9842BC18AF90C47CBA2A,10691,0,7,7,33,48,1698
83162,83162,419CA953287F9842BC18AF90C47CBA2A,42204,7,15,8,43,46,2196
83163,83163,419CA953287F9842BC18AF90C47CBA2A,10691,19,23,4,33,48,1698
83170,83170,BF5242715718EEF665EE93EC69F552EB,13101,1,10,9,40,47,2047
83171,83171,BF5242715718EEF665EE93EC69F552EB,13271,12,15,3,41,47,2097
83172,83172,BF5242715718EEF665EE93EC69F552EB,11481,15,17,2,41,48,2098
83173,83173,BF5242715718EEF665EE93EC69F552EB,12021,18,20,2,37,49,1899
83174,83174,BF5242715718EEF665EE93EC69F552EB,13101,22,23,1,40,47,2047
83175,83175,6224797A94401F7316FE4DF239A66FE7,12221,0,10,10,43,44,2194
83176,83176,6224797A94401F7316FE4DF239A66FE7,12561,12,16,4,45,43,2293
83177,83177,6224797A94401F7316FE4DF239A66FE7,13911,20,22,2,39,46,1996
83178,83178,6224797A94401F7316FE4DF239A66FE7,42633,22,23,1,42,46,2146
83182,83182,F7AAD8355D0FB48A1E8C914954424109,10731,0,6,6,33,47,1697
83183,83183,F7AAD8355D0FB48A1E8C914954424109,11831,7,12,5,32,45,1645
83184,83184,F7AAD8355D0FB48A1E8C914954424109,42921,15,17,2,33,47,1697
83185,83185,F7AAD8355D0FB48A1E8C914954424109,11834,17,21,4,32,45,1645
83186,83186,F7AAD8355D0FB48A1E8C914954424109,10731,21,22,1,33,47,1697
83187,83187,A0E829F4319BFCF37BA7414AFCB09FF1,11074,0,9,9,37,47,1897
83188,83188,A0E829F4319BFCF37BA7414AFCB09FF1,41005,10,11,1,38,47,1947
83189,83189,A0E829F4319BFCF37BA7414AFCB09FF1,11074,13,15,2,37,47,1897
83190,83190,A0E829F4319BFCF37BA7414AFCB09FF1,42221,17,19,2,38,48,1948
83191,83191,A0E829F4319BFCF37BA7414AFCB09FF1,41005,22,23,1,38,47,1947
83198,83198,3C1FE3D867D28EEDD89D2AE77037BF3E,43581,1,7,6,33,48,1698
83199,83199,3C1FE3D867D28EEDD89D2AE77037BF3E,42231,9,12,3,37,46,1896
83200,83200,3C1FE3D867D28EEDD89D2AE77037BF3E,42511,12,13,1,37,47,1897
83201,83201,3C1FE3D867D28EEDD89D2AE77037BF3E,11541,16,21,5,35,49,1799
83210,83210,8D1AFC57DD4959BC02935BD14C9B0A32,11471,0,2,2,12,48,648
83211,83211,8D1AFC57DD4959BC02935BD14C9B0A32,19441,3,18,15,8,46,446
83212,83212,8D1AFC57DD4959BC02935BD14C9B0A32,42041,20,21,1,10,47,547
83213,83213,B7C38298C00B5719B985378BBFDFB0B8,43971,6,7,1,30,48,1548
83214,83214,B7C38298C00B5719B985378BBFDFB0B8,13601,8,9,1,34,47,1747
83215,83215,B7C38298C00B5719B985378BBFDFB0B8,11074,11,13,2,37,47,1897
83216,83216,B7C38298C00B5719B985378BBFDFB0B8,13601,15,23,8,34,47,1747
83217,83217,2DEEBB48AA143492C3327B09EC5E3064,40101,0,6,6,34,49,1749
83218,83218,2DEEBB48AA143492C3327B09EC5E3064,11201,6,7,1,35,49,1799
83219,83219,2DEEBB48AA143492C3327B09EC5E3064,10221,8,9,1,34,49,1749
83220,83220,2DEEBB48AA143492C3327B09EC5E3064,13094,11,16,5,21,42,1092
83221,83221,2DEEBB48AA143492C3327B09EC5E3064,40101,21,23,2,34,49,1749
83222,83222,8141A730EF01126DFD9282AFDEA49317,40637,2,6,4,36,47,1847
83223,83223,8141A730EF01126DFD9282AFDEA49317,12121,11,12,1,29,47,1497
83224,83224,8141A730EF01126DFD9282AFDEA49317,11351,12,23,11,36,48,1848
83225,83225,37CA6FC93298247417BA55BAFA788505,11061,0,1,1,29,48,1498
83226,83226,37CA6FC93298247417BA55BAFA788505,11351,2,8,6,36,48,1848
83227,83227,37CA6FC93298247417BA55BAFA788505,42523,9,12,3,31,47,1597
83228,83228,37CA6FC93298247417BA55BAFA788505,11731,19,23,4,36,48,1848
83233,83233,D1DF8B8CF696B3934AD219B19DE51DE4,11811,0,2,2,38,49,1949
83234,83234,D1DF8B8CF696B3934AD219B19DE51DE4,10251,2,11,9,35,47,1797
83235,83235,D1DF8B8CF696B3934AD219B19DE51DE4,11811,15,17,2,38,49,1949
83236,83236,D1DF8B8CF696B3934AD219B19DE51DE4,43361,18,21,3,38,48,1948
83237,83237,668B25EA27DB62433F6B97341A2F29D6,10251,0,8,8,35,47,1797
83238,83238,668B25EA27DB62433F6B97341A2F29D6,11875,11,12,1,30,46,1546
83239,83239,668B25EA27DB62433F6B97341A2F29D6,10251,13,23,10,35,47,1797
83247,83247,97C2BF5A29CED539C43A6B4C2D504EB5,11701,0,11,11,43,48,2198
83248,83248,97C2BF5A29CED539C43A6B4C2D504EB5,40277,12,15,3,35,49,1799
83249,83249,97C2BF5A29CED539C43A6B4C2D504EB5,42161,16,21,5,36,47,1847
83253,83253,0EEF00D524FC221E0814F0ECEF97AD09,10544,0,2,2,28,48,1448
83254,83254,0EEF00D524FC221E0814F0ECEF97AD09,42831,2,5,3,27,48,1398
83255,83255,0EEF00D524FC221E0814F0ECEF97AD09,10544,6,8,2,28,48,1448
83256,83256,0EEF00D524FC221E0814F0ECEF97AD09,43501,12,20,8,27,48,1398
83257,83257,0EEF00D524FC221E0814F0ECEF97AD09,10107,20,22,2,38,49,1949
83258,83258,0EEF00D524FC221E0814F0ECEF97AD09,10544,22,23,1,28,48,1448
83259,83259,A4568B18E470D509060E9E98454BE847,10351,0,3,3,28,45,1445
83260,83260,A4568B18E470D509060E9E98454BE847,12601,3,6,3,25,47,1297
83261,83261,A4568B18E470D509060E9E98454BE847,13771,7,8,1,21,45,1095
83262,83262,A4568B18E470D509060E9E98454BE847,12601,10,20,10,25,47,1297
83263,83263,62DDFD12FD80957CA0268CDDC1A48DA2,11151,0,1,1,30,48,1548
83264,83264,62DDFD12FD80957CA0268CDDC1A48DA2,43391,1,8,7,29,48,1498
83265,83265,62DDFD12FD80957CA0268CDDC1A48DA2,11151,8,14,6,30,48,1548
83266,83266,62DDFD12FD80957CA0268CDDC1A48DA2,43391,15,16,1,29,48,1498
83267,83267,62DDFD12FD80957CA0268CDDC1A48DA2,11151,16,22,6,30,48,1548
83272,83272,EFBD35E04D1D2A6AB930447D9AF55992,11551,0,1,1,39,49,1999
83273,83273,EFBD35E04D1D2A6AB930447D9AF55992,42301,15,20,5,36,47,1847
83274,83274,EFBD35E04D1D2A6AB930447D9AF55992,10111,20,22,2,37,47,1897
83275,83275,FEE5ACDB24DFF6E9A25C550C618C43AE,40673,3,4,1,36,48,1848
83276,83276,FEE5ACDB24DFF6E9A25C550C618C43AE,42161,4,9,5,36,47,1847
83277,83277,FEE5ACDB24DFF6E9A25C550C618C43AE,10251,12,17,5,35,47,1797
83278,83278,FEE5ACDB24DFF6E9A25C550C618C43AE,11941,18,19,1,37,46,1896
83279,83279,FEE5ACDB24DFF6E9A25C550C618C43AE,40951,20,22,2,36,49,1849
83280,83280,FEE5ACDB24DFF6E9A25C550C618C43AE,10251,22,23,1,35,47,1797
83284,83284,609B49FC6A5F2051B191B22D52271D49,40891,1,10,9,37,47,1897
83285,83285,609B49FC6A5F2051B191B22D52271D49,12521,13,16,3,35,41,1791
83286,83286,609B49FC6A5F2051B191B22D52271D49,10841,19,20,1,37,47,1897
83287,83287,E02F64059E677B81EAF8B96D760DDB0F,15143,0,7,7,18,7,907
83288,83288,E02F64059E677B81EAF8B96D760DDB0F,16281,9,17,8,11,4,554
83289,83289,E02F64059E677B81EAF8B96D760DDB0F,15143,17,22,5,18,7,907
83302,83302,B51991AF4ACE325C0342855E568A0491,12051,1,4,3,20,47,1047
83303,83303,B51991AF4ACE325C0342855E568A0491,11361,6,7,1,22,48,1148
83304,83304,B51991AF4ACE325C0342855E568A0491,12581,9,11,2,24,48,1248
83305,83305,B51991AF4ACE325C0342855E568A0491,12051,11,23,12,20,47,1047
83312,83312,F13D3DEE3873922393A59999280D3E31,42071,6,8,2,31,49,1599
83313,83313,F13D3DEE3873922393A59999280D3E31,10451,11,13,2,25,48,1298
83314,83314,F13D3DEE3873922393A59999280D3E31,42071,17,18,1,31,49,1599
83315,83315,784B731FB48DA266D31BFD4ACBDB8A39,11021,0,8,8,36,49,1849
83316,83316,784B731FB48DA266D31BFD4ACBDB8A39,10811,9,10,1,38,46,1946
83317,83317,784B731FB48DA266D31BFD4ACBDB8A39,11021,12,23,11,36,49,1849
83318,83318,D8A76E089BFF36425F7258A5A82E7975,42321,0,1,1,43,47,2197
83319,83319,D8A76E089BFF36425F7258A5A82E7975,10801,1,4,3,42,47,2147
83320,83320,D8A76E089BFF36425F7258A5A82E7975,13941,5,12,7,41,47,2097
83321,83321,D8A76E089BFF36425F7258A5A82E7975,42321,12,15,3,43,47,2197
83322,83322,D8A76E089BFF36425F7258A5A82E7975,13941,19,21,2,41,47,2097
83323,83323,7861278735CDA91B9BABB196FBF7605C,43951,0,5,5,49,41,2491
83324,83324,7861278735CDA91B9BABB196FBF7605C,13951,12,17,5,47,45,2395
83325,83325,7861278735CDA91B9BABB196FBF7605C,43951,17,21,4,49,41,2491
83326,83326,EDAB0C0B8195ECBA5ACF0AFE7CCDE2D3,13461,0,1,1,39,44,1994
83327,83327,EDAB0C0B8195ECBA5ACF0AFE7CCDE2D3,13231,1,3,2,39,46,1996
83328,83328,EDAB0C0B8195ECBA5ACF0AFE7CCDE2D3,42861,6,17,11,37,44,1894
83329,83329,EDAB0C0B8195ECBA5ACF0AFE7CCDE2D3,11261,19,20,1,36,46,1846
83330,83330,09E35A3086ED2C100882D697DC471A83,42231,0,9,9,37,46,1896
83331,83331,09E35A3086ED2C100882D697DC471A83,11861,10,16,6,32,47,1647
83332,83332,09E35A3086ED2C100882D697DC471A83,42231,19,21,2,37,46,1896
83333,83333,09E35A3086ED2C100882D697DC471A83,13711,21,22,1,38,46,1946
83334,83334,8860F485E5911A51D7DB4B8D2B543310,42204,10,11,1,43,46,2196
83335,83335,8860F485E5911A51D7DB4B8D2B543310,15653,15,16,1,40,25,2025
83336,83336,8860F485E5911A51D7DB4B8D2B543310,42301,19,21,2,36,47,1847
83337,83337,8860F485E5911A51D7DB4B8D2B543310,11021,21,23,2,36,49,1849
83338,83338,459FC13F46F4ADFF5396006102B4142A,42601,0,1,1,44,48,2248
83339,83339,459FC13F46F4ADFF5396006102B4142A,13111,3,4,1,42,46,2146
83340,83340,459FC13F46F4ADFF5396006102B4142A,42204,7,8,1,43,46,2196
83341,83341,459FC13F46F4ADFF5396006102B4142A,10924,9,10,1,43,49,2199
83342,83342,459FC13F46F4ADFF5396006102B4142A,42091,15,16,1,43,46,2196
83343,83343,459FC13F46F4ADFF5396006102B4142A,13111,21,23,2,42,46,2146
83344,83344,6AD981E757B177FB5B64F1D1D2EAA27F,10901,0,1,1,35,48,1798
83345,83345,6AD981E757B177FB5B64F1D1D2EAA27F,10771,2,9,7,41,46,2096
83346,83346,6AD981E757B177FB5B64F1D1D2EAA27F,10971,10,11,1,35,47,1797
83347,83347,6AD981E757B177FB5B64F1D1D2EAA27F,10901,15,23,8,35,48,1798
83372,83372,00B181DD66423FB09C5417E3C6EB3025,12511,0,1,1,39,47,1997
83373,83373,00B181DD66423FB09C5417E3C6EB3025,13941,3,5,2,41,47,2097
83374,83374,00B181DD66423FB09C5417E3C6EB3025,42321,6,8,2,43,47,2197
83375,83375,00B181DD66423FB09C5417E3C6EB3025,42941,15,16,1,37,47,1897
83376,83376,00B181DD66423FB09C5417E3C6EB3025,12121,19,20,1,29,47,1497
83377,83377,0CB53170B0580516D256BCBB9691DC54,11861,0,10,10,32,47,1647
83378,83378,0CB53170B0580516D256BCBB9691DC54,12083,13,18,5,36,49,1849
83379,83379,0CB53170B0580516D256BCBB9691DC54,11861,22,23,1,32,47,1647
83383,83383,CE0A4CCE99BE3E0C12C8AD0F52E9AE51,42071,2,10,8,31,49,1599
83384,83384,CE0A4CCE99BE3E0C12C8AD0F52E9AE51,42261,12,13,1,25,49,1299
83385,83385,CE0A4CCE99BE3E0C12C8AD0F52E9AE51,42071,14,18,4,31,49,1599
83386,83386,1CDF6C6970CBC7D24D606B7FD41E9D6C,12641,0,8,8,10,43,543
83387,83387,1CDF6C6970CBC7D24D606B7FD41E9D6C,12921,10,16,6,9,41,491
83388,83388,1CDF6C6970CBC7D24D606B7FD41E9D6C,19114,19,20,1,7,43,393
83389,83389,1CDF6C6970CBC7D24D606B7FD41E9D6C,12921,20,22,2,9,41,491
83390,83390,1CDF6C6970CBC7D24D606B7FD41E9D6C,12641,22,23,1,10,43,543
83391,83391,AA9DDBAE747C0C61A76E689DD898E315,42301,0,7,7,36,47,1847
83392,83392,AA9DDBAE747C0C61A76E689DD898E315,10301,7,10,3,31,45,1595
83393,83393,AA9DDBAE747C0C61A76E689DD898E315,42871,12,13,1,30,45,1545
83394,83394,AA9DDBAE747C0C61A76E689DD898E315,12311,13,16,3,30,44,1544
83395,83395,AA9DDBAE747C0C61A76E689DD898E315,42301,18,22,4,36,47,1847
83406,83406,0FB5FA6E5FD19BCDFACF335C2D092AC6,11324,0,7,7,31,46,1596
83407,83407,0FB5FA6E5FD19BCDFACF335C2D092AC6,43451,9,17,8,37,40,1890
83408,83408,0FB5FA6E5FD19BCDFACF335C2D092AC6,10781,18,20,2,35,47,1797
83409,83409,DE17516082F25E2D46D107AE8D072D0B,43311,0,13,13,31,48,1598
83410,83410,DE17516082F25E2D46D107AE8D072D0B,10221,14,15,1,34,49,1749
83411,83411,DE17516082F25E2D46D107AE8D072D0B,11731,16,18,2,36,48,1848
83412,83412,DE17516082F25E2D46D107AE8D072D0B,11161,19,23,4,32,48,1648
83413,83413,12F01F702C58A326E76270B66B78946A,43061,0,8,8,43,46,2196
83414,83414,12F01F702C58A326E76270B66B78946A,40951,13,15,2,36,49,1849
83415,83415,12F01F702C58A326E76270B66B78946A,43061,16,23,7,43,46,2196
83416,83416,0F784CBCB73AEA2648D885974B30C4FB,42371,0,7,7,34,46,1746
83417,83417,0F784CBCB73AEA2648D885974B30C4FB,12601,9,17,8,25,47,1297
83418,83418,0F784CBCB73AEA2648D885974B30C4FB,42371,18,23,5,34,46,1746
83422,83422,EB3039C415C508F2A2DCF6403E75C42C,43021,1,5,4,16,43,843
83423,83423,EB3039C415C508F2A2DCF6403E75C42C,12921,7,21,14,9,41,491
83424,83424,EB3039C415C508F2A2DCF6403E75C42C,43021,21,23,2,16,43,843
83435,83435,2242A0C42502E5FAF42331EAEF91866A,19264,0,4,4,10,36,536
83436,83436,2242A0C42502E5FAF42331EAEF91866A,12871,9,15,6,22,33,1133
83437,83437,2242A0C42502E5FAF42331EAEF91866A,19264,19,21,2,10,36,536
83438,83438,7ACE3A6233C5892843B04912C5D83A2F,42321,0,7,7,43,47,2197
83439,83439,7ACE3A6233C5892843B04912C5D83A2F,13951,10,11,1,47,45,2395
83440,83440,7ACE3A6233C5892843B04912C5D83A2F,12021,15,17,2,37,49,1899
83441,83441,7ACE3A6233C5892843B04912C5D83A2F,42321,18,23,5,43,47,2197
83442,83442,F475546FA2D112D7D0EDED3FAB477F8E,40801,0,8,8,43,46,2196
83443,83443,F475546FA2D112D7D0EDED3FAB477F8E,10251,8,10,2,35,47,1797
83444,83444,F475546FA2D112D7D0EDED3FAB477F8E,40801,11,19,8,43,46,2196
83445,83445,F475546FA2D112D7D0EDED3FAB477F8E,11074,19,21,2,37,47,1897
83446,83446,F475546FA2D112D7D0EDED3FAB477F8E,40801,21,23,2,43,46,2196
83450,83450,EF05FB842A1E901414445EBF59786A4F,13941,2,4,2,41,47,2097
83451,83451,EF05FB842A1E901414445EBF59786A4F,12971,4,9,5,32,48,1648
83452,83452,EF05FB842A1E901414445EBF59786A4F,13941,11,17,6,41,47,2097
83453,83453,EF05FB842A1E901414445EBF59786A4F,13111,17,19,2,42,46,2146
83454,83454,EF05FB842A1E901414445EBF59786A4F,13941,21,23,2,41,47,2097
83461,83461,C0C88AF8BA6186FF52C981D818FF206C,10721,0,10,10,31,48,1598
83462,83462,C0C88AF8BA6186FF52C981D818FF206C,42623,11,13,2,22,49,1149
83463,83463,C0C88AF8BA6186FF52C981D818FF206C,10721,15,23,8,31,48,1598
83467,83467,ED329B71006D1766A598ADE6F5BD2F71,11321,0,6,6,31,46,1596
83468,83468,ED329B71006D1766A598ADE6F5BD2F71,12311,7,8,1,30,44,1544
83469,83469,ED329B71006D1766A598ADE6F5BD2F71,11321,12,13,1,31,46,1596
83470,83470,ED329B71006D1766A598ADE6F5BD2F71,12311,15,18,3,30,44,1544
83471,83471,ED329B71006D1766A598ADE6F5BD2F71,11321,19,23,4,31,46,1596
83475,83475,F446BD66986C8D0106C0CF1D69F54FAE,42371,0,6,6,34,46,1746
83476,83476,F446BD66986C8D0106C0CF1D69F54FAE,12661,8,9,1,32,45,1645
83477,83477,F446BD66986C8D0106C0CF1D69F54FAE,12311,10,11,1,30,44,1544
83478,83478,F446BD66986C8D0106C0CF1D69F54FAE,13671,13,21,8,27,43,1393
83479,83479,714C0145DA512D375AD8C8EEC9A58FD1,42201,10,13,3,43,46,2196
83480,83480,714C0145DA512D375AD8C8EEC9A58FD1,10107,15,16,1,38,49,1949
83481,83481,714C0145DA512D375AD8C8EEC9A58FD1,11201,18,22,4,35,49,1799
83482,83482,7779D5C4E5073D864A9050EB76A5AC64,11261,2,4,2,36,46,1846
83483,83483,7779D5C4E5073D864A9050EB76A5AC64,43341,5,7,2,41,46,2096
83484,83484,7779D5C4E5073D864A9050EB76A5AC64,11261,10,13,3,36,46,1846
83485,83485,7779D5C4E5073D864A9050EB76A5AC64,43341,14,15,1,41,46,2096
83486,83486,7779D5C4E5073D864A9050EB76A5AC64,42351,16,17,1,38,45,1945
83487,83487,7779D5C4E5073D864A9050EB76A5AC64,11261,18,20,2,36,46,1846
83492,83492,CA269BAD556781918B5BA94C8942431A,42871,1,3,2,30,45,1545
83493,83493,CA269BAD556781918B5BA94C8942431A,11261,8,9,1,36,46,1846
83494,83494,CA269BAD556781918B5BA94C8942431A,13911,11,17,6,39,46,1996
83495,83495,CA269BAD556781918B5BA94C8942431A,11261,18,19,1,36,46,1846
83499,83499,D3E10CE72D4AD84FD9BC70DA697D3C48,11571,0,4,4,13,46,696
83500,83500,D3E10CE72D4AD84FD9BC70DA697D3C48,19441,4,6,2,8,46,446
83501,83501,D3E10CE72D4AD84FD9BC70DA697D3C48,19021,7,8,1,10,45,545
83502,83502,D3E10CE72D4AD84FD9BC70DA697D3C48,43021,10,11,1,16,43,843
83503,83503,D3E10CE72D4AD84FD9BC70DA697D3C48,19021,16,18,2,10,45,545
83504,83504,D3E10CE72D4AD84FD9BC70DA697D3C48,43021,19,20,1,16,43,843
83508,83508,C1A76D9FE1BCABD0CDD8E880D0795C34,40891,0,7,7,37,47,1897
83509,83509,C1A76D9FE1BCABD0CDD8E880D0795C34,11381,9,13,4,30,47,1547
83510,83510,C1A76D9FE1BCABD0CDD8E880D0795C34,12221,15,17,2,43,44,2194
83511,83511,C1A76D9FE1BCABD0CDD8E880D0795C34,11271,19,21,2,37,48,1898
83512,83512,C1A76D9FE1BCABD0CDD8E880D0795C34,10841,22,23,1,37,47,1897
83513,83513,CEEEE12D961020D889C4958F8C670187,42861,1,5,4,37,44,1894
83514,83514,CEEEE12D961020D889C4958F8C670187,11261,7,8,1,36,46,1846
83515,83515,CEEEE12D961020D889C4958F8C670187,42151,10,13,3,35,45,1795
83516,83516,CEEEE12D961020D889C4958F8C670187,42861,15,16,1,37,44,1894
83517,83517,CEEEE12D961020D889C4958F8C670187,42151,16,18,2,35,45,1795
83518,83518,CEEEE12D961020D889C4958F8C670187,42861,19,21,2,37,44,1894
83519,83519,4515D69DA9DF7C67BD58AB71BAA57E58,11331,0,8,8,37,48,1898
83520,83520,4515D69DA9DF7C67BD58AB71BAA57E58,40343,8,15,7,24,49,1249
83521,83521,4515D69DA9DF7C67BD58AB71BAA57E58,11331,19,22,3,37,48,1898
83522,83522,8C93E9687A717AEFB87364B357E16B82,10911,0,2,2,39,46,1996
83523,83523,8C93E9687A717AEFB87364B357E16B82,10251,2,11,9,35,47,1797
83524,83524,8C93E9687A717AEFB87364B357E16B82,11001,13,15,2,42,47,2147
83525,83525,8C93E9687A717AEFB87364B357E16B82,10911,17,18,1,39,46,1996
83540,83540,D59A2A795558AA457F13EDE8D62837D5,11461,0,13,13,37,49,1899
83541,83541,D59A2A795558AA457F13EDE8D62837D5,12641,16,18,2,10,43,543
83542,83542,D59A2A795558AA457F13EDE8D62837D5,11461,20,22,2,37,49,1899
83543,83543,11FECEE7865049CDA55CAB34FACD3089,12311,0,6,6,30,44,1544
83544,83544,11FECEE7865049CDA55CAB34FACD3089,11381,9,11,2,30,47,1547
83545,83545,11FECEE7865049CDA55CAB34FACD3089,11871,11,13,2,29,46,1496
83546,83546,11FECEE7865049CDA55CAB34FACD3089,11875,13,15,2,30,46,1546
83547,83547,11FECEE7865049CDA55CAB34FACD3089,11061,15,16,1,29,48,1498
83548,83548,11FECEE7865049CDA55CAB34FACD3089,11871,18,19,1,29,46,1496
83549,83549,11FECEE7865049CDA55CAB34FACD3089,10301,19,21,2,31,45,1595
83550,83550,11FECEE7865049CDA55CAB34FACD3089,11875,21,23,2,30,46,1546
83558,83558,823BB637426A4B64F4A56D087D45C241,49201,0,1,1,7,41,391
83559,83559,823BB637426A4B64F4A56D087D45C241,12641,2,3,1,10,43,543
83560,83560,823BB637426A4B64F4A56D087D45C241,49201,5,7,2,7,41,391
83561,83561,823BB637426A4B64F4A56D087D45C241,12921,9,12,3,9,41,491
83562,83562,823BB637426A4B64F4A56D087D45C241,49201,13,23,10,7,41,391
83566,83566,E7D13D922A1B600C3FF10C90AE32F045,12491,0,12,12,36,43,1843
83567,83567,E7D13D922A1B600C3FF10C90AE32F045,11261,15,18,3,36,46,1846
83568,83568,E7D13D922A1B600C3FF10C90AE32F045,12211,19,22,3,41,44,2094
83569,83569,BD23461971395615C4DFBEA8F5A6E3B3,42961,0,6,6,35,49,1799
83570,83570,BD23461971395615C4DFBEA8F5A6E3B3,11061,7,18,11,29,48,1498
83571,83571,BD23461971395615C4DFBEA8F5A6E3B3,12391,19,23,4,36,49,1849
83575,83575,D604CE1D6F1A7F1409A082A5844B835D,10292,0,8,8,30,47,1547
83576,83576,D604CE1D6F1A7F1409A082A5844B835D,12601,8,11,3,25,47,1297
83577,83577,D604CE1D6F1A7F1409A082A5844B835D,10292,13,14,1,30,47,1547
83578,83578,D604CE1D6F1A7F1409A082A5844B835D,12601,15,16,1,25,47,1297
83579,83579,D604CE1D6F1A7F1409A082A5844B835D,10292,20,23,3,30,47,1547
83583,83583,728BD7A3608732BAF29F7C650A6A54B2,11231,0,1,1,37,49,1899
83584,83584,728BD7A3608732BAF29F7C650A6A54B2,43341,2,13,11,41,46,2096
83585,83585,728BD7A3608732BAF29F7C650A6A54B2,13371,18,20,2,41,47,2097
83586,83586,728BD7A3608732BAF29F7C650A6A54B2,43341,21,23,2,41,46,2096
83590,83590,16D740AE27D92BE968DE244652195181,13671,0,6,6,27,43,1393
83591,83591,16D740AE27D92BE968DE244652195181,12761,6,8,2,25,40,1290
83592,83592,16D740AE27D92BE968DE244652195181,13671,11,15,4,27,43,1393
83593,83593,16D740AE27D92BE968DE244652195181,10951,15,18,3,29,48,1498
83601,83601,42171C55BE0006DB5CFC504C991D1532,11101,0,11,11,18,48,948
83602,83602,42171C55BE0006DB5CFC504C991D1532,42321,13,15,2,43,47,2197
83603,83603,42171C55BE0006DB5CFC504C991D1532,43041,20,23,3,41,46,2096
83604,83604,CDB95A3DD4178327A9D9EE22837ADCC0,40171,2,12,10,38,48,1948
83605,83605,CDB95A3DD4178327A9D9EE22837ADCC0,42231,19,20,1,37,46,1896
83606,83606,CDB95A3DD4178327A9D9EE22837ADCC0,11631,22,23,1,12,49,649
83607,83607,7C5210855A5DFB6ACF7A087ADA0E2F3D,13911,1,2,1,39,46,1996
83608,83608,7C5210855A5DFB6ACF7A087ADA0E2F3D,42351,4,5,1,38,45,1945
83609,83609,7C5210855A5DFB6ACF7A087ADA0E2F3D,13911,5,7,2,39,46,1996
83610,83610,7C5210855A5DFB6ACF7A087ADA0E2F3D,42231,7,9,2,37,46,1896
83611,83611,7C5210855A5DFB6ACF7A087ADA0E2F3D,13911,9,22,13,39,46,1996
83615,83615,9437129F84751E1C2490DB0BBAFB8B36,15051,8,13,5,19,4,954
83616,83616,9437129F84751E1C2490DB0BBAFB8B36,16281,13,17,4,11,4,554
83617,83617,9437129F84751E1C2490DB0BBAFB8B36,15051,18,23,5,19,4,954
83618,83618,446AC7E279C6659F3E40FC9C0B9B7F45,13341,4,6,2,44,45,2245
83619,83619,446AC7E279C6659F3E40FC9C0B9B7F45,43061,6,9,3,43,46,2196
83620,83620,446AC7E279C6659F3E40FC9C0B9B7F45,13341,14,15,1,44,45,2245
83621,83621,446AC7E279C6659F3E40FC9C0B9B7F45,42631,16,17,1,43,45,2195
83622,83622,446AC7E279C6659F3E40FC9C0B9B7F45,13341,18,23,5,44,45,2245
83623,83623,EC4330687AFAD23F392FAEF4FB4107B7,11491,0,8,8,36,47,1847
83624,83624,EC4330687AFAD23F392FAEF4FB4107B7,11081,10,12,2,35,46,1796
83625,83625,EC4330687AFAD23F392FAEF4FB4107B7,11111,15,16,1,26,48,1348
83626,83626,EC4330687AFAD23F392FAEF4FB4107B7,40431,18,23,5,36,47,1847
83636,83636,CE355671904C744921C19AF2A27D28F5,19744,0,5,5,6,43,343
83637,83637,CE355671904C744921C19AF2A27D28F5,12921,7,8,1,9,41,491
83638,83638,CE355671904C744921C19AF2A27D28F5,19744,12,23,11,6,43,343
83639,83639,C7D4935453BFEC1CB164593EE1B84EA4,15391,0,10,10,35,26,1776
83640,83640,C7D4935453BFEC1CB164593EE1B84EA4,12792,10,13,3,34,30,1730
83641,83641,C7D4935453BFEC1CB164593EE1B84EA4,15391,13,23,10,35,26,1776
83645,83645,5C96E9B05EB3EFE9DE3B43368A9F3BB9,42401,0,8,8,36,47,1847
83646,83646,5C96E9B05EB3EFE9DE3B43368A9F3BB9,10161,9,16,7,35,49,1799
83647,83647,5C96E9B05EB3EFE9DE3B43368A9F3BB9,42491,17,19,2,32,46,1646
83648,83648,5C96E9B05EB3EFE9DE3B43368A9F3BB9,42161,21,23,2,36,47,1847
83658,83658,68233A8ECF508EC4F1A54A497AD0F3D0,11541,0,1,1,35,49,1799
83659,83659,68233A8ECF508EC4F1A54A497AD0F3D0,13651,12,13,1,30,47,1547
83660,83660,68233A8ECF508EC4F1A54A497AD0F3D0,11021,18,19,1,36,49,1849
83661,83661,66A1757BF5A4116BA4BCC483D90F56EF,13911,0,7,7,39,46,1996
83662,83662,66A1757BF5A4116BA4BCC483D90F56EF,42351,8,10,2,38,45,1945
83663,83663,66A1757BF5A4116BA4BCC483D90F56EF,42231,11,12,1,37,46,1896
83664,83664,66A1757BF5A4116BA4BCC483D90F56EF,42351,13,15,2,38,45,1945
83665,83665,66A1757BF5A4116BA4BCC483D90F56EF,41007,16,17,1,37,47,1897
83666,83666,66A1757BF5A4116BA4BCC483D90F56EF,42231,18,20,2,37,46,1896
83690,83690,99B2123974B4742CCAE355E715186AD6,10281,0,7,7,33,48,1698
83691,83691,99B2123974B4742CCAE355E715186AD6,11861,10,12,2,32,47,1647
83692,83692,99B2123974B4742CCAE355E715186AD6,10281,13,15,2,33,48,1698
83693,83693,99B2123974B4742CCAE355E715186AD6,11861,16,17,1,32,47,1647
83694,83694,99B2123974B4742CCAE355E715186AD6,10281,18,23,5,33,48,1698
83695,83695,EA84EDCB7C9475F6273168934FDD6476,19441,1,7,6,8,46,446
83696,83696,EA84EDCB7C9475F6273168934FDD6476,42041,7,9,2,10,47,547
83697,83697,EA84EDCB7C9475F6273168934FDD6476,19441,13,15,2,8,46,446
83698,83698,EA84EDCB7C9475F6273168934FDD6476,11571,18,20,2,13,46,696
83699,83699,EA84EDCB7C9475F6273168934FDD6476,19441,21,23,2,8,46,446
83700,83700,D7349708A10855AEF98FEB8D22C33E59,40833,0,7,7,41,47,2097
83701,83701,D7349708A10855AEF98FEB8D22C33E59,11231,8,17,9,37,49,1899
83702,83702,D7349708A10855AEF98FEB8D22C33E59,13271,20,23,3,41,47,2097
83703,83703,903BC7C5B3846AB22A9162C0B635F49F,43761,9,11,2,32,47,1647
83704,83704,903BC7C5B3846AB22A9162C0B635F49F,40951,15,16,1,36,49,1849
83705,83705,903BC7C5B3846AB22A9162C0B635F49F,10295,18,20,2,30,47,1547
83706,83706,903BC7C5B3846AB22A9162C0B635F49F,42471,21,22,1,35,49,1799
83707,83707,5AF85D9ED958D0E5348613692DAC5B4D,12083,1,13,12,36,49,1849
83708,83708,5AF85D9ED958D0E5348613692DAC5B4D,11541,15,17,2,35,49,1799
83709,83709,5AF85D9ED958D0E5348613692DAC5B4D,11861,19,21,2,32,47,1647
83710,83710,525655B30753832E11A6455806FEB5D9,11941,0,11,11,37,46,1896
83711,83711,525655B30753832E11A6455806FEB5D9,11201,12,13,1,35,49,1799
83712,83712,525655B30753832E11A6455806FEB5D9,13121,16,17,1,38,46,1946
83713,83713,525655B30753832E11A6455806FEB5D9,10511,18,20,2,35,46,1796
83714,83714,525655B30753832E11A6455806FEB5D9,40094,21,23,2,29,48,1498
83719,83719,02520C980C83C228272F82E550C0374E,11151,0,8,8,30,48,1548
83720,83720,02520C980C83C228272F82E550C0374E,10107,13,16,3,38,49,1949
83721,83721,02520C980C83C228272F82E550C0374E,10731,20,21,1,33,47,1697
83722,83722,C645C910C47A8D54684C650F67C490EB,13341,0,8,8,44,45,2245
83723,83723,C645C910C47A8D54684C650F67C490EB,11481,9,10,1,41,48,2098
83724,83724,C645C910C47A8D54684C650F67C490EB,13341,13,23,10,44,45,2245
83728,83728,92E1BAA88B052422B820ED36A9E8F107,41392,0,6,6,43,48,2198
83729,83729,92E1BAA88B052422B820ED36A9E8F107,11794,7,8,1,38,49,1949
83730,83730,92E1BAA88B052422B820ED36A9E8F107,11701,11,23,12,43,48,2198
83734,83734,ACD04627348D28EB014FAB46490D4B92,10351,0,2,2,28,45,1445
83735,83735,ACD04627348D28EB014FAB46490D4B92,13771,2,8,6,21,45,1095
83736,83736,ACD04627348D28EB014FAB46490D4B92,12601,13,15,2,25,47,1297
83737,83737,ACD04627348D28EB014FAB46490D4B92,10351,16,20,4,28,45,1445
83738,83738,ACD04627348D28EB014FAB46490D4B92,12601,20,22,2,25,47,1297
83743,83743,2C8D86692AE365367C699CBAAA0C190E,15411,0,8,8,44,27,2227
83744,83744,2C8D86692AE365367C699CBAAA0C190E,12792,9,13,4,34,30,1730
83745,83745,2C8D86692AE365367C699CBAAA0C190E,15411,13,19,6,44,27,2227
83746,83746,2C8D86692AE365367C699CBAAA0C190E,15311,19,21,2,43,25,2175
83757,83757,D54F9F7B5ACE26D54228A669C839B9DF,42231,0,5,5,37,46,1896
83758,83758,D54F9F7B5ACE26D54228A669C839B9DF,42351,6,7,1,38,45,1945
83759,83759,D54F9F7B5ACE26D54228A669C839B9DF,42231,7,11,4,37,46,1896
83760,83760,D54F9F7B5ACE26D54228A669C839B9DF,42351,13,16,3,38,45,1945
83761,83761,D54F9F7B5ACE26D54228A669C839B9DF,42231,17,23,6,37,46,1896
83773,83773,F004825C5EEC7F8B7A184D4985895C55,13341,0,6,6,44,45,2245
83774,83774,F004825C5EEC7F8B7A184D4985895C55,42631,7,8,1,43,45,2195
83775,83775,F004825C5EEC7F8B7A184D4985895C55,13341,12,16,4,44,45,2245
83776,83776,F004825C5EEC7F8B7A184D4985895C55,42631,17,18,1,43,45,2195
83777,83777,F004825C5EEC7F8B7A184D4985895C55,13341,22,23,1,44,45,2245
83778,83778,8436FA510D59B3814E50B7F18BD1D92C,43644,1,3,2,14,38,738
83779,83779,8436FA510D59B3814E50B7F18BD1D92C,12641,7,9,2,10,43,543
83780,83780,8436FA510D59B3814E50B7F18BD1D92C,19571,11,13,2,1,36,86
83781,83781,8436FA510D59B3814E50B7F18BD1D92C,12641,15,17,2,10,43,543
83782,83782,8436FA510D59B3814E50B7F18BD1D92C,19261,20,23,3,6,37,337
83799,83799,4A05C11F924E5E77EEF26908B87D29D6,10691,0,7,7,33,48,1698
83800,83800,4A05C11F924E5E77EEF26908B87D29D6,12521,8,15,7,35,41,1791
83801,83801,4A05C11F924E5E77EEF26908B87D29D6,10691,19,23,4,33,48,1698
83802,83802,1C0548F40841AD0870DAD8EC7BECCBC6,13314,0,7,7,31,39,1589
83803,83803,1C0548F40841AD0870DAD8EC7BECCBC6,12521,7,17,10,35,41,1791
83804,83804,1C0548F40841AD0870DAD8EC7BECCBC6,13314,20,22,2,31,39,1589
83805,83805,E648A6F090A3BE85617E0ED54A73B4F0,12671,0,1,1,21,43,1093
83806,83806,E648A6F090A3BE85617E0ED54A73B4F0,10351,3,5,2,28,45,1445
83807,83807,E648A6F090A3BE85617E0ED54A73B4F0,12601,9,23,14,25,47,1297
83808,83808,4D0ED6C01EC55D2BA8CCC5E44CD25B70,13121,0,7,7,38,46,1946
83809,83809,4D0ED6C01EC55D2BA8CCC5E44CD25B70,12381,8,17,9,32,48,1648
83810,83810,4D0ED6C01EC55D2BA8CCC5E44CD25B70,11941,19,23,4,37,46,1896
83811,83811,3B8FB8720B738954F0287E8A91FB9A89,43751,0,13,13,19,48,998
83812,83812,3B8FB8720B738954F0287E8A91FB9A89,12581,15,16,1,24,48,1248
83813,83813,3B8FB8720B738954F0287E8A91FB9A89,43751,21,22,1,19,48,998
83814,83814,3C07D1557002BF4F1AA6A6D7A8949EF2,42523,0,4,4,31,47,1597
83815,83815,3C07D1557002BF4F1AA6A6D7A8949EF2,12601,8,17,9,25,47,1297
83816,83816,3C07D1557002BF4F1AA6A6D7A8949EF2,42523,19,20,1,31,47,1597
83820,83820,2F66AC01887397A198C9CCA6611EA97B,12521,0,13,13,35,41,1791
83821,83821,2F66AC01887397A198C9CCA6611EA97B,13314,13,17,4,31,39,1589
83822,83822,2F66AC01887397A198C9CCA6611EA97B,12521,17,23,6,35,41,1791
83823,83823,9C686B624E1F19B96755FA9920EEF4B6,42271,0,1,1,40,47,2047
83824,83824,9C686B624E1F19B96755FA9920EEF4B6,42921,4,7,3,33,47,1697
83825,83825,9C686B624E1F19B96755FA9920EEF4B6,13561,12,16,4,37,49,1899
83826,83826,9C686B624E1F19B96755FA9920EEF4B6,43161,18,19,1,35,47,1797
83827,83827,9C686B624E1F19B96755FA9920EEF4B6,10111,20,23,3,37,47,1897
83828,83828,1089C0BE5216A591F3582EF7A99E7609,43161,0,6,6,35,47,1797
83829,83829,1089C0BE5216A591F3582EF7A99E7609,11261,11,12,1,36,46,1846
83830,83830,1089C0BE5216A591F3582EF7A99E7609,42231,15,16,1,37,46,1896
83831,83831,1089C0BE5216A591F3582EF7A99E7609,42781,17,18,1,36,46,1846
83832,83832,1089C0BE5216A591F3582EF7A99E7609,43161,19,21,2,35,47,1797
83833,83833,1089C0BE5216A591F3582EF7A99E7609,10271,22,23,1,37,46,1896
83834,83834,3AB35E62E3464B5074E82DE69E9DD0D9,42501,0,8,8,28,47,1447
83835,83835,3AB35E62E3464B5074E82DE69E9DD0D9,19441,9,17,8,8,46,446
83836,83836,3AB35E62E3464B5074E82DE69E9DD0D9,42501,18,23,5,28,47,1447
83837,83837,C7C431E83C90A041B3FA2A63798CE4F8,43021,0,1,1,16,43,843
83838,83838,C7C431E83C90A041B3FA2A63798CE4F8,12921,2,4,2,9,41,491
83839,83839,C7C431E83C90A041B3FA2A63798CE4F8,43021,4,11,7,16,43,843
83840,83840,C7C431E83C90A041B3FA2A63798CE4F8,12921,12,13,1,9,41,491
83841,83841,C7C431E83C90A041B3FA2A63798CE4F8,43021,14,19,5,16,43,843
83854,83854,5DC656AE1F755A21D4CE0049D29039D4,12521,2,4,2,35,41,1791
83855,83855,5DC656AE1F755A21D4CE0049D29039D4,12491,4,5,1,36,43,1843
83856,83856,5DC656AE1F755A21D4CE0049D29039D4,12521,6,8,2,35,41,1791
83857,83857,5DC656AE1F755A21D4CE0049D29039D4,12491,8,10,2,36,43,1843
83858,83858,5DC656AE1F755A21D4CE0049D29039D4,40951,13,17,4,36,49,1849
83859,83859,5DC656AE1F755A21D4CE0049D29039D4,11751,17,19,2,35,48,1798
83860,83860,5DC656AE1F755A21D4CE0049D29039D4,11261,20,23,3,36,46,1846
83861,83861,6D66725D0B9803C07583F5B30C783245,42531,4,12,8,31,45,1595
83862,83862,6D66725D0B9803C07583F5B30C783245,42111,17,18,1,44,46,2246
83863,83863,6D66725D0B9803C07583F5B30C783245,12311,19,20,1,30,44,1544
83864,83864,6D66725D0B9803C07583F5B30C783245,42531,20,21,1,31,45,1595
83865,83865,7E6ABF38A691D9304A64197B5968007E,42461,1,4,3,45,47,2297
83866,83866,7E6ABF38A691D9304A64197B5968007E,42321,6,17,11,43,47,2197
83867,83867,7E6ABF38A691D9304A64197B5968007E,42461,18,19,1,45,47,2297
83868,83868,7E6ABF38A691D9304A64197B5968007E,42321,20,21,1,43,47,2197
83869,83869,7E6ABF38A691D9304A64197B5968007E,42461,22,23,1,45,47,2297
83874,83874,76DA946F4DC1318DD46A32E1D303D6B7,12521,0,13,13,35,41,1791
83875,83875,76DA946F4DC1318DD46A32E1D303D6B7,13314,13,15,2,31,39,1589
83876,83876,76DA946F4DC1318DD46A32E1D303D6B7,12521,15,23,8,35,41,1791
83877,83877,A67F50337E2EC43D03A4976B44AE2823,42204,0,1,1,43,46,2196
83878,83878,A67F50337E2EC43D03A4976B44AE2823,11941,4,6,2,37,46,1896
83879,83879,A67F50337E2EC43D03A4976B44AE2823,13711,6,7,1,38,46,1946
83880,83880,A67F50337E2EC43D03A4976B44AE2823,11941,8,10,2,37,46,1896
83881,83881,A67F50337E2EC43D03A4976B44AE2823,10107,15,21,6,38,49,1949
83882,83882,658F12866DF04DEFD1752C8716ACBB95,42551,0,6,6,14,48,748
83883,83883,658F12866DF04DEFD1752C8716ACBB95,19441,9,12,3,8,46,446
83884,83884,658F12866DF04DEFD1752C8716ACBB95,42551,12,13,1,14,48,748
83885,83885,658F12866DF04DEFD1752C8716ACBB95,19901,19,20,1,7,44,394
83886,83886,658F12866DF04DEFD1752C8716ACBB95,42551,21,22,1,14,48,748
83890,83890,68D66AC2F31097852E1113FCAC38B096,12121,5,6,1,29,47,1497
83891,83891,68D66AC2F31097852E1113FCAC38B096,42531,10,12,2,31,45,1595
83892,83892,68D66AC2F31097852E1113FCAC38B096,12311,12,15,3,30,44,1544
83893,83893,68D66AC2F31097852E1113FCAC38B096,42531,17,19,2,31,45,1595
83894,83894,68D66AC2F31097852E1113FCAC38B096,12311,20,22,2,30,44,1544
83895,83895,E886E5251030835554FC7C0727BBE348,12874,0,5,5,20,34,1034
83896,83896,E886E5251030835554FC7C0727BBE348,43121,8,16,8,25,27,1277
83897,83897,E886E5251030835554FC7C0727BBE348,12871,17,22,5,22,33,1133
83901,83901,04D73C3CD00D40CB611F6BA5801F802C,13314,0,6,6,31,39,1589
83902,83902,04D73C3CD00D40CB611F6BA5801F802C,12521,7,8,1,35,41,1791
83903,83903,04D73C3CD00D40CB611F6BA5801F802C,13314,12,23,11,31,39,1589
83904,83904,D5AEB0275C07F9A43E4282B7A52A66F5,11061,0,16,16,29,48,1498
83905,83905,D5AEB0275C07F9A43E4282B7A52A66F5,40951,17,18,1,36,49,1849
83906,83906,D5AEB0275C07F9A43E4282B7A52A66F5,11061,19,22,3,29,48,1498
83907,83907,5B93149195498C1BB1324829076057CC,13711,0,9,9,38,46,1946
83908,83908,5B93149195498C1BB1324829076057CC,40341,10,15,5,23,49,1199
83909,83909,5B93149195498C1BB1324829076057CC,13711,18,22,4,38,46,1946
83910,83910,3167279CE8CFD8F4AA7B1E5335A41089,11151,0,8,8,30,48,1548
83911,83911,3167279CE8CFD8F4AA7B1E5335A41089,12601,12,17,5,25,47,1297
83912,83912,3167279CE8CFD8F4AA7B1E5335A41089,12051,20,21,1,20,47,1047
83913,83913,5F09B173620062093E73818D879CF79B,43021,0,5,5,16,43,843
83914,83914,5F09B173620062093E73818D879CF79B,12121,6,7,1,29,47,1497
83915,83915,5F09B173620062093E73818D879CF79B,43021,8,23,15,16,43,843
83919,83919,3C98F7394473AF286503765E077D8C3A,19181,0,1,1,8,40,440
83920,83920,3C98F7394473AF286503765E077D8C3A,49201,4,6,2,7,41,391
83921,83921,3C98F7394473AF286503765E077D8C3A,12921,7,8,1,9,41,491
83922,83922,3C98F7394473AF286503765E077D8C3A,49201,13,16,3,7,41,391
83923,83923,3C98F7394473AF286503765E077D8C3A,12921,18,20,2,9,41,491
83924,83924,331C93B6083F5634586EEDFC958D0A76,11171,0,9,9,33,48,1698
83925,83925,331C93B6083F5634586EEDFC958D0A76,10151,10,13,3,34,47,1747
83926,83926,331C93B6083F5634586EEDFC958D0A76,11231,18,19,1,37,49,1899
83927,83927,331C93B6083F5634586EEDFC958D0A76,42351,20,23,3,38,45,1945
83928,83928,C06A2B736F0C9DE7AE001761CE315949,12792,0,6,6,34,30,1730
83929,83929,C06A2B736F0C9DE7AE001761CE315949,15191,6,10,4,36,27,1827
83930,83930,C06A2B736F0C9DE7AE001761CE315949,15061,12,13,1,41,25,2075
83931,83931,C06A2B736F0C9DE7AE001761CE315949,15191,15,19,4,36,27,1827
83932,83932,C06A2B736F0C9DE7AE001761CE315949,12792,21,23,2,34,30,1730
83933,83933,0B1F81D50BCD55F78AD202EF0803FA05,41393,0,13,13,43,49,2199
83934,83934,0B1F81D50BCD55F78AD202EF0803FA05,13041,15,18,3,30,37,1537
83935,83935,0B1F81D50BCD55F78AD202EF0803FA05,41393,21,23,2,43,49,2199
83936,83936,BD06CA25E555DDE2E112C969AAFCC3A9,43581,0,6,6,33,48,1698
83937,83937,BD06CA25E555DDE2E112C969AAFCC3A9,43731,8,10,2,34,47,1747
83938,83938,BD06CA25E555DDE2E112C969AAFCC3A9,10401,13,15,2,33,49,1699
83939,83939,BD06CA25E555DDE2E112C969AAFCC3A9,42941,15,16,1,37,47,1897
83940,83940,BD06CA25E555DDE2E112C969AAFCC3A9,43581,21,23,2,33,48,1698
83941,83941,6A457FC295BEABB4E7455CBB04B50835,43021,0,9,9,16,43,843
83942,83942,6A457FC295BEABB4E7455CBB04B50835,12921,9,11,2,9,41,491
83943,83943,6A457FC295BEABB4E7455CBB04B50835,43021,15,18,3,16,43,843
83944,83944,6A457FC295BEABB4E7455CBB04B50835,12641,22,23,1,10,43,543
83948,83948,4AFE4F64A4241A18C27A9622FF1285EA,11951,3,11,8,31,49,1599
83949,83949,4AFE4F64A4241A18C27A9622FF1285EA,11541,12,13,1,35,49,1799
83950,83950,4AFE4F64A4241A18C27A9622FF1285EA,10381,13,19,6,31,49,1599
83951,83951,4AFE4F64A4241A18C27A9622FF1285EA,11661,21,23,2,40,49,2049
83955,83955,E8315564C8D014B58F5DA2816FD2FA6D,13341,0,13,13,44,45,2245
83956,83956,E8315564C8D014B58F5DA2816FD2FA6D,13551,17,18,1,45,38,2288
83957,83957,E8315564C8D014B58F5DA2816FD2FA6D,13341,21,23,2,44,45,2245
83958,83958,FB6D357AE6E744B7566081ADA8598AEB,43731,0,6,6,34,47,1747
83959,83959,FB6D357AE6E744B7566081ADA8598AEB,13511,9,12,3,34,48,1748
83960,83960,FB6D357AE6E744B7566081ADA8598AEB,40463,16,19,3,38,49,1949
83971,83971,85061C43999146706723F4E0700EE955,13911,0,6,6,39,46,1996
83972,83972,85061C43999146706723F4E0700EE955,11261,7,8,1,36,46,1846
83973,83973,85061C43999146706723F4E0700EE955,13911,12,14,2,39,46,1996
83974,83974,85061C43999146706723F4E0700EE955,11261,14,16,2,36,46,1846
83975,83975,85061C43999146706723F4E0700EE955,13911,18,19,1,39,46,1996
83976,83976,2DF55C2584719A60978A4B87BCCC14A1,42523,1,2,1,31,47,1597
83977,83977,2DF55C2584719A60978A4B87BCCC14A1,42491,2,10,8,32,46,1646
83978,83978,2DF55C2584719A60978A4B87BCCC14A1,42523,11,14,3,31,47,1597
83979,83979,2DF55C2584719A60978A4B87BCCC14A1,43761,15,18,3,32,47,1647
83980,83980,2DF55C2584719A60978A4B87BCCC14A1,42521,18,23,5,31,47,1597
83981,83981,2D9F8EEE0946858BEC66856CB73B8335,43021,0,5,5,16,43,843
83982,83982,2D9F8EEE0946858BEC66856CB73B8335,12921,5,10,5,9,41,491
83983,83983,2D9F8EEE0946858BEC66856CB73B8335,43021,10,13,3,16,43,843
83984,83984,2D9F8EEE0946858BEC66856CB73B8335,12921,15,17,2,9,41,491
83985,83985,2D9F8EEE0946858BEC66856CB73B8335,43021,20,23,3,16,43,843
83989,83989,AC9A35D001464E087369411DD671E08D,42941,0,5,5,37,47,1897
83990,83990,AC9A35D001464E087369411DD671E08D,42161,11,13,2,36,47,1847
83991,83991,AC9A35D001464E087369411DD671E08D,12221,13,15,2,43,44,2194
83992,83992,AC9A35D001464E087369411DD671E08D,42941,18,23,5,37,47,1897
83993,83993,C0A5FC6D99A04AB7CC2D865E46B186E7,40833,0,9,9,41,47,2097
83994,83994,C0A5FC6D99A04AB7CC2D865E46B186E7,11806,10,13,3,41,48,2098
83995,83995,C0A5FC6D99A04AB7CC2D865E46B186E7,10691,15,18,3,33,48,1698
83996,83996,C0A5FC6D99A04AB7CC2D865E46B186E7,12511,20,21,1,39,47,1997
83997,83997,9ECA5557B94DDF8D494B58216329A377,42864,5,6,1,38,44,1944
83998,83998,9ECA5557B94DDF8D494B58216329A377,11261,6,9,3,36,46,1846
83999,83999,9ECA5557B94DDF8D494B58216329A377,42864,12,13,1,38,44,1944
84000,84000,9ECA5557B94DDF8D494B58216329A377,11261,15,18,3,36,46,1846
84001,84001,9ECA5557B94DDF8D494B58216329A377,42864,19,22,3,38,44,1944
84002,84002,9ECA5557B94DDF8D494B58216329A377,11261,22,23,1,36,46,1846
84003,84003,F60275774A8E100C709A8CD8761F5FF3,13111,0,6,6,42,46,2146
84004,84004,F60275774A8E100C709A8CD8761F5FF3,42031,7,9,2,40,46,2046
84005,84005,F60275774A8E100C709A8CD8761F5FF3,13111,11,18,7,42,46,2146
84006,84006,F60275774A8E100C709A8CD8761F5FF3,42031,19,20,1,40,46,2046
84007,84007,F60275774A8E100C709A8CD8761F5FF3,13111,21,23,2,42,46,2146
84008,84008,7D8BB90B66B5BB302B836A7DB354A71B,42601,0,6,6,44,48,2248
84009,84009,7D8BB90B66B5BB302B836A7DB354A71B,42321,7,8,1,43,47,2197
84010,84010,7D8BB90B66B5BB302B836A7DB354A71B,11701,8,10,2,43,48,2198
84011,84011,7D8BB90B66B5BB302B836A7DB354A71B,42601,11,13,2,44,48,2248
84012,84012,7D8BB90B66B5BB302B836A7DB354A71B,42321,15,16,1,43,47,2197
84013,84013,7D8BB90B66B5BB302B836A7DB354A71B,42601,17,18,1,44,48,2248
84014,84014,7D8BB90B66B5BB302B836A7DB354A71B,41393,21,23,2,43,49,2199
84015,84015,EB6092222E8735ECE3E5E9FA7E4FABEB,13341,0,5,5,44,45,2245
84016,84016,EB6092222E8735ECE3E5E9FA7E4FABEB,43061,7,12,5,43,46,2196
84017,84017,EB6092222E8735ECE3E5E9FA7E4FABEB,13341,13,17,4,44,45,2245
84018,84018,EB6092222E8735ECE3E5E9FA7E4FABEB,40691,18,21,3,42,48,2148
84026,84026,6C476726016CF6452D61AA39F918CC14,42141,2,7,5,32,47,1647
84027,84027,6C476726016CF6452D61AA39F918CC14,11201,8,12,4,35,49,1799
84028,84028,6C476726016CF6452D61AA39F918CC14,11381,15,23,8,30,47,1547
84029,84029,6869A5F90DBC32E3AB5337DBC7DAA2BA,12491,1,5,4,36,43,1843
84030,84030,6869A5F90DBC32E3AB5337DBC7DAA2BA,12311,6,7,1,30,44,1544
84031,84031,6869A5F90DBC32E3AB5337DBC7DAA2BA,43761,9,11,2,32,47,1647
84032,84032,6869A5F90DBC32E3AB5337DBC7DAA2BA,42151,15,18,3,35,45,1795
84033,84033,6869A5F90DBC32E3AB5337DBC7DAA2BA,12311,19,22,3,30,44,1544
84034,84034,348AA49B2B8ADD43B604294D03AB7595,12401,2,9,7,39,49,1999
84035,84035,348AA49B2B8ADD43B604294D03AB7595,40171,12,13,1,38,48,1948
84036,84036,348AA49B2B8ADD43B604294D03AB7595,40041,15,17,2,40,49,2049
84037,84037,348AA49B2B8ADD43B604294D03AB7595,11491,19,21,2,36,47,1847
84038,84038,348AA49B2B8ADD43B604294D03AB7595,11591,21,23,2,36,49,1849
84042,84042,9C2C2A9A5923C3E8476FE17BB2B155DD,19114,0,4,4,7,43,393
84043,84043,9C2C2A9A5923C3E8476FE17BB2B155DD,12641,6,9,3,10,43,543
84044,84044,9C2C2A9A5923C3E8476FE17BB2B155DD,19021,12,13,1,10,45,545
84045,84045,9C2C2A9A5923C3E8476FE17BB2B155DD,19114,16,23,7,7,43,393
84046,84046,1D51AC4BBFB933A632C5A69F521FA887,11861,0,11,11,32,47,1647
84047,84047,1D51AC4BBFB933A632C5A69F521FA887,11271,13,16,3,37,48,1898
84048,84048,1D51AC4BBFB933A632C5A69F521FA887,11861,18,23,5,32,47,1647
84052,84052,61373D3E3FAD453D1F5480C688E3B1FD,13091,10,11,1,20,42,1042
84053,84053,61373D3E3FAD453D1F5480C688E3B1FD,40341,15,17,2,23,49,1199
84054,84054,61373D3E3FAD453D1F5480C688E3B1FD,40171,20,23,3,38,48,1948
84055,84055,4D4ED6DA4881471B754325004FE8E6E9,11074,0,7,7,37,47,1897
84056,84056,4D4ED6DA4881471B754325004FE8E6E9,13821,9,11,2,49,45,2495
84057,84057,4D4ED6DA4881471B754325004FE8E6E9,13951,15,17,2,47,45,2395
84058,84058,4D4ED6DA4881471B754325004FE8E6E9,10661,18,20,2,37,49,1899
84059,84059,4D4ED6DA4881471B754325004FE8E6E9,40271,20,22,2,35,49,1799
84066,84066,C6ECE5EEB3C55F11FF8684D918998C95,11571,0,6,6,13,46,696
84067,84067,C6ECE5EEB3C55F11FF8684D918998C95,19021,6,8,2,10,45,545
84068,84068,C6ECE5EEB3C55F11FF8684D918998C95,11571,12,13,1,13,46,696
84069,84069,C6ECE5EEB3C55F11FF8684D918998C95,19021,16,17,1,10,45,545
84070,84070,C6ECE5EEB3C55F11FF8684D918998C95,11571,21,23,2,13,46,696
84071,84071,8E21695328CD990E36A796F4A2E5D43C,13371,0,6,6,41,47,2097
84072,84072,8E21695328CD990E36A796F4A2E5D43C,42931,6,7,1,41,49,2099
84073,84073,8E21695328CD990E36A796F4A2E5D43C,43101,8,20,12,46,40,2340
84074,84074,4A775C6F9F7FED0E03EC3E2B16AE34C8,10341,0,6,6,31,47,1597
84075,84075,4A775C6F9F7FED0E03EC3E2B16AE34C8,11481,10,16,6,41,48,2098
84076,84076,4A775C6F9F7FED0E03EC3E2B16AE34C8,11324,20,23,3,31,46,1596
84077,84077,DEA13AE4E25C1F5535D501BC3C7ECF55,19111,1,7,6,9,45,495
84078,84078,DEA13AE4E25C1F5535D501BC3C7ECF55,11631,8,9,1,12,49,649
84079,84079,DEA13AE4E25C1F5535D501BC3C7ECF55,11541,11,21,10,35,49,1799
84083,84083,5DB82E605B1FB0DDC2A0B5A637F4F0AF,42351,0,3,3,38,45,1945
84084,84084,5DB82E605B1FB0DDC2A0B5A637F4F0AF,13911,4,5,1,39,46,1996
84085,84085,5DB82E605B1FB0DDC2A0B5A637F4F0AF,42231,7,12,5,37,46,1896
84086,84086,5DB82E605B1FB0DDC2A0B5A637F4F0AF,42351,12,16,4,38,45,1945
84087,84087,5DB82E605B1FB0DDC2A0B5A637F4F0AF,42231,17,21,4,37,46,1896
84091,84091,1F87CA1D778B027B6DE06AC8BD5FBD25,13314,0,8,8,31,39,1589
84092,84092,1F87CA1D778B027B6DE06AC8BD5FBD25,42851,9,10,1,35,41,1791
84093,84093,1F87CA1D778B027B6DE06AC8BD5FBD25,13314,12,15,3,31,39,1589
84094,84094,1F87CA1D778B027B6DE06AC8BD5FBD25,12521,15,18,3,35,41,1791
84095,84095,FEBA5FF8CC875B7C4F7C26A2D1A865EB,10951,0,6,6,29,48,1498
84096,84096,FEBA5FF8CC875B7C4F7C26A2D1A865EB,19021,10,11,1,10,45,545
84097,84097,FEBA5FF8CC875B7C4F7C26A2D1A865EB,10951,16,17,1,29,48,1498
84098,84098,FEBA5FF8CC875B7C4F7C26A2D1A865EB,11381,19,20,1,30,47,1547
84112,84112,D576B25AEDC54A3B6E8FAA1E814D0619,10544,0,11,11,28,48,1448
84113,84113,D576B25AEDC54A3B6E8FAA1E814D0619,11151,12,15,3,30,48,1548
84114,84114,D576B25AEDC54A3B6E8FAA1E814D0619,11021,15,17,2,36,49,1849
84115,84115,D576B25AEDC54A3B6E8FAA1E814D0619,10544,18,20,2,28,48,1448
84126,84126,0B33559CDE995CCD90C9E87EB6E98B9E,42461,2,6,4,45,47,2297
84127,84127,0B33559CDE995CCD90C9E87EB6E98B9E,42091,9,16,7,43,46,2196
84128,84128,0B33559CDE995CCD90C9E87EB6E98B9E,11794,20,22,2,38,49,1949
84140,84140,FF604ADE0B9A2535A71C015160B61DC6,12761,0,2,2,25,40,1290
84141,84141,FF604ADE0B9A2535A71C015160B61DC6,12521,4,5,1,35,41,1791
84142,84142,FF604ADE0B9A2535A71C015160B61DC6,10351,8,11,3,28,45,1445
84143,84143,FF604ADE0B9A2535A71C015160B61DC6,12761,13,15,2,25,40,1290
84144,84144,FF604ADE0B9A2535A71C015160B61DC6,11281,15,16,1,27,40,1390
84145,84145,FF604ADE0B9A2535A71C015160B61DC6,12521,20,22,2,35,41,1791
84149,84149,576B01C43A9F86D222730FAFCEED6223,12581,3,4,1,24,48,1248
84150,84150,576B01C43A9F86D222730FAFCEED6223,11361,5,6,1,22,48,1148
84151,84151,576B01C43A9F86D222730FAFCEED6223,43751,7,21,14,19,48,998
84152,84152,B20D4CCCBBF9B534BB9F26A35B371E4C,42351,0,5,5,38,45,1945
84153,84153,B20D4CCCBBF9B534BB9F26A35B371E4C,11261,9,10,1,36,46,1846
84154,84154,B20D4CCCBBF9B534BB9F26A35B371E4C,42351,13,15,2,38,45,1945
84155,84155,B20D4CCCBBF9B534BB9F26A35B371E4C,11261,15,18,3,36,46,1846
84156,84156,B20D4CCCBBF9B534BB9F26A35B371E4C,12211,22,23,1,41,44,2094
84163,84163,64D9BB0C5CDE027D719746DF3735698D,12921,0,5,5,9,41,491
84164,84164,64D9BB0C5CDE027D719746DF3735698D,13094,8,10,2,21,42,1092
84165,84165,64D9BB0C5CDE027D719746DF3735698D,12921,12,14,2,9,41,491
84166,84166,64D9BB0C5CDE027D719746DF3735698D,12641,16,17,1,10,43,543
84167,84167,64D9BB0C5CDE027D719746DF3735698D,12921,19,23,4,9,41,491
84172,84172,1C7DBF9E53F65ED639E90C6178E9F4A9,42151,0,8,8,35,45,1795
84173,84173,1C7DBF9E53F65ED639E90C6178E9F4A9,11261,11,13,2,36,46,1846
84174,84174,1C7DBF9E53F65ED639E90C6178E9F4A9,13911,13,15,2,39,46,1996
84175,84175,1C7DBF9E53F65ED639E90C6178E9F4A9,40951,20,21,1,36,49,1849
84182,84182,83F2640D21345A35D8A8F80AAF4553B1,13111,0,7,7,42,46,2146
84183,84183,83F2640D21345A35D8A8F80AAF4553B1,19111,9,16,7,9,45,495
84184,84184,83F2640D21345A35D8A8F80AAF4553B1,10471,18,20,2,37,48,1898
84185,84185,83F2640D21345A35D8A8F80AAF4553B1,13111,21,23,2,42,46,2146
84186,84186,6A0394A16431C3763362EDB77E0D6861,42071,0,9,9,31,49,1599
84187,84187,6A0394A16431C3763362EDB77E0D6861,42831,12,14,2,27,48,1398
84188,84188,6A0394A16431C3763362EDB77E0D6861,42071,15,16,1,31,49,1599
84189,84189,6A0394A16431C3763362EDB77E0D6861,42831,16,18,2,27,48,1398
84190,84190,6A0394A16431C3763362EDB77E0D6861,42071,18,22,4,31,49,1599
84191,84191,49B9A9725DA3E20D87644DF5E8EDED23,11074,3,11,8,37,47,1897
84192,84192,49B9A9725DA3E20D87644DF5E8EDED23,19021,13,20,7,10,45,545
84193,84193,49B9A9725DA3E20D87644DF5E8EDED23,19901,20,23,3,7,44,394
84194,84194,54C28B082733E33A64393D2DD39B9D4C,12514,1,3,2,38,47,1947
84195,84195,54C28B082733E33A64393D2DD39B9D4C,10841,3,5,2,37,47,1897
84196,84196,54C28B082733E33A64393D2DD39B9D4C,12514,5,6,1,38,47,1947
84197,84197,54C28B082733E33A64393D2DD39B9D4C,42221,9,13,4,38,48,1948
84198,84198,54C28B082733E33A64393D2DD39B9D4C,10841,16,17,1,37,47,1897
84199,84199,54C28B082733E33A64393D2DD39B9D4C,11491,17,21,4,36,47,1847
84200,84200,54C28B082733E33A64393D2DD39B9D4C,10841,21,23,2,37,47,1897
84201,84201,11B7F7677A0CABD0DA5C6CA237E025AC,10691,1,15,14,33,48,1698
84202,84202,11B7F7677A0CABD0DA5C6CA237E025AC,10191,16,20,4,40,48,2048
84203,84203,11B7F7677A0CABD0DA5C6CA237E025AC,11521,22,23,1,41,48,2098
84213,84213,4EC8D8BFDD4FC00C53BDA72AE182E742,42511,0,9,9,37,47,1897
84214,84214,4EC8D8BFDD4FC00C53BDA72AE182E742,43181,12,13,1,39,48,1998
84215,84215,4EC8D8BFDD4FC00C53BDA72AE182E742,10841,15,16,1,37,47,1897
84216,84216,4EC8D8BFDD4FC00C53BDA72AE182E742,10881,16,18,2,34,48,1748
84217,84217,4EC8D8BFDD4FC00C53BDA72AE182E742,10721,18,20,2,31,48,1598
84218,84218,4EC8D8BFDD4FC00C53BDA72AE182E742,42511,21,23,2,37,47,1897
84222,84222,6F60DF43E72A344D99FCB3944A72DCC7,42871,0,9,9,30,45,1545
84223,84223,6F60DF43E72A344D99FCB3944A72DCC7,10711,10,11,1,29,46,1496
84224,84224,6F60DF43E72A344D99FCB3944A72DCC7,42871,12,14,2,30,45,1545
84225,84225,6F60DF43E72A344D99FCB3944A72DCC7,12601,18,22,4,25,47,1297
84226,84226,1078436CC9F31DFE63B8B6F9AEB69E32,42151,0,6,6,35,45,1795
84227,84227,1078436CC9F31DFE63B8B6F9AEB69E32,12641,7,8,1,10,43,543
84228,84228,1078436CC9F31DFE63B8B6F9AEB69E32,12661,12,17,5,32,45,1645
84229,84229,1078436CC9F31DFE63B8B6F9AEB69E32,11861,20,22,2,32,47,1647
84230,84230,F6CF1C41F7C41D5A8B55D9B98830D394,11701,0,7,7,43,48,2198
84231,84231,F6CF1C41F7C41D5A8B55D9B98830D394,10271,8,17,9,37,46,1896
84232,84232,F6CF1C41F7C41D5A8B55D9B98830D394,11701,18,19,1,43,48,2198
84233,84233,F6CF1C41F7C41D5A8B55D9B98830D394,40691,20,22,2,42,48,2148
84237,84237,B584ECCE32EE4C49FF68F8E796132301,40833,0,1,1,41,47,2097
84238,84238,B584ECCE32EE4C49FF68F8E796132301,42204,1,7,6,43,46,2196
84239,84239,B584ECCE32EE4C49FF68F8E796132301,16151,11,14,3,13,11,661
84240,84240,B584ECCE32EE4C49FF68F8E796132301,13111,15,20,5,42,46,2146
84241,84241,B584ECCE32EE4C49FF68F8E796132301,11701,21,23,2,43,48,2198
84242,84242,F80217E3B51992ECD97DB6E1ACCD96C3,13781,5,6,1,48,32,2432
84243,84243,F80217E3B51992ECD97DB6E1ACCD96C3,43101,7,13,6,46,40,2340
84244,84244,F80217E3B51992ECD97DB6E1ACCD96C3,13491,15,16,1,48,39,2439
84245,84245,F80217E3B51992ECD97DB6E1ACCD96C3,43101,17,23,6,46,40,2340
84252,84252,7A7AEC35AE07D4110F6099DB218EF80C,19441,0,1,1,8,46,446
84253,84253,7A7AEC35AE07D4110F6099DB218EF80C,10211,3,4,1,16,49,849
84254,84254,7A7AEC35AE07D4110F6099DB218EF80C,19021,8,18,10,10,45,545
84255,84255,7A7AEC35AE07D4110F6099DB218EF80C,19901,20,22,2,7,44,394
84271,84271,FB78D5322DE89BC4ACBA0A9E43B4FF54,41392,0,7,7,43,48,2198
84272,84272,FB78D5322DE89BC4ACBA0A9E43B4FF54,42201,7,8,1,43,46,2196
84273,84273,FB78D5322DE89BC4ACBA0A9E43B4FF54,13561,10,12,2,37,49,1899
84274,84274,FB78D5322DE89BC4ACBA0A9E43B4FF54,41392,13,17,4,43,48,2198
84275,84275,FB78D5322DE89BC4ACBA0A9E43B4FF54,10771,18,19,1,41,46,2096
84276,84276,FB78D5322DE89BC4ACBA0A9E43B4FF54,41392,20,22,2,43,48,2198
84277,84277,5513A4EBEB51AF5647B29C75D8B8CC2C,10341,2,7,5,31,47,1597
84278,84278,5513A4EBEB51AF5647B29C75D8B8CC2C,42491,8,11,3,32,46,1646
84279,84279,5513A4EBEB51AF5647B29C75D8B8CC2C,10221,11,21,10,34,49,1749
84280,84280,AD5871AA9EAD75878C606AE9C3D0E3D8,12561,1,6,5,45,43,2293
84281,84281,AD5871AA9EAD75878C606AE9C3D0E3D8,43951,7,18,11,49,41,2491
84282,84282,AD5871AA9EAD75878C606AE9C3D0E3D8,12561,19,21,2,45,43,2293
84283,84283,A573FF285872EC96818445928AD4461A,13671,1,3,2,27,43,1393
84284,84284,A573FF285872EC96818445928AD4461A,11281,4,5,1,27,40,1390
84285,84285,A573FF285872EC96818445928AD4461A,13671,5,8,3,27,43,1393
84286,84286,A573FF285872EC96818445928AD4461A,11281,16,17,1,27,40,1390
84287,84287,A573FF285872EC96818445928AD4461A,13671,17,22,5,27,43,1393
84291,84291,4395C6E2ABA59930045C5FB0134BA180,10711,0,6,6,29,46,1496
84292,84292,4395C6E2ABA59930045C5FB0134BA180,10301,7,10,3,31,45,1595
84293,84293,4395C6E2ABA59930045C5FB0134BA180,12311,12,14,2,30,44,1544
84294,84294,4395C6E2ABA59930045C5FB0134BA180,10301,15,20,5,31,45,1595
84295,84295,4395C6E2ABA59930045C5FB0134BA180,10711,20,23,3,29,46,1496
84309,84309,D21AD56E1413F233CB19B53125C6F06A,11591,4,13,9,36,49,1849
84310,84310,D21AD56E1413F233CB19B53125C6F06A,11271,16,17,1,37,48,1898
84311,84311,D21AD56E1413F233CB19B53125C6F06A,43311,18,19,1,31,48,1598
84312,84312,D21AD56E1413F233CB19B53125C6F06A,12971,21,23,2,32,48,1648
84313,84313,F9DC2F592D6193343BD07B6C3149B9BD,42161,1,2,1,36,47,1847
84314,84314,F9DC2F592D6193343BD07B6C3149B9BD,11131,3,7,4,33,48,1698
84315,84315,F9DC2F592D6193343BD07B6C3149B9BD,43731,7,17,10,34,47,1747
84316,84316,F9DC2F592D6193343BD07B6C3149B9BD,10401,17,20,3,33,49,1699
84317,84317,751B7CB9C035034746EB082217066F97,10351,0,7,7,28,45,1445
84318,84318,751B7CB9C035034746EB082217066F97,10711,7,8,1,29,46,1496
84319,84319,751B7CB9C035034746EB082217066F97,10351,8,13,5,28,45,1445
84320,84320,751B7CB9C035034746EB082217066F97,10711,18,20,2,29,46,1496
84321,84321,751B7CB9C035034746EB082217066F97,10351,21,23,2,28,45,1445
84330,84330,046445D1DB12CBF4315C57EFE7A8E5B3,13941,0,8,8,41,47,2097
84331,84331,046445D1DB12CBF4315C57EFE7A8E5B3,10971,12,13,1,35,47,1797
84332,84332,046445D1DB12CBF4315C57EFE7A8E5B3,43731,13,15,2,34,47,1747
84333,84333,046445D1DB12CBF4315C57EFE7A8E5B3,42321,19,21,2,43,47,2197
84337,84337,D28E5E78DFC1F96DF4D6C3C735439CA9,12401,0,10,10,39,49,1999
84338,84338,D28E5E78DFC1F96DF4D6C3C735439CA9,11151,14,15,1,30,48,1548
84339,84339,D28E5E78DFC1F96DF4D6C3C735439CA9,11061,15,17,2,29,48,1498
84340,84340,D28E5E78DFC1F96DF4D6C3C735439CA9,11151,21,22,1,30,48,1548
84341,84341,4FA7E2AF35091649A8D61648BF92F5C0,42581,0,7,7,38,48,1948
84342,84342,4FA7E2AF35091649A8D61648BF92F5C0,10471,7,11,4,37,48,1898
84343,84343,4FA7E2AF35091649A8D61648BF92F5C0,42581,12,13,1,38,48,1948
84344,84344,4FA7E2AF35091649A8D61648BF92F5C0,10471,15,17,2,37,48,1898
84345,84345,4FA7E2AF35091649A8D61648BF92F5C0,42221,20,22,2,38,48,1948
84346,84346,B51D9FF5C85A339CA5BC5AEEEDDD9188,19901,0,7,7,7,44,394
84347,84347,B51D9FF5C85A339CA5BC5AEEEDDD9188,10491,10,14,4,33,48,1698
84348,84348,B51D9FF5C85A339CA5BC5AEEEDDD9188,42231,15,22,7,37,46,1896
84353,84353,7EA63201A47B68AA085BD7B8AF1F7767,10721,0,7,7,31,48,1598
84354,84354,7EA63201A47B68AA085BD7B8AF1F7767,11231,11,12,1,37,49,1899
84355,84355,7EA63201A47B68AA085BD7B8AF1F7767,10121,13,15,2,36,49,1849
84356,84356,7EA63201A47B68AA085BD7B8AF1F7767,11231,15,18,3,37,49,1899
84357,84357,7EA63201A47B68AA085BD7B8AF1F7767,13341,20,23,3,44,45,2245
84365,84365,99D46FD0BFCE2697587F3F7CC00D69FD,11911,0,7,7,37,48,1898
84366,84366,99D46FD0BFCE2697587F3F7CC00D69FD,13511,8,9,1,34,48,1748
84367,84367,99D46FD0BFCE2697587F3F7CC00D69FD,11911,12,19,7,37,48,1898
84368,84368,99D46FD0BFCE2697587F3F7CC00D69FD,10341,21,22,1,31,47,1597
84376,84376,90E77A64F01EF90E4F34D3CF5763883D,11151,0,7,7,30,48,1548
84377,84377,90E77A64F01EF90E4F34D3CF5763883D,43761,8,9,1,32,47,1647
84378,84378,90E77A64F01EF90E4F34D3CF5763883D,40094,13,16,3,29,48,1498
84379,84379,90E77A64F01EF90E4F34D3CF5763883D,10721,18,20,2,31,48,1598
84380,84380,90E77A64F01EF90E4F34D3CF5763883D,11151,21,22,1,30,48,1548
84381,84381,209CBAFCECFCFAF5ADEC7A13A8F80FC5,12641,1,2,1,10,43,543
84382,84382,209CBAFCECFCFAF5ADEC7A13A8F80FC5,19114,6,10,4,7,43,393
84383,84383,209CBAFCECFCFAF5ADEC7A13A8F80FC5,12641,12,13,1,10,43,543
84384,84384,209CBAFCECFCFAF5ADEC7A13A8F80FC5,12921,15,17,2,9,41,491
84385,84385,209CBAFCECFCFAF5ADEC7A13A8F80FC5,19114,17,18,1,7,43,393
84386,84386,209CBAFCECFCFAF5ADEC7A13A8F80FC5,12921,19,21,2,9,41,491
84390,84390,C467D64B05CEF95392B4823581CD9EF0,11211,0,2,2,34,49,1749
84391,84391,C467D64B05CEF95392B4823581CD9EF0,42471,3,7,4,35,49,1799
84392,84392,C467D64B05CEF95392B4823581CD9EF0,13111,9,18,9,42,46,2146
84407,84407,F2C5EC57808705B9AD12F4B58D41E320,11431,0,16,16,29,47,1497
84408,84408,F2C5EC57808705B9AD12F4B58D41E320,11074,16,19,3,37,47,1897
84409,84409,F2C5EC57808705B9AD12F4B58D41E320,42281,19,20,1,40,48,2048
84410,84410,F2C5EC57808705B9AD12F4B58D41E320,43481,22,23,1,39,48,1998
84435,84435,BDE131E3985277A452A63ED13E5958AD,11381,0,5,5,30,47,1547
84436,84436,BDE131E3985277A452A63ED13E5958AD,13071,7,10,3,41,41,2091
84437,84437,BDE131E3985277A452A63ED13E5958AD,13441,10,15,5,39,39,1989
84438,84438,BDE131E3985277A452A63ED13E5958AD,13071,16,17,1,41,41,2091
84439,84439,BDE131E3985277A452A63ED13E5958AD,11381,20,23,3,30,47,1547
84440,84440,08AC3004B7EDC2BC1ED435C12C5F8EC9,42771,2,6,4,36,47,1847
84441,84441,08AC3004B7EDC2BC1ED435C12C5F8EC9,10841,6,12,6,37,47,1897
84442,84442,08AC3004B7EDC2BC1ED435C12C5F8EC9,42771,15,16,1,36,47,1847
84443,84443,08AC3004B7EDC2BC1ED435C12C5F8EC9,11061,18,20,2,29,48,1498
84447,84447,4B5119258FB3482B746B53277561992F,12051,2,9,7,20,47,1047
84448,84448,4B5119258FB3482B746B53277561992F,12581,10,12,2,24,48,1248
84449,84449,4B5119258FB3482B746B53277561992F,12601,12,14,2,25,47,1297
84450,84450,4B5119258FB3482B746B53277561992F,10061,14,23,9,20,46,1046
84451,84451,63A1194DA67A916294F825B4249AD293,42301,0,4,4,36,47,1847
84452,84452,63A1194DA67A916294F825B4249AD293,42351,6,7,1,38,45,1945
84453,84453,63A1194DA67A916294F825B4249AD293,10841,8,13,5,37,47,1897
84454,84454,63A1194DA67A916294F825B4249AD293,42351,16,17,1,38,45,1945
84455,84455,63A1194DA67A916294F825B4249AD293,42301,18,20,2,36,47,1847
84456,84456,63A1194DA67A916294F825B4249AD293,10841,20,21,1,37,47,1897
84457,84457,63A1194DA67A916294F825B4249AD293,42161,22,23,1,36,47,1847
84461,84461,AA541C733BB5F99408992FE5EC11F72D,13231,2,4,2,39,46,1996
84462,84462,AA541C733BB5F99408992FE5EC11F72D,42861,8,9,1,37,44,1894
84463,84463,AA541C733BB5F99408992FE5EC11F72D,13071,10,12,2,41,41,2091
84464,84464,AA541C733BB5F99408992FE5EC11F72D,42861,13,19,6,37,44,1894
84465,84465,AA541C733BB5F99408992FE5EC11F72D,11261,20,22,2,36,46,1846
84490,84490,591DE5D56810C23474F629A9FED02810,42491,4,12,8,32,46,1646
84491,84491,591DE5D56810C23474F629A9FED02810,43281,16,18,2,37,48,1898
84492,84492,591DE5D56810C23474F629A9FED02810,42523,19,20,1,31,47,1597
84493,84493,591DE5D56810C23474F629A9FED02810,42491,20,23,3,32,46,1646
84494,84494,41835EC02F00D39605A1221637AA4EB5,40431,0,8,8,36,47,1847
84495,84495,41835EC02F00D39605A1221637AA4EB5,40341,17,19,2,23,49,1199
84496,84496,41835EC02F00D39605A1221637AA4EB5,42161,21,23,2,36,47,1847
84497,84497,E1FACDD16916395E3AFDD39C0C7F38D6,11571,4,5,1,13,46,696
84498,84498,E1FACDD16916395E3AFDD39C0C7F38D6,10061,8,11,3,20,46,1046
84499,84499,E1FACDD16916395E3AFDD39C0C7F38D6,12601,12,13,1,25,47,1297
84500,84500,E1FACDD16916395E3AFDD39C0C7F38D6,10061,13,23,10,20,46,1046
84508,84508,BC71A128CC1D1FD204F1FA3A371EA53A,43021,0,6,6,16,43,843
84509,84509,BC71A128CC1D1FD204F1FA3A371EA53A,12921,6,18,12,9,41,491
84510,84510,BC71A128CC1D1FD204F1FA3A371EA53A,43021,19,23,4,16,43,843
84514,84514,2CAEA5E29EC045ABED8FBD60EF3344BD,42051,0,8,8,42,48,2148
84515,84515,2CAEA5E29EC045ABED8FBD60EF3344BD,12971,9,15,6,32,48,1648
84516,84516,2CAEA5E29EC045ABED8FBD60EF3344BD,41601,16,20,4,39,49,1999
84517,84517,2CAEA5E29EC045ABED8FBD60EF3344BD,11301,21,23,2,41,49,2099
84518,84518,2B90D35F75598E468316E9A5E2C23841,13111,6,9,3,42,46,2146
84519,84519,2B90D35F75598E468316E9A5E2C23841,42201,10,11,1,43,46,2196
84520,84520,2B90D35F75598E468316E9A5E2C23841,13111,12,16,4,42,46,2146
84521,84521,2B90D35F75598E468316E9A5E2C23841,43621,16,17,1,46,48,2348
84522,84522,2B90D35F75598E468316E9A5E2C23841,42201,18,20,2,43,46,2196
84523,84523,E6F8254FB06F11B0E1B2D4AA336C6A03,12921,0,11,11,9,41,491
84524,84524,E6F8254FB06F11B0E1B2D4AA336C6A03,19244,13,15,2,1,43,93
84525,84525,E6F8254FB06F11B0E1B2D4AA336C6A03,12921,18,23,5,9,41,491
84532,84532,476CF509528DDA8C3E341A679B945B9E,10951,0,7,7,29,48,1498
84533,84533,476CF509528DDA8C3E341A679B945B9E,10351,11,14,3,28,45,1445
84534,84534,476CF509528DDA8C3E341A679B945B9E,10634,15,16,1,27,45,1395
84535,84535,476CF509528DDA8C3E341A679B945B9E,10351,16,18,2,28,45,1445
84536,84536,476CF509528DDA8C3E341A679B945B9E,10634,18,20,2,27,45,1395
84537,84537,476CF509528DDA8C3E341A679B945B9E,10351,20,22,2,28,45,1445
84541,84541,4C0B4AC61D24A3A943FEC75230408343,10381,0,7,7,31,49,1599
84542,84542,4C0B4AC61D24A3A943FEC75230408343,11151,7,11,4,30,48,1548
84543,84543,4C0B4AC61D24A3A943FEC75230408343,11061,11,15,4,29,48,1498
84544,84544,4C0B4AC61D24A3A943FEC75230408343,11151,15,17,2,30,48,1548
84545,84545,4C0B4AC61D24A3A943FEC75230408343,11061,20,23,3,29,48,1498
84546,84546,B2FF699F2D213EDD8D43D893134155CA,10951,0,12,12,29,48,1498
84547,84547,B2FF699F2D213EDD8D43D893134155CA,10214,12,13,1,15,49,799
84548,84548,B2FF699F2D213EDD8D43D893134155CA,11381,20,21,1,30,47,1547
84549,84549,401DBF9291C70DB6E3FE8385830F996E,13791,0,7,7,42,47,2147
84550,84550,401DBF9291C70DB6E3FE8385830F996E,11201,9,11,2,35,49,1799
84551,84551,401DBF9291C70DB6E3FE8385830F996E,11021,12,15,3,36,49,1849
84552,84552,401DBF9291C70DB6E3FE8385830F996E,13791,22,23,1,42,47,2147
84553,84553,8D8E9039F0B9A1657D1F9D7D1E057C89,11731,0,9,9,36,48,1848
84554,84554,8D8E9039F0B9A1657D1F9D7D1E057C89,43761,11,13,2,32,47,1647
84555,84555,8D8E9039F0B9A1657D1F9D7D1E057C89,42081,16,17,1,24,49,1249
84556,84556,8D8E9039F0B9A1657D1F9D7D1E057C89,40341,17,20,3,23,49,1199
84557,84557,8D8E9039F0B9A1657D1F9D7D1E057C89,42623,20,21,1,22,49,1149
84558,84558,0A252836FA6DFCFDFC50B5267919BF05,43021,0,4,4,16,43,843
84559,84559,0A252836FA6DFCFDFC50B5267919BF05,12921,5,10,5,9,41,491
84560,84560,0A252836FA6DFCFDFC50B5267919BF05,43021,13,14,1,16,43,843
84561,84561,0A252836FA6DFCFDFC50B5267919BF05,19181,15,16,1,8,40,440
84562,84562,0A252836FA6DFCFDFC50B5267919BF05,43021,20,23,3,16,43,843
84563,84563,D5D027DEC2E15CD439B6E37A42DFD8C1,43021,0,10,10,16,43,843
84564,84564,D5D027DEC2E15CD439B6E37A42DFD8C1,12921,11,13,2,9,41,491
84565,84565,D5D027DEC2E15CD439B6E37A42DFD8C1,43021,15,18,3,16,43,843
84566,84566,7555C7D56C0A52217E91484DDE32D6BD,42161,0,18,18,36,47,1847
84567,84567,7555C7D56C0A52217E91484DDE32D6BD,40112,19,22,3,32,48,1648
84568,84568,7555C7D56C0A52217E91484DDE32D6BD,42161,22,23,1,36,47,1847
84569,84569,931952BCA4D3C2B1AA68DC250E71D553,41393,0,14,14,43,49,2199
84570,84570,931952BCA4D3C2B1AA68DC250E71D553,12083,16,20,4,36,49,1849
84571,84571,931952BCA4D3C2B1AA68DC250E71D553,11751,20,23,3,35,48,1798
84576,84576,A9FF4E7243102AC55B98AE7F53A11FDA,19621,0,2,2,5,46,296
84577,84577,A9FF4E7243102AC55B98AE7F53A11FDA,19114,2,7,5,7,43,393
84578,84578,A9FF4E7243102AC55B98AE7F53A11FDA,19021,10,17,7,10,45,545
84579,84579,A9FF4E7243102AC55B98AE7F53A11FDA,12381,19,21,2,32,48,1648
84584,84584,AF85AB0F84B58F4A12483525349C1572,43121,0,6,6,25,27,1277
84585,84585,AF85AB0F84B58F4A12483525349C1572,15191,7,10,3,36,27,1827
84586,84586,AF85AB0F84B58F4A12483525349C1572,43121,12,22,10,25,27,1277
84593,84593,4509CA6F4F6AE506CFF527F6805D5251,19031,1,6,5,1,42,92
84594,84594,4509CA6F4F6AE506CFF527F6805D5251,12641,6,16,10,10,43,543
84595,84595,4509CA6F4F6AE506CFF527F6805D5251,19181,19,21,2,8,40,440
84596,84596,DBBC5E2E49AC38D72E9709D19A142B0B,11271,0,10,10,37,48,1898
84597,84597,DBBC5E2E49AC38D72E9709D19A142B0B,12601,15,17,2,25,47,1297
84598,84598,DBBC5E2E49AC38D72E9709D19A142B0B,11271,18,20,2,37,48,1898
84599,84599,DBBC5E2E49AC38D72E9709D19A142B0B,11461,20,22,2,37,49,1899
84600,84600,139E323C8869BB23D1CEE92D77CF1FFD,11541,1,11,10,35,49,1799
84601,84601,139E323C8869BB23D1CEE92D77CF1FFD,40341,14,16,2,23,49,1199
84602,84602,139E323C8869BB23D1CEE92D77CF1FFD,11211,16,18,2,34,49,1749
84615,84615,14430BF803136C52604E8FE6E361832C,42461,0,8,8,45,47,2297
84616,84616,14430BF803136C52604E8FE6E361832C,10901,11,13,2,35,48,1798
84617,84617,14430BF803136C52604E8FE6E361832C,42461,16,20,4,45,47,2297
84618,84618,14430BF803136C52604E8FE6E361832C,42321,20,21,1,43,47,2197
84619,84619,14430BF803136C52604E8FE6E361832C,42461,21,22,1,45,47,2297
84630,84630,48D09EA1E123F030FD71CF37426D4799,42151,2,5,3,35,45,1795
84631,84631,48D09EA1E123F030FD71CF37426D4799,43011,5,11,6,40,42,2042
84632,84632,48D09EA1E123F030FD71CF37426D4799,42151,13,22,9,35,45,1795
84633,84633,3BD30092E78F928C91E4887B7831932C,11331,0,5,5,37,48,1898
84634,84634,3BD30092E78F928C91E4887B7831932C,10111,7,9,2,37,47,1897
84635,84635,3BD30092E78F928C91E4887B7831932C,42161,10,11,1,36,47,1847
84636,84636,3BD30092E78F928C91E4887B7831932C,11331,12,15,3,37,48,1898
84637,84637,3BD30092E78F928C91E4887B7831932C,10111,16,17,1,37,47,1897
84638,84638,3BD30092E78F928C91E4887B7831932C,42161,18,19,1,36,47,1847
84639,84639,3BD30092E78F928C91E4887B7831932C,11331,20,23,3,37,48,1898
84644,84644,6343BF60CCF3D70B5AB02F8245B426EB,13121,0,2,2,38,46,1946
84645,84645,6343BF60CCF3D70B5AB02F8245B426EB,42511,4,5,1,37,47,1897
84646,84646,6343BF60CCF3D70B5AB02F8245B426EB,13121,6,8,2,38,46,1946
84647,84647,6343BF60CCF3D70B5AB02F8245B426EB,10431,9,12,3,33,49,1699
84648,84648,6343BF60CCF3D70B5AB02F8245B426EB,13121,13,23,10,38,46,1946
84649,84649,1A5DEB007188BBCFFE665C75C024CDE9,42531,1,3,2,31,45,1595
84650,84650,1A5DEB007188BBCFFE665C75C024CDE9,12121,4,5,1,29,47,1497
84651,84651,1A5DEB007188BBCFFE665C75C024CDE9,42531,8,10,2,31,45,1595
84652,84652,1A5DEB007188BBCFFE665C75C024CDE9,12311,13,15,2,30,44,1544
84653,84653,1A5DEB007188BBCFFE665C75C024CDE9,42531,19,21,2,31,45,1595
84658,84658,D3EF141BDC81929D7A3D2C86A2B15366,12611,0,1,1,41,29,2079
84659,84659,D3EF141BDC81929D7A3D2C86A2B15366,15411,1,6,5,44,27,2227
84660,84660,D3EF141BDC81929D7A3D2C86A2B15366,12611,6,13,7,41,29,2079
84661,84661,D3EF141BDC81929D7A3D2C86A2B15366,15411,18,19,1,44,27,2227
84662,84662,D3EF141BDC81929D7A3D2C86A2B15366,12611,20,21,1,41,29,2079
84663,84663,9A38471F29C616F9951DCE5B3B0692E3,10511,1,2,1,35,46,1796
84664,84664,9A38471F29C616F9951DCE5B3B0692E3,42151,2,5,3,35,45,1795
84665,84665,9A38471F29C616F9951DCE5B3B0692E3,10491,8,9,1,33,48,1698
84666,84666,9A38471F29C616F9951DCE5B3B0692E3,13651,9,15,6,30,47,1547
84667,84667,9A38471F29C616F9951DCE5B3B0692E3,11151,18,19,1,30,48,1548
84668,84668,9A38471F29C616F9951DCE5B3B0692E3,12131,21,22,1,32,47,1647
84672,84672,0EC1D2502267B7D6F36C8EA9D8EC3DDA,10171,0,7,7,26,47,1347
84673,84673,0EC1D2502267B7D6F36C8EA9D8EC3DDA,11001,9,18,9,42,47,2147
84674,84674,0EC1D2502267B7D6F36C8EA9D8EC3DDA,10171,19,22,3,26,47,1347
84675,84675,4CCB55254B52DB3F5A81A19CE1E78374,11231,0,8,8,37,49,1899
84676,84676,4CCB55254B52DB3F5A81A19CE1E78374,10121,11,13,2,36,49,1849
84677,84677,4CCB55254B52DB3F5A81A19CE1E78374,10661,15,17,2,37,49,1899
84678,84678,4CCB55254B52DB3F5A81A19CE1E78374,10121,17,20,3,36,49,1849
84679,84679,4CCB55254B52DB3F5A81A19CE1E78374,10661,22,23,1,37,49,1899
84683,84683,068FED97D465E9858DEA740965A57348,11231,9,10,1,37,49,1899
84684,84684,068FED97D465E9858DEA740965A57348,10901,13,15,2,35,48,1798
84685,84685,068FED97D465E9858DEA740965A57348,11231,15,18,3,37,49,1899
84686,84686,068FED97D465E9858DEA740965A57348,42141,19,22,3,32,47,1647
84687,84687,FDFFD3689D8C37E1D22EB7165084122F,42471,1,10,9,35,49,1799
84688,84688,FDFFD3689D8C37E1D22EB7165084122F,10421,18,19,1,41,48,2098
84689,84689,FDFFD3689D8C37E1D22EB7165084122F,43234,21,23,2,37,49,1899
84697,84697,9397083C419903E30A62F5C06D299D5C,42381,2,3,1,39,41,1991
84698,84698,9397083C419903E30A62F5C06D299D5C,43451,6,9,3,37,40,1890
84699,84699,9397083C419903E30A62F5C06D299D5C,42381,10,11,1,39,41,1991
84700,84700,9397083C419903E30A62F5C06D299D5C,13071,12,13,1,41,41,2091
84701,84701,9397083C419903E30A62F5C06D299D5C,42381,19,20,1,39,41,1991
84702,84702,9397083C419903E30A62F5C06D299D5C,13071,21,22,1,41,41,2091
84703,84703,6F5C3F3E991E6C719894B0F1EC34AF94,43011,0,5,5,40,42,2042
84704,84704,6F5C3F3E991E6C719894B0F1EC34AF94,12761,6,12,6,25,40,1290
84705,84705,6F5C3F3E991E6C719894B0F1EC34AF94,13671,16,17,1,27,43,1393
84706,84706,6F5C3F3E991E6C719894B0F1EC34AF94,43011,19,21,2,40,42,2042
84710,84710,6CC24D921FE70D79D98FA5B7890BCB55,19441,0,3,3,8,46,446
84711,84711,6CC24D921FE70D79D98FA5B7890BCB55,42041,3,5,2,10,47,547
84712,84712,6CC24D921FE70D79D98FA5B7890BCB55,19441,5,19,14,8,46,446
84713,84713,6CC24D921FE70D79D98FA5B7890BCB55,11471,20,23,3,12,48,648
84714,84714,E92CAF6D4B44B37BBAB00740F2202866,42581,1,13,12,38,48,1948
84715,84715,E92CAF6D4B44B37BBAB00740F2202866,11701,15,16,1,43,48,2198
84716,84716,E92CAF6D4B44B37BBAB00740F2202866,42583,19,21,2,40,48,2048
84723,84723,A53DAA006542212C0F792E33874BF547,10221,1,12,11,34,49,1749
84724,84724,A53DAA006542212C0F792E33874BF547,11661,13,15,2,40,49,2049
84725,84725,A53DAA006542212C0F792E33874BF547,10971,17,19,2,35,47,1797
84726,84726,A53DAA006542212C0F792E33874BF547,43281,22,23,1,37,48,1898
84737,84737,D3BAC8C0E0992EDDBB0B9FF009EAFB6A,11381,0,8,8,30,47,1547
84738,84738,D3BAC8C0E0992EDDBB0B9FF009EAFB6A,43971,13,15,2,30,48,1548
84739,84739,D3BAC8C0E0992EDDBB0B9FF009EAFB6A,12083,15,16,1,36,49,1849
84740,84740,D3BAC8C0E0992EDDBB0B9FF009EAFB6A,11381,19,23,4,30,47,1547
84741,84741,F6F2E45DD62CF36C9B7066251C572F8C,42331,0,7,7,39,46,1996
84742,84742,F6F2E45DD62CF36C9B7066251C572F8C,13121,8,16,8,38,46,1946
84743,84743,F6F2E45DD62CF36C9B7066251C572F8C,13961,16,20,4,42,48,2148
84744,84744,F6F2E45DD62CF36C9B7066251C572F8C,42331,21,23,2,39,46,1996
84745,84745,DFE0075BA441F09CC854C6FA18C2E9B5,11791,0,6,6,38,49,1949
84746,84746,DFE0075BA441F09CC854C6FA18C2E9B5,11211,9,11,2,34,49,1749
84747,84747,DFE0075BA441F09CC854C6FA18C2E9B5,19621,12,13,1,5,46,296
84748,84748,DFE0075BA441F09CC854C6FA18C2E9B5,11531,15,18,3,34,49,1749
84749,84749,DFE0075BA441F09CC854C6FA18C2E9B5,42121,19,21,2,26,49,1349
84750,84750,DFE0075BA441F09CC854C6FA18C2E9B5,11791,22,23,1,38,49,1949
84751,84751,726D8BF6FE9D2B730CE8E7DD26F779CD,11381,0,1,1,30,47,1547
84752,84752,726D8BF6FE9D2B730CE8E7DD26F779CD,12121,6,7,1,29,47,1497
84753,84753,726D8BF6FE9D2B730CE8E7DD26F779CD,42501,8,9,1,28,47,1447
84754,84754,726D8BF6FE9D2B730CE8E7DD26F779CD,11131,11,13,2,33,48,1698
84755,84755,726D8BF6FE9D2B730CE8E7DD26F779CD,11381,18,19,1,30,47,1547
84756,84756,00AF64C30DD1AF7B063E67637E648889,10271,5,6,1,37,46,1896
84757,84757,00AF64C30DD1AF7B063E67637E648889,12221,8,11,3,43,44,2194
84758,84758,00AF64C30DD1AF7B063E67637E648889,10271,13,22,9,37,46,1896
84759,84759,DBB647C4A4603B7F4340A7E09EDD7C70,43051,0,5,5,46,45,2345
84760,84760,DBB647C4A4603B7F4340A7E09EDD7C70,11701,6,8,2,43,48,2198
84761,84761,DBB647C4A4603B7F4340A7E09EDD7C70,43051,11,23,12,46,45,2345
84766,84766,B768DBD477008511AD969C6F4C6366B9,10601,0,7,7,39,47,1997
84767,84767,B768DBD477008511AD969C6F4C6366B9,10771,8,9,1,41,46,2096
84768,84768,B768DBD477008511AD969C6F4C6366B9,10601,12,13,1,39,47,1997
84769,84769,B768DBD477008511AD969C6F4C6366B9,43241,18,21,3,36,46,1846
84770,84770,B768DBD477008511AD969C6F4C6366B9,13711,22,23,1,38,46,1946
84778,84778,2522D6E38ECAB5C3B8D9E645448C4F62,11081,3,17,14,35,46,1796
84779,84779,2522D6E38ECAB5C3B8D9E645448C4F62,11794,18,21,3,38,49,1949
84780,84780,2522D6E38ECAB5C3B8D9E645448C4F62,10111,22,23,1,37,47,1897
84781,84781,27C0C493D2738B1346B24DF1710FD5F2,19031,0,6,6,1,42,92
84782,84782,27C0C493D2738B1346B24DF1710FD5F2,12641,7,10,3,10,43,543
84783,84783,27C0C493D2738B1346B24DF1710FD5F2,19031,11,23,12,1,42,92
84784,84784,9B49BEB65E16F10DE8E30D5D01D652E3,10811,0,7,7,38,46,1946
84785,84785,9B49BEB65E16F10DE8E30D5D01D652E3,12311,12,17,5,30,44,1544
84786,84786,9B49BEB65E16F10DE8E30D5D01D652E3,11261,19,21,2,36,46,1846
84787,84787,9B49BEB65E16F10DE8E30D5D01D652E3,10811,22,23,1,38,46,1946
84798,84798,C242AD7A1BE8FEA8853CCDF59C1941FF,10801,0,1,1,42,47,2147
84799,84799,C242AD7A1BE8FEA8853CCDF59C1941FF,13841,2,8,6,40,46,2046
84800,84800,C242AD7A1BE8FEA8853CCDF59C1941FF,11461,9,11,2,37,49,1899
84801,84801,C242AD7A1BE8FEA8853CCDF59C1941FF,13094,18,20,2,21,42,1092
84802,84802,C242AD7A1BE8FEA8853CCDF59C1941FF,43161,21,23,2,35,47,1797
84806,84806,512965DC7E2584D886D6B5F50766448D,12083,0,2,2,36,49,1849
84807,84807,512965DC7E2584D886D6B5F50766448D,11861,3,7,4,32,47,1647
84808,84808,512965DC7E2584D886D6B5F50766448D,42623,15,16,1,22,49,1149
84809,84809,512965DC7E2584D886D6B5F50766448D,11861,18,23,5,32,47,1647
84810,84810,33DCEB99733F5490EC3E4641096F98E9,40402,0,6,6,41,46,2096
84811,84811,33DCEB99733F5490EC3E4641096F98E9,42861,8,18,10,37,44,1894
84812,84812,33DCEB99733F5490EC3E4641096F98E9,11806,18,23,5,41,48,2098
84813,84813,3BE46C14B2CA2CE1D859CAF16A631486,13341,0,13,13,44,45,2245
84814,84814,3BE46C14B2CA2CE1D859CAF16A631486,43951,13,15,2,49,41,2491
84815,84815,3BE46C14B2CA2CE1D859CAF16A631486,13341,20,22,2,44,45,2245
84828,84828,47F367271A3019C66832E2578732C11B,42941,0,7,7,37,47,1897
84829,84829,47F367271A3019C66832E2578732C11B,11491,9,12,3,36,47,1847
84830,84830,47F367271A3019C66832E2578732C11B,40341,15,18,3,23,49,1199
84831,84831,47F367271A3019C66832E2578732C11B,11491,20,21,1,36,47,1847
84832,84832,A1E88710F597AD993ACF1C23AEB06926,42271,7,9,2,40,47,2047
84833,84833,A1E88710F597AD993ACF1C23AEB06926,16441,14,16,2,15,17,767
84834,84834,A1E88710F597AD993ACF1C23AEB06926,42271,18,23,5,40,47,2047
84835,84835,974F76AAA3E21167ABAC6BE6648ADEC3,11921,0,6,6,38,48,1948
84836,84836,974F76AAA3E21167ABAC6BE6648ADEC3,40801,10,11,1,43,46,2196
84837,84837,974F76AAA3E21167ABAC6BE6648ADEC3,13791,15,23,8,42,47,2147
84842,84842,DAF070E37522449552E837969D087804,11171,0,6,6,33,48,1698
84843,84843,DAF070E37522449552E837969D087804,11231,7,11,4,37,49,1899
84844,84844,DAF070E37522449552E837969D087804,11171,11,13,2,33,48,1698
84845,84845,DAF070E37522449552E837969D087804,11231,15,18,3,37,49,1899
84846,84846,DAF070E37522449552E837969D087804,11171,20,23,3,33,48,1698
84850,84850,A80DE6EDA094D2F9075FE4FB6E0AAC46,42271,0,3,3,40,47,2047
84851,84851,A80DE6EDA094D2F9075FE4FB6E0AAC46,11806,3,4,1,41,48,2098
84852,84852,A80DE6EDA094D2F9075FE4FB6E0AAC46,42271,7,8,1,40,47,2047
84853,84853,A80DE6EDA094D2F9075FE4FB6E0AAC46,10601,12,15,3,39,47,1997
84854,84854,A80DE6EDA094D2F9075FE4FB6E0AAC46,10921,15,19,4,43,48,2198
84855,84855,A80DE6EDA094D2F9075FE4FB6E0AAC46,42271,19,22,3,40,47,2047
84856,84856,3AE9C3B6C0E6A8AA6B3B6C58033F1358,13941,0,6,6,41,47,2097
84857,84857,3AE9C3B6C0E6A8AA6B3B6C58033F1358,42981,7,11,4,36,49,1849
84858,84858,3AE9C3B6C0E6A8AA6B3B6C58033F1358,13741,11,13,2,37,49,1899
84859,84859,3AE9C3B6C0E6A8AA6B3B6C58033F1358,42981,13,18,5,36,49,1849
84860,84860,3AE9C3B6C0E6A8AA6B3B6C58033F1358,13941,18,22,4,41,47,2097
84865,84865,C7DA09D84BB6D5A3ABEAD976C8C0731E,42861,0,5,5,37,44,1894
84866,84866,C7DA09D84BB6D5A3ABEAD976C8C0731E,11261,9,10,1,36,46,1846
84867,84867,C7DA09D84BB6D5A3ABEAD976C8C0731E,42861,10,13,3,37,44,1894
84868,84868,C7DA09D84BB6D5A3ABEAD976C8C0731E,11261,14,16,2,36,46,1846
84869,84869,C7DA09D84BB6D5A3ABEAD976C8C0731E,42861,19,23,4,37,44,1894
84878,84878,DC55487259997B32C5BA24A9732036BD,13681,2,9,7,38,47,1947
84879,84879,DC55487259997B32C5BA24A9732036BD,42204,12,13,1,43,46,2196
84880,84880,DC55487259997B32C5BA24A9732036BD,42031,16,17,1,40,46,2046
84881,84881,DC55487259997B32C5BA24A9732036BD,13681,21,23,2,38,47,1947
84889,84889,C2A50BE7B064AAEC27D9E1859F234BD0,11954,0,9,9,32,49,1649
84890,84890,C2A50BE7B064AAEC27D9E1859F234BD0,11951,15,16,1,31,49,1599
84891,84891,C2A50BE7B064AAEC27D9E1859F234BD0,40611,18,20,2,35,47,1797
84892,84892,C2A50BE7B064AAEC27D9E1859F234BD0,40051,21,23,2,32,49,1649
84896,84896,004D26DDA49F4E295E56D0D4EFA58427,16261,0,2,2,3,3,153
84897,84897,004D26DDA49F4E295E56D0D4EFA58427,16011,4,14,10,3,4,154
84898,84898,004D26DDA49F4E295E56D0D4EFA58427,11541,17,18,1,35,49,1799
84899,84899,004D26DDA49F4E295E56D0D4EFA58427,11731,22,23,1,36,48,1848
84900,84900,4939079DBC41D72C03B48C02C72AD37E,43021,0,6,6,16,43,843
84901,84901,4939079DBC41D72C03B48C02C72AD37E,12921,8,10,2,9,41,491
84902,84902,4939079DBC41D72C03B48C02C72AD37E,43021,11,12,1,16,43,843
84903,84903,4939079DBC41D72C03B48C02C72AD37E,12921,15,17,2,9,41,491
84904,84904,4939079DBC41D72C03B48C02C72AD37E,43021,20,23,3,16,43,843
84905,84905,9259900CF1484CEAFCB0BE9321BC8694,10691,0,7,7,33,48,1698
84906,84906,9259900CF1484CEAFCB0BE9321BC8694,13331,9,10,1,38,47,1947
84907,84907,9259900CF1484CEAFCB0BE9321BC8694,10471,12,18,6,37,48,1898
84908,84908,9259900CF1484CEAFCB0BE9321BC8694,10401,20,21,1,33,49,1699
84909,84909,9259900CF1484CEAFCB0BE9321BC8694,10691,22,23,1,33,48,1698
84910,84910,DC0D8934916D54D9527BB54B38A2F92C,10501,9,11,2,22,46,1146
84911,84911,DC0D8934916D54D9527BB54B38A2F92C,42711,12,13,1,26,48,1348
84912,84912,DC0D8934916D54D9527BB54B38A2F92C,10501,16,19,3,22,46,1146
84913,84913,DC0D8934916D54D9527BB54B38A2F92C,12601,19,22,3,25,47,1297
84921,84921,98BAC9D7C38A055D8666EE1E1444386F,12871,0,8,8,22,33,1133
84922,84922,98BAC9D7C38A055D8666EE1E1444386F,19281,10,21,11,16,32,832
84923,84923,98BAC9D7C38A055D8666EE1E1444386F,12871,22,23,1,22,33,1133
84931,84931,181B5103F0FBF120AFF5BEC3A26A3DB7,43761,0,1,1,32,47,1647
84932,84932,181B5103F0FBF120AFF5BEC3A26A3DB7,11161,3,5,2,32,48,1648
84933,84933,181B5103F0FBF120AFF5BEC3A26A3DB7,42141,7,18,11,32,47,1647
84934,84934,181B5103F0FBF120AFF5BEC3A26A3DB7,42521,18,20,2,31,47,1597
84935,84935,181B5103F0FBF120AFF5BEC3A26A3DB7,43761,21,23,2,32,47,1647
84936,84936,D8963F7C81A647B0DB7A8BBF70036A0B,12514,0,1,1,38,47,1947
84937,84937,D8963F7C81A647B0DB7A8BBF70036A0B,42221,2,8,6,38,48,1948
84938,84938,D8963F7C81A647B0DB7A8BBF70036A0B,11231,9,12,3,37,49,1899
84939,84939,D8963F7C81A647B0DB7A8BBF70036A0B,10107,13,16,3,38,49,1949
84940,84940,D8963F7C81A647B0DB7A8BBF70036A0B,11231,19,21,2,37,49,1899
84944,84944,4BE03AB7B88CA8091DBCEF6257C15779,42371,0,5,5,34,46,1746
84945,84945,4BE03AB7B88CA8091DBCEF6257C15779,11161,6,7,1,32,48,1648
84946,84946,4BE03AB7B88CA8091DBCEF6257C15779,43761,7,13,6,32,47,1647
84947,84947,4BE03AB7B88CA8091DBCEF6257C15779,42521,13,18,5,31,47,1597
84948,84948,4BE03AB7B88CA8091DBCEF6257C15779,11161,20,22,2,32,48,1648
84952,84952,D2E6AB586A09EFBBD099D10181890291,11061,0,9,9,29,48,1498
84953,84953,D2E6AB586A09EFBBD099D10181890291,42501,12,13,1,28,47,1447
84954,84954,D2E6AB586A09EFBBD099D10181890291,11061,15,16,1,29,48,1498
84955,84955,D2E6AB586A09EFBBD099D10181890291,42501,17,18,1,28,47,1447
84956,84956,D2E6AB586A09EFBBD099D10181890291,11281,19,20,1,27,40,1390
84960,84960,5AF26FD3EDD59D73F20E2AE7E3BEDAFF,10681,0,6,6,30,48,1548
84961,84961,5AF26FD3EDD59D73F20E2AE7E3BEDAFF,49201,7,14,7,7,41,391
84962,84962,5AF26FD3EDD59D73F20E2AE7E3BEDAFF,12921,16,17,1,9,41,491
84963,84963,5AF26FD3EDD59D73F20E2AE7E3BEDAFF,49201,21,23,2,7,41,391
84964,84964,33F80FB1B3682C2C3CDF17BAD155C351,42151,0,9,9,35,45,1795
84965,84965,33F80FB1B3682C2C3CDF17BAD155C351,42861,9,11,2,37,44,1894
84966,84966,33F80FB1B3682C2C3CDF17BAD155C351,42151,12,17,5,35,45,1795
84967,84967,33F80FB1B3682C2C3CDF17BAD155C351,11861,20,22,2,32,47,1647
84971,84971,6A033A0EADDB46E67519B419B27B2B4B,12031,0,7,7,33,48,1698
84972,84972,6A033A0EADDB46E67519B419B27B2B4B,42621,9,11,2,24,49,1249
84973,84973,6A033A0EADDB46E67519B419B27B2B4B,10491,18,23,5,33,48,1698
84978,84978,BB3DB8BDA13F245F7DA1B278DE6D4FF0,43021,0,3,3,16,43,843
84979,84979,BB3DB8BDA13F245F7DA1B278DE6D4FF0,12641,5,7,2,10,43,543
84980,84980,BB3DB8BDA13F245F7DA1B278DE6D4FF0,43021,11,23,12,16,43,843
84984,84984,8A8A9D1DCF5CE4C5E06E6D3FC9C4B051,42301,1,10,9,36,47,1847
84985,84985,8A8A9D1DCF5CE4C5E06E6D3FC9C4B051,43061,15,16,1,43,46,2196
84986,84986,8A8A9D1DCF5CE4C5E06E6D3FC9C4B051,13111,17,22,5,42,46,2146
84996,84996,733C937DB298F04AAEFCC56682186FAA,11741,1,8,7,42,49,2149
84997,84997,733C937DB298F04AAEFCC56682186FAA,10621,9,11,2,41,49,2099
84998,84998,733C937DB298F04AAEFCC56682186FAA,11741,12,16,4,42,49,2149
84999,84999,733C937DB298F04AAEFCC56682186FAA,41271,18,21,3,38,48,1948
85007,85007,617CDCBB763C8E42460705E2218A65BF,11074,0,4,4,37,47,1897
85008,85008,617CDCBB763C8E42460705E2218A65BF,42491,7,9,2,32,46,1646
85009,85009,617CDCBB763C8E42460705E2218A65BF,42523,9,10,1,31,47,1597
85010,85010,617CDCBB763C8E42460705E2218A65BF,43761,11,13,2,32,47,1647
85011,85011,617CDCBB763C8E42460705E2218A65BF,42491,16,17,1,32,46,1646
85012,85012,617CDCBB763C8E42460705E2218A65BF,43761,17,23,6,32,47,1647
85016,85016,CA7675D4504FF649E5D3C79C1D770D57,10901,0,6,6,35,48,1798
85017,85017,CA7675D4504FF649E5D3C79C1D770D57,10381,7,15,8,31,49,1599
85018,85018,CA7675D4504FF649E5D3C79C1D770D57,10901,18,23,5,35,48,1798
85022,85022,FBFB039BFE202B4D733B8197A5DE9AA1,43751,2,7,5,19,48,998
85023,85023,FBFB039BFE202B4D733B8197A5DE9AA1,12051,8,15,7,20,47,1047
85024,85024,FBFB039BFE202B4D733B8197A5DE9AA1,12581,16,18,2,24,48,1248
85025,85025,EF7EE9F0825E500C83748044E0BD2521,13651,0,8,8,30,47,1547
85026,85026,EF7EE9F0825E500C83748044E0BD2521,19021,10,11,1,10,45,545
85027,85027,EF7EE9F0825E500C83748044E0BD2521,10351,12,13,1,28,45,1445
85028,85028,EF7EE9F0825E500C83748044E0BD2521,13651,16,23,7,30,47,1547
85029,85029,DC4AF4725F7C80F74CE23BAEAD57BA2F,42091,0,9,9,43,46,2196
85030,85030,DC4AF4725F7C80F74CE23BAEAD57BA2F,42511,10,11,1,37,47,1897
85031,85031,DC4AF4725F7C80F74CE23BAEAD57BA2F,12521,13,19,6,35,41,1791
85042,85042,B7783E40C231BF2A915C5200F2E2562A,12031,0,9,9,33,48,1698
85043,85043,B7783E40C231BF2A915C5200F2E2562A,40951,10,15,5,36,49,1849
85044,85044,B7783E40C231BF2A915C5200F2E2562A,10161,16,17,1,35,49,1799
85045,85045,B7783E40C231BF2A915C5200F2E2562A,40951,17,19,2,36,49,1849
85046,85046,B7783E40C231BF2A915C5200F2E2562A,10491,20,22,2,33,48,1698
85050,85050,F40AC1EDE9EB783E2CA294E73A950959,42351,0,6,6,38,45,1945
85051,85051,F40AC1EDE9EB783E2CA294E73A950959,42231,7,11,4,37,46,1896
85052,85052,F40AC1EDE9EB783E2CA294E73A950959,42351,13,17,4,38,45,1945
85053,85053,F40AC1EDE9EB783E2CA294E73A950959,11074,19,20,1,37,47,1897
85054,85054,F40AC1EDE9EB783E2CA294E73A950959,11261,21,22,1,36,46,1846
85055,85055,8255A2F4BC245ABC1F6126838351DBA2,40637,0,1,1,36,47,1847
85056,85056,8255A2F4BC245ABC1F6126838351DBA2,10411,1,8,7,36,48,1848
85057,85057,8255A2F4BC245ABC1F6126838351DBA2,42531,12,15,3,31,45,1595
85058,85058,8255A2F4BC245ABC1F6126838351DBA2,12381,19,20,1,32,48,1648
85063,85063,9D369833089F92472FC6631700F511AB,12051,0,15,15,20,47,1047
85064,85064,9D369833089F92472FC6631700F511AB,42681,16,17,1,24,48,1248
85065,85065,9D369833089F92472FC6631700F511AB,12051,19,22,3,20,47,1047
85069,85069,FB8A3B40A5A14C5EDDE5181B01A70E2A,11261,1,8,7,36,46,1846
85070,85070,FB8A3B40A5A14C5EDDE5181B01A70E2A,42861,8,10,2,37,44,1894
85071,85071,FB8A3B40A5A14C5EDDE5181B01A70E2A,11261,10,11,1,36,46,1846
85072,85072,FB8A3B40A5A14C5EDDE5181B01A70E2A,42861,11,16,5,37,44,1894
85073,85073,FB8A3B40A5A14C5EDDE5181B01A70E2A,11261,20,21,1,36,46,1846
85074,85074,FB8A3B40A5A14C5EDDE5181B01A70E2A,42151,22,23,1,35,45,1795
85075,85075,7B1780D02DBAB86C859055603E266F6B,42161,0,9,9,36,47,1847
85076,85076,7B1780D02DBAB86C859055603E266F6B,13671,10,18,8,27,43,1393
85077,85077,7B1780D02DBAB86C859055603E266F6B,40094,21,22,1,29,48,1498
85081,85081,4A738DA40DC51A413284A84FD94422C1,11631,5,11,6,12,49,649
85082,85082,4A738DA40DC51A413284A84FD94422C1,11151,12,13,1,30,48,1548
85083,85083,4A738DA40DC51A413284A84FD94422C1,11061,16,20,4,29,48,1498
85084,85084,27B6DDFE3A356062F221ABD7AD70BB14,11061,0,9,9,29,48,1498
85085,85085,27B6DDFE3A356062F221ABD7AD70BB14,10681,9,12,3,30,48,1548
85086,85086,27B6DDFE3A356062F221ABD7AD70BB14,11061,12,16,4,29,48,1498
85087,85087,27B6DDFE3A356062F221ABD7AD70BB14,10681,17,19,2,30,48,1548
85088,85088,27B6DDFE3A356062F221ABD7AD70BB14,11061,19,23,4,29,48,1498
85093,85093,9F8C865EE2A9CFFC2444EE9A2D43A357,10221,0,5,5,34,49,1749
85094,85094,9F8C865EE2A9CFFC2444EE9A2D43A357,10491,5,18,13,33,48,1698
85095,85095,9F8C865EE2A9CFFC2444EE9A2D43A357,11061,19,22,3,29,48,1498
85096,85096,A2DD7BA75FCE1B5306A377D198F94491,12792,1,4,3,34,30,1730
85097,85097,A2DD7BA75FCE1B5306A377D198F94491,15391,8,10,2,35,26,1776
85098,85098,A2DD7BA75FCE1B5306A377D198F94491,12792,15,16,1,34,30,1730
85099,85099,A2DD7BA75FCE1B5306A377D198F94491,15391,20,22,2,35,26,1776
85100,85100,E89C7657A21278EA8E51337529892FD6,10691,0,6,6,33,48,1698
85101,85101,E89C7657A21278EA8E51337529892FD6,42491,7,10,3,32,46,1646
85102,85102,E89C7657A21278EA8E51337529892FD6,10431,11,12,1,33,49,1699
85103,85103,E89C7657A21278EA8E51337529892FD6,42491,13,16,3,32,46,1646
85104,85104,E89C7657A21278EA8E51337529892FD6,42021,17,18,1,33,47,1697
85105,85105,E89C7657A21278EA8E51337529892FD6,10691,19,23,4,33,48,1698
85115,85115,CB6CE8B284764CB65EC4187E6FE5A3FF,43021,0,6,6,16,43,843
85116,85116,CB6CE8B284764CB65EC4187E6FE5A3FF,11571,9,12,3,13,46,696
85117,85117,CB6CE8B284764CB65EC4187E6FE5A3FF,43021,12,21,9,16,43,843
85118,85118,CB6CE8B284764CB65EC4187E6FE5A3FF,19021,22,23,1,10,45,545
85119,85119,AE0FCD2E71074EC83400DA10B63EF737,42141,0,8,8,32,47,1647
85120,85120,AE0FCD2E71074EC83400DA10B63EF737,11074,10,12,2,37,47,1897
85121,85121,AE0FCD2E71074EC83400DA10B63EF737,42141,18,23,5,32,47,1647
85122,85122,48DCE60D429B0B1E7F2F1B7A462BF9BF,11861,0,2,2,32,47,1647
85123,85123,48DCE60D429B0B1E7F2F1B7A462BF9BF,13651,4,11,7,30,47,1547
85124,85124,48DCE60D429B0B1E7F2F1B7A462BF9BF,42523,12,15,3,31,47,1597
85125,85125,48DCE60D429B0B1E7F2F1B7A462BF9BF,11861,15,17,2,32,47,1647
85126,85126,48DCE60D429B0B1E7F2F1B7A462BF9BF,10341,17,19,2,31,47,1597
85127,85127,48DCE60D429B0B1E7F2F1B7A462BF9BF,11861,21,23,2,32,47,1647
85144,85144,CDBAA18CDFFF08A273B9E6BC73E59B8B,11834,0,9,9,32,45,1645
85145,85145,CDBAA18CDFFF08A273B9E6BC73E59B8B,42231,9,12,3,37,46,1896
85146,85146,CDBAA18CDFFF08A273B9E6BC73E59B8B,11834,15,17,2,32,45,1645
85147,85147,CDBAA18CDFFF08A273B9E6BC73E59B8B,42633,20,23,3,42,46,2146
85151,85151,E675A65705B47E64E764764AA7201F3F,15411,2,13,11,44,27,2227
85152,85152,E675A65705B47E64E764764AA7201F3F,12611,15,17,2,41,29,2079
85153,85153,E675A65705B47E64E764764AA7201F3F,15411,17,22,5,44,27,2227
85154,85154,BD318E9AF2E060A187A0EF37B2B8ED3A,12381,0,7,7,32,48,1648
85155,85155,BD318E9AF2E060A187A0EF37B2B8ED3A,42231,8,11,3,37,46,1896
85156,85156,BD318E9AF2E060A187A0EF37B2B8ED3A,10841,12,13,1,37,47,1897
85157,85157,BD318E9AF2E060A187A0EF37B2B8ED3A,10161,15,20,5,35,49,1799
85158,85158,BD318E9AF2E060A187A0EF37B2B8ED3A,12381,21,23,2,32,48,1648
85159,85159,340EDD88D12FF48F7C7FFC4318436C37,11381,1,11,10,30,47,1547
85160,85160,340EDD88D12FF48F7C7FFC4318436C37,40341,17,18,1,23,49,1199
85161,85161,340EDD88D12FF48F7C7FFC4318436C37,10951,18,20,2,29,48,1498
85162,85162,340EDD88D12FF48F7C7FFC4318436C37,11381,21,23,2,30,47,1547
85163,85163,6B2E238C2A4978AFB452986609DB74C2,42523,1,6,5,31,47,1597
85164,85164,6B2E238C2A4978AFB452986609DB74C2,43761,8,15,7,32,47,1647
85165,85165,6B2E238C2A4978AFB452986609DB74C2,10841,19,20,1,37,47,1897
85166,85166,6B2E238C2A4978AFB452986609DB74C2,42523,20,23,3,31,47,1597
85167,85167,8C54F679DD59F109DAF19BDB41D1658A,12121,1,6,5,29,47,1497
85168,85168,8C54F679DD59F109DAF19BDB41D1658A,10951,7,8,1,29,48,1498
85169,85169,8C54F679DD59F109DAF19BDB41D1658A,11461,12,13,1,37,49,1899
85170,85170,8C54F679DD59F109DAF19BDB41D1658A,11061,15,17,2,29,48,1498
85171,85171,8C54F679DD59F109DAF19BDB41D1658A,12121,18,20,2,29,47,1497
85172,85172,8C54F679DD59F109DAF19BDB41D1658A,11531,22,23,1,34,49,1749
85173,85173,84F67B4B3C17ACCABE2B7DC342CF0E8C,16151,1,10,9,13,11,661
85174,85174,84F67B4B3C17ACCABE2B7DC342CF0E8C,15114,12,13,1,22,16,1116
85175,85175,84F67B4B3C17ACCABE2B7DC342CF0E8C,16151,13,23,10,13,11,661
85176,85176,4D239E998445105BB1DB28C4CB8040D2,12514,0,6,6,38,47,1947
85177,85177,4D239E998445105BB1DB28C4CB8040D2,11914,7,10,3,37,48,1898
85178,85178,4D239E998445105BB1DB28C4CB8040D2,42581,11,12,1,38,48,1948
85179,85179,4D239E998445105BB1DB28C4CB8040D2,12514,15,16,1,38,47,1947
85180,85180,4D239E998445105BB1DB28C4CB8040D2,42581,21,23,2,38,48,1948
85194,85194,74027EE8D9052C6DCDF13D12A9D0BC68,13251,0,7,7,48,28,2428
85195,85195,74027EE8D9052C6DCDF13D12A9D0BC68,13121,7,10,3,38,46,1946
85196,85196,74027EE8D9052C6DCDF13D12A9D0BC68,13251,11,22,11,48,28,2428
85197,85197,84D5DD5743261CBA6220A6F1E627F47F,40171,0,1,1,38,48,1948
85198,85198,84D5DD5743261CBA6220A6F1E627F47F,43581,4,7,3,33,48,1698
85199,85199,84D5DD5743261CBA6220A6F1E627F47F,11061,9,13,4,29,48,1498
85200,85200,84D5DD5743261CBA6220A6F1E627F47F,12971,16,17,1,32,48,1648
85201,85201,84D5DD5743261CBA6220A6F1E627F47F,11521,19,20,1,41,48,2098
85202,85202,84D5DD5743261CBA6220A6F1E627F47F,11061,21,23,2,29,48,1498
85203,85203,D622AAD01DD5982861A246970AE90D47,11381,1,11,10,30,47,1547
85204,85204,D622AAD01DD5982861A246970AE90D47,42381,15,18,3,39,41,1991
85205,85205,D622AAD01DD5982861A246970AE90D47,11381,19,23,4,30,47,1547
85212,85212,24576DC2C63BF30A46BA06C33A71F868,13911,0,1,1,39,46,1996
85213,85213,24576DC2C63BF30A46BA06C33A71F868,12491,1,5,4,36,43,1843
85214,85214,24576DC2C63BF30A46BA06C33A71F868,11261,6,10,4,36,46,1846
85215,85215,24576DC2C63BF30A46BA06C33A71F868,12491,10,14,4,36,43,1843
85216,85216,24576DC2C63BF30A46BA06C33A71F868,11261,15,17,2,36,46,1846
85217,85217,24576DC2C63BF30A46BA06C33A71F868,12491,21,22,1,36,43,1843
85218,85218,B48E4C408DBFAE36CBADDF9B2320388A,42271,1,3,2,40,47,2047
85219,85219,B48E4C408DBFAE36CBADDF9B2320388A,40171,3,11,8,38,48,1948
85220,85220,B48E4C408DBFAE36CBADDF9B2320388A,11331,12,17,5,37,48,1898
85221,85221,B48E4C408DBFAE36CBADDF9B2320388A,40341,18,21,3,23,49,1199
85228,85228,F90313BC40FFD1908C2B8D9FAFC50C6B,11261,0,6,6,36,46,1846
85229,85229,F90313BC40FFD1908C2B8D9FAFC50C6B,12601,9,16,7,25,47,1297
85230,85230,F90313BC40FFD1908C2B8D9FAFC50C6B,11261,21,23,2,36,46,1846
85231,85231,4F6A74BBD714EF065A4DB365EFF3390D,11271,0,7,7,37,48,1898
85232,85232,4F6A74BBD714EF065A4DB365EFF3390D,12083,8,11,3,36,49,1849
85233,85233,4F6A74BBD714EF065A4DB365EFF3390D,11271,12,14,2,37,48,1898
85234,85234,4F6A74BBD714EF065A4DB365EFF3390D,42971,15,17,2,43,49,2199
85235,85235,4F6A74BBD714EF065A4DB365EFF3390D,11291,18,19,1,40,49,2049
85239,85239,FEBD122FF83E402204912098A86567F3,43761,0,8,8,32,47,1647
85240,85240,FEBD122FF83E402204912098A86567F3,40302,9,10,1,40,49,2049
85241,85241,FEBD122FF83E402204912098A86567F3,43761,13,20,7,32,47,1647
85242,85242,FEBD122FF83E402204912098A86567F3,42021,20,22,2,33,47,1697
85243,85243,F276DA0C0E39AE3BAD5B91AE46CB6EA8,10471,0,1,1,37,48,1898
85244,85244,F276DA0C0E39AE3BAD5B91AE46CB6EA8,11231,5,6,1,37,49,1899
85245,85245,F276DA0C0E39AE3BAD5B91AE46CB6EA8,10471,11,12,1,37,48,1898
85246,85246,F276DA0C0E39AE3BAD5B91AE46CB6EA8,11231,14,18,4,37,49,1899
85247,85247,F276DA0C0E39AE3BAD5B91AE46CB6EA8,42971,21,22,1,43,49,2199
85251,85251,7C7590A7661FDF4886D00AA41D769E6E,15091,2,4,2,35,26,1776
85252,85252,7C7590A7661FDF4886D00AA41D769E6E,43081,4,6,2,27,28,1378
85253,85253,7C7590A7661FDF4886D00AA41D769E6E,15191,6,10,4,36,27,1827
85254,85254,7C7590A7661FDF4886D00AA41D769E6E,15091,13,19,6,35,26,1776
85255,85255,7C7590A7661FDF4886D00AA41D769E6E,43081,19,21,2,27,28,1378
85256,85256,7C7590A7661FDF4886D00AA41D769E6E,15191,22,23,1,36,27,1827
85257,85257,BBCB9918D42B41DEDF16DD7F5A9BE26F,11861,0,9,9,32,47,1647
85258,85258,BBCB9918D42B41DEDF16DD7F5A9BE26F,42161,9,12,3,36,47,1847
85259,85259,BBCB9918D42B41DEDF16DD7F5A9BE26F,11911,12,17,5,37,48,1898
85260,85260,BBCB9918D42B41DEDF16DD7F5A9BE26F,42021,17,23,6,33,47,1697
85264,85264,B8A307DC401D07931A2F403AC35943A6,42351,9,11,2,38,45,1945
85265,85265,B8A307DC401D07931A2F403AC35943A6,42231,11,12,1,37,46,1896
85266,85266,B8A307DC401D07931A2F403AC35943A6,13911,13,15,2,39,46,1996
85267,85267,B8A307DC401D07931A2F403AC35943A6,11074,16,18,2,37,47,1897
85268,85268,B8A307DC401D07931A2F403AC35943A6,42351,20,21,1,38,45,1945
85269,85269,8123312A9D40FCE9F32767A0B3A11F65,11301,2,8,6,41,49,2099
85270,85270,8123312A9D40FCE9F32767A0B3A11F65,10921,9,10,1,43,48,2198
85271,85271,8123312A9D40FCE9F32767A0B3A11F65,11301,14,17,3,41,49,2099
85272,85272,8123312A9D40FCE9F32767A0B3A11F65,11901,18,20,2,42,49,2149
85273,85273,8123312A9D40FCE9F32767A0B3A11F65,10107,20,21,1,38,49,1949
85274,85274,8123312A9D40FCE9F32767A0B3A11F65,11301,21,23,2,41,49,2099
85275,85275,1331EB294578A8B5035A897C4CDC8F40,42523,0,7,7,31,47,1597
85276,85276,1331EB294578A8B5035A897C4CDC8F40,43761,9,10,1,32,47,1647
85277,85277,1331EB294578A8B5035A897C4CDC8F40,42523,14,15,1,31,47,1597
85278,85278,1331EB294578A8B5035A897C4CDC8F40,42141,19,21,2,32,47,1647
85279,85279,1331EB294578A8B5035A897C4CDC8F40,42491,21,22,1,32,46,1646
85295,85295,5C087BE097BD7C65E07DEF266C8D9DC9,42521,0,3,3,31,47,1597
85296,85296,5C087BE097BD7C65E07DEF266C8D9DC9,10295,4,6,2,30,47,1547
85297,85297,5C087BE097BD7C65E07DEF266C8D9DC9,43731,8,12,4,34,47,1747
85298,85298,5C087BE097BD7C65E07DEF266C8D9DC9,42161,15,16,1,36,47,1847
85299,85299,5C087BE097BD7C65E07DEF266C8D9DC9,43731,16,18,2,34,47,1747
85300,85300,5C087BE097BD7C65E07DEF266C8D9DC9,42161,21,22,1,36,47,1847
85319,85319,7C3D8D6A0621EB24608684305ED7A7E5,11361,0,6,6,22,48,1148
85320,85320,7C3D8D6A0621EB24608684305ED7A7E5,11101,6,7,1,18,48,948
85321,85321,7C3D8D6A0621EB24608684305ED7A7E5,11361,11,19,8,22,48,1148
85322,85322,7C3D8D6A0621EB24608684305ED7A7E5,11531,20,21,1,34,49,1749
85323,85323,D48C648C1D8E99D79DDC90BDE949351A,13231,0,3,3,39,46,1996
85324,85324,D48C648C1D8E99D79DDC90BDE949351A,11261,3,14,11,36,46,1846
85325,85325,D48C648C1D8E99D79DDC90BDE949351A,11111,17,18,1,26,48,1348
85326,85326,D48C648C1D8E99D79DDC90BDE949351A,10841,21,23,2,37,47,1897
85327,85327,147320C3133F09A06423F79D22663CE8,12521,1,12,11,35,41,1791
85328,85328,147320C3133F09A06423F79D22663CE8,13041,13,15,2,30,37,1537
85329,85329,147320C3133F09A06423F79D22663CE8,12521,15,22,7,35,41,1791
85337,85337,E2FC80C995A3EFA4B2AF01BAD4B24C1C,12083,0,10,10,36,49,1849
85338,85338,E2FC80C995A3EFA4B2AF01BAD4B24C1C,42871,12,13,1,30,45,1545
85339,85339,E2FC80C995A3EFA4B2AF01BAD4B24C1C,12083,17,23,6,36,49,1849
85343,85343,2CA7F7242E76579D7DF2C857A1AA360C,40941,0,1,1,32,48,1648
85344,85344,2CA7F7242E76579D7DF2C857A1AA360C,42321,3,14,11,43,47,2197
85345,85345,2CA7F7242E76579D7DF2C857A1AA360C,10221,15,17,2,34,49,1749
85346,85346,2CA7F7242E76579D7DF2C857A1AA360C,11231,18,19,1,37,49,1899
85347,85347,2CA7F7242E76579D7DF2C857A1AA360C,12971,20,23,3,32,48,1648
85348,85348,EAAB672210C677BA2879CCE67BDB7DF5,11151,0,5,5,30,48,1548
85349,85349,EAAB672210C677BA2879CCE67BDB7DF5,10381,6,10,4,31,49,1599
85350,85350,EAAB672210C677BA2879CCE67BDB7DF5,11151,11,13,2,30,48,1548
85351,85351,EAAB672210C677BA2879CCE67BDB7DF5,10381,14,16,2,31,49,1599
85352,85352,EAAB672210C677BA2879CCE67BDB7DF5,42831,16,17,1,27,48,1398
85353,85353,EAAB672210C677BA2879CCE67BDB7DF5,11151,18,23,5,30,48,1548
85374,85374,BCBA00BEAEB6DE0B9A71959AB040ABB5,12221,0,5,5,43,44,2194
85375,85375,BCBA00BEAEB6DE0B9A71959AB040ABB5,42631,7,11,4,43,45,2195
85376,85376,BCBA00BEAEB6DE0B9A71959AB040ABB5,12221,12,13,1,43,44,2194
85377,85377,BCBA00BEAEB6DE0B9A71959AB040ABB5,42631,13,15,2,43,45,2195
85378,85378,BCBA00BEAEB6DE0B9A71959AB040ABB5,11481,17,22,5,41,48,2098
85379,85379,085A54B112E93B58F53705ABE7F444E7,42601,6,8,2,44,48,2248
85380,85380,085A54B112E93B58F53705ABE7F444E7,43621,9,10,1,46,48,2348
85381,85381,085A54B112E93B58F53705ABE7F444E7,13471,12,13,1,47,49,2399
85382,85382,085A54B112E93B58F53705ABE7F444E7,43621,14,15,1,46,48,2348
85383,85383,085A54B112E93B58F53705ABE7F444E7,42601,18,20,2,44,48,2248
85384,85384,085A54B112E93B58F53705ABE7F444E7,13471,21,23,2,47,49,2399
85385,85385,F2CD95DF225347E0C0C222BAC5742374,10634,4,6,2,27,45,1395
85386,85386,F2CD95DF225347E0C0C222BAC5742374,13651,7,8,1,30,47,1547
85387,85387,F2CD95DF225347E0C0C222BAC5742374,40381,9,11,2,32,46,1646
85388,85388,F2CD95DF225347E0C0C222BAC5742374,10634,13,15,2,27,45,1395
85389,85389,F2CD95DF225347E0C0C222BAC5742374,42021,20,21,1,33,47,1697
85393,85393,0A06E26D4B63B311703019BBFB7FEF42,10381,0,3,3,31,49,1599
85394,85394,0A06E26D4B63B311703019BBFB7FEF42,10471,3,18,15,37,48,1898
85395,85395,0A06E26D4B63B311703019BBFB7FEF42,10401,19,20,1,33,49,1699
85396,85396,0A06E26D4B63B311703019BBFB7FEF42,11201,20,23,3,35,49,1799
85397,85397,A4F650955D0F2E8B3DBCA61C267939BC,13651,0,13,13,30,47,1547
85398,85398,A4F650955D0F2E8B3DBCA61C267939BC,42161,15,17,2,36,47,1847
85399,85399,A4F650955D0F2E8B3DBCA61C267939BC,13651,21,22,1,30,47,1547
85400,85400,845099180B2D20E8B353EF994AE250AC,42031,0,15,15,40,46,2046
85401,85401,845099180B2D20E8B353EF994AE250AC,11331,16,17,1,37,48,1898
85402,85402,845099180B2D20E8B353EF994AE250AC,42031,20,23,3,40,46,2046
85403,85403,346BF3F539A4C5C04EF0491F7207CF76,19114,0,5,5,7,43,393
85404,85404,346BF3F539A4C5C04EF0491F7207CF76,12641,5,8,3,10,43,543
85405,85405,346BF3F539A4C5C04EF0491F7207CF76,19021,8,9,1,10,45,545
85406,85406,346BF3F539A4C5C04EF0491F7207CF76,12641,15,17,2,10,43,543
85407,85407,346BF3F539A4C5C04EF0491F7207CF76,19114,18,23,5,7,43,393
85408,85408,1AAA21044A088724F55D52327AA438E4,11861,9,13,4,32,47,1647
85409,85409,1AAA21044A088724F55D52327AA438E4,42511,15,16,1,37,47,1897
85410,85410,1AAA21044A088724F55D52327AA438E4,43761,20,21,1,32,47,1647
85421,85421,FA5E97B8E90C5A955BBD79C61D708804,10431,0,13,13,33,49,1699
85422,85422,FA5E97B8E90C5A955BBD79C61D708804,42941,13,15,2,37,47,1897
85423,85423,FA5E97B8E90C5A955BBD79C61D708804,10431,19,23,4,33,49,1699
85424,85424,711198BFAB79ECCB6C11C1945EA45B0D,43644,0,5,5,14,38,738
85425,85425,711198BFAB79ECCB6C11C1945EA45B0D,12921,9,14,5,9,41,491
85426,85426,711198BFAB79ECCB6C11C1945EA45B0D,11631,18,22,4,12,49,649
85427,85427,FF0C11254BA355CCA708C36EE5C4353D,11381,0,7,7,30,47,1547
85428,85428,FF0C11254BA355CCA708C36EE5C4353D,42111,8,17,9,44,46,2246
85429,85429,FF0C11254BA355CCA708C36EE5C4353D,11381,18,23,5,30,47,1547
85430,85430,A11021665283D6C62A5E3EE561A2FB8C,11261,0,1,1,36,46,1846
85431,85431,A11021665283D6C62A5E3EE561A2FB8C,42351,2,3,1,38,45,1945
85432,85432,A11021665283D6C62A5E3EE561A2FB8C,11261,3,6,3,36,46,1846
85433,85433,A11021665283D6C62A5E3EE561A2FB8C,42351,8,12,4,38,45,1945
85434,85434,A11021665283D6C62A5E3EE561A2FB8C,11261,12,14,2,36,46,1846
85435,85435,A11021665283D6C62A5E3EE561A2FB8C,13911,14,19,5,39,46,1996
85436,85436,CDD868B7CD2EE63A11365508386D7821,42371,0,7,7,34,46,1746
85437,85437,CDD868B7CD2EE63A11365508386D7821,12311,7,8,1,30,44,1544
85438,85438,CDD868B7CD2EE63A11365508386D7821,42371,11,13,2,34,46,1746
85439,85439,CDD868B7CD2EE63A11365508386D7821,11231,15,16,1,37,49,1899
85440,85440,CDD868B7CD2EE63A11365508386D7821,42371,17,18,1,34,46,1746
85441,85441,CDD868B7CD2EE63A11365508386D7821,10881,19,23,4,34,48,1748
85445,85445,6096B1727CEF2FA2F6084BB7C1D00A7C,16441,3,5,2,15,17,767
85446,85446,6096B1727CEF2FA2F6084BB7C1D00A7C,16231,6,8,2,11,15,565
85447,85447,6096B1727CEF2FA2F6084BB7C1D00A7C,15114,9,12,3,22,16,1116
85448,85448,6096B1727CEF2FA2F6084BB7C1D00A7C,15421,15,17,2,20,18,1018
85449,85449,6096B1727CEF2FA2F6084BB7C1D00A7C,15114,17,18,1,22,16,1116
85450,85450,6096B1727CEF2FA2F6084BB7C1D00A7C,16231,19,22,3,11,15,565
85451,85451,5A94336DADEC71A201B6EE1AC7B33E86,11531,2,6,4,34,49,1749
85452,85452,5A94336DADEC71A201B6EE1AC7B33E86,10191,7,18,11,40,48,2048
85453,85453,5A94336DADEC71A201B6EE1AC7B33E86,42971,18,20,2,43,49,2199
85454,85454,5A94336DADEC71A201B6EE1AC7B33E86,10191,21,22,1,40,48,2048
85458,85458,F0D2167C8002A5BE9DA4F82074AFEE15,13111,0,11,11,42,46,2146
85459,85459,F0D2167C8002A5BE9DA4F82074AFEE15,40801,12,15,3,43,46,2196
85460,85460,F0D2167C8002A5BE9DA4F82074AFEE15,13091,18,19,1,20,42,1042
85461,85461,F0D2167C8002A5BE9DA4F82074AFEE15,13111,20,23,3,42,46,2146
85466,85466,61CC7CB5EA609C6320BD2A3529DD90CF,11911,0,6,6,37,48,1898
85467,85467,61CC7CB5EA609C6320BD2A3529DD90CF,13121,9,11,2,38,46,1946
85468,85468,61CC7CB5EA609C6320BD2A3529DD90CF,10271,11,14,3,37,46,1896
85469,85469,61CC7CB5EA609C6320BD2A3529DD90CF,13121,15,17,2,38,46,1946
85470,85470,61CC7CB5EA609C6320BD2A3529DD90CF,11911,18,23,5,37,48,1898
85471,85471,04FC279D8763FD0D52EBF8F599CB8F45,10121,0,8,8,36,49,1849
85472,85472,04FC279D8763FD0D52EBF8F599CB8F45,42511,9,21,12,37,47,1897
85473,85473,04FC279D8763FD0D52EBF8F599CB8F45,11521,21,23,2,41,48,2098
85474,85474,68C9F04DAA4541DA8F80DE2D18F7E884,13471,0,8,8,47,49,2399
85475,85475,68C9F04DAA4541DA8F80DE2D18F7E884,42801,10,14,4,40,49,2049
85476,85476,68C9F04DAA4541DA8F80DE2D18F7E884,13471,17,18,1,47,49,2399
85477,85477,68C9F04DAA4541DA8F80DE2D18F7E884,42601,19,22,3,44,48,2248
85478,85478,7C58847480DE6BEF66566E51AC51CE71,10381,5,6,1,31,49,1599
85479,85479,7C58847480DE6BEF66566E51AC51CE71,42081,11,12,1,24,49,1249
85480,85480,7C58847480DE6BEF66566E51AC51CE71,10381,15,19,4,31,49,1599
85484,85484,E01DE11186C96A37795CE4A9BBA43FC1,11834,3,8,5,32,45,1645
85485,85485,E01DE11186C96A37795CE4A9BBA43FC1,12491,10,20,10,36,43,1843
85486,85486,E01DE11186C96A37795CE4A9BBA43FC1,42151,22,23,1,35,45,1795
85490,85490,AA0564E7F7FCC6943A6EA9EACCEA71BD,12381,0,5,5,32,48,1648
85491,85491,AA0564E7F7FCC6943A6EA9EACCEA71BD,40841,9,10,1,33,49,1699
85492,85492,AA0564E7F7FCC6943A6EA9EACCEA71BD,11461,12,13,1,37,49,1899
85493,85493,AA0564E7F7FCC6943A6EA9EACCEA71BD,43581,15,23,8,33,48,1698
85494,85494,60D23AD266759E2E814BBD58140F3538,43671,0,3,3,35,48,1798
85495,85495,60D23AD266759E2E814BBD58140F3538,11731,4,11,7,36,48,1848
85496,85496,60D23AD266759E2E814BBD58140F3538,11531,11,13,2,34,49,1749
85497,85497,60D23AD266759E2E814BBD58140F3538,11351,15,17,2,36,48,1848
85498,85498,60D23AD266759E2E814BBD58140F3538,43281,18,22,4,37,48,1898
85499,85499,1277ACA424D6A91D4C363B632562549C,12601,0,7,7,25,47,1297
85500,85500,1277ACA424D6A91D4C363B632562549C,10951,8,9,1,29,48,1498
85501,85501,1277ACA424D6A91D4C363B632562549C,10501,9,10,1,22,46,1146
85502,85502,1277ACA424D6A91D4C363B632562549C,12601,11,13,2,25,47,1297
85503,85503,1277ACA424D6A91D4C363B632562549C,10501,13,15,2,22,46,1146
85504,85504,1277ACA424D6A91D4C363B632562549C,12601,19,21,2,25,47,1297
85505,85505,29A4DCF52DC2F3624D699E5BA6DF8CE9,11231,9,12,3,37,49,1899
85506,85506,29A4DCF52DC2F3624D699E5BA6DF8CE9,43581,13,15,2,33,48,1698
85507,85507,29A4DCF52DC2F3624D699E5BA6DF8CE9,11231,17,19,2,37,49,1899
85508,85508,29A4DCF52DC2F3624D699E5BA6DF8CE9,10841,19,21,2,37,47,1897
85509,85509,29A4DCF52DC2F3624D699E5BA6DF8CE9,11231,22,23,1,37,49,1899
85510,85510,7072D45C58A4A94BABD1B710AD10F471,42351,3,5,2,38,45,1945
85511,85511,7072D45C58A4A94BABD1B710AD10F471,12311,6,13,7,30,44,1544
85512,85512,7072D45C58A4A94BABD1B710AD10F471,13911,17,19,2,39,46,1996
85513,85513,7072D45C58A4A94BABD1B710AD10F471,42351,20,22,2,38,45,1945
85514,85514,52B7C1F93C49E83607112CD6D0ABFEE0,13651,2,8,6,30,47,1547
85515,85515,52B7C1F93C49E83607112CD6D0ABFEE0,10711,10,11,1,29,46,1496
85516,85516,52B7C1F93C49E83607112CD6D0ABFEE0,11091,12,13,1,29,47,1497
85517,85517,52B7C1F93C49E83607112CD6D0ABFEE0,11061,15,17,2,29,48,1498
85518,85518,52B7C1F93C49E83607112CD6D0ABFEE0,10292,21,23,2,30,47,1547
85519,85519,CE26B8570DA2E6BAF7525A9993322910,11901,0,7,7,42,49,2149
85520,85520,CE26B8570DA2E6BAF7525A9993322910,42051,8,10,2,42,48,2148
85521,85521,CE26B8570DA2E6BAF7525A9993322910,10451,15,16,1,25,48,1298
85522,85522,CE26B8570DA2E6BAF7525A9993322910,11531,20,21,1,34,49,1749
85526,85526,414AA00EC00DAA3D830C87A4F3E4DD09,11861,0,10,10,32,47,1647
85527,85527,414AA00EC00DAA3D830C87A4F3E4DD09,10107,12,15,3,38,49,1949
85528,85528,414AA00EC00DAA3D830C87A4F3E4DD09,10121,19,23,4,36,49,1849
85538,85538,2E7B2253AC418B1A43B0E145571CC5CD,42511,0,9,9,37,47,1897
85539,85539,2E7B2253AC418B1A43B0E145571CC5CD,10511,9,11,2,35,46,1796
85540,85540,2E7B2253AC418B1A43B0E145571CC5CD,11701,19,20,1,43,48,2198
85541,85541,2E7B2253AC418B1A43B0E145571CC5CD,42511,21,23,2,37,47,1897
85560,85560,74D7455BA02D3AF6902685E6503704F2,11261,0,9,9,36,46,1846
85561,85561,74D7455BA02D3AF6902685E6503704F2,10411,12,13,1,36,48,1848
85562,85562,74D7455BA02D3AF6902685E6503704F2,12601,15,19,4,25,47,1297
85563,85563,74D7455BA02D3AF6902685E6503704F2,10107,21,23,2,38,49,1949
85564,85564,7E361CF03F197FC1628B1CC780E8D87B,42623,8,11,3,22,49,1149
85565,85565,7E361CF03F197FC1628B1CC780E8D87B,42071,12,15,3,31,49,1599
85566,85566,7E361CF03F197FC1628B1CC780E8D87B,42261,20,22,2,25,49,1299
85567,85567,E40453BF40D8901B8230DD1E0DCFB607,11271,0,7,7,37,48,1898
85568,85568,E40453BF40D8901B8230DD1E0DCFB607,12971,11,16,5,32,48,1648
85569,85569,E40453BF40D8901B8230DD1E0DCFB607,40171,20,23,3,38,48,1948
85574,85574,4BD2D720B1C94D9CBECB412FDF6799B4,11261,0,5,5,36,46,1846
85575,85575,4BD2D720B1C94D9CBECB412FDF6799B4,42861,6,10,4,37,44,1894
85576,85576,4BD2D720B1C94D9CBECB412FDF6799B4,11261,12,15,3,36,46,1846
85577,85577,4BD2D720B1C94D9CBECB412FDF6799B4,43011,19,20,1,40,42,2042
85578,85578,32718D50E38C7A2D02CBC4B348782426,11861,0,9,9,32,47,1647
85579,85579,32718D50E38C7A2D02CBC4B348782426,11941,9,13,4,37,46,1896
85580,85580,32718D50E38C7A2D02CBC4B348782426,11861,15,23,8,32,47,1647
85587,85587,72D431B0819605E8021508E3D5962061,42161,0,1,1,36,47,1847
85588,85588,72D431B0819605E8021508E3D5962061,43171,1,9,8,39,49,1999
85589,85589,72D431B0819605E8021508E3D5962061,10221,15,23,8,34,49,1749
85599,85599,2C92D9A1E7726DE0B07E3A3E97221DE4,11491,0,10,10,36,47,1847
85600,85600,2C92D9A1E7726DE0B07E3A3E97221DE4,42941,11,13,2,37,47,1897
85601,85601,2C92D9A1E7726DE0B07E3A3E97221DE4,42381,15,16,1,39,41,1991
85602,85602,2C92D9A1E7726DE0B07E3A3E97221DE4,11491,20,23,3,36,47,1847
85603,85603,CFEAB1C9674CBEABBC88FF4B300B52A9,11261,0,6,6,36,46,1846
85604,85604,CFEAB1C9674CBEABBC88FF4B300B52A9,42351,7,9,2,38,45,1945
85605,85605,CFEAB1C9674CBEABBC88FF4B300B52A9,11261,10,11,1,36,46,1846
85606,85606,CFEAB1C9674CBEABBC88FF4B300B52A9,42351,13,14,1,38,45,1945
85607,85607,CFEAB1C9674CBEABBC88FF4B300B52A9,11261,16,19,3,36,46,1846
85637,85637,BBED2FFAE46770F0D73304C008766B5A,13651,0,10,10,30,47,1547
85638,85638,BBED2FFAE46770F0D73304C008766B5A,12381,14,15,1,32,48,1648
85639,85639,BBED2FFAE46770F0D73304C008766B5A,10295,15,17,2,30,47,1547
85640,85640,BBED2FFAE46770F0D73304C008766B5A,12131,18,20,2,32,47,1647
85641,85641,BBED2FFAE46770F0D73304C008766B5A,11091,20,23,3,29,47,1497
85650,85650,4A18F9CDCDB1BC5B8756A2E850C227AB,42161,2,8,6,36,47,1847
85651,85651,4A18F9CDCDB1BC5B8756A2E850C227AB,10491,11,12,1,33,48,1698
85652,85652,4A18F9CDCDB1BC5B8756A2E850C227AB,11061,13,15,2,29,48,1498
85653,85653,4A18F9CDCDB1BC5B8756A2E850C227AB,42161,18,23,5,36,47,1847
85654,85654,30A84C07EF1AB60D698CCAE92E216F76,43581,0,7,7,33,48,1698
85655,85655,30A84C07EF1AB60D698CCAE92E216F76,19111,8,12,4,9,45,495
85656,85656,30A84C07EF1AB60D698CCAE92E216F76,43581,14,15,1,33,48,1698
85657,85657,30A84C07EF1AB60D698CCAE92E216F76,11551,17,19,2,39,49,1999
85658,85658,E40FF661B4F3DA89AB28D734DF463F41,12671,2,6,4,21,43,1093
85659,85659,E40FF661B4F3DA89AB28D734DF463F41,12921,8,18,10,9,41,491
85660,85660,E40FF661B4F3DA89AB28D734DF463F41,19901,18,20,2,7,44,394
85665,85665,0E4CEBD674D5D1E0A017D5869882E030,11794,1,9,8,38,49,1949
85666,85666,0E4CEBD674D5D1E0A017D5869882E030,11631,11,13,2,12,49,649
85667,85667,0E4CEBD674D5D1E0A017D5869882E030,10231,15,23,8,39,49,1999
85668,85668,F031FD2F854EE78DC74B73079D5A136F,11861,0,1,1,32,47,1647
85669,85669,F031FD2F854EE78DC74B73079D5A136F,12121,2,8,6,29,47,1497
85670,85670,F031FD2F854EE78DC74B73079D5A136F,42501,9,12,3,28,47,1447
85671,85671,F031FD2F854EE78DC74B73079D5A136F,12121,12,13,1,29,47,1497
85672,85672,F031FD2F854EE78DC74B73079D5A136F,11871,16,21,5,29,46,1496
85673,85673,F031FD2F854EE78DC74B73079D5A136F,12121,22,23,1,29,47,1497
85674,85674,27BCDD064516A189095F064E0ADAB9A4,10811,0,12,12,38,46,1946
85675,85675,27BCDD064516A189095F064E0ADAB9A4,13091,14,15,1,20,42,1042
85676,85676,27BCDD064516A189095F064E0ADAB9A4,15261,18,20,2,39,13,1963
85677,85677,27BCDD064516A189095F064E0ADAB9A4,10811,21,23,2,38,46,1946
85685,85685,09F64A9A641B3F2B92615DE97B925264,10631,0,1,1,28,46,1446
85686,85686,09F64A9A641B3F2B92615DE97B925264,10351,2,12,10,28,45,1445
85687,85687,09F64A9A641B3F2B92615DE97B925264,10634,13,14,1,27,45,1395
85688,85688,09F64A9A641B3F2B92615DE97B925264,10351,20,22,2,28,45,1445
85689,85689,09F64A9A641B3F2B92615DE97B925264,10634,22,23,1,27,45,1395
85699,85699,946768BFA72752D5660750415178C67F,11131,0,4,4,33,48,1698
85700,85700,946768BFA72752D5660750415178C67F,13601,5,8,3,34,47,1747
85701,85701,946768BFA72752D5660750415178C67F,11651,10,14,4,33,47,1697
85702,85702,946768BFA72752D5660750415178C67F,13731,18,20,2,33,49,1699
85703,85703,946768BFA72752D5660750415178C67F,43731,21,23,2,34,47,1747
85712,85712,6B301C33659FC7DDF1FEBEFD22E1FEA8,42931,0,11,11,41,49,2099
85713,85713,6B301C33659FC7DDF1FEBEFD22E1FEA8,43761,13,16,3,32,47,1647
85714,85714,6B301C33659FC7DDF1FEBEFD22E1FEA8,42931,18,23,5,41,49,2099
85715,85715,03D6FFA8E0742D0181BD0480CCE1246D,11861,0,1,1,32,47,1647
85716,85716,03D6FFA8E0742D0181BD0480CCE1246D,42511,2,7,5,37,47,1897
85717,85717,03D6FFA8E0742D0181BD0480CCE1246D,13911,8,9,1,39,46,1996
85718,85718,03D6FFA8E0742D0181BD0480CCE1246D,10292,15,16,1,30,47,1547
85719,85719,03D6FFA8E0742D0181BD0480CCE1246D,11875,17,21,4,30,46,1546
85720,85720,CD5473964A2C6DE7DF346EF887FB8309,13381,0,6,6,39,47,1997
85721,85721,CD5473964A2C6DE7DF346EF887FB8309,43641,8,12,4,16,38,838
85722,85722,CD5473964A2C6DE7DF346EF887FB8309,12511,14,23,9,39,47,1997
85723,85723,D278A78B03015D942733A0F36181B50F,43041,0,7,7,41,46,2096
85724,85724,D278A78B03015D942733A0F36181B50F,10431,8,10,2,33,49,1699
85725,85725,D278A78B03015D942733A0F36181B50F,43041,13,19,6,41,46,2096
85726,85726,D278A78B03015D942733A0F36181B50F,11171,20,22,2,33,48,1698
85730,85730,E8E9D7FFA16E2A5F20F0A6E4D68711FF,42691,0,1,1,24,48,1248
85731,85731,E8E9D7FFA16E2A5F20F0A6E4D68711FF,11104,1,3,2,17,47,897
85732,85732,E8E9D7FFA16E2A5F20F0A6E4D68711FF,42691,3,5,2,24,48,1248
85733,85733,E8E9D7FFA16E2A5F20F0A6E4D68711FF,11061,17,20,3,29,48,1498
85734,85734,E8E9D7FFA16E2A5F20F0A6E4D68711FF,12971,21,23,2,32,48,1648
85744,85744,20EBDF07FAB10C468662B7339874EF65,11806,0,1,1,41,48,2098
85745,85745,20EBDF07FAB10C468662B7339874EF65,42271,2,8,6,40,47,2047
85746,85746,20EBDF07FAB10C468662B7339874EF65,11806,9,12,3,41,48,2098
85747,85747,20EBDF07FAB10C468662B7339874EF65,42271,12,13,1,40,47,2047
85748,85748,20EBDF07FAB10C468662B7339874EF65,11806,15,22,7,41,48,2098
85749,85749,DAA36BAEF29B6E0B04C7BC08E7820332,13671,0,8,8,27,43,1393
85750,85750,DAA36BAEF29B6E0B04C7BC08E7820332,10951,9,15,6,29,48,1498
85751,85751,DAA36BAEF29B6E0B04C7BC08E7820332,13671,16,23,7,27,43,1393
85755,85755,BE6556F4F32DDBE17FA5A6143CEC24DA,42921,5,6,1,33,47,1697
85756,85756,BE6556F4F32DDBE17FA5A6143CEC24DA,11201,8,12,4,35,49,1799
85757,85757,BE6556F4F32DDBE17FA5A6143CEC24DA,42201,13,16,3,43,46,2196
85758,85758,BE6556F4F32DDBE17FA5A6143CEC24DA,11801,17,19,2,42,48,2148
85762,85762,7FDF765DE8224652A25C1223A2C4E352,11531,9,11,2,34,49,1749
85763,85763,7FDF765DE8224652A25C1223A2C4E352,12381,16,17,1,32,48,1648
85764,85764,7FDF765DE8224652A25C1223A2C4E352,42341,18,20,2,43,49,2199
85765,85765,E1E647F326354CA21DAEC7F0B9FA45FB,11794,0,7,7,38,49,1949
85766,85766,E1E647F326354CA21DAEC7F0B9FA45FB,10471,7,9,2,37,48,1898
85767,85767,E1E647F326354CA21DAEC7F0B9FA45FB,13941,10,13,3,41,47,2097
85768,85768,E1E647F326354CA21DAEC7F0B9FA45FB,13111,16,18,2,42,46,2146
85769,85769,E1E647F326354CA21DAEC7F0B9FA45FB,13941,19,20,1,41,47,2097
85770,85770,E1E647F326354CA21DAEC7F0B9FA45FB,11794,21,23,2,38,49,1949
85771,85771,FC2B6C9534E7C1512D38DCF38341E8E8,42871,0,9,9,30,45,1545
85772,85772,FC2B6C9534E7C1512D38DCF38341E8E8,10107,12,15,3,38,49,1949
85773,85773,FC2B6C9534E7C1512D38DCF38341E8E8,42871,20,23,3,30,45,1545
85777,85777,CFB5B91AB0CD7543884ADBE535AD19D6,43021,0,4,4,16,43,843
85778,85778,CFB5B91AB0CD7543884ADBE535AD19D6,43641,8,9,1,16,38,838
85779,85779,CFB5B91AB0CD7543884ADBE535AD19D6,43021,12,13,1,16,43,843
85780,85780,CFB5B91AB0CD7543884ADBE535AD19D6,12921,15,17,2,9,41,491
85781,85781,CFB5B91AB0CD7543884ADBE535AD19D6,43021,19,21,2,16,43,843
85782,85782,BF7F1EED1E9C2A95386EE0E636C7D632,42204,0,6,6,43,46,2196
85783,85783,BF7F1EED1E9C2A95386EE0E636C7D632,13111,6,8,2,42,46,2146
85784,85784,BF7F1EED1E9C2A95386EE0E636C7D632,43341,10,11,1,41,46,2096
85785,85785,BF7F1EED1E9C2A95386EE0E636C7D632,13951,14,15,1,47,45,2395
85786,85786,BF7F1EED1E9C2A95386EE0E636C7D632,13111,16,23,7,42,46,2146
85787,85787,1DFA47B14F32C6AE13AA4486CBC3E827,11641,0,4,4,22,49,1149
85788,85788,1DFA47B14F32C6AE13AA4486CBC3E827,12121,5,6,1,29,47,1497
85789,85789,1DFA47B14F32C6AE13AA4486CBC3E827,42081,7,23,16,24,49,1249
85793,85793,C3C6FC1109DBF4FF52D9B91886397AC1,13101,10,13,3,40,47,2047
85794,85794,C3C6FC1109DBF4FF52D9B91886397AC1,43101,16,17,1,46,40,2340
85795,85795,C3C6FC1109DBF4FF52D9B91886397AC1,13411,17,19,2,49,42,2492
85796,85796,D22668D0695DE589F636D2A7DA933A25,11791,0,9,9,38,49,1949
85797,85797,D22668D0695DE589F636D2A7DA933A25,10731,11,16,5,33,47,1697
85798,85798,D22668D0695DE589F636D2A7DA933A25,11861,16,19,3,32,47,1647
85799,85799,D22668D0695DE589F636D2A7DA933A25,11791,20,23,3,38,49,1949
85811,85811,E859A0BF6FB37F9B42DF06EC7EE8FF9D,42461,0,6,6,45,47,2297
85812,85812,E859A0BF6FB37F9B42DF06EC7EE8FF9D,42321,7,10,3,43,47,2197
85813,85813,E859A0BF6FB37F9B42DF06EC7EE8FF9D,42461,10,11,1,45,47,2297
85814,85814,E859A0BF6FB37F9B42DF06EC7EE8FF9D,42321,11,13,2,43,47,2197
85815,85815,E859A0BF6FB37F9B42DF06EC7EE8FF9D,42461,13,15,2,45,47,2297
85816,85816,E859A0BF6FB37F9B42DF06EC7EE8FF9D,42321,15,17,2,43,47,2197
85817,85817,E859A0BF6FB37F9B42DF06EC7EE8FF9D,42461,19,23,4,45,47,2297
85824,85824,615EDF25A924323AEF1D5C61D1C3550F,10191,0,2,2,40,48,2048
85825,85825,615EDF25A924323AEF1D5C61D1C3550F,11291,2,5,3,40,49,2049
85826,85826,615EDF25A924323AEF1D5C61D1C3550F,10471,5,13,8,37,48,1898
85827,85827,615EDF25A924323AEF1D5C61D1C3550F,10251,13,16,3,35,47,1797
85828,85828,615EDF25A924323AEF1D5C61D1C3550F,11701,16,20,4,43,48,2198
85832,85832,2BB5E6319C361908A67DD8509286CF7C,19031,0,9,9,1,42,92
85833,85833,2BB5E6319C361908A67DD8509286CF7C,12641,9,11,2,10,43,543
85834,85834,2BB5E6319C361908A67DD8509286CF7C,19031,11,14,3,1,42,92
85835,85835,2BB5E6319C361908A67DD8509286CF7C,12641,14,18,4,10,43,543
85836,85836,2BB5E6319C361908A67DD8509286CF7C,19031,19,23,4,1,42,92
85837,85837,DD5F8A74300A882C9276D44B0BD9BA94,10491,0,6,6,33,48,1698
85838,85838,DD5F8A74300A882C9276D44B0BD9BA94,11561,7,8,1,32,49,1649
85839,85839,DD5F8A74300A882C9276D44B0BD9BA94,42941,9,16,7,37,47,1897
85840,85840,DD5F8A74300A882C9276D44B0BD9BA94,10491,19,23,4,33,48,1698
85844,85844,3B9989389C2FB72384F3330F9A990AB0,13911,1,2,1,39,46,1996
85845,85845,3B9989389C2FB72384F3330F9A990AB0,42351,2,3,1,38,45,1945
85846,85846,3B9989389C2FB72384F3330F9A990AB0,13911,5,6,1,39,46,1996
85847,85847,3B9989389C2FB72384F3330F9A990AB0,42231,7,10,3,37,46,1896
85848,85848,3B9989389C2FB72384F3330F9A990AB0,42351,13,14,1,38,45,1945
85849,85849,3B9989389C2FB72384F3330F9A990AB0,42231,14,17,3,37,46,1896
85850,85850,3B9989389C2FB72384F3330F9A990AB0,12514,18,20,2,38,47,1947
85854,85854,0AA5586D6B12F9AD29AA699D8536DBEA,11231,1,9,8,37,49,1899
85855,85855,0AA5586D6B12F9AD29AA699D8536DBEA,11271,9,11,2,37,48,1898
85856,85856,0AA5586D6B12F9AD29AA699D8536DBEA,11231,11,13,2,37,49,1899
85857,85857,0AA5586D6B12F9AD29AA699D8536DBEA,11271,13,14,1,37,48,1898
85858,85858,0AA5586D6B12F9AD29AA699D8536DBEA,11201,17,19,2,35,49,1799
85859,85859,0AA5586D6B12F9AD29AA699D8536DBEA,43361,20,22,2,38,48,1948
85866,85866,C113C3BFA8200BB19492C01042EDAB2E,11061,0,1,1,29,48,1498
85867,85867,C113C3BFA8200BB19492C01042EDAB2E,42501,1,5,4,28,47,1447
85868,85868,C113C3BFA8200BB19492C01042EDAB2E,10351,6,8,2,28,45,1445
85869,85869,C113C3BFA8200BB19492C01042EDAB2E,42501,17,20,3,28,47,1447
85870,85870,C113C3BFA8200BB19492C01042EDAB2E,11061,21,23,2,29,48,1498
85875,85875,D1D5B16F27340AAF330DB0252EB38467,19101,0,8,8,17,29,879
85876,85876,D1D5B16F27340AAF330DB0252EB38467,11771,12,13,1,39,49,1999
85877,85877,D1D5B16F27340AAF330DB0252EB38467,10431,15,17,2,33,49,1699
85878,85878,D1D5B16F27340AAF330DB0252EB38467,11781,19,21,2,38,49,1949
85889,85889,FED58C37E35B0401CC49237E100333B8,10381,0,8,8,31,49,1599
85890,85890,FED58C37E35B0401CC49237E100333B8,40872,8,9,1,30,49,1549
85891,85891,FED58C37E35B0401CC49237E100333B8,11061,10,11,1,29,48,1498
85892,85892,FED58C37E35B0401CC49237E100333B8,10381,12,15,3,31,49,1599
85893,85893,FED58C37E35B0401CC49237E100333B8,10251,18,20,2,35,47,1797
85894,85894,FED58C37E35B0401CC49237E100333B8,11061,21,23,2,29,48,1498
85895,85895,990F89A555478F97C2E0E123BB133187,49201,2,4,2,7,41,391
85896,85896,990F89A555478F97C2E0E123BB133187,19181,4,5,1,8,40,440
85897,85897,990F89A555478F97C2E0E123BB133187,49201,10,11,1,7,41,391
85898,85898,990F89A555478F97C2E0E123BB133187,12921,16,17,1,9,41,491
85899,85899,990F89A555478F97C2E0E123BB133187,19181,20,22,2,8,40,440
85900,85900,A4B13605C78797589D9B98BC8787EDD0,19114,0,4,4,7,43,393
85901,85901,A4B13605C78797589D9B98BC8787EDD0,12921,7,9,2,9,41,491
85902,85902,A4B13605C78797589D9B98BC8787EDD0,19931,11,13,2,7,43,393
85903,85903,A4B13605C78797589D9B98BC8787EDD0,12921,15,16,1,9,41,491
85904,85904,A4B13605C78797589D9B98BC8787EDD0,19931,18,23,5,7,43,393
85905,85905,44A1B2095028F2B1D6198AB3D390B206,11061,0,2,2,29,48,1498
85906,85906,44A1B2095028F2B1D6198AB3D390B206,10681,2,10,8,30,48,1548
85907,85907,44A1B2095028F2B1D6198AB3D390B206,11061,12,19,7,29,48,1498
85908,85908,44A1B2095028F2B1D6198AB3D390B206,11631,19,21,2,12,49,649
85909,85909,E96212EFC2FCFD2907ABEE6EE15AC7FD,12381,0,9,9,32,48,1648
85910,85910,E96212EFC2FCFD2907ABEE6EE15AC7FD,12731,13,16,3,22,40,1140
85911,85911,E96212EFC2FCFD2907ABEE6EE15AC7FD,10721,19,23,4,31,48,1598
85921,85921,54F474844D3214F1AF14A37BADFC69E4,10531,0,7,7,34,46,1746
85922,85922,54F474844D3214F1AF14A37BADFC69E4,11151,11,12,1,30,48,1548
85923,85923,54F474844D3214F1AF14A37BADFC69E4,10531,13,19,6,34,46,1746
85924,85924,54F474844D3214F1AF14A37BADFC69E4,40951,20,23,3,36,49,1849
85925,85925,F8270FA2BD4758ED053EDD560CA9353A,10661,0,4,4,37,49,1899
85926,85926,F8270FA2BD4758ED053EDD560CA9353A,13601,6,8,2,34,47,1747
85927,85927,F8270FA2BD4758ED053EDD560CA9353A,40673,8,11,3,36,48,1848
85928,85928,F8270FA2BD4758ED053EDD560CA9353A,11751,14,19,5,35,48,1798
85929,85929,2920C6EA4ADD2270CEA8FC8BAF425178,42531,0,8,8,31,45,1595
85930,85930,2920C6EA4ADD2270CEA8FC8BAF425178,13671,9,10,1,27,43,1393
85931,85931,2920C6EA4ADD2270CEA8FC8BAF425178,12311,13,14,1,30,44,1544
85932,85932,2920C6EA4ADD2270CEA8FC8BAF425178,12514,17,18,1,38,47,1947
85933,85933,2920C6EA4ADD2270CEA8FC8BAF425178,12661,19,20,1,32,45,1645
85934,85934,ED6E335A01A9415740706B079F2407EA,10471,0,1,1,37,48,1898
85935,85935,ED6E335A01A9415740706B079F2407EA,10107,1,8,7,38,49,1949
85936,85936,ED6E335A01A9415740706B079F2407EA,10471,8,9,1,37,48,1898
85937,85937,ED6E335A01A9415740706B079F2407EA,11231,9,15,6,37,49,1899
85938,85938,ED6E335A01A9415740706B079F2407EA,10471,17,18,1,37,48,1898
85942,85942,A8491B4932A74BB29E61F0906E6D23DE,11751,9,11,2,35,48,1798
85943,85943,A8491B4932A74BB29E61F0906E6D23DE,42204,11,12,1,43,46,2196
85944,85944,A8491B4932A74BB29E61F0906E6D23DE,11751,14,22,8,35,48,1798
85952,85952,5ABC9E905F8F6D8C8CB5A05232E2F155,40636,0,1,1,35,48,1798
85953,85953,5ABC9E905F8F6D8C8CB5A05232E2F155,10251,2,4,2,35,47,1797
85954,85954,5ABC9E905F8F6D8C8CB5A05232E2F155,42161,8,10,2,36,47,1847
85955,85955,5ABC9E905F8F6D8C8CB5A05232E2F155,10251,12,13,1,35,47,1797
85956,85956,5ABC9E905F8F6D8C8CB5A05232E2F155,41007,15,17,2,37,47,1897
85957,85957,5ABC9E905F8F6D8C8CB5A05232E2F155,10251,17,19,2,35,47,1797
85958,85958,ED765AC07D21387339B2A29ECDD013E0,10251,0,10,10,35,47,1797
85959,85959,ED765AC07D21387339B2A29ECDD013E0,40637,17,19,2,36,47,1847
85960,85960,ED765AC07D21387339B2A29ECDD013E0,11771,19,21,2,39,49,1999
85961,85961,ED765AC07D21387339B2A29ECDD013E0,10251,22,23,1,35,47,1797
85962,85962,5FB7FCDE8733B3DE0082FB61D42FC13D,13941,0,4,4,41,47,2097
85963,85963,5FB7FCDE8733B3DE0082FB61D42FC13D,11001,4,6,2,42,47,2147
85964,85964,5FB7FCDE8733B3DE0082FB61D42FC13D,13941,6,8,2,41,47,2097
85965,85965,5FB7FCDE8733B3DE0082FB61D42FC13D,42321,9,17,8,43,47,2197
85966,85966,5FB7FCDE8733B3DE0082FB61D42FC13D,42204,17,19,2,43,46,2196
85967,85967,5FB7FCDE8733B3DE0082FB61D42FC13D,42321,19,21,2,43,47,2197
85975,85975,6680C80DFC3F7ACED725F17452013614,12083,0,9,9,36,49,1849
85976,85976,6680C80DFC3F7ACED725F17452013614,42501,10,12,2,28,47,1447
85977,85977,6680C80DFC3F7ACED725F17452013614,43051,16,17,1,46,45,2345
85978,85978,6680C80DFC3F7ACED725F17452013614,13371,18,23,5,41,47,2097
85979,85979,85B2DF84AA2D7E94FBA22E89836AF436,10491,0,7,7,33,48,1698
85980,85980,85B2DF84AA2D7E94FBA22E89836AF436,11291,8,13,5,40,49,2049
85981,85981,85B2DF84AA2D7E94FBA22E89836AF436,11551,13,16,3,39,49,1999
85982,85982,85B2DF84AA2D7E94FBA22E89836AF436,11381,18,21,3,30,47,1547
85983,85983,85B2DF84AA2D7E94FBA22E89836AF436,10491,22,23,1,33,48,1698
85988,85988,69F41107244EDDE97DD1AAB2D554177A,12871,1,6,5,22,33,1133
85989,85989,69F41107244EDDE97DD1AAB2D554177A,19281,7,8,1,16,32,832
85990,85990,69F41107244EDDE97DD1AAB2D554177A,12871,11,15,4,22,33,1133
85991,85991,69F41107244EDDE97DD1AAB2D554177A,19281,19,20,1,16,32,832
85992,85992,6DFA48F81EF42083077B44FC80706865,43161,6,8,2,35,47,1797
85993,85993,6DFA48F81EF42083077B44FC80706865,42161,8,10,2,36,47,1847
85994,85994,6DFA48F81EF42083077B44FC80706865,10971,12,17,5,35,47,1797
85995,85995,6DFA48F81EF42083077B44FC80706865,11541,18,19,1,35,49,1799
85996,85996,6DFA48F81EF42083077B44FC80706865,43731,21,22,1,34,47,1747
85997,85997,6324E038DED9EC12CD06DF2BDBC3BEAA,19181,0,7,7,8,40,440
85998,85998,6324E038DED9EC12CD06DF2BDBC3BEAA,12641,7,13,6,10,43,543
85999,85999,6324E038DED9EC12CD06DF2BDBC3BEAA,19181,17,22,5,8,40,440
86000,86000,54024ABE1F3F87C4C1BA35808DDABE39,11951,1,7,6,31,49,1599
86001,86001,54024ABE1F3F87C4C1BA35808DDABE39,11021,10,12,2,36,49,1849
86002,86002,54024ABE1F3F87C4C1BA35808DDABE39,10161,13,16,3,35,49,1799
86003,86003,54024ABE1F3F87C4C1BA35808DDABE39,10451,18,20,2,25,48,1298
86004,86004,54024ABE1F3F87C4C1BA35808DDABE39,10221,22,23,1,34,49,1749
86005,86005,DF9B8E821F7AD4F811914C4050CA11ED,10292,0,14,14,30,47,1547
86006,86006,DF9B8E821F7AD4F811914C4050CA11ED,10111,16,17,1,37,47,1897
86007,86007,DF9B8E821F7AD4F811914C4050CA11ED,42021,19,21,2,33,47,1697
86008,86008,DF9B8E821F7AD4F811914C4050CA11ED,42491,21,22,1,32,46,1646
86013,86013,0AE1F060A9917578AF6CC39BEF4A5FD7,11914,1,2,1,37,48,1898
86014,86014,0AE1F060A9917578AF6CC39BEF4A5FD7,11074,3,4,1,37,47,1897
86015,86015,0AE1F060A9917578AF6CC39BEF4A5FD7,11914,5,6,1,37,48,1898
86016,86016,0AE1F060A9917578AF6CC39BEF4A5FD7,10371,10,18,8,37,49,1899
86017,86017,0AE1F060A9917578AF6CC39BEF4A5FD7,11074,20,21,1,37,47,1897
86018,86018,8D1C7D3E8471776AB0F8518BEA63DEC7,12151,0,12,12,41,33,2083
86019,86019,8D1C7D3E8471776AB0F8518BEA63DEC7,13371,14,20,6,41,47,2097
86020,86020,8D1C7D3E8471776AB0F8518BEA63DEC7,11001,20,22,2,42,47,2147
86021,86021,23F8F9B0AC0C62AC07DD5CA5BCEDE820,43101,0,2,2,46,40,2340
86022,86022,23F8F9B0AC0C62AC07DD5CA5BCEDE820,13551,7,8,1,45,38,2288
86023,86023,23F8F9B0AC0C62AC07DD5CA5BCEDE820,43101,8,12,4,46,40,2340
86024,86024,23F8F9B0AC0C62AC07DD5CA5BCEDE820,13551,16,17,1,45,38,2288
86025,86025,23F8F9B0AC0C62AC07DD5CA5BCEDE820,43101,19,20,1,46,40,2340
86026,86026,DC108CA51A8D783261AB9156C36F59F1,12601,8,9,1,25,47,1297
86027,86027,DC108CA51A8D783261AB9156C36F59F1,10351,12,14,2,28,45,1445
86028,86028,DC108CA51A8D783261AB9156C36F59F1,12601,18,19,1,25,47,1297
86032,86032,BC3DA9BAF9B0A0C935A79D91ECBDA067,42041,0,1,1,10,47,547
86033,86033,BC3DA9BAF9B0A0C935A79D91ECBDA067,19441,2,12,10,8,46,446
86034,86034,BC3DA9BAF9B0A0C935A79D91ECBDA067,19901,13,22,9,7,44,394
86035,86035,05BD882F25219A49EB57A8F905CE344B,12083,0,17,17,36,49,1849
86036,86036,05BD882F25219A49EB57A8F905CE344B,42021,19,21,2,33,47,1697
86037,86037,05BD882F25219A49EB57A8F905CE344B,43281,21,23,2,37,48,1898
86044,86044,57470F475E5DBA3DA7C3C4BECACE7F3D,42633,0,5,5,42,46,2146
86045,86045,57470F475E5DBA3DA7C3C4BECACE7F3D,42351,5,6,1,38,45,1945
86046,86046,57470F475E5DBA3DA7C3C4BECACE7F3D,42081,9,14,5,24,49,1249
86047,86047,57470F475E5DBA3DA7C3C4BECACE7F3D,11381,15,16,1,30,47,1547
86048,86048,57470F475E5DBA3DA7C3C4BECACE7F3D,42081,18,19,1,24,49,1249
86052,86052,DFFD8263F8D171E98D9F6788AFF5A2A7,11806,2,3,1,41,48,2098
86053,86053,DFFD8263F8D171E98D9F6788AFF5A2A7,42271,4,6,2,40,47,2047
86054,86054,DFFD8263F8D171E98D9F6788AFF5A2A7,11806,6,7,1,41,48,2098
86055,86055,DFFD8263F8D171E98D9F6788AFF5A2A7,42271,7,8,1,40,47,2047
86056,86056,DFFD8263F8D171E98D9F6788AFF5A2A7,11806,8,10,2,41,48,2098
86057,86057,DFFD8263F8D171E98D9F6788AFF5A2A7,42271,10,12,2,40,47,2047
86058,86058,DFFD8263F8D171E98D9F6788AFF5A2A7,11481,16,17,1,41,48,2098
86059,86059,DFFD8263F8D171E98D9F6788AFF5A2A7,40341,18,20,2,23,49,1199
86060,86060,DFFD8263F8D171E98D9F6788AFF5A2A7,11481,21,22,1,41,48,2098
86068,86068,5767E0EE50B7CB3B0CFBFCA7463471BC,11806,0,6,6,41,48,2098
86069,86069,5767E0EE50B7CB3B0CFBFCA7463471BC,10221,7,18,11,34,49,1749
86070,86070,5767E0EE50B7CB3B0CFBFCA7463471BC,11806,19,23,4,41,48,2098
86074,86074,CD55B44A3FD4B718A673CC03711FD344,12921,5,9,4,9,41,491
86075,86075,CD55B44A3FD4B718A673CC03711FD344,12641,10,11,1,10,43,543
86076,86076,CD55B44A3FD4B718A673CC03711FD344,43021,13,14,1,16,43,843
86077,86077,CD55B44A3FD4B718A673CC03711FD344,12921,19,20,1,9,41,491
86087,86087,AFB83B245E30F3051A42272B92833F59,42511,1,7,6,37,47,1897
86088,86088,AFB83B245E30F3051A42272B92833F59,10431,9,10,1,33,49,1699
86089,86089,AFB83B245E30F3051A42272B92833F59,42301,12,13,1,36,47,1847
86090,86090,AFB83B245E30F3051A42272B92833F59,42511,14,15,1,37,47,1897
86091,86091,AFB83B245E30F3051A42272B92833F59,10771,16,18,2,41,46,2096
86092,86092,E05F67959FE0060F5DAD596617CE48BB,12921,0,8,8,9,41,491
86093,86093,E05F67959FE0060F5DAD596617CE48BB,49201,8,9,1,7,41,391
86094,86094,E05F67959FE0060F5DAD596617CE48BB,19901,12,16,4,7,44,394
86095,86095,E05F67959FE0060F5DAD596617CE48BB,49201,20,21,1,7,41,391
86102,86102,BAAEF1F815128F9C42A2F609EF6E43D2,42921,1,9,8,33,47,1697
86103,86103,BAAEF1F815128F9C42A2F609EF6E43D2,40951,13,14,1,36,49,1849
86104,86104,BAAEF1F815128F9C42A2F609EF6E43D2,43161,16,18,2,35,47,1797
86105,86105,BAAEF1F815128F9C42A2F609EF6E43D2,42921,19,20,1,33,47,1697
86106,86106,BAAEF1F815128F9C42A2F609EF6E43D2,11461,22,23,1,37,49,1899
86107,86107,BA285F01E6926591864F1F3184565800,42581,0,4,4,38,48,1948
86108,86108,BA285F01E6926591864F1F3184565800,11914,9,12,3,37,48,1898
86109,86109,BA285F01E6926591864F1F3184565800,10107,15,17,2,38,49,1949
86110,86110,BA285F01E6926591864F1F3184565800,11771,18,20,2,39,49,1999
86111,86111,BA285F01E6926591864F1F3184565800,42191,21,23,2,38,49,1949
86115,86115,DE72E271C1E5F751EBA41E679880C0F8,13231,0,5,5,39,46,1996
86116,86116,DE72E271C1E5F751EBA41E679880C0F8,12211,6,11,5,41,44,2094
86117,86117,DE72E271C1E5F751EBA41E679880C0F8,12221,12,13,1,43,44,2194
86118,86118,DE72E271C1E5F751EBA41E679880C0F8,12211,14,17,3,41,44,2094
86119,86119,DE72E271C1E5F751EBA41E679880C0F8,13231,18,23,5,39,46,1996
86124,86124,6B614428F8D95ECFDE2207017437E97D,12871,0,4,4,22,33,1133
86125,86125,6B614428F8D95ECFDE2207017437E97D,19281,4,5,1,16,32,832
86126,86126,6B614428F8D95ECFDE2207017437E97D,12871,9,17,8,22,33,1133
86127,86127,6B614428F8D95ECFDE2207017437E97D,19281,18,19,1,16,32,832
86128,86128,6B614428F8D95ECFDE2207017437E97D,12871,19,23,4,22,33,1133
86129,86129,73557328FFECDF841821FA993CF1984C,42271,0,14,14,40,47,2047
86130,86130,73557328FFECDF841821FA993CF1984C,10401,18,20,2,33,49,1699
86131,86131,73557328FFECDF841821FA993CF1984C,42271,21,22,1,40,47,2047
86132,86132,6A1939C4E93461BA60703DAC3120D4E0,11151,1,5,4,30,48,1548
86133,86133,6A1939C4E93461BA60703DAC3120D4E0,43391,7,8,1,29,48,1498
86134,86134,6A1939C4E93461BA60703DAC3120D4E0,11631,11,12,1,12,49,649
86135,86135,6A1939C4E93461BA60703DAC3120D4E0,11061,13,17,4,29,48,1498
86136,86136,6A1939C4E93461BA60703DAC3120D4E0,11151,17,22,5,30,48,1548
86137,86137,223756A3D5197A93368C0DAB420FEECF,15311,0,5,5,43,25,2175
86138,86138,223756A3D5197A93368C0DAB420FEECF,12781,9,10,1,46,24,2324
86139,86139,223756A3D5197A93368C0DAB420FEECF,15311,12,14,2,43,25,2175
86140,86140,223756A3D5197A93368C0DAB420FEECF,12881,14,17,3,47,22,2372
86141,86141,223756A3D5197A93368C0DAB420FEECF,15311,19,23,4,43,25,2175
86142,86142,7861278735CDA91B9BABB196FBF7605C,43951,1,3,2,49,41,2491
86143,86143,7861278735CDA91B9BABB196FBF7605C,13951,13,16,3,47,45,2395
86144,86144,7861278735CDA91B9BABB196FBF7605C,43951,17,18,1,49,41,2491
86145,86145,53D8E731DA65650E5B825C52CF592433,10221,1,3,2,34,49,1749
86146,86146,53D8E731DA65650E5B825C52CF592433,11201,3,14,11,35,49,1799
86147,86147,53D8E731DA65650E5B825C52CF592433,11261,18,19,1,36,46,1846
86151,86151,E1D9DCC26BD9E70C84DC1D28D9FFAAE6,19114,0,3,3,7,43,393
86152,86152,E1D9DCC26BD9E70C84DC1D28D9FFAAE6,12731,4,5,1,22,40,1140
86153,86153,E1D9DCC26BD9E70C84DC1D28D9FFAAE6,12641,6,16,10,10,43,543
86154,86154,E1D9DCC26BD9E70C84DC1D28D9FFAAE6,19114,19,22,3,7,43,393
86158,86158,D57B4F47C17DAF70D7DF257462476687,11871,0,7,7,29,46,1496
86159,86159,D57B4F47C17DAF70D7DF257462476687,12601,10,12,2,25,47,1297
86160,86160,D57B4F47C17DAF70D7DF257462476687,11871,13,21,8,29,46,1496
86185,86185,60431017DB48728DD1D9AC55BBBFB348,11161,0,10,10,32,48,1648
86186,86186,60431017DB48728DD1D9AC55BBBFB348,42623,19,20,1,22,49,1149
86187,86187,60431017DB48728DD1D9AC55BBBFB348,11161,20,23,3,32,48,1648
86194,86194,3380DDD2A29CB974B8421AA1A4DC975D,15651,10,11,1,39,25,1975
86195,86195,3380DDD2A29CB974B8421AA1A4DC975D,15221,12,14,2,31,4,1554
86196,86196,3380DDD2A29CB974B8421AA1A4DC975D,12621,18,19,1,10,48,548
86197,86197,3380DDD2A29CB974B8421AA1A4DC975D,10151,21,23,2,34,47,1747
86198,86198,8167EF05D15F996A6B93D96BD3E78468,10601,0,1,1,39,47,1997
86199,86199,8167EF05D15F996A6B93D96BD3E78468,13371,2,13,11,41,47,2097
86200,86200,8167EF05D15F996A6B93D96BD3E78468,42271,14,17,3,40,47,2047
86201,86201,8167EF05D15F996A6B93D96BD3E78468,12514,18,19,1,38,47,1947
86202,86202,8167EF05D15F996A6B93D96BD3E78468,42271,20,23,3,40,47,2047
86207,86207,9B16C8FF79CD32EF97A08ADCC08A0C98,12921,0,7,7,9,41,491
86208,86208,9B16C8FF79CD32EF97A08ADCC08A0C98,12641,8,10,2,10,43,543
86209,86209,9B16C8FF79CD32EF97A08ADCC08A0C98,19181,11,13,2,8,40,440
86210,86210,9B16C8FF79CD32EF97A08ADCC08A0C98,12641,14,15,1,10,43,543
86211,86211,9B16C8FF79CD32EF97A08ADCC08A0C98,12921,18,23,5,9,41,491
86212,86212,7C1223ABDC06A013346FEEE5F5DF7328,12521,0,9,9,35,41,1791
86213,86213,7C1223ABDC06A013346FEEE5F5DF7328,10292,12,14,2,30,47,1547
86214,86214,7C1223ABDC06A013346FEEE5F5DF7328,12521,18,23,5,35,41,1791
86222,86222,AF57FD742700B6DD506E3D60F4DB6DD5,10661,0,6,6,37,49,1899
86223,86223,AF57FD742700B6DD506E3D60F4DB6DD5,40302,7,10,3,40,49,2049
86224,86224,AF57FD742700B6DD506E3D60F4DB6DD5,11631,12,23,11,12,49,649
86225,86225,48DD61320EB4B5D793B42EB8DC63FA6F,10107,0,11,11,38,49,1949
86226,86226,48DD61320EB4B5D793B42EB8DC63FA6F,42091,13,15,2,43,46,2196
86227,86227,48DD61320EB4B5D793B42EB8DC63FA6F,10107,19,23,4,38,49,1949
86228,86228,D1B681929BD44A1A7918A0268A3E43F0,43021,2,11,9,16,43,843
86229,86229,D1B681929BD44A1A7918A0268A3E43F0,12921,13,17,4,9,41,491
86230,86230,D1B681929BD44A1A7918A0268A3E43F0,43021,18,22,4,16,43,843
86251,86251,EB3039C415C508F2A2DCF6403E75C42C,12921,1,10,9,9,41,491
86252,86252,EB3039C415C508F2A2DCF6403E75C42C,43021,10,13,3,16,43,843
86253,86253,EB3039C415C508F2A2DCF6403E75C42C,12921,13,16,3,9,41,491
86254,86254,EB3039C415C508F2A2DCF6403E75C42C,19114,18,23,5,7,43,393
86258,86258,32EC0F36441544FE0077B62E357B89B9,12921,0,6,6,9,41,491
86259,86259,32EC0F36441544FE0077B62E357B89B9,19901,7,12,5,7,44,394
86260,86260,32EC0F36441544FE0077B62E357B89B9,12921,17,18,1,9,41,491
86261,86261,32EC0F36441544FE0077B62E357B89B9,19114,18,22,4,7,43,393
86265,86265,7169FA01502782C069FB888C1FC19962,10681,0,8,8,30,48,1548
86266,86266,7169FA01502782C069FB888C1FC19962,10634,9,10,1,27,45,1395
86267,86267,7169FA01502782C069FB888C1FC19962,10351,14,15,1,28,45,1445
86268,86268,7169FA01502782C069FB888C1FC19962,10634,16,19,3,27,45,1395
86273,86273,6328F7CDE1FD4A3418797D65E47142EC,10381,8,15,7,31,49,1599
86274,86274,6328F7CDE1FD4A3418797D65E47142EC,42691,16,21,5,24,48,1248
86275,86275,6328F7CDE1FD4A3418797D65E47142EC,10451,21,22,1,25,48,1298
86276,86276,B46AE2CE1BCA5140A3BF4389C8F3A1DA,10901,0,8,8,35,48,1798
86277,86277,B46AE2CE1BCA5140A3BF4389C8F3A1DA,11521,18,20,2,41,48,2098
86278,86278,B46AE2CE1BCA5140A3BF4389C8F3A1DA,10901,21,23,2,35,48,1798
86282,86282,0C653DC860B823A0FBD73915967D7A74,43051,0,5,5,46,45,2345
86283,86283,0C653DC860B823A0FBD73915967D7A74,12221,6,8,2,43,44,2194
86284,86284,0C653DC860B823A0FBD73915967D7A74,43051,12,13,1,46,45,2345
86285,86285,0C653DC860B823A0FBD73915967D7A74,42631,16,18,2,43,45,2195
86286,86286,0C653DC860B823A0FBD73915967D7A74,43051,21,23,2,46,45,2345
86287,86287,7D11A4DA6D18D3AA9A4F60CCB926EA3E,43021,5,8,3,16,43,843
86288,86288,7D11A4DA6D18D3AA9A4F60CCB926EA3E,12921,9,11,2,9,41,491
86289,86289,7D11A4DA6D18D3AA9A4F60CCB926EA3E,43021,14,20,6,16,43,843
86290,86290,2C77555C5C771F95660B533F444D612A,15091,5,10,5,35,26,1776
86291,86291,2C77555C5C771F95660B533F444D612A,12792,14,17,3,34,30,1730
86292,86292,2C77555C5C771F95660B533F444D612A,15191,20,23,3,36,27,1827
86296,86296,ED329B71006D1766A598ADE6F5BD2F71,11321,0,6,6,31,46,1596
86297,86297,ED329B71006D1766A598ADE6F5BD2F71,12311,7,9,2,30,44,1544
86298,86298,ED329B71006D1766A598ADE6F5BD2F71,11321,12,13,1,31,46,1596
86299,86299,ED329B71006D1766A598ADE6F5BD2F71,11871,16,17,1,29,46,1496
86300,86300,ED329B71006D1766A598ADE6F5BD2F71,11321,18,23,5,31,46,1596
86314,86314,096291A7826A281BB9AE079B593A0255,12581,6,7,1,24,48,1248
86315,86315,096291A7826A281BB9AE079B593A0255,11361,8,10,2,22,48,1148
86316,86316,096291A7826A281BB9AE079B593A0255,42691,12,14,2,24,48,1248
86317,86317,096291A7826A281BB9AE079B593A0255,11361,16,17,1,22,48,1148
86318,86318,096291A7826A281BB9AE079B593A0255,42691,22,23,1,24,48,1248
86323,86323,E46021F2EBB1FF86CE07D74A4E5B9C9F,49201,0,5,5,7,41,391
86324,86324,E46021F2EBB1FF86CE07D74A4E5B9C9F,12921,6,10,4,9,41,491
86325,86325,E46021F2EBB1FF86CE07D74A4E5B9C9F,49201,10,12,2,7,41,391
86326,86326,E46021F2EBB1FF86CE07D74A4E5B9C9F,12921,14,16,2,9,41,491
86327,86327,E46021F2EBB1FF86CE07D74A4E5B9C9F,49201,20,21,1,7,41,391
86328,86328,4515D69DA9DF7C67BD58AB71BAA57E58,11914,0,7,7,37,48,1898
86329,86329,4515D69DA9DF7C67BD58AB71BAA57E58,42081,8,18,10,24,49,1249
86330,86330,4515D69DA9DF7C67BD58AB71BAA57E58,11331,19,23,4,37,48,1898
86331,86331,CEEEE12D961020D889C4958F8C670187,42861,1,7,6,37,44,1894
86332,86332,CEEEE12D961020D889C4958F8C670187,42151,9,11,2,35,45,1795
86333,86333,CEEEE12D961020D889C4958F8C670187,42861,11,20,9,37,44,1894
86334,86334,CEEEE12D961020D889C4958F8C670187,43041,21,22,1,41,46,2096
86338,86338,149A3DD1D28608A22B073ECD4C70B636,11791,0,11,11,38,49,1949
86339,86339,149A3DD1D28608A22B073ECD4C70B636,11861,11,19,8,32,47,1647
86340,86340,149A3DD1D28608A22B073ECD4C70B636,11791,20,23,3,38,49,1949
86349,86349,5C6E53E118C549BF3CD453A35E6BA378,43951,8,13,5,49,41,2491
86350,86350,5C6E53E118C549BF3CD453A35E6BA378,10471,14,18,4,37,48,1898
86351,86351,5C6E53E118C549BF3CD453A35E6BA378,11231,21,23,2,37,49,1899
86352,86352,ED0F18A4BA51840DF7EAD878A0CEC2C2,42231,0,8,8,37,46,1896
86353,86353,ED0F18A4BA51840DF7EAD878A0CEC2C2,10151,9,13,4,34,47,1747
86354,86354,ED0F18A4BA51840DF7EAD878A0CEC2C2,11074,14,15,1,37,47,1897
86355,86355,ED0F18A4BA51840DF7EAD878A0CEC2C2,42231,16,17,1,37,46,1896
86356,86356,ED0F18A4BA51840DF7EAD878A0CEC2C2,10151,17,23,6,34,47,1747
86361,86361,27F132E818644D3933B7D51A13F3BE57,15411,0,15,15,44,27,2227
86362,86362,27F132E818644D3933B7D51A13F3BE57,12611,16,17,1,41,29,2079
86363,86363,27F132E818644D3933B7D51A13F3BE57,15411,20,21,1,44,27,2227
86376,86376,5280CC76DC0C4B8862CCE29AE305F774,10721,0,12,12,31,48,1598
86377,86377,5280CC76DC0C4B8862CCE29AE305F774,40951,15,16,1,36,49,1849
86378,86378,5280CC76DC0C4B8862CCE29AE305F774,11151,21,23,2,30,48,1548
86379,86379,73701CC9434D9172C828A8DD1EB9C8FD,49201,8,9,1,7,41,391
86380,86380,73701CC9434D9172C828A8DD1EB9C8FD,19114,10,11,1,7,43,393
86381,86381,73701CC9434D9172C828A8DD1EB9C8FD,12921,12,19,7,9,41,491
86382,86382,73701CC9434D9172C828A8DD1EB9C8FD,19114,19,20,1,7,43,393
86383,86383,73701CC9434D9172C828A8DD1EB9C8FD,12921,22,23,1,9,41,491
86384,86384,2E45D01B51B3AF01B612D73FD415764E,43971,8,10,2,30,48,1548
86385,86385,2E45D01B51B3AF01B612D73FD415764E,11381,12,13,1,30,47,1547
86386,86386,2E45D01B51B3AF01B612D73FD415764E,43061,17,18,1,43,46,2196
86387,86387,2E45D01B51B3AF01B612D73FD415764E,42071,20,21,1,31,49,1599
86388,86388,BD23461971395615C4DFBEA8F5A6E3B3,42961,0,6,6,35,49,1799
86389,86389,BD23461971395615C4DFBEA8F5A6E3B3,11061,7,17,10,29,48,1498
86390,86390,BD23461971395615C4DFBEA8F5A6E3B3,42961,19,23,4,35,49,1799
86395,86395,A349D8C83E1914464A7CDA23A563E70B,42523,0,9,9,31,47,1597
86396,86396,A349D8C83E1914464A7CDA23A563E70B,43761,11,17,6,32,47,1647
86397,86397,A349D8C83E1914464A7CDA23A563E70B,12521,18,19,1,35,41,1791
86398,86398,A349D8C83E1914464A7CDA23A563E70B,42523,21,23,2,31,47,1597
86399,86399,D604CE1D6F1A7F1409A082A5844B835D,10292,0,7,7,30,47,1547
86400,86400,D604CE1D6F1A7F1409A082A5844B835D,12601,8,11,3,25,47,1297
86401,86401,D604CE1D6F1A7F1409A082A5844B835D,10292,12,15,3,30,47,1547
86402,86402,D604CE1D6F1A7F1409A082A5844B835D,12601,15,17,2,25,47,1297
86403,86403,D604CE1D6F1A7F1409A082A5844B835D,10292,18,23,5,30,47,1547
86410,86410,4A68C1945FCC1868E3DBF0CF909E5429,10691,0,1,1,33,48,1698
86411,86411,4A68C1945FCC1868E3DBF0CF909E5429,10381,2,11,9,31,49,1599
86412,86412,4A68C1945FCC1868E3DBF0CF909E5429,11751,12,13,1,35,48,1798
86413,86413,4A68C1945FCC1868E3DBF0CF909E5429,10151,15,17,2,34,47,1747
86414,86414,4A68C1945FCC1868E3DBF0CF909E5429,40872,18,21,3,30,49,1549
86415,86415,4A68C1945FCC1868E3DBF0CF909E5429,11201,21,23,2,35,49,1799
86416,86416,8196A2B8C47A96553EE65FF191FE9DED,11861,1,13,12,32,47,1647
86417,86417,8196A2B8C47A96553EE65FF191FE9DED,10841,15,16,1,37,47,1897
86418,86418,8196A2B8C47A96553EE65FF191FE9DED,10924,17,20,3,43,49,2199
86419,86419,8196A2B8C47A96553EE65FF191FE9DED,11351,21,23,2,36,48,1848
86420,86420,16D740AE27D92BE968DE244652195181,13671,5,13,8,27,43,1393
86421,86421,16D740AE27D92BE968DE244652195181,12761,15,18,3,25,40,1290
86422,86422,16D740AE27D92BE968DE244652195181,13671,19,20,1,27,43,1393
86436,86436,D9BB41A84CF921B48387DB07E0CD66FA,42221,0,5,5,38,48,1948
86437,86437,D9BB41A84CF921B48387DB07E0CD66FA,11074,9,14,5,37,47,1897
86438,86438,D9BB41A84CF921B48387DB07E0CD66FA,11631,18,20,2,12,49,649
86442,86442,C97D1EB6332A2DCE6ADB1DE5937351DA,42971,0,13,13,43,49,2199
86443,86443,C97D1EB6332A2DCE6ADB1DE5937351DA,42633,13,16,3,42,46,2146
86444,86444,C97D1EB6332A2DCE6ADB1DE5937351DA,11211,19,22,3,34,49,1749
86466,86466,7DF20745CA3702FAFFAC0138B1B2E95E,10661,0,1,1,37,49,1899
86467,86467,7DF20745CA3702FAFFAC0138B1B2E95E,12083,3,10,7,36,49,1849
86468,86468,7DF20745CA3702FAFFAC0138B1B2E95E,11231,11,16,5,37,49,1899
86469,86469,7DF20745CA3702FAFFAC0138B1B2E95E,12083,17,19,2,36,49,1849
86470,86470,7DF20745CA3702FAFFAC0138B1B2E95E,13561,21,22,1,37,49,1899
86475,86475,CD48A94261265D1AD1036CA0FAE4FA76,43051,0,6,6,46,45,2345
86476,86476,CD48A94261265D1AD1036CA0FAE4FA76,43731,8,9,1,34,47,1747
86477,86477,CD48A94261265D1AD1036CA0FAE4FA76,42921,11,23,12,33,47,1697
86496,86496,DA0BA167325B7981484B5CF554F97280,42401,0,9,9,36,47,1847
86497,86497,DA0BA167325B7981484B5CF554F97280,13091,13,15,2,20,42,1042
86498,86498,DA0BA167325B7981484B5CF554F97280,15261,18,20,2,39,13,1963
86502,86502,372A21350F3884793152DCFF165CE566,12561,4,6,2,45,43,2293
86503,86503,372A21350F3884793152DCFF165CE566,12211,6,7,1,41,44,2094
86504,86504,372A21350F3884793152DCFF165CE566,13341,12,23,11,44,45,2245
86505,86505,903BC7C5B3846AB22A9162C0B635F49F,42511,0,2,2,37,47,1897
86506,86506,903BC7C5B3846AB22A9162C0B635F49F,42521,4,11,7,31,47,1597
86507,86507,903BC7C5B3846AB22A9162C0B635F49F,43761,11,13,2,32,47,1647
86508,86508,903BC7C5B3846AB22A9162C0B635F49F,10295,13,20,7,30,47,1547
86509,86509,EAD0F857A028E27AEC5E665129C31CC4,11111,9,10,1,26,48,1348
86510,86510,EAD0F857A028E27AEC5E665129C31CC4,10801,12,15,3,42,47,2147
86511,86511,EAD0F857A028E27AEC5E665129C31CC4,42321,17,19,2,43,47,2197
86512,86512,A838ECC1E2CDA001A8AF04C158B09C78,42401,0,8,8,36,47,1847
86513,86513,A838ECC1E2CDA001A8AF04C158B09C78,13821,11,13,2,49,45,2495
86514,86514,A838ECC1E2CDA001A8AF04C158B09C78,42401,15,23,8,36,47,1847
86521,86521,9D7E28E179E5F5D009F8D277D0F434A8,11861,0,5,5,32,47,1647
86522,86522,9D7E28E179E5F5D009F8D277D0F434A8,42861,7,18,11,37,44,1894
86523,86523,9D7E28E179E5F5D009F8D277D0F434A8,11861,20,23,3,32,47,1647
86541,86541,BF1C25FEA2CAF96E8C013A91242C0773,11531,2,3,1,34,49,1749
86542,86542,BF1C25FEA2CAF96E8C013A91242C0773,11591,3,7,4,36,49,1849
86543,86543,BF1C25FEA2CAF96E8C013A91242C0773,42641,7,9,2,33,49,1699
86544,86544,BF1C25FEA2CAF96E8C013A91242C0773,11531,16,18,2,34,49,1749
86545,86545,BF1C25FEA2CAF96E8C013A91242C0773,11591,18,20,2,36,49,1849
86550,86550,FA01A09326FDE88829CC7783C381B035,12051,9,10,1,20,47,1047
86551,86551,FA01A09326FDE88829CC7783C381B035,10451,10,12,2,25,48,1298
86552,86552,FA01A09326FDE88829CC7783C381B035,42691,13,16,3,24,48,1248
86553,86553,FA01A09326FDE88829CC7783C381B035,12051,18,19,1,20,47,1047
86564,86564,F06696253146EEBB7842F43A19CD992F,19801,1,2,1,19,26,976
86565,86565,F06696253146EEBB7842F43A19CD992F,12874,4,5,1,20,34,1034
86566,86566,F06696253146EEBB7842F43A19CD992F,19801,6,10,4,19,26,976
86567,86567,F06696253146EEBB7842F43A19CD992F,12871,16,18,2,22,33,1133
86568,86568,F06696253146EEBB7842F43A19CD992F,19801,18,22,4,19,26,976
86569,86569,B24DFEF6BEA91CB0AE942579D8124FCB,42161,0,7,7,36,47,1847
86570,86570,B24DFEF6BEA91CB0AE942579D8124FCB,11731,8,10,2,36,48,1848
86571,86571,B24DFEF6BEA91CB0AE942579D8124FCB,12083,11,12,1,36,49,1849
86572,86572,B24DFEF6BEA91CB0AE942579D8124FCB,11731,12,14,2,36,48,1848
86573,86573,B24DFEF6BEA91CB0AE942579D8124FCB,10971,21,23,2,35,47,1797
86574,86574,26942AA5F68CEAEF074F6EB26B334985,11481,0,11,11,41,48,2098
86575,86575,26942AA5F68CEAEF074F6EB26B334985,12391,13,15,2,36,49,1849
86576,86576,26942AA5F68CEAEF074F6EB26B334985,10107,15,17,2,38,49,1949
86577,86577,26942AA5F68CEAEF074F6EB26B334985,13101,18,23,5,40,47,2047
86581,86581,4880B43E085B571F9DC3CE0CDA20B230,10107,0,15,15,38,49,1949
86582,86582,4880B43E085B571F9DC3CE0CDA20B230,11151,16,18,2,30,48,1548
86583,86583,4880B43E085B571F9DC3CE0CDA20B230,10107,18,23,5,38,49,1949
86584,86584,AE35AF59E07E84F79120874DC21D6F87,13111,0,8,8,42,46,2146
86585,86585,AE35AF59E07E84F79120874DC21D6F87,12021,8,12,4,37,49,1899
86586,86586,AE35AF59E07E84F79120874DC21D6F87,13111,14,23,9,42,46,2146
86591,86591,F004825C5EEC7F8B7A184D4985895C55,13341,0,7,7,44,45,2245
86592,86592,F004825C5EEC7F8B7A184D4985895C55,42631,9,11,2,43,45,2195
86593,86593,F004825C5EEC7F8B7A184D4985895C55,13341,12,13,1,44,45,2245
86594,86594,F004825C5EEC7F8B7A184D4985895C55,42631,13,15,2,43,45,2195
86595,86595,F004825C5EEC7F8B7A184D4985895C55,10107,19,21,2,38,49,1949
86599,86599,8436FA510D59B3814E50B7F18BD1D92C,19571,0,4,4,1,36,86
86600,86600,8436FA510D59B3814E50B7F18BD1D92C,12641,9,10,1,10,43,543
86601,86601,8436FA510D59B3814E50B7F18BD1D92C,12921,15,16,1,9,41,491
86602,86602,8436FA510D59B3814E50B7F18BD1D92C,19571,18,21,3,1,36,86
86603,86603,8436FA510D59B3814E50B7F18BD1D92C,19181,22,23,1,8,40,440
86604,86604,87EB555D6099B841DEA08133918E958C,11381,0,2,2,30,47,1547
86605,86605,87EB555D6099B841DEA08133918E958C,11061,3,4,1,29,48,1498
86606,86606,87EB555D6099B841DEA08133918E958C,11381,4,8,4,30,47,1547
86607,86607,87EB555D6099B841DEA08133918E958C,11061,12,16,4,29,48,1498
86608,86608,87EB555D6099B841DEA08133918E958C,11381,19,22,3,30,47,1547
86622,86622,BF5EFB3BDBF5437ACD467C87E9038A8B,43021,0,5,5,16,43,843
86623,86623,BF5EFB3BDBF5437ACD467C87E9038A8B,19261,7,9,2,6,37,337
86624,86624,BF5EFB3BDBF5437ACD467C87E9038A8B,43021,10,21,11,16,43,843
86629,86629,3D50CF8DA80A4761FAF974D4CBB0A177,43751,0,6,6,19,48,998
86630,86630,3D50CF8DA80A4761FAF974D4CBB0A177,12601,7,11,4,25,47,1297
86631,86631,3D50CF8DA80A4761FAF974D4CBB0A177,10061,16,17,1,20,46,1046
86632,86632,3D50CF8DA80A4761FAF974D4CBB0A177,43751,19,22,3,19,48,998
86633,86633,34A498ECBF094B1655F6385A2FF4F5D2,11361,3,14,11,22,48,1148
86634,86634,34A498ECBF094B1655F6385A2FF4F5D2,10451,14,18,4,25,48,1298
86635,86635,34A498ECBF094B1655F6385A2FF4F5D2,10171,19,23,4,26,47,1347
86642,86642,1C0548F40841AD0870DAD8EC7BECCBC6,13314,0,7,7,31,39,1589
86643,86643,1C0548F40841AD0870DAD8EC7BECCBC6,12521,8,10,2,35,41,1791
86644,86644,1C0548F40841AD0870DAD8EC7BECCBC6,13314,11,13,2,31,39,1589
86645,86645,1C0548F40841AD0870DAD8EC7BECCBC6,12521,14,17,3,35,41,1791
86646,86646,1C0548F40841AD0870DAD8EC7BECCBC6,13314,18,23,5,31,39,1589
86655,86655,B9BCF71C2F61A77B3AFDA6CAB9B35F57,42071,3,4,1,31,49,1599
86656,86656,B9BCF71C2F61A77B3AFDA6CAB9B35F57,42623,9,10,1,22,49,1149
86657,86657,B9BCF71C2F61A77B3AFDA6CAB9B35F57,42121,12,13,1,26,49,1349
86658,86658,B9BCF71C2F61A77B3AFDA6CAB9B35F57,11151,16,18,2,30,48,1548
86663,86663,B3B6DB42A007138565C740275F503BCE,43021,0,4,4,16,43,843
86664,86664,B3B6DB42A007138565C740275F503BCE,19021,5,7,2,10,45,545
86665,86665,B3B6DB42A007138565C740275F503BCE,11101,7,9,2,18,48,948
86666,86666,B3B6DB42A007138565C740275F503BCE,19021,9,21,12,10,45,545
86667,86667,B3B6DB42A007138565C740275F503BCE,12641,21,23,2,10,43,543
86668,86668,567BA56B3BCFA543331B7DA53FB8FA00,19031,0,6,6,1,42,92
86669,86669,567BA56B3BCFA543331B7DA53FB8FA00,12641,8,16,8,10,43,543
86670,86670,567BA56B3BCFA543331B7DA53FB8FA00,19031,19,23,4,1,42,92
86671,86671,E648A6F090A3BE85617E0ED54A73B4F0,12601,0,3,3,25,47,1297
86672,86672,E648A6F090A3BE85617E0ED54A73B4F0,13771,4,7,3,21,45,1095
86673,86673,E648A6F090A3BE85617E0ED54A73B4F0,12601,8,13,5,25,47,1297
86674,86674,E648A6F090A3BE85617E0ED54A73B4F0,12671,14,15,1,21,43,1093
86675,86675,E648A6F090A3BE85617E0ED54A73B4F0,12601,16,23,7,25,47,1297
86676,86676,4D0ED6C01EC55D2BA8CCC5E44CD25B70,12381,8,14,6,32,48,1648
86677,86677,4D0ED6C01EC55D2BA8CCC5E44CD25B70,11941,16,18,2,37,46,1896
86678,86678,4D0ED6C01EC55D2BA8CCC5E44CD25B70,13121,18,19,1,38,46,1946
86686,86686,90AEF58BB4CABDF543DA1FFF777671DC,11381,1,15,14,30,47,1547
86687,86687,90AEF58BB4CABDF543DA1FFF777671DC,11231,16,17,1,37,49,1899
86688,86688,90AEF58BB4CABDF543DA1FFF777671DC,11381,18,19,1,30,47,1547
86689,86689,90AEF58BB4CABDF543DA1FFF777671DC,42523,19,21,2,31,47,1597
86690,86690,90AEF58BB4CABDF543DA1FFF777671DC,11381,21,23,2,30,47,1547
86691,86691,5417A6F92A553E01B7C73CE94852B163,11231,0,9,9,37,49,1899
86692,86692,5417A6F92A553E01B7C73CE94852B163,40331,10,14,4,30,47,1547
86693,86693,5417A6F92A553E01B7C73CE94852B163,11231,19,23,4,37,49,1899
86694,86694,A397CA34DC305144BBC47B61A59BF2DD,11074,0,1,1,37,47,1897
86695,86695,A397CA34DC305144BBC47B61A59BF2DD,42401,2,7,5,36,47,1847
86696,86696,A397CA34DC305144BBC47B61A59BF2DD,12561,9,18,9,45,43,2293
86697,86697,A397CA34DC305144BBC47B61A59BF2DD,42301,19,22,3,36,47,1847
86701,86701,D9419B851F8839F5D675C951F631DB8E,10921,0,7,7,43,48,2198
86702,86702,D9419B851F8839F5D675C951F631DB8E,49181,9,10,1,21,31,1081
86703,86703,D9419B851F8839F5D675C951F631DB8E,13481,12,17,5,26,31,1331
86704,86704,D9419B851F8839F5D675C951F631DB8E,10921,19,23,4,43,48,2198
86705,86705,2F66AC01887397A198C9CCA6611EA97B,12521,0,15,15,35,41,1791
86706,86706,2F66AC01887397A198C9CCA6611EA97B,13314,15,16,1,31,39,1589
86707,86707,2F66AC01887397A198C9CCA6611EA97B,12521,19,23,4,35,41,1791
86718,86718,3AB35E62E3464B5074E82DE69E9DD0D9,42501,0,2,2,28,47,1447
86719,86719,3AB35E62E3464B5074E82DE69E9DD0D9,42541,3,6,3,25,47,1297
86720,86720,3AB35E62E3464B5074E82DE69E9DD0D9,19441,10,18,8,8,46,446
86721,86721,3AB35E62E3464B5074E82DE69E9DD0D9,42501,21,23,2,28,47,1447
86722,86722,C7C431E83C90A041B3FA2A63798CE4F8,43021,0,13,13,16,43,843
86723,86723,C7C431E83C90A041B3FA2A63798CE4F8,12921,15,16,1,9,41,491
86724,86724,C7C431E83C90A041B3FA2A63798CE4F8,43021,20,21,1,16,43,843
86734,86734,CC6A63734928B4CD8F414AAB01241B9F,10611,0,9,9,32,48,1648
86735,86735,CC6A63734928B4CD8F414AAB01241B9F,42081,12,14,2,24,49,1249
86736,86736,CC6A63734928B4CD8F414AAB01241B9F,10161,15,17,2,35,49,1799
86737,86737,CC6A63734928B4CD8F414AAB01241B9F,11751,20,22,2,35,48,1798
86738,86738,01067BD464140B42D6F1D4D82F8B8EE7,42271,1,3,2,40,47,2047
86739,86739,01067BD464140B42D6F1D4D82F8B8EE7,43481,3,8,5,39,48,1998
86740,86740,01067BD464140B42D6F1D4D82F8B8EE7,11231,9,13,4,37,49,1899
86741,86741,01067BD464140B42D6F1D4D82F8B8EE7,40203,13,17,4,33,49,1699
86742,86742,01067BD464140B42D6F1D4D82F8B8EE7,43481,21,23,2,39,48,1998
86743,86743,65D64C160A447AEB66DB50D8CA5B54D8,42321,0,14,14,43,47,2197
86744,86744,65D64C160A447AEB66DB50D8CA5B54D8,10251,17,18,1,35,47,1797
86745,86745,65D64C160A447AEB66DB50D8CA5B54D8,42271,19,23,4,40,47,2047
86749,86749,5DC656AE1F755A21D4CE0049D29039D4,12521,2,5,3,35,41,1791
86750,86750,5DC656AE1F755A21D4CE0049D29039D4,12491,6,8,2,36,43,1843
86751,86751,5DC656AE1F755A21D4CE0049D29039D4,10107,12,16,4,38,49,1949
86752,86752,5DC656AE1F755A21D4CE0049D29039D4,12491,18,20,2,36,43,1843
86753,86753,5DC656AE1F755A21D4CE0049D29039D4,11261,22,23,1,36,46,1846
86761,86761,62AF9B3FEBDF97558B7670BE726C1773,40171,0,14,14,38,48,1948
86762,86762,62AF9B3FEBDF97558B7670BE726C1773,43181,15,16,1,39,48,1998
86763,86763,62AF9B3FEBDF97558B7670BE726C1773,10611,19,20,1,32,48,1648
86764,86764,464A8954189CE9AFFA4CED6E8000F863,43751,0,9,9,19,48,998
86765,86765,464A8954189CE9AFFA4CED6E8000F863,11361,13,21,8,22,48,1148
86766,86766,464A8954189CE9AFFA4CED6E8000F863,10501,21,23,2,22,46,1146
86767,86767,649CA0B4C9C73F10630BCAC6C100E533,42151,2,13,11,35,45,1795
86768,86768,649CA0B4C9C73F10630BCAC6C100E533,12311,14,15,1,30,44,1544
86769,86769,649CA0B4C9C73F10630BCAC6C100E533,42151,16,23,7,35,45,1795
86770,86770,062CB60A9AB52624CD2A180862C1595A,42461,0,2,2,45,47,2297
86771,86771,062CB60A9AB52624CD2A180862C1595A,43061,2,3,1,43,46,2196
86772,86772,062CB60A9AB52624CD2A180862C1595A,42461,7,11,4,45,47,2297
86773,86773,062CB60A9AB52624CD2A180862C1595A,42204,15,17,2,43,46,2196
86774,86774,062CB60A9AB52624CD2A180862C1595A,42461,19,23,4,45,47,2297
86778,86778,9508FAE0B774FCD97D7CFB3C4BD72215,11861,0,1,1,32,47,1647
86779,86779,9508FAE0B774FCD97D7CFB3C4BD72215,10111,1,8,7,37,47,1897
86780,86780,9508FAE0B774FCD97D7CFB3C4BD72215,10251,11,13,2,35,47,1797
86781,86781,9508FAE0B774FCD97D7CFB3C4BD72215,10292,13,16,3,30,47,1547
86782,86782,9508FAE0B774FCD97D7CFB3C4BD72215,10251,17,19,2,35,47,1797
86783,86783,9508FAE0B774FCD97D7CFB3C4BD72215,42401,19,23,4,36,47,1847
86787,86787,DE69FEBC50432F9871EF62D07F7A5C1A,43021,0,5,5,16,43,843
86788,86788,DE69FEBC50432F9871EF62D07F7A5C1A,12921,6,10,4,9,41,491
86789,86789,DE69FEBC50432F9871EF62D07F7A5C1A,12641,11,12,1,10,43,543
86790,86790,DE69FEBC50432F9871EF62D07F7A5C1A,12921,14,16,2,9,41,491
86791,86791,DE69FEBC50432F9871EF62D07F7A5C1A,19181,18,19,1,8,40,440
86799,86799,D6B99B7221B6428901933B53B4CD2E3E,42581,0,6,6,38,48,1948
86800,86800,D6B99B7221B6428901933B53B4CD2E3E,11914,6,7,1,37,48,1898
86801,86801,D6B99B7221B6428901933B53B4CD2E3E,42581,9,11,2,38,48,1948
86802,86802,D6B99B7221B6428901933B53B4CD2E3E,11914,11,12,1,37,48,1898
86803,86803,D6B99B7221B6428901933B53B4CD2E3E,42581,13,18,5,38,48,1948
86804,86804,D6B99B7221B6428901933B53B4CD2E3E,11914,20,21,1,37,48,1898
86809,86809,FF16D1104349162E539969031BE39A02,43481,1,2,1,39,48,1998
86810,86810,FF16D1104349162E539969031BE39A02,12511,4,7,3,39,47,1997
86811,86811,FF16D1104349162E539969031BE39A02,12514,8,10,2,38,47,1947
86812,86812,FF16D1104349162E539969031BE39A02,43481,12,14,2,39,48,1998
86813,86813,FF16D1104349162E539969031BE39A02,12514,18,19,1,38,47,1947
86814,86814,FF16D1104349162E539969031BE39A02,42271,21,23,2,40,47,2047
86815,86815,3167279CE8CFD8F4AA7B1E5335A41089,12601,1,4,3,25,47,1297
86816,86816,3167279CE8CFD8F4AA7B1E5335A41089,11081,5,17,12,35,46,1796
86817,86817,3167279CE8CFD8F4AA7B1E5335A41089,12051,21,22,1,20,47,1047
86822,86822,331C93B6083F5634586EEDFC958D0A76,42351,0,8,8,38,45,1945
86823,86823,331C93B6083F5634586EEDFC958D0A76,11021,10,11,1,36,49,1849
86824,86824,331C93B6083F5634586EEDFC958D0A76,13911,11,14,3,39,46,1996
86825,86825,331C93B6083F5634586EEDFC958D0A76,11231,17,18,1,37,49,1899
86830,86830,D1D4F1B4017FEA89A042CB8ED8E15110,40343,0,16,16,24,49,1249
86831,86831,D1D4F1B4017FEA89A042CB8ED8E15110,40925,16,18,2,35,49,1799
86832,86832,D1D4F1B4017FEA89A042CB8ED8E15110,40343,19,23,4,24,49,1249
86836,86836,D6B662C0D72BBB94314A69A6BE13D66E,10381,1,10,9,31,49,1599
86837,86837,D6B662C0D72BBB94314A69A6BE13D66E,42523,11,15,4,31,47,1597
86838,86838,D6B662C0D72BBB94314A69A6BE13D66E,40073,16,22,6,37,48,1898
86843,86843,05FAC26C716C22886CC30B6006B2DDD9,10811,1,3,2,38,46,1946
86844,86844,05FAC26C716C22886CC30B6006B2DDD9,42351,3,4,1,38,45,1945
86845,86845,05FAC26C716C22886CC30B6006B2DDD9,10811,5,14,9,38,46,1946
86846,86846,05FAC26C716C22886CC30B6006B2DDD9,13341,14,16,2,44,45,2245
86847,86847,05FAC26C716C22886CC30B6006B2DDD9,10811,18,20,2,38,46,1946
86848,86848,05FAC26C716C22886CC30B6006B2DDD9,11806,21,23,2,41,48,2098
86852,86852,083E6F45CD758E55D59CE683A8831561,42381,0,6,6,39,41,1991
86853,86853,083E6F45CD758E55D59CE683A8831561,13071,6,7,1,41,41,2091
86854,86854,083E6F45CD758E55D59CE683A8831561,43451,9,10,1,37,40,1890
86855,86855,083E6F45CD758E55D59CE683A8831561,42381,12,13,1,39,41,1991
86856,86856,083E6F45CD758E55D59CE683A8831561,13071,14,21,7,41,41,2091
86857,86857,083E6F45CD758E55D59CE683A8831561,43011,21,23,2,40,42,2042
86861,86861,50F75ACC0EBCD6CB7E01B16CF26F5736,42301,0,10,10,36,47,1847
86862,86862,50F75ACC0EBCD6CB7E01B16CF26F5736,13091,13,15,2,20,42,1042
86863,86863,50F75ACC0EBCD6CB7E01B16CF26F5736,15261,18,19,1,39,13,1963
86867,86867,1F42215006F7886C1F1C7AC253EDA68D,11841,0,8,8,33,46,1696
86868,86868,1F42215006F7886C1F1C7AC253EDA68D,10911,8,9,1,39,46,1996
86869,86869,1F42215006F7886C1F1C7AC253EDA68D,10151,13,15,2,34,47,1747
86870,86870,1F42215006F7886C1F1C7AC253EDA68D,40951,15,18,3,36,49,1849
86871,86871,1F42215006F7886C1F1C7AC253EDA68D,11841,20,23,3,33,46,1696
86884,86884,2D9F8EEE0946858BEC66856CB73B8335,43021,0,6,6,16,43,843
86885,86885,2D9F8EEE0946858BEC66856CB73B8335,12921,8,10,2,9,41,491
86886,86886,2D9F8EEE0946858BEC66856CB73B8335,43021,11,23,12,16,43,843
86898,86898,D8B759EF262E37334F16BE14DF6587E6,40094,1,7,6,29,48,1498
86899,86899,D8B759EF262E37334F16BE14DF6587E6,11331,9,10,1,37,48,1898
86900,86900,D8B759EF262E37334F16BE14DF6587E6,11061,13,18,5,29,48,1498
86901,86901,7F95A9A249FFE85241CD9778528D8579,42351,0,4,4,38,45,1945
86902,86902,7F95A9A249FFE85241CD9778528D8579,42633,6,7,1,42,46,2146
86903,86903,7F95A9A249FFE85241CD9778528D8579,42081,9,20,11,24,49,1249
86904,86904,0079E35B7606E0DE1B56E35EAC74136E,42071,0,1,1,31,49,1599
86905,86905,0079E35B7606E0DE1B56E35EAC74136E,42081,2,4,2,24,49,1249
86906,86906,0079E35B7606E0DE1B56E35EAC74136E,42071,5,22,17,31,49,1599
86907,86907,01B42CBE932F13FE9124509437B67554,12021,0,12,12,37,49,1899
86908,86908,01B42CBE932F13FE9124509437B67554,40341,14,17,3,23,49,1199
86909,86909,01B42CBE932F13FE9124509437B67554,11641,18,21,3,22,49,1149
86914,86914,94092014F9DD3213271810B8D19555BE,49201,0,5,5,7,41,391
86915,86915,94092014F9DD3213271810B8D19555BE,12921,8,10,2,9,41,491
86916,86916,94092014F9DD3213271810B8D19555BE,49201,11,13,2,7,41,391
86917,86917,94092014F9DD3213271810B8D19555BE,12641,14,15,1,10,43,543
86918,86918,94092014F9DD3213271810B8D19555BE,49201,19,23,4,7,41,391
86919,86919,94DF6D416CC5B92A0E5062ABBAC5B786,11914,1,5,4,37,48,1898
86920,86920,94DF6D416CC5B92A0E5062ABBAC5B786,10381,9,20,11,31,49,1599
86921,86921,94DF6D416CC5B92A0E5062ABBAC5B786,11074,21,23,2,37,47,1897
86922,86922,7D8BB90B66B5BB302B836A7DB354A71B,42601,0,6,6,44,48,2248
86923,86923,7D8BB90B66B5BB302B836A7DB354A71B,42321,7,10,3,43,47,2197
86924,86924,7D8BB90B66B5BB302B836A7DB354A71B,11701,12,15,3,43,48,2198
86925,86925,7D8BB90B66B5BB302B836A7DB354A71B,42601,17,19,2,44,48,2248
86926,86926,7D8BB90B66B5BB302B836A7DB354A71B,41393,22,23,1,43,49,2199
86927,86927,7C934DECF77A595DE63063184CF871A6,11381,0,11,11,30,47,1547
86928,86928,7C934DECF77A595DE63063184CF871A6,40171,12,13,1,38,48,1948
86929,86929,7C934DECF77A595DE63063184CF871A6,11381,14,23,9,30,47,1547
86944,86944,C069A0126B5D5D8D81FDB27FE9AA5203,40381,0,17,17,32,46,1646
86945,86945,C069A0126B5D5D8D81FDB27FE9AA5203,11201,18,19,1,35,49,1799
86946,86946,C069A0126B5D5D8D81FDB27FE9AA5203,40381,20,22,2,32,46,1646
86947,86947,89C5F5C036761FD2C32F64BC4CDE2E5B,19441,0,12,12,8,46,446
86948,86948,89C5F5C036761FD2C32F64BC4CDE2E5B,11541,14,15,1,35,49,1799
86949,86949,89C5F5C036761FD2C32F64BC4CDE2E5B,19114,18,20,2,7,43,393
86950,86950,89C5F5C036761FD2C32F64BC4CDE2E5B,19441,20,22,2,8,46,446
86963,86963,C6ECE5EEB3C55F11FF8684D918998C95,11571,0,6,6,13,46,696
86964,86964,C6ECE5EEB3C55F11FF8684D918998C95,19021,7,11,4,10,45,545
86965,86965,C6ECE5EEB3C55F11FF8684D918998C95,11571,12,13,1,13,46,696
86966,86966,C6ECE5EEB3C55F11FF8684D918998C95,19021,15,17,2,10,45,545
86967,86967,C6ECE5EEB3C55F11FF8684D918998C95,43021,17,19,2,16,43,843
86968,86968,C6ECE5EEB3C55F11FF8684D918998C95,11571,21,23,2,13,46,696
86969,86969,8E21695328CD990E36A796F4A2E5D43C,13551,1,7,6,45,38,2288
86970,86970,8E21695328CD990E36A796F4A2E5D43C,43101,7,8,1,46,40,2340
86971,86971,8E21695328CD990E36A796F4A2E5D43C,13371,10,20,10,41,47,2097
86972,86972,8E21695328CD990E36A796F4A2E5D43C,13381,21,22,1,39,47,1997
86973,86973,14D802A3B202443F8B89CB3561B9B173,12311,0,7,7,30,44,1544
86974,86974,14D802A3B202443F8B89CB3561B9B173,42531,7,9,2,31,45,1595
86975,86975,14D802A3B202443F8B89CB3561B9B173,10221,11,14,3,34,49,1749
86976,86976,14D802A3B202443F8B89CB3561B9B173,10351,15,19,4,28,45,1445
86977,86977,C1CF59B64EE7642E956AF0C2EBE03CC9,42921,0,8,8,33,47,1697
86978,86978,C1CF59B64EE7642E956AF0C2EBE03CC9,10841,9,10,1,37,47,1897
86979,86979,C1CF59B64EE7642E956AF0C2EBE03CC9,42921,10,13,3,33,47,1697
86980,86980,C1CF59B64EE7642E956AF0C2EBE03CC9,43361,19,21,2,38,48,1948
86984,86984,583602182C31C8E2D985404EA5592339,12921,0,1,1,9,41,491
86985,86985,583602182C31C8E2D985404EA5592339,19261,3,6,3,6,37,337
86986,86986,583602182C31C8E2D985404EA5592339,12921,7,20,13,9,41,491
86991,86991,A1949442C5CEA079E7EF9FDA762FFB2E,42491,0,1,1,32,46,1646
86992,86992,A1949442C5CEA079E7EF9FDA762FFB2E,10341,4,7,3,31,47,1597
86993,86993,A1949442C5CEA079E7EF9FDA762FFB2E,42491,9,10,1,32,46,1646
86994,86994,A1949442C5CEA079E7EF9FDA762FFB2E,43391,14,15,1,29,48,1498
86995,86995,A1949442C5CEA079E7EF9FDA762FFB2E,10292,18,19,1,30,47,1547
86996,86996,A1949442C5CEA079E7EF9FDA762FFB2E,42523,19,23,4,31,47,1597
87000,87000,EC5970EBB0B137E41374AE48E57C0F01,42151,0,3,3,35,45,1795
87001,87001,EC5970EBB0B137E41374AE48E57C0F01,11261,6,11,5,36,46,1846
87002,87002,EC5970EBB0B137E41374AE48E57C0F01,13911,12,13,1,39,46,1996
87003,87003,EC5970EBB0B137E41374AE48E57C0F01,11261,13,19,6,36,46,1846
87007,87007,96056246DD9856C2DDE7E703B0D16D68,42301,0,2,2,36,47,1847
87008,87008,96056246DD9856C2DDE7E703B0D16D68,10951,3,11,8,29,48,1498
87009,87009,96056246DD9856C2DDE7E703B0D16D68,11381,11,23,12,30,47,1547
87010,87010,E572D34D15CCFF06895D9E2C410E6273,12311,10,11,1,30,44,1544
87011,87011,E572D34D15CCFF06895D9E2C410E6273,42151,12,18,6,35,45,1795
87012,87012,E572D34D15CCFF06895D9E2C410E6273,42121,18,20,2,26,49,1349
87013,87013,B9E127195A4DFA1F988A0F90827556AB,13951,0,10,10,47,45,2395
87014,87014,B9E127195A4DFA1F988A0F90827556AB,11431,12,13,1,29,47,1497
87015,87015,B9E127195A4DFA1F988A0F90827556AB,42461,15,16,1,45,47,2297
87016,87016,B9E127195A4DFA1F988A0F90827556AB,13821,17,23,6,49,45,2495
87017,87017,1F899C425E1D44BC86781F60DDEF728E,43021,0,7,7,16,43,843
87018,87018,1F899C425E1D44BC86781F60DDEF728E,12921,7,17,10,9,41,491
87019,87019,1F899C425E1D44BC86781F60DDEF728E,43021,20,23,3,16,43,843
87020,87020,B36C8579A2DBF718933C4838B2421A42,10841,4,8,4,37,47,1897
87021,87021,B36C8579A2DBF718933C4838B2421A42,13121,9,10,1,38,46,1946
87022,87022,B36C8579A2DBF718933C4838B2421A42,42511,11,12,1,37,47,1897
87023,87023,B36C8579A2DBF718933C4838B2421A42,13681,15,16,1,38,47,1947
87024,87024,B36C8579A2DBF718933C4838B2421A42,13121,16,23,7,38,46,1946
87036,87036,C77F23D19DAEA5BB8ADE1BB3D3C261B4,13671,0,4,4,27,43,1393
87037,87037,C77F23D19DAEA5BB8ADE1BB3D3C261B4,13091,5,6,1,20,42,1042
87038,87038,C77F23D19DAEA5BB8ADE1BB3D3C261B4,42531,11,13,2,31,45,1595
87039,87039,C77F23D19DAEA5BB8ADE1BB3D3C261B4,13671,14,15,1,27,43,1393
87040,87040,C77F23D19DAEA5BB8ADE1BB3D3C261B4,12661,18,21,3,32,45,1645
87041,87041,B7C33B5C4F6E6D84F66DE44CC367A266,42861,3,5,2,37,44,1894
87042,87042,B7C33B5C4F6E6D84F66DE44CC367A266,12601,9,17,8,25,47,1297
87043,87043,B7C33B5C4F6E6D84F66DE44CC367A266,42861,20,21,1,37,44,1894
87044,87044,0C3194ACA02EEEE83211FBC6BBEAC731,11875,0,8,8,30,46,1546
87045,87045,0C3194ACA02EEEE83211FBC6BBEAC731,13121,10,12,2,38,46,1946
87046,87046,0C3194ACA02EEEE83211FBC6BBEAC731,42554,14,23,9,14,46,746
87047,87047,BE9C7D5970EDB149C920B55BDA903F43,10751,1,3,2,47,43,2393
87048,87048,BE9C7D5970EDB149C920B55BDA903F43,13951,4,15,11,47,45,2395
87049,87049,BE9C7D5970EDB149C920B55BDA903F43,12211,15,16,1,41,44,2094
87050,87050,BE9C7D5970EDB149C920B55BDA903F43,13951,20,21,1,47,45,2395
87054,87054,3DB43BF5A8573EFBFD489A47E3D30CBD,42081,2,4,2,24,49,1249
87055,87055,3DB43BF5A8573EFBFD489A47E3D30CBD,10381,4,8,4,31,49,1599
87056,87056,3DB43BF5A8573EFBFD489A47E3D30CBD,42081,9,18,9,24,49,1249
87057,87057,3DB43BF5A8573EFBFD489A47E3D30CBD,10381,18,19,1,31,49,1599
87058,87058,3DB43BF5A8573EFBFD489A47E3D30CBD,42081,20,23,3,24,49,1249
87059,87059,62F6BE848412C7FADEB816AFD62C431F,16151,9,15,6,13,11,661
87060,87060,62F6BE848412C7FADEB816AFD62C431F,15145,15,17,2,22,9,1109
87061,87061,62F6BE848412C7FADEB816AFD62C431F,16151,17,19,2,13,11,661
87062,87062,62F6BE848412C7FADEB816AFD62C431F,15141,21,23,2,26,11,1311
87070,87070,0E54FDDDFEF0BF7075D3505985BA7000,13071,0,14,14,41,41,2091
87071,87071,0E54FDDDFEF0BF7075D3505985BA7000,43451,15,16,1,37,40,1890
87072,87072,0E54FDDDFEF0BF7075D3505985BA7000,13071,16,23,7,41,41,2091
87073,87073,F5691F37A02FA042BB333016905488CC,12381,0,8,8,32,48,1648
87074,87074,F5691F37A02FA042BB333016905488CC,42151,10,11,1,35,45,1795
87075,87075,F5691F37A02FA042BB333016905488CC,40941,21,23,2,32,48,1648
87082,87082,10855C931F3D54C1DF8C185C9AF3F920,12971,0,7,7,32,48,1648
87083,87083,10855C931F3D54C1DF8C185C9AF3F920,11261,11,12,1,36,46,1846
87084,87084,10855C931F3D54C1DF8C185C9AF3F920,11731,15,17,2,36,48,1848
87085,87085,10855C931F3D54C1DF8C185C9AF3F920,40941,18,19,1,32,48,1648
87086,87086,21C21587890502DDD311AAE3E126DBBD,11061,0,6,6,29,48,1498
87087,87087,21C21587890502DDD311AAE3E126DBBD,11381,8,10,2,30,47,1547
87088,87088,21C21587890502DDD311AAE3E126DBBD,11061,12,13,1,29,48,1498
87089,87089,21C21587890502DDD311AAE3E126DBBD,11381,14,16,2,30,47,1547
87090,87090,21C21587890502DDD311AAE3E126DBBD,11061,16,17,1,29,48,1498
87091,87091,21C21587890502DDD311AAE3E126DBBD,10401,19,22,3,33,49,1699
87092,87092,975688BDD7D3B41B53C460B57B5AC58A,43751,4,14,10,19,48,998
87093,87093,975688BDD7D3B41B53C460B57B5AC58A,10451,17,18,1,25,48,1298
87094,87094,975688BDD7D3B41B53C460B57B5AC58A,43751,20,23,3,19,48,998
87095,87095,7A784F63DA542325785D1949B0ED9A3A,12311,0,5,5,30,44,1544
87096,87096,7A784F63DA542325785D1949B0ED9A3A,13314,8,9,1,31,39,1589
87097,87097,7A784F63DA542325785D1949B0ED9A3A,10301,10,17,7,31,45,1595
87098,87098,7A784F63DA542325785D1949B0ED9A3A,12311,19,20,1,30,44,1544
87106,87106,A2393883FDFDB5F029F5622F83E15337,11801,0,12,12,42,48,2148
87107,87107,A2393883FDFDB5F029F5622F83E15337,10901,12,14,2,35,48,1798
87108,87108,A2393883FDFDB5F029F5622F83E15337,40341,15,17,2,23,49,1199
87109,87109,A2393883FDFDB5F029F5622F83E15337,12514,18,21,3,38,47,1947
87110,87110,A2393883FDFDB5F029F5622F83E15337,40361,22,23,1,42,48,2148
87111,87111,B20D4CCCBBF9B534BB9F26A35B371E4C,42351,0,6,6,38,45,1945
87112,87112,B20D4CCCBBF9B534BB9F26A35B371E4C,11261,6,7,1,36,46,1846
87113,87113,B20D4CCCBBF9B534BB9F26A35B371E4C,42351,8,10,2,38,45,1945
87114,87114,B20D4CCCBBF9B534BB9F26A35B371E4C,11261,15,17,2,36,46,1846
87115,87115,B20D4CCCBBF9B534BB9F26A35B371E4C,42351,17,18,1,38,45,1945
87116,87116,B20D4CCCBBF9B534BB9F26A35B371E4C,11261,18,21,3,36,46,1846
87117,87117,B20D4CCCBBF9B534BB9F26A35B371E4C,42351,22,23,1,38,45,1945
87118,87118,B3477C1D01BBBB78E6BFFFBF4AF4AC51,13111,0,7,7,42,46,2146
87119,87119,B3477C1D01BBBB78E6BFFFBF4AF4AC51,13121,8,9,1,38,46,1946
87120,87120,B3477C1D01BBBB78E6BFFFBF4AF4AC51,40951,12,14,2,36,49,1849
87121,87121,B3477C1D01BBBB78E6BFFFBF4AF4AC51,13111,15,23,8,42,46,2146
87122,87122,FEAE154A6512A4AAA940A407079559C2,43761,0,8,8,32,47,1647
87123,87123,FEAE154A6512A4AAA940A407079559C2,10471,11,18,7,37,48,1898
87124,87124,FEAE154A6512A4AAA940A407079559C2,11861,20,22,2,32,47,1647
87128,87128,353B91514B85060D7FF199AF75C52EFF,42071,6,8,2,31,49,1599
87129,87129,353B91514B85060D7FF199AF75C52EFF,42623,13,15,2,22,49,1149
87130,87130,353B91514B85060D7FF199AF75C52EFF,42071,18,19,1,31,49,1599
87131,87131,353B91514B85060D7FF199AF75C52EFF,11151,21,23,2,30,48,1548
87132,87132,F7A05B3FECD253C9C578617425D22E9D,42051,0,1,1,42,48,2148
87133,87133,F7A05B3FECD253C9C578617425D22E9D,11231,2,5,3,37,49,1899
87134,87134,F7A05B3FECD253C9C578617425D22E9D,13471,7,16,9,47,49,2399
87135,87135,F7A05B3FECD253C9C578617425D22E9D,11701,16,18,2,43,48,2198
87143,87143,EFF270FAB30C179BABF7EC7AD5634449,13314,0,10,10,31,39,1589
87144,87144,EFF270FAB30C179BABF7EC7AD5634449,40341,12,14,2,23,49,1199
87145,87145,EFF270FAB30C179BABF7EC7AD5634449,11074,17,18,1,37,47,1897
87146,87146,EFF270FAB30C179BABF7EC7AD5634449,13314,20,23,3,31,39,1589
87147,87147,6A0394A16431C3763362EDB77E0D6861,42831,0,1,1,27,48,1398
87148,87148,6A0394A16431C3763362EDB77E0D6861,42071,1,16,15,31,49,1599
87149,87149,6A0394A16431C3763362EDB77E0D6861,42831,16,18,2,27,48,1398
87150,87150,6A0394A16431C3763362EDB77E0D6861,42071,18,23,5,31,49,1599
87154,87154,F40CCBE0F53CE8C39AAE5C5C821E8F3D,40691,0,8,8,42,48,2148
87155,87155,F40CCBE0F53CE8C39AAE5C5C821E8F3D,11701,8,10,2,43,48,2198
87156,87156,F40CCBE0F53CE8C39AAE5C5C821E8F3D,10421,12,14,2,41,48,2098
87157,87157,F40CCBE0F53CE8C39AAE5C5C821E8F3D,11701,14,16,2,43,48,2198
87158,87158,F40CCBE0F53CE8C39AAE5C5C821E8F3D,10421,19,21,2,41,48,2098
87159,87159,952D9993D6EC0FC8746CC84C9CE1D71A,42471,0,7,7,35,49,1799
87160,87160,952D9993D6EC0FC8746CC84C9CE1D71A,11531,8,11,3,34,49,1749
87161,87161,952D9993D6EC0FC8746CC84C9CE1D71A,42471,12,14,2,35,49,1799
87162,87162,952D9993D6EC0FC8746CC84C9CE1D71A,11021,16,18,2,36,49,1849
87163,87163,952D9993D6EC0FC8746CC84C9CE1D71A,42471,18,20,2,35,49,1799
87179,87179,1078436CC9F31DFE63B8B6F9AEB69E32,42151,0,9,9,35,45,1795
87180,87180,1078436CC9F31DFE63B8B6F9AEB69E32,12661,13,17,4,32,45,1645
87181,87181,1078436CC9F31DFE63B8B6F9AEB69E32,11861,19,21,2,32,47,1647
87182,87182,1078436CC9F31DFE63B8B6F9AEB69E32,11231,22,23,1,37,49,1899
87187,87187,6F60DF43E72A344D99FCB3944A72DCC7,12601,0,2,2,25,47,1297
87188,87188,6F60DF43E72A344D99FCB3944A72DCC7,10716,3,8,5,30,46,1546
87189,87189,6F60DF43E72A344D99FCB3944A72DCC7,42871,8,9,1,30,45,1545
87190,87190,6F60DF43E72A344D99FCB3944A72DCC7,10716,10,13,3,30,46,1546
87191,87191,6F60DF43E72A344D99FCB3944A72DCC7,42871,14,16,2,30,45,1545
87192,87192,6F60DF43E72A344D99FCB3944A72DCC7,10716,17,20,3,30,46,1546
87193,87193,09757EDFE7795D1E67DCE5C4439A4727,12521,0,8,8,35,41,1791
87194,87194,09757EDFE7795D1E67DCE5C4439A4727,13314,8,11,3,31,39,1589
87195,87195,09757EDFE7795D1E67DCE5C4439A4727,12521,11,23,12,35,41,1791
87210,87210,B951230F2D8FB21FF5FBA5B70040A128,11151,0,7,7,30,48,1548
87211,87211,B951230F2D8FB21FF5FBA5B70040A128,11061,9,12,3,29,48,1498
87212,87212,B951230F2D8FB21FF5FBA5B70040A128,11021,16,17,1,36,49,1849
87213,87213,B951230F2D8FB21FF5FBA5B70040A128,10681,18,20,2,30,48,1548
87214,87214,58FF60972C1637520443DC5766A2AB67,13411,2,6,4,49,42,2492
87215,87215,58FF60972C1637520443DC5766A2AB67,43951,6,15,9,49,41,2491
87216,87216,58FF60972C1637520443DC5766A2AB67,12561,16,17,1,45,43,2293
87217,87217,58FF60972C1637520443DC5766A2AB67,13411,18,23,5,49,42,2492
87218,87218,77BEC10366F22E18FB464DE5972EB0EA,11061,2,8,6,29,48,1498
87219,87219,77BEC10366F22E18FB464DE5972EB0EA,11381,8,13,5,30,47,1547
87220,87220,77BEC10366F22E18FB464DE5972EB0EA,42071,13,15,2,31,49,1599
87221,87221,77BEC10366F22E18FB464DE5972EB0EA,42623,16,17,1,22,49,1149
87222,87222,77BEC10366F22E18FB464DE5972EB0EA,42071,18,23,5,31,49,1599
87223,87223,91EE37A1CABDA06BD50E1ABAFF82181C,12651,1,10,9,43,47,2197
87224,87224,91EE37A1CABDA06BD50E1ABAFF82181C,10901,12,13,1,35,48,1798
87225,87225,91EE37A1CABDA06BD50E1ABAFF82181C,13561,13,15,2,37,49,1899
87226,87226,91EE37A1CABDA06BD50E1ABAFF82181C,11021,18,21,3,36,49,1849
87234,87234,8E1DB9D4ECEC1F108A151A8D21BA1A04,42231,0,8,8,37,46,1896
87235,87235,8E1DB9D4ECEC1F108A151A8D21BA1A04,13911,8,10,2,39,46,1996
87236,87236,8E1DB9D4ECEC1F108A151A8D21BA1A04,42231,11,12,1,37,46,1896
87237,87237,8E1DB9D4ECEC1F108A151A8D21BA1A04,13911,14,15,1,39,46,1996
87238,87238,8E1DB9D4ECEC1F108A151A8D21BA1A04,42231,16,22,6,37,46,1896
87239,87239,914FCCE81925BD3B7C09A01C1E108BA6,42461,1,12,11,45,47,2297
87240,87240,914FCCE81925BD3B7C09A01C1E108BA6,43621,12,15,3,46,48,2348
87241,87241,914FCCE81925BD3B7C09A01C1E108BA6,42621,16,17,1,24,49,1249
87242,87242,914FCCE81925BD3B7C09A01C1E108BA6,42091,19,21,2,43,46,2196
87243,87243,BD23ED11EB2BC3C1B45585381285E047,11061,0,5,5,29,48,1498
87244,87244,BD23ED11EB2BC3C1B45585381285E047,43451,7,8,1,37,40,1890
87245,87245,BD23ED11EB2BC3C1B45585381285E047,11061,12,13,1,29,48,1498
87246,87246,BD23ED11EB2BC3C1B45585381285E047,43501,13,15,2,27,48,1398
87247,87247,BD23ED11EB2BC3C1B45585381285E047,11571,18,20,2,13,46,696
87248,87248,22E0CD429C1B1E7AC6170F90C318BE33,19031,0,7,7,1,42,92
87249,87249,22E0CD429C1B1E7AC6170F90C318BE33,12641,7,20,13,10,43,543
87250,87250,22E0CD429C1B1E7AC6170F90C318BE33,19114,21,23,2,7,43,393
87257,87257,04ED2C698002ED049877B001216EC992,42971,0,13,13,43,49,2199
87258,87258,04ED2C698002ED049877B001216EC992,10471,14,18,4,37,48,1898
87259,87259,04ED2C698002ED049877B001216EC992,42971,19,23,4,43,49,2199
87260,87260,214B9A514ECE2B2C8A8458625A9B5245,10601,0,2,2,39,47,1997
87261,87261,214B9A514ECE2B2C8A8458625A9B5245,10821,3,11,8,40,47,2047
87262,87262,214B9A514ECE2B2C8A8458625A9B5245,11631,14,15,1,12,49,649
87263,87263,214B9A514ECE2B2C8A8458625A9B5245,42031,18,23,5,40,46,2046
87264,87264,28AE6FF44E8686DC354D2E3DF7700FCC,42461,0,6,6,45,47,2297
87265,87265,28AE6FF44E8686DC354D2E3DF7700FCC,42321,7,10,3,43,47,2197
87266,87266,28AE6FF44E8686DC354D2E3DF7700FCC,42461,10,13,3,45,47,2297
87267,87267,28AE6FF44E8686DC354D2E3DF7700FCC,42321,13,17,4,43,47,2197
87268,87268,28AE6FF44E8686DC354D2E3DF7700FCC,43621,18,21,3,46,48,2348
87269,87269,28AE6FF44E8686DC354D2E3DF7700FCC,42461,21,23,2,45,47,2297
87270,87270,D21AD56E1413F233CB19B53125C6F06A,12971,0,1,1,32,48,1648
87271,87271,D21AD56E1413F233CB19B53125C6F06A,42471,3,15,12,35,49,1799
87272,87272,D21AD56E1413F233CB19B53125C6F06A,11591,18,19,1,36,49,1849
87280,87280,752B63C7D21B67B5424373111388C3C6,13711,0,1,1,38,46,1946
87281,87281,752B63C7D21B67B5424373111388C3C6,11941,1,5,4,37,46,1896
87282,87282,752B63C7D21B67B5424373111388C3C6,13711,8,12,4,38,46,1946
87283,87283,752B63C7D21B67B5424373111388C3C6,10107,13,14,1,38,49,1949
87284,87284,752B63C7D21B67B5424373111388C3C6,10841,15,18,3,37,47,1897
87288,87288,CC0D30B226024F1F29D1C2ECB6081AFF,10191,0,9,9,40,48,2048
87289,87289,CC0D30B226024F1F29D1C2ECB6081AFF,10721,12,13,1,31,48,1598
87290,87290,CC0D30B226024F1F29D1C2ECB6081AFF,42583,16,23,7,40,48,2048
87294,87294,A5BFF32240AF511BF31ADB547FFA4DAD,11151,8,10,2,30,48,1548
87295,87295,A5BFF32240AF511BF31ADB547FFA4DAD,11491,13,15,2,36,47,1847
87296,87296,A5BFF32240AF511BF31ADB547FFA4DAD,12311,17,18,1,30,44,1544
87297,87297,A5BFF32240AF511BF31ADB547FFA4DAD,42301,20,22,2,36,47,1847
87298,87298,4FA7E2AF35091649A8D61648BF92F5C0,42581,0,7,7,38,48,1948
87299,87299,4FA7E2AF35091649A8D61648BF92F5C0,10471,8,11,3,37,48,1898
87300,87300,4FA7E2AF35091649A8D61648BF92F5C0,42581,12,15,3,38,48,1948
87301,87301,4FA7E2AF35091649A8D61648BF92F5C0,10471,18,19,1,37,48,1898
87302,87302,4FA7E2AF35091649A8D61648BF92F5C0,42581,21,23,2,38,48,1948
87309,87309,D51B70E2460C3867B9599EFF4688B6B4,10841,0,9,9,37,47,1897
87310,87310,D51B70E2460C3867B9599EFF4688B6B4,11481,9,10,1,41,48,2098
87311,87311,D51B70E2460C3867B9599EFF4688B6B4,10841,11,14,3,37,47,1897
87312,87312,D51B70E2460C3867B9599EFF4688B6B4,10251,19,21,2,35,47,1797
87313,87313,D51B70E2460C3867B9599EFF4688B6B4,41027,21,23,2,38,47,1947
87314,87314,E6AB07C9B4BB739382103AE9E98B473D,43311,0,6,6,31,48,1598
87315,87315,E6AB07C9B4BB739382103AE9E98B473D,10681,7,9,2,30,48,1548
87316,87316,E6AB07C9B4BB739382103AE9E98B473D,43311,11,13,2,31,48,1598
87317,87317,E6AB07C9B4BB739382103AE9E98B473D,10681,14,15,1,30,48,1548
87318,87318,E6AB07C9B4BB739382103AE9E98B473D,11061,17,18,1,29,48,1498
87319,87319,E6AB07C9B4BB739382103AE9E98B473D,43311,19,23,4,31,48,1598
87324,87324,99ABF293A45A6D4D0D6074565A60DF8B,42071,0,1,1,31,49,1599
87325,87325,99ABF293A45A6D4D0D6074565A60DF8B,10544,2,3,1,28,48,1448
87326,87326,99ABF293A45A6D4D0D6074565A60DF8B,42071,4,16,12,31,49,1599
87327,87327,99ABF293A45A6D4D0D6074565A60DF8B,11061,18,19,1,29,48,1498
87328,87328,99ABF293A45A6D4D0D6074565A60DF8B,42071,20,23,3,31,49,1599
87335,87335,E290A26C7D4416C955AC8C063CBB1C21,42161,0,9,9,36,47,1847
87336,87336,E290A26C7D4416C955AC8C063CBB1C21,10211,9,12,3,16,49,849
87337,87337,E290A26C7D4416C955AC8C063CBB1C21,12391,14,21,7,36,49,1849
87338,87338,209CBAFCECFCFAF5ADEC7A13A8F80FC5,19114,5,7,2,7,43,393
87339,87339,209CBAFCECFCFAF5ADEC7A13A8F80FC5,19901,10,13,3,7,44,394
87340,87340,209CBAFCECFCFAF5ADEC7A13A8F80FC5,11331,15,17,2,37,48,1898
87341,87341,209CBAFCECFCFAF5ADEC7A13A8F80FC5,12401,18,19,1,39,49,1999
87342,87342,209CBAFCECFCFAF5ADEC7A13A8F80FC5,10191,21,22,1,40,48,2048
87356,87356,822752BBEE42503618273E785748F226,12514,2,6,4,38,47,1947
87357,87357,822752BBEE42503618273E785748F226,41621,10,11,1,38,49,1949
87358,87358,822752BBEE42503618273E785748F226,43471,16,18,2,31,49,1599
87359,87359,822752BBEE42503618273E785748F226,11921,20,22,2,38,48,1948
87364,87364,1C28F39B6E92104A5F767DF1DD64A4C7,40302,0,1,1,40,49,2049
87365,87365,1C28F39B6E92104A5F767DF1DD64A4C7,13511,2,20,18,34,48,1748
87366,87366,1C28F39B6E92104A5F767DF1DD64A4C7,40951,21,22,1,36,49,1849
87367,87367,BC73F6184F0E0B277714E7A26253C025,10711,0,14,14,29,46,1496
87368,87368,BC73F6184F0E0B277714E7A26253C025,10471,16,18,2,37,48,1898
87369,87369,BC73F6184F0E0B277714E7A26253C025,11481,18,21,3,41,48,2098
87370,87370,A53D76C44A71267FF477911E38598EC8,11161,3,10,7,32,48,1648
87371,87371,A53D76C44A71267FF477911E38598EC8,42381,10,12,2,39,41,1991
87372,87372,A53D76C44A71267FF477911E38598EC8,16016,15,16,1,4,5,205
87373,87373,A53D76C44A71267FF477911E38598EC8,10611,17,19,2,32,48,1648
87374,87374,A53D76C44A71267FF477911E38598EC8,10341,19,20,1,31,47,1597
87375,87375,A53D76C44A71267FF477911E38598EC8,42071,22,23,1,31,49,1599
87376,87376,EA2198FE9E005CD880F504BDC91F0354,10811,0,12,12,38,46,1946
87377,87377,EA2198FE9E005CD880F504BDC91F0354,11701,14,17,3,43,48,2198
87378,87378,EA2198FE9E005CD880F504BDC91F0354,10811,18,21,3,38,46,1946
87383,87383,3F7C450D7F9680D27C99C429CD433354,42151,4,5,1,35,45,1795
87384,87384,3F7C450D7F9680D27C99C429CD433354,13671,9,13,4,27,43,1393
87385,87385,3F7C450D7F9680D27C99C429CD433354,12311,13,19,6,30,44,1544
87386,87386,3F7C450D7F9680D27C99C429CD433354,13671,21,23,2,27,43,1393
87394,87394,466786D54A3236A0CA1395E1CA33DFC4,11381,0,9,9,30,47,1547
87395,87395,466786D54A3236A0CA1395E1CA33DFC4,42621,14,15,1,24,49,1249
87396,87396,466786D54A3236A0CA1395E1CA33DFC4,11381,20,23,3,30,47,1547
87397,87397,4507A6AA40E86D001FA56149FC45CD13,12921,9,11,2,9,41,491
87398,87398,4507A6AA40E86D001FA56149FC45CD13,19181,14,18,4,8,40,440
87399,87399,4507A6AA40E86D001FA56149FC45CD13,19741,20,23,3,5,44,294
87403,87403,F391FEFA9432A9926CD3EC0CCD01F66E,10491,0,8,8,33,48,1698
87404,87404,F391FEFA9432A9926CD3EC0CCD01F66E,43391,8,10,2,29,48,1498
87405,87405,F391FEFA9432A9926CD3EC0CCD01F66E,10491,13,14,1,33,48,1698
87406,87406,F391FEFA9432A9926CD3EC0CCD01F66E,42623,18,19,1,22,49,1149
87410,87410,4B5119258FB3482B746B53277561992F,12051,2,3,1,20,47,1047
87411,87411,4B5119258FB3482B746B53277561992F,12581,4,5,1,24,48,1248
87412,87412,4B5119258FB3482B746B53277561992F,12051,6,7,1,20,47,1047
87413,87413,4B5119258FB3482B746B53277561992F,12601,12,18,6,25,47,1297
87414,87414,4B5119258FB3482B746B53277561992F,12051,18,22,4,20,47,1047
87418,87418,CDBBC82AE29F75B6F0235982341C058F,13651,0,16,16,30,47,1547
87419,87419,CDBBC82AE29F75B6F0235982341C058F,43671,17,20,3,35,48,1798
87420,87420,CDBBC82AE29F75B6F0235982341C058F,13651,21,23,2,30,47,1547
87421,87421,6F589A063749366C77ACB2AC9D392360,40445,0,1,1,30,48,1548
87422,87422,6F589A063749366C77ACB2AC9D392360,42521,6,7,1,31,47,1597
87423,87423,6F589A063749366C77ACB2AC9D392360,11331,11,13,2,37,48,1898
87424,87424,6F589A063749366C77ACB2AC9D392360,13731,14,18,4,33,49,1699
87425,87425,6F589A063749366C77ACB2AC9D392360,40445,20,23,3,30,48,1548
87433,87433,AA541C733BB5F99408992FE5EC11F72D,13461,0,4,4,39,44,1994
87434,87434,AA541C733BB5F99408992FE5EC11F72D,13071,5,7,2,41,41,2091
87435,87435,AA541C733BB5F99408992FE5EC11F72D,43011,8,9,1,40,42,2042
87436,87436,AA541C733BB5F99408992FE5EC11F72D,42861,10,17,7,37,44,1894
87437,87437,AA541C733BB5F99408992FE5EC11F72D,11261,20,21,1,36,46,1846
87438,87438,787E2D15898542A785C91CF72E674285,42351,0,1,1,38,45,1945
87439,87439,787E2D15898542A785C91CF72E674285,13911,3,6,3,39,46,1996
87440,87440,787E2D15898542A785C91CF72E674285,11261,6,8,2,36,46,1846
87441,87441,787E2D15898542A785C91CF72E674285,42351,10,11,1,38,45,1945
87442,87442,787E2D15898542A785C91CF72E674285,11261,13,14,1,36,46,1846
87443,87443,787E2D15898542A785C91CF72E674285,42351,14,17,3,38,45,1945
87444,87444,787E2D15898542A785C91CF72E674285,42231,19,21,2,37,46,1896
87445,87445,63D46256AD6F86C8491C2B2581A93893,11291,0,14,14,40,49,2049
87446,87446,63D46256AD6F86C8491C2B2581A93893,11901,15,16,1,42,49,2149
87447,87447,63D46256AD6F86C8491C2B2581A93893,13711,19,20,1,38,46,1946
87448,87448,63D46256AD6F86C8491C2B2581A93893,11291,21,23,2,40,49,2049
87455,87455,198F13224A4C889E12ED1D538BD7168E,15391,0,6,6,35,26,1776
87456,87456,198F13224A4C889E12ED1D538BD7168E,12792,6,8,2,34,30,1730
87457,87457,198F13224A4C889E12ED1D538BD7168E,15191,9,10,1,36,27,1827
87458,87458,198F13224A4C889E12ED1D538BD7168E,12792,13,15,2,34,30,1730
87459,87459,198F13224A4C889E12ED1D538BD7168E,15191,15,17,2,36,27,1827
87460,87460,198F13224A4C889E12ED1D538BD7168E,15391,19,23,4,35,26,1776
87461,87461,77EA23FEBF1AF98A4F6293E826F27BD4,42271,2,10,8,40,47,2047
87462,87462,77EA23FEBF1AF98A4F6293E826F27BD4,10911,13,14,1,39,46,1996
87463,87463,77EA23FEBF1AF98A4F6293E826F27BD4,10601,15,19,4,39,47,1997
87464,87464,77EA23FEBF1AF98A4F6293E826F27BD4,11806,20,22,2,41,48,2098
87465,87465,77EA23FEBF1AF98A4F6293E826F27BD4,42271,22,23,1,40,47,2047
87466,87466,256716E7BC700918221B302D675AB769,43311,0,5,5,31,48,1598
87467,87467,256716E7BC700918221B302D675AB769,10401,5,7,2,33,49,1699
87468,87468,256716E7BC700918221B302D675AB769,43311,11,14,3,31,48,1598
87469,87469,256716E7BC700918221B302D675AB769,43761,15,17,2,32,47,1647
87470,87470,256716E7BC700918221B302D675AB769,12381,20,23,3,32,48,1648
87471,87471,5CE4BD076974CDFDBB29CBFC6C974D60,12514,0,14,14,38,47,1947
87472,87472,5CE4BD076974CDFDBB29CBFC6C974D60,11861,15,19,4,32,47,1647
87473,87473,5CE4BD076974CDFDBB29CBFC6C974D60,12514,21,22,1,38,47,1947
87481,87481,F934A070299A0C2535F9C55A84D4AE40,13091,4,7,3,20,42,1042
87482,87482,F934A070299A0C2535F9C55A84D4AE40,19441,9,10,1,8,46,446
87483,87483,F934A070299A0C2535F9C55A84D4AE40,19901,12,16,4,7,44,394
87484,87484,F934A070299A0C2535F9C55A84D4AE40,19441,17,18,1,8,46,446
87485,87485,F934A070299A0C2535F9C55A84D4AE40,19901,20,23,3,7,44,394
87486,87486,5A5517D1B1C399056C5CDDCC747ED230,11491,1,12,11,36,47,1847
87487,87487,5A5517D1B1C399056C5CDDCC747ED230,11861,13,15,2,32,47,1647
87488,87488,5A5517D1B1C399056C5CDDCC747ED230,11491,16,18,2,36,47,1847
87489,87489,5A5517D1B1C399056C5CDDCC747ED230,10491,19,20,1,33,48,1698
87490,87490,5A5517D1B1C399056C5CDDCC747ED230,40271,21,23,2,35,49,1799
87504,87504,68B7F35FF0F720B98D20E32639E524A9,42921,0,15,15,33,47,1697
87505,87505,68B7F35FF0F720B98D20E32639E524A9,42861,19,20,1,37,44,1894
87506,87506,68B7F35FF0F720B98D20E32639E524A9,42021,21,23,2,33,47,1697
87510,87510,502BA7C99D6C789C99C98C286A11AFF4,13951,5,6,1,47,45,2395
87511,87511,502BA7C99D6C789C99C98C286A11AFF4,43051,10,18,8,46,45,2345
87512,87512,502BA7C99D6C789C99C98C286A11AFF4,43011,20,22,2,40,42,2042
87513,87513,BC71A128CC1D1FD204F1FA3A371EA53A,43021,0,6,6,16,43,843
87514,87514,BC71A128CC1D1FD204F1FA3A371EA53A,12921,6,11,5,9,41,491
87515,87515,BC71A128CC1D1FD204F1FA3A371EA53A,43021,12,13,1,16,43,843
87516,87516,BC71A128CC1D1FD204F1FA3A371EA53A,12921,14,19,5,9,41,491
87517,87517,BC71A128CC1D1FD204F1FA3A371EA53A,43021,20,23,3,16,43,843
87525,87525,C4D6F0BF53BD9BD92C93EF2AD0B56F39,11921,1,9,8,38,48,1948
87526,87526,C4D6F0BF53BD9BD92C93EF2AD0B56F39,42864,10,11,1,38,44,1944
87527,87527,C4D6F0BF53BD9BD92C93EF2AD0B56F39,11074,12,13,1,37,47,1897
87528,87528,C4D6F0BF53BD9BD92C93EF2AD0B56F39,11921,13,14,1,38,48,1948
87529,87529,C4D6F0BF53BD9BD92C93EF2AD0B56F39,11074,19,20,1,37,47,1897
87541,87541,099FE0090B4EE7DA6124F36A27A26FB9,13271,0,12,12,41,47,2097
87542,87542,099FE0090B4EE7DA6124F36A27A26FB9,40631,14,15,1,36,48,1848
87543,87543,099FE0090B4EE7DA6124F36A27A26FB9,13271,21,23,2,41,47,2097
87544,87544,9742F15B01F6B20FFF8B06E85DFC863A,42291,0,7,7,29,48,1498
87545,87545,9742F15B01F6B20FFF8B06E85DFC863A,11641,10,12,2,22,49,1149
87546,87546,9742F15B01F6B20FFF8B06E85DFC863A,42621,14,18,4,24,49,1249
87547,87547,9C1ECB944E18DA57B54A0C1F2B7E04B0,42861,4,8,4,37,44,1894
87548,87548,9C1ECB944E18DA57B54A0C1F2B7E04B0,13671,8,10,2,27,43,1393
87549,87549,9C1ECB944E18DA57B54A0C1F2B7E04B0,42861,14,21,7,37,44,1894
87550,87550,B50AB2F8CA3544850F13D4D256795C48,12971,0,10,10,32,48,1648
87551,87551,B50AB2F8CA3544850F13D4D256795C48,40951,13,14,1,36,49,1849
87552,87552,B50AB2F8CA3544850F13D4D256795C48,10431,16,17,1,33,49,1699
87553,87553,B50AB2F8CA3544850F13D4D256795C48,12971,21,23,2,32,48,1648
87554,87554,9A32E318CA0CDE9DA0BCF043EF40ABC3,43234,0,1,1,37,49,1899
87555,87555,9A32E318CA0CDE9DA0BCF043EF40ABC3,11081,2,14,12,35,46,1796
87556,87556,9A32E318CA0CDE9DA0BCF043EF40ABC3,40691,17,18,1,42,48,2148
87557,87557,9A32E318CA0CDE9DA0BCF043EF40ABC3,10511,22,23,1,35,46,1796
87558,87558,C5C866B840AB1E710A19532E1F1DAD43,11201,0,3,3,35,49,1799
87559,87559,C5C866B840AB1E710A19532E1F1DAD43,10341,3,7,4,31,47,1597
87560,87560,C5C866B840AB1E710A19532E1F1DAD43,10295,10,14,4,30,47,1547
87561,87561,C5C866B840AB1E710A19532E1F1DAD43,43181,14,21,7,39,48,1998
87562,87562,C5C866B840AB1E710A19532E1F1DAD43,10341,21,22,1,31,47,1597
87563,87563,B304D2AD98C7DE24CAE6DD0DA65095F0,10431,0,6,6,33,49,1699
87564,87564,B304D2AD98C7DE24CAE6DD0DA65095F0,43581,7,8,1,33,48,1698
87565,87565,B304D2AD98C7DE24CAE6DD0DA65095F0,42491,8,14,6,32,46,1646
87566,87566,B304D2AD98C7DE24CAE6DD0DA65095F0,42141,14,18,4,32,47,1647
87567,87567,B304D2AD98C7DE24CAE6DD0DA65095F0,10431,19,23,4,33,49,1699
87568,87568,28B8EF76314447DF77BE1FDB0E993B92,43581,0,14,14,33,48,1698
87569,87569,28B8EF76314447DF77BE1FDB0E993B92,11701,15,16,1,43,48,2198
87570,87570,28B8EF76314447DF77BE1FDB0E993B92,11531,18,22,4,34,49,1749
87571,87571,476CF509528DDA8C3E341A679B945B9E,10351,6,7,1,28,45,1445
87572,87572,476CF509528DDA8C3E341A679B945B9E,10634,7,10,3,27,45,1395
87573,87573,476CF509528DDA8C3E341A679B945B9E,10351,10,15,5,28,45,1445
87574,87574,476CF509528DDA8C3E341A679B945B9E,10634,15,18,3,27,45,1395
87575,87575,476CF509528DDA8C3E341A679B945B9E,10351,18,20,2,28,45,1445
87583,87583,451B0DF1BCDD4D3D854FAAD1FB153193,42581,0,4,4,38,48,1948
87584,87584,451B0DF1BCDD4D3D854FAAD1FB153193,11914,6,8,2,37,48,1898
87585,87585,451B0DF1BCDD4D3D854FAAD1FB153193,42581,13,14,1,38,48,1948
87586,87586,451B0DF1BCDD4D3D854FAAD1FB153193,11914,15,16,1,37,48,1898
87587,87587,451B0DF1BCDD4D3D854FAAD1FB153193,42581,18,20,2,38,48,1948
87588,87588,EA4346C82B2DB28BABC4E2B816D4C45D,19051,3,4,1,16,23,823
87589,87589,EA4346C82B2DB28BABC4E2B816D4C45D,15121,7,16,9,27,19,1369
87590,87590,EA4346C82B2DB28BABC4E2B816D4C45D,15351,18,20,2,24,22,1222
87603,87603,439D8CB010A4086802C0243322BA6C31,10251,0,9,9,35,47,1797
87604,87604,439D8CB010A4086802C0243322BA6C31,11061,10,16,6,29,48,1498
87605,87605,439D8CB010A4086802C0243322BA6C31,11481,17,20,3,41,48,2098
87606,87606,439D8CB010A4086802C0243322BA6C31,42221,21,23,2,38,48,1948
87623,87623,3C5D029D57650D7A9CE83503042F1003,43041,0,7,7,41,46,2096
87624,87624,3C5D029D57650D7A9CE83503042F1003,42151,8,9,1,35,45,1795
87625,87625,3C5D029D57650D7A9CE83503042F1003,11261,10,23,13,36,46,1846
87629,87629,4F0FAE1A4C157E89DA0B0C6E262D64A5,10351,0,13,13,28,45,1445
87630,87630,4F0FAE1A4C157E89DA0B0C6E262D64A5,12601,15,19,4,25,47,1297
87631,87631,4F0FAE1A4C157E89DA0B0C6E262D64A5,10351,21,23,2,28,45,1445
87632,87632,F4C8F856DD638BBA75F52C720E10C05D,12641,0,14,14,10,43,543
87633,87633,F4C8F856DD638BBA75F52C720E10C05D,43021,17,18,1,16,43,843
87634,87634,F4C8F856DD638BBA75F52C720E10C05D,12921,18,23,5,9,41,491
87639,87639,145E734E186950C5FCF9FF61BBA7968A,12161,1,3,2,32,46,1646
87640,87640,145E734E186950C5FCF9FF61BBA7968A,42371,3,5,2,34,46,1746
87641,87641,145E734E186950C5FCF9FF61BBA7968A,12161,6,9,3,32,46,1646
87642,87642,145E734E186950C5FCF9FF61BBA7968A,10111,10,14,4,37,47,1897
87643,87643,145E734E186950C5FCF9FF61BBA7968A,42401,16,23,7,36,47,1847
87647,87647,66AFBD9C113F67320652DF95B713C893,12221,0,6,6,43,44,2194
87648,87648,66AFBD9C113F67320652DF95B713C893,43011,7,10,3,40,42,2042
87649,87649,66AFBD9C113F67320652DF95B713C893,12221,11,14,3,43,44,2194
87650,87650,66AFBD9C113F67320652DF95B713C893,43011,19,22,3,40,42,2042
87655,87655,FCB3F67711CEBAA3447F5F56A47CDE2C,41031,2,10,8,32,49,1649
87656,87656,FCB3F67711CEBAA3447F5F56A47CDE2C,11021,10,15,5,36,49,1849
87657,87657,FCB3F67711CEBAA3447F5F56A47CDE2C,10841,15,17,2,37,47,1897
87658,87658,FCB3F67711CEBAA3447F5F56A47CDE2C,41031,20,23,3,32,49,1649
87662,87662,48D09EA1E123F030FD71CF37426D4799,42151,2,3,1,35,45,1795
87663,87663,48D09EA1E123F030FD71CF37426D4799,43011,3,4,1,40,42,2042
87664,87664,48D09EA1E123F030FD71CF37426D4799,42151,4,6,2,35,45,1795
87665,87665,48D09EA1E123F030FD71CF37426D4799,43011,6,9,3,40,42,2042
87666,87666,48D09EA1E123F030FD71CF37426D4799,42151,14,19,5,35,45,1795
87667,87667,48D09EA1E123F030FD71CF37426D4799,12211,22,23,1,41,44,2094
87668,87668,3BD30092E78F928C91E4887B7831932C,42281,2,4,2,40,48,2048
87669,87669,3BD30092E78F928C91E4887B7831932C,10111,8,9,1,37,47,1897
87670,87670,3BD30092E78F928C91E4887B7831932C,11331,12,13,1,37,48,1898
87671,87671,3BD30092E78F928C91E4887B7831932C,42161,18,20,2,36,47,1847
87672,87672,3BD30092E78F928C91E4887B7831932C,11331,20,22,2,37,48,1898
87684,87684,4D5D3F015222D9A4A636663FE67FCAD4,42501,0,9,9,28,47,1447
87685,87685,4D5D3F015222D9A4A636663FE67FCAD4,10171,11,13,2,26,47,1347
87686,87686,4D5D3F015222D9A4A636663FE67FCAD4,10401,15,16,1,33,49,1699
87687,87687,4D5D3F015222D9A4A636663FE67FCAD4,41591,18,19,1,34,49,1749
87688,87688,4D5D3F015222D9A4A636663FE67FCAD4,10151,20,22,2,34,47,1747
87689,87689,88D3AECB79C42D19C5311DB0C1B36772,10271,0,6,6,37,46,1896
87690,87690,88D3AECB79C42D19C5311DB0C1B36772,42301,7,8,1,36,47,1847
87691,87691,88D3AECB79C42D19C5311DB0C1B36772,13711,8,9,1,38,46,1946
87692,87692,88D3AECB79C42D19C5311DB0C1B36772,42301,11,15,4,36,47,1847
87693,87693,88D3AECB79C42D19C5311DB0C1B36772,13121,15,17,2,38,46,1946
87694,87694,88D3AECB79C42D19C5311DB0C1B36772,10271,17,18,1,37,46,1896
87704,87704,A0402DF5761F5D0D062E6DE56AF93C04,13111,0,10,10,42,46,2146
87705,87705,A0402DF5761F5D0D062E6DE56AF93C04,12601,12,15,3,25,47,1297
87706,87706,A0402DF5761F5D0D062E6DE56AF93C04,40801,17,20,3,43,46,2196
87710,87710,62CA9C2DB4CCD42E20C60BB9A4960A48,42161,2,3,1,36,47,1847
87711,87711,62CA9C2DB4CCD42E20C60BB9A4960A48,10251,4,17,13,35,47,1797
87712,87712,62CA9C2DB4CCD42E20C60BB9A4960A48,11551,17,19,2,39,49,1999
87716,87716,5BBCD63F1FDBD49661B51EE642BD2472,43311,0,11,11,31,48,1598
87717,87717,5BBCD63F1FDBD49661B51EE642BD2472,19281,13,14,1,16,32,832
87718,87718,5BBCD63F1FDBD49661B51EE642BD2472,12871,14,15,1,22,33,1133
87719,87719,5BBCD63F1FDBD49661B51EE642BD2472,19281,16,20,4,16,32,832
87720,87720,725F4DF1678770995D2853C4CA844B3D,43761,2,11,9,32,47,1647
87721,87721,725F4DF1678770995D2853C4CA844B3D,12311,14,15,1,30,44,1544
87722,87722,725F4DF1678770995D2853C4CA844B3D,10681,18,19,1,30,48,1548
87723,87723,725F4DF1678770995D2853C4CA844B3D,43761,21,23,2,32,47,1647
87724,87724,3717F18D88C40095DBADE8C95C390E6F,42861,0,1,1,37,44,1894
87725,87725,3717F18D88C40095DBADE8C95C390E6F,42151,1,2,1,35,45,1795
87726,87726,3717F18D88C40095DBADE8C95C390E6F,42861,6,7,1,37,44,1894
87727,87727,3717F18D88C40095DBADE8C95C390E6F,42151,8,13,5,35,45,1795
87728,87728,3717F18D88C40095DBADE8C95C390E6F,42861,14,18,4,37,44,1894
87729,87729,3717F18D88C40095DBADE8C95C390E6F,42151,21,23,2,35,45,1795
87733,87733,9397083C419903E30A62F5C06D299D5C,42381,0,6,6,39,41,1991
87734,87734,9397083C419903E30A62F5C06D299D5C,42151,7,9,2,35,45,1795
87735,87735,9397083C419903E30A62F5C06D299D5C,12491,9,11,2,36,43,1843
87736,87736,9397083C419903E30A62F5C06D299D5C,43451,14,17,3,37,40,1890
87737,87737,9397083C419903E30A62F5C06D299D5C,13071,20,22,2,41,41,2091
87745,87745,AAC98D8EB5664A9B5DE56F266CB31991,16281,1,6,5,11,4,554
87746,87746,AAC98D8EB5664A9B5DE56F266CB31991,15143,7,9,2,18,7,907
87747,87747,AAC98D8EB5664A9B5DE56F266CB31991,16281,10,23,13,11,4,554
87748,87748,53243F2B39B3EF334F848C3B71492B67,10151,0,13,13,34,47,1747
87749,87749,53243F2B39B3EF334F848C3B71492B67,40341,14,17,3,23,49,1199
87750,87750,53243F2B39B3EF334F848C3B71492B67,13601,21,23,2,34,47,1747
87751,87751,27040DAA07D6DC64DCD4E5DE780283DD,42071,7,9,2,31,49,1599
87752,87752,27040DAA07D6DC64DCD4E5DE780283DD,42081,9,12,3,24,49,1249
87753,87753,27040DAA07D6DC64DCD4E5DE780283DD,42071,12,22,10,31,49,1599
87754,87754,6E17E209924D93962579B4220EAAAC4C,13551,0,2,2,45,38,2288
87755,87755,6E17E209924D93962579B4220EAAAC4C,13321,2,12,10,41,37,2087
87756,87756,6E17E209924D93962579B4220EAAAC4C,43101,13,16,3,46,40,2340
87757,87757,6E17E209924D93962579B4220EAAAC4C,13321,19,22,3,41,37,2087
87758,87758,6CC24D921FE70D79D98FA5B7890BCB55,11471,0,1,1,12,48,648
87759,87759,6CC24D921FE70D79D98FA5B7890BCB55,42041,2,3,1,10,47,547
87760,87760,6CC24D921FE70D79D98FA5B7890BCB55,19441,5,14,9,8,46,446
87761,87761,6CC24D921FE70D79D98FA5B7890BCB55,42041,15,16,1,10,47,547
87762,87762,6CC24D921FE70D79D98FA5B7890BCB55,19441,19,22,3,8,46,446
87763,87763,AAED9BE930876CCFBFDFA351B63D61EF,13741,0,1,1,37,49,1899
87764,87764,AAED9BE930876CCFBFDFA351B63D61EF,13951,9,10,1,47,45,2395
87765,87765,AAED9BE930876CCFBFDFA351B63D61EF,10191,19,21,2,40,48,2048
87769,87769,4BEB96C1A6F8B99181CDADEF48D75275,42501,0,5,5,28,47,1447
87770,87770,4BEB96C1A6F8B99181CDADEF48D75275,42081,7,18,11,24,49,1249
87771,87771,4BEB96C1A6F8B99181CDADEF48D75275,42501,20,23,3,28,47,1447
87772,87772,92C829C196D69D1F6785C73B9B016B15,11875,0,6,6,30,46,1546
87773,87773,92C829C196D69D1F6785C73B9B016B15,12661,8,10,2,32,45,1645
87774,87774,92C829C196D69D1F6785C73B9B016B15,11875,12,13,1,30,46,1546
87775,87775,92C829C196D69D1F6785C73B9B016B15,12311,15,18,3,30,44,1544
87776,87776,92C829C196D69D1F6785C73B9B016B15,11875,18,20,2,30,46,1546
87777,87777,D75839547F19BC6AA2555211CD306BBE,12514,0,5,5,38,47,1947
87778,87778,D75839547F19BC6AA2555211CD306BBE,42161,7,10,3,36,47,1847
87779,87779,D75839547F19BC6AA2555211CD306BBE,12511,11,13,2,39,47,1997
87780,87780,D75839547F19BC6AA2555211CD306BBE,11074,14,16,2,37,47,1897
87781,87781,D75839547F19BC6AA2555211CD306BBE,12514,16,23,7,38,47,1947
87782,87782,5767DCB7927C2A22DA225038742C1BCE,13561,2,7,5,37,49,1899
87783,87783,5767DCB7927C2A22DA225038742C1BCE,11021,10,11,1,36,49,1849
87784,87784,5767DCB7927C2A22DA225038742C1BCE,13561,12,13,1,37,49,1899
87785,87785,5767DCB7927C2A22DA225038742C1BCE,11021,13,19,6,36,49,1849
87786,87786,5767DCB7927C2A22DA225038742C1BCE,13561,19,21,2,37,49,1899
87787,87787,46624C7A7A05E81084BABC40FE8F937C,13314,0,13,13,31,39,1589
87788,87788,46624C7A7A05E81084BABC40FE8F937C,12521,13,16,3,35,41,1791
87789,87789,46624C7A7A05E81084BABC40FE8F937C,13314,18,23,5,31,39,1589
87790,87790,D860CA24E1A21370A62EA410F7DE5B45,10491,0,6,6,33,48,1698
87791,87791,D860CA24E1A21370A62EA410F7DE5B45,11061,7,8,1,29,48,1498
87792,87792,D860CA24E1A21370A62EA410F7DE5B45,10491,12,14,2,33,48,1698
87793,87793,D860CA24E1A21370A62EA410F7DE5B45,11061,14,17,3,29,48,1498
87794,87794,D860CA24E1A21370A62EA410F7DE5B45,10491,19,23,4,33,48,1698
87801,87801,CE2F05770EAE7211AF1856B90409D64B,12514,0,1,1,38,47,1947
87802,87802,CE2F05770EAE7211AF1856B90409D64B,42221,4,10,6,38,48,1948
87803,87803,CE2F05770EAE7211AF1856B90409D64B,11074,11,13,2,37,47,1897
87804,87804,CE2F05770EAE7211AF1856B90409D64B,42221,13,17,4,38,48,1948
87805,87805,CE2F05770EAE7211AF1856B90409D64B,11074,17,21,4,37,47,1897
87806,87806,4A1082E29116D07A4EA830C32D0BE5ED,12221,0,1,1,43,44,2194
87807,87807,4A1082E29116D07A4EA830C32D0BE5ED,12211,2,4,2,41,44,2094
87808,87808,4A1082E29116D07A4EA830C32D0BE5ED,13341,8,9,1,44,45,2245
87809,87809,4A1082E29116D07A4EA830C32D0BE5ED,12221,12,15,3,43,44,2194
87810,87810,4A1082E29116D07A4EA830C32D0BE5ED,13341,15,16,1,44,45,2245
87811,87811,4A1082E29116D07A4EA830C32D0BE5ED,12221,21,22,1,43,44,2194
87815,87815,B768DBD477008511AD969C6F4C6366B9,13711,0,6,6,38,46,1946
87816,87816,B768DBD477008511AD969C6F4C6366B9,13371,7,8,1,41,47,2097
87817,87817,B768DBD477008511AD969C6F4C6366B9,42231,9,12,3,37,46,1896
87818,87818,B768DBD477008511AD969C6F4C6366B9,10601,13,15,2,39,47,1997
87819,87819,B768DBD477008511AD969C6F4C6366B9,10911,16,18,2,39,46,1996
87827,87827,51E47FDE51716EB36BE96125516194AB,11021,1,10,9,36,49,1849
87828,87828,51E47FDE51716EB36BE96125516194AB,40697,12,14,2,43,48,2198
87829,87829,51E47FDE51716EB36BE96125516194AB,10651,14,16,2,36,49,1849
87830,87830,51E47FDE51716EB36BE96125516194AB,40697,17,20,3,43,48,2198
87831,87831,51E47FDE51716EB36BE96125516194AB,11021,21,23,2,36,49,1849
87832,87832,1522BDE7E05C3ADAA9D8391F632D7715,12051,0,4,4,20,47,1047
87833,87833,1522BDE7E05C3ADAA9D8391F632D7715,12581,7,8,1,24,48,1248
87834,87834,1522BDE7E05C3ADAA9D8391F632D7715,11361,12,20,8,22,48,1148
87835,87835,91775955B3BB3F8B2A1BBBCDF1B34DD8,11811,0,6,6,38,49,1949
87836,87836,91775955B3BB3F8B2A1BBBCDF1B34DD8,42523,8,11,3,31,47,1597
87837,87837,91775955B3BB3F8B2A1BBBCDF1B34DD8,13651,11,14,3,30,47,1547
87838,87838,91775955B3BB3F8B2A1BBBCDF1B34DD8,42523,14,16,2,31,47,1597
87839,87839,91775955B3BB3F8B2A1BBBCDF1B34DD8,11811,18,23,5,38,49,1949
87847,87847,181802B57A29F4FAE1E7EF60B334A9D5,13911,0,5,5,39,46,1996
87848,87848,181802B57A29F4FAE1E7EF60B334A9D5,11261,6,7,1,36,46,1846
87849,87849,181802B57A29F4FAE1E7EF60B334A9D5,13911,7,11,4,39,46,1996
87850,87850,181802B57A29F4FAE1E7EF60B334A9D5,11261,12,18,6,36,46,1846
87851,87851,181802B57A29F4FAE1E7EF60B334A9D5,13911,20,21,1,39,46,1996
87852,87852,7BC04BFCDFBB58A8AA12009BA0ED2780,40801,1,13,12,43,46,2196
87853,87853,7BC04BFCDFBB58A8AA12009BA0ED2780,10431,15,16,1,33,49,1699
87854,87854,7BC04BFCDFBB58A8AA12009BA0ED2780,11531,18,19,1,34,49,1749
87855,87855,7BC04BFCDFBB58A8AA12009BA0ED2780,40801,21,23,2,43,46,2196
87860,87860,2317EEF942E511029895E416C1875CE5,43181,0,1,1,39,48,1998
87861,87861,2317EEF942E511029895E416C1875CE5,10661,3,7,4,37,49,1899
87862,87862,2317EEF942E511029895E416C1875CE5,42511,11,12,1,37,47,1897
87863,87863,2317EEF942E511029895E416C1875CE5,10281,15,17,2,33,48,1698
87864,87864,2317EEF942E511029895E416C1875CE5,12621,19,21,2,10,48,548
87865,87865,2317EEF942E511029895E416C1875CE5,10281,22,23,1,33,48,1698
87866,87866,33DCEB99733F5490EC3E4641096F98E9,10601,3,7,4,39,47,1997
87867,87867,33DCEB99733F5490EC3E4641096F98E9,42861,10,12,2,37,44,1894
87868,87868,33DCEB99733F5490EC3E4641096F98E9,11261,12,14,2,36,46,1846
87869,87869,33DCEB99733F5490EC3E4641096F98E9,42861,15,18,3,37,44,1894
87870,87870,33DCEB99733F5490EC3E4641096F98E9,13941,21,22,1,41,47,2097
87875,87875,4034674068B3C97F9C5DD807E7BD5A8D,42121,0,1,1,26,49,1349
87876,87876,4034674068B3C97F9C5DD807E7BD5A8D,10381,2,5,3,31,49,1599
87877,87877,4034674068B3C97F9C5DD807E7BD5A8D,42121,9,22,13,26,49,1349
87878,87878,BF3354E7653978B437BDBF5412A04932,12871,0,6,6,22,33,1133
87879,87879,BF3354E7653978B437BDBF5412A04932,19281,9,11,2,16,32,832
87880,87880,BF3354E7653978B437BDBF5412A04932,12871,12,14,2,22,33,1133
87881,87881,BF3354E7653978B437BDBF5412A04932,19281,17,20,3,16,32,832
87882,87882,BF3354E7653978B437BDBF5412A04932,12871,21,23,2,22,33,1133
87895,87895,DAF070E37522449552E837969D087804,10491,0,6,6,33,48,1698
87896,87896,DAF070E37522449552E837969D087804,11231,6,10,4,37,49,1899
87897,87897,DAF070E37522449552E837969D087804,10491,11,13,2,33,48,1698
87898,87898,DAF070E37522449552E837969D087804,11231,14,19,5,37,49,1899
87899,87899,DAF070E37522449552E837969D087804,11171,21,23,2,33,48,1698
87903,87903,3AE9C3B6C0E6A8AA6B3B6C58033F1358,13941,0,6,6,41,47,2097
87904,87904,3AE9C3B6C0E6A8AA6B3B6C58033F1358,42981,7,18,11,36,49,1849
87905,87905,3AE9C3B6C0E6A8AA6B3B6C58033F1358,13941,19,23,4,41,47,2097
87906,87906,C7DA09D84BB6D5A3ABEAD976C8C0731E,42861,0,5,5,37,44,1894
87907,87907,C7DA09D84BB6D5A3ABEAD976C8C0731E,11261,6,8,2,36,46,1846
87908,87908,C7DA09D84BB6D5A3ABEAD976C8C0731E,42861,11,13,2,37,44,1894
87909,87909,C7DA09D84BB6D5A3ABEAD976C8C0731E,11261,14,17,3,36,46,1846
87910,87910,C7DA09D84BB6D5A3ABEAD976C8C0731E,42861,18,23,5,37,44,1894
87911,87911,ACE6CA8B487669BE8A7949AA7EA2747D,10107,0,2,2,38,49,1949
87912,87912,ACE6CA8B487669BE8A7949AA7EA2747D,12381,4,12,8,32,48,1648
87913,87913,ACE6CA8B487669BE8A7949AA7EA2747D,10191,14,16,2,40,48,2048
87914,87914,ACE6CA8B487669BE8A7949AA7EA2747D,10911,16,22,6,39,46,1996
87915,87915,312B05864E66D5067B631DCC2B756133,16071,0,13,13,3,3,153
87916,87916,312B05864E66D5067B631DCC2B756133,42351,13,14,1,38,45,1945
87917,87917,312B05864E66D5067B631DCC2B756133,10661,14,17,3,37,49,1899
87918,87918,312B05864E66D5067B631DCC2B756133,12083,17,18,1,36,49,1849
87919,87919,312B05864E66D5067B631DCC2B756133,16041,21,22,1,1,5,55
87927,87927,CFB955845BE47E8DF9B61EDC1A8940E9,13911,0,6,6,39,46,1996
87928,87928,CFB955845BE47E8DF9B61EDC1A8940E9,12311,6,15,9,30,44,1544
87929,87929,CFB955845BE47E8DF9B61EDC1A8940E9,13231,20,22,2,39,46,1996
87940,87940,C2A50BE7B064AAEC27D9E1859F234BD0,40051,0,9,9,32,49,1649
87941,87941,C2A50BE7B064AAEC27D9E1859F234BD0,13041,13,14,1,30,37,1537
87942,87942,C2A50BE7B064AAEC27D9E1859F234BD0,10251,18,19,1,35,47,1797
87943,87943,C2A50BE7B064AAEC27D9E1859F234BD0,40051,21,23,2,32,49,1649
87951,87951,4939079DBC41D72C03B48C02C72AD37E,43021,0,6,6,16,43,843
87952,87952,4939079DBC41D72C03B48C02C72AD37E,12921,10,12,2,9,41,491
87953,87953,4939079DBC41D72C03B48C02C72AD37E,43021,14,18,4,16,43,843
87954,87954,6B4FAB397217C25457DFB4FC930EC14C,13314,0,14,14,31,39,1589
87955,87955,6B4FAB397217C25457DFB4FC930EC14C,12021,18,19,1,37,49,1899
87956,87956,6B4FAB397217C25457DFB4FC930EC14C,13314,20,23,3,31,39,1589
87964,87964,57068447BEEE4D7969FF166D57966ECA,42541,0,6,6,25,47,1297
87965,87965,57068447BEEE4D7969FF166D57966ECA,11361,6,9,3,22,48,1148
87966,87966,57068447BEEE4D7969FF166D57966ECA,12581,9,11,2,24,48,1248
87967,87967,57068447BEEE4D7969FF166D57966ECA,11361,13,18,5,22,48,1148
87968,87968,57068447BEEE4D7969FF166D57966ECA,10171,19,20,1,26,47,1347
87969,87969,57068447BEEE4D7969FF166D57966ECA,42541,21,23,2,25,47,1297
87970,87970,E475335B4A73FACCC2CE9CF4C6AFC402,11331,0,14,14,37,48,1898
87971,87971,E475335B4A73FACCC2CE9CF4C6AFC402,13731,14,16,2,33,49,1699
87972,87972,E475335B4A73FACCC2CE9CF4C6AFC402,40445,19,21,2,30,48,1548
87973,87973,DBE56CF804EFF98F06EBBF480586FC01,43021,1,6,5,16,43,843
87974,87974,DBE56CF804EFF98F06EBBF480586FC01,12921,6,10,4,9,41,491
87975,87975,DBE56CF804EFF98F06EBBF480586FC01,43021,13,23,10,16,43,843
87980,87980,E1C859FD8CC74565ED07635B54DBAB6A,43761,2,3,1,32,47,1647
87981,87981,E1C859FD8CC74565ED07635B54DBAB6A,11061,7,11,4,29,48,1498
87982,87982,E1C859FD8CC74565ED07635B54DBAB6A,16211,15,16,1,4,3,203
87983,87983,E1C859FD8CC74565ED07635B54DBAB6A,16261,18,23,5,3,3,153
87988,87988,5BF2E48B25609217F8588AE451592E57,11431,0,6,6,29,47,1497
87989,87989,5BF2E48B25609217F8588AE451592E57,12584,11,13,2,24,48,1248
87990,87990,5BF2E48B25609217F8588AE451592E57,11381,14,21,7,30,47,1547
87997,87997,50654F68D94497D10A1C2B9ADDEB1DF4,12381,0,9,9,32,48,1648
87998,87998,50654F68D94497D10A1C2B9ADDEB1DF4,15651,10,11,1,39,25,1975
87999,87999,50654F68D94497D10A1C2B9ADDEB1DF4,12381,15,19,4,32,48,1648
88000,88000,5CE5B38C43463AB4DE2D4D106DC3D232,13111,0,1,1,42,46,2146
88001,88001,5CE5B38C43463AB4DE2D4D106DC3D232,13791,2,4,2,42,47,2147
88002,88002,5CE5B38C43463AB4DE2D4D106DC3D232,13111,5,6,1,42,46,2146
88003,88003,5CE5B38C43463AB4DE2D4D106DC3D232,13791,6,8,2,42,47,2147
88004,88004,5CE5B38C43463AB4DE2D4D106DC3D232,13111,9,23,14,42,46,2146
88005,88005,55533B9612A041F560AB09E0A0C2A735,10251,0,8,8,35,47,1797
88006,88006,55533B9612A041F560AB09E0A0C2A735,43731,9,10,1,34,47,1747
88007,88007,55533B9612A041F560AB09E0A0C2A735,40611,12,13,1,35,47,1797
88008,88008,55533B9612A041F560AB09E0A0C2A735,13601,15,17,2,34,47,1747
88009,88009,55533B9612A041F560AB09E0A0C2A735,10251,21,23,2,35,47,1797
88010,88010,367CBFCF66D6125F104F45942894497E,16441,1,6,5,15,17,767
88011,88011,367CBFCF66D6125F104F45942894497E,15114,6,9,3,22,16,1116
88012,88012,367CBFCF66D6125F104F45942894497E,16441,12,21,9,15,17,767
88023,88023,C5AC3744EA191771220A3FE471A7FACC,42161,0,7,7,36,47,1847
88024,88024,C5AC3744EA191771220A3FE471A7FACC,19024,8,17,9,9,45,495
88025,88025,C5AC3744EA191771220A3FE471A7FACC,10661,18,21,3,37,49,1899
88026,88026,C5AC3744EA191771220A3FE471A7FACC,42771,22,23,1,36,47,1847
88030,88030,8A8A9D1DCF5CE4C5E06E6D3FC9C4B051,10801,0,13,13,42,47,2147
88031,88031,8A8A9D1DCF5CE4C5E06E6D3FC9C4B051,13121,13,14,1,38,46,1946
88032,88032,8A8A9D1DCF5CE4C5E06E6D3FC9C4B051,42941,15,18,3,37,47,1897
88033,88033,8A8A9D1DCF5CE4C5E06E6D3FC9C4B051,13111,18,22,4,42,46,2146
88034,88034,8B162D826614AE6B0D3DB5A304485836,42581,0,7,7,38,48,1948
88035,88035,8B162D826614AE6B0D3DB5A304485836,11914,8,10,2,37,48,1898
88036,88036,8B162D826614AE6B0D3DB5A304485836,12511,13,16,3,39,47,1997
88037,88037,8B162D826614AE6B0D3DB5A304485836,10841,18,19,1,37,47,1897
88038,88038,8B162D826614AE6B0D3DB5A304485836,11914,20,23,3,37,48,1898
88039,88039,6561B276C0FDB6B75611B4B54FEC9B8F,10154,0,11,11,33,47,1697
88040,88040,6561B276C0FDB6B75611B4B54FEC9B8F,10151,12,13,1,34,47,1747
88041,88041,6561B276C0FDB6B75611B4B54FEC9B8F,40341,14,18,4,23,49,1199
88042,88042,6561B276C0FDB6B75611B4B54FEC9B8F,10151,19,23,4,34,47,1747
88049,88049,03ED86F5BE3D351350BAE58E2A3698E8,13681,0,5,5,38,47,1947
88050,88050,03ED86F5BE3D351350BAE58E2A3698E8,42301,5,7,2,36,47,1847
88051,88051,03ED86F5BE3D351350BAE58E2A3698E8,13681,8,9,1,38,47,1947
88052,88052,03ED86F5BE3D351350BAE58E2A3698E8,10661,9,11,2,37,49,1899
88053,88053,03ED86F5BE3D351350BAE58E2A3698E8,10691,12,17,5,33,48,1698
88054,88054,03ED86F5BE3D351350BAE58E2A3698E8,42301,21,22,1,36,47,1847
88055,88055,4FA50ACEDD30F1F921CEE6F85693AFFB,42161,0,7,7,36,47,1847
88056,88056,4FA50ACEDD30F1F921CEE6F85693AFFB,10111,10,12,2,37,47,1897
88057,88057,4FA50ACEDD30F1F921CEE6F85693AFFB,10471,15,17,2,37,48,1898
88058,88058,4FA50ACEDD30F1F921CEE6F85693AFFB,10111,19,21,2,37,47,1897
88059,88059,4FA50ACEDD30F1F921CEE6F85693AFFB,42301,21,23,2,36,47,1847
88060,88060,18D8CFD7E327F0DFC291318C65722023,11381,0,10,10,30,47,1547
88061,88061,18D8CFD7E327F0DFC291318C65722023,40951,11,14,3,36,49,1849
88062,88062,18D8CFD7E327F0DFC291318C65722023,11751,14,16,2,35,48,1798
88063,88063,18D8CFD7E327F0DFC291318C65722023,11381,19,22,3,30,47,1547
88064,88064,9F4FE5C66D1FE88FA924255DF3CD2B31,11911,0,17,17,37,48,1898
88065,88065,9F4FE5C66D1FE88FA924255DF3CD2B31,11381,19,20,1,30,47,1547
88066,88066,9F4FE5C66D1FE88FA924255DF3CD2B31,11911,21,23,2,37,48,1898
88067,88067,733C937DB298F04AAEFCC56682186FAA,11741,0,6,6,42,49,2149
88068,88068,733C937DB298F04AAEFCC56682186FAA,43061,6,12,6,43,46,2196
88069,88069,733C937DB298F04AAEFCC56682186FAA,11741,12,17,5,42,49,2149
88070,88070,733C937DB298F04AAEFCC56682186FAA,11211,19,20,1,34,49,1749
88071,88071,733C937DB298F04AAEFCC56682186FAA,40697,21,22,1,43,48,2198
88075,88075,5529DD2214C36634346603006F6A0F3F,12521,0,8,8,35,41,1791
88076,88076,5529DD2214C36634346603006F6A0F3F,13314,8,10,2,31,39,1589
88077,88077,5529DD2214C36634346603006F6A0F3F,12521,11,18,7,35,41,1791
88078,88078,6D62BE8B751688E1124EF442CD693D0D,12641,1,6,5,10,43,543
88079,88079,6D62BE8B751688E1124EF442CD693D0D,19021,6,8,2,10,45,545
88080,88080,6D62BE8B751688E1124EF442CD693D0D,12641,11,13,2,10,43,543
88081,88081,6D62BE8B751688E1124EF442CD693D0D,19021,16,18,2,10,45,545
88082,88082,6D62BE8B751688E1124EF442CD693D0D,12641,21,23,2,10,43,543
88089,88089,04265608666EC54B2CC7015FDC38CB94,10801,0,11,11,42,47,2147
88090,88090,04265608666EC54B2CC7015FDC38CB94,40611,13,14,1,35,47,1797
88091,88091,04265608666EC54B2CC7015FDC38CB94,10811,16,17,1,38,46,1946
88092,88092,04265608666EC54B2CC7015FDC38CB94,40833,20,21,1,41,47,2097
88102,88102,EF7EE9F0825E500C83748044E0BD2521,13651,0,10,10,30,47,1547
88103,88103,EF7EE9F0825E500C83748044E0BD2521,10351,11,15,4,28,45,1445
88104,88104,EF7EE9F0825E500C83748044E0BD2521,19021,16,17,1,10,45,545
88105,88105,EF7EE9F0825E500C83748044E0BD2521,13651,18,23,5,30,47,1547
88106,88106,2F380CE2E674806561EC26C449F15D1B,41393,0,8,8,43,49,2199
88107,88107,2F380CE2E674806561EC26C449F15D1B,10161,10,13,3,35,49,1799
88108,88108,2F380CE2E674806561EC26C449F15D1B,10431,14,18,4,33,49,1699
88109,88109,2F380CE2E674806561EC26C449F15D1B,41393,22,23,1,43,49,2199
88110,88110,3F48B0843A6DE79E1B79258D18F461E8,42341,0,8,8,43,49,2199
88111,88111,3F48B0843A6DE79E1B79258D18F461E8,13951,9,13,4,47,45,2395
88112,88112,3F48B0843A6DE79E1B79258D18F461E8,13821,14,18,4,49,45,2495
88121,88121,CFF4943452741BA085C68AD1AAC66347,10331,0,7,7,39,46,1996
88122,88122,CFF4943452741BA085C68AD1AAC66347,11481,7,11,4,41,48,2098
88123,88123,CFF4943452741BA085C68AD1AAC66347,10331,11,14,3,39,46,1996
88124,88124,CFF4943452741BA085C68AD1AAC66347,11731,14,18,4,36,48,1848
88125,88125,CFF4943452741BA085C68AD1AAC66347,10331,20,23,3,39,46,1996
88126,88126,EC861FE21AFD755213652562865FFBF9,43101,0,13,13,46,40,2340
88127,88127,EC861FE21AFD755213652562865FFBF9,13071,15,17,2,41,41,2091
88128,88128,EC861FE21AFD755213652562865FFBF9,43101,17,22,5,46,40,2340
88129,88129,95426015650BC53898B8F1908C1F7E01,42501,0,5,5,28,47,1447
88130,88130,95426015650BC53898B8F1908C1F7E01,11111,15,17,2,26,48,1348
88131,88131,95426015650BC53898B8F1908C1F7E01,10221,18,23,5,34,49,1749
88132,88132,A81638617545A61CA275F98CB5E7FC67,12051,0,4,4,20,47,1047
88133,88133,A81638617545A61CA275F98CB5E7FC67,11081,5,17,12,35,46,1796
88134,88134,A81638617545A61CA275F98CB5E7FC67,11361,20,21,1,22,48,1148
88135,88135,A81638617545A61CA275F98CB5E7FC67,12601,21,23,2,25,47,1297
88143,88143,8255A2F4BC245ABC1F6126838351DBA2,42531,0,13,13,31,45,1595
88144,88144,8255A2F4BC245ABC1F6126838351DBA2,10841,15,17,2,37,47,1897
88145,88145,8255A2F4BC245ABC1F6126838351DBA2,42341,17,18,1,43,49,2199
88146,88146,8255A2F4BC245ABC1F6126838351DBA2,42531,22,23,1,31,45,1595
88147,88147,5C2B763013F3453FD43407A455CBD2B2,13651,1,5,4,30,47,1547
88148,88148,5C2B763013F3453FD43407A455CBD2B2,11211,7,9,2,34,49,1749
88149,88149,5C2B763013F3453FD43407A455CBD2B2,10401,12,15,3,33,49,1699
88150,88150,5C2B763013F3453FD43407A455CBD2B2,11211,17,18,1,34,49,1749
88151,88151,5C2B763013F3453FD43407A455CBD2B2,13651,18,19,1,30,47,1547
88152,88152,A63D605A72631A6DDAE7BAAAC6A30961,43051,0,11,11,46,45,2345
88153,88153,A63D605A72631A6DDAE7BAAAC6A30961,43061,12,13,1,43,46,2196
88154,88154,A63D605A72631A6DDAE7BAAAC6A30961,43051,13,15,2,46,45,2345
88155,88155,A63D605A72631A6DDAE7BAAAC6A30961,43061,17,19,2,43,46,2196
88156,88156,A63D605A72631A6DDAE7BAAAC6A30961,43051,20,23,3,46,45,2345
88157,88157,FB8A3B40A5A14C5EDDE5181B01A70E2A,42151,0,5,5,35,45,1795
88158,88158,FB8A3B40A5A14C5EDDE5181B01A70E2A,12491,6,7,1,36,43,1843
88159,88159,FB8A3B40A5A14C5EDDE5181B01A70E2A,42151,8,10,2,35,45,1795
88160,88160,FB8A3B40A5A14C5EDDE5181B01A70E2A,42861,12,16,4,37,44,1894
88161,88161,FB8A3B40A5A14C5EDDE5181B01A70E2A,11261,20,23,3,36,46,1846
88162,88162,EB723F2604EF7AE7C37A9459E67C1BA0,43761,2,11,9,32,47,1647
88163,88163,EB723F2604EF7AE7C37A9459E67C1BA0,10171,11,16,5,26,47,1347
88164,88164,EB723F2604EF7AE7C37A9459E67C1BA0,19901,17,23,6,7,44,394
88165,88165,734BE21864A3611A04F28278A72C8D0B,42151,0,9,9,35,45,1795
88166,88166,734BE21864A3611A04F28278A72C8D0B,13791,12,13,1,42,47,2147
88167,88167,734BE21864A3611A04F28278A72C8D0B,42151,14,19,5,35,45,1795
88168,88168,D1CD491A1E74AABCE3373BF8DA9FFB07,42481,0,5,5,22,49,1149
88169,88169,D1CD491A1E74AABCE3373BF8DA9FFB07,12051,7,8,1,20,47,1047
88170,88170,D1CD491A1E74AABCE3373BF8DA9FFB07,11641,12,14,2,22,49,1149
88171,88171,D1CD491A1E74AABCE3373BF8DA9FFB07,12581,16,18,2,24,48,1248
88172,88172,D1CD491A1E74AABCE3373BF8DA9FFB07,42481,20,21,1,22,49,1149
88173,88173,1FD256A2DF92D3C0A6E8DCD05FE1D5A0,13341,0,11,11,44,45,2245
88174,88174,1FD256A2DF92D3C0A6E8DCD05FE1D5A0,10751,14,16,2,47,43,2393
88175,88175,1FD256A2DF92D3C0A6E8DCD05FE1D5A0,43061,20,23,3,43,46,2196
88179,88179,6AC8DE323FB14BE993C46DD5BD0A71D5,42461,0,7,7,45,47,2297
88180,88180,6AC8DE323FB14BE993C46DD5BD0A71D5,43051,9,10,1,46,45,2345
88181,88181,6AC8DE323FB14BE993C46DD5BD0A71D5,10301,13,14,1,31,45,1595
88182,88182,6AC8DE323FB14BE993C46DD5BD0A71D5,43051,16,18,2,46,45,2345
88183,88183,A2DD7BA75FCE1B5306A377D198F94491,15391,10,11,1,35,26,1776
88184,88184,A2DD7BA75FCE1B5306A377D198F94491,12792,12,13,1,34,30,1730
88185,88185,A2DD7BA75FCE1B5306A377D198F94491,15391,14,22,8,35,26,1776
88186,88186,A2DD7BA75FCE1B5306A377D198F94491,12792,22,23,1,34,30,1730
88190,88190,1EAE8E0D28D79DCFE0DA0CD7004A4A71,19441,0,4,4,8,46,446
88191,88191,1EAE8E0D28D79DCFE0DA0CD7004A4A71,11571,5,6,1,13,46,696
88192,88192,1EAE8E0D28D79DCFE0DA0CD7004A4A71,19441,7,23,16,8,46,446
88193,88193,40A3F567657A043546A2ED7A5DC91A85,12792,0,5,5,34,30,1730
88194,88194,40A3F567657A043546A2ED7A5DC91A85,15331,5,11,6,38,24,1924
88195,88195,40A3F567657A043546A2ED7A5DC91A85,12151,14,16,2,41,33,2083
88196,88196,40A3F567657A043546A2ED7A5DC91A85,15671,20,22,2,37,26,1876
88197,88197,BB6408B6449FE57F7E33631A828BC98E,42201,3,14,11,43,46,2196
88198,88198,BB6408B6449FE57F7E33631A828BC98E,40697,15,20,5,43,48,2198
88199,88199,BB6408B6449FE57F7E33631A828BC98E,11751,21,23,2,35,48,1798
88203,88203,AB57CFBC7FBBD1B4F46C04046F726522,15171,2,6,4,42,21,2121
88204,88204,AB57CFBC7FBBD1B4F46C04046F726522,15021,6,17,11,46,18,2318
88205,88205,AB57CFBC7FBBD1B4F46C04046F726522,15171,17,22,5,42,21,2121
88210,88210,E45BFF8A7B42DBE312092B84982F68A3,11861,0,8,8,32,47,1647
88211,88211,E45BFF8A7B42DBE312092B84982F68A3,11074,9,13,4,37,47,1897
88212,88212,E45BFF8A7B42DBE312092B84982F68A3,11861,16,23,7,32,47,1647
88213,88213,409A27121CD9E6BC90762C45B277F54C,11861,0,6,6,32,47,1647
88214,88214,409A27121CD9E6BC90762C45B277F54C,43281,7,17,10,37,48,1898
88215,88215,409A27121CD9E6BC90762C45B277F54C,11861,18,23,5,32,47,1647
88216,88216,56B410A0D41A489997A75B26273A772A,11521,0,9,9,41,48,2098
88217,88217,56B410A0D41A489997A75B26273A772A,11074,18,19,1,37,47,1897
88218,88218,56B410A0D41A489997A75B26273A772A,11794,21,22,1,38,49,1949
88222,88222,54AF0735D887B9C0B8CEE7B0E8BAEF2D,19441,3,5,2,8,46,446
88223,88223,54AF0735D887B9C0B8CEE7B0E8BAEF2D,11471,6,7,1,12,48,648
88224,88224,54AF0735D887B9C0B8CEE7B0E8BAEF2D,19441,10,20,10,8,46,446
88228,88228,9D5BAF04F73E2316C0A20C69FD467449,10411,0,2,2,36,48,1848
88229,88229,9D5BAF04F73E2316C0A20C69FD467449,11861,2,14,12,32,47,1647
88230,88230,9D5BAF04F73E2316C0A20C69FD467449,11911,16,19,3,37,48,1898
88231,88231,9D5BAF04F73E2316C0A20C69FD467449,11861,20,23,3,32,47,1647
88236,88236,2C9F9127F2AECFBA8069624790D23C60,10471,0,10,10,37,48,1898
88237,88237,2C9F9127F2AECFBA8069624790D23C60,10211,14,16,2,16,49,849
88238,88238,2C9F9127F2AECFBA8069624790D23C60,10471,17,23,6,37,48,1898
88242,88242,3C4F290E088B2251F5A11549B4DEDAFC,40123,0,7,7,38,47,1947
88243,88243,3C4F290E088B2251F5A11549B4DEDAFC,43951,11,12,1,49,41,2491
88244,88244,3C4F290E088B2251F5A11549B4DEDAFC,13331,14,16,2,38,47,1947
88245,88245,3C4F290E088B2251F5A11549B4DEDAFC,10841,17,21,4,37,47,1897
88249,88249,92FB499978AE5927D502ECEF0280A31F,11001,0,2,2,42,47,2147
88250,88250,92FB499978AE5927D502ECEF0280A31F,13941,2,4,2,41,47,2097
88251,88251,92FB499978AE5927D502ECEF0280A31F,11001,6,7,1,42,47,2147
88252,88252,92FB499978AE5927D502ECEF0280A31F,42511,8,17,9,37,47,1897
88253,88253,92FB499978AE5927D502ECEF0280A31F,12514,21,22,1,38,47,1947
88254,88254,1A8DFA9DA14422C77AB2C036FA719B1A,10801,0,1,1,42,47,2147
88255,88255,1A8DFA9DA14422C77AB2C036FA719B1A,42461,1,15,14,45,47,2297
88256,88256,1A8DFA9DA14422C77AB2C036FA719B1A,10841,17,19,2,37,47,1897
88257,88257,1A8DFA9DA14422C77AB2C036FA719B1A,42461,22,23,1,45,47,2297
88258,88258,5A02A0783A87EA433648AFD73A3E8C60,12311,0,6,6,30,44,1544
88259,88259,5A02A0783A87EA433648AFD73A3E8C60,42711,7,8,1,26,48,1348
88260,88260,5A02A0783A87EA433648AFD73A3E8C60,10471,12,19,7,37,48,1898
88261,88261,5A02A0783A87EA433648AFD73A3E8C60,42711,21,23,2,26,48,1348
88262,88262,DBE824B61173F6DDC9B93492DF44D2A0,11661,0,7,7,40,49,2049
88263,88263,DBE824B61173F6DDC9B93492DF44D2A0,10621,11,13,2,41,49,2099
88264,88264,DBE824B61173F6DDC9B93492DF44D2A0,11731,14,15,1,36,48,1848
88265,88265,DBE824B61173F6DDC9B93492DF44D2A0,11011,15,18,3,39,49,1999
88266,88266,DBE824B61173F6DDC9B93492DF44D2A0,43191,20,23,3,40,49,2049
88276,88276,90AC20E6CC0B4ABA3A4EAC5C3086C030,13741,0,14,14,37,49,1899
88277,88277,90AC20E6CC0B4ABA3A4EAC5C3086C030,11271,16,17,1,37,48,1898
88278,88278,90AC20E6CC0B4ABA3A4EAC5C3086C030,13271,21,22,1,41,47,2097
88283,88283,1DA7D70236936C90EAC57F810F371773,11861,10,14,4,32,47,1647
88284,88284,1DA7D70236936C90EAC57F810F371773,10107,14,16,2,38,49,1949
88285,88285,1DA7D70236936C90EAC57F810F371773,11861,17,23,6,32,47,1647
88289,88289,0F11A8AC53B70D9E79879A6E3E243693,11531,8,10,2,34,49,1749
88290,88290,0F11A8AC53B70D9E79879A6E3E243693,43181,12,13,1,39,48,1998
88291,88291,0F11A8AC53B70D9E79879A6E3E243693,11781,14,15,1,38,49,1949
88292,88292,0F11A8AC53B70D9E79879A6E3E243693,11351,19,22,3,36,48,1848
88297,88297,3E7942CC71D03F103F23ED151D419DA7,49201,0,1,1,7,41,391
88298,88298,3E7942CC71D03F103F23ED151D419DA7,12921,2,4,2,9,41,491
88299,88299,3E7942CC71D03F103F23ED151D419DA7,49201,8,11,3,7,41,391
88300,88300,3E7942CC71D03F103F23ED151D419DA7,12921,11,19,8,9,41,491
88301,88301,3E7942CC71D03F103F23ED151D419DA7,49201,21,23,2,7,41,391
88309,88309,32BB999A72664A60BCD6D0C5EF6C9372,19031,0,2,2,1,42,92
88310,88310,32BB999A72664A60BCD6D0C5EF6C9372,49201,7,14,7,7,41,391
88311,88311,32BB999A72664A60BCD6D0C5EF6C9372,12921,17,19,2,9,41,491
88320,88320,9027D7BCCA8B9488D727103093A0EE77,13341,0,5,5,44,45,2245
88321,88321,9027D7BCCA8B9488D727103093A0EE77,43951,7,15,8,49,41,2491
88322,88322,9027D7BCCA8B9488D727103093A0EE77,13341,18,20,2,44,45,2245
88323,88323,C46CDF3840B783157CCBA7C0D999F0A9,10292,0,11,11,30,47,1547
88324,88324,C46CDF3840B783157CCBA7C0D999F0A9,11151,13,15,2,30,48,1548
88325,88325,C46CDF3840B783157CCBA7C0D999F0A9,10292,15,19,4,30,47,1547
88326,88326,C46CDF3840B783157CCBA7C0D999F0A9,42491,20,21,1,32,46,1646
88327,88327,C46CDF3840B783157CCBA7C0D999F0A9,10292,22,23,1,30,47,1547
88328,88328,6A6B5E81D1573652A3361A0C1E5C2EED,11061,1,7,6,29,48,1498
88329,88329,6A6B5E81D1573652A3361A0C1E5C2EED,11381,11,13,2,30,47,1547
88330,88330,6A6B5E81D1573652A3361A0C1E5C2EED,11751,16,17,1,35,48,1798
88331,88331,6A6B5E81D1573652A3361A0C1E5C2EED,12121,19,21,2,29,47,1497
88332,88332,E090AE745FE0157CE235544725EE3E3A,42281,0,2,2,40,48,2048
88333,88333,E090AE745FE0157CE235544725EE3E3A,12514,5,7,2,38,47,1947
88334,88334,E090AE745FE0157CE235544725EE3E3A,13711,9,12,3,38,46,1946
88335,88335,E090AE745FE0157CE235544725EE3E3A,12511,14,15,1,39,47,1997
88336,88336,E090AE745FE0157CE235544725EE3E3A,12514,16,17,1,38,47,1947
88337,88337,E090AE745FE0157CE235544725EE3E3A,40171,19,23,4,38,48,1948
88338,88338,4F6A74BBD714EF065A4DB365EFF3390D,10411,0,7,7,36,48,1848
88339,88339,4F6A74BBD714EF065A4DB365EFF3390D,11291,9,13,4,40,49,2049
88340,88340,4F6A74BBD714EF065A4DB365EFF3390D,11521,19,20,1,41,48,2098
88341,88341,4F6A74BBD714EF065A4DB365EFF3390D,10411,21,23,2,36,48,1848
88342,88342,AB283B89035534646B2ACD936A77B602,11001,0,5,5,42,47,2147
88343,88343,AB283B89035534646B2ACD936A77B602,40431,8,9,1,36,47,1847
88344,88344,AB283B89035534646B2ACD936A77B602,11001,12,20,8,42,47,2147
88349,88349,F276DA0C0E39AE3BAD5B91AE46CB6EA8,42971,1,8,7,43,49,2199
88350,88350,F276DA0C0E39AE3BAD5B91AE46CB6EA8,11231,8,14,6,37,49,1899
88351,88351,F276DA0C0E39AE3BAD5B91AE46CB6EA8,10911,16,17,1,39,46,1996
88352,88352,F276DA0C0E39AE3BAD5B91AE46CB6EA8,42351,20,23,3,38,45,1945
88353,88353,8BED20F2A09E7790626E7AC82B68816D,10292,0,8,8,30,47,1547
88354,88354,8BED20F2A09E7790626E7AC82B68816D,42521,9,11,2,31,47,1597
88355,88355,8BED20F2A09E7790626E7AC82B68816D,10295,14,15,1,30,47,1547
88356,88356,8BED20F2A09E7790626E7AC82B68816D,11491,20,21,1,36,47,1847
88357,88357,A15C0678EF39F4E1D2E8B3E08C176676,13911,0,6,6,39,46,1996
88358,88358,A15C0678EF39F4E1D2E8B3E08C176676,11261,6,7,1,36,46,1846
88359,88359,A15C0678EF39F4E1D2E8B3E08C176676,42351,7,13,6,38,45,1945
88360,88360,A15C0678EF39F4E1D2E8B3E08C176676,42231,14,15,1,37,46,1896
88361,88361,A15C0678EF39F4E1D2E8B3E08C176676,42351,16,19,3,38,45,1945
88362,88362,A15C0678EF39F4E1D2E8B3E08C176676,11261,22,23,1,36,46,1846
88363,88363,04895415E76D1FFF866D6B8869FD01BC,40637,0,10,10,36,47,1847
88364,88364,04895415E76D1FFF866D6B8869FD01BC,10251,10,14,4,35,47,1797
88365,88365,04895415E76D1FFF866D6B8869FD01BC,10151,14,16,2,34,47,1747
88366,88366,04895415E76D1FFF866D6B8869FD01BC,10251,17,20,3,35,47,1797
88367,88367,04895415E76D1FFF866D6B8869FD01BC,13741,21,23,2,37,49,1899
88372,88372,C6E2FE724EC40E59A83AB356B4604856,11331,0,6,6,37,48,1898
88373,88373,C6E2FE724EC40E59A83AB356B4604856,11951,9,12,3,31,49,1599
88374,88374,C6E2FE724EC40E59A83AB356B4604856,11331,19,23,4,37,48,1898
88375,88375,45CC8E14474EA774B17ABFBC375D9618,19441,0,7,7,8,46,446
88376,88376,45CC8E14474EA774B17ABFBC375D9618,10785,11,12,1,35,47,1797
88377,88377,45CC8E14474EA774B17ABFBC375D9618,19441,17,20,3,8,46,446
88390,88390,E38BACB91CF25ECCABC03D838D11F6E2,15641,1,13,12,9,21,471
88391,88391,E38BACB91CF25ECCABC03D838D11F6E2,19051,15,18,3,16,23,823
88392,88392,E38BACB91CF25ECCABC03D838D11F6E2,15641,19,23,4,9,21,471
88404,88404,95CCF589A9220F3D300E82C46D963125,13111,4,5,1,42,46,2146
88405,88405,95CCF589A9220F3D300E82C46D963125,42931,7,11,4,41,49,2099
88406,88406,95CCF589A9220F3D300E82C46D963125,42204,12,14,2,43,46,2196
88407,88407,95CCF589A9220F3D300E82C46D963125,13111,18,20,2,42,46,2146
88408,88408,95CCF589A9220F3D300E82C46D963125,13941,21,23,2,41,47,2097
88415,88415,A5267560F8241F40BFCB325C4ADBB18D,12601,0,7,7,25,47,1297
88416,88416,A5267560F8241F40BFCB325C4ADBB18D,12121,8,10,2,29,47,1497
88417,88417,A5267560F8241F40BFCB325C4ADBB18D,12601,10,12,2,25,47,1297
88418,88418,A5267560F8241F40BFCB325C4ADBB18D,42501,13,16,3,28,47,1447
88419,88419,A5267560F8241F40BFCB325C4ADBB18D,10351,17,18,1,28,45,1445
88420,88420,A5267560F8241F40BFCB325C4ADBB18D,12601,18,21,3,25,47,1297
88421,88421,44204903DA6B531E6F888417C2B4381D,42221,0,9,9,38,48,1948
88422,88422,44204903DA6B531E6F888417C2B4381D,10491,10,11,1,33,48,1698
88423,88423,44204903DA6B531E6F888417C2B4381D,11954,11,13,2,32,49,1649
88424,88424,44204903DA6B531E6F888417C2B4381D,11201,14,16,2,35,49,1799
88425,88425,44204903DA6B531E6F888417C2B4381D,10491,17,23,6,33,48,1698
88426,88426,FC32FCDE5EA162E6A3931CE10EF22190,11021,4,7,3,36,49,1849
88427,88427,FC32FCDE5EA162E6A3931CE10EF22190,11231,7,9,2,37,49,1899
88428,88428,FC32FCDE5EA162E6A3931CE10EF22190,11021,11,14,3,36,49,1849
88429,88429,FC32FCDE5EA162E6A3931CE10EF22190,11231,15,17,2,37,49,1899
88430,88430,FC32FCDE5EA162E6A3931CE10EF22190,11021,20,22,2,36,49,1849
88431,88431,FA73CEEF86E3045F96788E3868F3C71A,10161,2,8,6,35,49,1799
88432,88432,FA73CEEF86E3045F96788E3868F3C71A,11331,8,11,3,37,48,1898
88433,88433,FA73CEEF86E3045F96788E3868F3C71A,11201,14,16,2,35,49,1799
88434,88434,FA73CEEF86E3045F96788E3868F3C71A,11151,18,19,1,30,48,1548
88435,88435,FA73CEEF86E3045F96788E3868F3C71A,10161,20,22,2,35,49,1799
88442,88442,FC520E1A3AAA0EF2D65F339FD547AD66,43751,1,5,4,19,48,998
88443,88443,FC520E1A3AAA0EF2D65F339FD547AD66,12581,7,16,9,24,48,1248
88444,88444,FC520E1A3AAA0EF2D65F339FD547AD66,43751,17,22,5,19,48,998
88451,88451,987356B0625D026E1AD90A681A116422,13601,0,13,13,34,47,1747
88452,88452,987356B0625D026E1AD90A681A116422,13711,14,15,1,38,46,1946
88453,88453,987356B0625D026E1AD90A681A116422,42021,18,21,3,33,47,1697
88454,88454,987356B0625D026E1AD90A681A116422,13601,22,23,1,34,47,1747
88455,88455,F7EC0B81250A7A465E15A49D72E1F238,10121,6,12,6,36,49,1849
88456,88456,F7EC0B81250A7A465E15A49D72E1F238,10681,12,13,1,30,48,1548
88457,88457,F7EC0B81250A7A465E15A49D72E1F238,10121,14,22,8,36,49,1849
88464,88464,8DA07DFE88EE4DA027BDA340934FE072,42091,0,13,13,43,46,2196
88465,88465,8DA07DFE88EE4DA027BDA340934FE072,11491,13,17,4,36,47,1847
88466,88466,8DA07DFE88EE4DA027BDA340934FE072,40697,19,20,1,43,48,2198
88470,88470,301DA8630F1711ABAA30DB6E5BAD6095,12521,0,2,2,35,41,1791
88471,88471,301DA8630F1711ABAA30DB6E5BAD6095,43451,2,7,5,37,40,1890
88472,88472,301DA8630F1711ABAA30DB6E5BAD6095,43391,14,16,2,29,48,1498
88473,88473,301DA8630F1711ABAA30DB6E5BAD6095,11201,18,21,3,35,49,1799
88477,88477,012D304B65BB1C01DC9FFE26FE6AEE56,42161,0,7,7,36,47,1847
88478,88478,012D304B65BB1C01DC9FFE26FE6AEE56,10191,9,10,1,40,48,2048
88479,88479,012D304B65BB1C01DC9FFE26FE6AEE56,10111,13,14,1,37,47,1897
88480,88480,012D304B65BB1C01DC9FFE26FE6AEE56,42401,15,16,1,36,47,1847
88481,88481,012D304B65BB1C01DC9FFE26FE6AEE56,10111,21,23,2,37,47,1897
88482,88482,D0D24C7F1A65A68DAA38891FB1757B47,19441,0,2,2,8,46,446
88483,88483,D0D24C7F1A65A68DAA38891FB1757B47,10214,2,5,3,15,49,799
88484,88484,D0D24C7F1A65A68DAA38891FB1757B47,19024,8,10,2,9,45,495
88485,88485,D0D24C7F1A65A68DAA38891FB1757B47,42041,10,21,11,10,47,547
88486,88486,884F24C0C30AAAE18B1978D3F711D159,42521,0,3,3,31,47,1597
88487,88487,884F24C0C30AAAE18B1978D3F711D159,11381,3,7,4,30,47,1547
88488,88488,884F24C0C30AAAE18B1978D3F711D159,43761,7,8,1,32,47,1647
88489,88489,884F24C0C30AAAE18B1978D3F711D159,40341,17,19,2,23,49,1199
88490,88490,884F24C0C30AAAE18B1978D3F711D159,43761,21,23,2,32,47,1647
88491,88491,FB6EB9D0BDE430C4FE28B7AB7C1A8EBF,11091,0,6,6,29,47,1497
88492,88492,FB6EB9D0BDE430C4FE28B7AB7C1A8EBF,12921,7,19,12,9,41,491
88493,88493,FB6EB9D0BDE430C4FE28B7AB7C1A8EBF,11091,20,23,3,29,47,1497
88494,88494,B1FCFAA740E90CDC4DB2AAE836393F73,10921,0,16,16,43,48,2198
88495,88495,B1FCFAA740E90CDC4DB2AAE836393F73,43731,18,19,1,34,47,1747
88496,88496,B1FCFAA740E90CDC4DB2AAE836393F73,10491,20,21,1,33,48,1698
88497,88497,B1FCFAA740E90CDC4DB2AAE836393F73,11231,21,23,2,37,49,1899
88498,88498,35507D733CAF04397C1F4C352260CF5D,40691,0,1,1,42,48,2148
88499,88499,35507D733CAF04397C1F4C352260CF5D,42583,1,9,8,40,48,2048
88500,88500,35507D733CAF04397C1F4C352260CF5D,42121,18,20,2,26,49,1349
88507,88507,3D2ECC6A4BAE851C87C67624F1270EC4,42351,0,5,5,38,45,1945
88508,88508,3D2ECC6A4BAE851C87C67624F1270EC4,13911,6,8,2,39,46,1996
88509,88509,3D2ECC6A4BAE851C87C67624F1270EC4,42351,8,10,2,38,45,1945
88510,88510,3D2ECC6A4BAE851C87C67624F1270EC4,13911,11,15,4,39,46,1996
88511,88511,3D2ECC6A4BAE851C87C67624F1270EC4,42351,19,23,4,38,45,1945
88512,88512,E7F1EEAC2431E472C01748ABBDDF9743,10271,0,7,7,37,46,1896
88513,88513,E7F1EEAC2431E472C01748ABBDDF9743,11481,11,17,6,41,48,2098
88514,88514,E7F1EEAC2431E472C01748ABBDDF9743,42161,18,20,2,36,47,1847
88515,88515,F36A9C530F88290C9D611D428C0B8F3A,11021,0,7,7,36,49,1849
88516,88516,F36A9C530F88290C9D611D428C0B8F3A,11531,9,11,2,34,49,1749
88517,88517,F36A9C530F88290C9D611D428C0B8F3A,11021,12,13,1,36,49,1849
88518,88518,F36A9C530F88290C9D611D428C0B8F3A,40261,16,18,2,35,49,1799
88519,88519,F36A9C530F88290C9D611D428C0B8F3A,11461,18,19,1,37,49,1899
88527,88527,41DD0A6027648481BFEC7812042262C9,42981,10,11,1,36,49,1849
88528,88528,41DD0A6027648481BFEC7812042262C9,42351,13,14,1,38,45,1945
88529,88529,41DD0A6027648481BFEC7812042262C9,11231,17,18,1,37,49,1899
88530,88530,9E006E8354C02D65527EEB188B09CE56,16231,0,6,6,11,15,565
88531,88531,9E006E8354C02D65527EEB188B09CE56,15421,7,9,2,20,18,1018
88532,88532,9E006E8354C02D65527EEB188B09CE56,16231,10,12,2,11,15,565
88533,88533,9E006E8354C02D65527EEB188B09CE56,15421,14,16,2,20,18,1018
88534,88534,9E006E8354C02D65527EEB188B09CE56,15114,18,19,1,22,16,1116
88535,88535,9E006E8354C02D65527EEB188B09CE56,16441,20,21,1,15,17,767
88536,88536,9E006E8354C02D65527EEB188B09CE56,15114,22,23,1,22,16,1116
88537,88537,B33429D7A00DB66721EA07FF9AC9AB45,11861,0,9,9,32,47,1647
88538,88538,B33429D7A00DB66721EA07FF9AC9AB45,11461,11,22,11,37,49,1899
88539,88539,B33429D7A00DB66721EA07FF9AC9AB45,11861,22,23,1,32,47,1647
88540,88540,A4F650955D0F2E8B3DBCA61C267939BC,13651,0,8,8,30,47,1547
88541,88541,A4F650955D0F2E8B3DBCA61C267939BC,10781,10,11,1,35,47,1797
88542,88542,A4F650955D0F2E8B3DBCA61C267939BC,10292,12,23,11,30,47,1547
88543,88543,346BF3F539A4C5C04EF0491F7207CF76,19931,0,4,4,7,43,393
88544,88544,346BF3F539A4C5C04EF0491F7207CF76,12641,7,11,4,10,43,543
88545,88545,346BF3F539A4C5C04EF0491F7207CF76,43021,11,13,2,16,43,843
88546,88546,346BF3F539A4C5C04EF0491F7207CF76,12641,14,19,5,10,43,543
88547,88547,8AC25483EE33693011BB8E880FFE7B7A,41551,1,11,10,37,46,1896
88548,88548,8AC25483EE33693011BB8E880FFE7B7A,12521,14,15,1,35,41,1791
88549,88549,8AC25483EE33693011BB8E880FFE7B7A,41551,16,18,2,37,46,1896
88550,88550,8AC25483EE33693011BB8E880FFE7B7A,12521,21,22,1,35,41,1791
88558,88558,912793B77DB904F2C28530520B92E0F4,11541,0,2,2,35,49,1799
88559,88559,912793B77DB904F2C28530520B92E0F4,40841,3,11,8,33,49,1699
88560,88560,912793B77DB904F2C28530520B92E0F4,10107,12,13,1,38,49,1949
88561,88561,912793B77DB904F2C28530520B92E0F4,42471,15,19,4,35,49,1799
88562,88562,912793B77DB904F2C28530520B92E0F4,10191,20,22,2,40,48,2048
88566,88566,77FD1986D1B482D2B09730F0DAAA372A,42321,0,1,1,43,47,2197
88567,88567,77FD1986D1B482D2B09730F0DAAA372A,42601,3,5,2,44,48,2248
88568,88568,77FD1986D1B482D2B09730F0DAAA372A,42321,7,9,2,43,47,2197
88569,88569,77FD1986D1B482D2B09730F0DAAA372A,11701,10,12,2,43,48,2198
88570,88570,77FD1986D1B482D2B09730F0DAAA372A,42321,12,20,8,43,47,2197
88575,88575,A7DFFB5A3569C8CF77891A76FE9723DE,42351,0,7,7,38,45,1945
88576,88576,A7DFFB5A3569C8CF77891A76FE9723DE,42081,9,14,5,24,49,1249
88577,88577,A7DFFB5A3569C8CF77891A76FE9723DE,11381,15,16,1,30,47,1547
88578,88578,A7DFFB5A3569C8CF77891A76FE9723DE,42081,18,22,4,24,49,1249
88583,88583,73E499F1CB8DF29225BD7C35FC5868BC,10451,4,6,2,25,48,1298
88584,88584,73E499F1CB8DF29225BD7C35FC5868BC,11641,7,8,1,22,49,1149
88585,88585,73E499F1CB8DF29225BD7C35FC5868BC,42071,13,17,4,31,49,1599
88586,88586,73E499F1CB8DF29225BD7C35FC5868BC,42641,19,21,2,33,49,1699
88587,88587,4C13C3D7416FEE47C7E01DACD89CC954,10634,2,6,4,27,45,1395
88588,88588,4C13C3D7416FEE47C7E01DACD89CC954,42871,7,9,2,30,45,1545
88589,88589,4C13C3D7416FEE47C7E01DACD89CC954,10301,11,14,3,31,45,1595
88590,88590,4C13C3D7416FEE47C7E01DACD89CC954,11875,20,21,1,30,46,1546
88591,88591,4C13C3D7416FEE47C7E01DACD89CC954,10301,21,23,2,31,45,1595
88592,88592,8820D655222FFDC13E2E08EC252AACD5,43161,0,9,9,35,47,1797
88593,88593,8820D655222FFDC13E2E08EC252AACD5,11081,12,14,2,35,46,1796
88594,88594,8820D655222FFDC13E2E08EC252AACD5,10971,18,19,1,35,47,1797
88595,88595,8820D655222FFDC13E2E08EC252AACD5,43731,20,21,1,34,47,1747
88596,88596,8820D655222FFDC13E2E08EC252AACD5,10971,21,22,1,35,47,1797
88600,88600,A383341D78EFA87F857B50ECF68ED16F,40441,2,5,3,30,48,1548
88601,88601,A383341D78EFA87F857B50ECF68ED16F,11381,6,8,2,30,47,1547
88602,88602,A383341D78EFA87F857B50ECF68ED16F,11061,10,12,2,29,48,1498
88603,88603,A383341D78EFA87F857B50ECF68ED16F,11381,13,15,2,30,47,1547
88604,88604,A383341D78EFA87F857B50ECF68ED16F,11061,17,19,2,29,48,1498
88605,88605,A383341D78EFA87F857B50ECF68ED16F,40441,21,22,1,30,48,1548
88606,88606,765113C0EC03D9C2E8837F99909100D7,42401,0,9,9,36,47,1847
88607,88607,765113C0EC03D9C2E8837F99909100D7,10681,11,13,2,30,48,1548
88608,88608,765113C0EC03D9C2E8837F99909100D7,11771,13,16,3,39,49,1999
88609,88609,765113C0EC03D9C2E8837F99909100D7,10681,17,18,1,30,48,1548
88610,88610,765113C0EC03D9C2E8837F99909100D7,40637,21,22,1,36,47,1847
88611,88611,ADE2314A196777EB9BB8FCDB87AABCAE,42191,0,11,11,38,49,1949
88612,88612,ADE2314A196777EB9BB8FCDB87AABCAE,43761,13,14,1,32,47,1647
88613,88613,ADE2314A196777EB9BB8FCDB87AABCAE,10231,16,20,4,39,49,1999
88617,88617,852BB5540E2D1D044093F0A403D4011D,42041,0,8,8,10,47,547
88618,88618,852BB5540E2D1D044093F0A403D4011D,19441,8,18,10,8,46,446
88619,88619,852BB5540E2D1D044093F0A403D4011D,11491,19,22,3,36,47,1847
88620,88620,852BB5540E2D1D044093F0A403D4011D,11531,22,23,1,34,49,1749
88625,88625,4F34225CDC596E63EE8F1BEB4ACA56CC,42864,0,6,6,38,44,1944
88626,88626,4F34225CDC596E63EE8F1BEB4ACA56CC,12521,8,17,9,35,41,1791
88627,88627,4F34225CDC596E63EE8F1BEB4ACA56CC,43011,18,23,5,40,42,2042
88639,88639,68C9F04DAA4541DA8F80DE2D18F7E884,13471,0,7,7,47,49,2399
88640,88640,68C9F04DAA4541DA8F80DE2D18F7E884,11741,9,10,1,42,49,2149
88641,88641,68C9F04DAA4541DA8F80DE2D18F7E884,40341,14,17,3,23,49,1199
88642,88642,68C9F04DAA4541DA8F80DE2D18F7E884,13471,18,19,1,47,49,2399
88643,88643,68C9F04DAA4541DA8F80DE2D18F7E884,42601,19,23,4,44,48,2248
88644,88644,38EAD9C71E0631172BE43F523D61F0B8,42971,0,6,6,43,49,2199
88645,88645,38EAD9C71E0631172BE43F523D61F0B8,43971,7,8,1,30,48,1548
88646,88646,38EAD9C71E0631172BE43F523D61F0B8,11061,8,13,5,29,48,1498
88647,88647,38EAD9C71E0631172BE43F523D61F0B8,42971,16,21,5,43,49,2199
88648,88648,38EAD9C71E0631172BE43F523D61F0B8,13561,21,23,2,37,49,1899
88649,88649,5A8308F9DAAF40265186D4E63F2640C9,10721,0,8,8,31,48,1598
88650,88650,5A8308F9DAAF40265186D4E63F2640C9,12083,12,13,1,36,49,1849
88651,88651,5A8308F9DAAF40265186D4E63F2640C9,12381,19,22,3,32,48,1648
88656,88656,4EE960BFBECD856B4B08E2C89C467744,19441,0,5,5,8,46,446
88657,88657,4EE960BFBECD856B4B08E2C89C467744,42041,6,7,1,10,47,547
88658,88658,4EE960BFBECD856B4B08E2C89C467744,19441,9,10,1,8,46,446
88659,88659,4EE960BFBECD856B4B08E2C89C467744,42041,18,19,1,10,47,547
88660,88660,4EE960BFBECD856B4B08E2C89C467744,19441,22,23,1,8,46,446
88661,88661,1030D8F4FE8CF10A7F5B83AE8CE6624F,42401,0,7,7,36,47,1847
88662,88662,1030D8F4FE8CF10A7F5B83AE8CE6624F,11331,8,10,2,37,48,1898
88663,88663,1030D8F4FE8CF10A7F5B83AE8CE6624F,42401,10,17,7,36,47,1847
88664,88664,1030D8F4FE8CF10A7F5B83AE8CE6624F,40341,18,21,3,23,49,1199
88665,88665,1030D8F4FE8CF10A7F5B83AE8CE6624F,42771,22,23,1,36,47,1847
88666,88666,1277ACA424D6A91D4C363B632562549C,10501,1,9,8,22,46,1146
88667,88667,1277ACA424D6A91D4C363B632562549C,12601,9,10,1,25,47,1297
88668,88668,1277ACA424D6A91D4C363B632562549C,10681,13,18,5,30,48,1548
88669,88669,1277ACA424D6A91D4C363B632562549C,12601,19,20,1,25,47,1297
88670,88670,2417DDB60A9909CB5199D91F850EB8C6,42031,7,13,6,40,46,2046
88671,88671,2417DDB60A9909CB5199D91F850EB8C6,11324,16,17,1,31,46,1596
88672,88672,2417DDB60A9909CB5199D91F850EB8C6,10292,17,22,5,30,47,1547
88676,88676,1C60CB0F57E29CF26D99169B6CE00B11,42291,1,6,5,29,48,1498
88677,88677,1C60CB0F57E29CF26D99169B6CE00B11,42161,10,12,2,36,47,1847
88678,88678,1C60CB0F57E29CF26D99169B6CE00B11,12481,13,14,1,37,49,1899
88679,88679,1C60CB0F57E29CF26D99169B6CE00B11,42161,16,23,7,36,47,1847
88680,88680,8B90954203DF4E7E8B8F7A420A0E2644,12141,0,9,9,42,45,2145
88681,88681,8B90954203DF4E7E8B8F7A420A0E2644,10231,13,16,3,39,49,1999
88682,88682,8B90954203DF4E7E8B8F7A420A0E2644,11271,17,21,4,37,48,1898
88683,88683,E536A8D977E6585D39D9C7DE50009A82,43361,0,1,1,38,48,1948
88684,88684,E536A8D977E6585D39D9C7DE50009A82,10611,3,13,10,32,48,1648
88685,88685,E536A8D977E6585D39D9C7DE50009A82,10107,16,20,4,38,49,1949
88686,88686,E536A8D977E6585D39D9C7DE50009A82,12381,21,22,1,32,48,1648
88687,88687,93DD2C863C5AA53C83002ED6F1D5AEBB,19181,1,3,2,8,40,440
88688,88688,93DD2C863C5AA53C83002ED6F1D5AEBB,19031,5,18,13,1,42,92
88689,88689,93DD2C863C5AA53C83002ED6F1D5AEBB,19901,21,22,1,7,44,394
88690,88690,C8236143E8B93D5FDE499177CF2B28F7,11091,0,1,1,29,47,1497
88691,88691,C8236143E8B93D5FDE499177CF2B28F7,11381,1,5,4,30,47,1547
88692,88692,C8236143E8B93D5FDE499177CF2B28F7,10751,6,16,10,47,43,2393
88693,88693,C8236143E8B93D5FDE499177CF2B28F7,11381,17,23,6,30,47,1547
88697,88697,0F18A9274445631256C7B0403CD7E0F0,10111,0,7,7,37,47,1897
88698,88698,0F18A9274445631256C7B0403CD7E0F0,11641,12,14,2,22,49,1149
88699,88699,0F18A9274445631256C7B0403CD7E0F0,10111,17,23,6,37,47,1897
88703,88703,1D20B498D42204F7DA0BA75047AF3620,10471,1,9,8,37,48,1898
88704,88704,1D20B498D42204F7DA0BA75047AF3620,12971,9,11,2,32,48,1648
88705,88705,1D20B498D42204F7DA0BA75047AF3620,10471,12,15,3,37,48,1898
88706,88706,1D20B498D42204F7DA0BA75047AF3620,41612,17,18,1,36,47,1847
88707,88707,1D20B498D42204F7DA0BA75047AF3620,10111,19,20,1,37,47,1897
88708,88708,1D20B498D42204F7DA0BA75047AF3620,10471,21,23,2,37,48,1898
88713,88713,DEF2119ECB90D4385AD1A45A0B2C7A35,42141,3,5,2,32,47,1647
88714,88714,DEF2119ECB90D4385AD1A45A0B2C7A35,42523,6,8,2,31,47,1597
88715,88715,DEF2119ECB90D4385AD1A45A0B2C7A35,43761,11,12,1,32,47,1647
88716,88716,DEF2119ECB90D4385AD1A45A0B2C7A35,42523,14,15,1,31,47,1597
88717,88717,DEF2119ECB90D4385AD1A45A0B2C7A35,43761,19,20,1,32,47,1647
88721,88721,CFE70D981023CA9E87D11124F3710133,10431,3,13,10,33,49,1699
88722,88722,CFE70D981023CA9E87D11124F3710133,42381,14,16,2,39,41,1991
88723,88723,CFE70D981023CA9E87D11124F3710133,40951,19,22,3,36,49,1849
88724,88724,C5E43FB7922ADA98C2BAC66B96E59D94,19744,0,12,12,6,43,343
88725,88725,C5E43FB7922ADA98C2BAC66B96E59D94,10401,17,18,1,33,49,1699
88726,88726,C5E43FB7922ADA98C2BAC66B96E59D94,19744,19,23,4,6,43,343
88734,88734,B7C01AFA6392259D8F950CD5BD5A252C,43751,0,4,4,19,48,998
88735,88735,B7C01AFA6392259D8F950CD5BD5A252C,12581,7,8,1,24,48,1248
88736,88736,B7C01AFA6392259D8F950CD5BD5A252C,43751,11,12,1,19,48,998
88737,88737,B7C01AFA6392259D8F950CD5BD5A252C,12581,12,14,2,24,48,1248
88738,88738,B7C01AFA6392259D8F950CD5BD5A252C,43751,19,22,3,19,48,998
88739,88739,B0625EAB93B103C27A325761671EA60A,43471,0,1,1,31,49,1599
88740,88740,B0625EAB93B103C27A325761671EA60A,11291,2,8,6,40,49,2049
88741,88741,B0625EAB93B103C27A325761671EA60A,11021,8,12,4,36,49,1849
88742,88742,B0625EAB93B103C27A325761671EA60A,11291,16,20,4,40,49,2049
88743,88743,B0625EAB93B103C27A325761671EA60A,10771,21,23,2,41,46,2096
88744,88744,5DB366BF2898593E6F79A071860A991B,11911,0,9,9,37,48,1898
88745,88745,5DB366BF2898593E6F79A071860A991B,13651,11,18,7,30,47,1547
88746,88746,5DB366BF2898593E6F79A071860A991B,11911,20,23,3,37,48,1898
88755,88755,F26891AEF6799F850643D11B9FD50B6F,13911,0,3,3,39,46,1996
88756,88756,F26891AEF6799F850643D11B9FD50B6F,42351,3,5,2,38,45,1945
88757,88757,F26891AEF6799F850643D11B9FD50B6F,42231,7,15,8,37,46,1896
88758,88758,F26891AEF6799F850643D11B9FD50B6F,42351,17,18,1,38,45,1945
88759,88759,F26891AEF6799F850643D11B9FD50B6F,42231,19,22,3,37,46,1896
88760,88760,4003E07D2A4AF66E84145561FFA003F3,10341,0,10,10,31,47,1597
88761,88761,4003E07D2A4AF66E84145561FFA003F3,42161,11,13,2,36,47,1847
88762,88762,4003E07D2A4AF66E84145561FFA003F3,10341,14,23,9,31,47,1597
88767,88767,8401B75264E9301421036C68C0E8016B,10421,1,9,8,41,48,2098
88768,88768,8401B75264E9301421036C68C0E8016B,12391,11,12,1,36,49,1849
88769,88769,8401B75264E9301421036C68C0E8016B,10421,14,18,4,41,48,2098
88770,88770,AF77E83C33BBDAC9BE49E19DF29439BD,10301,3,10,7,31,45,1595
88771,88771,AF77E83C33BBDAC9BE49E19DF29439BD,40833,13,15,2,41,47,2097
88772,88772,AF77E83C33BBDAC9BE49E19DF29439BD,11301,18,19,1,41,49,2099
88773,88773,AF77E83C33BBDAC9BE49E19DF29439BD,10781,20,22,2,35,47,1797
88777,88777,65C79E4B9AE50DC8A677345D796B93D3,11481,0,1,1,41,48,2098
88778,88778,65C79E4B9AE50DC8A677345D796B93D3,13101,1,8,7,40,47,2047
88779,88779,65C79E4B9AE50DC8A677345D796B93D3,10151,11,12,1,34,47,1747
88780,88780,65C79E4B9AE50DC8A677345D796B93D3,11481,12,14,2,41,48,2098
88781,88781,65C79E4B9AE50DC8A677345D796B93D3,13601,14,23,9,34,47,1747
88782,88782,A53907219614BC9E0FC05C0EC4AF6DC2,13911,0,5,5,39,46,1996
88783,88783,A53907219614BC9E0FC05C0EC4AF6DC2,42231,8,11,3,37,46,1896
88784,88784,A53907219614BC9E0FC05C0EC4AF6DC2,13911,12,13,1,39,46,1996
88785,88785,A53907219614BC9E0FC05C0EC4AF6DC2,42231,14,16,2,37,46,1896
88786,88786,A53907219614BC9E0FC05C0EC4AF6DC2,13711,16,18,2,38,46,1946
88787,88787,A53907219614BC9E0FC05C0EC4AF6DC2,13911,19,23,4,39,46,1996
88788,88788,6C445C0B50CB48233C8A5E9A47D54779,10292,0,10,10,30,47,1547
88789,88789,6C445C0B50CB48233C8A5E9A47D54779,41393,13,14,1,43,49,2199
88790,88790,6C445C0B50CB48233C8A5E9A47D54779,10292,18,19,1,30,47,1547
88791,88791,6C445C0B50CB48233C8A5E9A47D54779,40891,21,23,2,37,47,1897
88801,88801,6F6BFA140B8F0D41AE13D3CFA2E32A87,19114,0,4,4,7,43,393
88802,88802,6F6BFA140B8F0D41AE13D3CFA2E32A87,19441,6,12,6,8,46,446
88803,88803,6F6BFA140B8F0D41AE13D3CFA2E32A87,10634,14,15,1,27,45,1395
88804,88804,6F6BFA140B8F0D41AE13D3CFA2E32A87,19114,18,23,5,7,43,393
88808,88808,C614ED68E8E88AC7D7918B9074DB2C33,10901,0,4,4,35,48,1798
88809,88809,C614ED68E8E88AC7D7918B9074DB2C33,43281,4,5,1,37,48,1898
88810,88810,C614ED68E8E88AC7D7918B9074DB2C33,10901,8,10,2,35,48,1798
88811,88811,C614ED68E8E88AC7D7918B9074DB2C33,40951,12,13,1,36,49,1849
88812,88812,C614ED68E8E88AC7D7918B9074DB2C33,40571,15,21,6,35,48,1798
88813,88813,2808B465D0CA5BE626B66BA705E41B68,42351,0,2,2,38,45,1945
88814,88814,2808B465D0CA5BE626B66BA705E41B68,11261,6,10,4,36,46,1846
88815,88815,2808B465D0CA5BE626B66BA705E41B68,42351,12,13,1,38,45,1945
88816,88816,2808B465D0CA5BE626B66BA705E41B68,11261,13,17,4,36,46,1846
88817,88817,2808B465D0CA5BE626B66BA705E41B68,42351,20,21,1,38,45,1945
88831,88831,3CC60A62625BD17932540051B07BB63C,40445,0,1,1,30,48,1548
88832,88832,3CC60A62625BD17932540051B07BB63C,42491,3,4,1,32,46,1646
88833,88833,3CC60A62625BD17932540051B07BB63C,42291,7,8,1,29,48,1498
88834,88834,3CC60A62625BD17932540051B07BB63C,40445,14,20,6,30,48,1548
88835,88835,3CC60A62625BD17932540051B07BB63C,42491,20,21,1,32,46,1646
88840,88840,8B729CDCB108916620DD6E0AF8317486,42071,0,8,8,31,49,1599
88841,88841,8B729CDCB108916620DD6E0AF8317486,42081,9,11,2,24,49,1249
88842,88842,8B729CDCB108916620DD6E0AF8317486,42071,11,22,11,31,49,1599
88843,88843,3C5BF8354C7B22C00BFA5438C070BC0F,13711,0,9,9,38,46,1946
88844,88844,3C5BF8354C7B22C00BFA5438C070BC0F,43241,9,10,1,36,46,1846
88845,88845,3C5BF8354C7B22C00BFA5438C070BC0F,13711,10,17,7,38,46,1946
88846,88846,3C5BF8354C7B22C00BFA5438C070BC0F,43241,17,18,1,36,46,1846
88847,88847,3C5BF8354C7B22C00BFA5438C070BC0F,13711,20,23,3,38,46,1946
88855,88855,4A97E701DB890F0A36533DCC33203AA3,42221,0,5,5,38,48,1948
88856,88856,4A97E701DB890F0A36533DCC33203AA3,11074,7,9,2,37,47,1897
88857,88857,4A97E701DB890F0A36533DCC33203AA3,42221,12,13,1,38,48,1948
88858,88858,4A97E701DB890F0A36533DCC33203AA3,11074,14,16,2,37,47,1897
88859,88859,4A97E701DB890F0A36533DCC33203AA3,42221,19,23,4,38,48,1948
88863,88863,3C02B5838EDEAB0B15A337805B269A42,10821,0,6,6,40,47,2047
88864,88864,3C02B5838EDEAB0B15A337805B269A42,42321,6,8,2,43,47,2197
88865,88865,3C02B5838EDEAB0B15A337805B269A42,42601,10,11,1,44,48,2248
88866,88866,3C02B5838EDEAB0B15A337805B269A42,42321,14,17,3,43,47,2197
88867,88867,3C02B5838EDEAB0B15A337805B269A42,13011,19,23,4,39,47,1997
88872,88872,0FFF5F408770D048188D5E71EF374A23,43751,0,6,6,19,48,998
88873,88873,0FFF5F408770D048188D5E71EF374A23,11381,7,10,3,30,47,1547
88874,88874,0FFF5F408770D048188D5E71EF374A23,10951,11,13,2,29,48,1498
88875,88875,0FFF5F408770D048188D5E71EF374A23,43751,17,23,6,19,48,998
88876,88876,7B63B781AF1E5C1909C9ECFED6946980,43761,0,6,6,32,47,1647
88877,88877,7B63B781AF1E5C1909C9ECFED6946980,42523,7,10,3,31,47,1597
88878,88878,7B63B781AF1E5C1909C9ECFED6946980,43761,12,13,1,32,47,1647
88879,88879,7B63B781AF1E5C1909C9ECFED6946980,42523,13,16,3,31,47,1597
88880,88880,7B63B781AF1E5C1909C9ECFED6946980,43761,17,19,2,32,47,1647
88881,88881,988754F4ACB1FFB14F8ADCC3660BA4EF,13911,1,2,1,39,46,1996
88882,88882,988754F4ACB1FFB14F8ADCC3660BA4EF,11261,6,16,10,36,46,1846
88883,88883,988754F4ACB1FFB14F8ADCC3660BA4EF,13911,16,19,3,39,46,1996
88884,88884,988754F4ACB1FFB14F8ADCC3660BA4EF,42231,19,20,1,37,46,1896
88885,88885,988754F4ACB1FFB14F8ADCC3660BA4EF,11261,22,23,1,36,46,1846
88886,88886,09F64A9A641B3F2B92615DE97B925264,10634,0,2,2,27,45,1395
88887,88887,09F64A9A641B3F2B92615DE97B925264,10631,4,5,1,28,46,1446
88888,88888,09F64A9A641B3F2B92615DE97B925264,10634,8,11,3,27,45,1395
88889,88889,09F64A9A641B3F2B92615DE97B925264,10951,16,17,1,29,48,1498
88890,88890,09F64A9A641B3F2B92615DE97B925264,10351,19,20,1,28,45,1445
88901,88901,35C7DEE52FA47B8400055A63F2463516,10801,0,11,11,42,47,2147
88902,88902,35C7DEE52FA47B8400055A63F2463516,12221,14,16,2,43,44,2194
88903,88903,35C7DEE52FA47B8400055A63F2463516,13121,19,20,1,38,46,1946
88904,88904,35C7DEE52FA47B8400055A63F2463516,10801,22,23,1,42,47,2147
88905,88905,EF9C99EE076D9702EF73224BC1A91C21,43621,0,6,6,46,48,2348
88906,88906,EF9C99EE076D9702EF73224BC1A91C21,42321,7,10,3,43,47,2197
88907,88907,EF9C99EE076D9702EF73224BC1A91C21,42601,12,13,1,44,48,2248
88908,88908,EF9C99EE076D9702EF73224BC1A91C21,42321,16,18,2,43,47,2197
88909,88909,EF9C99EE076D9702EF73224BC1A91C21,43621,19,23,4,46,48,2348
88910,88910,74EBB90FA1C414F58477B49370E7F73F,11861,0,7,7,32,47,1647
88911,88911,74EBB90FA1C414F58477B49370E7F73F,12311,7,16,9,30,44,1544
88912,88912,74EBB90FA1C414F58477B49370E7F73F,11861,18,22,4,32,47,1647
88916,88916,4D9515E84D9E429F8CCA9A1323018F2F,40491,0,10,10,39,49,1999
88917,88917,4D9515E84D9E429F8CCA9A1323018F2F,43361,12,14,2,38,48,1948
88918,88918,4D9515E84D9E429F8CCA9A1323018F2F,10451,17,18,1,25,48,1298
88919,88919,0E002027D741B8AED4EE58E469659344,10951,9,12,3,29,48,1498
88920,88920,0E002027D741B8AED4EE58E469659344,12601,14,15,1,25,47,1297
88921,88921,0E002027D741B8AED4EE58E469659344,10061,17,19,2,20,46,1046
88922,88922,0E002027D741B8AED4EE58E469659344,10951,21,22,1,29,48,1498
88923,88923,0E002027D741B8AED4EE58E469659344,10061,22,23,1,20,46,1046
88924,88924,39179060954ADF536A44D5CDC3D7ADA4,13911,0,9,9,39,46,1996
88925,88925,39179060954ADF536A44D5CDC3D7ADA4,11261,11,18,7,36,46,1846
88926,88926,39179060954ADF536A44D5CDC3D7ADA4,10921,21,23,2,43,48,2198
88927,88927,BE6556F4F32DDBE17FA5A6143CEC24DA,42921,0,8,8,33,47,1697
88928,88928,BE6556F4F32DDBE17FA5A6143CEC24DA,11801,12,15,3,42,48,2148
88929,88929,BE6556F4F32DDBE17FA5A6143CEC24DA,42921,19,20,1,33,47,1697
88930,88930,BF7F1EED1E9C2A95386EE0E636C7D632,13111,0,8,8,42,46,2146
88931,88931,BF7F1EED1E9C2A95386EE0E636C7D632,12391,10,12,2,36,49,1849
88932,88932,BF7F1EED1E9C2A95386EE0E636C7D632,12921,16,18,2,9,41,491
88933,88933,BF7F1EED1E9C2A95386EE0E636C7D632,13791,19,20,1,42,47,2147
88934,88934,BF7F1EED1E9C2A95386EE0E636C7D632,42204,20,22,2,43,46,2196
88935,88935,4F218B591484142BCC1168E4506477B5,12971,0,7,7,32,48,1648
88936,88936,4F218B591484142BCC1168E4506477B5,13671,11,17,6,27,43,1393
88937,88937,4F218B591484142BCC1168E4506477B5,12971,21,22,1,32,48,1648
88938,88938,176F4E967E986DAF00C74DDD3BF2A8FE,11806,1,4,3,41,48,2098
88939,88939,176F4E967E986DAF00C74DDD3BF2A8FE,42271,4,5,1,40,47,2047
88940,88940,176F4E967E986DAF00C74DDD3BF2A8FE,11806,5,8,3,41,48,2098
88941,88941,176F4E967E986DAF00C74DDD3BF2A8FE,13331,13,15,2,38,47,1947
88942,88942,176F4E967E986DAF00C74DDD3BF2A8FE,11806,17,19,2,41,48,2098
88943,88943,176F4E967E986DAF00C74DDD3BF2A8FE,13331,20,23,3,38,47,1947
88948,88948,CFB5B91AB0CD7543884ADBE535AD19D6,12921,0,2,2,9,41,491
88949,88949,CFB5B91AB0CD7543884ADBE535AD19D6,43021,5,6,1,16,43,843
88950,88950,CFB5B91AB0CD7543884ADBE535AD19D6,12921,9,10,1,9,41,491
88951,88951,CFB5B91AB0CD7543884ADBE535AD19D6,43021,12,22,10,16,43,843
88955,88955,66185B68E33CC3920DCF084557286231,13121,0,6,6,38,46,1946
88956,88956,66185B68E33CC3920DCF084557286231,42301,6,10,4,36,47,1847
88957,88957,66185B68E33CC3920DCF084557286231,13121,10,12,2,38,46,1946
88958,88958,66185B68E33CC3920DCF084557286231,42301,13,18,5,36,47,1847
88959,88959,66185B68E33CC3920DCF084557286231,13121,20,21,1,38,46,1946
88960,88960,6B233920E3ADCD98186EA0225BEE346B,13271,0,7,7,41,47,2097
88961,88961,6B233920E3ADCD98186EA0225BEE346B,11771,7,13,6,39,49,1999
88962,88962,6B233920E3ADCD98186EA0225BEE346B,11131,16,17,1,33,48,1698
88963,88963,6B233920E3ADCD98186EA0225BEE346B,42921,22,23,1,33,47,1697
88964,88964,58DF107986367FA88C1D627635A20D98,11861,2,6,4,32,47,1647
88965,88965,58DF107986367FA88C1D627635A20D98,42011,9,17,8,36,46,1846
88966,88966,58DF107986367FA88C1D627635A20D98,11861,18,21,3,32,47,1647
88967,88967,A5A342C5B79B8AEE00BA80AE678B8EC5,42331,0,7,7,39,46,1996
88968,88968,A5A342C5B79B8AEE00BA80AE678B8EC5,10295,7,16,9,30,47,1547
88969,88969,A5A342C5B79B8AEE00BA80AE678B8EC5,10331,18,23,5,39,46,1996
88973,88973,D3B77B24DF5EC6CEA013C69B5AA71FE2,13911,0,9,9,39,46,1996
88974,88974,D3B77B24DF5EC6CEA013C69B5AA71FE2,42151,14,15,1,35,45,1795
88975,88975,D3B77B24DF5EC6CEA013C69B5AA71FE2,13911,17,23,6,39,46,1996
88976,88976,F4C44655D662E7B0953357C6BC0F15C4,11631,6,7,1,12,49,649
88977,88977,F4C44655D662E7B0953357C6BC0F15C4,12641,12,16,4,10,43,543
88978,88978,F4C44655D662E7B0953357C6BC0F15C4,19021,20,23,3,10,45,545
88979,88979,292AD485DA7AE4FB3CFCA1190DC036DF,13911,2,3,1,39,46,1996
88980,88980,292AD485DA7AE4FB3CFCA1190DC036DF,42351,4,6,2,38,45,1945
88981,88981,292AD485DA7AE4FB3CFCA1190DC036DF,42151,10,11,1,35,45,1795
88982,88982,292AD485DA7AE4FB3CFCA1190DC036DF,13911,14,17,3,39,46,1996
88983,88983,292AD485DA7AE4FB3CFCA1190DC036DF,42231,19,20,1,37,46,1896
88984,88984,292AD485DA7AE4FB3CFCA1190DC036DF,13911,21,23,2,39,46,1996
88985,88985,2BB5E6319C361908A67DD8509286CF7C,19031,1,7,6,1,42,92
88986,88986,2BB5E6319C361908A67DD8509286CF7C,12641,7,18,11,10,43,543
88987,88987,2BB5E6319C361908A67DD8509286CF7C,19031,19,22,3,1,42,92
88988,88988,9467C00340FDB6745E40F052A8816117,11791,9,10,1,38,49,1949
88989,88989,9467C00340FDB6745E40F052A8816117,10401,14,19,5,33,49,1699
88990,88990,9467C00340FDB6745E40F052A8816117,13791,20,22,2,42,47,2147
88991,88991,9467C00340FDB6745E40F052A8816117,42091,22,23,1,43,46,2196
88999,88999,C8E87AF8532CEAD2E0037D4C1FBEDF52,13911,0,1,1,39,46,1996
89000,89000,C8E87AF8532CEAD2E0037D4C1FBEDF52,42351,2,6,4,38,45,1945
89001,89001,C8E87AF8532CEAD2E0037D4C1FBEDF52,10401,9,11,2,33,49,1699
89002,89002,C8E87AF8532CEAD2E0037D4C1FBEDF52,42231,14,16,2,37,46,1896
89003,89003,C8E87AF8532CEAD2E0037D4C1FBEDF52,11791,20,21,1,38,49,1949
89008,89008,9F40B3D85B5B187AC3E43FCFCE8AC0B8,13671,0,6,6,27,43,1393
89009,89009,9F40B3D85B5B187AC3E43FCFCE8AC0B8,10711,11,13,2,29,46,1496
89010,89010,9F40B3D85B5B187AC3E43FCFCE8AC0B8,13671,14,22,8,27,43,1393
89018,89018,ACB823DB33D22CC4344D979C1DDF92F4,11261,0,2,2,36,46,1846
89019,89019,ACB823DB33D22CC4344D979C1DDF92F4,42861,6,10,4,37,44,1894
89020,89020,ACB823DB33D22CC4344D979C1DDF92F4,11261,13,14,1,36,46,1846
89021,89021,ACB823DB33D22CC4344D979C1DDF92F4,42861,14,16,2,37,44,1894
89022,89022,ACB823DB33D22CC4344D979C1DDF92F4,11261,20,21,1,36,46,1846
89026,89026,7DEB53A4993B41126407300DE16CC673,40171,0,2,2,38,48,1948
89027,89027,7DEB53A4993B41126407300DE16CC673,10491,3,11,8,33,48,1698
89028,89028,7DEB53A4993B41126407300DE16CC673,12083,16,17,1,36,49,1849
89029,89029,7DEB53A4993B41126407300DE16CC673,12381,18,22,4,32,48,1648
89030,89030,EA9A666FA0B23AFFCF7291147CEC4E64,43761,3,9,6,32,47,1647
89031,89031,EA9A666FA0B23AFFCF7291147CEC4E64,42021,11,13,2,33,47,1697
89032,89032,EA9A666FA0B23AFFCF7291147CEC4E64,11914,14,15,1,37,48,1898
89033,89033,EA9A666FA0B23AFFCF7291147CEC4E64,11551,17,19,2,39,49,1999
89034,89034,19A29A27E6506D34C07A04E6E9F52A03,12491,0,3,3,36,43,1843
89035,89035,19A29A27E6506D34C07A04E6E9F52A03,42151,7,8,1,35,45,1795
89036,89036,19A29A27E6506D34C07A04E6E9F52A03,12491,8,9,1,36,43,1843
89037,89037,19A29A27E6506D34C07A04E6E9F52A03,42151,10,12,2,35,45,1795
89038,89038,19A29A27E6506D34C07A04E6E9F52A03,12491,14,15,1,36,43,1843
89039,89039,19A29A27E6506D34C07A04E6E9F52A03,42151,17,19,2,35,45,1795
89040,89040,990F89A555478F97C2E0E123BB133187,19181,0,1,1,8,40,440
89041,89041,990F89A555478F97C2E0E123BB133187,49201,1,4,3,7,41,391
89042,89042,990F89A555478F97C2E0E123BB133187,12921,9,11,2,9,41,491
89043,89043,990F89A555478F97C2E0E123BB133187,19181,12,14,2,8,40,440
89044,89044,990F89A555478F97C2E0E123BB133187,49201,14,22,8,7,41,391
89045,89045,5D77C455155C654440C1FABC6822DC8C,11301,0,5,5,41,49,2099
89046,89046,5D77C455155C654440C1FABC6822DC8C,10711,7,9,2,29,46,1496
89047,89047,5D77C455155C654440C1FABC6822DC8C,10716,11,21,10,30,46,1546
89048,89048,E6D049947968658F47DDC695A59302A1,42321,1,2,1,43,47,2197
89049,89049,E6D049947968658F47DDC695A59302A1,42204,6,7,1,43,46,2196
89050,89050,E6D049947968658F47DDC695A59302A1,42301,11,19,8,36,47,1847
89051,89051,E6D049947968658F47DDC695A59302A1,42204,20,22,2,43,46,2196
89059,89059,71AB304A084EB4095E1F705C48CB0E23,11901,0,7,7,42,49,2149
89060,89060,71AB304A084EB4095E1F705C48CB0E23,11914,9,10,1,37,48,1898
89061,89061,71AB304A084EB4095E1F705C48CB0E23,42581,10,13,3,38,48,1948
89062,89062,71AB304A084EB4095E1F705C48CB0E23,11914,14,18,4,37,48,1898
89063,89063,71AB304A084EB4095E1F705C48CB0E23,11901,20,23,3,42,49,2149
89064,89064,8420BC80E057341A3D646D0572754A34,12921,0,3,3,9,41,491
89065,89065,8420BC80E057341A3D646D0572754A34,12641,3,7,4,10,43,543
89066,89066,8420BC80E057341A3D646D0572754A34,11201,9,14,5,35,49,1799
89067,89067,8420BC80E057341A3D646D0572754A34,11074,17,18,1,37,47,1897
89068,89068,03A91EC93647A8BA652DF6ED44DA5BB9,11161,1,2,1,32,48,1648
89069,89069,03A91EC93647A8BA652DF6ED44DA5BB9,42141,2,4,2,32,47,1647
89070,89070,03A91EC93647A8BA652DF6ED44DA5BB9,11161,4,5,1,32,48,1648
89071,89071,03A91EC93647A8BA652DF6ED44DA5BB9,11021,10,11,1,36,49,1849
89072,89072,03A91EC93647A8BA652DF6ED44DA5BB9,11161,13,23,10,32,48,1648
89073,89073,CDEDDC7EB9BBB406F00B4A47C203F67B,10451,2,4,2,25,48,1298
89074,89074,CDEDDC7EB9BBB406F00B4A47C203F67B,12581,6,7,1,24,48,1248
89075,89075,CDEDDC7EB9BBB406F00B4A47C203F67B,43751,7,8,1,19,48,998
89076,89076,CDEDDC7EB9BBB406F00B4A47C203F67B,12581,9,13,4,24,48,1248
89077,89077,CDEDDC7EB9BBB406F00B4A47C203F67B,43751,17,18,1,19,48,998
89085,89085,96E6A1C1C07658E8B77FA819ED76B569,10924,1,5,4,43,49,2199
89086,89086,96E6A1C1C07658E8B77FA819ED76B569,43121,9,18,9,25,27,1277
89087,89087,96E6A1C1C07658E8B77FA819ED76B569,13791,20,21,1,42,47,2147
89088,89088,A8491B4932A74BB29E61F0906E6D23DE,42461,0,7,7,45,47,2297
89089,89089,A8491B4932A74BB29E61F0906E6D23DE,42204,9,15,6,43,46,2196
89090,89090,A8491B4932A74BB29E61F0906E6D23DE,11074,17,19,2,37,47,1897
89091,89091,A8491B4932A74BB29E61F0906E6D23DE,42461,20,22,2,45,47,2297
89095,89095,F3355C7CE640AE85292C2A8D8E7E2415,11901,0,1,1,42,49,2149
89096,89096,F3355C7CE640AE85292C2A8D8E7E2415,11801,1,7,6,42,48,2148
89097,89097,F3355C7CE640AE85292C2A8D8E7E2415,43061,8,9,1,43,46,2196
89098,89098,F3355C7CE640AE85292C2A8D8E7E2415,10211,14,16,2,16,49,849
89099,89099,F3355C7CE640AE85292C2A8D8E7E2415,42471,18,21,3,35,49,1799
89100,89100,F3355C7CE640AE85292C2A8D8E7E2415,13271,21,23,2,41,47,2097
89101,89101,26D70945C43960D97DB289F7CCF774D8,19114,0,6,6,7,43,393
89102,89102,26D70945C43960D97DB289F7CCF774D8,12921,7,11,4,9,41,491
89103,89103,26D70945C43960D97DB289F7CCF774D8,19114,12,13,1,7,43,393
89104,89104,26D70945C43960D97DB289F7CCF774D8,12921,16,18,2,9,41,491
89105,89105,26D70945C43960D97DB289F7CCF774D8,19114,19,22,3,7,43,393
89109,89109,84BFDA5775B1A36CF113618F1669E73C,42521,0,8,8,31,47,1597
89110,89110,84BFDA5775B1A36CF113618F1669E73C,13651,9,10,1,30,47,1547
89111,89111,84BFDA5775B1A36CF113618F1669E73C,42521,12,14,2,31,47,1597
89112,89112,84BFDA5775B1A36CF113618F1669E73C,11381,17,18,1,30,47,1547
89113,89113,84BFDA5775B1A36CF113618F1669E73C,42521,19,23,4,31,47,1597
89124,89124,69F41107244EDDE97DD1AAB2D554177A,19281,0,4,4,16,32,832
89125,89125,69F41107244EDDE97DD1AAB2D554177A,19531,7,8,1,17,30,880
89126,89126,69F41107244EDDE97DD1AAB2D554177A,12871,13,15,2,22,33,1133
89127,89127,69F41107244EDDE97DD1AAB2D554177A,19281,18,19,1,16,32,832
89134,89134,39DE046406ED4E97449B21C0797B47DC,42031,0,7,7,40,46,2046
89135,89135,39DE046406ED4E97449B21C0797B47DC,42523,9,12,3,31,47,1597
89136,89136,39DE046406ED4E97449B21C0797B47DC,42491,12,14,2,32,46,1646
89137,89137,39DE046406ED4E97449B21C0797B47DC,10716,15,22,7,30,46,1546
89138,89138,DFB165CFE9559A5506E7B4D8DE725042,40431,0,8,8,36,47,1847
89139,89139,DFB165CFE9559A5506E7B4D8DE725042,10221,9,12,3,34,49,1749
89140,89140,DFB165CFE9559A5506E7B4D8DE725042,10401,14,15,1,33,49,1699
89141,89141,DFB165CFE9559A5506E7B4D8DE725042,40431,20,23,3,36,47,1847
89145,89145,BF29A9480BAB7B58A18F76AD129514BD,10111,0,7,7,37,47,1897
89146,89146,BF29A9480BAB7B58A18F76AD129514BD,11951,11,12,1,31,49,1599
89147,89147,BF29A9480BAB7B58A18F76AD129514BD,10111,20,23,3,37,47,1897
89148,89148,E58A200B04D899814E22828CF3AE88BE,10841,0,11,11,37,47,1897
89149,89149,E58A200B04D899814E22828CF3AE88BE,11481,14,17,3,41,48,2098
89150,89150,E58A200B04D899814E22828CF3AE88BE,40341,18,20,2,23,49,1199
89151,89151,E58A200B04D899814E22828CF3AE88BE,42941,21,22,1,37,47,1897
89152,89152,3EC3CF0A5199B71D2CF2B1315B035F3D,15191,0,6,6,36,27,1827
89153,89153,3EC3CF0A5199B71D2CF2B1315B035F3D,12792,7,8,1,34,30,1730
89154,89154,3EC3CF0A5199B71D2CF2B1315B035F3D,15391,9,10,1,35,26,1776
89155,89155,3EC3CF0A5199B71D2CF2B1315B035F3D,15191,13,23,10,36,27,1827
89156,89156,6A1C79DEE631F633E432336A53DA033A,12211,1,2,1,41,44,2094
89157,89157,6A1C79DEE631F633E432336A53DA033A,10531,2,3,1,34,46,1746
89158,89158,6A1C79DEE631F633E432336A53DA033A,12211,6,8,2,41,44,2094
89159,89159,6A1C79DEE631F633E432336A53DA033A,42011,13,15,2,36,46,1846
89160,89160,6A1C79DEE631F633E432336A53DA033A,10531,18,19,1,34,46,1746
89165,89165,67E463A97F2732907F7B14F7E69E6FDD,11861,0,8,8,32,47,1647
89166,89166,67E463A97F2732907F7B14F7E69E6FDD,13491,12,14,2,48,39,2439
89167,89167,67E463A97F2732907F7B14F7E69E6FDD,11861,16,18,2,32,47,1647
89168,89168,D6553FC98A27307181CDBCB3E58A1E0C,10331,0,7,7,39,46,1996
89169,89169,D6553FC98A27307181CDBCB3E58A1E0C,11231,13,14,1,37,49,1899
89170,89170,D6553FC98A27307181CDBCB3E58A1E0C,11781,15,16,1,38,49,1949
89171,89171,D6553FC98A27307181CDBCB3E58A1E0C,12511,18,19,1,39,47,1997
89172,89172,D6553FC98A27307181CDBCB3E58A1E0C,10331,19,22,3,39,46,1996
89173,89173,F4A5CE128B0276BA64A57CF9F5D60F74,42831,0,13,13,27,48,1398
89174,89174,F4A5CE128B0276BA64A57CF9F5D60F74,12381,15,17,2,32,48,1648
89175,89175,F4A5CE128B0276BA64A57CF9F5D60F74,11331,17,19,2,37,48,1898
89176,89176,F4A5CE128B0276BA64A57CF9F5D60F74,10107,19,22,3,38,49,1949
89177,89177,4326A99732F97B46651D6FE77C28BB70,10951,0,1,1,29,48,1498
89178,89178,4326A99732F97B46651D6FE77C28BB70,11381,1,2,1,30,47,1547
89179,89179,4326A99732F97B46651D6FE77C28BB70,10951,3,5,2,29,48,1498
89180,89180,4326A99732F97B46651D6FE77C28BB70,11381,6,20,14,30,47,1547
89181,89181,4326A99732F97B46651D6FE77C28BB70,10951,21,23,2,29,48,1498
89185,89185,5767E0EE50B7CB3B0CFBFCA7463471BC,11806,0,6,6,41,48,2098
89186,89186,5767E0EE50B7CB3B0CFBFCA7463471BC,10221,7,11,4,34,49,1749
89187,89187,5767E0EE50B7CB3B0CFBFCA7463471BC,11806,13,22,9,41,48,2098
89188,89188,1CE5F4D10EE2FB173CB9F2BC0746661A,12311,0,1,1,30,44,1544
89189,89189,1CE5F4D10EE2FB173CB9F2BC0746661A,42531,2,8,6,31,45,1595
89190,89190,1CE5F4D10EE2FB173CB9F2BC0746661A,12311,12,13,1,30,44,1544
89191,89191,1CE5F4D10EE2FB173CB9F2BC0746661A,42531,14,16,2,31,45,1595
89192,89192,1CE5F4D10EE2FB173CB9F2BC0746661A,12311,17,18,1,30,44,1544
89193,89193,1CE5F4D10EE2FB173CB9F2BC0746661A,42531,19,20,1,31,45,1595
89194,89194,0B308F8177D01C3A8D264E73918BD4FC,10801,1,3,2,42,47,2147
89195,89195,0B308F8177D01C3A8D264E73918BD4FC,42321,4,5,1,43,47,2197
89196,89196,0B308F8177D01C3A8D264E73918BD4FC,10801,9,11,2,42,47,2147
89197,89197,0B308F8177D01C3A8D264E73918BD4FC,42321,11,17,6,43,47,2197
89198,89198,0B308F8177D01C3A8D264E73918BD4FC,10801,18,19,1,42,47,2147
89199,89199,F3E280D806C0279BCC08880D6A71DAC7,42501,0,11,11,28,47,1447
89200,89200,F3E280D806C0279BCC08880D6A71DAC7,11021,12,15,3,36,49,1849
89201,89201,F3E280D806C0279BCC08880D6A71DAC7,42471,20,23,3,35,49,1799
89202,89202,5B606639B0DDA81D89C67819EC5B7D64,13101,1,6,5,40,47,2047
89203,89203,5B606639B0DDA81D89C67819EC5B7D64,13271,6,8,2,41,47,2097
89204,89204,5B606639B0DDA81D89C67819EC5B7D64,12514,10,13,3,38,47,1947
89205,89205,5B606639B0DDA81D89C67819EC5B7D64,13271,13,15,2,41,47,2097
89206,89206,5B606639B0DDA81D89C67819EC5B7D64,11291,20,21,1,40,49,2049
89207,89207,5B606639B0DDA81D89C67819EC5B7D64,13271,21,23,2,41,47,2097
89208,89208,C5ED324891B8B95E257970408E8D4150,11914,0,5,5,37,48,1898
89209,89209,C5ED324891B8B95E257970408E8D4150,43361,7,8,1,38,48,1948
89210,89210,C5ED324891B8B95E257970408E8D4150,11914,11,12,1,37,48,1898
89211,89211,C5ED324891B8B95E257970408E8D4150,11921,17,18,1,38,48,1948
89212,89212,C5ED324891B8B95E257970408E8D4150,11914,21,22,1,37,48,1898
89216,89216,A4568B18E470D509060E9E98454BE847,13771,0,6,6,21,45,1095
89217,89217,A4568B18E470D509060E9E98454BE847,12601,7,9,2,25,47,1297
89218,89218,A4568B18E470D509060E9E98454BE847,13771,9,11,2,21,45,1095
89219,89219,A4568B18E470D509060E9E98454BE847,12601,12,14,2,25,47,1297
89220,89220,A4568B18E470D509060E9E98454BE847,13771,15,16,1,21,45,1095
89221,89221,A4568B18E470D509060E9E98454BE847,12601,17,18,1,25,47,1297
89229,89229,E02F64059E677B81EAF8B96D760DDB0F,15143,0,5,5,18,7,907
89230,89230,E02F64059E677B81EAF8B96D760DDB0F,16281,6,7,1,11,4,554
89231,89231,E02F64059E677B81EAF8B96D760DDB0F,15143,7,9,2,18,7,907
89232,89232,E02F64059E677B81EAF8B96D760DDB0F,16281,14,19,5,11,4,554
89233,89233,E0598E89F1ED8C52F5770CB15BF80933,19281,0,11,11,16,32,832
89234,89234,E0598E89F1ED8C52F5770CB15BF80933,12871,15,17,2,22,33,1133
89235,89235,E0598E89F1ED8C52F5770CB15BF80933,19281,18,19,1,16,32,832
89239,89239,BAAEF1F815128F9C42A2F609EF6E43D2,42921,1,7,6,33,47,1697
89240,89240,BAAEF1F815128F9C42A2F609EF6E43D2,42161,8,15,7,36,47,1847
89241,89241,BAAEF1F815128F9C42A2F609EF6E43D2,43161,16,18,2,35,47,1797
89242,89242,BAAEF1F815128F9C42A2F609EF6E43D2,11061,19,20,1,29,48,1498
89243,89243,BAAEF1F815128F9C42A2F609EF6E43D2,12131,21,23,2,32,47,1647
89247,89247,537D82A817A1381A8BFD833A3BEC4C9C,12491,0,6,6,36,43,1843
89248,89248,537D82A817A1381A8BFD833A3BEC4C9C,11261,11,13,2,36,46,1846
89249,89249,537D82A817A1381A8BFD833A3BEC4C9C,13911,14,15,1,39,46,1996
89250,89250,537D82A817A1381A8BFD833A3BEC4C9C,11261,16,17,1,36,46,1846
89251,89251,537D82A817A1381A8BFD833A3BEC4C9C,12491,21,23,2,36,43,1843
89255,89255,DA8DFA407AE0B56955050FDA05808335,19021,5,6,1,10,45,545
89256,89256,DA8DFA407AE0B56955050FDA05808335,42041,10,11,1,10,47,547
89257,89257,DA8DFA407AE0B56955050FDA05808335,19901,15,16,1,7,44,394
89258,89258,DA8DFA407AE0B56955050FDA05808335,19621,20,22,2,5,46,296
89263,89263,D8A76E089BFF36425F7258A5A82E7975,10801,1,5,4,42,47,2147
89264,89264,D8A76E089BFF36425F7258A5A82E7975,13271,5,9,4,41,47,2097
89265,89265,D8A76E089BFF36425F7258A5A82E7975,11001,12,15,3,42,47,2147
89266,89266,D8A76E089BFF36425F7258A5A82E7975,13941,17,19,2,41,47,2097
89267,89267,D8A76E089BFF36425F7258A5A82E7975,42321,21,23,2,43,47,2197
89271,89271,28EBDF129D422CC62555B67FAF051D3A,43761,0,7,7,32,47,1647
89272,89272,28EBDF129D422CC62555B67FAF051D3A,11231,8,9,1,37,49,1899
89273,89273,28EBDF129D422CC62555B67FAF051D3A,10901,12,14,2,35,48,1798
89274,89274,28EBDF129D422CC62555B67FAF051D3A,43761,18,21,3,32,47,1647
89275,89275,28EBDF129D422CC62555B67FAF051D3A,11231,21,23,2,37,49,1899
89276,89276,F43D09B23595A0EFD783876DA1E6003B,10651,0,8,8,36,49,1849
89277,89277,F43D09B23595A0EFD783876DA1E6003B,11875,9,11,2,30,46,1546
89278,89278,F43D09B23595A0EFD783876DA1E6003B,10651,13,23,10,36,49,1849
89285,89285,A567BE5B1DACD6E00CC2FAA52D5DB6DF,13271,0,8,8,41,47,2097
89286,89286,A567BE5B1DACD6E00CC2FAA52D5DB6DF,42531,10,17,7,31,45,1595
89287,89287,A567BE5B1DACD6E00CC2FAA52D5DB6DF,11806,18,22,4,41,48,2098
89291,89291,804B7737707030C63DF2E4BD94DF220F,42971,0,7,7,43,49,2199
89292,89292,804B7737707030C63DF2E4BD94DF220F,11806,8,19,11,41,48,2098
89293,89293,804B7737707030C63DF2E4BD94DF220F,42271,19,20,1,40,47,2047
89303,89303,2772001BC3F7379DE82D552064F2ABBB,12874,6,8,2,20,34,1034
89304,89304,2772001BC3F7379DE82D552064F2ABBB,19811,8,9,1,10,34,534
89305,89305,2772001BC3F7379DE82D552064F2ABBB,19281,11,14,3,16,32,832
89306,89306,2772001BC3F7379DE82D552064F2ABBB,12971,15,16,1,32,48,1648
89307,89307,2772001BC3F7379DE82D552064F2ABBB,10491,16,18,2,33,48,1698
89308,89308,997A8B6260B2C603C54BED278570BFCF,43751,0,13,13,19,48,998
89309,89309,997A8B6260B2C603C54BED278570BFCF,12581,14,15,1,24,48,1248
89310,89310,997A8B6260B2C603C54BED278570BFCF,43751,19,21,2,19,48,998
89311,89311,997A8B6260B2C603C54BED278570BFCF,12051,22,23,1,20,47,1047
89312,89312,9B16C8FF79CD32EF97A08ADCC08A0C98,19181,2,3,1,8,40,440
89313,89313,9B16C8FF79CD32EF97A08ADCC08A0C98,12921,4,6,2,9,41,491
89314,89314,9B16C8FF79CD32EF97A08ADCC08A0C98,12641,7,14,7,10,43,543
89315,89315,9B16C8FF79CD32EF97A08ADCC08A0C98,12921,18,23,5,9,41,491
89316,89316,7C1223ABDC06A013346FEEE5F5DF7328,12521,0,8,8,35,41,1791
89317,89317,7C1223ABDC06A013346FEEE5F5DF7328,11261,9,10,1,36,46,1846
89318,89318,7C1223ABDC06A013346FEEE5F5DF7328,12521,11,13,2,35,41,1791
89319,89319,7C1223ABDC06A013346FEEE5F5DF7328,11281,21,22,1,27,40,1390
89320,89320,7C1223ABDC06A013346FEEE5F5DF7328,12521,22,23,1,35,41,1791
89331,89331,65FB78B2C3975B7E029AA4576B8D48D2,12921,0,7,7,9,41,491
89332,89332,65FB78B2C3975B7E029AA4576B8D48D2,49201,7,8,1,7,41,391
89333,89333,65FB78B2C3975B7E029AA4576B8D48D2,19031,9,17,8,1,42,92
89334,89334,65FB78B2C3975B7E029AA4576B8D48D2,12921,19,21,2,9,41,491
89339,89339,400659CE2E6F8BFF6D95D6F52F73DF5B,42921,0,5,5,33,47,1697
89340,89340,400659CE2E6F8BFF6D95D6F52F73DF5B,11861,6,11,5,32,47,1647
89341,89341,400659CE2E6F8BFF6D95D6F52F73DF5B,42921,12,13,1,33,47,1697
89342,89342,400659CE2E6F8BFF6D95D6F52F73DF5B,11861,13,19,6,32,47,1647
89343,89343,400659CE2E6F8BFF6D95D6F52F73DF5B,42921,20,23,3,33,47,1697
89350,89350,559777BBBCD664850DC1E8E7503633C6,11355,1,3,2,36,48,1848
89351,89351,559777BBBCD664850DC1E8E7503633C6,10351,6,7,1,28,45,1445
89352,89352,559777BBBCD664850DC1E8E7503633C6,10301,9,15,6,31,45,1595
89353,89353,559777BBBCD664850DC1E8E7503633C6,12661,19,23,4,32,45,1645
89354,89354,C35D795DA33BE0311413852FD4760F3A,11261,0,5,5,36,46,1846
89355,89355,C35D795DA33BE0311413852FD4760F3A,42864,7,9,2,38,44,1944
89356,89356,C35D795DA33BE0311413852FD4760F3A,42031,11,13,2,40,46,2046
89357,89357,C35D795DA33BE0311413852FD4760F3A,11261,13,15,2,36,46,1846
89358,89358,C35D795DA33BE0311413852FD4760F3A,13911,19,21,2,39,46,1996
89359,89359,C35D795DA33BE0311413852FD4760F3A,11261,22,23,1,36,46,1846
89360,89360,8AC8B1E6CB950C4620C9ADD9BF2E2AE1,42281,0,6,6,40,48,2048
89361,89361,8AC8B1E6CB950C4620C9ADD9BF2E2AE1,11151,6,8,2,30,48,1548
89362,89362,8AC8B1E6CB950C4620C9ADD9BF2E2AE1,42071,12,20,8,31,49,1599
89367,89367,511248B31413344B77C12D74A5EE7CDF,43471,0,7,7,31,49,1599
89368,89368,511248B31413344B77C12D74A5EE7CDF,11151,7,10,3,30,48,1548
89369,89369,511248B31413344B77C12D74A5EE7CDF,11061,12,14,2,29,48,1498
89370,89370,511248B31413344B77C12D74A5EE7CDF,11151,15,16,1,30,48,1548
89371,89371,511248B31413344B77C12D74A5EE7CDF,11061,16,17,1,29,48,1498
89372,89372,511248B31413344B77C12D74A5EE7CDF,40872,21,22,1,30,49,1549
89373,89373,8AD57CA03EB8F7AB0E5EA1F117F384BB,13671,0,5,5,27,43,1393
89374,89374,8AD57CA03EB8F7AB0E5EA1F117F384BB,11531,9,12,3,34,49,1749
89375,89375,8AD57CA03EB8F7AB0E5EA1F117F384BB,13671,15,22,7,27,43,1393
89376,89376,EB3039C415C508F2A2DCF6403E75C42C,43021,0,5,5,16,43,843
89377,89377,EB3039C415C508F2A2DCF6403E75C42C,12921,5,10,5,9,41,491
89378,89378,EB3039C415C508F2A2DCF6403E75C42C,43021,12,13,1,16,43,843
89379,89379,EB3039C415C508F2A2DCF6403E75C42C,12921,13,20,7,9,41,491
89383,89383,32EC0F36441544FE0077B62E357B89B9,12921,3,15,12,9,41,491
89384,89384,32EC0F36441544FE0077B62E357B89B9,12641,16,17,1,10,43,543
89385,89385,32EC0F36441544FE0077B62E357B89B9,43021,19,20,1,16,43,843
89386,89386,32EC0F36441544FE0077B62E357B89B9,12921,21,23,2,9,41,491
89393,89393,7EE35C2F58BD1EE347B0161DF72135F9,11741,0,15,15,42,49,2149
89394,89394,7EE35C2F58BD1EE347B0161DF72135F9,42623,18,20,2,22,49,1149
89395,89395,7EE35C2F58BD1EE347B0161DF72135F9,11741,21,22,1,42,49,2149
89396,89396,ACC988BC7C7C8AB1A0A907CFDFB620E6,10451,0,8,8,25,48,1298
89397,89397,ACC988BC7C7C8AB1A0A907CFDFB620E6,10292,9,13,4,30,47,1547
89398,89398,ACC988BC7C7C8AB1A0A907CFDFB620E6,10451,17,19,2,25,48,1298
89399,89399,ACC988BC7C7C8AB1A0A907CFDFB620E6,10221,21,23,2,34,49,1749
89400,89400,EFDF91E2B28E3A4349E3FCC663793551,11091,0,6,6,29,47,1497
89401,89401,EFDF91E2B28E3A4349E3FCC663793551,11381,6,10,4,30,47,1547
89402,89402,EFDF91E2B28E3A4349E3FCC663793551,11091,10,16,6,29,47,1497
89403,89403,EFDF91E2B28E3A4349E3FCC663793551,10711,16,19,3,29,46,1496
89404,89404,EFDF91E2B28E3A4349E3FCC663793551,11091,19,23,4,29,47,1497
89405,89405,A09953F67FED80A8C2308F84F83FE6DA,43241,0,7,7,36,46,1846
89406,89406,A09953F67FED80A8C2308F84F83FE6DA,13711,9,10,1,38,46,1946
89407,89407,A09953F67FED80A8C2308F84F83FE6DA,43241,10,11,1,36,46,1846
89408,89408,A09953F67FED80A8C2308F84F83FE6DA,10511,13,15,2,35,46,1796
89409,89409,A09953F67FED80A8C2308F84F83FE6DA,43241,17,22,5,36,46,1846
89410,89410,07214D7F8DC05E2B1DD1940CCD11F188,42011,0,9,9,36,46,1846
89411,89411,07214D7F8DC05E2B1DD1940CCD11F188,40341,15,18,3,23,49,1199
89412,89412,07214D7F8DC05E2B1DD1940CCD11F188,43241,20,23,3,36,46,1846
89423,89423,5C81004482023832AD545CD8F1DA1576,13911,0,7,7,39,46,1996
89424,89424,5C81004482023832AD545CD8F1DA1576,11261,7,8,1,36,46,1846
89425,89425,5C81004482023832AD545CD8F1DA1576,13911,9,15,6,39,46,1996
89426,89426,5C81004482023832AD545CD8F1DA1576,11261,16,18,2,36,46,1846
89427,89427,5C81004482023832AD545CD8F1DA1576,13911,18,20,2,39,46,1996
89442,89442,CF59BBFCFA36DB4C2F7A2E35C4549750,43361,0,11,11,38,48,1948
89443,89443,CF59BBFCFA36DB4C2F7A2E35C4549750,42621,16,17,1,24,49,1249
89444,89444,CF59BBFCFA36DB4C2F7A2E35C4549750,11261,18,20,2,36,46,1846
89445,89445,4515D69DA9DF7C67BD58AB71BAA57E58,11914,0,7,7,37,48,1898
89446,89446,4515D69DA9DF7C67BD58AB71BAA57E58,42081,8,9,1,24,49,1249
89447,89447,4515D69DA9DF7C67BD58AB71BAA57E58,11331,13,23,10,37,48,1898
89451,89451,92281A0D755891E7CE6879F8990277A0,10111,1,2,1,37,47,1897
89452,89452,92281A0D755891E7CE6879F8990277A0,11081,3,4,1,35,46,1796
89453,89453,92281A0D755891E7CE6879F8990277A0,10111,4,7,3,37,47,1897
89454,89454,92281A0D755891E7CE6879F8990277A0,11081,8,13,5,35,46,1796
89455,89455,92281A0D755891E7CE6879F8990277A0,42161,13,16,3,36,47,1847
89456,89456,92281A0D755891E7CE6879F8990277A0,11081,18,22,4,35,46,1796
89457,89457,20E55A794AD60637654CF75BCA6DFDC6,13601,9,10,1,34,47,1747
89458,89458,20E55A794AD60637654CF75BCA6DFDC6,11061,13,14,1,29,48,1498
89459,89459,20E55A794AD60637654CF75BCA6DFDC6,42071,18,19,1,31,49,1599
89460,89460,24CACD73BA8D75767DDD668E5EA165E2,42191,0,6,6,38,49,1949
89461,89461,24CACD73BA8D75767DDD668E5EA165E2,11914,8,11,3,37,48,1898
89462,89462,24CACD73BA8D75767DDD668E5EA165E2,42191,12,13,1,38,49,1949
89463,89463,24CACD73BA8D75767DDD668E5EA165E2,11914,17,18,1,37,48,1898
89464,89464,24CACD73BA8D75767DDD668E5EA165E2,40171,22,23,1,38,48,1948
89465,89465,5FF9CE460A753808614E5114D88F66EB,40801,0,6,6,43,46,2196
89466,89466,5FF9CE460A753808614E5114D88F66EB,16016,8,11,3,4,5,205
89467,89467,5FF9CE460A753808614E5114D88F66EB,16071,11,12,1,3,3,153
89468,89468,5FF9CE460A753808614E5114D88F66EB,42491,13,14,1,32,46,1646
89469,89469,5FF9CE460A753808614E5114D88F66EB,40801,14,23,9,43,46,2196
89470,89470,7300FFB733BFFEA187DB110E4D4DC3D2,49201,0,4,4,7,41,391
89471,89471,7300FFB733BFFEA187DB110E4D4DC3D2,19181,5,7,2,8,40,440
89472,89472,7300FFB733BFFEA187DB110E4D4DC3D2,12921,8,9,1,9,41,491
89473,89473,7300FFB733BFFEA187DB110E4D4DC3D2,49201,12,14,2,7,41,391
89474,89474,7300FFB733BFFEA187DB110E4D4DC3D2,12921,15,19,4,9,41,491
89485,89485,AB35C432DC3D59E7929F031635A675AA,12601,0,9,9,25,47,1297
89486,89486,AB35C432DC3D59E7929F031635A675AA,11381,9,11,2,30,47,1547
89487,89487,AB35C432DC3D59E7929F031635A675AA,12601,14,22,8,25,47,1297
89488,89488,53173294ED5BF12AABAED82F9B761816,10161,0,14,14,35,49,1799
89489,89489,53173294ED5BF12AABAED82F9B761816,40431,18,20,2,36,47,1847
89490,89490,53173294ED5BF12AABAED82F9B761816,10821,21,23,2,40,47,2047
89491,89491,F0F944706382F0443615560FA328E069,40341,9,11,2,23,49,1199
89492,89492,F0F944706382F0443615560FA328E069,40361,14,15,1,42,48,2148
89493,89493,F0F944706382F0443615560FA328E069,10107,17,19,2,38,49,1949
89494,89494,F0F944706382F0443615560FA328E069,40361,21,23,2,42,48,2148
89501,89501,823BB637426A4B64F4A56D087D45C241,49201,0,3,3,7,41,391
89502,89502,823BB637426A4B64F4A56D087D45C241,12641,4,6,2,10,43,543
89503,89503,823BB637426A4B64F4A56D087D45C241,49201,6,13,7,7,41,391
89504,89504,823BB637426A4B64F4A56D087D45C241,19181,14,16,2,8,40,440
89505,89505,823BB637426A4B64F4A56D087D45C241,12921,17,18,1,9,41,491
89506,89506,823BB637426A4B64F4A56D087D45C241,49201,18,23,5,7,41,391
89507,89507,11403535660C2C95D3F3D69ACB5A6A25,42231,0,8,8,37,46,1896
89508,89508,11403535660C2C95D3F3D69ACB5A6A25,11301,10,16,6,41,49,2099
89509,89509,11403535660C2C95D3F3D69ACB5A6A25,42231,18,22,4,37,46,1896
89510,89510,BA6468A84C81B4949B332F392AF7BE2D,13101,7,11,4,40,47,2047
89511,89511,BA6468A84C81B4949B332F392AF7BE2D,12311,12,16,4,30,44,1544
89512,89512,BA6468A84C81B4949B332F392AF7BE2D,13101,17,18,1,40,47,2047
89513,89513,BA6468A84C81B4949B332F392AF7BE2D,11806,21,22,1,41,48,2098
89514,89514,0F6FFF3F7FD61C56AAE44D741096AA4C,42131,0,7,7,44,48,2248
89515,89515,0F6FFF3F7FD61C56AAE44D741096AA4C,11331,7,17,10,37,48,1898
89516,89516,0F6FFF3F7FD61C56AAE44D741096AA4C,41393,18,19,1,43,49,2199
89517,89517,C77C8812EE3DBDBAFF1246F561D23EE6,19031,0,5,5,1,42,92
89518,89518,C77C8812EE3DBDBAFF1246F561D23EE6,12641,8,18,10,10,43,543
89519,89519,C77C8812EE3DBDBAFF1246F561D23EE6,19031,18,23,5,1,42,92
89520,89520,BCF7902B3144684D44567B20BDAA780E,13741,0,7,7,37,49,1899
89521,89521,BCF7902B3144684D44567B20BDAA780E,10221,7,9,2,34,49,1749
89522,89522,BCF7902B3144684D44567B20BDAA780E,10651,13,14,1,36,49,1849
89523,89523,BCF7902B3144684D44567B20BDAA780E,42971,20,22,2,43,49,2199
89524,89524,231F2A6283769489A9B02D83485CEEFB,11281,0,13,13,27,40,1390
89525,89525,231F2A6283769489A9B02D83485CEEFB,12521,14,16,2,35,41,1791
89526,89526,231F2A6283769489A9B02D83485CEEFB,11281,19,22,3,27,40,1390
89530,89530,A4FB037706170157DA9B94939FEE9474,11001,3,11,8,42,47,2147
89531,89531,A4FB037706170157DA9B94939FEE9474,10841,14,17,3,37,47,1897
89532,89532,A4FB037706170157DA9B94939FEE9474,11001,18,19,1,42,47,2147
89533,89533,A4FB037706170157DA9B94939FEE9474,13941,20,21,1,41,47,2097
89541,89541,E22B1C54A0FAFCF3D8C5712FD60B6323,11521,1,7,6,41,48,2098
89542,89542,E22B1C54A0FAFCF3D8C5712FD60B6323,11211,10,11,1,34,49,1749
89543,89543,E22B1C54A0FAFCF3D8C5712FD60B6323,11521,12,14,2,41,48,2098
89544,89544,E22B1C54A0FAFCF3D8C5712FD60B6323,11751,17,22,5,35,48,1798
89556,89556,1D8BB04BA223F58C0F7219E50B383AFD,11061,0,15,15,29,48,1498
89557,89557,1D8BB04BA223F58C0F7219E50B383AFD,10971,19,21,2,35,47,1797
89558,89558,1D8BB04BA223F58C0F7219E50B383AFD,11061,22,23,1,29,48,1498
89563,89563,14790389920F96C7E63D3FDC54DD1213,13601,1,13,12,34,47,1747
89564,89564,14790389920F96C7E63D3FDC54DD1213,40341,14,15,1,23,49,1199
89565,89565,14790389920F96C7E63D3FDC54DD1213,43731,16,22,6,34,47,1747
89566,89566,C7D4935453BFEC1CB164593EE1B84EA4,15391,1,16,15,35,26,1776
89567,89567,C7D4935453BFEC1CB164593EE1B84EA4,12792,17,18,1,34,30,1730
89568,89568,C7D4935453BFEC1CB164593EE1B84EA4,15391,21,23,2,35,26,1776
89569,89569,7C98BDF484E2B085C51A4945E804FC0C,42151,0,1,1,35,45,1795
89570,89570,7C98BDF484E2B085C51A4945E804FC0C,13671,2,4,2,27,43,1393
89571,89571,7C98BDF484E2B085C51A4945E804FC0C,42151,6,18,12,35,45,1795
89579,89579,1C12FD1823A36FA85667FC8316128B0A,13681,0,3,3,38,47,1947
89580,89580,1C12FD1823A36FA85667FC8316128B0A,42511,5,7,2,37,47,1897
89581,89581,1C12FD1823A36FA85667FC8316128B0A,13121,7,8,1,38,46,1946
89582,89582,1C12FD1823A36FA85667FC8316128B0A,42511,9,16,7,37,47,1897
89583,89583,1C12FD1823A36FA85667FC8316128B0A,13681,18,19,1,38,47,1947
89588,89588,7942E211B1A4646A4843A84110E073E6,19281,0,5,5,16,32,832
89589,89589,7942E211B1A4646A4843A84110E073E6,12871,7,8,1,22,33,1133
89590,89590,7942E211B1A4646A4843A84110E073E6,19281,10,11,1,16,32,832
89591,89591,7942E211B1A4646A4843A84110E073E6,12871,12,13,1,22,33,1133
89592,89592,7942E211B1A4646A4843A84110E073E6,19281,17,18,1,16,32,832
89593,89593,7942E211B1A4646A4843A84110E073E6,12871,22,23,1,22,33,1133
89594,89594,55B62CF97C3AEC62D987D2F1F6626FBA,10771,0,6,6,41,46,2096
89595,89595,55B62CF97C3AEC62D987D2F1F6626FBA,13711,8,9,1,38,46,1946
89596,89596,55B62CF97C3AEC62D987D2F1F6626FBA,42231,13,14,1,37,46,1896
89597,89597,55B62CF97C3AEC62D987D2F1F6626FBA,42031,19,21,2,40,46,2046
89598,89598,55B62CF97C3AEC62D987D2F1F6626FBA,42311,22,23,1,41,46,2096
89599,89599,D12718BDE5AA6994DCC8C0E9C4106488,19114,0,7,7,7,43,393
89600,89600,D12718BDE5AA6994DCC8C0E9C4106488,42271,8,12,4,40,47,2047
89601,89601,D12718BDE5AA6994DCC8C0E9C4106488,12514,12,14,2,38,47,1947
89602,89602,D12718BDE5AA6994DCC8C0E9C4106488,19114,15,23,8,7,43,393
89607,89607,779A5912B4A6F6D2F940BBF5EC5AAE58,12601,0,10,10,25,47,1297
89608,89608,779A5912B4A6F6D2F940BBF5EC5AAE58,12641,13,16,3,10,43,543
89609,89609,779A5912B4A6F6D2F940BBF5EC5AAE58,10171,20,23,3,26,47,1347
89610,89610,7C25276FDFEE61F55EFE0CD20CA4F5F9,11061,0,7,7,29,48,1498
89611,89611,7C25276FDFEE61F55EFE0CD20CA4F5F9,10681,7,9,2,30,48,1548
89612,89612,7C25276FDFEE61F55EFE0CD20CA4F5F9,11061,9,10,1,29,48,1498
89613,89613,7C25276FDFEE61F55EFE0CD20CA4F5F9,10681,12,13,1,30,48,1548
89614,89614,7C25276FDFEE61F55EFE0CD20CA4F5F9,11061,15,16,1,29,48,1498
89615,89615,7C25276FDFEE61F55EFE0CD20CA4F5F9,42541,17,19,2,25,47,1297
89616,89616,7C25276FDFEE61F55EFE0CD20CA4F5F9,10681,20,21,1,30,48,1548
89617,89617,7C25276FDFEE61F55EFE0CD20CA4F5F9,11061,21,22,1,29,48,1498
89618,89618,D7349708A10855AEF98FEB8D22C33E59,10921,0,7,7,43,48,2198
89619,89619,D7349708A10855AEF98FEB8D22C33E59,11231,8,18,10,37,49,1899
89620,89620,D7349708A10855AEF98FEB8D22C33E59,13271,19,20,1,41,47,2097
89621,89621,D7349708A10855AEF98FEB8D22C33E59,10921,21,22,1,43,48,2198
89626,89626,9D7E28E179E5F5D009F8D277D0F434A8,11861,0,5,5,32,47,1647
89627,89627,9D7E28E179E5F5D009F8D277D0F434A8,42861,9,14,5,37,44,1894
89628,89628,9D7E28E179E5F5D009F8D277D0F434A8,11861,19,23,4,32,47,1647
89635,89635,2917A11EB625CB868E9962150273A0D4,10301,0,7,7,31,45,1595
89636,89636,2917A11EB625CB868E9962150273A0D4,10431,8,11,3,33,49,1699
89637,89637,2917A11EB625CB868E9962150273A0D4,10301,12,14,2,31,45,1595
89638,89638,2917A11EB625CB868E9962150273A0D4,10471,18,21,3,37,48,1898
89639,89639,56B5641ECD958384F4615E8368602153,11261,1,2,1,36,46,1846
89640,89640,56B5641ECD958384F4615E8368602153,42351,2,6,4,38,45,1945
89641,89641,56B5641ECD958384F4615E8368602153,42231,9,11,2,37,46,1896
89642,89642,56B5641ECD958384F4615E8368602153,42351,11,12,1,38,45,1945
89643,89643,56B5641ECD958384F4615E8368602153,42231,14,19,5,37,46,1896
89650,89650,42C74C72D35B339ED05BC27A3DEC0690,19031,0,6,6,1,42,92
89651,89651,42C74C72D35B339ED05BC27A3DEC0690,12921,8,10,2,9,41,491
89652,89652,42C74C72D35B339ED05BC27A3DEC0690,19031,12,23,11,1,42,92
89653,89653,558A6887C0D5899B43E75BBD844A7C64,13471,0,5,5,47,49,2399
89654,89654,558A6887C0D5899B43E75BBD844A7C64,42321,6,15,9,43,47,2197
89655,89655,558A6887C0D5899B43E75BBD844A7C64,42461,16,18,2,45,47,2297
89656,89656,558A6887C0D5899B43E75BBD844A7C64,42321,19,20,1,43,47,2197
89660,89660,1B1161CB64D4F33B625617AD87ACE363,19621,0,8,8,5,46,296
89661,89661,1B1161CB64D4F33B625617AD87ACE363,11061,11,13,2,29,48,1498
89662,89662,1B1161CB64D4F33B625617AD87ACE363,10681,16,19,3,30,48,1548
89663,89663,1B1161CB64D4F33B625617AD87ACE363,19621,21,23,2,5,46,296
89670,89670,E962C3D0A8FC163364DD770DFBF0ADE9,13651,0,8,8,30,47,1547
89671,89671,E962C3D0A8FC163364DD770DFBF0ADE9,41591,9,13,4,34,49,1749
89672,89672,E962C3D0A8FC163364DD770DFBF0ADE9,10411,14,15,1,36,48,1848
89673,89673,E962C3D0A8FC163364DD770DFBF0ADE9,40925,20,21,1,35,49,1799
89680,89680,8436FA510D59B3814E50B7F18BD1D92C,19181,0,1,1,8,40,440
89681,89681,8436FA510D59B3814E50B7F18BD1D92C,19571,2,13,11,1,36,86
89682,89682,8436FA510D59B3814E50B7F18BD1D92C,12921,15,16,1,9,41,491
89683,89683,8436FA510D59B3814E50B7F18BD1D92C,19571,19,23,4,1,36,86
89687,89687,86663282C13F9BF91EBAA9A2AA818B18,15051,0,12,12,19,4,954
89688,89688,86663282C13F9BF91EBAA9A2AA818B18,16281,13,19,6,11,4,554
89689,89689,86663282C13F9BF91EBAA9A2AA818B18,15051,19,22,3,19,4,954
89694,89694,E8F5F4A78C0DE5C1EE8D56EB7226C7B2,11131,1,8,7,33,48,1698
89695,89695,E8F5F4A78C0DE5C1EE8D56EB7226C7B2,10161,12,13,1,35,49,1799
89696,89696,E8F5F4A78C0DE5C1EE8D56EB7226C7B2,19101,18,19,1,17,29,879
89697,89697,E8F5F4A78C0DE5C1EE8D56EB7226C7B2,10911,21,23,2,39,46,1996
89698,89698,D091BDFCFCDE5F934035C67F47F33C3F,11791,0,8,8,38,49,1949
89699,89699,D091BDFCFCDE5F934035C67F47F33C3F,11701,8,16,8,43,48,2198
89700,89700,D091BDFCFCDE5F934035C67F47F33C3F,11771,18,20,2,39,49,1999
89701,89701,C1901A09BA05F642A4A55DF0E24CFD76,42151,0,5,5,35,45,1795
89702,89702,C1901A09BA05F642A4A55DF0E24CFD76,12491,6,7,1,36,43,1843
89703,89703,C1901A09BA05F642A4A55DF0E24CFD76,11021,10,14,4,36,49,1849
89704,89704,C1901A09BA05F642A4A55DF0E24CFD76,42151,18,23,5,35,45,1795
89714,89714,A32DF7F91BA5DF29E0CC0A23C60F35BC,13911,0,8,8,39,46,1996
89715,89715,A32DF7F91BA5DF29E0CC0A23C60F35BC,42151,8,15,7,35,45,1795
89716,89716,A32DF7F91BA5DF29E0CC0A23C60F35BC,13911,16,23,7,39,46,1996
89717,89717,F49EE04071D0B4FCCD4263F4C2BBEA7A,11061,0,5,5,29,48,1498
89718,89718,F49EE04071D0B4FCCD4263F4C2BBEA7A,10841,8,11,3,37,47,1897
89719,89719,F49EE04071D0B4FCCD4263F4C2BBEA7A,11061,12,14,2,29,48,1498
89720,89720,F49EE04071D0B4FCCD4263F4C2BBEA7A,42401,14,16,2,36,47,1847
89721,89721,F49EE04071D0B4FCCD4263F4C2BBEA7A,42521,17,18,1,31,47,1597
89722,89722,F49EE04071D0B4FCCD4263F4C2BBEA7A,11061,19,23,4,29,48,1498
89726,89726,A6EF3AA52D2C883DD4C8A6E9BED0EE14,12921,6,11,5,9,41,491
89727,89727,A6EF3AA52D2C883DD4C8A6E9BED0EE14,43631,13,15,2,19,43,993
89728,89728,A6EF3AA52D2C883DD4C8A6E9BED0EE14,43021,17,19,2,16,43,843
89729,89729,A6EF3AA52D2C883DD4C8A6E9BED0EE14,19111,20,22,2,9,45,495
89730,89730,14626FF97257934EB932E8E843AFE8E1,42864,0,7,7,38,44,1944
89731,89731,14626FF97257934EB932E8E843AFE8E1,11261,7,8,1,36,46,1846
89732,89732,14626FF97257934EB932E8E843AFE8E1,42864,12,17,5,38,44,1944
89733,89733,14626FF97257934EB932E8E843AFE8E1,11261,18,20,2,36,46,1846
89734,89734,14626FF97257934EB932E8E843AFE8E1,42864,21,22,1,38,44,1944
89738,89738,1C0548F40841AD0870DAD8EC7BECCBC6,13314,0,7,7,31,39,1589
89739,89739,1C0548F40841AD0870DAD8EC7BECCBC6,12521,7,9,2,35,41,1791
89740,89740,1C0548F40841AD0870DAD8EC7BECCBC6,13314,12,13,1,31,39,1589
89741,89741,1C0548F40841AD0870DAD8EC7BECCBC6,12521,13,17,4,35,41,1791
89742,89742,1C0548F40841AD0870DAD8EC7BECCBC6,13314,20,23,3,31,39,1589
89747,89747,E648A6F090A3BE85617E0ED54A73B4F0,12601,0,2,2,25,47,1297
89748,89748,E648A6F090A3BE85617E0ED54A73B4F0,12671,3,9,6,21,43,1093
89749,89749,E648A6F090A3BE85617E0ED54A73B4F0,12601,10,22,12,25,47,1297
89750,89750,10C0C5D076A21A64090D9921C6DEDE9B,16281,0,6,6,11,4,554
89751,89751,10C0C5D076A21A64090D9921C6DEDE9B,15051,6,12,6,19,4,954
89752,89752,10C0C5D076A21A64090D9921C6DEDE9B,16281,14,16,2,11,4,554
89753,89753,10C0C5D076A21A64090D9921C6DEDE9B,15051,17,18,1,19,4,954
89754,89754,10C0C5D076A21A64090D9921C6DEDE9B,16281,18,21,3,11,4,554
89755,89755,5417A6F92A553E01B7C73CE94852B163,11231,0,8,8,37,49,1899
89756,89756,5417A6F92A553E01B7C73CE94852B163,13651,9,17,8,30,47,1547
89757,89757,5417A6F92A553E01B7C73CE94852B163,11231,20,23,3,37,49,1899
89758,89758,098FE8401B48D35D8F8F23ACB7575A2C,43021,9,15,6,16,43,843
89759,89759,098FE8401B48D35D8F8F23ACB7575A2C,12921,15,17,2,9,41,491
89760,89760,098FE8401B48D35D8F8F23ACB7575A2C,43021,18,20,2,16,43,843
89761,89761,BECB17E0AD4F06C8390C173C333FCA7C,42204,1,10,9,43,46,2196
89762,89762,BECB17E0AD4F06C8390C173C333FCA7C,13791,14,15,1,42,47,2147
89763,89763,BECB17E0AD4F06C8390C173C333FCA7C,10221,16,18,2,34,49,1749
89764,89764,BECB17E0AD4F06C8390C173C333FCA7C,11201,18,19,1,35,49,1799
89765,89765,BECB17E0AD4F06C8390C173C333FCA7C,11791,20,21,1,38,49,1949
89769,89769,D9419B851F8839F5D675C951F631DB8E,10921,0,7,7,43,48,2198
89770,89770,D9419B851F8839F5D675C951F631DB8E,49181,9,11,2,21,31,1081
89771,89771,D9419B851F8839F5D675C951F631DB8E,12871,11,13,2,22,33,1133
89772,89772,D9419B851F8839F5D675C951F631DB8E,10921,17,23,6,43,48,2198
89773,89773,6CA320FFF385B278278CAF7895A6704A,42921,0,13,13,33,47,1697
89774,89774,6CA320FFF385B278278CAF7895A6704A,40463,14,16,2,38,49,1949
89775,89775,6CA320FFF385B278278CAF7895A6704A,42921,20,22,2,33,47,1697
89776,89776,888D3867D3038878970E976C5AE9B1B6,13651,0,10,10,30,47,1547
89777,89777,888D3867D3038878970E976C5AE9B1B6,10634,11,12,1,27,45,1395
89778,89778,888D3867D3038878970E976C5AE9B1B6,19021,14,15,1,10,45,545
89779,89779,888D3867D3038878970E976C5AE9B1B6,13651,18,23,5,30,47,1547
89784,89784,59DD4D14E624C2B5E0CF9CBC57143681,10801,0,6,6,42,47,2147
89785,89785,59DD4D14E624C2B5E0CF9CBC57143681,42321,9,11,2,43,47,2197
89786,89786,59DD4D14E624C2B5E0CF9CBC57143681,10801,11,12,1,42,47,2147
89787,89787,59DD4D14E624C2B5E0CF9CBC57143681,42321,13,21,8,43,47,2197
89788,89788,59DD4D14E624C2B5E0CF9CBC57143681,10801,21,22,1,42,47,2147
89789,89789,3AB35E62E3464B5074E82DE69E9DD0D9,42501,0,8,8,28,47,1447
89790,89790,3AB35E62E3464B5074E82DE69E9DD0D9,19441,8,14,6,8,46,446
89791,89791,3AB35E62E3464B5074E82DE69E9DD0D9,42501,17,22,5,28,47,1447
89792,89792,C7C431E83C90A041B3FA2A63798CE4F8,12921,0,4,4,9,41,491
89793,89793,C7C431E83C90A041B3FA2A63798CE4F8,43021,5,17,12,16,43,843
89794,89794,C7C431E83C90A041B3FA2A63798CE4F8,12921,20,21,1,9,41,491
89798,89798,8E04CA34920941791B1B2D80E2E36134,10221,2,10,8,34,49,1749
89799,89799,8E04CA34920941791B1B2D80E2E36134,43581,13,14,1,33,48,1698
89800,89800,8E04CA34920941791B1B2D80E2E36134,11381,15,16,1,30,47,1547
89801,89801,8E04CA34920941791B1B2D80E2E36134,43581,21,22,1,33,48,1698
89802,89802,65D64C160A447AEB66DB50D8CA5B54D8,42271,0,1,1,40,47,2047
89803,89803,65D64C160A447AEB66DB50D8CA5B54D8,42321,2,18,16,43,47,2197
89804,89804,65D64C160A447AEB66DB50D8CA5B54D8,10251,19,21,2,35,47,1797
89808,89808,DEAC51B2E11252996BADB6022BF58243,11231,2,14,12,37,49,1899
89809,89809,DEAC51B2E11252996BADB6022BF58243,40341,17,18,1,23,49,1199
89810,89810,DEAC51B2E11252996BADB6022BF58243,13561,19,21,2,37,49,1899
89818,89818,464A8954189CE9AFFA4CED6E8000F863,43751,0,10,10,19,48,998
89819,89819,464A8954189CE9AFFA4CED6E8000F863,12581,10,16,6,24,48,1248
89820,89820,464A8954189CE9AFFA4CED6E8000F863,10061,21,22,1,20,46,1046
89821,89821,8073345703B614CB6E971148A63B1D93,10107,1,6,5,38,49,1949
89822,89822,8073345703B614CB6E971148A63B1D93,10471,6,11,5,37,48,1898
89823,89823,8073345703B614CB6E971148A63B1D93,11231,13,15,2,37,49,1899
89824,89824,8073345703B614CB6E971148A63B1D93,10471,16,19,3,37,48,1898
89825,89825,8073345703B614CB6E971148A63B1D93,11231,19,21,2,37,49,1899
89826,89826,8073345703B614CB6E971148A63B1D93,10471,21,23,2,37,48,1898
89827,89827,9508FAE0B774FCD97D7CFB3C4BD72215,10251,0,4,4,35,47,1797
89828,89828,9508FAE0B774FCD97D7CFB3C4BD72215,10111,6,8,2,37,47,1897
89829,89829,9508FAE0B774FCD97D7CFB3C4BD72215,42351,8,9,1,38,45,1945
89830,89830,9508FAE0B774FCD97D7CFB3C4BD72215,10111,17,23,6,37,47,1897
89835,89835,97F15181D86229649E406F5275B66DD1,41551,0,4,4,37,46,1896
89836,89836,97F15181D86229649E406F5275B66DD1,42351,5,6,1,38,45,1945
89837,89837,97F15181D86229649E406F5275B66DD1,11941,10,14,4,37,46,1896
89838,89838,97F15181D86229649E406F5275B66DD1,11261,20,21,1,36,46,1846
89839,89839,97F15181D86229649E406F5275B66DD1,42351,22,23,1,38,45,1945
89843,89843,A67F50337E2EC43D03A4976B44AE2823,13711,1,9,8,38,46,1946
89844,89844,A67F50337E2EC43D03A4976B44AE2823,11941,14,15,1,37,46,1896
89845,89845,A67F50337E2EC43D03A4976B44AE2823,13711,16,18,2,38,46,1946
89846,89846,A67F50337E2EC43D03A4976B44AE2823,11941,18,20,2,37,46,1896
89847,89847,A67F50337E2EC43D03A4976B44AE2823,13711,21,22,1,38,46,1946
89848,89848,68D66AC2F31097852E1113FCAC38B096,12311,1,5,4,30,44,1544
89849,89849,68D66AC2F31097852E1113FCAC38B096,42531,8,14,6,31,45,1595
89850,89850,68D66AC2F31097852E1113FCAC38B096,12311,14,15,1,30,44,1544
89851,89851,68D66AC2F31097852E1113FCAC38B096,42531,15,18,3,31,45,1595
89852,89852,68D66AC2F31097852E1113FCAC38B096,12311,20,23,3,30,44,1544
89860,89860,5F09B173620062093E73818D879CF79B,43021,0,5,5,16,43,843
89861,89861,5F09B173620062093E73818D879CF79B,12121,6,7,1,29,47,1497
89862,89862,5F09B173620062093E73818D879CF79B,43021,11,18,7,16,43,843
89863,89863,5F09B173620062093E73818D879CF79B,12921,19,20,1,9,41,491
89864,89864,B1D77411DB323E16280CAE6EA48D111F,10107,0,2,2,38,49,1949
89865,89865,B1D77411DB323E16280CAE6EA48D111F,11231,3,7,4,37,49,1899
89866,89866,B1D77411DB323E16280CAE6EA48D111F,10471,9,10,1,37,48,1898
89867,89867,B1D77411DB323E16280CAE6EA48D111F,10731,16,17,1,33,47,1697
89868,89868,B1D77411DB323E16280CAE6EA48D111F,10107,19,20,1,38,49,1949
89869,89869,CF7DA1891D00F069E0E0214450037183,11381,0,1,1,30,47,1547
89870,89870,CF7DA1891D00F069E0E0214450037183,11061,1,7,6,29,48,1498
89871,89871,CF7DA1891D00F069E0E0214450037183,11751,8,9,1,35,48,1798
89872,89872,CF7DA1891D00F069E0E0214450037183,11381,12,15,3,30,47,1547
89873,89873,CF7DA1891D00F069E0E0214450037183,43971,15,16,1,30,48,1548
89874,89874,CF7DA1891D00F069E0E0214450037183,11061,17,19,2,29,48,1498
89883,89883,2E9ACB5217DEAC635E911A6AAEF6DCF5,11261,0,7,7,36,46,1846
89884,89884,2E9ACB5217DEAC635E911A6AAEF6DCF5,10107,8,10,2,38,49,1949
89885,89885,2E9ACB5217DEAC635E911A6AAEF6DCF5,11261,12,14,2,36,46,1846
89886,89886,2E9ACB5217DEAC635E911A6AAEF6DCF5,40637,16,17,1,36,47,1847
89887,89887,2E9ACB5217DEAC635E911A6AAEF6DCF5,11331,19,20,1,37,48,1898
89888,89888,2E9ACB5217DEAC635E911A6AAEF6DCF5,11261,21,22,1,36,46,1846
89889,89889,C06A2B736F0C9DE7AE001761CE315949,12792,0,5,5,34,30,1730
89890,89890,C06A2B736F0C9DE7AE001761CE315949,15191,6,8,2,36,27,1827
89891,89891,C06A2B736F0C9DE7AE001761CE315949,12792,10,19,9,34,30,1730
89899,89899,AFAE133FA88B98A999C46702AA923186,42511,0,9,9,37,47,1897
89900,89900,AFAE133FA88B98A999C46702AA923186,43101,12,15,3,46,40,2340
89901,89901,AFAE133FA88B98A999C46702AA923186,10911,16,20,4,39,46,1996
89902,89902,AFAE133FA88B98A999C46702AA923186,13011,21,22,1,39,47,1997
89903,89903,D6B662C0D72BBB94314A69A6BE13D66E,43761,0,9,9,32,47,1647
89904,89904,D6B662C0D72BBB94314A69A6BE13D66E,19111,11,12,1,9,45,495
89905,89905,D6B662C0D72BBB94314A69A6BE13D66E,12311,14,16,2,30,44,1544
89906,89906,D6B662C0D72BBB94314A69A6BE13D66E,43761,20,22,2,32,47,1647
89907,89907,56724C20C0AEA6C6F56FF45E8F5E1CF9,42491,1,6,5,32,46,1646
89908,89908,56724C20C0AEA6C6F56FF45E8F5E1CF9,43761,6,14,8,32,47,1647
89909,89909,56724C20C0AEA6C6F56FF45E8F5E1CF9,42291,14,17,3,29,48,1498
89910,89910,56724C20C0AEA6C6F56FF45E8F5E1CF9,43761,18,23,5,32,47,1647
89917,89917,2DF55C2584719A60978A4B87BCCC14A1,42523,2,3,1,31,47,1597
89918,89918,2DF55C2584719A60978A4B87BCCC14A1,10292,4,5,1,30,47,1547
89919,89919,2DF55C2584719A60978A4B87BCCC14A1,42523,6,17,11,31,47,1597
89920,89920,2DF55C2584719A60978A4B87BCCC14A1,43761,18,20,2,32,47,1647
89921,89921,2DF55C2584719A60978A4B87BCCC14A1,42523,21,23,2,31,47,1597
89922,89922,F8783A2482E77A1E790086D6E9648A43,42204,0,6,6,43,46,2196
89923,89923,F8783A2482E77A1E790086D6E9648A43,13791,8,9,1,42,47,2147
89924,89924,F8783A2482E77A1E790086D6E9648A43,13111,10,15,5,42,46,2146
89925,89925,F8783A2482E77A1E790086D6E9648A43,13791,19,20,1,42,47,2147
89926,89926,F8783A2482E77A1E790086D6E9648A43,42204,22,23,1,43,46,2196
89933,89933,403E4ED8501B3F3BFADB94D815ACA889,42771,0,7,7,36,47,1847
89934,89934,403E4ED8501B3F3BFADB94D815ACA889,11021,9,14,5,36,49,1849
89935,89935,403E4ED8501B3F3BFADB94D815ACA889,11871,18,22,4,29,46,1496
89936,89936,9FD07F08B957B9919E73D64BBF49A52F,11794,0,3,3,38,49,1949
89937,89937,9FD07F08B957B9919E73D64BBF49A52F,11771,3,4,1,39,49,1999
89938,89938,9FD07F08B957B9919E73D64BBF49A52F,11794,5,8,3,38,49,1949
89939,89939,9FD07F08B957B9919E73D64BBF49A52F,10511,10,11,1,35,46,1796
89940,89940,9FD07F08B957B9919E73D64BBF49A52F,10531,12,17,5,34,46,1746
89941,89941,9FD07F08B957B9919E73D64BBF49A52F,11791,19,20,1,38,49,1949
89945,89945,94092014F9DD3213271810B8D19555BE,49201,0,5,5,7,41,391
89946,89946,94092014F9DD3213271810B8D19555BE,12921,5,9,4,9,41,491
89947,89947,94092014F9DD3213271810B8D19555BE,49201,11,13,2,7,41,391
89948,89948,94092014F9DD3213271810B8D19555BE,12921,13,19,6,9,41,491
89949,89949,94092014F9DD3213271810B8D19555BE,49201,19,22,3,7,41,391
89950,89950,8D2C2C42E63FD22BFD992889F79D269F,42523,1,6,5,31,47,1597
89951,89951,8D2C2C42E63FD22BFD992889F79D269F,43761,6,7,1,32,47,1647
89952,89952,8D2C2C42E63FD22BFD992889F79D269F,11061,8,11,3,29,48,1498
89953,89953,8D2C2C42E63FD22BFD992889F79D269F,11381,13,20,7,30,47,1547
89954,89954,8D2C2C42E63FD22BFD992889F79D269F,43761,21,23,2,32,47,1647
89958,89958,831CEF471029417D091D2BE9F78234DD,42321,4,7,3,43,47,2197
89959,89959,831CEF471029417D091D2BE9F78234DD,10801,8,14,6,42,47,2147
89960,89960,831CEF471029417D091D2BE9F78234DD,11811,18,23,5,38,49,1949
89961,89961,FE4547C9BDE2F0CE3554897F6352AE34,43011,0,7,7,40,42,2042
89962,89962,FE4547C9BDE2F0CE3554897F6352AE34,43451,7,9,2,37,40,1890
89963,89963,FE4547C9BDE2F0CE3554897F6352AE34,43011,12,13,1,40,42,2042
89964,89964,FE4547C9BDE2F0CE3554897F6352AE34,42151,18,19,1,35,45,1795
89969,89969,DEA13AE4E25C1F5535D501BC3C7ECF55,19111,0,14,14,9,45,495
89970,89970,DEA13AE4E25C1F5535D501BC3C7ECF55,11541,16,18,2,35,49,1799
89971,89971,DEA13AE4E25C1F5535D501BC3C7ECF55,13511,19,22,3,34,48,1748
89979,89979,C1CF59B64EE7642E956AF0C2EBE03CC9,11351,0,6,6,36,48,1848
89980,89980,C1CF59B64EE7642E956AF0C2EBE03CC9,42921,8,9,1,33,47,1697
89981,89981,C1CF59B64EE7642E956AF0C2EBE03CC9,11351,12,13,1,36,48,1848
89982,89982,C1CF59B64EE7642E956AF0C2EBE03CC9,43361,17,19,2,38,48,1948
89983,89983,C1CF59B64EE7642E956AF0C2EBE03CC9,11901,22,23,1,42,49,2149
89987,89987,96056246DD9856C2DDE7E703B0D16D68,11355,0,1,1,36,48,1848
89988,89988,96056246DD9856C2DDE7E703B0D16D68,11381,2,19,17,30,47,1547
89989,89989,96056246DD9856C2DDE7E703B0D16D68,11491,20,21,1,36,47,1847
89990,89990,055660D96102C90837257CF6FD6D548A,13911,0,6,6,39,46,1996
89991,89991,055660D96102C90837257CF6FD6D548A,11261,6,9,3,36,46,1846
89992,89992,055660D96102C90837257CF6FD6D548A,42351,13,14,1,38,45,1945
89993,89993,055660D96102C90837257CF6FD6D548A,13341,17,20,3,44,45,2245
89994,89994,055660D96102C90837257CF6FD6D548A,13911,21,22,1,39,46,1996
89995,89995,F676BD317E9AD54A34455DBE3ED088EB,42141,0,7,7,32,47,1647
89996,89996,F676BD317E9AD54A34455DBE3ED088EB,11731,12,14,2,36,48,1848
89997,89997,F676BD317E9AD54A34455DBE3ED088EB,10281,16,22,6,33,48,1698
90004,90004,B7C33B5C4F6E6D84F66DE44CC367A266,42861,0,2,2,37,44,1894
90005,90005,B7C33B5C4F6E6D84F66DE44CC367A266,12601,6,9,3,25,47,1297
90006,90006,B7C33B5C4F6E6D84F66DE44CC367A266,10061,10,13,3,20,46,1046
90007,90007,B7C33B5C4F6E6D84F66DE44CC367A266,12601,14,15,1,25,47,1297
90008,90008,B7C33B5C4F6E6D84F66DE44CC367A266,42861,18,21,3,37,44,1894
90013,90013,72CCFF68A8139FE3616EAEC5752357DB,10251,0,8,8,35,47,1797
90014,90014,72CCFF68A8139FE3616EAEC5752357DB,40637,8,9,1,36,47,1847
90015,90015,72CCFF68A8139FE3616EAEC5752357DB,10841,9,12,3,37,47,1897
90016,90016,72CCFF68A8139FE3616EAEC5752357DB,10251,13,18,5,35,47,1797
90017,90017,72CCFF68A8139FE3616EAEC5752357DB,43731,18,21,3,34,47,1747
90018,90018,72CCFF68A8139FE3616EAEC5752357DB,10971,21,22,1,35,47,1797
90019,90019,3E3400E81F33727D0845365703B2CDF7,42471,0,7,7,35,49,1799
90020,90020,3E3400E81F33727D0845365703B2CDF7,41393,8,16,8,43,49,2199
90021,90021,3E3400E81F33727D0845365703B2CDF7,10161,20,23,3,35,49,1799
90022,90022,7B4E6126570CADEFC5C95EC455FF20E3,11914,0,4,4,37,48,1898
90023,90023,7B4E6126570CADEFC5C95EC455FF20E3,43361,5,9,4,38,48,1948
90024,90024,7B4E6126570CADEFC5C95EC455FF20E3,11914,10,13,3,37,48,1898
90025,90025,7B4E6126570CADEFC5C95EC455FF20E3,11921,15,16,1,38,48,1948
90026,90026,7B4E6126570CADEFC5C95EC455FF20E3,11914,16,20,4,37,48,1898
90030,90030,FF604ADE0B9A2535A71C015160B61DC6,12761,0,7,7,25,40,1290
90031,90031,FF604ADE0B9A2535A71C015160B61DC6,11381,9,11,2,30,47,1547
90032,90032,FF604ADE0B9A2535A71C015160B61DC6,13671,14,15,1,27,43,1393
90033,90033,FF604ADE0B9A2535A71C015160B61DC6,12761,16,18,2,25,40,1290
90034,90034,FF604ADE0B9A2535A71C015160B61DC6,13671,20,21,1,27,43,1393
90035,90035,FF604ADE0B9A2535A71C015160B61DC6,12521,21,23,2,35,41,1791
90036,90036,975688BDD7D3B41B53C460B57B5AC58A,43751,0,5,5,19,48,998
90037,90037,975688BDD7D3B41B53C460B57B5AC58A,10451,9,11,2,25,48,1298
90038,90038,975688BDD7D3B41B53C460B57B5AC58A,43751,12,14,2,19,48,998
90039,90039,975688BDD7D3B41B53C460B57B5AC58A,11361,14,16,2,22,48,1148
90040,90040,975688BDD7D3B41B53C460B57B5AC58A,12581,18,19,1,24,48,1248
90041,90041,C67AD33695FBB59FE91EDDED93659237,10544,1,7,6,28,48,1448
90042,90042,C67AD33695FBB59FE91EDDED93659237,11331,8,15,7,37,48,1898
90043,90043,C67AD33695FBB59FE91EDDED93659237,11061,17,20,3,29,48,1498
90056,90056,51CA45CA2AACCC83748D6918E9F511C1,12661,0,1,1,32,45,1645
90057,90057,51CA45CA2AACCC83748D6918E9F511C1,12491,2,7,5,36,43,1843
90058,90058,51CA45CA2AACCC83748D6918E9F511C1,42151,8,15,7,35,45,1795
90059,90059,51CA45CA2AACCC83748D6918E9F511C1,12491,18,20,2,36,43,1843
90068,90068,BB641CBF102512A21E2D52863882919C,19441,0,6,6,8,46,446
90069,90069,BB641CBF102512A21E2D52863882919C,10951,10,18,8,29,48,1498
90070,90070,BB641CBF102512A21E2D52863882919C,19441,20,22,2,8,46,446
90084,90084,E05B5C52B64B71B8B169987ED3AF2DF3,42081,3,8,5,24,49,1249
90085,90085,E05B5C52B64B71B8B169987ED3AF2DF3,42071,9,10,1,31,49,1599
90086,90086,E05B5C52B64B71B8B169987ED3AF2DF3,42081,14,15,1,24,49,1249
90087,90087,E05B5C52B64B71B8B169987ED3AF2DF3,42071,17,19,2,31,49,1599
90088,90088,B55DB2025C7D6E56428DE796745638AE,11521,0,7,7,41,48,2098
90089,90089,B55DB2025C7D6E56428DE796745638AE,19114,9,14,5,7,43,393
90090,90090,B55DB2025C7D6E56428DE796745638AE,42051,18,19,1,42,48,2148
90091,90091,B55DB2025C7D6E56428DE796745638AE,11074,20,22,2,37,47,1897
90092,90092,2C992222ACB93CD1B2234E4466A7A38C,12651,0,1,1,43,47,2197
90093,90093,2C992222ACB93CD1B2234E4466A7A38C,41392,2,4,2,43,48,2198
90094,90094,2C992222ACB93CD1B2234E4466A7A38C,12651,4,8,4,43,47,2197
90095,90095,2C992222ACB93CD1B2234E4466A7A38C,10801,14,17,3,42,47,2147
90096,90096,2C992222ACB93CD1B2234E4466A7A38C,42471,18,19,1,35,49,1799
90097,90097,D256AE34DD31744D7365602849D9C40A,10341,0,3,3,31,47,1597
90098,90098,D256AE34DD31744D7365602849D9C40A,42491,3,7,4,32,46,1646
90099,90099,D256AE34DD31744D7365602849D9C40A,10841,8,9,1,37,47,1897
90100,90100,D256AE34DD31744D7365602849D9C40A,12601,15,16,1,25,47,1297
90101,90101,D256AE34DD31744D7365602849D9C40A,42491,17,22,5,32,46,1646
90111,90111,1DD07CF7FD5B3CCCB4E85025836774E4,12841,1,7,6,37,47,1897
90112,90112,1DD07CF7FD5B3CCCB4E85025836774E4,11231,7,11,4,37,49,1899
90113,90113,1DD07CF7FD5B3CCCB4E85025836774E4,11351,12,14,2,36,48,1848
90114,90114,1DD07CF7FD5B3CCCB4E85025836774E4,11231,14,17,3,37,49,1899
90115,90115,1DD07CF7FD5B3CCCB4E85025836774E4,42021,18,20,2,33,47,1697
90116,90116,1DD07CF7FD5B3CCCB4E85025836774E4,12841,21,22,1,37,47,1897
90117,90117,22E0CD429C1B1E7AC6170F90C318BE33,19114,0,5,5,7,43,393
90118,90118,22E0CD429C1B1E7AC6170F90C318BE33,12641,7,19,12,10,43,543
90119,90119,22E0CD429C1B1E7AC6170F90C318BE33,13941,20,22,2,41,47,2097
90120,90120,58FF60972C1637520443DC5766A2AB67,13411,0,4,4,49,42,2492
90121,90121,58FF60972C1637520443DC5766A2AB67,43951,6,8,2,49,41,2491
90122,90122,58FF60972C1637520443DC5766A2AB67,13411,12,16,4,49,42,2492
90123,90123,58FF60972C1637520443DC5766A2AB67,43951,16,17,1,49,41,2491
90124,90124,58FF60972C1637520443DC5766A2AB67,13411,18,23,5,49,42,2492
90125,90125,4E3C517E3D2C2E3E59295FE594C8A0D0,43761,0,8,8,32,47,1647
90126,90126,4E3C517E3D2C2E3E59295FE594C8A0D0,12391,12,15,3,36,49,1849
90127,90127,4E3C517E3D2C2E3E59295FE594C8A0D0,10901,15,17,2,35,48,1798
90128,90128,4E3C517E3D2C2E3E59295FE594C8A0D0,40697,19,22,3,43,48,2198
90138,90138,4F3F717E93BC5AFE00C4421DCBF0AA01,42301,0,9,9,36,47,1847
90139,90139,4F3F717E93BC5AFE00C4421DCBF0AA01,11261,12,15,3,36,46,1846
90140,90140,4F3F717E93BC5AFE00C4421DCBF0AA01,42864,15,17,2,38,44,1944
90141,90141,4F3F717E93BC5AFE00C4421DCBF0AA01,11261,17,18,1,36,46,1846
90142,90142,4F3F717E93BC5AFE00C4421DCBF0AA01,40322,20,22,2,38,46,1946
90143,90143,85AF3F568DC121A84EF6CC84157293A0,12651,0,7,7,43,47,2197
90144,90144,85AF3F568DC121A84EF6CC84157293A0,13111,7,10,3,42,46,2146
90145,90145,85AF3F568DC121A84EF6CC84157293A0,19021,10,16,6,10,45,545
90146,90146,85AF3F568DC121A84EF6CC84157293A0,11801,19,22,3,42,48,2148
90150,90150,5C772A747616DBF7CE2EDA1D1E9695C9,13671,0,7,7,27,43,1393
90151,90151,5C772A747616DBF7CE2EDA1D1E9695C9,12311,11,12,1,30,44,1544
90152,90152,5C772A747616DBF7CE2EDA1D1E9695C9,11381,15,17,2,30,47,1547
90153,90153,5C772A747616DBF7CE2EDA1D1E9695C9,13671,21,23,2,27,43,1393
90154,90154,2533C59D178CE851BF8EB714FE63A29E,12311,0,4,4,30,44,1544
90155,90155,2533C59D178CE851BF8EB714FE63A29E,10301,4,5,1,31,45,1595
90156,90156,2533C59D178CE851BF8EB714FE63A29E,12311,9,10,1,30,44,1544
90157,90157,2533C59D178CE851BF8EB714FE63A29E,10631,19,20,1,28,46,1446
90158,90158,2533C59D178CE851BF8EB714FE63A29E,12311,20,23,3,30,44,1544
90159,90159,4FA7E2AF35091649A8D61648BF92F5C0,42581,0,6,6,38,48,1948
90160,90160,4FA7E2AF35091649A8D61648BF92F5C0,10471,7,10,3,37,48,1898
90161,90161,4FA7E2AF35091649A8D61648BF92F5C0,42581,13,16,3,38,48,1948
90162,90162,4FA7E2AF35091649A8D61648BF92F5C0,13651,18,19,1,30,47,1547
90163,90163,51898DE5E0965BE533E51C9BF9FEF431,13511,0,2,2,34,48,1748
90164,90164,51898DE5E0965BE533E51C9BF9FEF431,11161,2,9,7,32,48,1648
90165,90165,51898DE5E0965BE533E51C9BF9FEF431,19744,14,15,1,6,43,343
90166,90166,51898DE5E0965BE533E51C9BF9FEF431,10634,15,17,2,27,45,1395
90167,90167,51898DE5E0965BE533E51C9BF9FEF431,19114,22,23,1,7,43,393
90175,90175,110EB8ED5B33FF374638B480C238C00D,10271,0,5,5,37,46,1896
90176,90176,110EB8ED5B33FF374638B480C238C00D,19744,9,17,8,6,43,343
90177,90177,110EB8ED5B33FF374638B480C238C00D,10271,19,21,2,37,46,1896
90185,90185,E6AB07C9B4BB739382103AE9E98B473D,43311,0,6,6,31,48,1598
90186,90186,E6AB07C9B4BB739382103AE9E98B473D,10681,6,8,2,30,48,1548
90187,90187,E6AB07C9B4BB739382103AE9E98B473D,43311,11,15,4,31,48,1598
90188,90188,E6AB07C9B4BB739382103AE9E98B473D,10681,16,17,1,30,48,1548
90189,90189,E6AB07C9B4BB739382103AE9E98B473D,43311,20,23,3,31,48,1598
90190,90190,99ABF293A45A6D4D0D6074565A60DF8B,11061,8,10,2,29,48,1498
90191,90191,99ABF293A45A6D4D0D6074565A60DF8B,42081,10,11,1,24,49,1249
90192,90192,99ABF293A45A6D4D0D6074565A60DF8B,42071,12,14,2,31,49,1599
90193,90193,99ABF293A45A6D4D0D6074565A60DF8B,43391,18,20,2,29,48,1498
90194,90194,99ABF293A45A6D4D0D6074565A60DF8B,42071,22,23,1,31,49,1599
90195,90195,5A3DFD82E1FA00FA267419BADF9C897C,12311,0,1,1,30,44,1544
90196,90196,5A3DFD82E1FA00FA267419BADF9C897C,42151,3,9,6,35,45,1795
90197,90197,5A3DFD82E1FA00FA267419BADF9C897C,12311,11,22,11,30,44,1544
90214,90214,DE3ED7ABFC9FE02B5BFB00BB0A1DEA7E,11871,0,5,5,29,46,1496
90215,90215,DE3ED7ABFC9FE02B5BFB00BB0A1DEA7E,42871,6,7,1,30,45,1545
90216,90216,DE3ED7ABFC9FE02B5BFB00BB0A1DEA7E,11871,9,10,1,29,46,1496
90217,90217,DE3ED7ABFC9FE02B5BFB00BB0A1DEA7E,13651,13,14,1,30,47,1547
90218,90218,DE3ED7ABFC9FE02B5BFB00BB0A1DEA7E,11871,16,20,4,29,46,1496
90232,90232,2764B8ABB23930F22F4F0762C2A18E7E,13711,2,6,4,38,46,1946
90233,90233,2764B8ABB23930F22F4F0762C2A18E7E,42231,8,9,1,37,46,1896
90234,90234,2764B8ABB23930F22F4F0762C2A18E7E,42351,14,15,1,38,45,1945
90235,90235,2764B8ABB23930F22F4F0762C2A18E7E,42231,15,16,1,37,46,1896
90236,90236,2764B8ABB23930F22F4F0762C2A18E7E,11261,18,19,1,36,46,1846
90237,90237,AA541C733BB5F99408992FE5EC11F72D,13461,1,3,2,39,44,1994
90238,90238,AA541C733BB5F99408992FE5EC11F72D,42861,5,9,4,37,44,1894
90239,90239,AA541C733BB5F99408992FE5EC11F72D,13231,13,15,2,39,46,1996
90240,90240,AA541C733BB5F99408992FE5EC11F72D,42861,18,19,1,37,44,1894
90241,90241,AA541C733BB5F99408992FE5EC11F72D,11261,20,22,2,36,46,1846
90242,90242,06E3078189D1C0438C76C1F46065DEEE,10251,0,5,5,35,47,1797
90243,90243,06E3078189D1C0438C76C1F46065DEEE,11753,6,7,1,35,48,1798
90244,90244,06E3078189D1C0438C76C1F46065DEEE,12381,8,16,8,32,48,1648
90245,90245,06E3078189D1C0438C76C1F46065DEEE,43731,19,20,1,34,47,1747
90246,90246,06E3078189D1C0438C76C1F46065DEEE,10251,21,22,1,35,47,1797
90247,90247,787E2D15898542A785C91CF72E674285,42351,1,4,3,38,45,1945
90248,90248,787E2D15898542A785C91CF72E674285,11261,7,10,3,36,46,1846
90249,90249,787E2D15898542A785C91CF72E674285,13911,11,12,1,39,46,1996
90250,90250,787E2D15898542A785C91CF72E674285,11261,16,18,2,36,46,1846
90251,90251,787E2D15898542A785C91CF72E674285,42231,18,23,5,37,46,1896
90255,90255,60C29AF7C3E64535BDDCBC0E4FBECBB6,19114,0,6,6,7,43,393
90256,90256,60C29AF7C3E64535BDDCBC0E4FBECBB6,12601,8,12,4,25,47,1297
90257,90257,60C29AF7C3E64535BDDCBC0E4FBECBB6,19931,12,20,8,7,43,393
90264,90264,46CB095EF81B7090747D900A43220105,42071,0,6,6,31,49,1599
90265,90265,46CB095EF81B7090747D900A43220105,42261,7,8,1,25,49,1299
90266,90266,46CB095EF81B7090747D900A43220105,42071,9,23,14,31,49,1599
90267,90267,1ECB7758304FB0B6302614AF93330553,12311,0,1,1,30,44,1544
90268,90268,1ECB7758304FB0B6302614AF93330553,42531,1,3,2,31,45,1595
90269,90269,1ECB7758304FB0B6302614AF93330553,12311,4,7,3,30,44,1544
90270,90270,1ECB7758304FB0B6302614AF93330553,42531,8,10,2,31,45,1595
90271,90271,1ECB7758304FB0B6302614AF93330553,10801,17,18,1,42,47,2147
90272,90272,1ECB7758304FB0B6302614AF93330553,43341,19,21,2,41,46,2096
90276,90276,FACA7C472055342CB52356ECCA18D789,11261,0,7,7,36,46,1846
90277,90277,FACA7C472055342CB52356ECCA18D789,10401,8,9,1,33,49,1699
90278,90278,FACA7C472055342CB52356ECCA18D789,11261,11,13,2,36,46,1846
90279,90279,FACA7C472055342CB52356ECCA18D789,43341,13,17,4,41,46,2096
90280,90280,FACA7C472055342CB52356ECCA18D789,13841,21,23,2,40,46,2046
90284,90284,4E44BBC9D86CBF4CC3EC68EEA6825DB2,12601,0,7,7,25,47,1297
90285,90285,4E44BBC9D86CBF4CC3EC68EEA6825DB2,42481,7,9,2,22,49,1149
90286,90286,4E44BBC9D86CBF4CC3EC68EEA6825DB2,12051,12,14,2,20,47,1047
90287,90287,4E44BBC9D86CBF4CC3EC68EEA6825DB2,12601,19,23,4,25,47,1297
90295,90295,325A357395139488DFA9EB4942638C18,11201,0,1,1,35,49,1799
90296,90296,325A357395139488DFA9EB4942638C18,42271,1,13,12,40,47,2047
90297,90297,325A357395139488DFA9EB4942638C18,40402,16,23,7,41,46,2096
90298,90298,61D4369B95803102112EEFE32BD36465,10295,0,5,5,30,47,1547
90299,90299,61D4369B95803102112EEFE32BD36465,43761,7,8,1,32,47,1647
90300,90300,61D4369B95803102112EEFE32BD36465,10295,12,13,1,30,47,1547
90301,90301,61D4369B95803102112EEFE32BD36465,43761,16,17,1,32,47,1647
90302,90302,61D4369B95803102112EEFE32BD36465,10295,21,22,1,30,47,1547
90312,90312,322CE539ED904974E8EE0F36B9A9900D,11381,0,6,6,30,47,1547
90313,90313,322CE539ED904974E8EE0F36B9A9900D,10901,7,12,5,35,48,1798
90314,90314,322CE539ED904974E8EE0F36B9A9900D,11381,12,20,8,30,47,1547
90319,90319,BC71A128CC1D1FD204F1FA3A371EA53A,43021,0,6,6,16,43,843
90320,90320,BC71A128CC1D1FD204F1FA3A371EA53A,12921,7,9,2,9,41,491
90321,90321,BC71A128CC1D1FD204F1FA3A371EA53A,43021,11,14,3,16,43,843
90322,90322,BC71A128CC1D1FD204F1FA3A371EA53A,12921,17,18,1,9,41,491
90326,90326,C9AEC4984FB48AB111972A72575D06EF,42961,8,11,3,35,49,1799
90327,90327,C9AEC4984FB48AB111972A72575D06EF,10251,12,14,2,35,47,1797
90328,90328,C9AEC4984FB48AB111972A72575D06EF,10471,15,16,1,37,48,1898
90329,90329,C9AEC4984FB48AB111972A72575D06EF,11701,18,21,3,43,48,2198
90330,90330,EBA7165C555CC8E7F5C07D37A066F01A,11231,0,3,3,37,49,1899
90331,90331,EBA7165C555CC8E7F5C07D37A066F01A,11481,6,17,11,41,48,2098
90332,90332,EBA7165C555CC8E7F5C07D37A066F01A,42471,18,22,4,35,49,1799
90333,90333,9A32E318CA0CDE9DA0BCF043EF40ABC3,10511,0,8,8,35,46,1796
90334,90334,9A32E318CA0CDE9DA0BCF043EF40ABC3,12381,12,14,2,32,48,1648
90335,90335,9A32E318CA0CDE9DA0BCF043EF40ABC3,12514,19,21,2,38,47,1947
90336,90336,9E8650B76E9047B63AD694EBC9D1BFBC,42321,0,5,5,43,47,2197
90337,90337,9E8650B76E9047B63AD694EBC9D1BFBC,10631,7,15,8,28,46,1446
90338,90338,9E8650B76E9047B63AD694EBC9D1BFBC,10634,18,19,1,27,45,1395
90339,90339,5F58C4D7485728C14537C34BCAAAA812,12514,0,8,8,38,47,1947
90340,90340,5F58C4D7485728C14537C34BCAAAA812,42461,9,11,2,45,47,2297
90341,90341,5F58C4D7485728C14537C34BCAAAA812,42201,12,23,11,43,46,2196
90342,90342,B304D2AD98C7DE24CAE6DD0DA65095F0,10431,0,6,6,33,49,1699
90343,90343,B304D2AD98C7DE24CAE6DD0DA65095F0,42161,7,8,1,36,47,1847
90344,90344,B304D2AD98C7DE24CAE6DD0DA65095F0,42491,8,17,9,32,46,1646
90345,90345,B304D2AD98C7DE24CAE6DD0DA65095F0,10431,21,22,1,33,49,1699
90352,90352,401DBF9291C70DB6E3FE8385830F996E,13791,0,7,7,42,47,2147
90353,90353,401DBF9291C70DB6E3FE8385830F996E,10221,9,12,3,34,49,1749
90354,90354,401DBF9291C70DB6E3FE8385830F996E,11021,12,14,2,36,49,1849
90355,90355,401DBF9291C70DB6E3FE8385830F996E,11201,17,20,3,35,49,1799
90360,90360,0A252836FA6DFCFDFC50B5267919BF05,43021,1,3,2,16,43,843
90361,90361,0A252836FA6DFCFDFC50B5267919BF05,12731,3,4,1,22,40,1140
90362,90362,0A252836FA6DFCFDFC50B5267919BF05,43021,5,23,18,16,43,843
90363,90363,53839C09BE15657631CB9A16E38A78CA,42931,2,7,5,41,49,2099
90364,90364,53839C09BE15657631CB9A16E38A78CA,11021,11,12,1,36,49,1849
90365,90365,53839C09BE15657631CB9A16E38A78CA,11481,14,15,1,41,48,2098
90366,90366,53839C09BE15657631CB9A16E38A78CA,41601,18,20,2,39,49,1999
90367,90367,53839C09BE15657631CB9A16E38A78CA,10421,20,22,2,41,48,2098
90368,90368,D5D027DEC2E15CD439B6E37A42DFD8C1,43021,0,3,3,16,43,843
90369,90369,D5D027DEC2E15CD439B6E37A42DFD8C1,12921,3,12,9,9,41,491
90370,90370,D5D027DEC2E15CD439B6E37A42DFD8C1,43021,13,15,2,16,43,843
90371,90371,D5D027DEC2E15CD439B6E37A42DFD8C1,12921,18,20,2,9,41,491
90372,90372,439D8CB010A4086802C0243322BA6C31,42221,0,6,6,38,48,1948
90373,90373,439D8CB010A4086802C0243322BA6C31,40343,8,17,9,24,49,1249
90374,90374,439D8CB010A4086802C0243322BA6C31,11061,17,20,3,29,48,1498
90375,90375,76254CADB829C1987D9520725150FC5C,10292,0,8,8,30,47,1547
90376,90376,76254CADB829C1987D9520725150FC5C,11875,9,10,1,30,46,1546
90377,90377,76254CADB829C1987D9520725150FC5C,13651,12,14,2,30,47,1547
90378,90378,76254CADB829C1987D9520725150FC5C,11875,14,15,1,30,46,1546
90379,90379,76254CADB829C1987D9520725150FC5C,42491,17,19,2,32,46,1646
90380,90380,CC7A1157903C1BC812AE9213C142B167,11171,0,7,7,33,48,1698
90381,90381,CC7A1157903C1BC812AE9213C142B167,12481,12,17,5,37,49,1899
90382,90382,CC7A1157903C1BC812AE9213C142B167,42301,18,19,1,36,47,1847
90383,90383,BAF87A0BC01C594FFAC1B35DD77FCF62,10471,1,5,4,37,48,1898
90384,90384,BAF87A0BC01C594FFAC1B35DD77FCF62,11461,5,10,5,37,49,1899
90385,90385,BAF87A0BC01C594FFAC1B35DD77FCF62,10471,12,13,1,37,48,1898
90386,90386,BAF87A0BC01C594FFAC1B35DD77FCF62,11231,15,18,3,37,49,1899
90387,90387,BAF87A0BC01C594FFAC1B35DD77FCF62,10471,20,23,3,37,48,1898
90397,90397,7A76A29B0C5938507D66F694FFA423BC,43761,0,9,9,32,47,1647
90398,90398,7A76A29B0C5938507D66F694FFA423BC,12161,11,12,1,32,46,1646
90399,90399,7A76A29B0C5938507D66F694FFA423BC,43761,13,14,1,32,47,1647
90400,90400,7A76A29B0C5938507D66F694FFA423BC,42523,15,17,2,31,47,1597
90401,90401,7A76A29B0C5938507D66F694FFA423BC,43761,18,21,3,32,47,1647
90405,90405,5F3681CA154176D9C587280037CBB99D,13561,0,9,9,37,49,1899
90406,90406,5F3681CA154176D9C587280037CBB99D,13091,12,18,6,20,42,1042
90407,90407,5F3681CA154176D9C587280037CBB99D,42471,19,20,1,35,49,1799
90408,90408,5F3681CA154176D9C587280037CBB99D,11531,22,23,1,34,49,1749
90412,90412,3E351ABACF5670F218BE0092A1FF748D,40343,0,14,14,24,49,1249
90413,90413,3E351ABACF5670F218BE0092A1FF748D,43761,15,17,2,32,47,1647
90414,90414,3E351ABACF5670F218BE0092A1FF748D,40343,19,23,4,24,49,1249
90415,90415,146F677EF89DD87D7647AA336D435E29,16184,0,12,12,1,1,51
90416,90416,146F677EF89DD87D7647AA336D435E29,13711,17,18,1,38,46,1946
90417,90417,146F677EF89DD87D7647AA336D435E29,16184,22,23,1,1,1,51
90418,90418,F85AEC7F2B6BE80F2F5A235C92416095,42201,0,7,7,43,46,2196
90419,90419,F85AEC7F2B6BE80F2F5A235C92416095,11331,9,15,6,37,48,1898
90420,90420,F85AEC7F2B6BE80F2F5A235C92416095,10251,19,20,1,35,47,1797
90421,90421,9A5138FE50A5516A3590C769AAB53571,40302,0,7,7,40,49,2049
90422,90422,9A5138FE50A5516A3590C769AAB53571,11875,9,11,2,30,46,1546
90423,90423,9A5138FE50A5516A3590C769AAB53571,40302,12,20,8,40,49,2049
90443,90443,725F4DF1678770995D2853C4CA844B3D,43761,0,1,1,32,47,1647
90444,90444,725F4DF1678770995D2853C4CA844B3D,12311,2,3,1,30,44,1544
90445,90445,725F4DF1678770995D2853C4CA844B3D,43761,3,10,7,32,47,1647
90446,90446,725F4DF1678770995D2853C4CA844B3D,11151,11,12,1,30,48,1548
90447,90447,725F4DF1678770995D2853C4CA844B3D,43761,14,18,4,32,47,1647
90448,90448,725F4DF1678770995D2853C4CA844B3D,10731,18,20,2,33,47,1697
90458,90458,AAC98D8EB5664A9B5DE56F266CB31991,16281,0,12,12,11,4,554
90459,90459,AAC98D8EB5664A9B5DE56F266CB31991,15143,13,18,5,18,7,907
90460,90460,AAC98D8EB5664A9B5DE56F266CB31991,16281,18,21,3,11,4,554
90461,90461,27040DAA07D6DC64DCD4E5DE780283DD,42071,1,12,11,31,49,1599
90462,90462,27040DAA07D6DC64DCD4E5DE780283DD,42081,13,19,6,24,49,1249
90463,90463,27040DAA07D6DC64DCD4E5DE780283DD,42071,19,22,3,31,49,1599
90464,90464,CADE9ADEC7B1B2F6454293174DEADF86,10681,0,7,7,30,48,1548
90465,90465,CADE9ADEC7B1B2F6454293174DEADF86,11531,13,14,1,34,49,1749
90466,90466,CADE9ADEC7B1B2F6454293174DEADF86,10681,19,21,2,30,48,1548
90467,90467,942A242C54C5AF79C66351D8C7F17676,42691,0,10,10,24,48,1248
90468,90468,942A242C54C5AF79C66351D8C7F17676,42161,12,13,1,36,47,1847
90469,90469,942A242C54C5AF79C66351D8C7F17676,43161,14,17,3,35,47,1797
90470,90470,942A242C54C5AF79C66351D8C7F17676,10451,21,22,1,25,48,1298
90471,90471,6CC24D921FE70D79D98FA5B7890BCB55,42041,1,2,1,10,47,547
90472,90472,6CC24D921FE70D79D98FA5B7890BCB55,19441,3,6,3,8,46,446
90473,90473,6CC24D921FE70D79D98FA5B7890BCB55,11471,9,12,3,12,48,648
90474,90474,6CC24D921FE70D79D98FA5B7890BCB55,42041,15,17,2,10,47,547
90475,90475,6CC24D921FE70D79D98FA5B7890BCB55,19061,21,23,2,3,43,193
90482,90482,8F2DCDB1E6ACA3D4E7FFFCA1E99BF72D,13651,0,3,3,30,47,1547
90483,90483,8F2DCDB1E6ACA3D4E7FFFCA1E99BF72D,42491,3,7,4,32,46,1646
90484,90484,8F2DCDB1E6ACA3D4E7FFFCA1E99BF72D,10292,7,9,2,30,47,1547
90485,90485,8F2DCDB1E6ACA3D4E7FFFCA1E99BF72D,43161,9,11,2,35,47,1797
90486,90486,8F2DCDB1E6ACA3D4E7FFFCA1E99BF72D,42021,13,14,1,33,47,1697
90487,90487,8F2DCDB1E6ACA3D4E7FFFCA1E99BF72D,43161,14,20,6,35,47,1797
90488,90488,4BEB96C1A6F8B99181CDADEF48D75275,42501,0,6,6,28,47,1447
90489,90489,4BEB96C1A6F8B99181CDADEF48D75275,42081,10,18,8,24,49,1249
90490,90490,4BEB96C1A6F8B99181CDADEF48D75275,42501,21,23,2,28,47,1447
90491,90491,604AAF4555B85DE6F1339E606D4F2175,42111,0,6,6,44,46,2246
90492,90492,604AAF4555B85DE6F1339E606D4F2175,42523,7,16,9,31,47,1597
90493,90493,604AAF4555B85DE6F1339E606D4F2175,42111,21,23,2,44,46,2246
90494,90494,9EA9C4745504CCAD164282FBEC0BBEB2,10751,0,6,6,47,43,2393
90495,90495,9EA9C4745504CCAD164282FBEC0BBEB2,12211,10,18,8,41,44,2094
90496,90496,9EA9C4745504CCAD164282FBEC0BBEB2,13341,18,22,4,44,45,2245
90501,90501,A53DAA006542212C0F792E33874BF547,11661,0,11,11,40,49,2049
90502,90502,A53DAA006542212C0F792E33874BF547,10231,13,16,3,39,49,1999
90503,90503,A53DAA006542212C0F792E33874BF547,10971,17,22,5,35,47,1797
90504,90504,081C42D8164EA39CD76978886CD1161E,12514,7,10,3,38,47,1947
90505,90505,081C42D8164EA39CD76978886CD1161E,11551,11,13,2,39,49,1999
90506,90506,081C42D8164EA39CD76978886CD1161E,11301,16,18,2,41,49,2099
90507,90507,081C42D8164EA39CD76978886CD1161E,10841,19,23,4,37,47,1897
90508,90508,AD24687CE009DD38418E30D2A06E4D4E,10121,0,9,9,36,49,1849
90509,90509,AD24687CE009DD38418E30D2A06E4D4E,13511,9,10,1,34,48,1748
90510,90510,AD24687CE009DD38418E30D2A06E4D4E,42941,12,13,1,37,47,1897
90511,90511,AD24687CE009DD38418E30D2A06E4D4E,11791,14,17,3,38,49,1949
90512,90512,AD24687CE009DD38418E30D2A06E4D4E,10121,22,23,1,36,49,1849
90516,90516,6606CC80A620FB56A8D3818C167DB7F4,10151,10,12,2,34,47,1747
90517,90517,6606CC80A620FB56A8D3818C167DB7F4,11871,12,14,2,29,46,1496
90518,90518,6606CC80A620FB56A8D3818C167DB7F4,10251,19,21,2,35,47,1797
90519,90519,6606CC80A620FB56A8D3818C167DB7F4,11871,21,23,2,29,46,1496
90523,90523,4A13D317408FAA25E5E85E9637D26642,10811,0,7,7,38,46,1946
90524,90524,4A13D317408FAA25E5E85E9637D26642,11541,8,10,2,35,49,1799
90525,90525,4A13D317408FAA25E5E85E9637D26642,11531,15,16,1,34,49,1749
90526,90526,4A13D317408FAA25E5E85E9637D26642,10811,19,23,4,38,46,1946
90527,90527,1522BDE7E05C3ADAA9D8391F632D7715,11361,0,5,5,22,48,1148
90528,90528,1522BDE7E05C3ADAA9D8391F632D7715,12581,7,9,2,24,48,1248
90529,90529,1522BDE7E05C3ADAA9D8391F632D7715,11361,11,14,3,22,48,1148
90530,90530,1522BDE7E05C3ADAA9D8391F632D7715,12051,14,16,2,20,47,1047
90531,90531,1522BDE7E05C3ADAA9D8391F632D7715,11361,20,23,3,22,48,1148
90532,90532,FB58E1CF4021B7476C59A06E20470DB9,42071,2,12,10,31,49,1599
90533,90533,FB58E1CF4021B7476C59A06E20470DB9,42081,12,14,2,24,49,1249
90534,90534,FB58E1CF4021B7476C59A06E20470DB9,42071,15,19,4,31,49,1599
90535,90535,718F9C02C6A67F792D4A34A4E958BCFE,10221,0,3,3,34,49,1749
90536,90536,718F9C02C6A67F792D4A34A4E958BCFE,12511,6,7,1,39,47,1997
90537,90537,718F9C02C6A67F792D4A34A4E958BCFE,13221,8,9,1,40,47,2047
90538,90538,718F9C02C6A67F792D4A34A4E958BCFE,12511,16,17,1,39,47,1997
90539,90539,718F9C02C6A67F792D4A34A4E958BCFE,43671,20,23,3,35,48,1798
90540,90540,9B49BEB65E16F10DE8E30D5D01D652E3,10811,0,9,9,38,46,1946
90541,90541,9B49BEB65E16F10DE8E30D5D01D652E3,12311,12,18,6,30,44,1544
90542,90542,9B49BEB65E16F10DE8E30D5D01D652E3,42011,20,21,1,36,46,1846
90543,90543,9B49BEB65E16F10DE8E30D5D01D652E3,10811,22,23,1,38,46,1946
90544,90544,7D111EF394DB5CCF734BDAA3C199167B,43021,1,4,3,16,43,843
90545,90545,7D111EF394DB5CCF734BDAA3C199167B,19021,5,11,6,10,45,545
90546,90546,7D111EF394DB5CCF734BDAA3C199167B,19441,13,18,5,8,46,446
90547,90547,181802B57A29F4FAE1E7EF60B334A9D5,13911,0,4,4,39,46,1996
90548,90548,181802B57A29F4FAE1E7EF60B334A9D5,11261,5,8,3,36,46,1846
90549,90549,181802B57A29F4FAE1E7EF60B334A9D5,13911,8,9,1,39,46,1996
90550,90550,181802B57A29F4FAE1E7EF60B334A9D5,11261,10,11,1,36,46,1846
90551,90551,181802B57A29F4FAE1E7EF60B334A9D5,13911,12,21,9,39,46,1996
90552,90552,67647AB269DDC246D19A34E703D72B5C,42871,0,16,16,30,45,1545
90553,90553,67647AB269DDC246D19A34E703D72B5C,11211,19,20,1,34,49,1749
90554,90554,67647AB269DDC246D19A34E703D72B5C,42871,21,23,2,30,45,1545
90558,90558,E5BE9C6FCF7FADF4DEA66537816E35CE,43161,0,7,7,35,47,1797
90559,90559,E5BE9C6FCF7FADF4DEA66537816E35CE,42301,8,9,1,36,47,1847
90560,90560,E5BE9C6FCF7FADF4DEA66537816E35CE,43161,12,14,2,35,47,1797
90561,90561,E5BE9C6FCF7FADF4DEA66537816E35CE,10651,18,20,2,36,49,1849
90562,90562,E5BE9C6FCF7FADF4DEA66537816E35CE,10281,21,23,2,33,48,1698
90563,90563,B217126F85B5F090E7D376CA23C6FEE9,11231,0,1,1,37,49,1899
90564,90564,B217126F85B5F090E7D376CA23C6FEE9,43161,3,4,1,35,47,1797
90565,90565,B217126F85B5F090E7D376CA23C6FEE9,13601,4,9,5,34,47,1747
90566,90566,B217126F85B5F090E7D376CA23C6FEE9,43761,13,15,2,32,47,1647
90567,90567,B217126F85B5F090E7D376CA23C6FEE9,10151,17,18,1,34,47,1747
90568,90568,B217126F85B5F090E7D376CA23C6FEE9,43471,21,23,2,31,49,1599
90572,90572,DFB39D9C16979A7A210D773BBB4B6305,12083,0,1,1,36,49,1849
90573,90573,DFB39D9C16979A7A210D773BBB4B6305,42351,3,21,18,38,45,1945
90574,90574,DFB39D9C16979A7A210D773BBB4B6305,13911,21,23,2,39,46,1996
90579,90579,B9BA9C4A9A58FB97E9FBCEF8809D76A7,12921,0,4,4,9,41,491
90580,90580,B9BA9C4A9A58FB97E9FBCEF8809D76A7,10221,8,17,9,34,49,1749
90581,90581,B9BA9C4A9A58FB97E9FBCEF8809D76A7,19021,20,21,1,10,45,545
90582,90582,DB3C92167D7C02EAB46060E4569D1D1B,12651,0,7,7,43,47,2197
90583,90583,DB3C92167D7C02EAB46060E4569D1D1B,11231,12,17,5,37,49,1899
90584,90584,DB3C92167D7C02EAB46060E4569D1D1B,11481,18,19,1,41,48,2098
90588,90588,DAF070E37522449552E837969D087804,10491,0,6,6,33,48,1698
90589,90589,DAF070E37522449552E837969D087804,11231,7,11,4,37,49,1899
90590,90590,DAF070E37522449552E837969D087804,10491,11,13,2,33,48,1698
90591,90591,DAF070E37522449552E837969D087804,11231,14,21,7,37,49,1899
90592,90592,DAF070E37522449552E837969D087804,10491,21,22,1,33,48,1698
90593,90593,C4CF162A657A7BAE13927070E3B5DFDA,13071,2,7,5,41,41,2091
90594,90594,C4CF162A657A7BAE13927070E3B5DFDA,43451,10,21,11,37,40,1890
90595,90595,C4CF162A657A7BAE13927070E3B5DFDA,13071,21,23,2,41,41,2091
90599,90599,1008DFEE7FA4E4148BDEB87B309051E2,11061,8,9,1,29,48,1498
90600,90600,1008DFEE7FA4E4148BDEB87B309051E2,11111,10,19,9,26,48,1348
90601,90601,1008DFEE7FA4E4148BDEB87B309051E2,41724,20,21,1,38,48,1948
90606,90606,C7DA09D84BB6D5A3ABEAD976C8C0731E,42861,0,5,5,37,44,1894
90607,90607,C7DA09D84BB6D5A3ABEAD976C8C0731E,11261,9,10,1,36,46,1846
90608,90608,C7DA09D84BB6D5A3ABEAD976C8C0731E,42861,11,13,2,37,44,1894
90609,90609,C7DA09D84BB6D5A3ABEAD976C8C0731E,11261,14,15,1,36,46,1846
90610,90610,C7DA09D84BB6D5A3ABEAD976C8C0731E,42861,19,22,3,37,44,1894
90614,90614,518D5FA443BE4CD4AC0BE1EE454FCBAE,12731,0,10,10,22,40,1140
90615,90615,518D5FA443BE4CD4AC0BE1EE454FCBAE,13671,12,14,2,27,43,1393
90616,90616,518D5FA443BE4CD4AC0BE1EE454FCBAE,12731,19,22,3,22,40,1140
90621,90621,D14484DB6515E86DA2EC37443AB9F264,13911,0,4,4,39,46,1996
90622,90622,D14484DB6515E86DA2EC37443AB9F264,11261,4,18,14,36,46,1846
90623,90623,D14484DB6515E86DA2EC37443AB9F264,13821,22,23,1,49,45,2495
90627,90627,AEFE66901F8D1843F747168E1F2C69AE,11914,3,4,1,37,48,1898
90628,90628,AEFE66901F8D1843F747168E1F2C69AE,43181,9,10,1,39,48,1998
90629,90629,AEFE66901F8D1843F747168E1F2C69AE,11914,10,11,1,37,48,1898
90630,90630,AEFE66901F8D1843F747168E1F2C69AE,43181,12,13,1,39,48,1998
90631,90631,AEFE66901F8D1843F747168E1F2C69AE,11914,16,19,3,37,48,1898
90639,90639,9259900CF1484CEAFCB0BE9321BC8694,10401,0,1,1,33,49,1699
90640,90640,9259900CF1484CEAFCB0BE9321BC8694,10691,6,7,1,33,48,1698
90641,90641,9259900CF1484CEAFCB0BE9321BC8694,10471,8,11,3,37,48,1898
90642,90642,9259900CF1484CEAFCB0BE9321BC8694,11231,11,19,8,37,49,1899
90643,90643,9259900CF1484CEAFCB0BE9321BC8694,10691,20,22,2,33,48,1698
90659,90659,84E097DF782FE990259E1DE5027828BD,40463,0,7,7,38,49,1949
90660,90660,84E097DF782FE990259E1DE5027828BD,40201,8,15,7,32,49,1649
90661,90661,84E097DF782FE990259E1DE5027828BD,13371,18,23,5,41,47,2097
90662,90662,5BF2E48B25609217F8588AE451592E57,11431,0,6,6,29,47,1497
90663,90663,5BF2E48B25609217F8588AE451592E57,12584,12,14,2,24,48,1248
90664,90664,5BF2E48B25609217F8588AE451592E57,10951,14,19,5,29,48,1498
90665,90665,5BF2E48B25609217F8588AE451592E57,11431,20,23,3,29,47,1497
90666,90666,A5A090591E63A367211B3058D6F881BC,12921,2,3,1,9,41,491
90667,90667,A5A090591E63A367211B3058D6F881BC,43021,5,6,1,16,43,843
90668,90668,A5A090591E63A367211B3058D6F881BC,12921,6,7,1,9,41,491
90669,90669,A5A090591E63A367211B3058D6F881BC,11021,14,17,3,36,49,1849
90670,90670,A5A090591E63A367211B3058D6F881BC,43021,19,21,2,16,43,843
90671,90671,483A60ABF20D1FCCF22B9C55FFDC179A,42071,5,6,1,31,49,1599
90672,90672,483A60ABF20D1FCCF22B9C55FFDC179A,42623,7,9,2,22,49,1149
90673,90673,483A60ABF20D1FCCF22B9C55FFDC179A,42071,10,21,11,31,49,1599
90674,90674,D227D6EA815AD3E534730A42BDF45066,42631,0,8,8,43,45,2195
90675,90675,D227D6EA815AD3E534730A42BDF45066,43951,8,15,7,49,41,2491
90676,90676,D227D6EA815AD3E534730A42BDF45066,42631,20,23,3,43,45,2195
90677,90677,E311A49FD79CE1E67702DBA9B7887B92,12641,0,6,6,10,43,543
90678,90678,E311A49FD79CE1E67702DBA9B7887B92,19021,6,8,2,10,45,545
90679,90679,E311A49FD79CE1E67702DBA9B7887B92,43021,10,12,2,16,43,843
90680,90680,E311A49FD79CE1E67702DBA9B7887B92,19021,14,16,2,10,45,545
90681,90681,E311A49FD79CE1E67702DBA9B7887B92,12641,18,21,3,10,43,543
90682,90682,5CE5B38C43463AB4DE2D4D106DC3D232,13111,0,12,12,42,46,2146
90683,90683,5CE5B38C43463AB4DE2D4D106DC3D232,43161,12,20,8,35,47,1797
90684,90684,5CE5B38C43463AB4DE2D4D106DC3D232,13111,21,23,2,42,46,2146
90689,90689,E8D3EFCC44481182637CB68B61639643,15051,0,6,6,19,4,954
90690,90690,E8D3EFCC44481182637CB68B61639643,16281,8,11,3,11,4,554
90691,90691,E8D3EFCC44481182637CB68B61639643,15051,11,12,1,19,4,954
90692,90692,E8D3EFCC44481182637CB68B61639643,16281,12,14,2,11,4,554
90693,90693,E8D3EFCC44481182637CB68B61639643,15051,15,20,5,19,4,954
90697,90697,C135D0CC048BFF7E971403A8703667AE,10351,0,1,1,28,45,1445
90698,90698,C135D0CC048BFF7E971403A8703667AE,10711,1,4,3,29,46,1496
90699,90699,C135D0CC048BFF7E971403A8703667AE,19441,7,17,10,8,46,446
90700,90700,C135D0CC048BFF7E971403A8703667AE,10351,19,21,2,28,45,1445
90701,90701,DB360EB4175B7811C3AFD1BD0E9AC4DA,10771,3,9,6,41,46,2096
90702,90702,DB360EB4175B7811C3AFD1BD0E9AC4DA,13094,12,13,1,21,42,1092
90703,90703,DB360EB4175B7811C3AFD1BD0E9AC4DA,12521,16,22,6,35,41,1791
90707,90707,3AAB646736804F2C3C62D48784909771,42921,0,8,8,33,47,1697
90708,90708,3AAB646736804F2C3C62D48784909771,13371,9,18,9,41,47,2097
90709,90709,3AAB646736804F2C3C62D48784909771,13601,21,22,1,34,47,1747
90710,90710,C5AC3744EA191771220A3FE471A7FACC,42161,0,7,7,36,47,1847
90711,90711,C5AC3744EA191771220A3FE471A7FACC,19024,9,15,6,9,45,495
90712,90712,C5AC3744EA191771220A3FE471A7FACC,42161,20,23,3,36,47,1847
90713,90713,55E490B3039AD9BC5768906A0D6AA0A2,11151,0,11,11,30,48,1548
90714,90714,55E490B3039AD9BC5768906A0D6AA0A2,11061,11,13,2,29,48,1498
90715,90715,55E490B3039AD9BC5768906A0D6AA0A2,11151,13,21,8,30,48,1548
90716,90716,55E490B3039AD9BC5768906A0D6AA0A2,42121,21,22,1,26,49,1349
90717,90717,BB3DB8BDA13F245F7DA1B278DE6D4FF0,43021,0,4,4,16,43,843
90718,90718,BB3DB8BDA13F245F7DA1B278DE6D4FF0,12921,6,8,2,9,41,491
90719,90719,BB3DB8BDA13F245F7DA1B278DE6D4FF0,12641,8,10,2,10,43,543
90720,90720,BB3DB8BDA13F245F7DA1B278DE6D4FF0,12921,14,19,5,9,41,491
90721,90721,BB3DB8BDA13F245F7DA1B278DE6D4FF0,43021,19,23,4,16,43,843
90722,90722,020D48C5A42B6569AEEF3362634FD199,42623,7,8,1,22,49,1149
90723,90723,020D48C5A42B6569AEEF3362634FD199,13951,13,14,1,47,45,2395
90724,90724,020D48C5A42B6569AEEF3362634FD199,41271,19,21,2,38,48,1948
90725,90725,BF19E34EF22C25E20CB766DD1F94922D,43751,0,13,13,19,48,998
90726,90726,BF19E34EF22C25E20CB766DD1F94922D,12581,15,17,2,24,48,1248
90727,90727,BF19E34EF22C25E20CB766DD1F94922D,43751,17,23,6,19,48,998
90731,90731,7D0B5FCD22D145BBE916FD977FC9A1B6,10111,0,7,7,37,47,1897
90732,90732,7D0B5FCD22D145BBE916FD977FC9A1B6,12971,9,17,8,32,48,1648
90733,90733,7D0B5FCD22D145BBE916FD977FC9A1B6,10111,18,21,3,37,47,1897
90734,90734,3C32EE6DB398BD5342CD85CC4002B6C2,11061,2,8,6,29,48,1498
90735,90735,3C32EE6DB398BD5342CD85CC4002B6C2,42541,9,15,6,25,47,1297
90736,90736,3C32EE6DB398BD5342CD85CC4002B6C2,10111,17,23,6,37,47,1897
90737,90737,466DCF1406EFBC3DC226AF4CB46068CC,19181,3,5,2,8,40,440
90738,90738,466DCF1406EFBC3DC226AF4CB46068CC,12641,6,7,1,10,43,543
90739,90739,466DCF1406EFBC3DC226AF4CB46068CC,19901,12,15,3,7,44,394
90740,90740,466DCF1406EFBC3DC226AF4CB46068CC,19181,17,19,2,8,40,440
90741,90741,AC515A6DB87687D196B4E3D3A76C6816,11211,0,3,3,34,49,1749
90742,90742,AC515A6DB87687D196B4E3D3A76C6816,11541,5,6,1,35,49,1799
90743,90743,AC515A6DB87687D196B4E3D3A76C6816,13561,8,9,1,37,49,1899
90744,90744,AC515A6DB87687D196B4E3D3A76C6816,11541,13,16,3,35,49,1799
90745,90745,AC515A6DB87687D196B4E3D3A76C6816,10221,19,22,3,34,49,1749
90746,90746,03FE0D0BD52A528C1B4DF1F3C44F085B,42351,0,1,1,38,45,1945
90747,90747,03FE0D0BD52A528C1B4DF1F3C44F085B,42231,2,8,6,37,46,1896
90748,90748,03FE0D0BD52A528C1B4DF1F3C44F085B,42351,12,14,2,38,45,1945
90749,90749,03FE0D0BD52A528C1B4DF1F3C44F085B,11261,14,16,2,36,46,1846
90750,90750,03FE0D0BD52A528C1B4DF1F3C44F085B,42351,17,19,2,38,45,1945
90751,90751,03FE0D0BD52A528C1B4DF1F3C44F085B,11261,19,20,1,36,46,1846
90752,90752,03FE0D0BD52A528C1B4DF1F3C44F085B,42351,20,23,3,38,45,1945
90753,90753,3536272718DEA79ABD008A016BEF1A97,10721,0,13,13,31,48,1598
90754,90754,3536272718DEA79ABD008A016BEF1A97,11751,14,16,2,35,48,1798
90755,90755,3536272718DEA79ABD008A016BEF1A97,40951,20,22,2,36,49,1849
90756,90756,3B5AEA05F36216184217F6895629427A,19744,3,5,2,6,43,343
90757,90757,3B5AEA05F36216184217F6895629427A,12641,8,10,2,10,43,543
90758,90758,3B5AEA05F36216184217F6895629427A,19031,10,11,1,1,42,92
90759,90759,3B5AEA05F36216184217F6895629427A,12641,12,16,4,10,43,543
90760,90760,3B5AEA05F36216184217F6895629427A,19031,20,22,2,1,42,92
90761,90761,C1A86408F22C4A96CA9DED3C9439B426,10721,0,8,8,31,48,1598
90762,90762,C1A86408F22C4A96CA9DED3C9439B426,10621,17,19,2,41,49,2099
90763,90763,C1A86408F22C4A96CA9DED3C9439B426,10721,22,23,1,31,48,1598
90764,90764,F270E2429049EC12B817A3B7398AF53A,13561,0,1,1,37,49,1899
90765,90765,F270E2429049EC12B817A3B7398AF53A,10111,4,15,11,37,47,1897
90766,90766,F270E2429049EC12B817A3B7398AF53A,42151,15,17,2,35,45,1795
90767,90767,F270E2429049EC12B817A3B7398AF53A,10111,19,23,4,37,47,1897
90771,90771,BAF8CBAEABDF4063FF5ED369E100E588,12083,0,11,11,36,49,1849
90772,90772,BAF8CBAEABDF4063FF5ED369E100E588,11161,12,20,8,32,48,1648
90773,90773,BAF8CBAEABDF4063FF5ED369E100E588,12083,20,23,3,36,49,1849
90774,90774,FBFB039BFE202B4D733B8197A5DE9AA1,43751,0,5,5,19,48,998
90775,90775,FBFB039BFE202B4D733B8197A5DE9AA1,12051,6,7,1,20,47,1047
90776,90776,FBFB039BFE202B4D733B8197A5DE9AA1,12581,10,15,5,24,48,1248
90777,90777,FBFB039BFE202B4D733B8197A5DE9AA1,43751,18,20,2,19,48,998
90778,90778,FBFB039BFE202B4D733B8197A5DE9AA1,12051,20,22,2,20,47,1047
90779,90779,9C52FD29B03EF1A5729C28BEF7100CC4,13314,0,7,7,31,39,1589
90780,90780,9C52FD29B03EF1A5729C28BEF7100CC4,12521,8,18,10,35,41,1791
90781,90781,9C52FD29B03EF1A5729C28BEF7100CC4,13314,19,23,4,31,39,1589
90785,90785,EF7EE9F0825E500C83748044E0BD2521,13651,0,9,9,30,47,1547
90786,90786,EF7EE9F0825E500C83748044E0BD2521,19021,14,17,3,10,45,545
90787,90787,EF7EE9F0825E500C83748044E0BD2521,13651,18,22,4,30,47,1547
90788,90788,79180DDD86B22B2BAEB51E3552560D4E,11355,0,2,2,36,48,1848
90789,90789,79180DDD86B22B2BAEB51E3552560D4E,11381,2,19,17,30,47,1547
90790,90790,79180DDD86B22B2BAEB51E3552560D4E,13511,21,23,2,34,48,1748
90814,90814,3C395260D74040E21557F119C015B734,11481,0,1,1,41,48,2098
90815,90815,3C395260D74040E21557F119C015B734,42271,3,7,4,40,47,2047
90816,90816,3C395260D74040E21557F119C015B734,10601,12,13,1,39,47,1997
90817,90817,3C395260D74040E21557F119C015B734,10107,19,20,1,38,49,1949
90818,90818,3C395260D74040E21557F119C015B734,11481,21,23,2,41,48,2098
90819,90819,FB8A3B40A5A14C5EDDE5181B01A70E2A,11261,0,5,5,36,46,1846
90820,90820,FB8A3B40A5A14C5EDDE5181B01A70E2A,42861,6,9,3,37,44,1894
90821,90821,FB8A3B40A5A14C5EDDE5181B01A70E2A,42151,9,10,1,35,45,1795
90822,90822,FB8A3B40A5A14C5EDDE5181B01A70E2A,42861,12,18,6,37,44,1894
90823,90823,FB8A3B40A5A14C5EDDE5181B01A70E2A,11261,22,23,1,36,46,1846
90833,90833,27B6DDFE3A356062F221ABD7AD70BB14,11061,0,6,6,29,48,1498
90834,90834,27B6DDFE3A356062F221ABD7AD70BB14,10681,7,8,1,30,48,1548
90835,90835,27B6DDFE3A356062F221ABD7AD70BB14,11061,11,16,5,29,48,1498
90836,90836,27B6DDFE3A356062F221ABD7AD70BB14,10681,16,20,4,30,48,1548
90837,90837,27B6DDFE3A356062F221ABD7AD70BB14,11061,21,23,2,29,48,1498
90844,90844,CB6CE8B284764CB65EC4187E6FE5A3FF,43021,10,14,4,16,43,843
90845,90845,CB6CE8B284764CB65EC4187E6FE5A3FF,19021,18,20,2,10,45,545
90846,90846,CB6CE8B284764CB65EC4187E6FE5A3FF,43021,20,23,3,16,43,843
90850,90850,0A15402BF50F336CD996C3C85D01B359,10471,0,13,13,37,48,1898
90851,90851,0A15402BF50F336CD996C3C85D01B359,11231,14,16,2,37,49,1899
90852,90852,0A15402BF50F336CD996C3C85D01B359,11861,16,17,1,32,47,1647
90853,90853,0A15402BF50F336CD996C3C85D01B359,10471,20,23,3,37,48,1898
90868,90868,F3B16B9F2FE5D66DD896BE8E61C1FA80,10301,0,1,1,31,45,1595
90869,90869,F3B16B9F2FE5D66DD896BE8E61C1FA80,10351,1,3,2,28,45,1445
90870,90870,F3B16B9F2FE5D66DD896BE8E61C1FA80,12311,4,6,2,30,44,1544
90871,90871,F3B16B9F2FE5D66DD896BE8E61C1FA80,10301,8,10,2,31,45,1595
90872,90872,F3B16B9F2FE5D66DD896BE8E61C1FA80,10351,13,14,1,28,45,1445
90873,90873,F3B16B9F2FE5D66DD896BE8E61C1FA80,10301,14,15,1,31,45,1595
90874,90874,F3B16B9F2FE5D66DD896BE8E61C1FA80,10351,20,21,1,28,45,1445
90878,90878,8482332275BDFBD74146AEDDCFF1AEF6,11111,4,5,1,26,48,1348
90879,90879,8482332275BDFBD74146AEDDCFF1AEF6,42541,6,10,4,25,47,1297
90880,90880,8482332275BDFBD74146AEDDCFF1AEF6,10501,15,16,1,22,46,1146
90881,90881,8482332275BDFBD74146AEDDCFF1AEF6,12601,20,21,1,25,47,1297
90886,90886,470BE60325DA2FBBD1F75F1607157E14,12521,0,7,7,35,41,1791
90887,90887,470BE60325DA2FBBD1F75F1607157E14,13314,8,9,1,31,39,1589
90888,90888,470BE60325DA2FBBD1F75F1607157E14,12521,11,23,12,35,41,1791
90889,90889,E675A65705B47E64E764764AA7201F3F,15411,0,1,1,44,27,2227
90890,90890,E675A65705B47E64E764764AA7201F3F,12611,2,3,1,41,29,2079
90891,90891,E675A65705B47E64E764764AA7201F3F,15411,4,19,15,44,27,2227
90892,90892,E675A65705B47E64E764764AA7201F3F,15561,20,21,1,32,22,1622
90893,90893,E675A65705B47E64E764764AA7201F3F,15411,22,23,1,44,27,2227
90897,90897,01B7A3B2C26FB99C1C09CE1411B2C84C,13911,0,9,9,39,46,1996
90898,90898,01B7A3B2C26FB99C1C09CE1411B2C84C,42231,9,10,1,37,46,1896
90899,90899,01B7A3B2C26FB99C1C09CE1411B2C84C,13911,11,12,1,39,46,1996
90900,90900,01B7A3B2C26FB99C1C09CE1411B2C84C,42231,12,18,6,37,46,1896
90901,90901,01B7A3B2C26FB99C1C09CE1411B2C84C,13911,20,21,1,39,46,1996
90902,90902,05DB08AFAEA6B1FFF1B9BBD7B1A29A93,10411,0,7,7,36,48,1848
90903,90903,05DB08AFAEA6B1FFF1B9BBD7B1A29A93,13371,9,18,9,41,47,2097
90904,90904,05DB08AFAEA6B1FFF1B9BBD7B1A29A93,11911,19,21,2,37,48,1898
90905,90905,2F1464FA3DE631911E14FF6E04C24354,10841,1,10,9,37,47,1897
90906,90906,2F1464FA3DE631911E14FF6E04C24354,10691,15,18,3,33,48,1698
90907,90907,2F1464FA3DE631911E14FF6E04C24354,10841,21,23,2,37,47,1897
90912,90912,F1E20BA750A6187AC06DE3BC6EDDD99B,42523,0,9,9,31,47,1597
90913,90913,F1E20BA750A6187AC06DE3BC6EDDD99B,11261,12,13,1,36,46,1846
90914,90914,F1E20BA750A6187AC06DE3BC6EDDD99B,42523,14,21,7,31,47,1597
90930,90930,38B6727BA08A29EBE559A750009E49CE,42231,1,3,2,37,46,1896
90931,90931,38B6727BA08A29EBE559A750009E49CE,10811,4,7,3,38,46,1946
90932,90932,38B6727BA08A29EBE559A750009E49CE,42231,7,17,10,37,46,1896
90933,90933,38B6727BA08A29EBE559A750009E49CE,10811,17,20,3,38,46,1946
90934,90934,38B6727BA08A29EBE559A750009E49CE,42231,21,23,2,37,46,1896
90939,90939,E7F0BEFEB527574747952B709C847F2A,15051,0,5,5,19,4,954
90940,90940,E7F0BEFEB527574747952B709C847F2A,16281,6,9,3,11,4,554
90941,90941,E7F0BEFEB527574747952B709C847F2A,15051,11,23,12,19,4,954
90946,90946,09C2A5500F5ABAEEAC932C07F5628EC4,11021,1,8,7,36,49,1849
90947,90947,09C2A5500F5ABAEEAC932C07F5628EC4,43161,9,11,2,35,47,1797
90948,90948,09C2A5500F5ABAEEAC932C07F5628EC4,11021,13,14,1,36,49,1849
90949,90949,09C2A5500F5ABAEEAC932C07F5628EC4,43161,15,19,4,35,47,1797
90950,90950,09C2A5500F5ABAEEAC932C07F5628EC4,11021,20,23,3,36,49,1849
90951,90951,A15C0678EF39F4E1D2E8B3E08C176676,13911,1,5,4,39,46,1996
90952,90952,A15C0678EF39F4E1D2E8B3E08C176676,11261,7,8,1,36,46,1846
90953,90953,A15C0678EF39F4E1D2E8B3E08C176676,13911,11,14,3,39,46,1996
90954,90954,A15C0678EF39F4E1D2E8B3E08C176676,11261,18,20,2,36,46,1846
90955,90955,A15C0678EF39F4E1D2E8B3E08C176676,13911,21,23,2,39,46,1996
90956,90956,086873B6FDDAA95F5D97B0E7D1FDE099,12514,0,13,13,38,47,1947
90957,90957,086873B6FDDAA95F5D97B0E7D1FDE099,13381,14,17,3,39,47,1997
90958,90958,086873B6FDDAA95F5D97B0E7D1FDE099,41392,20,22,2,43,48,2198
90959,90959,46248CD3AE5F02514CBE5AD511617E45,43641,0,8,8,16,38,838
90960,90960,46248CD3AE5F02514CBE5AD511617E45,13671,13,15,2,27,43,1393
90961,90961,46248CD3AE5F02514CBE5AD511617E45,11281,16,19,3,27,40,1390
90969,90969,983842B60AEE8AF2D9A0F2BA47994634,11381,0,9,9,30,47,1547
90970,90970,983842B60AEE8AF2D9A0F2BA47994634,12121,9,11,2,29,47,1497
90971,90971,983842B60AEE8AF2D9A0F2BA47994634,11381,12,15,3,30,47,1547
90972,90972,983842B60AEE8AF2D9A0F2BA47994634,12121,15,16,1,29,47,1497
90973,90973,983842B60AEE8AF2D9A0F2BA47994634,11381,18,23,5,30,47,1547
90974,90974,D49ACB9D15E069F7B065182278AF10C3,42331,1,3,2,39,46,1996
90975,90975,D49ACB9D15E069F7B065182278AF10C3,10601,4,7,3,39,47,1997
90976,90976,D49ACB9D15E069F7B065182278AF10C3,42301,11,12,1,36,47,1847
90977,90977,D49ACB9D15E069F7B065182278AF10C3,13711,14,16,2,38,46,1946
90978,90978,D49ACB9D15E069F7B065182278AF10C3,42301,16,19,3,36,47,1847
90985,90985,81565F9704E60766FEFBB47B416D00DF,12581,0,2,2,24,48,1248
90986,90986,81565F9704E60766FEFBB47B416D00DF,12051,2,10,8,20,47,1047
90987,90987,81565F9704E60766FEFBB47B416D00DF,12581,12,13,1,24,48,1248
90988,90988,81565F9704E60766FEFBB47B416D00DF,12051,13,15,2,20,47,1047
90989,90989,81565F9704E60766FEFBB47B416D00DF,12581,18,22,4,24,48,1248
90993,90993,809D30997DBB6653E10DF33CB05A97F7,13771,3,16,13,21,45,1095
90994,90994,809D30997DBB6653E10DF33CB05A97F7,12601,16,19,3,25,47,1297
90995,90995,809D30997DBB6653E10DF33CB05A97F7,13771,22,23,1,21,45,1095
90996,90996,EE6B8585E25BB845D2DA0A95F88FAB79,13911,0,1,1,39,46,1996
90997,90997,EE6B8585E25BB845D2DA0A95F88FAB79,42231,2,12,10,37,46,1896
90998,90998,EE6B8585E25BB845D2DA0A95F88FAB79,11875,14,15,1,30,46,1546
90999,90999,EE6B8585E25BB845D2DA0A95F88FAB79,42231,19,20,1,37,46,1896
91004,91004,40A368CA34750DF505DA57A322872C86,12611,0,5,5,41,29,2079
91005,91005,40A368CA34750DF505DA57A322872C86,15411,7,16,9,44,27,2227
91006,91006,40A368CA34750DF505DA57A322872C86,12611,17,22,5,41,29,2079
91007,91007,5B3D0019DD251A5BFCDC9AED9DB8499C,43061,1,3,2,43,46,2196
91008,91008,5B3D0019DD251A5BFCDC9AED9DB8499C,13111,3,4,1,42,46,2146
91009,91009,5B3D0019DD251A5BFCDC9AED9DB8499C,43061,5,6,1,43,46,2196
91010,91010,5B3D0019DD251A5BFCDC9AED9DB8499C,13111,6,12,6,42,46,2146
91011,91011,5B3D0019DD251A5BFCDC9AED9DB8499C,42204,13,17,4,43,46,2196
91012,91012,5B3D0019DD251A5BFCDC9AED9DB8499C,12651,19,20,1,43,47,2197
91016,91016,132BAF41704DD845C2F70543C3732C4E,13711,0,2,2,38,46,1946
91017,91017,132BAF41704DD845C2F70543C3732C4E,42231,5,8,3,37,46,1896
91018,91018,132BAF41704DD845C2F70543C3732C4E,13711,12,19,7,38,46,1946
91019,91019,132BAF41704DD845C2F70543C3732C4E,42231,19,21,2,37,46,1896
91020,91020,132BAF41704DD845C2F70543C3732C4E,13711,22,23,1,38,46,1946
91021,91021,46C2394E1CAF6C24A6D0E9EA9BC5539C,10221,0,9,9,34,49,1749
91022,91022,46C2394E1CAF6C24A6D0E9EA9BC5539C,13601,9,10,1,34,47,1747
91023,91023,46C2394E1CAF6C24A6D0E9EA9BC5539C,11641,14,15,1,22,49,1149
91024,91024,46C2394E1CAF6C24A6D0E9EA9BC5539C,40861,19,23,4,34,48,1748
91025,91025,9C538BB9379C59245E38A722A1BAC592,10691,0,6,6,33,48,1698
91026,91026,9C538BB9379C59245E38A722A1BAC592,42204,7,16,9,43,46,2196
91027,91027,9C538BB9379C59245E38A722A1BAC592,10691,18,23,5,33,48,1698
91034,91034,15351107348D533F1A62174A9ED24724,13314,0,7,7,31,39,1589
91035,91035,15351107348D533F1A62174A9ED24724,12521,11,19,8,35,41,1791
91036,91036,15351107348D533F1A62174A9ED24724,13314,20,23,3,31,39,1589
91041,91041,FDF3A555382668B3FCFD730AFF8664D2,10411,0,7,7,36,48,1848
91042,91042,FDF3A555382668B3FCFD730AFF8664D2,11231,8,9,1,37,49,1899
91043,91043,FDF3A555382668B3FCFD730AFF8664D2,10471,9,11,2,37,48,1898
91044,91044,FDF3A555382668B3FCFD730AFF8664D2,11231,11,13,2,37,49,1899
91045,91045,FDF3A555382668B3FCFD730AFF8664D2,10471,14,19,5,37,48,1898
91046,91046,FDF3A555382668B3FCFD730AFF8664D2,11231,21,23,2,37,49,1899
91047,91047,E92442C28CB44C67B1AFA3BE5AC81485,10107,0,1,1,38,49,1949
91048,91048,E92442C28CB44C67B1AFA3BE5AC81485,10471,1,2,1,37,48,1898
91049,91049,E92442C28CB44C67B1AFA3BE5AC81485,12131,3,22,19,32,47,1647
91050,91050,E92442C28CB44C67B1AFA3BE5AC81485,42401,22,23,1,36,47,1847
91051,91051,FD926C96A4F9758B0E89829758CD18F3,10151,0,7,7,34,47,1747
91052,91052,FD926C96A4F9758B0E89829758CD18F3,40277,8,9,1,35,49,1799
91053,91053,FD926C96A4F9758B0E89829758CD18F3,42631,9,10,1,43,45,2195
91054,91054,FD926C96A4F9758B0E89829758CD18F3,43181,12,13,1,39,48,1998
91055,91055,FD926C96A4F9758B0E89829758CD18F3,41601,13,14,1,39,49,1999
91056,91056,FD926C96A4F9758B0E89829758CD18F3,42631,16,17,1,43,45,2195
91057,91057,FD926C96A4F9758B0E89829758CD18F3,10151,18,23,5,34,47,1747
91058,91058,34B0487DA91675A6216B605C367EE35D,40094,0,7,7,29,48,1498
91059,91059,34B0487DA91675A6216B605C367EE35D,43581,12,13,1,33,48,1698
91060,91060,34B0487DA91675A6216B605C367EE35D,40841,15,18,3,33,49,1699
91061,91061,0B48A85C2E63306F2732FBA1CEDC76FB,11021,0,8,8,36,49,1849
91062,91062,0B48A85C2E63306F2732FBA1CEDC76FB,10221,9,11,2,34,49,1749
91063,91063,0B48A85C2E63306F2732FBA1CEDC76FB,11021,11,14,3,36,49,1849
91064,91064,0B48A85C2E63306F2732FBA1CEDC76FB,10221,15,16,1,34,49,1749
91065,91065,0B48A85C2E63306F2732FBA1CEDC76FB,11021,21,22,1,36,49,1849
91076,91076,586F3CB937FEA42C49864E019CACBB68,11074,0,6,6,37,47,1897
91077,91077,586F3CB937FEA42C49864E019CACBB68,10951,7,15,8,29,48,1498
91078,91078,586F3CB937FEA42C49864E019CACBB68,12401,18,20,2,39,49,1999
91079,91079,9E006E8354C02D65527EEB188B09CE56,16231,0,6,6,11,15,565
91080,91080,9E006E8354C02D65527EEB188B09CE56,15421,7,9,2,20,18,1018
91081,91081,9E006E8354C02D65527EEB188B09CE56,16231,11,14,3,11,15,565
91082,91082,9E006E8354C02D65527EEB188B09CE56,15421,15,16,1,20,18,1018
91083,91083,9E006E8354C02D65527EEB188B09CE56,16231,17,23,6,11,15,565
91084,91084,27FD8A6CDE751A5F2BC12F75826C7985,43021,8,17,9,16,43,843
91085,91085,27FD8A6CDE751A5F2BC12F75826C7985,12921,18,20,2,9,41,491
91086,91086,27FD8A6CDE751A5F2BC12F75826C7985,43021,20,22,2,16,43,843
91090,91090,346BF3F539A4C5C04EF0491F7207CF76,19114,0,5,5,7,43,393
91091,91091,346BF3F539A4C5C04EF0491F7207CF76,12641,6,8,2,10,43,543
91092,91092,346BF3F539A4C5C04EF0491F7207CF76,43021,11,13,2,16,43,843
91093,91093,346BF3F539A4C5C04EF0491F7207CF76,12641,14,19,5,10,43,543
91094,91094,346BF3F539A4C5C04EF0491F7207CF76,19114,21,23,2,7,43,393
91095,91095,B8E7E289F9430AF8CDDF4777B090A6CC,42941,2,6,4,37,47,1897
91096,91096,B8E7E289F9430AF8CDDF4777B090A6CC,10251,6,9,3,35,47,1797
91097,91097,B8E7E289F9430AF8CDDF4777B090A6CC,13731,11,12,1,33,49,1699
91098,91098,B8E7E289F9430AF8CDDF4777B090A6CC,42161,20,22,2,36,47,1847
91106,91106,FA5E97B8E90C5A955BBD79C61D708804,10431,0,7,7,33,49,1699
91107,91107,FA5E97B8E90C5A955BBD79C61D708804,42941,9,11,2,37,47,1897
91108,91108,FA5E97B8E90C5A955BBD79C61D708804,10431,12,23,11,33,49,1699
91109,91109,4BFB0EA34002EF7F67C6D864994F6F63,10731,0,8,8,33,47,1697
91110,91110,4BFB0EA34002EF7F67C6D864994F6F63,11231,9,11,2,37,49,1899
91111,91111,4BFB0EA34002EF7F67C6D864994F6F63,10731,14,19,5,33,47,1697
91115,91115,B2C146BE7E2B98821BDB0E11A4AFFE8A,11541,1,2,1,35,49,1799
91116,91116,B2C146BE7E2B98821BDB0E11A4AFFE8A,11211,2,3,1,34,49,1749
91117,91117,B2C146BE7E2B98821BDB0E11A4AFFE8A,11541,4,6,2,35,49,1799
91118,91118,B2C146BE7E2B98821BDB0E11A4AFFE8A,11021,9,15,6,36,49,1849
91119,91119,B2C146BE7E2B98821BDB0E11A4AFFE8A,11541,19,21,2,35,49,1799
91123,91123,4F34225CDC596E63EE8F1BEB4ACA56CC,43011,1,7,6,40,42,2042
91124,91124,4F34225CDC596E63EE8F1BEB4ACA56CC,12521,10,18,8,35,41,1791
91125,91125,4F34225CDC596E63EE8F1BEB4ACA56CC,42864,20,22,2,38,44,1944
91132,91132,2446E8F15BFC2A49F5E456D12DC187B8,10381,5,6,1,31,49,1599
91133,91133,2446E8F15BFC2A49F5E456D12DC187B8,43391,7,8,1,29,48,1498
91134,91134,2446E8F15BFC2A49F5E456D12DC187B8,10381,9,10,1,31,49,1599
91135,91135,2446E8F15BFC2A49F5E456D12DC187B8,43391,16,18,2,29,48,1498
91136,91136,2446E8F15BFC2A49F5E456D12DC187B8,42071,19,22,3,31,49,1599
91137,91137,38EAD9C71E0631172BE43F523D61F0B8,42971,0,7,7,43,49,2199
91138,91138,38EAD9C71E0631172BE43F523D61F0B8,11061,8,14,6,29,48,1498
91139,91139,38EAD9C71E0631172BE43F523D61F0B8,42971,17,23,6,43,49,2199
91146,91146,C8236143E8B93D5FDE499177CF2B28F7,11381,0,13,13,30,47,1547
91147,91147,C8236143E8B93D5FDE499177CF2B28F7,11091,14,17,3,29,47,1497
91148,91148,C8236143E8B93D5FDE499177CF2B28F7,11381,18,19,1,30,47,1547
91149,91149,C8236143E8B93D5FDE499177CF2B28F7,42501,19,20,1,28,47,1447
91150,91150,C8236143E8B93D5FDE499177CF2B28F7,11381,21,22,1,30,47,1547
91151,91151,38BAD20AF3F1C2D76FC5AB52738907B1,10341,0,6,6,31,47,1597
91152,91152,38BAD20AF3F1C2D76FC5AB52738907B1,11861,6,8,2,32,47,1647
91153,91153,38BAD20AF3F1C2D76FC5AB52738907B1,10341,10,13,3,31,47,1597
91154,91154,38BAD20AF3F1C2D76FC5AB52738907B1,11861,16,17,1,32,47,1647
91155,91155,38BAD20AF3F1C2D76FC5AB52738907B1,10341,19,20,1,31,47,1597
91156,91156,756266AA2D3282E41A15D30D8262945F,12381,0,12,12,32,48,1648
91157,91157,756266AA2D3282E41A15D30D8262945F,13561,13,15,2,37,49,1899
91158,91158,756266AA2D3282E41A15D30D8262945F,12381,15,20,5,32,48,1648
91163,91163,52DDD213A9585CD07FA338B98E613976,42081,0,1,1,24,49,1249
91164,91164,52DDD213A9585CD07FA338B98E613976,42071,1,15,14,31,49,1599
91165,91165,52DDD213A9585CD07FA338B98E613976,42081,15,20,5,24,49,1249
91166,91166,52DDD213A9585CD07FA338B98E613976,42071,22,23,1,31,49,1599
91173,91173,2E6ECF3A2D9F0F99E9DEBA2062D89A0D,12601,0,1,1,25,47,1297
91174,91174,2E6ECF3A2D9F0F99E9DEBA2062D89A0D,10351,3,9,6,28,45,1445
91175,91175,2E6ECF3A2D9F0F99E9DEBA2062D89A0D,13771,11,13,2,21,45,1095
91176,91176,2E6ECF3A2D9F0F99E9DEBA2062D89A0D,12601,16,20,4,25,47,1297
91180,91180,FD6F3D9CFB531FE01A1AEA9CDBE73454,42231,5,7,2,37,46,1896
91181,91181,FD6F3D9CFB531FE01A1AEA9CDBE73454,42351,7,13,6,38,45,1945
91182,91182,FD6F3D9CFB531FE01A1AEA9CDBE73454,42231,14,15,1,37,46,1896
91183,91183,FD6F3D9CFB531FE01A1AEA9CDBE73454,42351,15,19,4,38,45,1945
91184,91184,FD6F3D9CFB531FE01A1AEA9CDBE73454,42231,19,20,1,37,46,1896
91185,91185,89EC37A7B83D9B7D194154C37975BD9C,42521,0,6,6,31,47,1597
91186,91186,89EC37A7B83D9B7D194154C37975BD9C,43311,8,10,2,31,48,1598
91187,91187,89EC37A7B83D9B7D194154C37975BD9C,11061,11,14,3,29,48,1498
91188,91188,89EC37A7B83D9B7D194154C37975BD9C,43311,15,16,1,31,48,1598
91189,91189,89EC37A7B83D9B7D194154C37975BD9C,11061,19,23,4,29,48,1498
91196,91196,EC680E319E6B81EFFD2BF3EF09820922,40673,0,7,7,36,48,1848
91197,91197,EC680E319E6B81EFFD2BF3EF09820922,13651,10,17,7,30,47,1547
91198,91198,EC680E319E6B81EFFD2BF3EF09820922,10251,19,20,1,35,47,1797
91199,91199,EC680E319E6B81EFFD2BF3EF09820922,40673,21,22,1,36,48,1848
91203,91203,CA9AC97A3C66AF0C64786EBB77D618C9,11631,3,6,3,12,49,649
91204,91204,CA9AC97A3C66AF0C64786EBB77D618C9,10951,8,9,1,29,48,1498
91205,91205,CA9AC97A3C66AF0C64786EBB77D618C9,43761,10,12,2,32,47,1647
91206,91206,CA9AC97A3C66AF0C64786EBB77D618C9,42523,12,22,10,31,47,1597
91209,91209,E603C5CE99E3FE3BB5D201DC1F4B77FD,42204,15,23,8,43,46,2196
