,Unnamed: 0,id,grid,start_hour,end_hour,duration,lon,lat,gps2id
0,0,AADB05184605E526D4301A47BFDDB588,42921,2,10,8,33,47,1697
1,1,AADB05184605E526D4301A47BFDDB588,10281,12,13,1,33,48,1698
2,2,AADB05184605E526D4301A47BFDDB588,11861,14,18,4,32,47,1647
3,3,AADB05184605E526D4301A47BFDDB588,42921,19,21,2,33,47,1697
4,4,6D411464E8569334C6217011CDDAB47B,10281,0,13,13,33,48,1698
5,5,6D411464E8569334C6217011CDDAB47B,10251,13,15,2,35,47,1797
6,6,6D411464E8569334C6217011CDDAB47B,42161,16,22,6,36,47,1847
7,7,A27FBDA95E2A69A4F36C58ED06D19FA6,42271,0,14,14,40,47,2047
8,8,A27FBDA95E2A69A4F36C58ED06D19FA6,40171,18,20,2,38,48,1948
9,9,A27FBDA95E2A69A4F36C58ED06D19FA6,13101,21,23,2,40,47,2047
14,14,2808B465D0CA5BE626B66BA705E41B68,13231,0,4,4,39,46,1996
15,15,2808B465D0CA5BE626B66BA705E41B68,42864,9,10,1,38,44,1944
16,16,2808B465D0CA5BE626B66BA705E41B68,11261,13,17,4,36,46,1846
17,17,2808B465D0CA5BE626B66BA705E41B68,42351,20,22,2,38,45,1945
18,18,14C205DF57BD0AA586E26BE4ED695846,42581,0,14,14,38,48,1948
19,19,14C205DF57BD0AA586E26BE4ED695846,11914,15,17,2,37,48,1898
20,20,14C205DF57BD0AA586E26BE4ED695846,40171,21,22,1,38,48,1948
26,26,1E80787B69718C7476B2A0E1C06850FD,42401,0,15,15,36,47,1847
27,27,1E80787B69718C7476B2A0E1C06850FD,11074,17,18,1,37,47,1897
28,28,1E80787B69718C7476B2A0E1C06850FD,42301,18,23,5,36,47,1847
33,33,662FC5D6B6F2D4B0D4559983BA297CBC,10281,1,11,10,33,48,1698
34,34,662FC5D6B6F2D4B0D4559983BA297CBC,40951,15,17,2,36,49,1849
35,35,662FC5D6B6F2D4B0D4559983BA297CBC,10281,18,22,4,33,48,1698
44,44,D75859C5199E26E4E069299921FEC112,42523,2,5,3,31,47,1597
45,45,D75859C5199E26E4E069299921FEC112,43761,8,18,10,32,47,1647
46,46,D75859C5199E26E4E069299921FEC112,42921,18,19,1,33,47,1697
55,55,B4D70E7CDFA879C6A4BAE698CD44BB37,10271,0,8,8,37,46,1896
56,56,B4D70E7CDFA879C6A4BAE698CD44BB37,13121,9,10,1,38,46,1946
57,57,B4D70E7CDFA879C6A4BAE698CD44BB37,10271,10,23,13,37,46,1896
61,61,EDBEDCDD3729803D79956D4495DD48D8,42351,0,1,1,38,45,1945
62,62,EDBEDCDD3729803D79956D4495DD48D8,11261,6,7,1,36,46,1846
63,63,EDBEDCDD3729803D79956D4495DD48D8,42864,8,10,2,38,44,1944
64,64,EDBEDCDD3729803D79956D4495DD48D8,11261,13,22,9,36,46,1846
65,65,884C9210F61ADBFD1EDE89A3EAB05C30,11481,2,10,8,41,48,2098
66,66,884C9210F61ADBFD1EDE89A3EAB05C30,40833,11,12,1,41,47,2097
67,67,884C9210F61ADBFD1EDE89A3EAB05C30,13101,14,22,8,40,47,2047
72,72,3821B66A00758CF4502F36B7CE2D17D9,12491,2,7,5,36,43,1843
73,73,3821B66A00758CF4502F36B7CE2D17D9,43451,10,12,2,37,40,1890
74,74,3821B66A00758CF4502F36B7CE2D17D9,12491,13,20,7,36,43,1843
87,87,176F4E967E986DAF00C74DDD3BF2A8FE,42271,4,9,5,40,47,2047
88,88,176F4E967E986DAF00C74DDD3BF2A8FE,11806,9,11,2,41,48,2098
89,89,176F4E967E986DAF00C74DDD3BF2A8FE,13331,13,16,3,38,47,1947
90,90,176F4E967E986DAF00C74DDD3BF2A8FE,11806,19,22,3,41,48,2098
91,91,4D8BE76F271C7AE4FAC0F3039FEBB60C,42281,0,16,16,40,48,2048
92,92,4D8BE76F271C7AE4FAC0F3039FEBB60C,13101,19,20,1,40,47,2047
93,93,4D8BE76F271C7AE4FAC0F3039FEBB60C,43181,22,23,1,39,48,1998
101,101,9F2BAB521AAFFBE7CC97AED22DC2FAF1,11261,0,9,9,36,46,1846
102,102,9F2BAB521AAFFBE7CC97AED22DC2FAF1,42151,10,14,4,35,45,1795
103,103,9F2BAB521AAFFBE7CC97AED22DC2FAF1,11261,19,22,3,36,46,1846
104,104,53650105F7F25F79263F92D3A7D439AB,42461,0,13,13,45,47,2297
105,105,53650105F7F25F79263F92D3A7D439AB,11001,15,16,1,42,47,2147
106,106,53650105F7F25F79263F92D3A7D439AB,42461,18,21,3,45,47,2297
107,107,E16566CAC1D2263C830A92E3D7A4B3A9,42231,1,4,3,37,46,1896
108,108,E16566CAC1D2263C830A92E3D7A4B3A9,42351,6,12,6,38,45,1945
109,109,E16566CAC1D2263C830A92E3D7A4B3A9,42231,17,21,4,37,46,1896
110,110,E16566CAC1D2263C830A92E3D7A4B3A9,42351,22,23,1,38,45,1945
130,130,E96212EFC2FCFD2907ABEE6EE15AC7FD,10721,1,10,9,31,48,1598
131,131,E96212EFC2FCFD2907ABEE6EE15AC7FD,10431,14,16,2,33,49,1699
132,132,E96212EFC2FCFD2907ABEE6EE15AC7FD,12971,18,20,2,32,48,1648
139,139,AA08818C7E8C591C20688C68152F6B6D,11481,0,9,9,41,48,2098
140,140,AA08818C7E8C591C20688C68152F6B6D,13101,13,15,2,40,47,2047
141,141,AA08818C7E8C591C20688C68152F6B6D,11481,19,23,4,41,48,2098
142,142,394D700E14C58A7853C10805B183B24E,11381,4,6,2,30,47,1547
143,143,394D700E14C58A7853C10805B183B24E,11871,8,19,11,29,46,1496
144,144,394D700E14C58A7853C10805B183B24E,11381,19,21,2,30,47,1547
145,145,E779DF22EB61C0D4BA72F0FBA1762DF8,42583,0,13,13,40,48,2048
146,146,E779DF22EB61C0D4BA72F0FBA1762DF8,42581,14,16,2,38,48,1948
147,147,E779DF22EB61C0D4BA72F0FBA1762DF8,42583,18,23,5,40,48,2048
148,148,460F97EBC86F8CBF93D1A8D6309E0ED8,43311,0,8,8,31,48,1598
149,149,460F97EBC86F8CBF93D1A8D6309E0ED8,10151,12,14,2,34,47,1747
150,150,460F97EBC86F8CBF93D1A8D6309E0ED8,43311,20,22,2,31,48,1598
155,155,FC153B410C5E5B56EE0C4EBEE683F42B,42301,0,13,13,36,47,1847
156,156,FC153B410C5E5B56EE0C4EBEE683F42B,10111,14,17,3,37,47,1897
157,157,FC153B410C5E5B56EE0C4EBEE683F42B,42301,17,23,6,36,47,1847
158,158,EEEB433A36E0F496A9DAB4A209387715,12311,0,2,2,30,44,1544
159,159,EEEB433A36E0F496A9DAB4A209387715,10351,6,13,7,28,45,1445
160,160,EEEB433A36E0F496A9DAB4A209387715,12121,17,18,1,29,47,1497
166,166,ED387BC9729A0D8CA1364378D6AA6E43,10634,7,8,1,27,45,1395
167,167,ED387BC9729A0D8CA1364378D6AA6E43,10351,11,12,1,28,45,1445
168,168,ED387BC9729A0D8CA1364378D6AA6E43,10634,13,23,10,27,45,1395
172,172,E733E2BCFA57BF507E7D4380A7C2C282,10841,0,11,11,37,47,1897
173,173,E733E2BCFA57BF507E7D4380A7C2C282,41027,13,16,3,38,47,1947
174,174,E733E2BCFA57BF507E7D4380A7C2C282,42221,16,20,4,38,48,1948
175,175,E733E2BCFA57BF507E7D4380A7C2C282,42511,21,22,1,37,47,1897
176,176,9FC853D14B199D9AE09B3905110E90BD,12514,0,13,13,38,47,1947
177,177,9FC853D14B199D9AE09B3905110E90BD,10471,16,19,3,37,48,1898
178,178,9FC853D14B199D9AE09B3905110E90BD,12514,19,23,4,38,47,1947
183,183,75B6D91479467607B0BA166BDAF35CA1,10431,0,6,6,33,49,1699
184,184,75B6D91479467607B0BA166BDAF35CA1,43581,7,15,8,33,48,1698
185,185,75B6D91479467607B0BA166BDAF35CA1,10431,17,22,5,33,49,1699
195,195,4A64F91296EF8C1DAA19E0A02FF0729A,10231,0,9,9,39,49,1999
196,196,4A64F91296EF8C1DAA19E0A02FF0729A,10661,9,10,1,37,49,1899
197,197,4A64F91296EF8C1DAA19E0A02FF0729A,10231,16,23,7,39,49,1999
203,203,C0EC240E36490D1263D83D45770C29BF,42321,0,10,10,43,47,2197
204,204,C0EC240E36490D1263D83D45770C29BF,42091,11,14,3,43,46,2196
205,205,C0EC240E36490D1263D83D45770C29BF,42321,15,23,8,43,47,2197
209,209,700A8469B8648E235281334EF5CC8DA1,10371,0,9,9,37,49,1899
210,210,700A8469B8648E235281334EF5CC8DA1,10471,10,11,1,37,48,1898
211,211,700A8469B8648E235281334EF5CC8DA1,10371,12,22,10,37,49,1899
212,212,2F3FBE39EE4E3AB748593134D6A2A772,42231,0,14,14,37,46,1896
213,213,2F3FBE39EE4E3AB748593134D6A2A772,42351,14,16,2,38,45,1945
214,214,2F3FBE39EE4E3AB748593134D6A2A772,42231,17,21,4,37,46,1896
223,223,A923C41770F47C64367C4A31C06C83C7,13651,1,8,7,30,47,1547
224,224,A923C41770F47C64367C4A31C06C83C7,42523,10,20,10,31,47,1597
225,225,A923C41770F47C64367C4A31C06C83C7,42021,21,23,2,33,47,1697
226,226,147D4CA14E030CF5CD446F8C173CED55,11061,2,4,2,29,48,1498
227,227,147D4CA14E030CF5CD446F8C173CED55,11381,6,9,3,30,47,1547
228,228,147D4CA14E030CF5CD446F8C173CED55,11061,13,23,10,29,48,1498
234,234,A4BAF2470A47998F3C12DA506493D53C,42141,8,15,7,32,47,1647
235,235,A4BAF2470A47998F3C12DA506493D53C,10281,15,17,2,33,48,1698
236,236,A4BAF2470A47998F3C12DA506493D53C,43761,19,22,3,32,47,1647
245,245,CD55B44A3FD4B718A673CC03711FD344,12921,3,10,7,9,41,491
246,246,CD55B44A3FD4B718A673CC03711FD344,12641,11,20,9,10,43,543
247,247,CD55B44A3FD4B718A673CC03711FD344,12921,20,21,1,9,41,491
248,248,FEE5ACDB24DFF6E9A25C550C618C43AE,10251,0,3,3,35,47,1797
249,249,FEE5ACDB24DFF6E9A25C550C618C43AE,40673,5,8,3,36,48,1848
250,250,FEE5ACDB24DFF6E9A25C550C618C43AE,10251,11,23,12,35,47,1797
254,254,20320E88A948067DE50CA3910E0A0CBE,42941,0,9,9,37,47,1897
255,255,20320E88A948067DE50CA3910E0A0CBE,42301,11,14,3,36,47,1847
256,256,20320E88A948067DE50CA3910E0A0CBE,42941,14,16,2,37,47,1897
257,257,20320E88A948067DE50CA3910E0A0CBE,11491,19,20,1,36,47,1847
258,258,405F80E4DB047BF65667610085A0E1FB,19441,2,11,9,8,46,446
259,259,405F80E4DB047BF65667610085A0E1FB,42041,11,13,2,10,47,547
260,260,405F80E4DB047BF65667610085A0E1FB,19441,13,23,10,8,46,446
261,261,070CCFB95BD7B5493FC205585FDC7AC9,13341,0,5,5,44,45,2245
262,262,070CCFB95BD7B5493FC205585FDC7AC9,42631,6,19,13,43,45,2195
263,263,070CCFB95BD7B5493FC205585FDC7AC9,13341,21,23,2,44,45,2245
273,273,B2D4F6629C1492A2195C8109F120607C,11914,0,17,17,37,48,1898
274,274,B2D4F6629C1492A2195C8109F120607C,43481,18,20,2,39,48,1998
275,275,B2D4F6629C1492A2195C8109F120607C,11914,21,23,2,37,48,1898
295,295,59BAD7D0307255207187442691451EAD,13094,0,7,7,21,42,1092
296,296,59BAD7D0307255207187442691451EAD,13091,7,9,2,20,42,1042
297,297,59BAD7D0307255207187442691451EAD,13094,10,22,12,21,42,1092
305,305,804B7737707030C63DF2E4BD94DF220F,11806,1,3,2,41,48,2098
306,306,804B7737707030C63DF2E4BD94DF220F,42271,4,6,2,40,47,2047
307,307,804B7737707030C63DF2E4BD94DF220F,11806,6,23,17,41,48,2098
311,311,E5DFBD5EA9D387D72488BF506891617B,11491,0,7,7,36,47,1847
312,312,E5DFBD5EA9D387D72488BF506891617B,13911,8,9,1,39,46,1996
313,313,E5DFBD5EA9D387D72488BF506891617B,11491,12,23,11,36,47,1847
333,333,58B59FD7AA0814C0C6E50CF40955E7AA,12121,3,4,1,29,47,1497
334,334,58B59FD7AA0814C0C6E50CF40955E7AA,10634,8,17,9,27,45,1395
335,335,58B59FD7AA0814C0C6E50CF40955E7AA,12601,18,21,3,25,47,1297
336,336,58B59FD7AA0814C0C6E50CF40955E7AA,10634,21,23,2,27,45,1395
340,340,DF6451E86EE4B7B98BCA60FC558F51EE,11151,0,3,3,30,48,1548
341,341,DF6451E86EE4B7B98BCA60FC558F51EE,11061,5,7,2,29,48,1498
342,342,DF6451E86EE4B7B98BCA60FC558F51EE,12121,9,16,7,29,47,1497
343,343,DF6451E86EE4B7B98BCA60FC558F51EE,11381,18,20,2,30,47,1547
368,368,3AE63A5055E736CBCC5634D603296607,11461,0,7,7,37,49,1899
369,369,3AE63A5055E736CBCC5634D603296607,43361,7,9,2,38,48,1948
370,370,3AE63A5055E736CBCC5634D603296607,11461,13,23,10,37,49,1899
382,382,5BBCBBF8769301A9D56E4463855D7C25,10471,0,17,17,37,48,1898
383,383,5BBCBBF8769301A9D56E4463855D7C25,43171,18,19,1,39,49,1999
384,384,5BBCBBF8769301A9D56E4463855D7C25,42191,20,23,3,38,49,1949
391,391,6BC8791C9564317F3EE4BD91033B70AD,13411,8,9,1,49,42,2492
392,392,6BC8791C9564317F3EE4BD91033B70AD,43951,12,14,2,49,41,2491
393,393,6BC8791C9564317F3EE4BD91033B70AD,13411,16,18,2,49,42,2492
398,398,A09953F67FED80A8C2308F84F83FE6DA,43241,0,5,5,36,46,1846
399,399,A09953F67FED80A8C2308F84F83FE6DA,13711,7,8,1,38,46,1946
400,400,A09953F67FED80A8C2308F84F83FE6DA,43241,8,22,14,36,46,1846
409,409,38FA3504D95B60E47A27E14C8CAD06CD,11301,0,4,4,41,49,2099
410,410,38FA3504D95B60E47A27E14C8CAD06CD,41392,4,7,3,43,48,2198
411,411,38FA3504D95B60E47A27E14C8CAD06CD,10924,8,23,15,43,49,2199
412,412,6C054AEBB9CA77441FEC6C9497BF29D2,42021,1,15,14,33,47,1697
413,413,6C054AEBB9CA77441FEC6C9497BF29D2,13601,19,20,1,34,47,1747
414,414,6C054AEBB9CA77441FEC6C9497BF29D2,42021,22,23,1,33,47,1697
415,415,E6F25669ED67A718BB8E1422AA23CC99,10821,0,6,6,40,47,2047
416,416,E6F25669ED67A718BB8E1422AA23CC99,13371,8,18,10,41,47,2097
417,417,E6F25669ED67A718BB8E1422AA23CC99,10821,20,23,3,40,47,2047
418,418,58C32AD55A2D53A9841F4840BEBC3755,43061,1,11,10,43,46,2196
419,419,58C32AD55A2D53A9841F4840BEBC3755,42461,12,22,10,45,47,2297
420,420,58C32AD55A2D53A9841F4840BEBC3755,43061,22,23,1,43,46,2196
421,421,EA58C87CB2005675859CA29FF6C3C184,40925,1,7,6,35,49,1799
422,422,EA58C87CB2005675859CA29FF6C3C184,11021,8,10,2,36,49,1849
423,423,EA58C87CB2005675859CA29FF6C3C184,10161,11,12,1,35,49,1799
424,424,EA58C87CB2005675859CA29FF6C3C184,42021,17,23,6,33,47,1697
425,425,B3ED00109F79EFA57E8CA134246B72E1,11861,7,13,6,32,47,1647
426,426,B3ED00109F79EFA57E8CA134246B72E1,10281,14,17,3,33,48,1698
427,427,B3ED00109F79EFA57E8CA134246B72E1,11861,17,20,3,32,47,1647
428,428,B3ED00109F79EFA57E8CA134246B72E1,11651,21,23,2,33,47,1697
429,429,73F5D46A0AB49D3D1FF3EBE9DD0774B5,11261,9,10,1,36,46,1846
430,430,73F5D46A0AB49D3D1FF3EBE9DD0774B5,42864,12,13,1,38,44,1944
431,431,73F5D46A0AB49D3D1FF3EBE9DD0774B5,11261,14,22,8,36,46,1846
464,464,C12DD644AAA0C0B1CFC20CC5C965BD9B,12641,0,15,15,10,43,543
465,465,C12DD644AAA0C0B1CFC20CC5C965BD9B,12921,15,17,2,9,41,491
466,466,C12DD644AAA0C0B1CFC20CC5C965BD9B,19114,19,20,1,7,43,393
471,471,0BC1BC9FA127A76D4558FF0A0EC8FEFB,42921,0,7,7,33,47,1697
472,472,0BC1BC9FA127A76D4558FF0A0EC8FEFB,10281,8,9,1,33,48,1698
473,473,0BC1BC9FA127A76D4558FF0A0EC8FEFB,42021,10,20,10,33,47,1697
474,474,446AC7E279C6659F3E40FC9C0B9B7F45,13341,7,8,1,44,45,2245
475,475,446AC7E279C6659F3E40FC9C0B9B7F45,42631,8,10,2,43,45,2195
476,476,446AC7E279C6659F3E40FC9C0B9B7F45,13341,13,21,8,44,45,2245
480,480,245BF0AC713EC7539F599FEB41303CFA,42461,9,13,4,45,47,2297
481,481,245BF0AC713EC7539F599FEB41303CFA,42201,18,20,2,43,46,2196
482,482,245BF0AC713EC7539F599FEB41303CFA,42461,20,23,3,45,47,2297
483,483,6246A984FAD84CA7D3D390355C22E494,42401,0,8,8,36,47,1847
484,484,6246A984FAD84CA7D3D390355C22E494,10111,8,18,10,37,47,1897
485,485,6246A984FAD84CA7D3D390355C22E494,42401,19,22,3,36,47,1847
486,486,4E4FA3262DF5F7B6F1852C92067A0539,11875,0,13,13,30,46,1546
487,487,4E4FA3262DF5F7B6F1852C92067A0539,12311,17,19,2,30,44,1544
488,488,4E4FA3262DF5F7B6F1852C92067A0539,11875,21,23,2,30,46,1546
497,497,829F3CF969A99106A0CF5C6D0ED0FE14,42161,0,13,13,36,47,1847
498,498,829F3CF969A99106A0CF5C6D0ED0FE14,11231,13,21,8,37,49,1899
499,499,829F3CF969A99106A0CF5C6D0ED0FE14,10251,21,23,2,35,47,1797
500,500,A486521758A27268CCD3905C2122B6F8,11861,0,18,18,32,47,1647
501,501,A486521758A27268CCD3905C2122B6F8,10281,18,19,1,33,48,1698
502,502,A486521758A27268CCD3905C2122B6F8,11861,20,23,3,32,47,1647
541,541,8CD5156CF883DA15618BAFE58DDCF2A7,42581,0,5,5,38,48,1948
542,542,8CD5156CF883DA15618BAFE58DDCF2A7,11914,6,20,14,37,48,1898
543,543,8CD5156CF883DA15618BAFE58DDCF2A7,42581,21,22,1,38,48,1948
544,544,0750773F2B2DAD2C2EBE988336E3DA7D,43181,2,7,5,39,48,1998
545,545,0750773F2B2DAD2C2EBE988336E3DA7D,11331,12,13,1,37,48,1898
546,546,0750773F2B2DAD2C2EBE988336E3DA7D,43181,14,15,1,39,48,1998
547,547,0750773F2B2DAD2C2EBE988336E3DA7D,11914,17,20,3,37,48,1898
548,548,A012A11840DA59BA9C0B1287642AE618,42461,8,10,2,45,47,2297
549,549,A012A11840DA59BA9C0B1287642AE618,13791,12,13,1,42,47,2147
550,550,A012A11840DA59BA9C0B1287642AE618,13951,14,21,7,47,45,2395
555,555,AD00213C3B59D2AB9F04638676B1CD2C,10491,0,15,15,33,48,1698
556,556,AD00213C3B59D2AB9F04638676B1CD2C,10251,16,20,4,35,47,1797
557,557,AD00213C3B59D2AB9F04638676B1CD2C,10491,21,22,1,33,48,1698
558,558,2CB6953F391C73F166D02AC31E930A06,11791,0,8,8,38,49,1949
559,559,2CB6953F391C73F166D02AC31E930A06,11921,12,15,3,38,48,1948
560,560,2CB6953F391C73F166D02AC31E930A06,11914,15,17,2,37,48,1898
561,561,2CB6953F391C73F166D02AC31E930A06,42581,17,19,2,38,48,1948
573,573,EFA01F4DCCCCAD2CD2F33CF685FE54EC,10911,1,18,17,39,46,1996
574,574,EFA01F4DCCCCAD2CD2F33CF685FE54EC,10601,20,21,1,39,47,1997
575,575,EFA01F4DCCCCAD2CD2F33CF685FE54EC,10911,21,23,2,39,46,1996
576,576,C64854E86A3681C3669A53990E16514C,10111,0,7,7,37,47,1897
577,577,C64854E86A3681C3669A53990E16514C,42401,7,16,9,36,47,1847
578,578,C64854E86A3681C3669A53990E16514C,10111,20,23,3,37,47,1897
591,591,558A6887C0D5899B43E75BBD844A7C64,42461,0,5,5,45,47,2297
592,592,558A6887C0D5899B43E75BBD844A7C64,42321,6,15,9,43,47,2197
593,593,558A6887C0D5899B43E75BBD844A7C64,42461,19,20,1,45,47,2297
594,594,A1B0CD375E5B0488BCD3D52356E98FD7,43061,0,8,8,43,46,2196
595,595,A1B0CD375E5B0488BCD3D52356E98FD7,13791,10,12,2,42,47,2147
596,596,A1B0CD375E5B0488BCD3D52356E98FD7,13111,13,16,3,42,46,2146
597,597,A1B0CD375E5B0488BCD3D52356E98FD7,42461,18,21,3,45,47,2297
598,598,582C27F29836D8A1EEDD6397D4042333,10251,9,11,2,35,47,1797
599,599,582C27F29836D8A1EEDD6397D4042333,42161,12,15,3,36,47,1847
600,600,582C27F29836D8A1EEDD6397D4042333,11211,15,17,2,34,49,1749
601,601,582C27F29836D8A1EEDD6397D4042333,42161,21,23,2,36,47,1847
602,602,E45B0EC44E00842EDD865C65A561543D,10471,8,15,7,37,48,1898
603,603,E45B0EC44E00842EDD865C65A561543D,11231,16,18,2,37,49,1899
604,604,E45B0EC44E00842EDD865C65A561543D,10471,18,20,2,37,48,1898
605,605,E45B0EC44E00842EDD865C65A561543D,11231,22,23,1,37,49,1899
606,606,B24DFEF6BEA91CB0AE942579D8124FCB,42161,0,5,5,36,47,1847
607,607,B24DFEF6BEA91CB0AE942579D8124FCB,10971,5,16,11,35,47,1797
608,608,B24DFEF6BEA91CB0AE942579D8124FCB,42161,21,23,2,36,47,1847
609,609,91FB7E11CCB9539E71578F3DFA4AFBA7,12921,9,10,1,9,41,491
610,610,91FB7E11CCB9539E71578F3DFA4AFBA7,19181,12,13,1,8,40,440
611,611,91FB7E11CCB9539E71578F3DFA4AFBA7,12921,16,17,1,9,41,491
612,612,91FB7E11CCB9539E71578F3DFA4AFBA7,19181,21,23,2,8,40,440
619,619,F004825C5EEC7F8B7A184D4985895C55,13341,0,10,10,44,45,2245
620,620,F004825C5EEC7F8B7A184D4985895C55,42631,10,12,2,43,45,2195
621,621,F004825C5EEC7F8B7A184D4985895C55,13341,16,23,7,44,45,2245
627,627,CE8FED3538E83DC20F7843C647A5712E,13271,0,7,7,41,47,2097
628,628,CE8FED3538E83DC20F7843C647A5712E,42321,12,18,6,43,47,2197
629,629,CE8FED3538E83DC20F7843C647A5712E,13271,20,23,3,41,47,2097
634,634,05D0332211576823EE224837627FFFA2,13651,10,18,8,30,47,1547
635,635,05D0332211576823EE224837627FFFA2,11561,19,20,1,32,49,1649
636,636,05D0332211576823EE224837627FFFA2,11951,21,23,2,31,49,1599
657,657,A1BDF95E9D3FC1D1F9602700F7A63FC0,42461,0,12,12,45,47,2297
658,658,A1BDF95E9D3FC1D1F9602700F7A63FC0,43621,15,16,1,46,48,2348
659,659,A1BDF95E9D3FC1D1F9602700F7A63FC0,42461,17,23,6,45,47,2297
669,669,D9419B851F8839F5D675C951F631DB8E,10921,0,7,7,43,48,2198
670,670,D9419B851F8839F5D675C951F631DB8E,42321,9,10,1,43,47,2197
671,671,D9419B851F8839F5D675C951F631DB8E,42461,14,15,1,45,47,2297
672,672,D9419B851F8839F5D675C951F631DB8E,10921,19,23,4,43,48,2198
673,673,3F22CE3BC69EEA321201B2CF165B0591,13551,0,15,15,45,38,2288
674,674,3F22CE3BC69EEA321201B2CF165B0591,43101,16,18,2,46,40,2340
675,675,3F22CE3BC69EEA321201B2CF165B0591,13551,19,21,2,45,38,2288
676,676,29B536EE93C2E266619D50C15F53EE29,42531,0,6,6,31,45,1595
677,677,29B536EE93C2E266619D50C15F53EE29,12311,6,10,4,30,44,1544
678,678,29B536EE93C2E266619D50C15F53EE29,42531,10,22,12,31,45,1595
683,683,034BF108F7447DC54755E0BD15E86728,42351,0,15,15,38,45,1945
684,684,034BF108F7447DC54755E0BD15E86728,11261,16,18,2,36,46,1846
685,685,034BF108F7447DC54755E0BD15E86728,42864,18,20,2,38,44,1944
686,686,034BF108F7447DC54755E0BD15E86728,42351,21,23,2,38,45,1945
687,687,08CD8F40B8378DF291040D4794BAEDFC,40123,0,3,3,38,47,1947
688,688,08CD8F40B8378DF291040D4794BAEDFC,10841,5,10,5,37,47,1897
689,689,08CD8F40B8378DF291040D4794BAEDFC,40123,15,23,8,38,47,1947
699,699,0D947EBDA1250C07F4411B7BDAEBFDBC,42531,0,12,12,31,45,1595
700,700,0D947EBDA1250C07F4411B7BDAEBFDBC,12311,13,16,3,30,44,1544
701,701,0D947EBDA1250C07F4411B7BDAEBFDBC,42531,16,23,7,31,45,1595
717,717,9CF16D35CBBB6D43AD3AFEFE9A0A13CD,11061,0,5,5,29,48,1498
718,718,9CF16D35CBBB6D43AD3AFEFE9A0A13CD,11151,6,7,1,30,48,1548
719,719,9CF16D35CBBB6D43AD3AFEFE9A0A13CD,11061,8,9,1,29,48,1498
720,720,9CF16D35CBBB6D43AD3AFEFE9A0A13CD,11151,16,23,7,30,48,1548
721,721,C3E732D15F022D9CEC194DCDE873E649,10471,0,17,17,37,48,1898
722,722,C3E732D15F022D9CEC194DCDE873E649,43171,18,19,1,39,49,1999
723,723,C3E732D15F022D9CEC194DCDE873E649,10471,20,23,3,37,48,1898
728,728,780CF605B987CE4335E0B64DFA86ACBF,12514,2,8,6,38,47,1947
729,729,780CF605B987CE4335E0B64DFA86ACBF,10841,9,17,8,37,47,1897
730,730,780CF605B987CE4335E0B64DFA86ACBF,11921,18,19,1,38,48,1948
731,731,780CF605B987CE4335E0B64DFA86ACBF,42271,19,22,3,40,47,2047
744,744,0C2847EFE5F93E92ACEB4EA16E4104D9,13411,0,5,5,49,42,2492
745,745,0C2847EFE5F93E92ACEB4EA16E4104D9,43951,16,19,3,49,41,2491
746,746,0C2847EFE5F93E92ACEB4EA16E4104D9,13411,20,21,1,49,42,2492
751,751,07E8F527E3C22F701EF1E12272A919B5,12514,0,5,5,38,47,1947
752,752,07E8F527E3C22F701EF1E12272A919B5,42221,5,6,1,38,48,1948
753,753,07E8F527E3C22F701EF1E12272A919B5,11074,7,19,12,37,47,1897
754,754,19544F9BC0BE20E6141BDD062D6E05AC,43451,4,5,1,37,40,1890
755,755,19544F9BC0BE20E6141BDD062D6E05AC,13441,8,10,2,39,39,1989
756,756,19544F9BC0BE20E6141BDD062D6E05AC,12521,10,19,9,35,41,1791
757,757,19544F9BC0BE20E6141BDD062D6E05AC,43451,21,22,1,37,40,1890
762,762,11E25ABC3A273FCF9863C71F053AB5B4,11741,0,10,10,42,49,2149
763,763,11E25ABC3A273FCF9863C71F053AB5B4,41392,11,12,1,43,48,2198
764,764,11E25ABC3A273FCF9863C71F053AB5B4,11741,12,23,11,42,49,2149
765,765,CEAC6C818D7651ADBA37DD2B6097C732,42351,0,10,10,38,45,1945
766,766,CEAC6C818D7651ADBA37DD2B6097C732,42231,10,15,5,37,46,1896
767,767,CEAC6C818D7651ADBA37DD2B6097C732,13911,16,17,1,39,46,1996
768,768,CEAC6C818D7651ADBA37DD2B6097C732,42231,21,22,1,37,46,1896
772,772,85061C43999146706723F4E0700EE955,13911,0,10,10,39,46,1996
773,773,85061C43999146706723F4E0700EE955,11261,10,12,2,36,46,1846
774,774,85061C43999146706723F4E0700EE955,13911,14,20,6,39,46,1996
775,775,F5E1FADD1A2B73E311D54EEEF39B7046,43621,0,5,5,46,48,2348
776,776,F5E1FADD1A2B73E311D54EEEF39B7046,11701,6,8,2,43,48,2198
777,777,F5E1FADD1A2B73E311D54EEEF39B7046,42601,8,18,10,44,48,2248
778,778,F5E1FADD1A2B73E311D54EEEF39B7046,43621,20,23,3,46,48,2348
779,779,FCA3C665B5BF337F331669EDB597A6AC,42791,0,7,7,35,45,1795
780,780,FCA3C665B5BF337F331669EDB597A6AC,10271,8,17,9,37,46,1896
781,781,FCA3C665B5BF337F331669EDB597A6AC,13121,17,19,2,38,46,1946
782,782,FCA3C665B5BF337F331669EDB597A6AC,42151,19,23,4,35,45,1795
803,803,BBEB20E4CE09F78FD771E8818046FF01,42583,0,6,6,40,48,2048
804,804,BBEB20E4CE09F78FD771E8818046FF01,42271,6,14,8,40,47,2047
805,805,BBEB20E4CE09F78FD771E8818046FF01,42583,18,23,5,40,48,2048
809,809,60268F7A02ED65A28DFDDFCBD631880E,42351,0,7,7,38,45,1945
810,810,60268F7A02ED65A28DFDDFCBD631880E,42231,9,11,2,37,46,1896
811,811,60268F7A02ED65A28DFDDFCBD631880E,42351,12,19,7,38,45,1945
844,844,F173533452309401C31245051401B465,13101,0,7,7,40,47,2047
845,845,F173533452309401C31245051401B465,10107,11,14,3,38,49,1949
846,846,F173533452309401C31245051401B465,13101,17,23,6,40,47,2047
850,850,86550A460AB2988C2BAAD303AABC083E,10691,0,9,9,33,48,1698
851,851,86550A460AB2988C2BAAD303AABC083E,42523,10,11,1,31,47,1597
852,852,86550A460AB2988C2BAAD303AABC083E,11861,14,19,5,32,47,1647
853,853,86550A460AB2988C2BAAD303AABC083E,10691,20,23,3,33,48,1698
854,854,E3F6BEAC53881C33A9632EFCBC166461,11021,0,12,12,36,49,1849
855,855,E3F6BEAC53881C33A9632EFCBC166461,11271,13,15,2,37,48,1898
856,856,E3F6BEAC53881C33A9632EFCBC166461,11201,17,19,2,35,49,1799
857,857,E3F6BEAC53881C33A9632EFCBC166461,11021,20,23,3,36,49,1849
866,866,612F18F83615AD18C521C0260D4FB623,11914,0,13,13,37,48,1898
867,867,612F18F83615AD18C521C0260D4FB623,40673,14,15,1,36,48,1848
868,868,612F18F83615AD18C521C0260D4FB623,11914,16,23,7,37,48,1898
869,869,663375B2B611809C9724B33ED9EFA61E,42281,0,6,6,40,48,2048
870,870,663375B2B611809C9724B33ED9EFA61E,13371,8,11,3,41,47,2097
871,871,663375B2B611809C9724B33ED9EFA61E,11231,11,18,7,37,49,1899
872,872,D44EDEFE20C6E53FAD2290D9CECCD593,42041,2,3,1,10,47,547
873,873,D44EDEFE20C6E53FAD2290D9CECCD593,19021,4,7,3,10,45,545
874,874,D44EDEFE20C6E53FAD2290D9CECCD593,19441,8,22,14,8,46,446
875,875,3CF7B0916CDE9473EE3871FE908999F3,19114,1,2,1,7,43,393
876,876,3CF7B0916CDE9473EE3871FE908999F3,19901,2,5,3,7,44,394
877,877,3CF7B0916CDE9473EE3871FE908999F3,12921,7,11,4,9,41,491
878,878,3CF7B0916CDE9473EE3871FE908999F3,19901,11,23,12,7,44,394
879,879,583602182C31C8E2D985404EA5592339,12641,1,4,3,10,43,543
880,880,583602182C31C8E2D985404EA5592339,12921,9,10,1,9,41,491
881,881,583602182C31C8E2D985404EA5592339,12641,12,13,1,10,43,543
882,882,583602182C31C8E2D985404EA5592339,12921,14,22,8,9,41,491
883,883,7A6C1F91C08B692A643E0B4791AE2CE6,12521,0,14,14,35,41,1791
884,884,7A6C1F91C08B692A643E0B4791AE2CE6,43451,14,15,1,37,40,1890
885,885,7A6C1F91C08B692A643E0B4791AE2CE6,12521,19,23,4,35,41,1791
911,911,B36C8579A2DBF718933C4838B2421A42,10841,7,10,3,37,47,1897
912,912,B36C8579A2DBF718933C4838B2421A42,13121,12,14,2,38,46,1946
913,913,B36C8579A2DBF718933C4838B2421A42,42511,15,16,1,37,47,1897
914,914,B36C8579A2DBF718933C4838B2421A42,13121,17,20,3,38,46,1946
915,915,AFB26E028A7D364AA3096B94F4E293F5,42141,0,5,5,32,47,1647
916,916,AFB26E028A7D364AA3096B94F4E293F5,42521,6,7,1,31,47,1597
917,917,AFB26E028A7D364AA3096B94F4E293F5,43761,11,23,12,32,47,1647
923,923,45E2591DDB181830E886EA4FBDDB1E4F,43761,0,8,8,32,47,1647
924,924,45E2591DDB181830E886EA4FBDDB1E4F,10681,9,18,9,30,48,1548
925,925,45E2591DDB181830E886EA4FBDDB1E4F,43761,20,21,1,32,47,1647
930,930,5E3DAD543888AED453CFEE13BBCB613D,42351,1,2,1,38,45,1945
931,931,5E3DAD543888AED453CFEE13BBCB613D,42231,2,15,13,37,46,1896
932,932,5E3DAD543888AED453CFEE13BBCB613D,13911,17,18,1,39,46,1996
936,936,C57E69593CB95494477C252AABEFF884,10811,0,10,10,38,46,1946
937,937,C57E69593CB95494477C252AABEFF884,10841,14,18,4,37,47,1897
938,938,C57E69593CB95494477C252AABEFF884,12514,20,23,3,38,47,1947
943,943,82B78DBAC5E35E1C39E7E024B52B465E,42071,8,15,7,31,49,1599
944,944,82B78DBAC5E35E1C39E7E024B52B465E,11151,18,20,2,30,48,1548
945,945,82B78DBAC5E35E1C39E7E024B52B465E,13511,20,23,3,34,48,1748
946,946,B400ACFA7232ADC3897E9004784F9482,13911,0,3,3,39,46,1996
947,947,B400ACFA7232ADC3897E9004784F9482,12211,4,8,4,41,44,2094
948,948,B400ACFA7232ADC3897E9004784F9482,11261,8,21,13,36,46,1846
949,949,D8DDB7680275E0BD85AEE2B6F249AE80,11021,0,16,16,36,49,1849
950,950,D8DDB7680275E0BD85AEE2B6F249AE80,11074,16,18,2,37,47,1897
951,951,D8DDB7680275E0BD85AEE2B6F249AE80,11541,22,23,1,35,49,1799
955,955,4C8E92DBB85921608C1C92929A7A8C92,42521,0,13,13,31,47,1597
956,956,4C8E92DBB85921608C1C92929A7A8C92,13651,16,18,2,30,47,1547
957,957,4C8E92DBB85921608C1C92929A7A8C92,42521,18,23,5,31,47,1597
971,971,69689F53A4CFA9624E1A1E18FFCBEEBA,11914,0,11,11,37,48,1898
972,972,69689F53A4CFA9624E1A1E18FFCBEEBA,13561,12,17,5,37,49,1899
973,973,69689F53A4CFA9624E1A1E18FFCBEEBA,40951,18,20,2,36,49,1849
974,974,6A0394A16431C3763362EDB77E0D6861,10381,0,2,2,31,49,1599
975,975,6A0394A16431C3763362EDB77E0D6861,10544,2,8,6,28,48,1448
976,976,6A0394A16431C3763362EDB77E0D6861,10381,8,23,15,31,49,1599
977,977,48A79D02D64E57D21DEE0200935875FC,11231,0,2,2,37,49,1899
978,978,48A79D02D64E57D21DEE0200935875FC,11541,2,11,9,35,49,1799
979,979,48A79D02D64E57D21DEE0200935875FC,13561,12,14,2,37,49,1899
980,980,48A79D02D64E57D21DEE0200935875FC,11531,16,18,2,34,49,1749
1007,1007,24C52F5FD3AA43CF1A9BAB6BC0B1DF40,43161,0,5,5,35,47,1797
1008,1008,24C52F5FD3AA43CF1A9BAB6BC0B1DF40,42161,10,12,2,36,47,1847
1009,1009,24C52F5FD3AA43CF1A9BAB6BC0B1DF40,43161,13,21,8,35,47,1797
1010,1010,CC04DF57CD476D56A9C2711AACC54374,11261,4,11,7,36,46,1846
1011,1011,CC04DF57CD476D56A9C2711AACC54374,42861,12,13,1,37,44,1894
1012,1012,CC04DF57CD476D56A9C2711AACC54374,11261,14,19,5,36,46,1846
1013,1013,3624837A8CEE8FA380EBBA166C2E7021,42091,0,11,11,43,46,2196
1014,1014,3624837A8CEE8FA380EBBA166C2E7021,13341,13,14,1,44,45,2245
1015,1015,3624837A8CEE8FA380EBBA166C2E7021,42091,18,19,1,43,46,2196
1039,1039,1C18101ADA4B02F048DFDA93997493B8,42491,0,13,13,32,46,1646
1040,1040,1C18101ADA4B02F048DFDA93997493B8,42523,14,15,1,31,47,1597
1041,1041,1C18101ADA4B02F048DFDA93997493B8,42491,18,21,3,32,46,1646
1046,1046,4A7EF801268FA87DD49AA705DCA560E1,42581,1,7,6,38,48,1948
1047,1047,4A7EF801268FA87DD49AA705DCA560E1,11914,9,10,1,37,48,1898
1048,1048,4A7EF801268FA87DD49AA705DCA560E1,42581,12,22,10,38,48,1948
1049,1049,58FF60972C1637520443DC5766A2AB67,13411,0,4,4,49,42,2492
1050,1050,58FF60972C1637520443DC5766A2AB67,43951,6,12,6,49,41,2491
1051,1051,58FF60972C1637520443DC5766A2AB67,13411,12,13,1,49,42,2492
1052,1052,58FF60972C1637520443DC5766A2AB67,43951,13,18,5,49,41,2491
1059,1059,2B18BEA2FBBC80F82CFB75E581EF2F20,10281,0,3,3,33,48,1698
1060,1060,2B18BEA2FBBC80F82CFB75E581EF2F20,11861,3,7,4,32,47,1647
1061,1061,2B18BEA2FBBC80F82CFB75E581EF2F20,10731,10,15,5,33,47,1697
1062,1062,2B18BEA2FBBC80F82CFB75E581EF2F20,11861,16,22,6,32,47,1647
1063,1063,4C1D4EF3951F66730671C0505D9B5BDE,10471,0,8,8,37,48,1898
1064,1064,4C1D4EF3951F66730671C0505D9B5BDE,11231,8,10,2,37,49,1899
1065,1065,4C1D4EF3951F66730671C0505D9B5BDE,10471,13,23,10,37,48,1898
1107,1107,A8DFAF39A5A26AE1BCD9E9DE060BB315,11091,0,6,6,29,47,1497
1108,1108,A8DFAF39A5A26AE1BCD9E9DE060BB315,13651,6,11,5,30,47,1547
1109,1109,A8DFAF39A5A26AE1BCD9E9DE060BB315,11091,11,23,12,29,47,1497
1110,1110,C54B7E894D1C5CD6E84B2182058F9208,12491,2,6,4,36,43,1843
1111,1111,C54B7E894D1C5CD6E84B2182058F9208,42864,8,11,3,38,44,1944
1112,1112,C54B7E894D1C5CD6E84B2182058F9208,42861,14,19,5,37,44,1894
1113,1113,C54B7E894D1C5CD6E84B2182058F9208,42864,20,23,3,38,44,1944
1114,1114,5A3DFD82E1FA00FA267419BADF9C897C,12311,0,6,6,30,44,1544
1115,1115,5A3DFD82E1FA00FA267419BADF9C897C,42531,8,11,3,31,45,1595
1116,1116,5A3DFD82E1FA00FA267419BADF9C897C,12311,12,20,8,30,44,1544
1117,1117,5B7D20533455968081F1917AE3C512DE,13121,0,6,6,38,46,1946
1118,1118,5B7D20533455968081F1917AE3C512DE,10841,9,21,12,37,47,1897
1119,1119,5B7D20533455968081F1917AE3C512DE,13121,21,22,1,38,46,1946
1120,1120,E798B778C510EAE2B47A353D8CC843E2,10971,9,11,2,35,47,1797
1121,1121,E798B778C510EAE2B47A353D8CC843E2,42161,14,16,2,36,47,1847
1122,1122,E798B778C510EAE2B47A353D8CC843E2,40961,18,19,1,35,47,1797
1123,1123,E798B778C510EAE2B47A353D8CC843E2,42161,21,23,2,36,47,1847
1124,1124,F2C5EC57808705B9AD12F4B58D41E320,11331,1,6,5,37,48,1898
1125,1125,F2C5EC57808705B9AD12F4B58D41E320,10911,7,8,1,39,46,1996
1126,1126,F2C5EC57808705B9AD12F4B58D41E320,11074,11,19,8,37,47,1897
1127,1127,F2C5EC57808705B9AD12F4B58D41E320,10601,21,23,2,39,47,1997
1133,1133,FCF6425DA3F542476DF1F93935C075D8,42581,0,17,17,38,48,1948
1134,1134,FCF6425DA3F542476DF1F93935C075D8,11914,17,19,2,37,48,1898
1135,1135,FCF6425DA3F542476DF1F93935C075D8,42581,21,23,2,38,48,1948
1136,1136,69E806C3AB4BEFEDA10BA970BFCD5C15,11861,0,7,7,32,47,1647
1137,1137,69E806C3AB4BEFEDA10BA970BFCD5C15,10281,8,13,5,33,48,1698
1138,1138,69E806C3AB4BEFEDA10BA970BFCD5C15,11861,13,23,10,32,47,1647
1146,1146,7FBB65FFFB6C624D9A36B33C0250B5DC,12921,0,8,8,9,41,491
1147,1147,7FBB65FFFB6C624D9A36B33C0250B5DC,12641,9,11,2,10,43,543
1148,1148,7FBB65FFFB6C624D9A36B33C0250B5DC,12921,11,23,12,9,41,491
1161,1161,2C8E08930C171C83314368D60E8BB2F5,11021,0,13,13,36,49,1849
1162,1162,2C8E08930C171C83314368D60E8BB2F5,11531,14,16,2,34,49,1749
1163,1163,2C8E08930C171C83314368D60E8BB2F5,43321,22,23,1,36,49,1849
1164,1164,6219AC88F04CB481B6A8F6B3653B0A84,10251,0,12,12,35,47,1797
1165,1165,6219AC88F04CB481B6A8F6B3653B0A84,42161,12,15,3,36,47,1847
1166,1166,6219AC88F04CB481B6A8F6B3653B0A84,10251,20,22,2,35,47,1797
1167,1167,2B75D649D733D42AAC85CA634BF0D07B,11914,0,14,14,37,48,1898
1168,1168,2B75D649D733D42AAC85CA634BF0D07B,42581,18,19,1,38,48,1948
1169,1169,2B75D649D733D42AAC85CA634BF0D07B,11914,19,23,4,37,48,1898
1170,1170,7F73A642AA11134206C46BA15C785E40,10295,0,5,5,30,47,1547
1171,1171,7F73A642AA11134206C46BA15C785E40,42523,5,14,9,31,47,1597
1172,1172,7F73A642AA11134206C46BA15C785E40,10292,16,22,6,30,47,1547
1173,1173,A35D1AA0AE24B0E74C54709AE3B1C7B8,10411,0,12,12,36,48,1848
1174,1174,A35D1AA0AE24B0E74C54709AE3B1C7B8,40951,15,17,2,36,49,1849
1175,1175,A35D1AA0AE24B0E74C54709AE3B1C7B8,42471,20,21,1,35,49,1799
1176,1176,9C3AC29B23B9A7DA8F796C670E195B52,11081,2,4,2,35,46,1796
1177,1177,9C3AC29B23B9A7DA8F796C670E195B52,11131,4,7,3,33,48,1698
1178,1178,9C3AC29B23B9A7DA8F796C670E195B52,42161,12,23,11,36,47,1847
1179,1179,5AB06890D1F02153F5E7416054C280D9,43581,0,6,6,33,48,1698
1180,1180,5AB06890D1F02153F5E7416054C280D9,43731,7,17,10,34,47,1747
1181,1181,5AB06890D1F02153F5E7416054C280D9,12031,19,23,4,33,48,1698
1182,1182,72272CDC285000236363EA14A7DE70DE,42301,0,15,15,36,47,1847
1183,1183,72272CDC285000236363EA14A7DE70DE,10781,17,19,2,35,47,1797
1184,1184,72272CDC285000236363EA14A7DE70DE,42301,19,23,4,36,47,1847
1185,1185,5ED8949BAC5CDF05EDA1019FB7CA4B17,42301,0,14,14,36,47,1847
1186,1186,5ED8949BAC5CDF05EDA1019FB7CA4B17,10471,15,20,5,37,48,1898
1187,1187,5ED8949BAC5CDF05EDA1019FB7CA4B17,42301,21,23,2,36,47,1847
1188,1188,E25E1285A7A60234C9FCE15CA921BDB1,11061,0,14,14,29,48,1498
1189,1189,E25E1285A7A60234C9FCE15CA921BDB1,12971,15,16,1,32,48,1648
1190,1190,E25E1285A7A60234C9FCE15CA921BDB1,43391,17,19,2,29,48,1498
1202,1202,4F0631F4673317A16DCB59F5A84B3918,13711,0,9,9,38,46,1946
1203,1203,4F0631F4673317A16DCB59F5A84B3918,42511,10,11,1,37,47,1897
1204,1204,4F0631F4673317A16DCB59F5A84B3918,13711,19,22,3,38,46,1946
1205,1205,D5941756B17B9199BA7A3AFF31EC477F,11021,0,21,21,36,49,1849
1206,1206,D5941756B17B9199BA7A3AFF31EC477F,13561,21,22,1,37,49,1899
1207,1207,D5941756B17B9199BA7A3AFF31EC477F,11021,22,23,1,36,49,1849
1239,1239,0F4C8C9CC15A29E7FC40E31F5D2234AD,11381,0,8,8,30,47,1547
1240,1240,0F4C8C9CC15A29E7FC40E31F5D2234AD,10951,8,9,1,29,48,1498
1241,1241,0F4C8C9CC15A29E7FC40E31F5D2234AD,11151,10,15,5,30,48,1548
1242,1242,0F4C8C9CC15A29E7FC40E31F5D2234AD,10951,19,22,3,29,48,1498
1248,1248,81D5034BB335E907C610C1F19BE8547C,13371,0,2,2,41,47,2097
1249,1249,81D5034BB335E907C610C1F19BE8547C,10801,5,10,5,42,47,2147
1250,1250,81D5034BB335E907C610C1F19BE8547C,13941,10,23,13,41,47,2097
1260,1260,1034E32537CD89A54195B02D13F8F6C7,42581,2,5,3,38,48,1948
1261,1261,1034E32537CD89A54195B02D13F8F6C7,11914,8,10,2,37,48,1898
1262,1262,1034E32537CD89A54195B02D13F8F6C7,42581,12,22,10,38,48,1948
1263,1263,6820E6314E59B0D0A2416E9349BFF838,43191,0,7,7,40,49,2049
1264,1264,6820E6314E59B0D0A2416E9349BFF838,10621,7,8,1,41,49,2099
1265,1265,6820E6314E59B0D0A2416E9349BFF838,43191,12,13,1,40,49,2049
1266,1266,6820E6314E59B0D0A2416E9349BFF838,12514,15,18,3,38,47,1947
1289,1289,02EE2A9621F66BD6F8785DE528B34698,11061,0,7,7,29,48,1498
1290,1290,02EE2A9621F66BD6F8785DE528B34698,10681,11,12,1,30,48,1548
1291,1291,02EE2A9621F66BD6F8785DE528B34698,11061,14,21,7,29,48,1498
1298,1298,068FED97D465E9858DEA740965A57348,11231,9,10,1,37,49,1899
1299,1299,068FED97D465E9858DEA740965A57348,10901,15,17,2,35,48,1798
1300,1300,068FED97D465E9858DEA740965A57348,11201,19,20,1,35,49,1799
1301,1301,068FED97D465E9858DEA740965A57348,40211,21,23,2,36,49,1849
1305,1305,D51C6C6BE8A8903D8184ED5A28006B69,11231,0,18,18,37,49,1899
1306,1306,D51C6C6BE8A8903D8184ED5A28006B69,42191,18,19,1,38,49,1949
1307,1307,D51C6C6BE8A8903D8184ED5A28006B69,11231,19,23,4,37,49,1899
1314,1314,B786ED6336BC588F18D5288F94297733,10107,10,12,2,38,49,1949
1315,1315,B786ED6336BC588F18D5288F94297733,11731,14,16,2,36,48,1848
1316,1316,B786ED6336BC588F18D5288F94297733,11231,20,23,3,37,49,1899
1328,1328,B7F8AF2F8E9E3B41152CE69E5C52A422,11481,6,7,1,41,48,2098
1329,1329,B7F8AF2F8E9E3B41152CE69E5C52A422,13101,9,10,1,40,47,2047
1330,1330,B7F8AF2F8E9E3B41152CE69E5C52A422,40833,14,15,1,41,47,2097
1331,1331,B7F8AF2F8E9E3B41152CE69E5C52A422,11481,17,21,4,41,48,2098
1337,1337,2F1F7798F5E8889B4080CA59D71F0274,10271,5,6,1,37,46,1896
1338,1338,2F1F7798F5E8889B4080CA59D71F0274,11081,6,9,3,35,46,1796
1339,1339,2F1F7798F5E8889B4080CA59D71F0274,10271,10,23,13,37,46,1896
1345,1345,8F3DC8AEE06C2BE7C4906663F6B8A5C8,42071,2,9,7,31,49,1599
1346,1346,8F3DC8AEE06C2BE7C4906663F6B8A5C8,11211,12,14,2,34,49,1749
1347,1347,8F3DC8AEE06C2BE7C4906663F6B8A5C8,10381,14,23,9,31,49,1599
1348,1348,FE72309A49FBEB6B76C0E42028E74707,42041,7,8,1,10,47,547
1349,1349,FE72309A49FBEB6B76C0E42028E74707,19441,8,16,8,8,46,446
1350,1350,FE72309A49FBEB6B76C0E42028E74707,42041,16,18,2,10,47,547
1351,1351,FE72309A49FBEB6B76C0E42028E74707,19441,21,23,2,8,46,446
1361,1361,157C584795D800615DAF4D6DD048A0E2,11871,0,6,6,29,46,1496
1362,1362,157C584795D800615DAF4D6DD048A0E2,42491,7,8,1,32,46,1646
1363,1363,157C584795D800615DAF4D6DD048A0E2,12311,12,13,1,30,44,1544
1364,1364,157C584795D800615DAF4D6DD048A0E2,11875,17,23,6,30,46,1546
1369,1369,FBDCCC7B029FD625FA592D70C1AE158B,10111,0,14,14,37,47,1897
1370,1370,FBDCCC7B029FD625FA592D70C1AE158B,42301,15,16,1,36,47,1847
1371,1371,FBDCCC7B029FD625FA592D70C1AE158B,10111,16,23,7,37,47,1897
1395,1395,405425CB3107629C743592DE469E38AA,42581,0,14,14,38,48,1948
1396,1396,405425CB3107629C743592DE469E38AA,11914,14,16,2,37,48,1898
1397,1397,405425CB3107629C743592DE469E38AA,42581,16,23,7,38,48,1948
1405,1405,2CBA54B2F1C25B10208FDF74997E0D60,11074,0,14,14,37,47,1897
1406,1406,2CBA54B2F1C25B10208FDF74997E0D60,42231,15,16,1,37,46,1896
1407,1407,2CBA54B2F1C25B10208FDF74997E0D60,11074,18,22,4,37,47,1897
1420,1420,53B9F7992DB29A9E3000FDBC39A3F0DF,11074,0,11,11,37,47,1897
1421,1421,53B9F7992DB29A9E3000FDBC39A3F0DF,12514,14,16,2,38,47,1947
1422,1422,53B9F7992DB29A9E3000FDBC39A3F0DF,11074,16,23,7,37,47,1897
1423,1423,22DC3A1B3F50E23162AF79389084588F,10781,1,17,16,35,47,1797
1424,1424,22DC3A1B3F50E23162AF79389084588F,13121,17,21,4,38,46,1946
1425,1425,22DC3A1B3F50E23162AF79389084588F,10971,21,23,2,35,47,1797
1426,1426,1008DFEE7FA4E4148BDEB87B309051E2,43971,0,1,1,30,48,1548
1427,1427,1008DFEE7FA4E4148BDEB87B309051E2,11061,3,11,8,29,48,1498
1428,1428,1008DFEE7FA4E4148BDEB87B309051E2,11111,13,17,4,26,48,1348
1429,1429,1008DFEE7FA4E4148BDEB87B309051E2,11061,19,20,1,29,48,1498
1430,1430,D72197F9972B6D5BB4AA8E5482CC045B,11381,2,12,10,30,47,1547
1431,1431,D72197F9972B6D5BB4AA8E5482CC045B,10381,15,18,3,31,49,1599
1432,1432,D72197F9972B6D5BB4AA8E5482CC045B,11381,19,23,4,30,47,1547
1441,1441,325F6E45B1DFC860919AE71795AA4212,11861,0,17,17,32,47,1647
1442,1442,325F6E45B1DFC860919AE71795AA4212,10281,19,20,1,33,48,1698
1443,1443,325F6E45B1DFC860919AE71795AA4212,11861,21,23,2,32,47,1647
1449,1449,FDDBAB9FCE399B704F31A21C4D97D4EB,10921,0,14,14,43,48,2198
1450,1450,FDDBAB9FCE399B704F31A21C4D97D4EB,13961,19,20,1,42,48,2148
1451,1451,FDDBAB9FCE399B704F31A21C4D97D4EB,11001,20,23,3,42,47,2147
1462,1462,8C29E031FB5956E038F5FE7083F4864A,42861,1,16,15,37,44,1894
1463,1463,8C29E031FB5956E038F5FE7083F4864A,11261,17,19,2,36,46,1846
1464,1464,8C29E031FB5956E038F5FE7083F4864A,42861,19,20,1,37,44,1894
1465,1465,53C8B8DDB325A454F26DD8A5AE88A7DE,13271,3,14,11,41,47,2097
1466,1466,53C8B8DDB325A454F26DD8A5AE88A7DE,13101,19,20,1,40,47,2047
1467,1467,53C8B8DDB325A454F26DD8A5AE88A7DE,40833,21,23,2,41,47,2097
1475,1475,4FBB43585DEEF505A9B88EDA95B62319,11631,0,2,2,12,49,649
1476,1476,4FBB43585DEEF505A9B88EDA95B62319,42551,2,6,4,14,48,748
1477,1477,4FBB43585DEEF505A9B88EDA95B62319,11631,7,23,16,12,49,649
1484,1484,50654F68D94497D10A1C2B9ADDEB1DF4,11551,0,7,7,39,49,1999
1485,1485,50654F68D94497D10A1C2B9ADDEB1DF4,10191,12,15,3,40,48,2048
1486,1486,50654F68D94497D10A1C2B9ADDEB1DF4,11551,18,23,5,39,49,1999
1487,1487,83032CC6A0DAD180410F046AB9CA56B4,11381,0,8,8,30,47,1547
1488,1488,83032CC6A0DAD180410F046AB9CA56B4,10731,9,10,1,33,47,1697
1489,1489,83032CC6A0DAD180410F046AB9CA56B4,11381,11,15,4,30,47,1547
1490,1490,83032CC6A0DAD180410F046AB9CA56B4,43971,17,19,2,30,48,1548
1491,1491,2D9132D891C9F27B94429ACB6007E58D,11161,0,8,8,32,48,1648
1492,1492,2D9132D891C9F27B94429ACB6007E58D,10491,9,19,10,33,48,1698
1493,1493,2D9132D891C9F27B94429ACB6007E58D,43311,22,23,1,31,48,1598
1517,1517,5B7E0FF980805016CA7392409D272673,10301,4,7,3,31,45,1595
1518,1518,5B7E0FF980805016CA7392409D272673,11834,9,19,10,32,45,1645
1519,1519,5B7E0FF980805016CA7392409D272673,10301,22,23,1,31,45,1595
1528,1528,617CDCBB763C8E42460705E2218A65BF,43761,0,19,19,32,47,1647
1529,1529,617CDCBB763C8E42460705E2218A65BF,10281,19,21,2,33,48,1698
1530,1530,617CDCBB763C8E42460705E2218A65BF,42141,21,22,1,32,47,1647
1535,1535,83257C8F033ED1BBDB8FBECF8D297148,10771,2,7,5,41,46,2096
1536,1536,83257C8F033ED1BBDB8FBECF8D297148,11806,8,10,2,41,48,2098
1537,1537,83257C8F033ED1BBDB8FBECF8D297148,10771,12,23,11,41,46,2096
1538,1538,FBFB039BFE202B4D733B8197A5DE9AA1,43751,3,6,3,19,48,998
1539,1539,FBFB039BFE202B4D733B8197A5DE9AA1,12051,8,18,10,20,47,1047
1540,1540,FBFB039BFE202B4D733B8197A5DE9AA1,43751,20,23,3,19,48,998
1541,1541,9EF2E337C6D77F71D8F5E64DA4E76CDC,42461,0,5,5,45,47,2297
1542,1542,9EF2E337C6D77F71D8F5E64DA4E76CDC,42321,7,17,10,43,47,2197
1543,1543,9EF2E337C6D77F71D8F5E64DA4E76CDC,42461,18,23,5,45,47,2297
1554,1554,02CAD1AF3092FCEB5E6FD12F4524766F,13711,2,15,13,38,46,1946
1555,1555,02CAD1AF3092FCEB5E6FD12F4524766F,10271,16,17,1,37,46,1896
1556,1556,02CAD1AF3092FCEB5E6FD12F4524766F,13121,17,22,5,38,46,1946
1571,1571,95471D684DB585D0049B7AB0C8B83123,43311,1,7,6,31,48,1598
1572,1572,95471D684DB585D0049B7AB0C8B83123,11061,7,18,11,29,48,1498
1573,1573,95471D684DB585D0049B7AB0C8B83123,40445,19,20,1,30,48,1548
1574,1574,95471D684DB585D0049B7AB0C8B83123,11061,20,22,2,29,48,1498
1594,1594,27B6DDFE3A356062F221ABD7AD70BB14,11061,0,12,12,29,48,1498
1595,1595,27B6DDFE3A356062F221ABD7AD70BB14,10681,13,14,1,30,48,1548
1596,1596,27B6DDFE3A356062F221ABD7AD70BB14,11061,14,23,9,29,48,1498
1606,1606,62E083FD6CCFD94FFA49C92986AAE56D,42141,0,14,14,32,47,1647
1607,1607,62E083FD6CCFD94FFA49C92986AAE56D,10281,16,21,5,33,48,1698
1608,1608,62E083FD6CCFD94FFA49C92986AAE56D,43761,22,23,1,32,47,1647
1629,1629,0CEDFC599FE515911C8AF1ADD0F867C7,42301,6,8,2,36,47,1847
1630,1630,0CEDFC599FE515911C8AF1ADD0F867C7,42511,10,14,4,37,47,1897
1631,1631,0CEDFC599FE515911C8AF1ADD0F867C7,11491,14,16,2,36,47,1847
1632,1632,0CEDFC599FE515911C8AF1ADD0F867C7,42271,20,21,1,40,47,2047
1633,1633,477CA15ED76F945C857CBB2B2112D601,42523,0,6,6,31,47,1597
1634,1634,477CA15ED76F945C857CBB2B2112D601,11875,8,9,1,30,46,1546
1635,1635,477CA15ED76F945C857CBB2B2112D601,11321,11,13,2,31,46,1596
1636,1636,477CA15ED76F945C857CBB2B2112D601,42523,15,18,3,31,47,1597
1637,1637,8B7D63C5EBF2F6E2C97BF1B06BF39487,42871,10,11,1,30,45,1545
1638,1638,8B7D63C5EBF2F6E2C97BF1B06BF39487,12311,11,13,2,30,44,1544
1639,1639,8B7D63C5EBF2F6E2C97BF1B06BF39487,10301,17,18,1,31,45,1595
1640,1640,B7441AF7393130851C80B120F7A866BD,11861,0,17,17,32,47,1647
1641,1641,B7441AF7393130851C80B120F7A866BD,43731,18,19,1,34,47,1747
1642,1642,B7441AF7393130851C80B120F7A866BD,11861,21,23,2,32,47,1647
1648,1648,19FF976328DAF40B2191A4FAD8E693E1,43451,7,9,2,37,40,1890
1649,1649,19FF976328DAF40B2191A4FAD8E693E1,42381,12,13,1,39,41,1991
1650,1650,19FF976328DAF40B2191A4FAD8E693E1,43451,14,18,4,37,40,1890
1651,1651,19FF976328DAF40B2191A4FAD8E693E1,42381,20,22,2,39,41,1991
1652,1652,F18C7871BFB82CA1A349E44A5DE6D0B7,11021,0,16,16,36,49,1849
1653,1653,F18C7871BFB82CA1A349E44A5DE6D0B7,10841,17,19,2,37,47,1897
1654,1654,F18C7871BFB82CA1A349E44A5DE6D0B7,11021,22,23,1,36,49,1849
1655,1655,B7B82240105739C2CEE1BD178BBE63E7,42271,2,10,8,40,47,2047
1656,1656,B7B82240105739C2CEE1BD178BBE63E7,40833,11,13,2,41,47,2097
1657,1657,B7B82240105739C2CEE1BD178BBE63E7,11481,15,16,1,41,48,2098
1658,1658,B7B82240105739C2CEE1BD178BBE63E7,13101,18,20,2,40,47,2047
1665,1665,97C28224A360AF4AD406F4028992AC3E,13741,0,6,6,37,49,1899
1666,1666,97C28224A360AF4AD406F4028992AC3E,11211,8,10,2,34,49,1749
1667,1667,97C28224A360AF4AD406F4028992AC3E,11261,12,16,4,36,46,1846
1668,1668,97C28224A360AF4AD406F4028992AC3E,10121,19,20,1,36,49,1849
1678,1678,BEF31F045A546CF30A63CFBCD60FD3FA,13911,0,10,10,39,46,1996
1679,1679,BEF31F045A546CF30A63CFBCD60FD3FA,42231,11,13,2,37,46,1896
1680,1680,BEF31F045A546CF30A63CFBCD60FD3FA,13911,14,16,2,39,46,1996
1681,1681,BEF31F045A546CF30A63CFBCD60FD3FA,42231,16,22,6,37,46,1896
1682,1682,44BA65919A80728667B0D62571A4968D,10271,2,3,1,37,46,1896
1683,1683,44BA65919A80728667B0D62571A4968D,13121,3,11,8,38,46,1946
1684,1684,44BA65919A80728667B0D62571A4968D,10271,14,15,1,37,46,1896
1685,1685,44BA65919A80728667B0D62571A4968D,13121,15,21,6,38,46,1946
1686,1686,EA76F6018E37635F2D98F3C61FC7376D,12514,2,13,11,38,47,1947
1687,1687,EA76F6018E37635F2D98F3C61FC7376D,10841,13,15,2,37,47,1897
1688,1688,EA76F6018E37635F2D98F3C61FC7376D,13331,16,18,2,38,47,1947
1689,1689,EA76F6018E37635F2D98F3C61FC7376D,10841,19,20,1,37,47,1897
1690,1690,629AE0A697B2305FF918536E11F0FBC4,43361,6,16,10,38,48,1948
1691,1691,629AE0A697B2305FF918536E11F0FBC4,42281,16,19,3,40,48,2048
1692,1692,629AE0A697B2305FF918536E11F0FBC4,43361,20,23,3,38,48,1948
1693,1693,DFA44588B9F7612E59AB24A1351E5F4F,12921,0,12,12,9,41,491
1694,1694,DFA44588B9F7612E59AB24A1351E5F4F,49201,14,15,1,7,41,391
1695,1695,DFA44588B9F7612E59AB24A1351E5F4F,12921,16,17,1,9,41,491
1696,1696,DFA44588B9F7612E59AB24A1351E5F4F,49201,18,19,1,7,41,391
1722,1722,59A8093F0E636C09E43B7E2C0A6B3BBC,12391,0,4,4,36,49,1849
1723,1723,59A8093F0E636C09E43B7E2C0A6B3BBC,13561,5,6,1,37,49,1899
1724,1724,59A8093F0E636C09E43B7E2C0A6B3BBC,11021,10,21,11,36,49,1849
1729,1729,97A72775944BA1B8C6B7775217FDFDCA,12514,0,6,6,38,47,1947
1730,1730,97A72775944BA1B8C6B7775217FDFDCA,42271,8,10,2,40,47,2047
1731,1731,97A72775944BA1B8C6B7775217FDFDCA,12514,13,19,6,38,47,1947
1732,1732,97A72775944BA1B8C6B7775217FDFDCA,42221,21,23,2,38,48,1948
1733,1733,04895415E76D1FFF866D6B8869FD01BC,40637,0,11,11,36,47,1847
1734,1734,04895415E76D1FFF866D6B8869FD01BC,12481,18,19,1,37,49,1899
1735,1735,04895415E76D1FFF866D6B8869FD01BC,40637,20,23,3,36,47,1847
1739,1739,60B3904EE9AFD7C630994F95D4C927AC,11231,0,12,12,37,49,1899
1740,1740,60B3904EE9AFD7C630994F95D4C927AC,40951,13,14,1,36,49,1849
1741,1741,60B3904EE9AFD7C630994F95D4C927AC,13561,15,22,7,37,49,1899
1742,1742,35CAA8E33B432720CDD3C14AE49DEBFD,11641,8,10,2,22,49,1149
1743,1743,35CAA8E33B432720CDD3C14AE49DEBFD,43751,10,11,1,19,48,998
1744,1744,35CAA8E33B432720CDD3C14AE49DEBFD,42481,18,21,3,22,49,1149
1749,1749,1331EB294578A8B5035A897C4CDC8F40,42491,0,7,7,32,46,1646
1750,1750,1331EB294578A8B5035A897C4CDC8F40,43761,10,18,8,32,47,1647
1751,1751,1331EB294578A8B5035A897C4CDC8F40,42491,22,23,1,32,46,1646
1757,1757,F14F880CFEF9382CA6FAE593A8A1E7ED,11231,0,11,11,37,49,1899
1758,1758,F14F880CFEF9382CA6FAE593A8A1E7ED,12391,13,15,2,36,49,1849
1759,1759,F14F880CFEF9382CA6FAE593A8A1E7ED,11231,15,23,8,37,49,1899
1765,1765,D9F678D6434563CFC855DB0C2C8BCDAA,10271,0,7,7,37,46,1896
1766,1766,D9F678D6434563CFC855DB0C2C8BCDAA,40951,11,13,2,36,49,1849
1767,1767,D9F678D6434563CFC855DB0C2C8BCDAA,10771,19,21,2,41,46,2096
1768,1768,D9F678D6434563CFC855DB0C2C8BCDAA,10271,21,23,2,37,46,1896
1769,1769,0F63EB0E2A76702961055628B34A5DB2,43241,0,8,8,36,46,1846
1770,1770,0F63EB0E2A76702961055628B34A5DB2,11491,12,13,1,36,47,1847
1771,1771,0F63EB0E2A76702961055628B34A5DB2,43241,14,16,2,36,46,1846
1772,1772,0F63EB0E2A76702961055628B34A5DB2,11074,21,22,1,37,47,1897
1773,1773,E429D5687CEEDF3C035534BDDBC8B9F3,11806,0,2,2,41,48,2098
1774,1774,E429D5687CEEDF3C035534BDDBC8B9F3,13101,7,17,10,40,47,2047
1775,1775,E429D5687CEEDF3C035534BDDBC8B9F3,13271,21,23,2,41,47,2097
1776,1776,F3BD6DC096346506415C8F819B3E2371,11271,0,7,7,37,48,1898
1777,1777,F3BD6DC096346506415C8F819B3E2371,11351,8,10,2,36,48,1848
1778,1778,F3BD6DC096346506415C8F819B3E2371,11271,10,23,13,37,48,1898
1779,1779,EE6B8585E25BB845D2DA0A95F88FAB79,42231,7,14,7,37,46,1896
1780,1780,EE6B8585E25BB845D2DA0A95F88FAB79,42351,15,17,2,38,45,1945
1781,1781,EE6B8585E25BB845D2DA0A95F88FAB79,13911,22,23,1,39,46,1996
1782,1782,1EF65F9DBDC1402BAA31164960F0EECD,42461,0,6,6,45,47,2297
1783,1783,1EF65F9DBDC1402BAA31164960F0EECD,42321,11,17,6,43,47,2197
1784,1784,1EF65F9DBDC1402BAA31164960F0EECD,42461,18,23,5,45,47,2297
1795,1795,DAAC2F234D4AF7282F0FE84305266518,11914,0,3,3,37,48,1898
1796,1796,DAAC2F234D4AF7282F0FE84305266518,42581,5,6,1,38,48,1948
1797,1797,DAAC2F234D4AF7282F0FE84305266518,11914,10,19,9,37,48,1898
1798,1798,52DE1B5B29EB088C4F7CC0D4865B38F5,42151,1,5,4,35,45,1795
1799,1799,52DE1B5B29EB088C4F7CC0D4865B38F5,42861,5,13,8,37,44,1894
1800,1800,52DE1B5B29EB088C4F7CC0D4865B38F5,42151,14,15,1,35,45,1795
1801,1801,52DE1B5B29EB088C4F7CC0D4865B38F5,42861,16,22,6,37,44,1894
1816,1816,36C68D591F1BB1615F00290E59A07445,42041,0,5,5,10,47,547
1817,1817,36C68D591F1BB1615F00290E59A07445,19441,6,11,5,8,46,446
1818,1818,36C68D591F1BB1615F00290E59A07445,42041,12,23,11,10,47,547
1819,1819,61104B29095CCCF7B60C4CC1473B674D,11751,0,10,10,35,48,1798
1820,1820,61104B29095CCCF7B60C4CC1473B674D,13511,14,18,4,34,48,1748
1821,1821,61104B29095CCCF7B60C4CC1473B674D,11271,19,21,2,37,48,1898
1825,1825,CEB438666719FF78831F75A6CA75D9E9,40271,0,5,5,35,49,1799
1826,1826,CEB438666719FF78831F75A6CA75D9E9,13561,7,8,1,37,49,1899
1827,1827,CEB438666719FF78831F75A6CA75D9E9,11021,10,22,12,36,49,1849
1831,1831,1C78870D668C804BBD342874ED35FD15,12083,3,11,8,36,49,1849
1832,1832,1C78870D668C804BBD342874ED35FD15,42961,15,18,3,35,49,1799
1833,1833,1C78870D668C804BBD342874ED35FD15,12391,19,20,1,36,49,1849
1834,1834,1C78870D668C804BBD342874ED35FD15,42961,21,23,2,35,49,1799
1835,1835,13FEB49EBF8CBBDDDEE7B78BF37E951A,10251,0,10,10,35,47,1797
1836,1836,13FEB49EBF8CBBDDDEE7B78BF37E951A,10111,10,18,8,37,47,1897
1837,1837,13FEB49EBF8CBBDDDEE7B78BF37E951A,10251,19,23,4,35,47,1797
1838,1838,C764BB01DA18ED1507B7F7E3E440D93B,10951,0,2,2,29,48,1498
1839,1839,C764BB01DA18ED1507B7F7E3E440D93B,11381,6,7,1,30,47,1547
1840,1840,C764BB01DA18ED1507B7F7E3E440D93B,43391,9,20,11,29,48,1498
1852,1852,23F96418DBDA7106BDBB6C7E2C3432BD,42351,0,7,7,38,45,1945
1853,1853,23F96418DBDA7106BDBB6C7E2C3432BD,42231,9,14,5,37,46,1896
1854,1854,23F96418DBDA7106BDBB6C7E2C3432BD,13911,18,20,2,39,46,1996
1860,1860,6EB4B0748327092CD6C11DF77B2A473A,43361,0,16,16,38,48,1948
1861,1861,6EB4B0748327092CD6C11DF77B2A473A,42281,16,18,2,40,48,2048
1862,1862,6EB4B0748327092CD6C11DF77B2A473A,43361,19,23,4,38,48,1948
1867,1867,A218D71A521B998628574D399C487655,19181,0,2,2,8,40,440
1868,1868,A218D71A521B998628574D399C487655,49201,6,7,1,7,41,391
1869,1869,A218D71A521B998628574D399C487655,12921,8,19,11,9,41,491
1870,1870,A218D71A521B998628574D399C487655,49201,20,22,2,7,41,391
1885,1885,46B3DE812748722328FAB277775E5F5A,12514,0,4,4,38,47,1947
1886,1886,46B3DE812748722328FAB277775E5F5A,11921,7,10,3,38,48,1948
1887,1887,46B3DE812748722328FAB277775E5F5A,12514,13,20,7,38,47,1947
1899,1899,93000056781E39E4F7DE1097E6CF3F56,11914,0,7,7,37,48,1898
1900,1900,93000056781E39E4F7DE1097E6CF3F56,10251,11,18,7,35,47,1797
1901,1901,93000056781E39E4F7DE1097E6CF3F56,13101,19,21,2,40,47,2047
1914,1914,38BAD20AF3F1C2D76FC5AB52738907B1,10341,10,13,3,31,47,1597
1915,1915,38BAD20AF3F1C2D76FC5AB52738907B1,10281,17,18,1,33,48,1698
1916,1916,38BAD20AF3F1C2D76FC5AB52738907B1,10341,18,21,3,31,47,1597
1921,1921,3922FD238DD5D48F7D9D1E9687F957C1,43161,0,12,12,35,47,1797
1922,1922,3922FD238DD5D48F7D9D1E9687F957C1,10731,12,14,2,33,47,1697
1923,1923,3922FD238DD5D48F7D9D1E9687F957C1,43161,18,19,1,35,47,1797
1924,1924,E8A3A2F2678AE58B36D710FCF037760E,11231,0,1,1,37,49,1899
1925,1925,E8A3A2F2678AE58B36D710FCF037760E,10411,2,16,14,36,48,1848
1926,1926,E8A3A2F2678AE58B36D710FCF037760E,11231,17,23,6,37,49,1899
1931,1931,FE157E2906F39F22EFF42EFD9B7DC358,11381,8,19,11,30,47,1547
1932,1932,FE157E2906F39F22EFF42EFD9B7DC358,11061,20,21,1,29,48,1498
1933,1933,FE157E2906F39F22EFF42EFD9B7DC358,11381,22,23,1,30,47,1547
1934,1934,F353FBF89E0E2BACA8526FFAD9D31A0D,11381,0,12,12,30,47,1547
1935,1935,F353FBF89E0E2BACA8526FFAD9D31A0D,10951,12,15,3,29,48,1498
1936,1936,F353FBF89E0E2BACA8526FFAD9D31A0D,11384,15,23,8,30,47,1547
1937,1937,8E7E1D3BA1392AF853A6068E181E9940,12971,1,16,15,32,48,1648
1938,1938,8E7E1D3BA1392AF853A6068E181E9940,10221,17,19,2,34,49,1749
1939,1939,8E7E1D3BA1392AF853A6068E181E9940,12971,19,23,4,32,48,1648
1956,1956,2FC852B4FFDF067DECF04814ED84AACA,42511,0,9,9,37,47,1897
1957,1957,2FC852B4FFDF067DECF04814ED84AACA,10271,12,19,7,37,46,1896
1958,1958,2FC852B4FFDF067DECF04814ED84AACA,42511,20,22,2,37,47,1897
1959,1959,9A1CB6044954B6099E36F60F8EE95A99,11381,0,5,5,30,47,1547
1960,1960,9A1CB6044954B6099E36F60F8EE95A99,10951,9,11,2,29,48,1498
1961,1961,9A1CB6044954B6099E36F60F8EE95A99,11381,16,17,1,30,47,1547
1962,1962,9A1CB6044954B6099E36F60F8EE95A99,10951,19,21,2,29,48,1498
1963,1963,5D7C4261B8FFB60E70298C794D171731,42921,2,12,10,33,47,1697
1964,1964,5D7C4261B8FFB60E70298C794D171731,11751,15,20,5,35,48,1798
1965,1965,5D7C4261B8FFB60E70298C794D171731,42161,21,22,1,36,47,1847
1966,1966,B7B03EB32BB81A6788B81E807AA6B9D3,13741,0,6,6,37,49,1899
1967,1967,B7B03EB32BB81A6788B81E807AA6B9D3,13711,7,16,9,38,46,1946
1968,1968,B7B03EB32BB81A6788B81E807AA6B9D3,10841,19,20,1,37,47,1897
1969,1969,B7B03EB32BB81A6788B81E807AA6B9D3,13741,21,23,2,37,49,1899
1970,1970,CD1558A461467623497C8E8A3785B0D9,42091,0,14,14,43,46,2196
1971,1971,CD1558A461467623497C8E8A3785B0D9,42111,16,17,1,44,46,2246
1972,1972,CD1558A461467623497C8E8A3785B0D9,42461,20,22,2,45,47,2297
1973,1973,8450A465CE75AEB7CF2142B6E9C693B5,11074,10,11,1,37,47,1897
1974,1974,8450A465CE75AEB7CF2142B6E9C693B5,40951,11,12,1,36,49,1849
1975,1975,8450A465CE75AEB7CF2142B6E9C693B5,42471,17,20,3,35,49,1799
1979,1979,3C5BF8354C7B22C00BFA5438C070BC0F,13711,0,9,9,38,46,1946
1980,1980,3C5BF8354C7B22C00BFA5438C070BC0F,42011,9,10,1,36,46,1846
1981,1981,3C5BF8354C7B22C00BFA5438C070BC0F,13711,10,23,13,38,46,1946
1982,1982,2510A335FA627692203CB5C3136C3C6E,43081,0,6,6,27,28,1378
1983,1983,2510A335FA627692203CB5C3136C3C6E,15321,7,13,6,29,26,1476
1984,1984,2510A335FA627692203CB5C3136C3C6E,43081,17,19,2,27,28,1378
1985,1985,2510A335FA627692203CB5C3136C3C6E,15321,21,22,1,29,26,1476
2005,2005,A133E2ED52A039664BC27B2C64703E62,11161,1,11,10,32,48,1648
2006,2006,A133E2ED52A039664BC27B2C64703E62,11861,12,17,5,32,47,1647
2007,2007,A133E2ED52A039664BC27B2C64703E62,11161,18,20,2,32,48,1648
2008,2008,A133E2ED52A039664BC27B2C64703E62,11861,20,23,3,32,47,1647
2009,2009,70944166688D752E1E975B18084F29B8,13941,0,17,17,41,47,2097
2010,2010,70944166688D752E1E975B18084F29B8,42971,18,20,2,43,49,2199
2011,2011,70944166688D752E1E975B18084F29B8,13941,20,23,3,41,47,2097
2012,2012,1C4286795932E5315147C67BA60ADCE3,15191,0,6,6,36,27,1827
2013,2013,1C4286795932E5315147C67BA60ADCE3,15091,9,12,3,35,26,1776
2014,2014,1C4286795932E5315147C67BA60ADCE3,15191,12,23,11,36,27,1827
2015,2015,B02817398E68340C5586B4B2228E2088,42523,8,9,1,31,47,1597
2016,2016,B02817398E68340C5586B4B2228E2088,13651,10,13,3,30,47,1547
2017,2017,B02817398E68340C5586B4B2228E2088,42523,17,19,2,31,47,1597
2018,2018,23938B8CBED0514FF17E1734652299B6,11074,2,15,13,37,47,1897
2019,2019,23938B8CBED0514FF17E1734652299B6,13231,17,18,1,39,46,1996
2020,2020,23938B8CBED0514FF17E1734652299B6,11074,18,23,5,37,47,1897
2042,2042,C10A062A2E87C521BC7FE101323C323B,11861,1,10,9,32,47,1647
2043,2043,C10A062A2E87C521BC7FE101323C323B,13601,10,18,8,34,47,1747
2044,2044,C10A062A2E87C521BC7FE101323C323B,11861,20,23,3,32,47,1647
2045,2045,E27666DBA5763DDAABCA463F0844803E,11831,0,7,7,32,45,1645
2046,2046,E27666DBA5763DDAABCA463F0844803E,12311,7,8,1,30,44,1544
2047,2047,E27666DBA5763DDAABCA463F0844803E,10301,9,11,2,31,45,1595
2048,2048,E27666DBA5763DDAABCA463F0844803E,11831,12,23,11,32,45,1645
2049,2049,973082922DDE0EAED861DD58E0A206BD,13271,0,11,11,41,47,2097
2050,2050,973082922DDE0EAED861DD58E0A206BD,13101,14,16,2,40,47,2047
2051,2051,973082922DDE0EAED861DD58E0A206BD,13271,17,22,5,41,47,2097
2073,2073,8DC35D7D7669C577615C2FE466F52394,10491,0,19,19,33,48,1698
2074,2074,8DC35D7D7669C577615C2FE466F52394,10731,19,20,1,33,47,1697
2075,2075,8DC35D7D7669C577615C2FE466F52394,10491,22,23,1,33,48,1698
2086,2086,A5A342C5B79B8AEE00BA80AE678B8EC5,10331,0,7,7,39,46,1996
2087,2087,A5A342C5B79B8AEE00BA80AE678B8EC5,11521,12,14,2,41,48,2098
2088,2088,A5A342C5B79B8AEE00BA80AE678B8EC5,10331,19,23,4,39,46,1996
2094,2094,E859A0BF6FB37F9B42DF06EC7EE8FF9D,42461,0,6,6,45,47,2297
2095,2095,E859A0BF6FB37F9B42DF06EC7EE8FF9D,42321,7,16,9,43,47,2197
2096,2096,E859A0BF6FB37F9B42DF06EC7EE8FF9D,42461,18,23,5,45,47,2297
2097,2097,F4C44655D662E7B0953357C6BC0F15C4,19904,0,14,14,9,44,494
2098,2098,F4C44655D662E7B0953357C6BC0F15C4,19114,14,15,1,7,43,393
2099,2099,F4C44655D662E7B0953357C6BC0F15C4,12641,15,18,3,10,43,543
2100,2100,F4C44655D662E7B0953357C6BC0F15C4,19904,19,23,4,9,44,494
2109,2109,377BD5B9C037AF000CC29F45169CD1E4,11231,0,10,10,37,49,1899
2110,2110,377BD5B9C037AF000CC29F45169CD1E4,11201,11,19,8,35,49,1799
2111,2111,377BD5B9C037AF000CC29F45169CD1E4,11231,20,23,3,37,49,1899
2119,2119,FC0936587C74EF8144A5D7B54D78302D,19021,0,13,13,10,45,545
2120,2120,FC0936587C74EF8144A5D7B54D78302D,11571,16,19,3,13,46,696
2121,2121,FC0936587C74EF8144A5D7B54D78302D,19021,20,22,2,10,45,545
2122,2122,36B9A094E8D22C518990766A8F925428,19114,0,4,4,7,43,393
2123,2123,36B9A094E8D22C518990766A8F925428,12641,5,7,2,10,43,543
2124,2124,36B9A094E8D22C518990766A8F925428,19114,9,18,9,7,43,393
2128,2128,F4A6A402BBA57C6D1D28948641A481D2,12641,10,11,1,10,43,543
2129,2129,F4A6A402BBA57C6D1D28948641A481D2,19114,13,14,1,7,43,393
2130,2130,F4A6A402BBA57C6D1D28948641A481D2,12921,17,19,2,9,41,491
2131,2131,F4A6A402BBA57C6D1D28948641A481D2,12641,21,22,1,10,43,543
2140,2140,067B7E1EDDCDFF8518B39FF240D5201F,11331,0,13,13,37,48,1898
2141,2141,067B7E1EDDCDFF8518B39FF240D5201F,42961,16,21,5,35,49,1799
2142,2142,067B7E1EDDCDFF8518B39FF240D5201F,11231,21,22,1,37,49,1899
2159,2159,7CB984CC0E6ABE59C1C741CAADBD1FA0,10431,0,12,12,33,49,1699
2160,2160,7CB984CC0E6ABE59C1C741CAADBD1FA0,11861,14,15,1,32,47,1647
2161,2161,7CB984CC0E6ABE59C1C741CAADBD1FA0,10431,16,23,7,33,49,1699
2162,2162,B3D9D8E72FD92A77A76B6490766A3C36,19114,4,13,9,7,43,393
2163,2163,B3D9D8E72FD92A77A76B6490766A3C36,19741,14,16,2,5,44,294
2164,2164,B3D9D8E72FD92A77A76B6490766A3C36,19114,17,21,4,7,43,393
2165,2165,88CCE7AF30CE4EC1E3BF7189154DB826,13121,0,1,1,38,46,1946
2166,2166,88CCE7AF30CE4EC1E3BF7189154DB826,10781,2,11,9,35,47,1797
2167,2167,88CCE7AF30CE4EC1E3BF7189154DB826,13711,11,17,6,38,46,1946
2168,2168,88CCE7AF30CE4EC1E3BF7189154DB826,10971,21,23,2,35,47,1797
2169,2169,2D7ACF8AD7E4B49F2A7FD23DB75DC6F1,42971,0,6,6,43,49,2199
2170,2170,2D7ACF8AD7E4B49F2A7FD23DB75DC6F1,10921,6,8,2,43,48,2198
2171,2171,2D7ACF8AD7E4B49F2A7FD23DB75DC6F1,11741,13,14,1,42,49,2149
2172,2172,2D7ACF8AD7E4B49F2A7FD23DB75DC6F1,42971,17,23,6,43,49,2199
2188,2188,182DF27376D899AFFEB1451233B17D49,15653,0,1,1,40,25,2025
2189,2189,182DF27376D899AFFEB1451233B17D49,15331,1,5,4,38,24,1924
2190,2190,182DF27376D899AFFEB1451233B17D49,15653,6,23,17,40,25,2025
2191,2191,F4D1CACDA44EA0B56E4022B1E4015F81,42511,0,8,8,37,47,1897
2192,2192,F4D1CACDA44EA0B56E4022B1E4015F81,11261,12,20,8,36,46,1846
2193,2193,F4D1CACDA44EA0B56E4022B1E4015F81,42511,21,23,2,37,47,1897
2200,2200,ED1B197D1A6AAA8BFAE9A2A66FB2A911,12921,0,8,8,9,41,491
2201,2201,ED1B197D1A6AAA8BFAE9A2A66FB2A911,49201,8,10,2,7,41,391
2202,2202,ED1B197D1A6AAA8BFAE9A2A66FB2A911,12921,11,12,1,9,41,491
2203,2203,ED1B197D1A6AAA8BFAE9A2A66FB2A911,49201,16,18,2,7,41,391
2204,2204,FC16C89141C8DCB8B75917211B563A66,42401,0,9,9,36,47,1847
2205,2205,FC16C89141C8DCB8B75917211B563A66,42921,9,10,1,33,47,1697
2206,2206,FC16C89141C8DCB8B75917211B563A66,42161,11,23,12,36,47,1847
2237,2237,7598D32DC332293D35F2F6ACB7EBDD15,10251,0,17,17,35,47,1797
2238,2238,7598D32DC332293D35F2F6ACB7EBDD15,40637,17,20,3,36,47,1847
2239,2239,7598D32DC332293D35F2F6ACB7EBDD15,10251,21,23,2,35,47,1797
2243,2243,29ADE64653596AF8549F266F3A0A10FE,42321,0,9,9,43,47,2197
2244,2244,29ADE64653596AF8549F266F3A0A10FE,11521,17,18,1,41,48,2098
2245,2245,29ADE64653596AF8549F266F3A0A10FE,42321,18,23,5,43,47,2197
2254,2254,1CE5F4D10EE2FB173CB9F2BC0746661A,42531,0,1,1,31,45,1595
2255,2255,1CE5F4D10EE2FB173CB9F2BC0746661A,12311,3,5,2,30,44,1544
2256,2256,1CE5F4D10EE2FB173CB9F2BC0746661A,42531,6,10,4,31,45,1595
2257,2257,1CE5F4D10EE2FB173CB9F2BC0746661A,12311,12,18,6,30,44,1544
2273,2273,0E44B8203565C08C4FE28AB9B72AEA81,10251,0,7,7,35,47,1797
2274,2274,0E44B8203565C08C4FE28AB9B72AEA81,11351,9,16,7,36,48,1848
2275,2275,0E44B8203565C08C4FE28AB9B72AEA81,43731,19,20,1,34,47,1747
2276,2276,0E44B8203565C08C4FE28AB9B72AEA81,40637,21,23,2,36,47,1847
2292,2292,9455A3D1656B029E3541C55E1FC4F4F1,13331,6,8,2,38,47,1947
2293,2293,9455A3D1656B029E3541C55E1FC4F4F1,13271,9,10,1,41,47,2097
2294,2294,9455A3D1656B029E3541C55E1FC4F4F1,11481,18,20,2,41,48,2098
2311,2311,9F541427977446D96030A544BAE61896,10221,0,8,8,34,49,1749
2312,2312,9F541427977446D96030A544BAE61896,10161,12,14,2,35,49,1799
2313,2313,9F541427977446D96030A544BAE61896,10651,15,17,2,36,49,1849
2314,2314,9F541427977446D96030A544BAE61896,10161,19,23,4,35,49,1799
2326,2326,22F3641E0471DCB2B80DB2A9F589D5C0,10151,0,8,8,34,47,1747
2327,2327,22F3641E0471DCB2B80DB2A9F589D5C0,10292,11,13,2,30,47,1547
2328,2328,22F3641E0471DCB2B80DB2A9F589D5C0,10151,16,23,7,34,47,1747
2329,2329,F3AB0FBBFC4C22E22895C854430E62BC,42351,0,7,7,38,45,1945
2330,2330,F3AB0FBBFC4C22E22895C854430E62BC,13231,7,9,2,39,46,1996
2331,2331,F3AB0FBBFC4C22E22895C854430E62BC,42351,12,23,11,38,45,1945
2343,2343,1F586282DD0AC03725A5E548411F5D82,10841,0,3,3,37,47,1897
2344,2344,1F586282DD0AC03725A5E548411F5D82,12514,4,16,12,38,47,1947
2345,2345,1F586282DD0AC03725A5E548411F5D82,42511,19,23,4,37,47,1897
2346,2346,7D7A12F5F833F85A7EE1C422265518C9,11901,4,8,4,42,49,2149
2347,2347,7D7A12F5F833F85A7EE1C422265518C9,11301,8,10,2,41,49,2099
2348,2348,7D7A12F5F833F85A7EE1C422265518C9,11901,10,23,13,42,49,2149
2352,2352,B7E1FA8163F9E5C37489B32682514507,10292,2,9,7,30,47,1547
2353,2353,B7E1FA8163F9E5C37489B32682514507,42523,11,13,2,31,47,1597
2354,2354,B7E1FA8163F9E5C37489B32682514507,10292,14,23,9,30,47,1547
2355,2355,813AD3246425C184A34F687274AB8E9F,40271,3,10,7,35,49,1799
2356,2356,813AD3246425C184A34F687274AB8E9F,10901,12,15,3,35,48,1798
2357,2357,813AD3246425C184A34F687274AB8E9F,10107,16,17,1,38,49,1949
2358,2358,813AD3246425C184A34F687274AB8E9F,10901,17,22,5,35,48,1798
2359,2359,8671664FCEA72D44791A077CF27C82B3,12641,5,10,5,10,43,543
2360,2360,8671664FCEA72D44791A077CF27C82B3,12921,11,18,7,9,41,491
2361,2361,8671664FCEA72D44791A077CF27C82B3,12641,18,20,2,10,43,543
2378,2378,10B8A2D44211CACA01D59967B38E8576,42161,0,11,11,36,47,1847
2379,2379,10B8A2D44211CACA01D59967B38E8576,12481,12,19,7,37,49,1899
2380,2380,10B8A2D44211CACA01D59967B38E8576,42161,21,23,2,36,47,1847
2381,2381,511248B31413344B77C12D74A5EE7CDF,43471,0,7,7,31,49,1599
2382,2382,511248B31413344B77C12D74A5EE7CDF,11061,11,12,1,29,48,1498
2383,2383,511248B31413344B77C12D74A5EE7CDF,11151,12,19,7,30,48,1548
2384,2384,511248B31413344B77C12D74A5EE7CDF,43471,20,23,3,31,49,1599
2391,2391,49F76EC706453C742CB5773F705FC79A,12083,0,8,8,36,49,1849
2392,2392,49F76EC706453C742CB5773F705FC79A,11531,9,11,2,34,49,1749
2393,2393,49F76EC706453C742CB5773F705FC79A,10161,12,20,8,35,49,1799
2394,2394,49F76EC706453C742CB5773F705FC79A,12391,21,23,2,36,49,1849
2403,2403,857A8E0D6DC1B408B8273E584D9A8FC4,13371,1,8,7,41,47,2097
2404,2404,857A8E0D6DC1B408B8273E584D9A8FC4,42091,9,10,1,43,46,2196
2405,2405,857A8E0D6DC1B408B8273E584D9A8FC4,13371,10,23,13,41,47,2097
2406,2406,5E8BB1A9FDE1AFD08848003FB8A60E0E,40673,0,14,14,36,48,1848
2407,2407,5E8BB1A9FDE1AFD08848003FB8A60E0E,43731,15,16,1,34,47,1747
2408,2408,5E8BB1A9FDE1AFD08848003FB8A60E0E,10971,17,19,2,35,47,1797
2409,2409,5E8BB1A9FDE1AFD08848003FB8A60E0E,40673,20,23,3,36,48,1848
2410,2410,17B310C5C0CD98D91D2EAE008E1E6775,42491,3,11,8,32,46,1646
2411,2411,17B310C5C0CD98D91D2EAE008E1E6775,13511,12,18,6,34,48,1748
2412,2412,17B310C5C0CD98D91D2EAE008E1E6775,12131,19,21,2,32,47,1647
2413,2413,D27AD15B109272EBC96B3A5E9E02000F,13911,0,7,7,39,46,1996
2414,2414,D27AD15B109272EBC96B3A5E9E02000F,13221,8,10,2,40,47,2047
2415,2415,D27AD15B109272EBC96B3A5E9E02000F,13911,10,13,3,39,46,1996
2416,2416,D27AD15B109272EBC96B3A5E9E02000F,11261,13,20,7,36,46,1846
2420,2420,694352DF30431AC8FE5C641A04ACE1F8,11324,9,10,1,31,46,1596
2421,2421,694352DF30431AC8FE5C641A04ACE1F8,42523,15,16,1,31,47,1597
2422,2422,694352DF30431AC8FE5C641A04ACE1F8,10716,17,19,2,30,46,1546
2429,2429,C69723D9BD6789983419D31FEEAF3013,42523,1,5,4,31,47,1597
2430,2430,C69723D9BD6789983419D31FEEAF3013,13651,6,8,2,30,47,1547
2431,2431,C69723D9BD6789983419D31FEEAF3013,42523,10,18,8,31,47,1597
2441,2441,ECE59966DCE70B4718D84F32D65EA68F,13511,0,14,14,34,48,1748
2442,2442,ECE59966DCE70B4718D84F32D65EA68F,12021,15,16,1,37,49,1899
2443,2443,ECE59966DCE70B4718D84F32D65EA68F,10881,20,23,3,34,48,1748
2455,2455,10EF731AC04D9ABA15B2A1CF1540EBA5,42461,0,10,10,45,47,2297
2456,2456,10EF731AC04D9ABA15B2A1CF1540EBA5,11801,12,16,4,42,48,2148
2457,2457,10EF731AC04D9ABA15B2A1CF1540EBA5,42461,20,22,2,45,47,2297
2458,2458,10EF731AC04D9ABA15B2A1CF1540EBA5,42111,22,23,1,44,46,2246
2463,2463,8C93E9687A717AEFB87364B357E16B82,13941,0,15,15,41,47,2097
2464,2464,8C93E9687A717AEFB87364B357E16B82,12514,18,19,1,38,47,1947
2465,2465,8C93E9687A717AEFB87364B357E16B82,13941,20,23,3,41,47,2097
2466,2466,F1D52E271AD2CA60B9DB39C5E4BE77A4,19021,0,5,5,10,45,545
2467,2467,F1D52E271AD2CA60B9DB39C5E4BE77A4,11571,7,8,1,13,46,696
2468,2468,F1D52E271AD2CA60B9DB39C5E4BE77A4,12641,12,19,7,10,43,543
2469,2469,F1D52E271AD2CA60B9DB39C5E4BE77A4,19021,21,23,2,10,45,545
2477,2477,9793A85FD5F8245DB87C881D3A802622,12661,0,13,13,32,45,1645
2478,2478,9793A85FD5F8245DB87C881D3A802622,12311,13,15,2,30,44,1544
2479,2479,9793A85FD5F8245DB87C881D3A802622,42531,15,16,1,31,45,1595
2480,2480,9793A85FD5F8245DB87C881D3A802622,12311,16,19,3,30,44,1544
2481,2481,520F9ABAA156FE9FB29070D4A540240C,43161,0,1,1,35,47,1797
2482,2482,520F9ABAA156FE9FB29070D4A540240C,10111,1,14,13,37,47,1897
2483,2483,520F9ABAA156FE9FB29070D4A540240C,10411,15,19,4,36,48,1848
2484,2484,520F9ABAA156FE9FB29070D4A540240C,10111,19,23,4,37,47,1897
2485,2485,7300FFB733BFFEA187DB110E4D4DC3D2,49201,0,3,3,7,41,391
2486,2486,7300FFB733BFFEA187DB110E4D4DC3D2,19181,3,6,3,8,40,440
2487,2487,7300FFB733BFFEA187DB110E4D4DC3D2,12921,8,10,2,9,41,491
2488,2488,7300FFB733BFFEA187DB110E4D4DC3D2,49201,12,22,10,7,41,391
2489,2489,D59A2A795558AA457F13EDE8D62837D5,11231,0,10,10,37,49,1899
2490,2490,D59A2A795558AA457F13EDE8D62837D5,42161,11,14,3,36,47,1847
2491,2491,D59A2A795558AA457F13EDE8D62837D5,11461,16,22,6,37,49,1899
2492,2492,49A87E1631E8CE67AEEC9937F25CDD97,10716,0,6,6,30,46,1546
2493,2493,49A87E1631E8CE67AEEC9937F25CDD97,42523,8,9,1,31,47,1597
2494,2494,49A87E1631E8CE67AEEC9937F25CDD97,11151,22,23,1,30,48,1548
2504,2504,00D2FC0AEF9B9FF41E1F26A6EC4801FB,10151,0,11,11,34,47,1747
2505,2505,00D2FC0AEF9B9FF41E1F26A6EC4801FB,11531,11,20,9,34,49,1749
2506,2506,00D2FC0AEF9B9FF41E1F26A6EC4801FB,11841,22,23,1,33,46,1696
2507,2507,B3D3247264CC59DE8B1DE47660D9C8A8,11161,0,4,4,32,48,1648
2508,2508,B3D3247264CC59DE8B1DE47660D9C8A8,43761,7,18,11,32,47,1647
2509,2509,B3D3247264CC59DE8B1DE47660D9C8A8,11161,20,22,2,32,48,1648
2519,2519,5EF7E68928329842CB67D20FA9512ADE,43481,1,8,7,39,48,1998
2520,2520,5EF7E68928329842CB67D20FA9512ADE,12511,9,10,1,39,47,1997
2521,2521,5EF7E68928329842CB67D20FA9512ADE,43481,11,12,1,39,48,1998
2522,2522,5EF7E68928329842CB67D20FA9512ADE,42271,16,18,2,40,47,2047
2523,2523,78C0E1E992CFF9ECB9C6D46D3E929FD4,12121,0,6,6,29,47,1497
2524,2524,78C0E1E992CFF9ECB9C6D46D3E929FD4,11381,8,14,6,30,47,1547
2525,2525,78C0E1E992CFF9ECB9C6D46D3E929FD4,12121,19,22,3,29,47,1497
2534,2534,DC9866094212A637CCAC17CF01FE4B5F,42861,0,5,5,37,44,1894
2535,2535,DC9866094212A637CCAC17CF01FE4B5F,11261,7,8,1,36,46,1846
2536,2536,DC9866094212A637CCAC17CF01FE4B5F,42861,9,23,14,37,44,1894
2545,2545,D9FB9F3F4820A4EF951566780A770C45,42351,0,4,4,38,45,1945
2546,2546,D9FB9F3F4820A4EF951566780A770C45,13911,6,8,2,39,46,1996
2547,2547,D9FB9F3F4820A4EF951566780A770C45,11261,9,22,13,36,46,1846
2548,2548,B11C90C30BACC34A74EC12A03A75D4DA,11261,6,9,3,36,46,1846
2549,2549,B11C90C30BACC34A74EC12A03A75D4DA,10331,10,16,6,39,46,1996
2550,2550,B11C90C30BACC34A74EC12A03A75D4DA,11261,17,19,2,36,46,1846
2551,2551,A1B4425A2C770F57087B15CFC165E63D,11861,0,14,14,32,47,1647
2552,2552,A1B4425A2C770F57087B15CFC165E63D,12381,15,18,3,32,48,1648
2553,2553,A1B4425A2C770F57087B15CFC165E63D,11861,19,23,4,32,47,1647
2554,2554,5C96E9B05EB3EFE9DE3B43368A9F3BB9,42161,0,7,7,36,47,1847
2555,2555,5C96E9B05EB3EFE9DE3B43368A9F3BB9,10161,9,20,11,35,49,1799
2556,2556,5C96E9B05EB3EFE9DE3B43368A9F3BB9,12021,22,23,1,37,49,1899
2572,2572,9A2B71FB3518EEB83FB2FF73CA1A114C,13491,0,8,8,48,39,2439
2573,2573,9A2B71FB3518EEB83FB2FF73CA1A114C,43101,9,20,11,46,40,2340
2574,2574,9A2B71FB3518EEB83FB2FF73CA1A114C,13491,22,23,1,48,39,2439
2585,2585,47844E829FCB05D6E87386BF9A1380C3,13711,0,8,8,38,46,1946
2586,2586,47844E829FCB05D6E87386BF9A1380C3,11941,10,13,3,37,46,1896
2587,2587,47844E829FCB05D6E87386BF9A1380C3,11491,14,23,9,36,47,1847
2599,2599,BEE853049D28B67DAA1CF8A47B438594,12921,0,11,11,9,41,491
2600,2600,BEE853049D28B67DAA1CF8A47B438594,12641,11,12,1,10,43,543
2601,2601,BEE853049D28B67DAA1CF8A47B438594,12921,17,19,2,9,41,491
2607,2607,E3F3B8AA4FF7646294B94B558D95C489,11941,0,6,6,37,46,1896
2608,2608,E3F3B8AA4FF7646294B94B558D95C489,13711,11,12,1,38,46,1946
2609,2609,E3F3B8AA4FF7646294B94B558D95C489,11941,15,16,1,37,46,1896
2610,2610,E3F3B8AA4FF7646294B94B558D95C489,13711,19,21,2,38,46,1946
2634,2634,2C8F3D11EF1554D46E77DD772B97CCCA,10281,1,10,9,33,48,1698
2635,2635,2C8F3D11EF1554D46E77DD772B97CCCA,11861,14,16,2,32,47,1647
2636,2636,2C8F3D11EF1554D46E77DD772B97CCCA,40112,16,20,4,32,48,1648
2637,2637,2C8F3D11EF1554D46E77DD772B97CCCA,42141,22,23,1,32,47,1647
2648,2648,4B3046DDC3BB9689596CDD5399FB5267,12311,10,12,2,30,44,1544
2649,2649,4B3046DDC3BB9689596CDD5399FB5267,11871,13,15,2,29,46,1496
2650,2650,4B3046DDC3BB9689596CDD5399FB5267,11875,17,19,2,30,46,1546
2663,2663,749B796E573CC68A347283ADE6C5408A,10924,0,7,7,43,49,2199
2664,2664,749B796E573CC68A347283ADE6C5408A,11701,16,17,1,43,48,2198
2665,2665,749B796E573CC68A347283ADE6C5408A,10924,18,20,2,43,49,2199
2666,2666,749B796E573CC68A347283ADE6C5408A,10921,21,23,2,43,48,2198
2667,2667,31C99BE35DAA7CC1D9A6D662CA3683F3,41021,7,9,2,38,47,1947
2668,2668,31C99BE35DAA7CC1D9A6D662CA3683F3,42331,12,18,6,39,46,1996
2669,2669,31C99BE35DAA7CC1D9A6D662CA3683F3,41021,21,22,1,38,47,1947
2670,2670,618D9F41DE4EC96FBA6A3C4386221825,10221,0,7,7,34,49,1749
2671,2671,618D9F41DE4EC96FBA6A3C4386221825,11201,10,17,7,35,49,1799
2672,2672,618D9F41DE4EC96FBA6A3C4386221825,10221,18,19,1,34,49,1749
2677,2677,7D165D6EF5EE6D7A94F3B95841A45261,10381,8,9,1,31,49,1599
2678,2678,7D165D6EF5EE6D7A94F3B95841A45261,11151,9,10,1,30,48,1548
2679,2679,7D165D6EF5EE6D7A94F3B95841A45261,42071,12,18,6,31,49,1599
2680,2680,7D165D6EF5EE6D7A94F3B95841A45261,13511,22,23,1,34,48,1748
2681,2681,2FE3A658AB2B7A9048527F74C274D683,42041,2,5,3,10,47,547
2682,2682,2FE3A658AB2B7A9048527F74C274D683,19024,6,7,1,9,45,495
2683,2683,2FE3A658AB2B7A9048527F74C274D683,42041,10,12,2,10,47,547
2684,2684,2FE3A658AB2B7A9048527F74C274D683,19024,16,23,7,9,45,495
2689,2689,DE980DACA70C6198972643EFAF0AD63A,42531,0,2,2,31,45,1595
2690,2690,DE980DACA70C6198972643EFAF0AD63A,11831,3,5,2,32,45,1645
2691,2691,DE980DACA70C6198972643EFAF0AD63A,42531,6,22,16,31,45,1595
2692,2692,2DF528642956EE7F281EE1C987DEF31F,10271,0,7,7,37,46,1896
2693,2693,2DF528642956EE7F281EE1C987DEF31F,13121,10,11,1,38,46,1946
2694,2694,2DF528642956EE7F281EE1C987DEF31F,10271,12,14,2,37,46,1896
2695,2695,2DF528642956EE7F281EE1C987DEF31F,43241,18,19,1,36,46,1846
2700,2700,8754D75561ECA9632B70CECEA43ED98F,11271,1,3,2,37,48,1898
2701,2701,8754D75561ECA9632B70CECEA43ED98F,11461,4,6,2,37,49,1899
2702,2702,8754D75561ECA9632B70CECEA43ED98F,11491,9,15,6,36,47,1847
2703,2703,8754D75561ECA9632B70CECEA43ED98F,11461,18,19,1,37,49,1899
2710,2710,BD8CAD24421DB26887D85E96D51CCDAC,42231,2,7,5,37,46,1896
2711,2711,BD8CAD24421DB26887D85E96D51CCDAC,12514,7,16,9,38,47,1947
2712,2712,BD8CAD24421DB26887D85E96D51CCDAC,42511,16,18,2,37,47,1897
2713,2713,BD8CAD24421DB26887D85E96D51CCDAC,13331,19,20,1,38,47,1947
2719,2719,83DF2DC67F792D97F66715470F9922B2,42521,1,10,9,31,47,1597
2720,2720,83DF2DC67F792D97F66715470F9922B2,43761,11,12,1,32,47,1647
2721,2721,83DF2DC67F792D97F66715470F9922B2,42521,16,18,2,31,47,1597
2722,2722,83DF2DC67F792D97F66715470F9922B2,43761,20,22,2,32,47,1647
2762,2762,F58A6BA375AD1293B95B27D538977CC9,11161,0,13,13,32,48,1648
2763,2763,F58A6BA375AD1293B95B27D538977CC9,10971,15,16,1,35,47,1797
2764,2764,F58A6BA375AD1293B95B27D538977CC9,11161,18,23,5,32,48,1648
2775,2775,88BD866547E35D038437E393C4A29F25,11261,0,8,8,36,46,1846
2776,2776,88BD866547E35D038437E393C4A29F25,12491,11,14,3,36,43,1843
2777,2777,88BD866547E35D038437E393C4A29F25,11261,15,23,8,36,46,1846
2792,2792,7A2C40FB80E14D0B750F490BD1DBAAD5,10811,2,9,7,38,46,1946
2793,2793,7A2C40FB80E14D0B750F490BD1DBAAD5,10331,11,17,6,39,46,1996
2794,2794,7A2C40FB80E14D0B750F490BD1DBAAD5,13711,18,22,4,38,46,1946
2823,2823,68D66AC2F31097852E1113FCAC38B096,12311,0,4,4,30,44,1544
2824,2824,68D66AC2F31097852E1113FCAC38B096,12121,5,6,1,29,47,1497
2825,2825,68D66AC2F31097852E1113FCAC38B096,42531,8,18,10,31,45,1595
2826,2826,68D66AC2F31097852E1113FCAC38B096,12311,22,23,1,30,44,1544
2827,2827,DEAED68AE3C073AACA878B29D6C9BBC2,42231,1,5,4,37,46,1896
2828,2828,DEAED68AE3C073AACA878B29D6C9BBC2,42351,9,12,3,38,45,1945
2829,2829,DEAED68AE3C073AACA878B29D6C9BBC2,42231,13,20,7,37,46,1896
2846,2846,9DAC7A32D3254121BCB79E377899B574,10841,0,8,8,37,47,1897
2847,2847,9DAC7A32D3254121BCB79E377899B574,42221,10,11,1,38,48,1948
2848,2848,9DAC7A32D3254121BCB79E377899B574,10841,16,23,7,37,47,1897
2852,2852,16A0589A145EA4C47047324378E38CE2,42633,0,5,5,42,46,2146
2853,2853,16A0589A145EA4C47047324378E38CE2,42631,6,9,3,43,45,2195
2854,2854,16A0589A145EA4C47047324378E38CE2,42633,10,23,13,42,46,2146
2855,2855,01308B72F71E3AACC045F922DA6CAE4D,43761,10,13,3,32,47,1647
2856,2856,01308B72F71E3AACC045F922DA6CAE4D,42523,13,14,1,31,47,1597
2857,2857,01308B72F71E3AACC045F922DA6CAE4D,43761,14,22,8,32,47,1647
2858,2858,1B1AA14FCBEAAD141CA6FAC7B338917E,11261,0,5,5,36,46,1846
2859,2859,1B1AA14FCBEAAD141CA6FAC7B338917E,42861,7,17,10,37,44,1894
2860,2860,1B1AA14FCBEAAD141CA6FAC7B338917E,11261,20,22,2,36,46,1846
2871,2871,F2D9B654FB0B674E68F375EE60FF33EF,10841,0,9,9,37,47,1897
2872,2872,F2D9B654FB0B674E68F375EE60FF33EF,12514,9,11,2,38,47,1947
2873,2873,F2D9B654FB0B674E68F375EE60FF33EF,10841,13,23,10,37,47,1897
2879,2879,137141A35283BD1412BC50E804A541AB,42633,0,8,8,42,46,2146
2880,2880,137141A35283BD1412BC50E804A541AB,13121,10,13,3,38,46,1946
2881,2881,137141A35283BD1412BC50E804A541AB,10911,20,22,2,39,46,1996
2882,2882,6F881E54FD8247C10253271465BFC769,10111,0,6,6,37,47,1897
2883,2883,6F881E54FD8247C10253271465BFC769,42161,6,8,2,36,47,1847
2884,2884,6F881E54FD8247C10253271465BFC769,10251,8,11,3,35,47,1797
2885,2885,6F881E54FD8247C10253271465BFC769,10111,11,23,12,37,47,1897
2892,2892,9ECA5557B94DDF8D494B58216329A377,42864,4,6,2,38,44,1944
2893,2893,9ECA5557B94DDF8D494B58216329A377,11261,6,8,2,36,46,1846
2894,2894,9ECA5557B94DDF8D494B58216329A377,42864,9,11,2,38,44,1944
2895,2895,9ECA5557B94DDF8D494B58216329A377,11261,11,22,11,36,46,1846
2906,2906,DD306562A0C8DE3D8FDED625E625682E,43281,0,19,19,37,48,1898
2907,2907,DD306562A0C8DE3D8FDED625E625682E,11531,19,21,2,34,49,1749
2908,2908,DD306562A0C8DE3D8FDED625E625682E,11231,21,22,1,37,49,1899
2913,2913,2DF13F3C6B51FEAFB9527CE1523C2712,10711,0,13,13,29,46,1496
2914,2914,2DF13F3C6B51FEAFB9527CE1523C2712,11381,14,15,1,30,47,1547
2915,2915,2DF13F3C6B51FEAFB9527CE1523C2712,10711,17,21,4,29,46,1496
2916,2916,2DF13F3C6B51FEAFB9527CE1523C2712,11381,22,23,1,30,47,1547
2927,2927,221907A0B5FBDE67A1B2826B991290F1,11061,0,6,6,29,48,1498
2928,2928,221907A0B5FBDE67A1B2826B991290F1,11381,6,7,1,30,47,1547
2929,2929,221907A0B5FBDE67A1B2826B991290F1,11061,8,11,3,29,48,1498
2930,2930,221907A0B5FBDE67A1B2826B991290F1,11381,15,19,4,30,47,1547
2939,2939,C676073EF1C3A2F33D7C3EA802CDFBBB,11081,10,11,1,35,46,1796
2940,2940,C676073EF1C3A2F33D7C3EA802CDFBBB,11491,14,16,2,36,47,1847
2941,2941,C676073EF1C3A2F33D7C3EA802CDFBBB,11081,17,18,1,35,46,1796
2958,2958,2F1F755AD0C3D64033AC7CD812D0FE51,42051,1,9,8,42,48,2148
2959,2959,2F1F755AD0C3D64033AC7CD812D0FE51,11901,13,16,3,42,49,2149
2960,2960,2F1F755AD0C3D64033AC7CD812D0FE51,10421,18,22,4,41,48,2098
2961,2961,2F1F755AD0C3D64033AC7CD812D0FE51,11301,22,23,1,41,49,2099
2983,2983,64F430C0C9FB5D31DDDDD74CCCBF2BEF,11061,0,18,18,29,48,1498
2984,2984,64F430C0C9FB5D31DDDDD74CCCBF2BEF,11151,18,21,3,30,48,1548
2985,2985,64F430C0C9FB5D31DDDDD74CCCBF2BEF,11061,21,23,2,29,48,1498
2986,2986,20CD9E3A1B77E936B4A35B7A2F14CDE6,12514,0,8,8,38,47,1947
2987,2987,20CD9E3A1B77E936B4A35B7A2F14CDE6,11074,12,17,5,37,47,1897
2988,2988,20CD9E3A1B77E936B4A35B7A2F14CDE6,12514,21,22,1,38,47,1947
2995,2995,8A35309960304DAF98A2649637AD86E1,10634,0,6,6,27,45,1395
2996,2996,8A35309960304DAF98A2649637AD86E1,10351,8,16,8,28,45,1445
2997,2997,8A35309960304DAF98A2649637AD86E1,10634,17,18,1,27,45,1395
2998,2998,8A35309960304DAF98A2649637AD86E1,10351,19,22,3,28,45,1445
3027,3027,0046CBCDCBA0AE47263F5486B06B7722,42021,0,17,17,33,47,1697
3028,3028,0046CBCDCBA0AE47263F5486B06B7722,11861,19,21,2,32,47,1647
3029,3029,0046CBCDCBA0AE47263F5486B06B7722,42021,21,22,1,33,47,1697
3030,3030,CC3FA096FA296BC301B8FB82BD507846,42471,3,16,13,35,49,1799
3031,3031,CC3FA096FA296BC301B8FB82BD507846,11531,17,19,2,34,49,1749
3032,3032,CC3FA096FA296BC301B8FB82BD507846,10381,20,23,3,31,49,1599
3033,3033,28C2D2FE4D28624F13409918B749F4EA,42231,0,6,6,37,46,1896
3034,3034,28C2D2FE4D28624F13409918B749F4EA,13711,7,18,11,38,46,1946
3035,3035,28C2D2FE4D28624F13409918B749F4EA,11941,18,19,1,37,46,1896
3036,3036,28C2D2FE4D28624F13409918B749F4EA,13711,20,21,1,38,46,1946
3040,3040,AFC682DA7B2C15A5BBB72506964CC56C,11001,0,6,6,42,47,2147
3041,3041,AFC682DA7B2C15A5BBB72506964CC56C,13941,8,14,6,41,47,2097
3042,3042,AFC682DA7B2C15A5BBB72506964CC56C,11001,18,19,1,42,47,2147
3043,3043,BD4B891FBD77D7BD1E693A9E94A83AB3,12641,9,10,1,10,43,543
3044,3044,BD4B891FBD77D7BD1E693A9E94A83AB3,19114,10,12,2,7,43,393
3045,3045,BD4B891FBD77D7BD1E693A9E94A83AB3,12641,12,14,2,10,43,543
3046,3046,BD4B891FBD77D7BD1E693A9E94A83AB3,19114,14,18,4,7,43,393
3047,3047,8868A050B2675F1D16135ACF47FD7E3C,19901,0,4,4,7,44,394
3048,3048,8868A050B2675F1D16135ACF47FD7E3C,19111,6,18,12,9,45,495
3049,3049,8868A050B2675F1D16135ACF47FD7E3C,12641,22,23,1,10,43,543
3050,3050,091DCC0237DDF0F056E1A7BFB1F57890,12641,0,5,5,10,43,543
3051,3051,091DCC0237DDF0F056E1A7BFB1F57890,19021,8,11,3,10,45,545
3052,3052,091DCC0237DDF0F056E1A7BFB1F57890,12641,12,13,1,10,43,543
3053,3053,091DCC0237DDF0F056E1A7BFB1F57890,19021,14,22,8,10,45,545
3054,3054,EAC1D4A2CA6BC033BCE82C152098CC16,11914,0,3,3,37,48,1898
3055,3055,EAC1D4A2CA6BC033BCE82C152098CC16,42581,6,7,1,38,48,1948
3056,3056,EAC1D4A2CA6BC033BCE82C152098CC16,10471,9,20,11,37,48,1898
3057,3057,EAC1D4A2CA6BC033BCE82C152098CC16,12841,21,22,1,37,47,1897
3058,3058,7A784F63DA542325785D1949B0ED9A3A,12311,0,13,13,30,44,1544
3059,3059,7A784F63DA542325785D1949B0ED9A3A,10301,14,16,2,31,45,1595
3060,3060,7A784F63DA542325785D1949B0ED9A3A,12311,20,21,1,30,44,1544
3068,3068,0E40901167898EDFDA9B65FF7D65C295,11851,1,5,4,13,47,697
3069,3069,0E40901167898EDFDA9B65FF7D65C295,42041,9,10,1,10,47,547
3070,3070,0E40901167898EDFDA9B65FF7D65C295,11851,11,22,11,13,47,697
3077,3077,8F0F9FD615E5CF54612AE31BD94EEC63,11381,5,10,5,30,47,1547
3078,3078,8F0F9FD615E5CF54612AE31BD94EEC63,11431,11,13,2,29,47,1497
3079,3079,8F0F9FD615E5CF54612AE31BD94EEC63,13651,15,22,7,30,47,1547
3088,3088,22A9DCD20E3D0F6B8EE783191AF51ADE,42531,1,13,12,31,45,1595
3089,3089,22A9DCD20E3D0F6B8EE783191AF51ADE,10351,17,18,1,28,45,1445
3090,3090,22A9DCD20E3D0F6B8EE783191AF51ADE,12661,20,22,2,32,45,1645
3127,3127,F04EE7F7E05AB27B1A8EDA5AA08E2E0B,42511,0,7,7,37,47,1897
3128,3128,F04EE7F7E05AB27B1A8EDA5AA08E2E0B,11231,9,15,6,37,49,1899
3129,3129,F04EE7F7E05AB27B1A8EDA5AA08E2E0B,41007,20,21,1,37,47,1897
3143,3143,05286C4B5017A260B39768783F7D4555,42581,0,10,10,38,48,1948
3144,3144,05286C4B5017A260B39768783F7D4555,11914,10,12,2,37,48,1898
3145,3145,05286C4B5017A260B39768783F7D4555,40171,15,23,8,38,48,1948
3146,3146,F93F3C4BC4975EDE545CB7377D417310,13371,0,14,14,41,47,2097
3147,3147,F93F3C4BC4975EDE545CB7377D417310,13011,14,18,4,39,47,1997
3148,3148,F93F3C4BC4975EDE545CB7377D417310,10111,19,21,2,37,47,1897
3149,3149,F93F3C4BC4975EDE545CB7377D417310,13011,22,23,1,39,47,1997
3158,3158,785BE75A9FC90AABEA4CAC4215A7CBC9,40941,0,12,12,32,48,1648
3159,3159,785BE75A9FC90AABEA4CAC4215A7CBC9,42021,12,16,4,33,47,1697
3160,3160,785BE75A9FC90AABEA4CAC4215A7CBC9,12381,17,23,6,32,48,1648
3164,3164,AE64A3DFBE9C3342907BF204A8902B7B,12311,0,1,1,30,44,1544
3165,3165,AE64A3DFBE9C3342907BF204A8902B7B,42531,2,3,1,31,45,1595
3166,3166,AE64A3DFBE9C3342907BF204A8902B7B,12311,6,20,14,30,44,1544
3183,3183,4F3F717E93BC5AFE00C4421DCBF0AA01,42301,0,7,7,36,47,1847
3184,3184,4F3F717E93BC5AFE00C4421DCBF0AA01,11261,9,20,11,36,46,1846
3185,3185,4F3F717E93BC5AFE00C4421DCBF0AA01,42511,21,23,2,37,47,1897
3197,3197,A0C13743AF441FE8099AA940DA71C612,43181,0,1,1,39,48,1998
3198,3198,A0C13743AF441FE8099AA940DA71C612,42581,4,10,6,38,48,1948
3199,3199,A0C13743AF441FE8099AA940DA71C612,11914,10,12,2,37,48,1898
3200,3200,A0C13743AF441FE8099AA940DA71C612,42581,12,23,11,38,48,1948
3215,3215,7EA63201A47B68AA085BD7B8AF1F7767,10901,0,8,8,35,48,1798
3216,3216,7EA63201A47B68AA085BD7B8AF1F7767,11231,8,15,7,37,49,1899
3217,3217,7EA63201A47B68AA085BD7B8AF1F7767,12083,17,18,1,36,49,1849
3244,3244,5B985E49A96AC1F29BC71E54AB886B64,10634,3,4,1,27,45,1395
3245,3245,5B985E49A96AC1F29BC71E54AB886B64,10351,4,7,3,28,45,1445
3246,3246,5B985E49A96AC1F29BC71E54AB886B64,10634,8,20,12,27,45,1395
3247,3247,8574FF8C59CC403393CD6B5D40491F79,10221,0,8,8,34,49,1749
3248,3248,8574FF8C59CC403393CD6B5D40491F79,10161,11,12,1,35,49,1799
3249,3249,8574FF8C59CC403393CD6B5D40491F79,10691,13,16,3,33,48,1698
3250,3250,8574FF8C59CC403393CD6B5D40491F79,10221,21,23,2,34,49,1749
3251,3251,CB475691D1589F2BB22AFAB50B53194C,42091,0,12,12,43,46,2196
3252,3252,CB475691D1589F2BB22AFAB50B53194C,13341,14,17,3,44,45,2245
3253,3253,CB475691D1589F2BB22AFAB50B53194C,42091,18,23,5,43,46,2196
3258,3258,B8EDEC6F665DEB478D0B21F34D151949,12083,0,1,1,36,49,1849
3259,3259,B8EDEC6F665DEB478D0B21F34D151949,11941,2,20,18,37,46,1896
3260,3260,B8EDEC6F665DEB478D0B21F34D151949,10111,21,22,1,37,47,1897
3268,3268,E1531D1016DAB55BA101619305B887D8,11361,0,3,3,22,48,1148
3269,3269,E1531D1016DAB55BA101619305B887D8,42691,4,15,11,24,48,1248
3270,3270,E1531D1016DAB55BA101619305B887D8,12051,17,18,1,20,47,1047
3271,3271,4507A6AA40E86D001FA56149FC45CD13,10731,0,6,6,33,47,1697
3272,3272,4507A6AA40E86D001FA56149FC45CD13,13601,6,13,7,34,47,1747
3273,3273,4507A6AA40E86D001FA56149FC45CD13,10731,13,22,9,33,47,1697
3292,3292,312060B326A149D1F0009EDC937831B5,42161,0,6,6,36,47,1847
3293,3293,312060B326A149D1F0009EDC937831B5,11201,7,8,1,35,49,1799
3294,3294,312060B326A149D1F0009EDC937831B5,10111,12,18,6,37,47,1897
3295,3295,312060B326A149D1F0009EDC937831B5,42161,19,23,4,36,47,1847
3303,3303,20790761AC932F5FB5C6E4B51978A3C8,11701,0,7,7,43,48,2198
3304,3304,20790761AC932F5FB5C6E4B51978A3C8,42091,9,12,3,43,46,2196
3305,3305,20790761AC932F5FB5C6E4B51978A3C8,11701,12,23,11,43,48,2198
3329,3329,EEE3AE7ABA4C03B6F4B079A7B52295B8,10281,0,12,12,33,48,1698
3330,3330,EEE3AE7ABA4C03B6F4B079A7B52295B8,10781,16,18,2,35,47,1797
3331,3331,EEE3AE7ABA4C03B6F4B079A7B52295B8,10731,20,23,3,33,47,1697
3340,3340,B6C7AA54BD01E2AF7E412AA91D8473DA,13101,10,11,1,40,47,2047
3341,3341,B6C7AA54BD01E2AF7E412AA91D8473DA,13371,14,15,1,41,47,2097
3342,3342,B6C7AA54BD01E2AF7E412AA91D8473DA,11481,20,23,3,41,48,2098
3350,3350,F7BA1E9C235C1D8A36FA4FE83DC9EFDD,10161,0,1,1,35,49,1799
3351,3351,F7BA1E9C235C1D8A36FA4FE83DC9EFDD,13561,5,6,1,37,49,1899
3352,3352,F7BA1E9C235C1D8A36FA4FE83DC9EFDD,11541,10,21,11,35,49,1799
3358,3358,E4DAC22C285EE7DCF2A6491936A72882,43061,2,5,3,43,46,2196
3359,3359,E4DAC22C285EE7DCF2A6491936A72882,13111,10,11,1,42,46,2146
3360,3360,E4DAC22C285EE7DCF2A6491936A72882,42461,11,21,10,45,47,2297
3369,3369,5EC66C5A4B87D37344B296F73CB04D80,11231,0,10,10,37,49,1899
3370,3370,5EC66C5A4B87D37344B296F73CB04D80,10471,10,17,7,37,48,1898
3371,3371,5EC66C5A4B87D37344B296F73CB04D80,11231,18,22,4,37,49,1899
3372,3372,BB44A13BCAB0B022B18D7F4EDDEC4037,11231,0,3,3,37,49,1899
3373,3373,BB44A13BCAB0B022B18D7F4EDDEC4037,42301,4,14,10,36,47,1847
3374,3374,BB44A13BCAB0B022B18D7F4EDDEC4037,42941,17,20,3,37,47,1897
3375,3375,BB44A13BCAB0B022B18D7F4EDDEC4037,11231,21,23,2,37,49,1899
3379,3379,08328CE7E9194F6D4D982F9C67BFE30D,10731,2,6,4,33,47,1697
3380,3380,08328CE7E9194F6D4D982F9C67BFE30D,13601,10,12,2,34,47,1747
3381,3381,08328CE7E9194F6D4D982F9C67BFE30D,42921,12,23,11,33,47,1697
3382,3382,2D48F3D02C9554B0BD3E088499E97B65,40637,0,12,12,36,47,1847
3383,3383,2D48F3D02C9554B0BD3E088499E97B65,42231,16,17,1,37,46,1896
3384,3384,2D48F3D02C9554B0BD3E088499E97B65,10107,19,20,1,38,49,1949
3385,3385,2D48F3D02C9554B0BD3E088499E97B65,43361,21,22,1,38,48,1948
3386,3386,CC115E075627F49AC17F5D9D869D1EC5,19441,0,12,12,8,46,446
3387,3387,CC115E075627F49AC17F5D9D869D1EC5,42041,15,16,1,10,47,547
3388,3388,CC115E075627F49AC17F5D9D869D1EC5,19441,17,18,1,8,46,446
3389,3389,8204652A3D7742C9538642482E893AC3,12921,0,8,8,9,41,491
3390,3390,8204652A3D7742C9538642482E893AC3,12641,11,17,6,10,43,543
3391,3391,8204652A3D7742C9538642482E893AC3,12921,21,22,1,9,41,491
3412,3412,3C5D029D57650D7A9CE83503042F1003,11261,0,4,4,36,46,1846
3413,3413,3C5D029D57650D7A9CE83503042F1003,42864,6,8,2,38,44,1944
3414,3414,3C5D029D57650D7A9CE83503042F1003,11261,12,20,8,36,46,1846
3415,3415,7961E5CE74E5C1ED13687E14F6869669,10841,1,7,6,37,47,1897
3416,3416,7961E5CE74E5C1ED13687E14F6869669,10471,9,12,3,37,48,1898
3417,3417,7961E5CE74E5C1ED13687E14F6869669,10841,13,15,2,37,47,1897
3418,3418,7961E5CE74E5C1ED13687E14F6869669,42301,16,23,7,36,47,1847
3419,3419,C55CD64DDAAD2837D1AA866EF86E4FF4,42861,0,11,11,37,44,1894
3420,3420,C55CD64DDAAD2837D1AA866EF86E4FF4,11261,16,18,2,36,46,1846
3421,3421,C55CD64DDAAD2837D1AA866EF86E4FF4,42331,21,23,2,39,46,1996
3422,3422,505FF343C6E446E7F99CFC0B5C13724B,42631,0,7,7,43,45,2195
3423,3423,505FF343C6E446E7F99CFC0B5C13724B,13341,9,14,5,44,45,2245
3424,3424,505FF343C6E446E7F99CFC0B5C13724B,42631,16,23,7,43,45,2195
3429,3429,D550BA69D7D3DA019A155BB1D8D005FE,11021,2,9,7,36,49,1849
3430,3430,D550BA69D7D3DA019A155BB1D8D005FE,42471,11,14,3,35,49,1799
3431,3431,D550BA69D7D3DA019A155BB1D8D005FE,11231,15,23,8,37,49,1899
3432,3432,5F3681CA154176D9C587280037CBB99D,13561,0,9,9,37,49,1899
3433,3433,5F3681CA154176D9C587280037CBB99D,10161,13,15,2,35,49,1799
3434,3434,5F3681CA154176D9C587280037CBB99D,13561,15,23,8,37,49,1899
3435,3435,78644A2A041D310FAC74E572ABE3CA9C,11431,2,6,4,29,47,1497
3436,3436,78644A2A041D310FAC74E572ABE3CA9C,11381,11,12,1,30,47,1547
3437,3437,78644A2A041D310FAC74E572ABE3CA9C,11431,15,17,2,29,47,1497
3438,3438,78644A2A041D310FAC74E572ABE3CA9C,10292,21,22,1,30,47,1547
3439,3439,2FC430E1448F290A8E229F5C2301E320,12921,0,9,9,9,41,491
3440,3440,2FC430E1448F290A8E229F5C2301E320,49201,11,12,1,7,41,391
3441,3441,2FC430E1448F290A8E229F5C2301E320,12921,15,20,5,9,41,491
3442,3442,2FC430E1448F290A8E229F5C2301E320,49201,21,23,2,7,41,391
3443,3443,70BC072844C7CA9E90555B310CFF3C22,13601,2,14,12,34,47,1747
3444,3444,70BC072844C7CA9E90555B310CFF3C22,10971,16,18,2,35,47,1797
3445,3445,70BC072844C7CA9E90555B310CFF3C22,43731,21,23,2,34,47,1747
3446,3446,F7F6E311089E545E2ADE21E1CFF4D206,43761,7,11,4,32,47,1647
3447,3447,F7F6E311089E545E2ADE21E1CFF4D206,42921,12,19,7,33,47,1697
3448,3448,F7F6E311089E545E2ADE21E1CFF4D206,40636,20,22,2,35,48,1798
3467,3467,CA591575FBA9862168722666C90215EA,10951,1,2,1,29,48,1498
3468,3468,CA591575FBA9862168722666C90215EA,11381,3,5,2,30,47,1547
3469,3469,CA591575FBA9862168722666C90215EA,10951,5,19,14,29,48,1498
3470,3470,33EC6D9AEACDDB4986AA7A8DDCF6503E,12131,0,1,1,32,47,1647
3471,3471,33EC6D9AEACDDB4986AA7A8DDCF6503E,10381,2,16,14,31,49,1599
3472,3472,33EC6D9AEACDDB4986AA7A8DDCF6503E,10681,22,23,1,30,48,1548
3480,3480,DEBCFE309B11741639F3C7FAE78B2E03,11061,0,8,8,29,48,1498
3481,3481,DEBCFE309B11741639F3C7FAE78B2E03,10381,9,11,2,31,49,1599
3482,3482,DEBCFE309B11741639F3C7FAE78B2E03,11061,11,23,12,29,48,1498
3483,3483,99E7A69682ADA3DC350489A1187F33F9,43761,1,16,15,32,47,1647
3484,3484,99E7A69682ADA3DC350489A1187F33F9,10281,17,20,3,33,48,1698
3485,3485,99E7A69682ADA3DC350489A1187F33F9,43761,21,23,2,32,47,1647
3492,3492,5767DCB7927C2A22DA225038742C1BCE,13561,0,13,13,37,49,1899
3493,3493,5767DCB7927C2A22DA225038742C1BCE,11021,14,17,3,36,49,1849
3494,3494,5767DCB7927C2A22DA225038742C1BCE,13561,18,23,5,37,49,1899
3495,3495,61AF80679359D43A0E6925D92F08EE37,12641,5,8,3,10,43,543
3496,3496,61AF80679359D43A0E6925D92F08EE37,19931,10,14,4,7,43,393
3497,3497,61AF80679359D43A0E6925D92F08EE37,12641,16,21,5,10,43,543
3498,3498,C4DA25473510C59AF311C46DB13EDB15,10971,0,5,5,35,47,1797
3499,3499,C4DA25473510C59AF311C46DB13EDB15,40951,8,10,2,36,49,1849
3500,3500,C4DA25473510C59AF311C46DB13EDB15,10251,11,16,5,35,47,1797
3501,3501,C4DA25473510C59AF311C46DB13EDB15,11081,18,20,2,35,46,1796
3502,3502,FAA2A83085DED75B2B76B1A263011697,11061,1,7,6,29,48,1498
3503,3503,FAA2A83085DED75B2B76B1A263011697,11381,9,14,5,30,47,1547
3504,3504,FAA2A83085DED75B2B76B1A263011697,11061,17,23,6,29,48,1498
3508,3508,23EA4F8B5D0ABEDDC9284DC80F701F9F,42091,0,8,8,43,46,2196
3509,3509,23EA4F8B5D0ABEDDC9284DC80F701F9F,42461,8,14,6,45,47,2297
3510,3510,23EA4F8B5D0ABEDDC9284DC80F701F9F,42091,16,18,2,43,46,2196
3511,3511,23EA4F8B5D0ABEDDC9284DC80F701F9F,42461,19,21,2,45,47,2297
3512,3512,018A1CC117B204501E34F73B68B137CB,42581,2,8,6,38,48,1948
3513,3513,018A1CC117B204501E34F73B68B137CB,11914,8,12,4,37,48,1898
3514,3514,018A1CC117B204501E34F73B68B137CB,42581,13,22,9,38,48,1948
3548,3548,F1249E9F0C0E4CFC8DF3A999C283E2E8,42151,0,17,17,35,45,1795
3549,3549,F1249E9F0C0E4CFC8DF3A999C283E2E8,42861,17,18,1,37,44,1894
3550,3550,F1249E9F0C0E4CFC8DF3A999C283E2E8,42791,18,23,5,35,45,1795
3556,3556,B313DC957E2F1850A88A4D61011A548A,10251,0,17,17,35,47,1797
3557,3557,B313DC957E2F1850A88A4D61011A548A,43731,17,20,3,34,47,1747
3558,3558,B313DC957E2F1850A88A4D61011A548A,10251,20,23,3,35,47,1797
3565,3565,3D0E1B656C5536FA930B97A859157563,41612,0,4,4,36,47,1847
3566,3566,3D0E1B656C5536FA930B97A859157563,12514,5,12,7,38,47,1947
3567,3567,3D0E1B656C5536FA930B97A859157563,10411,19,21,2,36,48,1848
3568,3568,3D0E1B656C5536FA930B97A859157563,40637,21,22,1,36,47,1847
3575,3575,A1E88710F597AD993ACF1C23AEB06926,42271,0,14,14,40,47,2047
3576,3576,A1E88710F597AD993ACF1C23AEB06926,10841,16,17,1,37,47,1897
3577,3577,A1E88710F597AD993ACF1C23AEB06926,42271,19,23,4,40,47,2047
3591,3591,64C0160C1BE92982C639D15A6F2AE02B,11921,2,8,6,38,48,1948
3592,3592,64C0160C1BE92982C639D15A6F2AE02B,11074,11,15,4,37,47,1897
3593,3593,64C0160C1BE92982C639D15A6F2AE02B,11921,17,18,1,38,48,1948
3594,3594,64C0160C1BE92982C639D15A6F2AE02B,11074,22,23,1,37,47,1897
3595,3595,1864B02419412B389045647628AEBFFB,43181,1,9,8,39,48,1998
3596,3596,1864B02419412B389045647628AEBFFB,11331,9,13,4,37,48,1898
3597,3597,1864B02419412B389045647628AEBFFB,11921,14,15,1,38,48,1948
3598,3598,1864B02419412B389045647628AEBFFB,40951,19,20,1,36,49,1849
3599,3599,7EFF4C1F410EC0093C0E819DD0DC2E31,10471,0,4,4,37,48,1898
3600,3600,7EFF4C1F410EC0093C0E819DD0DC2E31,42581,4,8,4,38,48,1948
3601,3601,7EFF4C1F410EC0093C0E819DD0DC2E31,10471,10,22,12,37,48,1898
3602,3602,6FAC7BB08E665D69B9DFE624BBEE190F,11021,0,2,2,36,49,1849
3603,3603,6FAC7BB08E665D69B9DFE624BBEE190F,10107,3,18,15,38,49,1949
3604,3604,6FAC7BB08E665D69B9DFE624BBEE190F,11021,19,23,4,36,49,1849
3614,3614,0635F9DF2EA1E946C4F55221676132EF,10281,0,9,9,33,48,1698
3615,3615,0635F9DF2EA1E946C4F55221676132EF,42523,10,12,2,31,47,1597
3616,3616,0635F9DF2EA1E946C4F55221676132EF,43761,13,19,6,32,47,1647
3622,3622,ECBDB2FB41C6B4CD6088AAF9D9AEA051,19114,0,8,8,7,43,393
3623,3623,ECBDB2FB41C6B4CD6088AAF9D9AEA051,19111,9,11,2,9,45,495
3624,3624,ECBDB2FB41C6B4CD6088AAF9D9AEA051,19114,11,14,3,7,43,393
3625,3625,ECBDB2FB41C6B4CD6088AAF9D9AEA051,12641,18,20,2,10,43,543
3646,3646,508A53F3E777F5ECDE2E5B976BFD7315,42231,2,16,14,37,46,1896
3647,3647,508A53F3E777F5ECDE2E5B976BFD7315,42351,17,18,1,38,45,1945
3648,3648,508A53F3E777F5ECDE2E5B976BFD7315,42231,19,23,4,37,46,1896
3657,3657,4BE03AB7B88CA8091DBCEF6257C15779,42371,0,4,4,34,46,1746
3658,3658,4BE03AB7B88CA8091DBCEF6257C15779,43761,7,13,6,32,47,1647
3659,3659,4BE03AB7B88CA8091DBCEF6257C15779,42521,14,15,1,31,47,1597
3660,3660,4BE03AB7B88CA8091DBCEF6257C15779,43761,17,20,3,32,47,1647
3661,3661,0A3BC1FC76594CFD8E86B400C856431C,42623,1,3,2,22,49,1149
3662,3662,0A3BC1FC76594CFD8E86B400C856431C,40343,3,4,1,24,49,1249
3663,3663,0A3BC1FC76594CFD8E86B400C856431C,42623,4,19,15,22,49,1149
3664,3664,C1BC146C1B557BAE93465B186B08C3FA,12661,0,8,8,32,45,1645
3665,3665,C1BC146C1B557BAE93465B186B08C3FA,42151,8,16,8,35,45,1795
3666,3666,C1BC146C1B557BAE93465B186B08C3FA,12661,18,19,1,32,45,1645
3667,3667,C1BC146C1B557BAE93465B186B08C3FA,12311,20,21,1,30,44,1544
3674,3674,F725A3F859B25741A70E1B3AC0517A8A,10111,0,11,11,37,47,1897
3675,3675,F725A3F859B25741A70E1B3AC0517A8A,42301,12,13,1,36,47,1847
3676,3676,F725A3F859B25741A70E1B3AC0517A8A,12021,13,16,3,37,49,1899
3677,3677,F725A3F859B25741A70E1B3AC0517A8A,42301,20,22,2,36,47,1847
3688,3688,996560DC5309A8A0F454027B1155DD56,11271,0,1,1,37,48,1898
3689,3689,996560DC5309A8A0F454027B1155DD56,12391,1,17,16,36,49,1849
3690,3690,996560DC5309A8A0F454027B1155DD56,11491,18,20,2,36,47,1847
3691,3691,996560DC5309A8A0F454027B1155DD56,11231,21,23,2,37,49,1899
3703,3703,EC1B3E82D1BC9172DE850DFC8774672E,11381,0,6,6,30,47,1547
3704,3704,EC1B3E82D1BC9172DE850DFC8774672E,11061,7,18,11,29,48,1498
3705,3705,EC1B3E82D1BC9172DE850DFC8774672E,11381,20,21,1,30,47,1547
3711,3711,032110C0B74A7FA0BB4790AD77839F0E,42861,0,3,3,37,44,1894
3712,3712,032110C0B74A7FA0BB4790AD77839F0E,11261,3,6,3,36,46,1846
3713,3713,032110C0B74A7FA0BB4790AD77839F0E,42861,6,8,2,37,44,1894
3714,3714,032110C0B74A7FA0BB4790AD77839F0E,11261,11,23,12,36,46,1846
3736,3736,03FE0D0BD52A528C1B4DF1F3C44F085B,43241,0,4,4,36,46,1846
3737,3737,03FE0D0BD52A528C1B4DF1F3C44F085B,11941,5,13,8,37,46,1896
3738,3738,03FE0D0BD52A528C1B4DF1F3C44F085B,42351,14,23,9,38,45,1945
3739,3739,C09C0EAB86082A4D7E18052318E53A38,43161,6,8,2,35,47,1797
3740,3740,C09C0EAB86082A4D7E18052318E53A38,10881,9,12,3,34,48,1748
3741,3741,C09C0EAB86082A4D7E18052318E53A38,12021,21,23,2,37,49,1899
3748,3748,19CFADE53A4E618D30CBCE45D478F0C7,12641,2,7,5,10,43,543
3749,3749,19CFADE53A4E618D30CBCE45D478F0C7,12921,8,17,9,9,41,491
3750,3750,19CFADE53A4E618D30CBCE45D478F0C7,12641,17,18,1,10,43,543
3751,3751,19CFADE53A4E618D30CBCE45D478F0C7,12921,21,23,2,9,41,491
3752,3752,2220ACECA44CDD6B643C1166EB143787,12641,0,6,6,10,43,543
3753,3753,2220ACECA44CDD6B643C1166EB143787,19114,11,12,1,7,43,393
3754,3754,2220ACECA44CDD6B643C1166EB143787,12641,16,23,7,10,43,543
3762,3762,79180DDD86B22B2BAEB51E3552560D4E,11381,0,13,13,30,47,1547
3763,3763,79180DDD86B22B2BAEB51E3552560D4E,12121,14,17,3,29,47,1497
3764,3764,79180DDD86B22B2BAEB51E3552560D4E,13651,18,23,5,30,47,1547
3765,3765,2B742D33ECA5D739DE9809C030EAA6E5,42351,0,12,12,38,45,1945
3766,3766,2B742D33ECA5D739DE9809C030EAA6E5,13911,13,17,4,39,46,1996
3767,3767,2B742D33ECA5D739DE9809C030EAA6E5,42351,20,21,1,38,45,1945
3774,3774,E0F1670DB5561200EEDBAB1833327673,11921,0,5,5,38,48,1948
3775,3775,E0F1670DB5561200EEDBAB1833327673,11231,6,8,2,37,49,1899
3776,3776,E0F1670DB5561200EEDBAB1833327673,12083,8,11,3,36,49,1849
3777,3777,E0F1670DB5561200EEDBAB1833327673,10111,12,22,10,37,47,1897
3778,3778,A50768F5EA25A7EF3C7F0188FC3F5CF0,11261,4,5,1,36,46,1846
3779,3779,A50768F5EA25A7EF3C7F0188FC3F5CF0,42864,5,9,4,38,44,1944
3780,3780,A50768F5EA25A7EF3C7F0188FC3F5CF0,11261,10,11,1,36,46,1846
3781,3781,A50768F5EA25A7EF3C7F0188FC3F5CF0,42864,11,23,12,38,44,1944
3782,3782,B64386F8532B164D8BD72E201ACF3412,43061,0,7,7,43,46,2196
3783,3783,B64386F8532B164D8BD72E201ACF3412,13371,7,18,11,41,47,2097
3784,3784,B64386F8532B164D8BD72E201ACF3412,43061,22,23,1,43,46,2196
3798,3798,DAEEB33C776B03012D94B6F1E26F3BEC,12511,9,11,2,39,47,1997
3799,3799,DAEEB33C776B03012D94B6F1E26F3BEC,43481,13,14,1,39,48,1998
3800,3800,DAEEB33C776B03012D94B6F1E26F3BEC,12511,15,19,4,39,47,1997
3825,3825,F20C6F9EEDC5052A0219DBE6439067E2,11091,1,3,2,29,47,1497
3826,3826,F20C6F9EEDC5052A0219DBE6439067E2,11871,4,5,1,29,46,1496
3827,3827,F20C6F9EEDC5052A0219DBE6439067E2,10716,20,21,1,30,46,1546
3828,3828,E5C174D2FF195FD116006ADE577A953D,11061,0,6,6,29,48,1498
3829,3829,E5C174D2FF195FD116006ADE577A953D,11151,8,15,7,30,48,1548
3830,3830,E5C174D2FF195FD116006ADE577A953D,43391,15,17,2,29,48,1498
3831,3831,E5C174D2FF195FD116006ADE577A953D,11151,17,20,3,30,48,1548
3844,3844,42FFB951EFF49B3A7C7FEF1D95A0CC7C,12514,1,4,3,38,47,1947
3845,3845,42FFB951EFF49B3A7C7FEF1D95A0CC7C,10107,8,17,9,38,49,1949
3846,3846,42FFB951EFF49B3A7C7FEF1D95A0CC7C,11074,20,23,3,37,47,1897
3847,3847,C910BD0B6C804D8FBB0567C9BD082512,43481,0,17,17,39,48,1998
3848,3848,C910BD0B6C804D8FBB0567C9BD082512,11074,19,20,1,37,47,1897
3849,3849,C910BD0B6C804D8FBB0567C9BD082512,43481,21,23,2,39,48,1998
3855,3855,E45BFF8A7B42DBE312092B84982F68A3,11861,0,7,7,32,47,1647
3856,3856,E45BFF8A7B42DBE312092B84982F68A3,11871,8,18,10,29,46,1496
3857,3857,E45BFF8A7B42DBE312092B84982F68A3,11861,21,23,2,32,47,1647
3875,3875,79638A9B8D858113B3F3D1341F67F149,42161,1,12,11,36,47,1847
3876,3876,79638A9B8D858113B3F3D1341F67F149,13121,14,16,2,38,46,1946
3877,3877,79638A9B8D858113B3F3D1341F67F149,42191,19,21,2,38,49,1949
3878,3878,79638A9B8D858113B3F3D1341F67F149,42301,22,23,1,36,47,1847
3879,3879,B32952569BD11113AE8B69EB8DFA8258,42231,3,9,6,37,46,1896
3880,3880,B32952569BD11113AE8B69EB8DFA8258,42351,12,14,2,38,45,1945
3881,3881,B32952569BD11113AE8B69EB8DFA8258,42231,16,20,4,37,46,1896
3885,3885,F3B16B9F2FE5D66DD896BE8E61C1FA80,10351,1,13,12,28,45,1445
3886,3886,F3B16B9F2FE5D66DD896BE8E61C1FA80,10301,14,18,4,31,45,1595
3887,3887,F3B16B9F2FE5D66DD896BE8E61C1FA80,10351,22,23,1,28,45,1445
3893,3893,8B70BE133D79B2254B85E5487DEC3028,10841,2,13,11,37,47,1897
3894,3894,8B70BE133D79B2254B85E5487DEC3028,11781,15,20,5,38,49,1949
3895,3895,8B70BE133D79B2254B85E5487DEC3028,11074,20,23,3,37,47,1897
3899,3899,87A97F0788368BF74B2165CDE829D86F,11481,3,9,6,41,48,2098
3900,3900,87A97F0788368BF74B2165CDE829D86F,40833,9,17,8,41,47,2097
3901,3901,87A97F0788368BF74B2165CDE829D86F,11481,18,20,2,41,48,2098
3907,3907,90AC20E6CC0B4ABA3A4EAC5C3086C030,13741,0,14,14,37,49,1899
3908,3908,90AC20E6CC0B4ABA3A4EAC5C3086C030,11074,15,16,1,37,47,1897
3909,3909,90AC20E6CC0B4ABA3A4EAC5C3086C030,10661,19,20,1,37,49,1899
3910,3910,ACD7D06D699A88B2E7BB7970CE635C80,13651,0,9,9,30,47,1547
3911,3911,ACD7D06D699A88B2E7BB7970CE635C80,42291,9,14,5,29,48,1498
3912,3912,ACD7D06D699A88B2E7BB7970CE635C80,11381,14,23,9,30,47,1547
3926,3926,DFA4422808D05CD48407C6EEDAAEBC25,11861,0,6,6,32,47,1647
3927,3927,DFA4422808D05CD48407C6EEDAAEBC25,42021,7,8,1,33,47,1697
3928,3928,DFA4422808D05CD48407C6EEDAAEBC25,13601,8,10,2,34,47,1747
3929,3929,DFA4422808D05CD48407C6EEDAAEBC25,10951,10,23,13,29,48,1498
3936,3936,24576DC2C63BF30A46BA06C33A71F868,11261,3,8,5,36,46,1846
3937,3937,24576DC2C63BF30A46BA06C33A71F868,12491,10,13,3,36,43,1843
3938,3938,24576DC2C63BF30A46BA06C33A71F868,11261,14,21,7,36,46,1846
3942,3942,9027D7BCCA8B9488D727103093A0EE77,13341,0,8,8,44,45,2245
3943,3943,9027D7BCCA8B9488D727103093A0EE77,12561,10,18,8,45,43,2293
3944,3944,9027D7BCCA8B9488D727103093A0EE77,13341,19,21,2,44,45,2245
3954,3954,CD47BB386DD569A62A78C26CD2C537AF,13941,2,7,5,41,47,2097
3955,3955,CD47BB386DD569A62A78C26CD2C537AF,11001,9,11,2,42,47,2147
3956,3956,CD47BB386DD569A62A78C26CD2C537AF,13941,13,22,9,41,47,2097
3960,3960,597064D826C3E01F204980F028CA1A17,42861,0,6,6,37,44,1894
3961,3961,597064D826C3E01F204980F028CA1A17,11261,6,9,3,36,46,1846
3962,3962,597064D826C3E01F204980F028CA1A17,42861,11,23,12,37,44,1894
3963,3963,FEBD122FF83E402204912098A86567F3,42921,0,8,8,33,47,1697
3964,3964,FEBD122FF83E402204912098A86567F3,11861,11,15,4,32,47,1647
3965,3965,FEBD122FF83E402204912098A86567F3,42921,16,21,5,33,47,1697
3984,3984,424595F1C8846A1CBAEDBFB8FB93F25B,11061,0,4,4,29,48,1498
3985,3985,424595F1C8846A1CBAEDBFB8FB93F25B,12121,6,15,9,29,47,1497
3986,3986,424595F1C8846A1CBAEDBFB8FB93F25B,11061,17,23,6,29,48,1498
3993,3993,CBE7A3597F63878DC13BCD0E58971325,10161,0,10,10,35,49,1799
3994,3994,CBE7A3597F63878DC13BCD0E58971325,42981,12,13,1,36,49,1849
3995,3995,CBE7A3597F63878DC13BCD0E58971325,10161,14,18,4,35,49,1799
3996,3996,CBE7A3597F63878DC13BCD0E58971325,12021,21,22,1,37,49,1899
4006,4006,132BAF41704DD845C2F70543C3732C4E,42231,0,10,10,37,46,1896
4007,4007,132BAF41704DD845C2F70543C3732C4E,13711,11,12,1,38,46,1946
4008,4008,132BAF41704DD845C2F70543C3732C4E,42231,12,15,3,37,46,1896
4009,4009,132BAF41704DD845C2F70543C3732C4E,13711,16,23,7,38,46,1946
4015,4015,F26BB7930BADD8B2E633351CC4D30F65,10471,0,8,8,37,48,1898
4016,4016,F26BB7930BADD8B2E633351CC4D30F65,10107,18,19,1,38,49,1949
4017,4017,F26BB7930BADD8B2E633351CC4D30F65,10471,20,23,3,37,48,1898
4018,4018,935FCB4619C3634B9AF35CE40D9BEC6A,13341,1,18,17,44,45,2245
4019,4019,935FCB4619C3634B9AF35CE40D9BEC6A,42631,19,20,1,43,45,2195
4020,4020,935FCB4619C3634B9AF35CE40D9BEC6A,13341,22,23,1,44,45,2245
4032,4032,CA3F0EB5F0B68EA00FAB1722882286A1,43361,0,18,18,38,48,1948
4033,4033,CA3F0EB5F0B68EA00FAB1722882286A1,11771,18,21,3,39,49,1999
4034,4034,CA3F0EB5F0B68EA00FAB1722882286A1,43361,21,23,2,38,48,1948
4035,4035,4C6EBE1C4B2FAAFACD17B57BF7692986,42161,1,6,5,36,47,1847
4036,4036,4C6EBE1C4B2FAAFACD17B57BF7692986,43731,10,17,7,34,47,1747
4037,4037,4C6EBE1C4B2FAAFACD17B57BF7692986,13511,17,21,4,34,48,1748
4056,4056,66F421352C22D8571066F0AF8EA7BD0D,10251,0,10,10,35,47,1797
4057,4057,66F421352C22D8571066F0AF8EA7BD0D,10491,10,12,2,33,48,1698
4058,4058,66F421352C22D8571066F0AF8EA7BD0D,42021,13,15,2,33,47,1697
4059,4059,66F421352C22D8571066F0AF8EA7BD0D,11861,16,18,2,32,47,1647
4066,4066,8C3FB362A4CAF31AF22E4EB203309D88,42021,6,8,2,33,47,1697
4067,4067,8C3FB362A4CAF31AF22E4EB203309D88,11861,8,13,5,32,47,1647
4068,4068,8C3FB362A4CAF31AF22E4EB203309D88,42021,13,23,10,33,47,1697
4069,4069,EAAB672210C677BA2879CCE67BDB7DF5,11151,0,13,13,30,48,1548
4070,4070,EAAB672210C677BA2879CCE67BDB7DF5,42831,14,15,1,27,48,1398
4071,4071,EAAB672210C677BA2879CCE67BDB7DF5,11061,17,22,5,29,48,1498
4072,4072,F49ED0A4CC36A173117E91CDA96EDE5B,11914,0,14,14,37,48,1898
4073,4073,F49ED0A4CC36A173117E91CDA96EDE5B,42581,14,15,1,38,48,1948
4074,4074,F49ED0A4CC36A173117E91CDA96EDE5B,11331,17,23,6,37,48,1898
4083,4083,F587555054424F7ED0D63829AAEB0C06,42271,0,12,12,40,47,2047
4084,4084,F587555054424F7ED0D63829AAEB0C06,11806,15,17,2,41,48,2098
4085,4085,F587555054424F7ED0D63829AAEB0C06,42271,17,20,3,40,47,2047
4095,4095,534F3B1CD78FDD46A8ACE2B5E3E0C898,11261,6,10,4,36,46,1846
4096,4096,534F3B1CD78FDD46A8ACE2B5E3E0C898,13911,12,13,1,39,46,1996
4097,4097,534F3B1CD78FDD46A8ACE2B5E3E0C898,11261,15,16,1,36,46,1846
4098,4098,534F3B1CD78FDD46A8ACE2B5E3E0C898,13911,21,23,2,39,46,1996
4104,4104,0B48A85C2E63306F2732FBA1CEDC76FB,11021,1,14,13,36,49,1849
4105,4105,0B48A85C2E63306F2732FBA1CEDC76FB,11331,15,16,1,37,48,1898
4106,4106,0B48A85C2E63306F2732FBA1CEDC76FB,11021,17,23,6,36,49,1849
4117,4117,CBDF034E68463476FF7CF3BFCDC64EE8,42301,0,14,14,36,47,1847
4118,4118,CBDF034E68463476FF7CF3BFCDC64EE8,11531,17,18,1,34,49,1749
4119,4119,CBDF034E68463476FF7CF3BFCDC64EE8,10271,19,21,2,37,46,1896
4120,4120,CBDF034E68463476FF7CF3BFCDC64EE8,11491,22,23,1,36,47,1847
4121,4121,2A299573B8ADE5EDDBBA5F82D87A0B34,13601,0,15,15,34,47,1747
4122,4122,2A299573B8ADE5EDDBBA5F82D87A0B34,10731,16,17,1,33,47,1697
4123,4123,2A299573B8ADE5EDDBBA5F82D87A0B34,13601,17,20,3,34,47,1747
4124,4124,61CD021E6A7838BDB314063DA6F5F60D,11061,0,4,4,29,48,1498
4125,4125,61CD021E6A7838BDB314063DA6F5F60D,11381,5,12,7,30,47,1547
4126,4126,61CD021E6A7838BDB314063DA6F5F60D,10544,15,17,2,28,48,1448
4127,4127,61CD021E6A7838BDB314063DA6F5F60D,42291,21,22,1,29,48,1498
4146,4146,EC8D784C19C185B8F2C30A9ECA831652,13911,1,12,11,39,46,1996
4147,4147,EC8D784C19C185B8F2C30A9ECA831652,11261,14,18,4,36,46,1846
4148,4148,EC8D784C19C185B8F2C30A9ECA831652,13911,19,20,1,39,46,1996
4163,4163,AEF4A164C37DCAFC577D72B8BDD1FA59,11151,3,13,10,30,48,1548
4164,4164,AEF4A164C37DCAFC577D72B8BDD1FA59,11061,14,16,2,29,48,1498
4165,4165,AEF4A164C37DCAFC577D72B8BDD1FA59,42071,16,18,2,31,49,1599
4166,4166,1030D8F4FE8CF10A7F5B83AE8CE6624F,42401,1,4,3,36,47,1847
4167,4167,1030D8F4FE8CF10A7F5B83AE8CE6624F,11331,4,13,9,37,48,1898
4168,4168,1030D8F4FE8CF10A7F5B83AE8CE6624F,42401,13,22,9,36,47,1847
4174,4174,1277ACA424D6A91D4C363B632562549C,12601,0,1,1,25,47,1297
4175,4175,1277ACA424D6A91D4C363B632562549C,10501,1,6,5,22,46,1146
4176,4176,1277ACA424D6A91D4C363B632562549C,12601,7,21,14,25,47,1297
4187,4187,756266AA2D3282E41A15D30D8262945F,12381,0,14,14,32,48,1648
4188,4188,756266AA2D3282E41A15D30D8262945F,43311,16,19,3,31,48,1598
4189,4189,756266AA2D3282E41A15D30D8262945F,10221,21,23,2,34,49,1749
4190,4190,01945A452F35C65728F999D92B79DE34,10111,0,12,12,37,47,1897
4191,4191,01945A452F35C65728F999D92B79DE34,42581,14,15,1,38,48,1948
4192,4192,01945A452F35C65728F999D92B79DE34,10111,19,20,1,37,47,1897
4202,4202,2287B0D379AE62342F9E5A8FE93DC228,11021,1,5,4,36,49,1849
4203,4203,2287B0D379AE62342F9E5A8FE93DC228,13561,6,8,2,37,49,1899
4204,4204,2287B0D379AE62342F9E5A8FE93DC228,11021,19,23,4,36,49,1849
4205,4205,EBA7DDA099D901E2B0F74ED4B3F733F8,10121,0,17,17,36,49,1849
4206,4206,EBA7DDA099D901E2B0F74ED4B3F733F8,11231,19,21,2,37,49,1899
4207,4207,EBA7DDA099D901E2B0F74ED4B3F733F8,42961,22,23,1,35,49,1799
4208,4208,59BD035622C1D294E1790B16458D6881,19441,0,11,11,8,46,446
4209,4209,59BD035622C1D294E1790B16458D6881,42041,15,17,2,10,47,547
4210,4210,59BD035622C1D294E1790B16458D6881,19441,19,23,4,8,46,446
4219,4219,89EC37A7B83D9B7D194154C37975BD9C,42521,2,4,2,31,47,1597
4220,4220,89EC37A7B83D9B7D194154C37975BD9C,11381,5,6,1,30,47,1547
4221,4221,89EC37A7B83D9B7D194154C37975BD9C,11061,10,23,13,29,48,1498
4222,4222,4676B3185E4FA5F0DE76C1CDFE074B51,10471,0,11,11,37,48,1898
4223,4223,4676B3185E4FA5F0DE76C1CDFE074B51,10107,12,13,1,38,49,1949
4224,4224,4676B3185E4FA5F0DE76C1CDFE074B51,10471,14,23,9,37,48,1898
4225,4225,0998E942923098D9BA4176BEA1738617,10681,1,8,7,30,48,1548
4226,4226,0998E942923098D9BA4176BEA1738617,11061,11,12,1,29,48,1498
4227,4227,0998E942923098D9BA4176BEA1738617,10681,12,20,8,30,48,1548
4228,4228,0998E942923098D9BA4176BEA1738617,11061,22,23,1,29,48,1498
4229,4229,A0B07DBD7CFEABE1E4A0E9444C496CF6,13381,0,8,8,39,47,1997
4230,4230,A0B07DBD7CFEABE1E4A0E9444C496CF6,42271,8,9,1,40,47,2047
4231,4231,A0B07DBD7CFEABE1E4A0E9444C496CF6,13381,9,21,12,39,47,1997
4252,4252,14C205DF57BD0AA586E26BE4ED695846,42581,0,5,5,38,48,1948
4253,4253,14C205DF57BD0AA586E26BE4ED695846,11914,8,11,3,37,48,1898
4254,4254,14C205DF57BD0AA586E26BE4ED695846,42581,12,16,4,38,48,1948
4255,4255,14C205DF57BD0AA586E26BE4ED695846,11914,16,21,5,37,48,1898
4259,4259,08B76115004F6EB3AEFC7DEF1A1E7865,10251,1,3,2,35,47,1797
4260,4260,08B76115004F6EB3AEFC7DEF1A1E7865,42161,4,13,9,36,47,1847
4261,4261,08B76115004F6EB3AEFC7DEF1A1E7865,10251,15,23,8,35,47,1797
4262,4262,CFEBEFA710E41E6FCE2B9A40127FC9F1,19441,0,7,7,8,46,446
4263,4263,CFEBEFA710E41E6FCE2B9A40127FC9F1,42041,7,8,1,10,47,547
4264,4264,CFEBEFA710E41E6FCE2B9A40127FC9F1,19441,10,23,13,8,46,446
4274,4274,D96C351A2D3BF2CB9C84E8F01C9997B6,12641,0,14,14,10,43,543
4275,4275,D96C351A2D3BF2CB9C84E8F01C9997B6,12921,14,16,2,9,41,491
4276,4276,D96C351A2D3BF2CB9C84E8F01C9997B6,12641,20,23,3,10,43,543
4311,4311,572FC1924B3D406C6B95088F85214228,42041,1,5,4,10,47,547
4312,4312,572FC1924B3D406C6B95088F85214228,11471,6,8,2,12,48,648
4313,4313,572FC1924B3D406C6B95088F85214228,19441,8,11,3,8,46,446
4314,4314,572FC1924B3D406C6B95088F85214228,42041,11,22,11,10,47,547
4322,4322,74520F546F2539E2BFCCF2955A1768C0,11231,0,1,1,37,49,1899
4323,4323,74520F546F2539E2BFCCF2955A1768C0,11271,2,7,5,37,48,1898
4324,4324,74520F546F2539E2BFCCF2955A1768C0,11231,10,21,11,37,49,1899
4341,4341,7BC84DBBA2D73C605C4D8BBF11C620B2,42231,0,14,14,37,46,1896
4342,4342,7BC84DBBA2D73C605C4D8BBF11C620B2,42011,16,17,1,36,46,1846
4343,4343,7BC84DBBA2D73C605C4D8BBF11C620B2,42231,18,23,5,37,46,1896
4358,4358,A300EE82D3804DCD52238D1B3DB8649A,11074,1,15,14,37,47,1897
4359,4359,A300EE82D3804DCD52238D1B3DB8649A,11261,15,16,1,36,46,1846
4360,4360,A300EE82D3804DCD52238D1B3DB8649A,11074,17,23,6,37,47,1897
4367,4367,7158BB5FE54F024DF86B9682428D7D80,42581,0,5,5,38,48,1948
4368,4368,7158BB5FE54F024DF86B9682428D7D80,10471,5,8,3,37,48,1898
4369,4369,7158BB5FE54F024DF86B9682428D7D80,42581,9,14,5,38,48,1948
4370,4370,7158BB5FE54F024DF86B9682428D7D80,10471,18,21,3,37,48,1898
4379,4379,A4B13605C78797589D9B98BC8787EDD0,12641,0,6,6,10,43,543
4380,4380,A4B13605C78797589D9B98BC8787EDD0,12921,8,10,2,9,41,491
4381,4381,A4B13605C78797589D9B98BC8787EDD0,12641,14,18,4,10,43,543
4382,4382,D54477AB0049D6C15615D96E9339F35F,10411,0,6,6,36,48,1848
4383,4383,D54477AB0049D6C15615D96E9339F35F,42161,10,17,7,36,47,1847
4384,4384,D54477AB0049D6C15615D96E9339F35F,10411,20,22,2,36,48,1848
4403,4403,394D700E14C58A7853C10805B183B24E,11381,1,3,2,30,47,1547
4404,4404,394D700E14C58A7853C10805B183B24E,11061,3,6,3,29,48,1498
4405,4405,394D700E14C58A7853C10805B183B24E,11871,9,18,9,29,46,1496
4406,4406,394D700E14C58A7853C10805B183B24E,11381,21,22,1,30,47,1547
4407,4407,EEEB433A36E0F496A9DAB4A209387715,10634,0,4,4,27,45,1395
4408,4408,EEEB433A36E0F496A9DAB4A209387715,12311,8,10,2,30,44,1544
4409,4409,EEEB433A36E0F496A9DAB4A209387715,42531,15,20,5,31,45,1595
4416,4416,80779C982E47128931C5479B9B9DAF80,10251,0,1,1,35,47,1797
4417,4417,80779C982E47128931C5479B9B9DAF80,11861,2,16,14,32,47,1647
4418,4418,80779C982E47128931C5479B9B9DAF80,10251,19,20,1,35,47,1797
4419,4419,80779C982E47128931C5479B9B9DAF80,11861,21,23,2,32,47,1647
4420,4420,F4EE372BA019175C25249C887C1C24C1,11231,0,2,2,37,49,1899
4421,4421,F4EE372BA019175C25249C887C1C24C1,10161,2,20,18,35,49,1799
4422,4422,F4EE372BA019175C25249C887C1C24C1,11231,20,23,3,37,49,1899
4423,4423,34F0FE8128B349687EAC9B8F5F449752,10221,0,10,10,34,49,1749
4424,4424,34F0FE8128B349687EAC9B8F5F449752,40951,15,17,2,36,49,1849
4425,4425,34F0FE8128B349687EAC9B8F5F449752,10221,21,23,2,34,49,1749
4426,4426,C13EDA65C3B019881628338CF4BA6FEF,42491,0,3,3,32,46,1646
4427,4427,C13EDA65C3B019881628338CF4BA6FEF,42523,3,20,17,31,47,1597
4428,4428,C13EDA65C3B019881628338CF4BA6FEF,42491,20,23,3,32,46,1646
4429,4429,6DFA48F81EF42083077B44FC80706865,10971,6,16,10,35,47,1797
4430,4430,6DFA48F81EF42083077B44FC80706865,43731,19,20,1,34,47,1747
4431,4431,6DFA48F81EF42083077B44FC80706865,43161,21,23,2,35,47,1797
4435,4435,E54448644210581D2882372CB147E429,10251,0,8,8,35,47,1797
4436,4436,E54448644210581D2882372CB147E429,42401,8,16,8,36,47,1847
4437,4437,E54448644210581D2882372CB147E429,10111,16,23,7,37,47,1897
4438,4438,7DFCA2932B390D69ABC0E415A2260097,10351,0,8,8,28,45,1445
4439,4439,7DFCA2932B390D69ABC0E415A2260097,42531,8,15,7,31,45,1595
4440,4440,7DFCA2932B390D69ABC0E415A2260097,12311,16,18,2,30,44,1544
4441,4441,7DFCA2932B390D69ABC0E415A2260097,10301,21,23,2,31,45,1595
4442,4442,87F0A5B37D23577900D9D67376C1E962,10721,9,12,3,31,48,1598
4443,4443,87F0A5B37D23577900D9D67376C1E962,10491,14,16,2,33,48,1698
4444,4444,87F0A5B37D23577900D9D67376C1E962,12381,16,20,4,32,48,1648
4445,4445,87F0A5B37D23577900D9D67376C1E962,10721,21,22,1,31,48,1598
4469,4469,09B258FCC1A04CEAAFFB93000EF42A6F,10811,0,6,6,38,46,1946
4470,4470,09B258FCC1A04CEAAFFB93000EF42A6F,11074,8,10,2,37,47,1897
4471,4471,09B258FCC1A04CEAAFFB93000EF42A6F,12511,12,17,5,39,47,1997
4472,4472,09B258FCC1A04CEAAFFB93000EF42A6F,13231,19,21,2,39,46,1996
4476,4476,A2939A88D49E89644FEBA8B1C0E8B435,42161,0,7,7,36,47,1847
4477,4477,A2939A88D49E89644FEBA8B1C0E8B435,10111,8,9,1,37,47,1897
4478,4478,A2939A88D49E89644FEBA8B1C0E8B435,10251,12,17,5,35,47,1797
4479,4479,A2939A88D49E89644FEBA8B1C0E8B435,10111,18,20,2,37,47,1897
4488,4488,CD55B44A3FD4B718A673CC03711FD344,12921,5,6,1,9,41,491
4489,4489,CD55B44A3FD4B718A673CC03711FD344,12641,8,10,2,10,43,543
4490,4490,CD55B44A3FD4B718A673CC03711FD344,12921,10,23,13,9,41,491
4511,4511,B411CA40C62639B41FB1F1B86351EA24,11021,0,7,7,36,49,1849
4512,4512,B411CA40C62639B41FB1F1B86351EA24,10111,10,21,11,37,47,1897
4513,4513,B411CA40C62639B41FB1F1B86351EA24,11021,22,23,1,36,49,1849
4521,4521,070CCFB95BD7B5493FC205585FDC7AC9,13341,0,5,5,44,45,2245
4522,4522,070CCFB95BD7B5493FC205585FDC7AC9,42631,6,9,3,43,45,2195
4523,4523,070CCFB95BD7B5493FC205585FDC7AC9,13341,13,14,1,44,45,2245
4524,4524,070CCFB95BD7B5493FC205585FDC7AC9,42631,16,22,6,43,45,2195
4525,4525,784B731FB48DA266D31BFD4ACBDB8A39,11021,0,13,13,36,49,1849
4526,4526,784B731FB48DA266D31BFD4ACBDB8A39,11074,13,17,4,37,47,1897
4527,4527,784B731FB48DA266D31BFD4ACBDB8A39,11021,18,20,2,36,49,1849
4528,4528,08940764F00FC28E90F01F884EE512E9,11061,1,10,9,29,48,1498
4529,4529,08940764F00FC28E90F01F884EE512E9,11151,12,13,1,30,48,1548
4530,4530,08940764F00FC28E90F01F884EE512E9,11061,17,22,5,29,48,1498
4538,4538,E969EC1FA6E19F3F5A602F2FE47F2E7D,13911,0,12,12,39,46,1996
4539,4539,E969EC1FA6E19F3F5A602F2FE47F2E7D,11261,15,16,1,36,46,1846
4540,4540,E969EC1FA6E19F3F5A602F2FE47F2E7D,13231,17,23,6,39,46,1996
4549,4549,A50C650BD813B6D195D37ED8F6B1810B,42521,0,3,3,31,47,1597
4550,4550,A50C650BD813B6D195D37ED8F6B1810B,43761,4,11,7,32,47,1647
4551,4551,A50C650BD813B6D195D37ED8F6B1810B,42521,14,19,5,31,47,1597
4555,4555,D8063B7C8CAA23F18B002D2A443A5135,43951,4,9,5,49,41,2491
4556,4556,D8063B7C8CAA23F18B002D2A443A5135,43101,11,12,1,46,40,2340
4557,4557,D8063B7C8CAA23F18B002D2A443A5135,43951,17,18,1,49,41,2491
4558,4558,D8063B7C8CAA23F18B002D2A443A5135,43101,20,23,3,46,40,2340
4562,4562,474A8DACA51CB40E50178AB2BE706270,11806,2,11,9,41,48,2098
4563,4563,474A8DACA51CB40E50178AB2BE706270,42271,14,15,1,40,47,2047
4564,4564,474A8DACA51CB40E50178AB2BE706270,11806,18,20,2,41,48,2098
4565,4565,F3EF2B020AD3C2B9A1E318E53D6A0F95,10221,1,14,13,34,49,1749
4566,4566,F3EF2B020AD3C2B9A1E318E53D6A0F95,40271,14,19,5,35,49,1799
4567,4567,F3EF2B020AD3C2B9A1E318E53D6A0F95,11591,21,23,2,36,49,1849
4580,4580,1CDF6C6970CBC7D24D606B7FD41E9D6C,12921,1,3,2,9,41,491
4581,4581,1CDF6C6970CBC7D24D606B7FD41E9D6C,12641,4,6,2,10,43,543
4582,4582,1CDF6C6970CBC7D24D606B7FD41E9D6C,12921,10,18,8,9,41,491
4583,4583,1CDF6C6970CBC7D24D606B7FD41E9D6C,12641,18,19,1,10,43,543
4592,4592,82C90751F319CEFB9BDA972422C0590C,11771,0,7,7,39,49,1999
4593,4593,82C90751F319CEFB9BDA972422C0590C,11791,7,8,1,38,49,1949
4594,4594,82C90751F319CEFB9BDA972422C0590C,11771,10,20,10,39,49,1999
4595,4595,82C90751F319CEFB9BDA972422C0590C,11231,21,23,2,37,49,1899
4621,4621,261E578A9ADD5DB5F1BF8D1F93100799,11261,4,5,1,36,46,1846
4622,4622,261E578A9ADD5DB5F1BF8D1F93100799,42864,6,7,1,38,44,1944
4623,4623,261E578A9ADD5DB5F1BF8D1F93100799,11261,9,21,12,36,46,1846
4631,4631,E4DC5BA4E90CD8A7BCCBC3E7AC2ABE5B,10691,0,7,7,33,48,1698
4632,4632,E4DC5BA4E90CD8A7BCCBC3E7AC2ABE5B,11861,11,14,3,32,47,1647
4633,4633,E4DC5BA4E90CD8A7BCCBC3E7AC2ABE5B,10691,18,23,5,33,48,1698
4639,4639,7C595694D88865CF5198ABC218C5C2B0,43481,1,3,2,39,48,1998
4640,4640,7C595694D88865CF5198ABC218C5C2B0,11921,6,15,9,38,48,1948
4641,4641,7C595694D88865CF5198ABC218C5C2B0,42051,19,20,1,42,48,2148
4642,4642,7C595694D88865CF5198ABC218C5C2B0,11921,21,23,2,38,48,1948
4643,4643,E68BA5F61F8B211BFB4BF381E08CC8FA,40636,0,2,2,35,48,1798
4644,4644,E68BA5F61F8B211BFB4BF381E08CC8FA,10841,3,15,12,37,47,1897
4645,4645,E68BA5F61F8B211BFB4BF381E08CC8FA,40636,18,22,4,35,48,1798
4646,4646,D83A3E3103AE521669D7D5F8A4C5417F,10331,0,13,13,39,46,1996
4647,4647,D83A3E3103AE521669D7D5F8A4C5417F,42221,14,16,2,38,48,1948
4648,4648,D83A3E3103AE521669D7D5F8A4C5417F,10331,19,23,4,39,46,1996
4654,4654,58C32AD55A2D53A9841F4840BEBC3755,42461,0,2,2,45,47,2297
4655,4655,58C32AD55A2D53A9841F4840BEBC3755,43061,2,8,6,43,46,2196
4656,4656,58C32AD55A2D53A9841F4840BEBC3755,42461,10,23,13,45,47,2297
4665,4665,4515D69DA9DF7C67BD58AB71BAA57E58,10471,0,10,10,37,48,1898
4666,4666,4515D69DA9DF7C67BD58AB71BAA57E58,40171,12,13,1,38,48,1948
4667,4667,4515D69DA9DF7C67BD58AB71BAA57E58,11231,14,21,7,37,49,1899
4668,4668,4515D69DA9DF7C67BD58AB71BAA57E58,40171,22,23,1,38,48,1948
4672,4672,1574AF3F5E38E5DEE82E49773E7EC20E,13331,0,9,9,38,47,1947
4673,4673,1574AF3F5E38E5DEE82E49773E7EC20E,11491,12,13,1,36,47,1847
4674,4674,1574AF3F5E38E5DEE82E49773E7EC20E,10111,13,17,4,37,47,1897
4675,4675,1574AF3F5E38E5DEE82E49773E7EC20E,42401,19,22,3,36,47,1847
4680,4680,ED159E34A7C87175DF3FAD9FE93B7C1A,42351,0,13,13,38,45,1945
4681,4681,ED159E34A7C87175DF3FAD9FE93B7C1A,11261,14,16,2,36,46,1846
4682,4682,ED159E34A7C87175DF3FAD9FE93B7C1A,42351,18,23,5,38,45,1945
4683,4683,E7233A336FF6DC7015F36A96AF40FCB1,43161,1,2,1,35,47,1797
4684,4684,E7233A336FF6DC7015F36A96AF40FCB1,11941,3,4,1,37,46,1896
4685,4685,E7233A336FF6DC7015F36A96AF40FCB1,42161,4,6,2,36,47,1847
4686,4686,E7233A336FF6DC7015F36A96AF40FCB1,11941,9,23,14,37,46,1896
4687,4687,82D1CEDE24E0792F5B9EEC9BCF1BF69B,43951,6,12,6,49,41,2491
4688,4688,82D1CEDE24E0792F5B9EEC9BCF1BF69B,43101,12,13,1,46,40,2340
4689,4689,82D1CEDE24E0792F5B9EEC9BCF1BF69B,43951,18,20,2,49,41,2491
4690,4690,B82AA28871B2A0DA168B91F2FCD11B71,40171,0,7,7,38,48,1948
4691,4691,B82AA28871B2A0DA168B91F2FCD11B71,11914,8,17,9,37,48,1898
4692,4692,B82AA28871B2A0DA168B91F2FCD11B71,40171,19,22,3,38,48,1948
4693,4693,DB95B8DA262AE824B688696C193FB2EC,10121,6,7,1,36,49,1849
4694,4694,DB95B8DA262AE824B688696C193FB2EC,11531,11,13,2,34,49,1749
4695,4695,DB95B8DA262AE824B688696C193FB2EC,10121,14,22,8,36,49,1849
4696,4696,446AC7E279C6659F3E40FC9C0B9B7F45,13341,4,6,2,44,45,2245
4697,4697,446AC7E279C6659F3E40FC9C0B9B7F45,42631,10,11,1,43,45,2195
4698,4698,446AC7E279C6659F3E40FC9C0B9B7F45,13341,11,18,7,44,45,2245
4699,4699,CD6FBF4118663ECE62CCA91FFBED80FB,11231,0,1,1,37,49,1899
4700,4700,CD6FBF4118663ECE62CCA91FFBED80FB,10121,1,15,14,36,49,1849
4701,4701,CD6FBF4118663ECE62CCA91FFBED80FB,13561,15,17,2,37,49,1899
4702,4702,CD6FBF4118663ECE62CCA91FFBED80FB,11021,18,21,3,36,49,1849
4706,4706,245BF0AC713EC7539F599FEB41303CFA,42461,0,6,6,45,47,2297
4707,4707,245BF0AC713EC7539F599FEB41303CFA,41392,8,10,2,43,48,2198
4708,4708,245BF0AC713EC7539F599FEB41303CFA,13341,12,18,6,44,45,2245
4709,4709,245BF0AC713EC7539F599FEB41303CFA,42111,20,23,3,44,46,2246
4710,4710,2A7561E6C4B0C216B0976EA2A5A37F5B,11771,7,12,5,39,49,1999
4711,4711,2A7561E6C4B0C216B0976EA2A5A37F5B,13121,14,15,1,38,46,1946
4712,4712,2A7561E6C4B0C216B0976EA2A5A37F5B,11771,17,18,1,39,49,1999
4713,4713,FCC81FB1D89F2E284C3312E5101F2149,42151,0,16,16,35,45,1795
4714,4714,FCC81FB1D89F2E284C3312E5101F2149,42861,17,18,1,37,44,1894
4715,4715,FCC81FB1D89F2E284C3312E5101F2149,42151,20,23,3,35,45,1795
4716,4716,EFBA89D1B9F8A3238B6B7005DFF11556,10801,0,1,1,42,47,2147
4717,4717,EFBA89D1B9F8A3238B6B7005DFF11556,13371,5,8,3,41,47,2097
4718,4718,EFBA89D1B9F8A3238B6B7005DFF11556,10801,11,12,1,42,47,2147
4719,4719,EFBA89D1B9F8A3238B6B7005DFF11556,13341,14,19,5,44,45,2245
4720,4720,B77744ABD6410AE2C7B9EEDE70706BAA,10111,0,9,9,37,47,1897
4721,4721,B77744ABD6410AE2C7B9EEDE70706BAA,42401,10,12,2,36,47,1847
4722,4722,B77744ABD6410AE2C7B9EEDE70706BAA,10111,14,20,6,37,47,1897
4723,4723,B77744ABD6410AE2C7B9EEDE70706BAA,42301,21,23,2,36,47,1847
4733,4733,0BF573716067AB088A10F8F6065B2D8A,42921,0,11,11,33,47,1697
4734,4734,0BF573716067AB088A10F8F6065B2D8A,13601,12,20,8,34,47,1747
4735,4735,0BF573716067AB088A10F8F6065B2D8A,42921,21,23,2,33,47,1697
4736,4736,19E507F0B1ECB32C1E8AEB16532120A1,42511,3,14,11,37,47,1897
4737,4737,19E507F0B1ECB32C1E8AEB16532120A1,42301,14,16,2,36,47,1847
4738,4738,19E507F0B1ECB32C1E8AEB16532120A1,42511,18,19,1,37,47,1897
4739,4739,66A1757BF5A4116BA4BCC483D90F56EF,42231,1,7,6,37,46,1896
4740,4740,66A1757BF5A4116BA4BCC483D90F56EF,42351,8,9,1,38,45,1945
4741,4741,66A1757BF5A4116BA4BCC483D90F56EF,42231,14,19,5,37,46,1896
4742,4742,387C2BFABED9CD0C7C45EBAD5F5242F9,10251,0,16,16,35,47,1797
4743,4743,387C2BFABED9CD0C7C45EBAD5F5242F9,41591,18,19,1,34,49,1749
4744,4744,387C2BFABED9CD0C7C45EBAD5F5242F9,13511,20,21,1,34,48,1748
4745,4745,00ED2280FB2BEC22D8FB36F8A7AFB1A5,42151,0,7,7,35,45,1795
4746,4746,00ED2280FB2BEC22D8FB36F8A7AFB1A5,13121,8,17,9,38,46,1946
4747,4747,00ED2280FB2BEC22D8FB36F8A7AFB1A5,42791,19,23,4,35,45,1795
4752,4752,CE730AB7CAA6F1EDCF3B001D68BA2D58,42161,0,2,2,36,47,1847
4753,4753,CE730AB7CAA6F1EDCF3B001D68BA2D58,10111,2,8,6,37,47,1897
4754,4754,CE730AB7CAA6F1EDCF3B001D68BA2D58,42161,12,23,11,36,47,1847
4755,4755,76B5A35D98B8893850740B68B6528B2B,42321,0,16,16,43,47,2197
4756,4756,76B5A35D98B8893850740B68B6528B2B,13941,17,18,1,41,47,2097
4757,4757,76B5A35D98B8893850740B68B6528B2B,42321,19,21,2,43,47,2197
4758,4758,2075B4FB25DAADC66CD593580F270747,11801,0,13,13,42,48,2148
4759,4759,2075B4FB25DAADC66CD593580F270747,11291,17,19,2,40,49,2049
4760,4760,2075B4FB25DAADC66CD593580F270747,11801,20,23,3,42,48,2148
4761,4761,7EB6B5518636168A453DDD4DAA08FEF9,11261,0,5,5,36,46,1846
4762,4762,7EB6B5518636168A453DDD4DAA08FEF9,42861,5,7,2,37,44,1894
4763,4763,7EB6B5518636168A453DDD4DAA08FEF9,11261,9,17,8,36,46,1846
4764,4764,7EB6B5518636168A453DDD4DAA08FEF9,42861,19,20,1,37,44,1894
4772,4772,70001957DCF2B9125DCB996733DDF49B,11381,0,11,11,30,47,1547
4773,4773,70001957DCF2B9125DCB996733DDF49B,42291,11,13,2,29,48,1498
4774,4774,70001957DCF2B9125DCB996733DDF49B,11381,13,23,10,30,47,1547
4775,4775,0750773F2B2DAD2C2EBE988336E3DA7D,11914,0,1,1,37,48,1898
4776,4776,0750773F2B2DAD2C2EBE988336E3DA7D,43181,1,11,10,39,48,1998
4777,4777,0750773F2B2DAD2C2EBE988336E3DA7D,10471,11,21,10,37,48,1898
4794,4794,232A65D7E72D31ED563D0041FCDF23A8,12491,0,13,13,36,43,1843
4795,4795,232A65D7E72D31ED563D0041FCDF23A8,42151,15,16,1,35,45,1795
4796,4796,232A65D7E72D31ED563D0041FCDF23A8,12491,16,19,3,36,43,1843
4797,4797,232A65D7E72D31ED563D0041FCDF23A8,42151,20,21,1,35,45,1795
4811,4811,37609981B6E37614B19EA7F916C7F3C8,43761,1,11,10,32,47,1647
4812,4812,37609981B6E37614B19EA7F916C7F3C8,42521,16,17,1,31,47,1597
4813,4813,37609981B6E37614B19EA7F916C7F3C8,43761,18,19,1,32,47,1647
4814,4814,37609981B6E37614B19EA7F916C7F3C8,42521,19,21,2,31,47,1597
4815,4815,445F8B1020EEDC6D6315C19BB0B3B1F7,11804,0,8,8,41,48,2098
4816,4816,445F8B1020EEDC6D6315C19BB0B3B1F7,10801,11,19,8,42,47,2147
4817,4817,445F8B1020EEDC6D6315C19BB0B3B1F7,11804,21,23,2,41,48,2098
4818,4818,B24DFEF6BEA91CB0AE942579D8124FCB,43161,0,12,12,35,47,1797
4819,4819,B24DFEF6BEA91CB0AE942579D8124FCB,42161,15,16,1,36,47,1847
4820,4820,B24DFEF6BEA91CB0AE942579D8124FCB,43161,20,23,3,35,47,1797
4821,4821,89680CECB0A0CAAB751B383429847A2B,13141,8,11,3,23,30,1180
4822,4822,89680CECB0A0CAAB751B383429847A2B,49181,12,13,1,21,31,1081
4823,4823,89680CECB0A0CAAB751B383429847A2B,13141,14,17,3,23,30,1180
4824,4824,89680CECB0A0CAAB751B383429847A2B,49181,19,21,2,21,31,1081
4844,4844,F3632CEFCEB99C36253996BED876A313,43501,0,8,8,27,48,1398
4845,4845,F3632CEFCEB99C36253996BED876A313,12601,9,12,3,25,47,1297
4846,4846,F3632CEFCEB99C36253996BED876A313,10351,13,18,5,28,45,1445
4847,4847,F3632CEFCEB99C36253996BED876A313,43501,21,23,2,27,48,1398
4848,4848,03807BDFECD796862E0B81DEAB9E0723,11131,0,11,11,33,48,1698
4849,4849,03807BDFECD796862E0B81DEAB9E0723,10251,12,22,10,35,47,1797
4850,4850,03807BDFECD796862E0B81DEAB9E0723,40637,22,23,1,36,47,1847
4854,4854,AECB3A586AEF5BFAEB4AB432CE762477,42271,4,5,1,40,47,2047
4855,4855,AECB3A586AEF5BFAEB4AB432CE762477,11806,8,11,3,41,48,2098
4856,4856,AECB3A586AEF5BFAEB4AB432CE762477,42271,12,14,2,40,47,2047
4857,4857,AECB3A586AEF5BFAEB4AB432CE762477,11806,15,23,8,41,48,2098
4861,4861,90CAE68E57E6D6254F2E8F80F351FD91,43471,0,9,9,31,49,1599
4862,4862,90CAE68E57E6D6254F2E8F80F351FD91,42471,20,21,1,35,49,1799
4863,4863,90CAE68E57E6D6254F2E8F80F351FD91,43471,21,22,1,31,49,1599
4864,4864,5A45F00505D10CE6F80144DAC647FEEE,19024,0,6,6,9,45,495
4865,4865,5A45F00505D10CE6F80144DAC647FEEE,12921,9,15,6,9,41,491
4866,4866,5A45F00505D10CE6F80144DAC647FEEE,19441,20,23,3,8,46,446
4867,4867,DFD67893B33D33FDAA92DC71D5732DAF,42161,0,11,11,36,47,1847
4868,4868,DFD67893B33D33FDAA92DC71D5732DAF,42941,12,13,1,37,47,1897
4869,4869,DFD67893B33D33FDAA92DC71D5732DAF,42161,17,18,1,36,47,1847
4875,4875,5DCDEE86AFA2D68FD07F31A3CA76F70F,11291,0,9,9,40,49,2049
4876,4876,5DCDEE86AFA2D68FD07F31A3CA76F70F,43181,9,11,2,39,48,1998
4877,4877,5DCDEE86AFA2D68FD07F31A3CA76F70F,11661,11,19,8,40,49,2049
4887,4887,8964BE3BDB8A882E0820AE09A961E1E9,13101,6,8,2,40,47,2047
4888,4888,8964BE3BDB8A882E0820AE09A961E1E9,13941,8,10,2,41,47,2097
4889,4889,8964BE3BDB8A882E0820AE09A961E1E9,13101,13,23,10,40,47,2047
4893,4893,A1AB93C3EFB33F8294A23FED3C85A042,11261,1,7,6,36,46,1846
4894,4894,A1AB93C3EFB33F8294A23FED3C85A042,10271,8,16,8,37,46,1896
4895,4895,A1AB93C3EFB33F8294A23FED3C85A042,42011,18,19,1,36,46,1846
4899,4899,10174C5AAAC6DE7A0575D462AC2C511D,10151,0,8,8,34,47,1747
4900,4900,10174C5AAAC6DE7A0575D462AC2C511D,11541,9,10,1,35,49,1799
4901,4901,10174C5AAAC6DE7A0575D462AC2C511D,10151,14,16,2,34,47,1747
4902,4902,10174C5AAAC6DE7A0575D462AC2C511D,11841,21,23,2,33,46,1696
4907,4907,29B536EE93C2E266619D50C15F53EE29,42531,0,6,6,31,45,1595
4908,4908,29B536EE93C2E266619D50C15F53EE29,12311,6,7,1,30,44,1544
4909,4909,29B536EE93C2E266619D50C15F53EE29,42531,9,22,13,31,45,1595
4922,4922,F177C252F712783B4F52D4F3F64FBA5B,42151,1,2,1,35,45,1795
4923,4923,F177C252F712783B4F52D4F3F64FBA5B,11261,4,7,3,36,46,1846
4924,4924,F177C252F712783B4F52D4F3F64FBA5B,42151,8,18,10,35,45,1795
4930,4930,7D5000772E957DD3A483CE8963A15A13,11381,0,4,4,30,47,1547
4931,4931,7D5000772E957DD3A483CE8963A15A13,42501,5,7,2,28,47,1447
4932,4932,7D5000772E957DD3A483CE8963A15A13,11381,8,10,2,30,47,1547
4933,4933,7D5000772E957DD3A483CE8963A15A13,12121,15,23,8,29,47,1497
4934,4934,2076FDA641FB832C37A3CEDC0E6FC7AC,10351,0,6,6,28,45,1445
4935,4935,2076FDA641FB832C37A3CEDC0E6FC7AC,13671,8,9,1,27,43,1393
4936,4936,2076FDA641FB832C37A3CEDC0E6FC7AC,12311,9,16,7,30,44,1544
4937,4937,2076FDA641FB832C37A3CEDC0E6FC7AC,10351,19,21,2,28,45,1445
4948,4948,9CF16D35CBBB6D43AD3AFEFE9A0A13CD,11151,2,14,12,30,48,1548
4949,4949,9CF16D35CBBB6D43AD3AFEFE9A0A13CD,11061,15,16,1,29,48,1498
4950,4950,9CF16D35CBBB6D43AD3AFEFE9A0A13CD,11151,17,18,1,30,48,1548
4951,4951,9CF16D35CBBB6D43AD3AFEFE9A0A13CD,11061,19,20,1,29,48,1498
4952,4952,780CF605B987CE4335E0B64DFA86ACBF,11921,0,1,1,38,48,1948
4953,4953,780CF605B987CE4335E0B64DFA86ACBF,12514,4,6,2,38,47,1947
4954,4954,780CF605B987CE4335E0B64DFA86ACBF,42511,8,17,9,37,47,1897
4955,4955,780CF605B987CE4335E0B64DFA86ACBF,11921,19,21,2,38,48,1948
4956,4956,21214DF25ABBFE57C13DD19922691751,42231,0,5,5,37,46,1896
4957,4957,21214DF25ABBFE57C13DD19922691751,42351,6,12,6,38,45,1945
4958,4958,21214DF25ABBFE57C13DD19922691751,11261,12,21,9,36,46,1846
4959,4959,21214DF25ABBFE57C13DD19922691751,13231,21,22,1,39,46,1996
4969,4969,F1502941AA4C982D115379B62AA4CCF5,11811,0,8,8,38,49,1949
4970,4970,F1502941AA4C982D115379B62AA4CCF5,11021,8,15,7,36,49,1849
4971,4971,F1502941AA4C982D115379B62AA4CCF5,10107,16,23,7,38,49,1949
4977,4977,AFEAFD83FD901253C07A2E98F10BB00B,42091,0,10,10,43,46,2196
4978,4978,AFEAFD83FD901253C07A2E98F10BB00B,42461,10,12,2,45,47,2297
4979,4979,AFEAFD83FD901253C07A2E98F10BB00B,42091,14,18,4,43,46,2196
4983,4983,306ED72E5C64C4C2F23E7A437192D997,10271,0,10,10,37,46,1896
4984,4984,306ED72E5C64C4C2F23E7A437192D997,11261,14,15,1,36,46,1846
4985,4985,306ED72E5C64C4C2F23E7A437192D997,43161,18,19,1,35,47,1797
4986,4986,306ED72E5C64C4C2F23E7A437192D997,43241,19,23,4,36,46,1846
5001,5001,FCA3C665B5BF337F331669EDB597A6AC,42791,0,7,7,35,45,1795
5002,5002,FCA3C665B5BF337F331669EDB597A6AC,10271,8,13,5,37,46,1896
5003,5003,FCA3C665B5BF337F331669EDB597A6AC,13121,15,18,3,38,46,1946
5004,5004,FCA3C665B5BF337F331669EDB597A6AC,42791,19,23,4,35,45,1795
5005,5005,DA244998CEA8BED2E06BE3F9FCFF9ED5,11381,0,17,17,30,47,1547
5006,5006,DA244998CEA8BED2E06BE3F9FCFF9ED5,10381,17,19,2,31,49,1599
5007,5007,DA244998CEA8BED2E06BE3F9FCFF9ED5,40094,19,22,3,29,48,1498
5014,5014,A680ECAC76DBA89C20A0DF678741D67C,10491,0,10,10,33,48,1698
5015,5015,A680ECAC76DBA89C20A0DF678741D67C,10901,12,13,1,35,48,1798
5016,5016,A680ECAC76DBA89C20A0DF678741D67C,10491,16,23,7,33,48,1698
5017,5017,A82EF90EFC2E4C8E36D65CBF0ADF5C03,13341,0,3,3,44,45,2245
5018,5018,A82EF90EFC2E4C8E36D65CBF0ADF5C03,43061,5,13,8,43,46,2196
5019,5019,A82EF90EFC2E4C8E36D65CBF0ADF5C03,13341,14,23,9,44,45,2245
5020,5020,BBEB20E4CE09F78FD771E8818046FF01,42583,0,6,6,40,48,2048
5021,5021,BBEB20E4CE09F78FD771E8818046FF01,42271,6,17,11,40,47,2047
5022,5022,BBEB20E4CE09F78FD771E8818046FF01,42583,18,23,5,40,48,2048
5028,5028,CBA3EEB115425BF46575E225F464D168,13941,0,8,8,41,47,2097
5029,5029,CBA3EEB115425BF46575E225F464D168,42321,9,10,1,43,47,2197
5030,5030,CBA3EEB115425BF46575E225F464D168,13941,13,23,10,41,47,2097
5031,5031,2770DAF26F856B8C604C0FF1601A7902,12921,9,10,1,9,41,491
5032,5032,2770DAF26F856B8C604C0FF1601A7902,12641,12,16,4,10,43,543
5033,5033,2770DAF26F856B8C604C0FF1601A7902,19181,18,19,1,8,40,440
5034,5034,2770DAF26F856B8C604C0FF1601A7902,12641,19,23,4,10,43,543
5035,5035,2DC51910B61D35F2AFC5DC08303A620B,13101,0,10,10,40,47,2047
5036,5036,2DC51910B61D35F2AFC5DC08303A620B,13271,12,14,2,41,47,2097
5037,5037,2DC51910B61D35F2AFC5DC08303A620B,13101,15,19,4,40,47,2047
5038,5038,2DC51910B61D35F2AFC5DC08303A620B,13271,21,23,2,41,47,2097
5042,5042,0BF2F7B48C432767D531FCBEB9CB4038,11941,0,6,6,37,46,1896
5043,5043,0BF2F7B48C432767D531FCBEB9CB4038,13711,10,11,1,38,46,1946
5044,5044,0BF2F7B48C432767D531FCBEB9CB4038,11941,13,23,10,37,46,1896
5045,5045,E03A93A395EA61129C69C9384454D20B,10781,0,16,16,35,47,1797
5046,5046,E03A93A395EA61129C69C9384454D20B,10111,17,21,4,37,47,1897
5047,5047,E03A93A395EA61129C69C9384454D20B,40431,22,23,1,36,47,1847
5061,5061,A0E96E8A9AD818FBF087A431E03695B8,10471,1,8,7,37,48,1898
5062,5062,A0E96E8A9AD818FBF087A431E03695B8,40171,10,11,1,38,48,1948
5063,5063,A0E96E8A9AD818FBF087A431E03695B8,10471,13,14,1,37,48,1898
5064,5064,A0E96E8A9AD818FBF087A431E03695B8,10251,19,21,2,35,47,1797
5070,5070,B3AFAE94DD2566E696C64910B44D8F60,10411,0,13,13,36,48,1848
5071,5071,B3AFAE94DD2566E696C64910B44D8F60,40951,17,18,1,36,49,1849
5072,5072,B3AFAE94DD2566E696C64910B44D8F60,40673,22,23,1,36,48,1848
5081,5081,612F18F83615AD18C521C0260D4FB623,11914,0,6,6,37,48,1898
5082,5082,612F18F83615AD18C521C0260D4FB623,40171,7,8,1,38,48,1948
5083,5083,612F18F83615AD18C521C0260D4FB623,11914,9,23,14,37,48,1898
5090,5090,D44EDEFE20C6E53FAD2290D9CECCD593,19441,0,1,1,8,46,446
5091,5091,D44EDEFE20C6E53FAD2290D9CECCD593,42041,2,9,7,10,47,547
5092,5092,D44EDEFE20C6E53FAD2290D9CECCD593,19021,13,14,1,10,45,545
5093,5093,D44EDEFE20C6E53FAD2290D9CECCD593,19441,15,22,7,8,46,446
5094,5094,583602182C31C8E2D985404EA5592339,12921,7,8,1,9,41,491
5095,5095,583602182C31C8E2D985404EA5592339,12641,12,13,1,10,43,543
5096,5096,583602182C31C8E2D985404EA5592339,12921,13,17,4,9,41,491
5097,5097,583602182C31C8E2D985404EA5592339,12641,18,19,1,10,43,543
5098,5098,D29AED97AE2D8761B58AD6ADEDA31157,12311,1,4,3,30,44,1544
5099,5099,D29AED97AE2D8761B58AD6ADEDA31157,10711,5,15,10,29,46,1496
5100,5100,D29AED97AE2D8761B58AD6ADEDA31157,12311,16,18,2,30,44,1544
5120,5120,C57E69593CB95494477C252AABEFF884,12514,0,1,1,38,47,1947
5121,5121,C57E69593CB95494477C252AABEFF884,10841,1,9,8,37,47,1897
5122,5122,C57E69593CB95494477C252AABEFF884,10811,10,11,1,38,46,1946
5123,5123,C57E69593CB95494477C252AABEFF884,10471,13,23,10,37,48,1898
5124,5124,4C8E92DBB85921608C1C92929A7A8C92,42521,0,5,5,31,47,1597
5125,5125,4C8E92DBB85921608C1C92929A7A8C92,11381,7,11,4,30,47,1547
5126,5126,4C8E92DBB85921608C1C92929A7A8C92,42521,12,23,11,31,47,1597
5127,5127,A1A5867AEAAAEF8BC662DDDD8683129F,49201,1,13,12,7,41,391
5128,5128,A1A5867AEAAAEF8BC662DDDD8683129F,12921,16,18,2,9,41,491
5129,5129,A1A5867AEAAAEF8BC662DDDD8683129F,49201,19,20,1,7,41,391
5136,5136,25C497B4D4DF884DBD8CBD5B228DA42D,11261,1,4,3,36,46,1846
5137,5137,25C497B4D4DF884DBD8CBD5B228DA42D,42861,9,10,1,37,44,1894
5138,5138,25C497B4D4DF884DBD8CBD5B228DA42D,10811,12,17,5,38,46,1946
5139,5139,25C497B4D4DF884DBD8CBD5B228DA42D,11261,22,23,1,36,46,1846
5140,5140,6A0394A16431C3763362EDB77E0D6861,42071,0,1,1,31,49,1599
5141,5141,6A0394A16431C3763362EDB77E0D6861,10544,1,6,5,28,48,1448
5142,5142,6A0394A16431C3763362EDB77E0D6861,10381,6,23,17,31,49,1599
5147,5147,AAF4696620C6353C66227214077A10B8,10251,0,7,7,35,47,1797
5148,5148,AAF4696620C6353C66227214077A10B8,10151,9,11,2,34,47,1747
5149,5149,AAF4696620C6353C66227214077A10B8,10971,13,19,6,35,47,1797
5150,5150,AAF4696620C6353C66227214077A10B8,11461,21,22,1,37,49,1899
5158,5158,2FCEA8AFEE1EB24BBCF386268B1232AC,11061,3,4,1,29,48,1498
5159,5159,2FCEA8AFEE1EB24BBCF386268B1232AC,11161,6,14,8,32,48,1648
5160,5160,2FCEA8AFEE1EB24BBCF386268B1232AC,43311,17,19,2,31,48,1598
5161,5161,2FCEA8AFEE1EB24BBCF386268B1232AC,11161,22,23,1,32,48,1648
5174,5174,79F70A1AE08CEE215DA71360DE1B25EA,42191,0,6,6,38,49,1949
5175,5175,79F70A1AE08CEE215DA71360DE1B25EA,42231,6,18,12,37,46,1896
5176,5176,79F70A1AE08CEE215DA71360DE1B25EA,42191,19,23,4,38,49,1949
5177,5177,33A12E47D788FDF55ACC2D02B9D51172,43481,0,17,17,39,48,1998
5178,5178,33A12E47D788FDF55ACC2D02B9D51172,11074,18,19,1,37,47,1897
5179,5179,33A12E47D788FDF55ACC2D02B9D51172,43481,19,22,3,39,48,1998
5186,5186,CC04DF57CD476D56A9C2711AACC54374,42861,1,4,3,37,44,1894
5187,5187,CC04DF57CD476D56A9C2711AACC54374,11261,6,11,5,36,46,1846
5188,5188,CC04DF57CD476D56A9C2711AACC54374,42861,14,20,6,37,44,1894
5193,5193,3624837A8CEE8FA380EBBA166C2E7021,42091,0,6,6,43,46,2196
5194,5194,3624837A8CEE8FA380EBBA166C2E7021,13341,6,16,10,44,45,2245
5195,5195,3624837A8CEE8FA380EBBA166C2E7021,42091,18,23,5,43,46,2196
5196,5196,F728E42B3FC103F48439702CC4DFDAA2,41392,0,10,10,43,48,2198
5197,5197,F728E42B3FC103F48439702CC4DFDAA2,13101,11,13,2,40,47,2047
5198,5198,F728E42B3FC103F48439702CC4DFDAA2,41392,14,19,5,43,48,2198
5199,5199,E3950B228FF57BC4F70CD2EC3D90B5FF,11941,0,2,2,37,46,1896
5200,5200,E3950B228FF57BC4F70CD2EC3D90B5FF,13911,4,7,3,39,46,1996
5201,5201,E3950B228FF57BC4F70CD2EC3D90B5FF,42151,11,15,4,35,45,1795
5202,5202,E3950B228FF57BC4F70CD2EC3D90B5FF,13711,19,23,4,38,46,1946
5216,5216,C2D5214FEC75C0AAC959B35BB6F64C25,40833,0,6,6,41,47,2097
5217,5217,C2D5214FEC75C0AAC959B35BB6F64C25,11481,8,11,3,41,48,2098
5218,5218,C2D5214FEC75C0AAC959B35BB6F64C25,13941,12,23,11,41,47,2097
5229,5229,A1AB9ABD6ED99AD6CBDD6E355E1BCC54,12651,0,16,16,43,47,2197
5230,5230,A1AB9ABD6ED99AD6CBDD6E355E1BCC54,41392,18,19,1,43,48,2198
5231,5231,A1AB9ABD6ED99AD6CBDD6E355E1BCC54,42321,20,22,2,43,47,2197
5232,5232,58FF60972C1637520443DC5766A2AB67,13411,2,4,2,49,42,2492
5233,5233,58FF60972C1637520443DC5766A2AB67,43951,6,18,12,49,41,2491
5234,5234,58FF60972C1637520443DC5766A2AB67,13411,20,23,3,49,42,2492
5244,5244,076B99487839159702A8E5132EA8D091,10801,0,11,11,42,47,2147
5245,5245,076B99487839159702A8E5132EA8D091,10191,14,17,3,40,48,2048
5246,5246,076B99487839159702A8E5132EA8D091,13791,18,19,1,42,47,2147
5247,5247,076B99487839159702A8E5132EA8D091,12511,21,22,1,39,47,1997
5248,5248,8EB0EA8A0FB0C9F044024C5DB3D8B52C,19021,0,13,13,10,45,545
5249,5249,8EB0EA8A0FB0C9F044024C5DB3D8B52C,19024,15,18,3,9,45,495
5250,5250,8EB0EA8A0FB0C9F044024C5DB3D8B52C,19021,22,23,1,10,45,545
5251,5251,9C35C609BEEB7023F559DA7824DEFA84,11061,0,15,15,29,48,1498
5252,5252,9C35C609BEEB7023F559DA7824DEFA84,10681,16,18,2,30,48,1548
5253,5253,9C35C609BEEB7023F559DA7824DEFA84,11061,18,19,1,29,48,1498
5254,5254,9C35C609BEEB7023F559DA7824DEFA84,43971,19,21,2,30,48,1548
5263,5263,E88F39A65DCBFC647F6F44FF9039942F,12601,4,6,2,25,47,1297
5264,5264,E88F39A65DCBFC647F6F44FF9039942F,10634,6,12,6,27,45,1395
5265,5265,E88F39A65DCBFC647F6F44FF9039942F,12601,12,14,2,25,47,1297
5266,5266,E88F39A65DCBFC647F6F44FF9039942F,10634,14,18,4,27,45,1395
5267,5267,E19F4EE89FEB316F2AF77CC76B6C0A25,43581,0,9,9,33,48,1698
5268,5268,E19F4EE89FEB316F2AF77CC76B6C0A25,11861,9,17,8,32,47,1647
5269,5269,E19F4EE89FEB316F2AF77CC76B6C0A25,10491,18,23,5,33,48,1698
5270,5270,5B7D20533455968081F1917AE3C512DE,13121,0,8,8,38,46,1946
5271,5271,5B7D20533455968081F1917AE3C512DE,10841,8,20,12,37,47,1897
5272,5272,5B7D20533455968081F1917AE3C512DE,13121,21,22,1,38,46,1946
5273,5273,7D60E69A1B941183EE4333D8968485D3,42071,0,1,1,31,49,1599
5274,5274,7D60E69A1B941183EE4333D8968485D3,11061,3,20,17,29,48,1498
5275,5275,7D60E69A1B941183EE4333D8968485D3,41591,22,23,1,34,49,1749
5285,5285,CC942D0DF2AC341810018AA4F0BAC79C,42623,0,7,7,22,49,1149
5286,5286,CC942D0DF2AC341810018AA4F0BAC79C,42081,10,12,2,24,49,1249
5287,5287,CC942D0DF2AC341810018AA4F0BAC79C,42623,13,22,9,22,49,1149
5291,5291,FE289D23B7E617AD349A76499E85C77F,42921,2,8,6,33,47,1697
5292,5292,FE289D23B7E617AD349A76499E85C77F,10431,11,18,7,33,49,1699
5293,5293,FE289D23B7E617AD349A76499E85C77F,42021,22,23,1,33,47,1697
5297,5297,590DAC63AAEA804ADBFB882BD29A8CA5,13651,0,7,7,30,47,1547
5298,5298,590DAC63AAEA804ADBFB882BD29A8CA5,42141,8,10,2,32,47,1647
5299,5299,590DAC63AAEA804ADBFB882BD29A8CA5,13651,13,19,6,30,47,1547
5316,5316,4A69CEF881C930B26BF97D2854913ACB,43951,0,9,9,49,41,2491
5317,5317,4A69CEF881C930B26BF97D2854913ACB,43101,10,11,1,46,40,2340
5318,5318,4A69CEF881C930B26BF97D2854913ACB,43951,12,23,11,49,41,2491
5319,5319,050B81EE52F1076CAD8D9BCE4E7B786B,12661,0,9,9,32,45,1645
5320,5320,050B81EE52F1076CAD8D9BCE4E7B786B,42021,10,12,2,33,47,1697
5321,5321,050B81EE52F1076CAD8D9BCE4E7B786B,10281,15,17,2,33,48,1698
5322,5322,050B81EE52F1076CAD8D9BCE4E7B786B,12161,20,22,2,32,46,1646
5323,5323,5ED8949BAC5CDF05EDA1019FB7CA4B17,42301,0,14,14,36,47,1847
5324,5324,5ED8949BAC5CDF05EDA1019FB7CA4B17,12131,16,17,1,32,47,1647
5325,5325,5ED8949BAC5CDF05EDA1019FB7CA4B17,10471,19,21,2,37,48,1898
5329,5329,A5DEEBB2A80DA4A946704DB84A952200,43761,0,15,15,32,47,1647
5330,5330,A5DEEBB2A80DA4A946704DB84A952200,42523,15,17,2,31,47,1597
5331,5331,A5DEEBB2A80DA4A946704DB84A952200,43761,21,22,1,32,47,1647
5338,5338,99F5BEE34C277EC7BBBEB92C558829F6,13711,0,12,12,38,46,1946
5339,5339,99F5BEE34C277EC7BBBEB92C558829F6,42231,13,15,2,37,46,1896
5340,5340,99F5BEE34C277EC7BBBEB92C558829F6,10811,15,23,8,38,46,1946
5345,5345,6F6EBF5CE181E2484DF02E32245DC6E0,10634,0,11,11,27,45,1395
5346,5346,6F6EBF5CE181E2484DF02E32245DC6E0,10351,12,15,3,28,45,1445
5347,5347,6F6EBF5CE181E2484DF02E32245DC6E0,10634,16,18,2,27,45,1395
5370,5370,C5FAF90C34968999A63CFDAD0562DDBD,10841,0,7,7,37,47,1897
5371,5371,C5FAF90C34968999A63CFDAD0562DDBD,43731,8,11,3,34,47,1747
5372,5372,C5FAF90C34968999A63CFDAD0562DDBD,10841,13,21,8,37,47,1897
5381,5381,B2FF699F2D213EDD8D43D893134155CA,10951,1,9,8,29,48,1498
5382,5382,B2FF699F2D213EDD8D43D893134155CA,11381,9,13,4,30,47,1547
5383,5383,B2FF699F2D213EDD8D43D893134155CA,10951,13,16,3,29,48,1498
5384,5384,B2FF699F2D213EDD8D43D893134155CA,11381,17,21,4,30,47,1547
5401,5401,AA9767605259B86DB046B02ED47FAF9A,13371,2,8,6,41,47,2097
5402,5402,AA9767605259B86DB046B02ED47FAF9A,42031,10,19,9,40,46,2046
5403,5403,AA9767605259B86DB046B02ED47FAF9A,13101,21,23,2,40,47,2047
5404,5404,0A252836FA6DFCFDFC50B5267919BF05,12641,0,10,10,10,43,543
5405,5405,0A252836FA6DFCFDFC50B5267919BF05,12921,11,12,1,9,41,491
5406,5406,0A252836FA6DFCFDFC50B5267919BF05,12641,15,21,6,10,43,543
5410,5410,700652E9AEC3E35C03C2694A58DB6D5E,10951,2,5,3,29,48,1498
5411,5411,700652E9AEC3E35C03C2694A58DB6D5E,11381,6,12,6,30,47,1547
5412,5412,700652E9AEC3E35C03C2694A58DB6D5E,10951,15,16,1,29,48,1498
5413,5413,700652E9AEC3E35C03C2694A58DB6D5E,11381,16,23,7,30,47,1547
5440,5440,1788FF83230593384DFEF88881720D90,13551,0,6,6,45,38,2288
5441,5441,1788FF83230593384DFEF88881720D90,43101,7,20,13,46,40,2340
5442,5442,1788FF83230593384DFEF88881720D90,13551,21,23,2,45,38,2288
5443,5443,1C986988F199195A6AD262FF1495C84D,19114,0,13,13,7,43,393
5444,5444,1C986988F199195A6AD262FF1495C84D,12921,16,18,2,9,41,491
5445,5445,1C986988F199195A6AD262FF1495C84D,19114,18,21,3,7,43,393
5457,5457,0DFD98C5BF618352145AEF64606DF221,42401,0,5,5,36,47,1847
5458,5458,0DFD98C5BF618352145AEF64606DF221,10251,9,10,1,35,47,1797
5459,5459,0DFD98C5BF618352145AEF64606DF221,42401,10,20,10,36,47,1847
5460,5460,BA6A444D7383AF1ED4944E8853DD84B2,13941,0,13,13,41,47,2097
5461,5461,BA6A444D7383AF1ED4944E8853DD84B2,42341,15,18,3,43,49,2199
5462,5462,BA6A444D7383AF1ED4944E8853DD84B2,10921,18,20,2,43,48,2198
5463,5463,BA6A444D7383AF1ED4944E8853DD84B2,40833,22,23,1,41,47,2097
5464,5464,EA2FF49AFA8BAE81E231360D1149B249,42351,2,12,10,38,45,1945
5465,5465,EA2FF49AFA8BAE81E231360D1149B249,42864,15,18,3,38,44,1944
5466,5466,EA2FF49AFA8BAE81E231360D1149B249,13231,21,23,2,39,46,1996
5484,5484,2D9490E1E73264DD4DD5DDE95A580FC1,13371,0,11,11,41,47,2097
5485,5485,2D9490E1E73264DD4DD5DDE95A580FC1,42271,11,13,2,40,47,2047
5486,5486,2D9490E1E73264DD4DD5DDE95A580FC1,13371,14,23,9,41,47,2097
5487,5487,102E9FD1E3E53F7FAEC119DA72FB8E7B,11914,0,5,5,37,48,1898
5488,5488,102E9FD1E3E53F7FAEC119DA72FB8E7B,11074,6,8,2,37,47,1897
5489,5489,102E9FD1E3E53F7FAEC119DA72FB8E7B,11914,8,22,14,37,48,1898
5490,5490,21709F7FFA433548AE3C0AA8A76FE0E7,11151,0,5,5,30,48,1548
5491,5491,21709F7FFA433548AE3C0AA8A76FE0E7,42831,6,9,3,27,48,1398
5492,5492,21709F7FFA433548AE3C0AA8A76FE0E7,11151,10,23,13,30,48,1548
5496,5496,D51C6C6BE8A8903D8184ED5A28006B69,11231,0,1,1,37,49,1899
5497,5497,D51C6C6BE8A8903D8184ED5A28006B69,10841,1,3,2,37,47,1897
5498,5498,D51C6C6BE8A8903D8184ED5A28006B69,11461,3,23,20,37,49,1899
5499,5499,D41FED47C1014BB03A5F6A9B0F872050,42401,0,10,10,36,47,1847
5500,5500,D41FED47C1014BB03A5F6A9B0F872050,10251,11,13,2,35,47,1797
5501,5501,D41FED47C1014BB03A5F6A9B0F872050,42161,14,21,7,36,47,1847
5508,5508,25FFDC221DF5C09B531F864D963D911D,12641,0,10,10,10,43,543
5509,5509,25FFDC221DF5C09B531F864D963D911D,19114,10,12,2,7,43,393
5510,5510,25FFDC221DF5C09B531F864D963D911D,12641,12,19,7,10,43,543
5533,5533,FE72309A49FBEB6B76C0E42028E74707,42041,1,2,1,10,47,547
5534,5534,FE72309A49FBEB6B76C0E42028E74707,11571,7,19,12,13,46,696
5535,5535,FE72309A49FBEB6B76C0E42028E74707,19441,19,20,1,8,46,446
5536,5536,FE72309A49FBEB6B76C0E42028E74707,42041,21,23,2,10,47,547
5541,5541,157C584795D800615DAF4D6DD048A0E2,11875,0,6,6,30,46,1546
5542,5542,157C584795D800615DAF4D6DD048A0E2,11871,11,13,2,29,46,1496
5543,5543,157C584795D800615DAF4D6DD048A0E2,11381,13,14,1,30,47,1547
5544,5544,157C584795D800615DAF4D6DD048A0E2,11871,17,23,6,29,46,1496
5545,5545,D7908753E27A75D44787A74577BAE5A4,10471,0,16,16,37,48,1898
5546,5546,D7908753E27A75D44787A74577BAE5A4,13121,16,17,1,38,46,1946
5547,5547,D7908753E27A75D44787A74577BAE5A4,10471,18,19,1,37,48,1898
5551,5551,7061033AE3231BB99A9FC726045EEAFB,42071,8,10,2,31,49,1599
5552,5552,7061033AE3231BB99A9FC726045EEAFB,40094,13,14,1,29,48,1498
5553,5553,7061033AE3231BB99A9FC726045EEAFB,42071,16,23,7,31,49,1599
5554,5554,7E6F1057729DFB8EE8B59466F9245966,42231,1,13,12,37,46,1896
5555,5555,7E6F1057729DFB8EE8B59466F9245966,13911,14,15,1,39,46,1996
5556,5556,7E6F1057729DFB8EE8B59466F9245966,42231,16,20,4,37,46,1896
5557,5557,7E6F1057729DFB8EE8B59466F9245966,13911,20,22,2,39,46,1996
5562,5562,FD1E029D98CD01DDECEF1389743BD5EB,11771,0,9,9,39,49,1999
5563,5563,FD1E029D98CD01DDECEF1389743BD5EB,40171,10,18,8,38,48,1948
5564,5564,FD1E029D98CD01DDECEF1389743BD5EB,12514,20,22,2,38,47,1947
5568,5568,ECFE9F32C8C332B2B3057848F3DFB81A,11701,0,5,5,43,48,2198
5569,5569,ECFE9F32C8C332B2B3057848F3DFB81A,42321,7,11,4,43,47,2197
5570,5570,ECFE9F32C8C332B2B3057848F3DFB81A,11701,13,22,9,43,48,2198
5587,5587,6975A57D8AEEA17C1A623171368D0686,43181,0,7,7,39,48,1998
5588,5588,6975A57D8AEEA17C1A623171368D0686,11701,15,17,2,43,48,2198
5589,5589,6975A57D8AEEA17C1A623171368D0686,10191,18,20,2,40,48,2048
5595,5595,13CD17A8850630D31FADD0E88D1F2704,40964,1,2,1,35,48,1798
5596,5596,13CD17A8850630D31FADD0E88D1F2704,13511,4,6,2,34,48,1748
5597,5597,13CD17A8850630D31FADD0E88D1F2704,11074,7,11,4,37,47,1897
5598,5598,13CD17A8850630D31FADD0E88D1F2704,42221,14,18,4,38,48,1948
5603,5603,181802B57A29F4FAE1E7EF60B334A9D5,42864,1,4,3,38,44,1944
5604,5604,181802B57A29F4FAE1E7EF60B334A9D5,11261,8,18,10,36,46,1846
5605,5605,181802B57A29F4FAE1E7EF60B334A9D5,42864,22,23,1,38,44,1944
5622,5622,B25570B41BE43EDFDB526BAD98D552B1,42631,0,3,3,43,45,2195
5623,5623,B25570B41BE43EDFDB526BAD98D552B1,13341,4,14,10,44,45,2245
5624,5624,B25570B41BE43EDFDB526BAD98D552B1,42631,18,20,2,43,45,2195
5625,5625,B25570B41BE43EDFDB526BAD98D552B1,13341,21,23,2,44,45,2245
5629,5629,3AE9C3B6C0E6A8AA6B3B6C58033F1358,13941,0,6,6,41,47,2097
5630,5630,3AE9C3B6C0E6A8AA6B3B6C58033F1358,10601,8,10,2,39,47,1997
5631,5631,3AE9C3B6C0E6A8AA6B3B6C58033F1358,13941,10,23,13,41,47,2097
5632,5632,C7DA09D84BB6D5A3ABEAD976C8C0731E,42861,0,13,13,37,44,1894
5633,5633,C7DA09D84BB6D5A3ABEAD976C8C0731E,11261,14,16,2,36,46,1846
5634,5634,C7DA09D84BB6D5A3ABEAD976C8C0731E,42861,19,23,4,37,44,1894
5653,5653,E9DAAA2EB4F2385F16C3D2B77BA49D0B,42231,0,8,8,37,46,1896
5654,5654,E9DAAA2EB4F2385F16C3D2B77BA49D0B,13711,11,14,3,38,46,1946
5655,5655,E9DAAA2EB4F2385F16C3D2B77BA49D0B,11074,17,22,5,37,47,1897
5656,5656,2C19FDC386B0B2E924F75B25676D719F,42231,0,2,2,37,46,1896
5657,5657,2C19FDC386B0B2E924F75B25676D719F,42351,2,12,10,38,45,1945
5658,5658,2C19FDC386B0B2E924F75B25676D719F,42231,13,19,6,37,46,1896
5659,5659,2C19FDC386B0B2E924F75B25676D719F,42351,20,23,3,38,45,1945
5660,5660,FCDFD54ACD63AC86C96C11A63ACB1B0B,11151,1,7,6,30,48,1548
5661,5661,FCDFD54ACD63AC86C96C11A63ACB1B0B,11061,9,10,1,29,48,1498
5662,5662,FCDFD54ACD63AC86C96C11A63ACB1B0B,43761,10,12,2,32,47,1647
5663,5663,FCDFD54ACD63AC86C96C11A63ACB1B0B,11061,12,22,10,29,48,1498
5674,5674,99B581E7F0C398B5023B1247C338AC80,11541,0,10,10,35,49,1799
5675,5675,99B581E7F0C398B5023B1247C338AC80,11551,18,20,2,39,49,1999
5676,5676,99B581E7F0C398B5023B1247C338AC80,11541,20,22,2,35,49,1799
5681,5681,6FD0A6F8A40C4655F4AA9AE9A6F213BC,43581,0,13,13,33,48,1698
5682,5682,6FD0A6F8A40C4655F4AA9AE9A6F213BC,11731,18,20,2,36,48,1848
5683,5683,6FD0A6F8A40C4655F4AA9AE9A6F213BC,42981,20,23,3,36,49,1849
5718,5718,5CD4E5BDE075B65005739EE4A33EE29F,10111,2,13,11,37,47,1897
5719,5719,5CD4E5BDE075B65005739EE4A33EE29F,42161,16,18,2,36,47,1847
5720,5720,5CD4E5BDE075B65005739EE4A33EE29F,10111,21,23,2,37,47,1897
5724,5724,177791B1BD9F9F1A23D0B9EF068F9A10,11161,0,7,7,32,48,1648
5725,5725,177791B1BD9F9F1A23D0B9EF068F9A10,11861,8,9,1,32,47,1647
5726,5726,177791B1BD9F9F1A23D0B9EF068F9A10,11161,10,23,13,32,48,1648
5732,5732,E8A7D53461D2BA6FA4B97BA7B6C7ACC4,12921,9,10,1,9,41,491
5733,5733,E8A7D53461D2BA6FA4B97BA7B6C7ACC4,49201,12,13,1,7,41,391
5734,5734,E8A7D53461D2BA6FA4B97BA7B6C7ACC4,19181,15,18,3,8,40,440
5735,5735,1C04D8021AA3D6ACE9D6057D8C5BDA46,43011,0,5,5,40,42,2042
5736,5736,1C04D8021AA3D6ACE9D6057D8C5BDA46,12211,8,15,7,41,44,2094
5737,5737,1C04D8021AA3D6ACE9D6057D8C5BDA46,43011,18,23,5,40,42,2042
5738,5738,BF5BCA14D860AAF096A7D7D4ED7BBBF7,10271,0,17,17,37,46,1896
5739,5739,BF5BCA14D860AAF096A7D7D4ED7BBBF7,12514,18,20,2,38,47,1947
5740,5740,BF5BCA14D860AAF096A7D7D4ED7BBBF7,10271,21,22,1,37,46,1896
5749,5749,61867183769D6530648E6A2694D2E431,42511,0,8,8,37,47,1897
5750,5750,61867183769D6530648E6A2694D2E431,10271,11,12,1,37,46,1896
5751,5751,61867183769D6530648E6A2694D2E431,42511,15,16,1,37,47,1897
5752,5752,61867183769D6530648E6A2694D2E431,43171,19,20,1,39,49,1999
5775,5775,A60E51B2BB36D63F6E34260285BCBDB6,12661,0,10,10,32,45,1645
5776,5776,A60E51B2BB36D63F6E34260285BCBDB6,42791,11,12,1,35,45,1795
5777,5777,A60E51B2BB36D63F6E34260285BCBDB6,42531,14,15,1,31,45,1595
5778,5778,A60E51B2BB36D63F6E34260285BCBDB6,12311,20,21,1,30,44,1544
5779,5779,B7783E40C231BF2A915C5200F2E2562A,12031,0,12,12,33,48,1698
5780,5780,B7783E40C231BF2A915C5200F2E2562A,40951,14,15,1,36,49,1849
5781,5781,B7783E40C231BF2A915C5200F2E2562A,10161,19,21,2,35,49,1799
5782,5782,0BA677AEFA1FE879EC9FCA98466C3A1A,11641,0,5,5,22,49,1149
5783,5783,0BA677AEFA1FE879EC9FCA98466C3A1A,42681,5,6,1,24,48,1248
5784,5784,0BA677AEFA1FE879EC9FCA98466C3A1A,11641,9,23,14,22,49,1149
5785,5785,CFF4943452741BA085C68AD1AAC66347,11481,7,11,4,41,48,2098
5786,5786,CFF4943452741BA085C68AD1AAC66347,40302,11,14,3,40,49,2049
5787,5787,CFF4943452741BA085C68AD1AAC66347,10331,14,23,9,39,46,1996
5788,5788,AD318EF32C0809165B01885B23F1F0E6,10121,0,13,13,36,49,1849
5789,5789,AD318EF32C0809165B01885B23F1F0E6,40171,15,16,1,38,48,1948
5790,5790,AD318EF32C0809165B01885B23F1F0E6,13561,20,23,3,37,49,1899
5795,5795,D051A53A52187B78CF6DA99F6B3FF9C4,40637,0,14,14,36,47,1847
5796,5796,D051A53A52187B78CF6DA99F6B3FF9C4,10251,18,19,1,35,47,1797
5797,5797,D051A53A52187B78CF6DA99F6B3FF9C4,42401,20,23,3,36,47,1847
5805,5805,A0E1933ED6F7A553840E39014C4F2632,12871,0,4,4,22,33,1133
5806,5806,A0E1933ED6F7A553840E39014C4F2632,49181,6,8,2,21,31,1081
5807,5807,A0E1933ED6F7A553840E39014C4F2632,12871,11,21,10,22,33,1133
5838,5838,27B6DDFE3A356062F221ABD7AD70BB14,11061,0,7,7,29,48,1498
5839,5839,27B6DDFE3A356062F221ABD7AD70BB14,10681,9,15,6,30,48,1548
5840,5840,27B6DDFE3A356062F221ABD7AD70BB14,11061,20,22,2,29,48,1498
5845,5845,6EA64DE0B2C8AED08AD497BE7A734836,42491,0,12,12,32,46,1646
5846,5846,6EA64DE0B2C8AED08AD497BE7A734836,10292,14,18,4,30,47,1547
5847,5847,6EA64DE0B2C8AED08AD497BE7A734836,10341,19,20,1,31,47,1597
5851,5851,62E083FD6CCFD94FFA49C92986AAE56D,42141,3,4,1,32,47,1647
5852,5852,62E083FD6CCFD94FFA49C92986AAE56D,10281,6,8,2,33,48,1698
5853,5853,62E083FD6CCFD94FFA49C92986AAE56D,43761,13,16,3,32,47,1647
5854,5854,62E083FD6CCFD94FFA49C92986AAE56D,10281,18,23,5,33,48,1698
5865,5865,631BED1D16E18180C99F5914B33929C8,19114,0,6,6,7,43,393
5866,5866,631BED1D16E18180C99F5914B33929C8,12641,8,9,1,10,43,543
5867,5867,631BED1D16E18180C99F5914B33929C8,19114,12,23,11,7,43,393
5881,5881,0BD963812C76C79887817EDC02327E50,42471,0,11,11,35,49,1799
5882,5882,0BD963812C76C79887817EDC02327E50,42371,14,15,1,34,46,1746
5883,5883,0BD963812C76C79887817EDC02327E50,11231,20,23,3,37,49,1899
5884,5884,A219673CD1F96172857F22648471893C,10611,0,8,8,32,48,1648
5885,5885,A219673CD1F96172857F22648471893C,11381,10,12,2,30,47,1547
5886,5886,A219673CD1F96172857F22648471893C,11061,12,13,1,29,48,1498
5887,5887,A219673CD1F96172857F22648471893C,10611,15,19,4,32,48,1648
5888,5888,0CEDFC599FE515911C8AF1ADD0F867C7,42271,0,5,5,40,47,2047
5889,5889,0CEDFC599FE515911C8AF1ADD0F867C7,42511,9,10,1,37,47,1897
5890,5890,0CEDFC599FE515911C8AF1ADD0F867C7,42301,11,13,2,36,47,1847
5891,5891,0CEDFC599FE515911C8AF1ADD0F867C7,10841,15,21,6,37,47,1897
5904,5904,F96339A49EA24867AF66AA212A3AA3FA,10221,0,3,3,34,49,1749
5905,5905,F96339A49EA24867AF66AA212A3AA3FA,10691,5,15,10,33,48,1698
5906,5906,F96339A49EA24867AF66AA212A3AA3FA,42141,20,22,2,32,47,1647
5907,5907,936F3EAEFFE6D40274671E4FB3E6BD97,11941,0,5,5,37,46,1896
5908,5908,936F3EAEFFE6D40274671E4FB3E6BD97,11074,6,17,11,37,47,1897
5909,5909,936F3EAEFFE6D40274671E4FB3E6BD97,11941,18,23,5,37,46,1896
5919,5919,3C4F290E088B2251F5A11549B4DEDAFC,42511,0,8,8,37,47,1897
5920,5920,3C4F290E088B2251F5A11549B4DEDAFC,40123,8,21,13,38,47,1947
5921,5921,3C4F290E088B2251F5A11549B4DEDAFC,42511,22,23,1,37,47,1897
5927,5927,B0981EAA402812DC9FCC34AF3439893C,42921,0,8,8,33,47,1697
5928,5928,B0981EAA402812DC9FCC34AF3439893C,10281,8,9,1,33,48,1698
5929,5929,B0981EAA402812DC9FCC34AF3439893C,42921,10,20,10,33,47,1697
5958,5958,BEF31F045A546CF30A63CFBCD60FD3FA,42351,2,13,11,38,45,1945
5959,5959,BEF31F045A546CF30A63CFBCD60FD3FA,42231,15,17,2,37,46,1896
5960,5960,BEF31F045A546CF30A63CFBCD60FD3FA,13911,18,19,1,39,46,1996
5961,5961,BEF31F045A546CF30A63CFBCD60FD3FA,42231,19,22,3,37,46,1896
5969,5969,97A8770499EF614B5EA8B726D63394BB,10544,0,6,6,28,48,1448
5970,5970,97A8770499EF614B5EA8B726D63394BB,40094,8,11,3,29,48,1498
5971,5971,97A8770499EF614B5EA8B726D63394BB,11151,11,17,6,30,48,1548
5972,5972,97A8770499EF614B5EA8B726D63394BB,10544,18,23,5,28,48,1448
5976,5976,90BBBAD36BFCBEB083708BDB4BDE5D50,13101,4,15,11,40,47,2047
5977,5977,90BBBAD36BFCBEB083708BDB4BDE5D50,11806,15,18,3,41,48,2098
5978,5978,90BBBAD36BFCBEB083708BDB4BDE5D50,13101,18,19,1,40,47,2047
5982,5982,66026EF77CBEF7186A8C71238274BA4B,11381,0,4,4,30,47,1547
5983,5983,66026EF77CBEF7186A8C71238274BA4B,11061,4,12,8,29,48,1498
5984,5984,66026EF77CBEF7186A8C71238274BA4B,11381,12,17,5,30,47,1547
5985,5985,66026EF77CBEF7186A8C71238274BA4B,11061,17,23,6,29,48,1498
5994,5994,E090AE745FE0157CE235544725EE3E3A,12514,0,13,13,38,47,1947
5995,5995,E090AE745FE0157CE235544725EE3E3A,42281,14,15,1,40,48,2048
5996,5996,E090AE745FE0157CE235544725EE3E3A,12514,18,19,1,38,47,1947
6002,6002,5196458B260B6FC88126AA7C0013D624,10881,0,17,17,34,48,1748
6003,6003,5196458B260B6FC88126AA7C0013D624,11651,17,19,2,33,47,1697
6004,6004,5196458B260B6FC88126AA7C0013D624,13601,20,22,2,34,47,1747
6012,6012,805AB066ED953C507E9840193079B74B,11331,0,9,9,37,48,1898
6013,6013,805AB066ED953C507E9840193079B74B,10251,9,17,8,35,47,1797
6014,6014,805AB066ED953C507E9840193079B74B,42161,17,23,6,36,47,1847
6015,6015,7593D7AED856FF2FC2E20D8E8570438A,10471,0,16,16,37,48,1898
6016,6016,7593D7AED856FF2FC2E20D8E8570438A,42581,17,18,1,38,48,1948
6017,6017,7593D7AED856FF2FC2E20D8E8570438A,10107,19,20,1,38,49,1949
6018,6018,7593D7AED856FF2FC2E20D8E8570438A,11271,22,23,1,37,48,1898
6019,6019,F14F880CFEF9382CA6FAE593A8A1E7ED,11231,0,16,16,37,49,1899
6020,6020,F14F880CFEF9382CA6FAE593A8A1E7ED,12083,16,18,2,36,49,1849
6021,6021,F14F880CFEF9382CA6FAE593A8A1E7ED,11231,21,23,2,37,49,1899
6026,6026,1D5E404C59DCB684ADDB8228B291218A,10471,0,10,10,37,48,1898
6027,6027,1D5E404C59DCB684ADDB8228B291218A,10271,14,16,2,37,46,1896
6028,6028,1D5E404C59DCB684ADDB8228B291218A,43281,20,23,3,37,48,1898
6034,6034,F3BD6DC096346506415C8F819B3E2371,11271,0,12,12,37,48,1898
6035,6035,F3BD6DC096346506415C8F819B3E2371,42351,15,16,1,38,45,1945
6036,6036,F3BD6DC096346506415C8F819B3E2371,11271,17,23,6,37,48,1898
6040,6040,1EF65F9DBDC1402BAA31164960F0EECD,42461,0,6,6,45,47,2297
6041,6041,1EF65F9DBDC1402BAA31164960F0EECD,42321,8,16,8,43,47,2197
6042,6042,1EF65F9DBDC1402BAA31164960F0EECD,42461,18,23,5,45,47,2297
6046,6046,435E98F8E4BA1C5ED5B064CF22D1AAF1,40302,0,7,7,40,49,2049
6047,6047,435E98F8E4BA1C5ED5B064CF22D1AAF1,11771,13,15,2,39,49,1999
6048,6048,435E98F8E4BA1C5ED5B064CF22D1AAF1,40302,18,23,5,40,49,2049
6049,6049,F083C7F1DD4EA05DF2E56B02B79D914A,42771,0,7,7,36,47,1847
6050,6050,F083C7F1DD4EA05DF2E56B02B79D914A,10491,8,17,9,33,48,1698
6051,6051,F083C7F1DD4EA05DF2E56B02B79D914A,10251,18,23,5,35,47,1797
6052,6052,52DE1B5B29EB088C4F7CC0D4865B38F5,42861,6,15,9,37,44,1894
6053,6053,52DE1B5B29EB088C4F7CC0D4865B38F5,42151,19,20,1,35,45,1795
6054,6054,52DE1B5B29EB088C4F7CC0D4865B38F5,42861,21,22,1,37,44,1894
6055,6055,36C68D591F1BB1615F00290E59A07445,42041,1,5,4,10,47,547
6056,6056,36C68D591F1BB1615F00290E59A07445,19441,8,17,9,8,46,446
6057,6057,36C68D591F1BB1615F00290E59A07445,42041,17,23,6,10,47,547
6058,6058,6B0C3EBFB355FDC40FD1A590445FAB6D,19441,0,7,7,8,46,446
6059,6059,6B0C3EBFB355FDC40FD1A590445FAB6D,42041,7,14,7,10,47,547
6060,6060,6B0C3EBFB355FDC40FD1A590445FAB6D,19441,16,20,4,8,46,446
6061,6061,6B0C3EBFB355FDC40FD1A590445FAB6D,42041,21,22,1,10,47,547
6065,6065,78102BB6CA60765D76F3DF3B51005292,11151,0,5,5,30,48,1548
6066,6066,78102BB6CA60765D76F3DF3B51005292,43391,5,7,2,29,48,1498
6067,6067,78102BB6CA60765D76F3DF3B51005292,11151,7,15,8,30,48,1548
6068,6068,78102BB6CA60765D76F3DF3B51005292,42071,19,23,4,31,49,1599
6069,6069,182A42BB7961D14AD940FD065D4EDF33,10271,0,11,11,37,46,1896
6070,6070,182A42BB7961D14AD940FD065D4EDF33,13121,15,17,2,38,46,1946
6071,6071,182A42BB7961D14AD940FD065D4EDF33,11941,17,19,2,37,46,1896
6072,6072,182A42BB7961D14AD940FD065D4EDF33,13121,20,23,3,38,46,1946
6099,6099,F36A9C530F88290C9D611D428C0B8F3A,11021,0,7,7,36,49,1849
6100,6100,F36A9C530F88290C9D611D428C0B8F3A,40261,9,13,4,35,49,1799
6101,6101,F36A9C530F88290C9D611D428C0B8F3A,11021,13,23,10,36,49,1849
6102,6102,C764BB01DA18ED1507B7F7E3E440D93B,10951,2,14,12,29,48,1498
6103,6103,C764BB01DA18ED1507B7F7E3E440D93B,11151,17,19,2,30,48,1548
6104,6104,C764BB01DA18ED1507B7F7E3E440D93B,43391,20,21,1,29,48,1498
6105,6105,C764BB01DA18ED1507B7F7E3E440D93B,11381,21,22,1,30,47,1547
6106,6106,30F8C36AA5137BBA2518C91121C2E6D3,11381,0,8,8,30,47,1547
6107,6107,30F8C36AA5137BBA2518C91121C2E6D3,10951,11,16,5,29,48,1498
6108,6108,30F8C36AA5137BBA2518C91121C2E6D3,11381,17,20,3,30,47,1547
6109,6109,30F8C36AA5137BBA2518C91121C2E6D3,10951,20,23,3,29,48,1498
6120,6120,56F7236209B5943366167DCDA9EF00BB,11061,0,10,10,29,48,1498
6121,6121,56F7236209B5943366167DCDA9EF00BB,10681,10,12,2,30,48,1548
6122,6122,56F7236209B5943366167DCDA9EF00BB,11061,12,15,3,29,48,1498
6123,6123,56F7236209B5943366167DCDA9EF00BB,10681,18,20,2,30,48,1548
6124,6124,23F96418DBDA7106BDBB6C7E2C3432BD,13911,0,8,8,39,46,1996
6125,6125,23F96418DBDA7106BDBB6C7E2C3432BD,42351,10,12,2,38,45,1945
6126,6126,23F96418DBDA7106BDBB6C7E2C3432BD,42231,14,15,1,37,46,1896
6127,6127,23F96418DBDA7106BDBB6C7E2C3432BD,42351,16,20,4,38,45,1945
6132,6132,452EB29CE3617E4C70004D20AD1B10AD,13711,1,10,9,38,46,1946
6133,6133,452EB29CE3617E4C70004D20AD1B10AD,42941,12,13,1,37,47,1897
6134,6134,452EB29CE3617E4C70004D20AD1B10AD,42301,16,18,2,36,47,1847
6135,6135,452EB29CE3617E4C70004D20AD1B10AD,42511,20,21,1,37,47,1897
6136,6136,64CD015D410FD64E05B4431B458C1C51,43951,0,2,2,49,41,2491
6137,6137,64CD015D410FD64E05B4431B458C1C51,13821,5,6,1,49,45,2495
6138,6138,64CD015D410FD64E05B4431B458C1C51,43951,7,20,13,49,41,2491
6146,6146,6E0A220D70B6915451A9F278684F62AE,10661,0,9,9,37,49,1899
6147,6147,6E0A220D70B6915451A9F278684F62AE,40951,14,15,1,36,49,1849
6148,6148,6E0A220D70B6915451A9F278684F62AE,10661,16,23,7,37,49,1899
6149,6149,9F344971AFB0848D22FABB2D34666ADF,40833,1,9,8,41,47,2097
6150,6150,9F344971AFB0848D22FABB2D34666ADF,10801,12,15,3,42,47,2147
6151,6151,9F344971AFB0848D22FABB2D34666ADF,42321,16,17,1,43,47,2197
6152,6152,9F344971AFB0848D22FABB2D34666ADF,10801,19,23,4,42,47,2147
6159,6159,B1B15E298D4FC7776BC307436F04587A,15653,0,7,7,40,25,2025
6160,6160,B1B15E298D4FC7776BC307436F04587A,15311,11,12,1,43,25,2175
6161,6161,B1B15E298D4FC7776BC307436F04587A,15331,16,18,2,38,24,1924
6170,6170,D792802317B190A0C4936C40B3DD8C79,11061,1,8,7,29,48,1498
6171,6171,D792802317B190A0C4936C40B3DD8C79,43761,10,11,1,32,47,1647
6172,6172,D792802317B190A0C4936C40B3DD8C79,11061,12,23,11,29,48,1498
6179,6179,64FF3E93355E6DCA29977E04D316EABA,10221,0,2,2,34,49,1749
6180,6180,64FF3E93355E6DCA29977E04D316EABA,40637,5,13,8,36,47,1847
6181,6181,64FF3E93355E6DCA29977E04D316EABA,43281,14,17,3,37,48,1898
6182,6182,64FF3E93355E6DCA29977E04D316EABA,42471,18,22,4,35,49,1799
6183,6183,38BAD20AF3F1C2D76FC5AB52738907B1,10281,6,7,1,33,48,1698
6184,6184,38BAD20AF3F1C2D76FC5AB52738907B1,10341,10,13,3,31,47,1597
6185,6185,38BAD20AF3F1C2D76FC5AB52738907B1,10281,15,17,2,33,48,1698
6186,6186,38BAD20AF3F1C2D76FC5AB52738907B1,10341,18,21,3,31,47,1597
6213,6213,E8A3A2F2678AE58B36D710FCF037760E,11231,0,2,2,37,49,1899
6214,6214,E8A3A2F2678AE58B36D710FCF037760E,11541,3,16,13,35,49,1799
6215,6215,E8A3A2F2678AE58B36D710FCF037760E,11231,17,23,6,37,49,1899
6219,6219,101726F5FBACAB93679E46049956E04B,11911,0,12,12,37,48,1898
6220,6220,101726F5FBACAB93679E46049956E04B,10661,19,21,2,37,49,1899
6221,6221,101726F5FBACAB93679E46049956E04B,11911,22,23,1,37,48,1898
6222,6222,A7DA4D12F23D48A719500B36B36DC705,10811,0,5,5,38,46,1946
6223,6223,A7DA4D12F23D48A719500B36B36DC705,42864,8,17,9,38,44,1944
6224,6224,A7DA4D12F23D48A719500B36B36DC705,10811,20,23,3,38,46,1946
6225,6225,CFBD6D6D5142063C71001C83584F2CC4,42231,0,12,12,37,46,1896
6226,6226,CFBD6D6D5142063C71001C83584F2CC4,42271,13,19,6,40,47,2047
6227,6227,CFBD6D6D5142063C71001C83584F2CC4,42231,19,23,4,37,46,1896
6252,6252,10ABDFD0F4CB2AA94EB148DB034D5020,42521,0,9,9,31,47,1597
6253,6253,10ABDFD0F4CB2AA94EB148DB034D5020,10295,10,11,1,30,47,1547
6254,6254,10ABDFD0F4CB2AA94EB148DB034D5020,42521,11,23,12,31,47,1597
6255,6255,DCF0E7A2CF6CF01600CEB25103C20FCF,11061,0,4,4,29,48,1498
6256,6256,DCF0E7A2CF6CF01600CEB25103C20FCF,11151,5,7,2,30,48,1548
6257,6257,DCF0E7A2CF6CF01600CEB25103C20FCF,11061,7,22,15,29,48,1498
6258,6258,3C5BF8354C7B22C00BFA5438C070BC0F,13711,0,13,13,38,46,1946
6259,6259,3C5BF8354C7B22C00BFA5438C070BC0F,43241,15,19,4,36,46,1846
6260,6260,3C5BF8354C7B22C00BFA5438C070BC0F,13711,21,23,2,38,46,1946
6264,6264,DE4C4188909D0535886D3FFC16C590B6,12311,0,17,17,30,44,1544
6265,6265,DE4C4188909D0535886D3FFC16C590B6,42531,18,20,2,31,45,1595
6266,6266,DE4C4188909D0535886D3FFC16C590B6,12311,22,23,1,30,44,1544
6267,6267,91CBC6C40E2C5E32A3B80285EA0B9AEB,11541,1,5,4,35,49,1799
6268,6268,91CBC6C40E2C5E32A3B80285EA0B9AEB,11021,6,18,12,36,49,1849
6269,6269,91CBC6C40E2C5E32A3B80285EA0B9AEB,11211,21,22,1,34,49,1749
6273,6273,96B100113D40E22B39686C026F5DA397,42864,0,6,6,38,44,1944
6274,6274,96B100113D40E22B39686C026F5DA397,11261,7,19,12,36,46,1846
6275,6275,96B100113D40E22B39686C026F5DA397,42864,20,22,2,38,44,1944
6276,6276,09F64A9A641B3F2B92615DE97B925264,10634,7,8,1,27,45,1395
6277,6277,09F64A9A641B3F2B92615DE97B925264,10351,11,16,5,28,45,1445
6278,6278,09F64A9A641B3F2B92615DE97B925264,10634,18,20,2,27,45,1395
6323,6323,3383EF1DECBBF9214B6D2B5F31896AB7,11211,0,13,13,34,49,1749
6324,6324,3383EF1DECBBF9214B6D2B5F31896AB7,11861,14,15,1,32,47,1647
6325,6325,3383EF1DECBBF9214B6D2B5F31896AB7,11211,17,23,6,34,49,1749
6330,6330,AF45D7FF91ADC8A42EE1BE638B4AB9CE,11701,0,12,12,43,48,2198
6331,6331,AF45D7FF91ADC8A42EE1BE638B4AB9CE,11801,19,21,2,42,48,2148
6332,6332,AF45D7FF91ADC8A42EE1BE638B4AB9CE,13271,22,23,1,41,47,2097
6340,6340,F4C44655D662E7B0953357C6BC0F15C4,12641,6,9,3,10,43,543
6341,6341,F4C44655D662E7B0953357C6BC0F15C4,19114,10,12,2,7,43,393
6342,6342,F4C44655D662E7B0953357C6BC0F15C4,19904,13,23,10,9,44,494
6346,6346,377BD5B9C037AF000CC29F45169CD1E4,11231,0,10,10,37,49,1899
6347,6347,377BD5B9C037AF000CC29F45169CD1E4,11201,11,19,8,35,49,1799
6348,6348,377BD5B9C037AF000CC29F45169CD1E4,12083,19,23,4,36,49,1849
6353,6353,FC0936587C74EF8144A5D7B54D78302D,19021,0,3,3,10,45,545
6354,6354,FC0936587C74EF8144A5D7B54D78302D,19441,4,18,14,8,46,446
6355,6355,FC0936587C74EF8144A5D7B54D78302D,19021,20,22,2,10,45,545
6356,6356,36B9A094E8D22C518990766A8F925428,19901,1,13,12,7,44,394
6357,6357,36B9A094E8D22C518990766A8F925428,12641,14,16,2,10,43,543
6358,6358,36B9A094E8D22C518990766A8F925428,19621,17,18,1,5,46,296
6359,6359,36B9A094E8D22C518990766A8F925428,19114,19,22,3,7,43,393
6360,6360,C113C3BFA8200BB19492C01042EDAB2E,10351,0,13,13,28,45,1445
6361,6361,C113C3BFA8200BB19492C01042EDAB2E,42501,14,18,4,28,47,1447
6362,6362,C113C3BFA8200BB19492C01042EDAB2E,10351,20,23,3,28,45,1445
6363,6363,B53C313F28E9C152305715765AEEF04B,42151,0,8,8,35,45,1795
6364,6364,B53C313F28E9C152305715765AEEF04B,42861,8,9,1,37,44,1894
6365,6365,B53C313F28E9C152305715765AEEF04B,42151,11,18,7,35,45,1795
6366,6366,ACB823DB33D22CC4344D979C1DDF92F4,11261,0,6,6,36,46,1846
6367,6367,ACB823DB33D22CC4344D979C1DDF92F4,42861,8,10,2,37,44,1894
6368,6368,ACB823DB33D22CC4344D979C1DDF92F4,11261,14,15,1,36,46,1846
6369,6369,ACB823DB33D22CC4344D979C1DDF92F4,42861,17,23,6,37,44,1894
6383,6383,C36C389487F236497E05D4F18E330E72,42491,0,6,6,32,46,1646
6384,6384,C36C389487F236497E05D4F18E330E72,42523,7,8,1,31,47,1597
6385,6385,C36C389487F236497E05D4F18E330E72,11324,10,12,2,31,46,1596
6386,6386,C36C389487F236497E05D4F18E330E72,11151,22,23,1,30,48,1548
6393,6393,06F407FD461A4B0FFE40FBF8673BD071,10351,0,7,7,28,45,1445
6394,6394,06F407FD461A4B0FFE40FBF8673BD071,10634,7,10,3,27,45,1395
6395,6395,06F407FD461A4B0FFE40FBF8673BD071,10351,10,20,10,28,45,1445
6401,6401,9CE25D5D0F1EBAC3F2953CC0B8A26E4A,11381,0,18,18,30,47,1547
6402,6402,9CE25D5D0F1EBAC3F2953CC0B8A26E4A,10951,18,21,3,29,48,1498
6403,6403,9CE25D5D0F1EBAC3F2953CC0B8A26E4A,11381,22,23,1,30,47,1547
6424,6424,5FB7FCDE8733B3DE0082FB61D42FC13D,13941,0,4,4,41,47,2097
6425,6425,5FB7FCDE8733B3DE0082FB61D42FC13D,42321,7,18,11,43,47,2197
6426,6426,5FB7FCDE8733B3DE0082FB61D42FC13D,13941,21,23,2,41,47,2097
6427,6427,0EA80F49CAFA9BFC58CF0D20F7967BFF,42871,0,5,5,30,45,1545
6428,6428,0EA80F49CAFA9BFC58CF0D20F7967BFF,12311,7,15,8,30,44,1544
6429,6429,0EA80F49CAFA9BFC58CF0D20F7967BFF,42871,19,23,4,30,45,1545
6430,6430,4CFE48022CAC445FF2DF9E1132BED841,11954,0,7,7,32,49,1649
6431,6431,4CFE48022CAC445FF2DF9E1132BED841,11951,11,14,3,31,49,1599
6432,6432,4CFE48022CAC445FF2DF9E1132BED841,11954,18,22,4,32,49,1649
6433,6433,5E462966E2CF0DDB1BA1FDC1B333EEC0,19441,0,10,10,8,46,446
6434,6434,5E462966E2CF0DDB1BA1FDC1B333EEC0,42041,14,17,3,10,47,547
6435,6435,5E462966E2CF0DDB1BA1FDC1B333EEC0,19441,21,22,1,8,46,446
6442,6442,DC6F2750E1589D9E93BB09689CD15111,13731,0,1,1,33,49,1699
6443,6443,DC6F2750E1589D9E93BB09689CD15111,11954,2,5,3,32,49,1649
6444,6444,DC6F2750E1589D9E93BB09689CD15111,13731,7,8,1,33,49,1699
6445,6445,DC6F2750E1589D9E93BB09689CD15111,11954,14,22,8,32,49,1649
6446,6446,2FC183BC2F941A64AA8A55C99BC3DFD9,11074,0,17,17,37,47,1897
6447,6447,2FC183BC2F941A64AA8A55C99BC3DFD9,42161,17,19,2,36,47,1847
6448,6448,2FC183BC2F941A64AA8A55C99BC3DFD9,13011,20,22,2,39,47,1997
6461,6461,E835E54D31E2053FF59F5E3D61ABCD72,11151,4,5,1,30,48,1548
6462,6462,E835E54D31E2053FF59F5E3D61ABCD72,11061,8,10,2,29,48,1498
6463,6463,E835E54D31E2053FF59F5E3D61ABCD72,11151,11,23,12,30,48,1548
6476,6476,1CE5F4D10EE2FB173CB9F2BC0746661A,42531,0,4,4,31,45,1595
6477,6477,1CE5F4D10EE2FB173CB9F2BC0746661A,12311,4,6,2,30,44,1544
6478,6478,1CE5F4D10EE2FB173CB9F2BC0746661A,42531,6,20,14,31,45,1595
6487,6487,D3E46B15B35DC3C198E6EE945D227259,42271,5,9,4,40,47,2047
6488,6488,D3E46B15B35DC3C198E6EE945D227259,11806,11,12,1,41,48,2098
6489,6489,D3E46B15B35DC3C198E6EE945D227259,13381,12,14,2,39,47,1997
6490,6490,D3E46B15B35DC3C198E6EE945D227259,42271,15,21,6,40,47,2047
6495,6495,C567BA758C03AD1D2310F8B57DE3E1B4,42864,1,12,11,38,44,1944
6496,6496,C567BA758C03AD1D2310F8B57DE3E1B4,11261,12,13,1,36,46,1846
6497,6497,C567BA758C03AD1D2310F8B57DE3E1B4,42864,13,19,6,38,44,1944
6515,6515,70E50AA138C0538910E5623295B506D8,13231,0,2,2,39,46,1996
6516,6516,70E50AA138C0538910E5623295B506D8,11261,2,7,5,36,46,1846
6517,6517,70E50AA138C0538910E5623295B506D8,42351,9,18,9,38,45,1945
6518,6518,70E50AA138C0538910E5623295B506D8,11261,20,21,1,36,46,1846
6532,6532,A54E515E45C9983FF6CA2263317B045A,42141,2,6,4,32,47,1647
6533,6533,A54E515E45C9983FF6CA2263317B045A,10281,7,9,2,33,48,1698
6534,6534,A54E515E45C9983FF6CA2263317B045A,11324,10,23,13,31,46,1596
6543,6543,AB0D8A80317F7BE676D43BBF62ED6A04,13411,9,10,1,49,42,2492
6544,6544,AB0D8A80317F7BE676D43BBF62ED6A04,43951,10,11,1,49,41,2491
6545,6545,AB0D8A80317F7BE676D43BBF62ED6A04,13411,15,16,1,49,42,2492
6546,6546,AB0D8A80317F7BE676D43BBF62ED6A04,43951,19,23,4,49,41,2491
6547,6547,9F7BBEBDE25379D4345B2CB89A6224BC,10295,0,9,9,30,47,1547
6548,6548,9F7BBEBDE25379D4345B2CB89A6224BC,42523,13,18,5,31,47,1597
6549,6549,9F7BBEBDE25379D4345B2CB89A6224BC,13651,18,21,3,30,47,1547
6550,6550,7FD9072832AAE29AE2915CDEF233B942,42321,0,6,6,43,47,2197
6551,6551,7FD9072832AAE29AE2915CDEF233B942,10801,10,13,3,42,47,2147
6552,6552,7FD9072832AAE29AE2915CDEF233B942,13221,16,18,2,40,47,2047
6553,6553,7FD9072832AAE29AE2915CDEF233B942,10801,19,23,4,42,47,2147
6561,6561,DC15358175A492C6F21AAEFAD4CD0BB7,42161,0,9,9,36,47,1847
6562,6562,DC15358175A492C6F21AAEFAD4CD0BB7,10901,9,12,3,35,48,1798
6563,6563,DC15358175A492C6F21AAEFAD4CD0BB7,10111,12,16,4,37,47,1897
6564,6564,DC15358175A492C6F21AAEFAD4CD0BB7,10251,18,23,5,35,47,1797
6572,6572,36D57AC4B96C7DFE87ABBE02CDA239B2,43161,0,4,4,35,47,1797
6573,6573,36D57AC4B96C7DFE87ABBE02CDA239B2,42161,4,9,5,36,47,1847
6574,6574,36D57AC4B96C7DFE87ABBE02CDA239B2,11861,10,12,2,32,47,1647
6575,6575,36D57AC4B96C7DFE87ABBE02CDA239B2,10251,13,23,10,35,47,1797
6596,6596,511248B31413344B77C12D74A5EE7CDF,43471,0,6,6,31,49,1599
6597,6597,511248B31413344B77C12D74A5EE7CDF,11151,9,14,5,30,48,1548
6598,6598,511248B31413344B77C12D74A5EE7CDF,11061,19,20,1,29,48,1498
6599,6599,511248B31413344B77C12D74A5EE7CDF,43471,21,23,2,31,49,1599
6619,6619,B22D37030214F2A7FFAA6A7CF0D7C446,10651,0,12,12,36,49,1849
6620,6620,B22D37030214F2A7FFAA6A7CF0D7C446,13561,12,14,2,37,49,1899
6621,6621,B22D37030214F2A7FFAA6A7CF0D7C446,10651,20,21,1,36,49,1849
6622,6622,5E8BB1A9FDE1AFD08848003FB8A60E0E,40673,0,8,8,36,48,1848
6623,6623,5E8BB1A9FDE1AFD08848003FB8A60E0E,43731,8,17,9,34,47,1747
6624,6624,5E8BB1A9FDE1AFD08848003FB8A60E0E,10411,19,22,3,36,48,1848
6625,6625,9CFD096A7BDD76C773AF0C5EF90468CD,11381,0,17,17,30,47,1547
6626,6626,9CFD096A7BDD76C773AF0C5EF90468CD,11061,19,22,3,29,48,1498
6627,6627,9CFD096A7BDD76C773AF0C5EF90468CD,11381,22,23,1,30,47,1547
6628,6628,89084C54499EDD168F6753B4E522A173,42581,6,9,3,38,48,1948
6629,6629,89084C54499EDD168F6753B4E522A173,12514,9,20,11,38,47,1947
6630,6630,89084C54499EDD168F6753B4E522A173,11914,20,22,2,37,48,1898
6631,6631,48A980CCF2A198BF882581E8F9F510C5,42161,0,12,12,36,47,1847
6632,6632,48A980CCF2A198BF882581E8F9F510C5,10111,12,16,4,37,47,1897
6633,6633,48A980CCF2A198BF882581E8F9F510C5,42401,16,23,7,36,47,1847
6648,6648,BA2EA0FB894B48D5E94919D0AC51D8C3,11301,0,7,7,41,49,2099
6649,6649,BA2EA0FB894B48D5E94919D0AC51D8C3,42281,8,10,2,40,48,2048
6650,6650,BA2EA0FB894B48D5E94919D0AC51D8C3,13101,14,15,1,40,47,2047
6651,6651,BA2EA0FB894B48D5E94919D0AC51D8C3,42931,19,20,1,41,49,2099
6660,6660,B470E3704A2F86A96D6A67582CEB1CB7,13111,9,10,1,42,46,2146
6661,6661,B470E3704A2F86A96D6A67582CEB1CB7,13371,12,16,4,41,47,2097
6662,6662,B470E3704A2F86A96D6A67582CEB1CB7,42031,17,19,2,40,46,2046
6663,6663,B470E3704A2F86A96D6A67582CEB1CB7,13111,19,23,4,42,46,2146
6669,6669,582FCEF67ED9C80E5B2E8667690F61FB,42221,0,7,7,38,48,1948
6670,6670,582FCEF67ED9C80E5B2E8667690F61FB,42401,7,12,5,36,47,1847
6671,6671,582FCEF67ED9C80E5B2E8667690F61FB,42221,13,17,4,38,48,1948
6672,6672,582FCEF67ED9C80E5B2E8667690F61FB,42401,17,22,5,36,47,1847
6673,6673,FFB1B36AA2200DC572A87CB17EFA9D1F,10431,1,12,11,33,49,1699
6674,6674,FFB1B36AA2200DC572A87CB17EFA9D1F,11201,12,14,2,35,49,1799
6675,6675,FFB1B36AA2200DC572A87CB17EFA9D1F,12083,15,17,2,36,49,1849
6676,6676,FFB1B36AA2200DC572A87CB17EFA9D1F,11201,17,23,6,35,49,1799
6683,6683,7CFAECF5A2F1F9BFEFF6C033052830B4,12641,8,13,5,10,43,543
6684,6684,7CFAECF5A2F1F9BFEFF6C033052830B4,19021,16,17,1,10,45,545
6685,6685,7CFAECF5A2F1F9BFEFF6C033052830B4,12641,21,22,1,10,43,543
6692,6692,AD22EC299874F8BC256C15F14ACCC85A,12561,0,15,15,45,43,2293
6693,6693,AD22EC299874F8BC256C15F14ACCC85A,12221,19,20,1,43,44,2194
6694,6694,AD22EC299874F8BC256C15F14ACCC85A,12561,21,23,2,45,43,2293
6713,6713,FBED60795FCFB63636BCD315FA3FE656,43761,0,12,12,32,47,1647
6714,6714,FBED60795FCFB63636BCD315FA3FE656,42521,14,19,5,31,47,1597
6715,6715,FBED60795FCFB63636BCD315FA3FE656,42141,21,23,2,32,47,1647
6716,6716,85A3472C760B288249587BF2433B560B,13681,0,10,10,38,47,1947
6717,6717,85A3472C760B288249587BF2433B560B,10841,12,16,4,37,47,1897
6718,6718,85A3472C760B288249587BF2433B560B,13681,21,23,2,38,47,1947
6719,6719,18CA1DE7DEE6BB73BF6E9BB235334726,13471,0,1,1,47,49,2399
6720,6720,18CA1DE7DEE6BB73BF6E9BB235334726,42601,2,7,5,44,48,2248
6721,6721,18CA1DE7DEE6BB73BF6E9BB235334726,13351,9,17,8,48,48,2448
6722,6722,18CA1DE7DEE6BB73BF6E9BB235334726,13471,18,22,4,47,49,2399
6723,6723,4381249BCF13D3BC77B69C580A9E4330,43731,0,8,8,34,47,1747
6724,6724,4381249BCF13D3BC77B69C580A9E4330,43161,9,10,1,35,47,1797
6725,6725,4381249BCF13D3BC77B69C580A9E4330,43731,11,23,12,34,47,1747
6726,6726,4AE162074F44355D07FE1733512A7F11,11021,0,9,9,36,49,1849
6727,6727,4AE162074F44355D07FE1733512A7F11,10107,12,14,2,38,49,1949
6728,6728,4AE162074F44355D07FE1733512A7F11,11021,15,23,8,36,49,1849
6729,6729,6B4D51A4231E697456281435F5175150,13841,0,13,13,40,46,2046
6730,6730,6B4D51A4231E697456281435F5175150,13221,15,17,2,40,47,2047
6731,6731,6B4D51A4231E697456281435F5175150,43341,18,19,1,41,46,2096
6736,6736,F7822E497E024984B061734A7CD1652C,42161,3,8,5,36,47,1847
6737,6737,F7822E497E024984B061734A7CD1652C,11271,12,15,3,37,48,1898
6738,6738,F7822E497E024984B061734A7CD1652C,11074,16,22,6,37,47,1897
6744,6744,8E1C16742CC2A11973E777449216F917,10721,0,15,15,31,48,1598
6745,6745,8E1C16742CC2A11973E777449216F917,10381,16,18,2,31,49,1599
6746,6746,8E1C16742CC2A11973E777449216F917,11151,19,21,2,30,48,1548
6747,6747,8E1C16742CC2A11973E777449216F917,11061,21,22,1,29,48,1498
6752,6752,1C12FD1823A36FA85667FC8316128B0A,13331,0,5,5,38,47,1947
6753,6753,1C12FD1823A36FA85667FC8316128B0A,42511,5,6,1,37,47,1897
6754,6754,1C12FD1823A36FA85667FC8316128B0A,42301,6,8,2,36,47,1847
6755,6755,1C12FD1823A36FA85667FC8316128B0A,13681,9,23,14,38,47,1947
6764,6764,6A72A6369674993FC322A428033222FA,42321,0,12,12,43,47,2197
6765,6765,6A72A6369674993FC322A428033222FA,11001,15,17,2,42,47,2147
6766,6766,6A72A6369674993FC322A428033222FA,42321,21,23,2,43,47,2197
6767,6767,BEE853049D28B67DAA1CF8A47B438594,12921,0,12,12,9,41,491
6768,6768,BEE853049D28B67DAA1CF8A47B438594,12641,13,14,1,10,43,543
6769,6769,BEE853049D28B67DAA1CF8A47B438594,12921,14,19,5,9,41,491
6775,6775,E24F34B965BE1054DCE4AF1C1CD48137,11861,0,17,17,32,47,1647
6776,6776,E24F34B965BE1054DCE4AF1C1CD48137,11651,18,19,1,33,47,1697
6777,6777,E24F34B965BE1054DCE4AF1C1CD48137,11861,20,23,3,32,47,1647
6778,6778,F850A01EC352DE808C8F4EFD91A8118B,42161,0,1,1,36,47,1847
6779,6779,F850A01EC352DE808C8F4EFD91A8118B,43161,1,2,1,35,47,1797
6780,6780,F850A01EC352DE808C8F4EFD91A8118B,10491,3,7,4,33,48,1698
6781,6781,F850A01EC352DE808C8F4EFD91A8118B,42161,21,22,1,36,47,1847
6788,6788,C7859131FC5613A278444EF81B856AED,13711,3,5,2,38,46,1946
6789,6789,C7859131FC5613A278444EF81B856AED,42511,5,16,11,37,47,1897
6790,6790,C7859131FC5613A278444EF81B856AED,12021,18,22,4,37,49,1899
6796,6796,749B796E573CC68A347283ADE6C5408A,10921,0,8,8,43,48,2198
6797,6797,749B796E573CC68A347283ADE6C5408A,40302,11,12,1,40,49,2049
6798,6798,749B796E573CC68A347283ADE6C5408A,11301,15,16,1,41,49,2099
6799,6799,749B796E573CC68A347283ADE6C5408A,10924,16,23,7,43,49,2199
6808,6808,9D25C8999E418D8C72AB77E479B8A009,11321,0,6,6,31,46,1596
6809,6809,9D25C8999E418D8C72AB77E479B8A009,10301,8,9,1,31,45,1595
6810,6810,9D25C8999E418D8C72AB77E479B8A009,11321,12,22,10,31,46,1596
6814,6814,2FE3A658AB2B7A9048527F74C274D683,19024,0,9,9,9,45,495
6815,6815,2FE3A658AB2B7A9048527F74C274D683,42041,10,12,2,10,47,547
6816,6816,2FE3A658AB2B7A9048527F74C274D683,19024,14,19,5,9,45,495
6817,6817,2FE3A658AB2B7A9048527F74C274D683,42041,19,22,3,10,47,547
6818,6818,3ACA97659E1008ADCF51B6F2339FB988,43391,8,12,4,29,48,1498
6819,6819,3ACA97659E1008ADCF51B6F2339FB988,10681,12,14,2,30,48,1548
6820,6820,3ACA97659E1008ADCF51B6F2339FB988,43391,15,19,4,29,48,1498
6821,6821,3ACA97659E1008ADCF51B6F2339FB988,10381,21,22,1,31,49,1599
6822,6822,E962C3D0A8FC163364DD770DFBF0ADE9,13651,0,12,12,30,47,1547
6823,6823,E962C3D0A8FC163364DD770DFBF0ADE9,12121,12,13,1,29,47,1497
6824,6824,E962C3D0A8FC163364DD770DFBF0ADE9,13651,17,19,2,30,47,1547
6829,6829,D3F18133881188A01FA675132E824AEA,11361,6,12,6,22,48,1148
6830,6830,D3F18133881188A01FA675132E824AEA,42481,14,15,1,22,49,1149
6831,6831,D3F18133881188A01FA675132E824AEA,42681,17,18,1,24,48,1248
6840,6840,2DF528642956EE7F281EE1C987DEF31F,10271,0,14,14,37,46,1896
6841,6841,2DF528642956EE7F281EE1C987DEF31F,43241,16,18,2,36,46,1846
6842,6842,2DF528642956EE7F281EE1C987DEF31F,13711,19,21,2,38,46,1946
6850,6850,DD11EC5E596BBBC5A00C9F6952DD9EC0,10281,0,11,11,33,48,1698
6851,6851,DD11EC5E596BBBC5A00C9F6952DD9EC0,42301,13,15,2,36,47,1847
6852,6852,DD11EC5E596BBBC5A00C9F6952DD9EC0,40673,15,16,1,36,48,1848
6853,6853,DD11EC5E596BBBC5A00C9F6952DD9EC0,10281,18,21,3,33,48,1698
6863,6863,808997A795BC5BFC148D7ED7B31E3237,11074,0,17,17,37,47,1897
6864,6864,808997A795BC5BFC148D7ED7B31E3237,41005,17,19,2,38,47,1947
6865,6865,808997A795BC5BFC148D7ED7B31E3237,42161,20,23,3,36,47,1847
6869,6869,A534FD7E51A551BE3196665029DD0400,19931,0,6,6,7,43,393
6870,6870,A534FD7E51A551BE3196665029DD0400,12641,6,18,12,10,43,543
6871,6871,A534FD7E51A551BE3196665029DD0400,19931,20,23,3,7,43,393
6872,6872,6EFCECAC6C771461757C90546CF9DA84,43311,0,7,7,31,48,1598
6873,6873,6EFCECAC6C771461757C90546CF9DA84,11161,8,10,2,32,48,1648
6874,6874,6EFCECAC6C771461757C90546CF9DA84,43311,12,19,7,31,48,1598
6882,6882,C42F4D358B434058D63F50357AB3111D,42321,1,6,5,43,47,2197
6883,6883,C42F4D358B434058D63F50357AB3111D,11001,7,14,7,42,47,2147
6884,6884,C42F4D358B434058D63F50357AB3111D,13221,16,18,2,40,47,2047
6885,6885,C42F4D358B434058D63F50357AB3111D,42321,20,21,1,43,47,2197
6886,6886,01067BD464140B42D6F1D4D82F8B8EE7,43481,0,8,8,39,48,1998
6887,6887,01067BD464140B42D6F1D4D82F8B8EE7,11231,9,17,8,37,49,1899
6888,6888,01067BD464140B42D6F1D4D82F8B8EE7,43481,18,22,4,39,48,1998
6889,6889,EE107F15123C6DB132974358298F51B4,42583,0,13,13,40,48,2048
6890,6890,EE107F15123C6DB132974358298F51B4,11914,16,18,2,37,48,1898
6891,6891,EE107F15123C6DB132974358298F51B4,11291,21,22,1,40,49,2049
6897,6897,7A2C40FB80E14D0B750F490BD1DBAAD5,42231,0,1,1,37,46,1896
6898,6898,7A2C40FB80E14D0B750F490BD1DBAAD5,10331,2,3,1,39,46,1996
6899,6899,7A2C40FB80E14D0B750F490BD1DBAAD5,10811,3,12,9,38,46,1946
6900,6900,7A2C40FB80E14D0B750F490BD1DBAAD5,10331,12,18,6,39,46,1996
6905,6905,DE69FEBC50432F9871EF62D07F7A5C1A,19181,1,5,4,8,40,440
6906,6906,DE69FEBC50432F9871EF62D07F7A5C1A,12921,6,8,2,9,41,491
6907,6907,DE69FEBC50432F9871EF62D07F7A5C1A,19181,8,18,10,8,40,440
6932,6932,6BD84C8A53F72BF8C93033C860230921,11021,0,10,10,36,49,1849
6933,6933,6BD84C8A53F72BF8C93033C860230921,10401,11,14,3,33,49,1699
6934,6934,6BD84C8A53F72BF8C93033C860230921,10651,17,18,1,36,49,1849
6935,6935,6BD84C8A53F72BF8C93033C860230921,40261,20,23,3,35,49,1799
6944,6944,45155754A6F701E65D67926402696B26,10111,0,10,10,37,47,1897
6945,6945,45155754A6F701E65D67926402696B26,10251,11,12,1,35,47,1797
6946,6946,45155754A6F701E65D67926402696B26,10111,13,23,10,37,47,1897
6953,6953,01308B72F71E3AACC045F922DA6CAE4D,43761,1,15,14,32,47,1647
6954,6954,01308B72F71E3AACC045F922DA6CAE4D,42523,16,17,1,31,47,1597
6955,6955,01308B72F71E3AACC045F922DA6CAE4D,43761,17,21,4,32,47,1647
6956,6956,01308B72F71E3AACC045F922DA6CAE4D,42523,21,23,2,31,47,1597
6960,6960,7875A34DC3B1C1A6D18480769685A825,13911,0,7,7,39,46,1996
6961,6961,7875A34DC3B1C1A6D18480769685A825,42231,9,16,7,37,46,1896
6962,6962,7875A34DC3B1C1A6D18480769685A825,13911,16,20,4,39,46,1996
6963,6963,734810FF97DF9866F27398812A969E07,10111,0,19,19,37,47,1897
6964,6964,734810FF97DF9866F27398812A969E07,43731,19,20,1,34,47,1747
6965,6965,734810FF97DF9866F27398812A969E07,10111,21,23,2,37,47,1897
6983,6983,03B985BD6480D63A60CC18D1C65DE880,13101,1,8,7,40,47,2047
6984,6984,03B985BD6480D63A60CC18D1C65DE880,12514,9,10,1,38,47,1947
6985,6985,03B985BD6480D63A60CC18D1C65DE880,11481,13,22,9,41,48,2098
6991,6991,B05A258B733A2800CC4DBE5F548BD20B,43761,0,14,14,32,47,1647
6992,6992,B05A258B733A2800CC4DBE5F548BD20B,11161,18,20,2,32,48,1648
6993,6993,B05A258B733A2800CC4DBE5F548BD20B,43761,21,22,1,32,47,1647
6997,6997,E78E0ABBE194ABEE97C2D7DD94378A1C,10121,0,14,14,36,49,1849
6998,6998,E78E0ABBE194ABEE97C2D7DD94378A1C,13331,14,15,1,38,47,1947
6999,6999,E78E0ABBE194ABEE97C2D7DD94378A1C,10121,19,23,4,36,49,1849
7003,7003,824CB1B1B23572593ECC1D95EF328196,42321,0,10,10,43,47,2197
7004,7004,824CB1B1B23572593ECC1D95EF328196,13941,14,15,1,41,47,2097
7005,7005,824CB1B1B23572593ECC1D95EF328196,11001,19,21,2,42,47,2147
7006,7006,2DF13F3C6B51FEAFB9527CE1523C2712,10711,0,5,5,29,46,1496
7007,7007,2DF13F3C6B51FEAFB9527CE1523C2712,11061,5,12,7,29,48,1498
7008,7008,2DF13F3C6B51FEAFB9527CE1523C2712,11381,12,23,11,30,47,1547
7022,7022,36E343A96D81AB746DE47507E4AE3DEE,12491,0,13,13,36,43,1843
7023,7023,36E343A96D81AB746DE47507E4AE3DEE,43451,14,17,3,37,40,1890
7024,7024,36E343A96D81AB746DE47507E4AE3DEE,12491,19,23,4,36,43,1843
7029,7029,053AF9D02F27761F1671A0A9A244D378,40441,0,8,8,30,48,1548
7030,7030,053AF9D02F27761F1671A0A9A244D378,42291,12,18,6,29,48,1498
7031,7031,053AF9D02F27761F1671A0A9A244D378,11381,19,21,2,30,47,1547
7042,7042,95BCDE710D7D8D89CD4BD88C80C9BAAA,12083,0,9,9,36,49,1849
7043,7043,95BCDE710D7D8D89CD4BD88C80C9BAAA,10111,11,13,2,37,47,1897
7044,7044,95BCDE710D7D8D89CD4BD88C80C9BAAA,43731,17,21,4,34,47,1747
7050,7050,7C11C7CBC4724062CEFCE060A70E0F2E,12921,0,5,5,9,41,491
7051,7051,7C11C7CBC4724062CEFCE060A70E0F2E,12641,6,18,12,10,43,543
7052,7052,7C11C7CBC4724062CEFCE060A70E0F2E,12921,18,23,5,9,41,491
7056,7056,EDC7C81BC2B9F6C61FA60D931FF80CEC,13711,6,7,1,38,46,1946
7057,7057,EDC7C81BC2B9F6C61FA60D931FF80CEC,11941,9,10,1,37,46,1896
7058,7058,EDC7C81BC2B9F6C61FA60D931FF80CEC,13711,12,22,10,38,46,1946
7064,7064,9ABE3B89C29F61B8F64784C4F64F4D33,11911,9,10,1,37,48,1898
7065,7065,9ABE3B89C29F61B8F64784C4F64F4D33,42581,11,12,1,38,48,1948
7066,7066,9ABE3B89C29F61B8F64784C4F64F4D33,11271,15,16,1,37,48,1898
7067,7067,9ABE3B89C29F61B8F64784C4F64F4D33,40171,19,23,4,38,48,1948
7078,7078,656752102BA99654C7060CE5B2133D72,19114,0,6,6,7,43,393
7079,7079,656752102BA99654C7060CE5B2133D72,49201,6,11,5,7,41,391
7080,7080,656752102BA99654C7060CE5B2133D72,12921,13,15,2,9,41,491
7081,7081,656752102BA99654C7060CE5B2133D72,19931,15,22,7,7,43,393
7085,7085,0CE1530259EA66797A9FEEF237D2664E,42861,0,5,5,37,44,1894
7086,7086,0CE1530259EA66797A9FEEF237D2664E,11261,7,9,2,36,46,1846
7087,7087,0CE1530259EA66797A9FEEF237D2664E,42861,9,23,14,37,44,1894
7092,7092,C2938F6FA2A943D6DFC754D5D6C219D6,11074,0,8,8,37,47,1897
7093,7093,C2938F6FA2A943D6DFC754D5D6C219D6,42221,10,11,1,38,48,1948
7094,7094,C2938F6FA2A943D6DFC754D5D6C219D6,11074,12,17,5,37,47,1897
7095,7095,C2938F6FA2A943D6DFC754D5D6C219D6,12514,19,21,2,38,47,1947
7096,7096,86DCDDE33411453F571CC544491FBB18,42511,0,14,14,37,47,1897
7097,7097,86DCDDE33411453F571CC544491FBB18,13331,15,16,1,38,47,1947
7098,7098,86DCDDE33411453F571CC544491FBB18,10841,19,20,1,37,47,1897
7099,7099,86DCDDE33411453F571CC544491FBB18,42301,21,23,2,36,47,1847
7100,7100,9F1824F4E1493708E44E02E9F071631E,11161,0,8,8,32,48,1648
7101,7101,9F1824F4E1493708E44E02E9F071631E,43761,8,10,2,32,47,1647
7102,7102,9F1824F4E1493708E44E02E9F071631E,11161,13,23,10,32,48,1648
7110,7110,2F8CA12038D8BFDAC42D43FF94213821,42381,0,3,3,39,41,1991
7111,7111,2F8CA12038D8BFDAC42D43FF94213821,43451,6,18,12,37,40,1890
7112,7112,2F8CA12038D8BFDAC42D43FF94213821,13071,19,20,1,41,41,2091
7122,7122,46E2AD869A50D26B31D29755AA6D4275,42583,1,5,4,40,48,2048
7123,7123,46E2AD869A50D26B31D29755AA6D4275,12511,6,8,2,39,47,1997
7124,7124,46E2AD869A50D26B31D29755AA6D4275,42583,11,23,12,40,48,2048
7128,7128,83FF48AB636D71DF6BA8AF05F7F294C8,11291,0,9,9,40,49,2049
7129,7129,83FF48AB636D71DF6BA8AF05F7F294C8,40951,12,17,5,36,49,1849
7130,7130,83FF48AB636D71DF6BA8AF05F7F294C8,11291,18,23,5,40,49,2049
7131,7131,2AF351B37413F74D5ABE0F1368F7A288,10111,0,12,12,37,47,1897
7132,7132,2AF351B37413F74D5ABE0F1368F7A288,11911,14,16,2,37,48,1898
7133,7133,2AF351B37413F74D5ABE0F1368F7A288,10111,16,23,7,37,47,1897
7143,7143,DD628D137A372FD9F2379158E8EE3966,12921,9,14,5,9,41,491
7144,7144,DD628D137A372FD9F2379158E8EE3966,19181,16,18,2,8,40,440
7145,7145,DD628D137A372FD9F2379158E8EE3966,12921,21,23,2,9,41,491
7146,7146,CC3FA096FA296BC301B8FB82BD507846,11531,3,8,5,34,49,1749
7147,7147,CC3FA096FA296BC301B8FB82BD507846,42471,10,21,11,35,49,1799
7148,7148,CC3FA096FA296BC301B8FB82BD507846,11531,21,23,2,34,49,1749
7153,7153,AFC682DA7B2C15A5BBB72506964CC56C,11001,1,14,13,42,47,2147
7154,7154,AFC682DA7B2C15A5BBB72506964CC56C,13941,16,17,1,41,47,2097
7155,7155,AFC682DA7B2C15A5BBB72506964CC56C,11001,18,21,3,42,47,2147
7198,7198,4DB0308FEE808EB4AB25FA1D5CC2FE73,42861,0,13,13,37,44,1894
7199,7199,4DB0308FEE808EB4AB25FA1D5CC2FE73,11261,13,15,2,36,46,1846
7200,7200,4DB0308FEE808EB4AB25FA1D5CC2FE73,42861,19,22,3,37,44,1894
7204,7204,2F0964870183D8D0FFE314E848023707,40673,0,4,4,36,48,1848
7205,7205,2F0964870183D8D0FFE314E848023707,42021,6,14,8,33,47,1697
7206,7206,2F0964870183D8D0FFE314E848023707,11081,16,23,7,35,46,1796
7207,7207,4E8CF0BE1A57E085938ED2B5916A9E34,11381,3,14,11,30,47,1547
7208,7208,4E8CF0BE1A57E085938ED2B5916A9E34,43661,14,19,5,33,47,1697
7209,7209,4E8CF0BE1A57E085938ED2B5916A9E34,11861,20,22,2,32,47,1647
7210,7210,18B6761AED1C3C2339B4532D918A85A7,42471,0,3,3,35,49,1799
7211,7211,18B6761AED1C3C2339B4532D918A85A7,40211,3,5,2,36,49,1849
7212,7212,18B6761AED1C3C2339B4532D918A85A7,10691,7,23,16,33,48,1698
7213,7213,A6C1FE9C86E0070D7B5C5A844D461B29,13101,3,8,5,40,47,2047
7214,7214,A6C1FE9C86E0070D7B5C5A844D461B29,11801,8,16,8,42,48,2148
7215,7215,A6C1FE9C86E0070D7B5C5A844D461B29,13101,18,19,1,40,47,2047
7220,7220,AE632AB563DDBD93D401093D98CBD7C6,12514,0,3,3,38,47,1947
7221,7221,AE632AB563DDBD93D401093D98CBD7C6,43481,3,5,2,39,48,1998
7222,7222,AE632AB563DDBD93D401093D98CBD7C6,42271,6,23,17,40,47,2047
7266,7266,28AE6FF44E8686DC354D2E3DF7700FCC,42461,0,6,6,45,47,2297
7267,7267,28AE6FF44E8686DC354D2E3DF7700FCC,42321,7,11,4,43,47,2197
7268,7268,28AE6FF44E8686DC354D2E3DF7700FCC,42461,12,13,1,45,47,2297
7269,7269,28AE6FF44E8686DC354D2E3DF7700FCC,42321,13,18,5,43,47,2197
7273,7273,B4D01E5DC34E1F304118BD0078329215,10471,0,14,14,37,48,1898
7274,7274,B4D01E5DC34E1F304118BD0078329215,10107,18,19,1,38,49,1949
7275,7275,B4D01E5DC34E1F304118BD0078329215,11461,21,23,2,37,49,1899
7281,7281,9C19E311843F01F479E4BB288BD95DB0,11381,0,17,17,30,47,1547
7282,7282,9C19E311843F01F479E4BB288BD95DB0,10731,17,18,1,33,47,1697
7283,7283,9C19E311843F01F479E4BB288BD95DB0,11381,20,23,3,30,47,1547
7300,7300,9B353F06ECF34A550C00046F7DE80EF8,42583,0,6,6,40,48,2048
7301,7301,9B353F06ECF34A550C00046F7DE80EF8,42271,7,9,2,40,47,2047
7302,7302,9B353F06ECF34A550C00046F7DE80EF8,42583,11,12,1,40,48,2048
7303,7303,9B353F06ECF34A550C00046F7DE80EF8,42271,15,21,6,40,47,2047
7304,7304,6A2C270BBD0D0D35CF836157F863E3CC,10651,0,9,9,36,49,1849
7305,7305,6A2C270BBD0D0D35CF836157F863E3CC,42961,10,15,5,35,49,1799
7306,7306,6A2C270BBD0D0D35CF836157F863E3CC,13561,21,23,2,37,49,1899
7307,7307,872EA7042E221A40D168D3255557BABA,43761,0,15,15,32,47,1647
7308,7308,872EA7042E221A40D168D3255557BABA,11381,16,17,1,30,47,1547
7309,7309,872EA7042E221A40D168D3255557BABA,43761,18,22,4,32,47,1647
7310,7310,872EA7042E221A40D168D3255557BABA,42523,22,23,1,31,47,1597
7314,7314,CB475691D1589F2BB22AFAB50B53194C,42091,0,6,6,43,46,2196
7315,7315,CB475691D1589F2BB22AFAB50B53194C,13341,7,9,2,44,45,2245
7316,7316,CB475691D1589F2BB22AFAB50B53194C,42201,13,23,10,43,46,2196
7317,7317,31C7D6EBBE109EA14915A4B3065924CF,42601,0,2,2,44,48,2248
7318,7318,31C7D6EBBE109EA14915A4B3065924CF,42971,5,7,2,43,49,2199
7319,7319,31C7D6EBBE109EA14915A4B3065924CF,11701,11,19,8,43,48,2198
7320,7320,31C7D6EBBE109EA14915A4B3065924CF,42601,20,22,2,44,48,2248
7321,7321,B0CA59461CE535DA6C80DC6682EBEAFB,42271,0,6,6,40,47,2047
7322,7322,B0CA59461CE535DA6C80DC6682EBEAFB,11291,8,13,5,40,49,2049
7323,7323,B0CA59461CE535DA6C80DC6682EBEAFB,42271,17,22,5,40,47,2047
7330,7330,B1EB0B0860BD6C8B84B53407190296C0,42691,0,12,12,24,48,1248
7331,7331,B1EB0B0860BD6C8B84B53407190296C0,10451,12,15,3,25,48,1298
7332,7332,B1EB0B0860BD6C8B84B53407190296C0,42691,17,19,2,24,48,1248
7333,7333,B1EB0B0860BD6C8B84B53407190296C0,10451,21,23,2,25,48,1298
7362,7362,4E5B59644819D7FCE2AE20E3C8904250,42221,3,7,4,38,48,1948
7363,7363,4E5B59644819D7FCE2AE20E3C8904250,12514,8,10,2,38,47,1947
7364,7364,4E5B59644819D7FCE2AE20E3C8904250,11074,11,23,12,37,47,1897
7373,7373,FC707C73D6614611D82A13C2F325D332,42511,3,16,13,37,47,1897
7374,7374,FC707C73D6614611D82A13C2F325D332,11261,16,17,1,36,46,1846
7375,7375,FC707C73D6614611D82A13C2F325D332,41081,18,22,4,36,49,1849
7380,7380,4DAFB85C918047225CA596E4134A09D3,42141,0,8,8,32,47,1647
7381,7381,4DAFB85C918047225CA596E4134A09D3,42523,8,18,10,31,47,1597
7382,7382,4DAFB85C918047225CA596E4134A09D3,42141,21,23,2,32,47,1647
7387,7387,B6C7AA54BD01E2AF7E412AA91D8473DA,11481,0,5,5,41,48,2098
7388,7388,B6C7AA54BD01E2AF7E412AA91D8473DA,12511,7,10,3,39,47,1997
7389,7389,B6C7AA54BD01E2AF7E412AA91D8473DA,13371,12,19,7,41,47,2097
7390,7390,A6FB8806348882E3287150AAB70E5425,42141,0,1,1,32,47,1647
7391,7391,A6FB8806348882E3287150AAB70E5425,11161,1,3,2,32,48,1648
7392,7392,A6FB8806348882E3287150AAB70E5425,42141,3,19,16,32,47,1647
7393,7393,619B4993323BBB76F010058331D5BCE1,13911,2,6,4,39,46,1996
7394,7394,619B4993323BBB76F010058331D5BCE1,11261,7,20,13,36,46,1846
7395,7395,619B4993323BBB76F010058331D5BCE1,13911,21,22,1,39,46,1996
7410,7410,F7BA1E9C235C1D8A36FA4FE83DC9EFDD,10161,0,5,5,35,49,1799
7411,7411,F7BA1E9C235C1D8A36FA4FE83DC9EFDD,13561,6,7,1,37,49,1899
7412,7412,F7BA1E9C235C1D8A36FA4FE83DC9EFDD,11541,10,23,13,35,49,1799
7421,7421,0AD8838435D12A1009D3BADE4EAE690D,11381,0,6,6,30,47,1547
7422,7422,0AD8838435D12A1009D3BADE4EAE690D,10951,6,10,4,29,48,1498
7423,7423,0AD8838435D12A1009D3BADE4EAE690D,11381,11,23,12,30,47,1547
7427,7427,BB44A13BCAB0B022B18D7F4EDDEC4037,11231,0,1,1,37,49,1899
7428,7428,BB44A13BCAB0B022B18D7F4EDDEC4037,10841,1,19,18,37,47,1897
7429,7429,BB44A13BCAB0B022B18D7F4EDDEC4037,11231,20,23,3,37,49,1899
7438,7438,CC115E075627F49AC17F5D9D869D1EC5,19441,1,16,15,8,46,446
7439,7439,CC115E075627F49AC17F5D9D869D1EC5,42041,16,17,1,10,47,547
7440,7440,CC115E075627F49AC17F5D9D869D1EC5,19441,20,22,2,8,46,446
7458,7458,3473FA09F0017B3BD24476C962AE1520,12521,9,10,1,35,41,1791
7459,7459,3473FA09F0017B3BD24476C962AE1520,43451,15,16,1,37,40,1890
7460,7460,3473FA09F0017B3BD24476C962AE1520,12521,17,21,4,35,41,1791
7461,7461,6F947024A8B73B97F8430A4C48FA1DF6,12083,0,6,6,36,49,1849
7462,7462,6F947024A8B73B97F8430A4C48FA1DF6,11231,6,17,11,37,49,1899
7463,7463,6F947024A8B73B97F8430A4C48FA1DF6,10107,18,20,2,38,49,1949
7464,7464,6F947024A8B73B97F8430A4C48FA1DF6,12083,20,23,3,36,49,1849
7469,7469,1E78C6812CC13AC596F7D7BD80A5DD70,11921,0,16,16,38,48,1948
7470,7470,1E78C6812CC13AC596F7D7BD80A5DD70,11074,17,19,2,37,47,1897
7471,7471,1E78C6812CC13AC596F7D7BD80A5DD70,11914,22,23,1,37,48,1898
7472,7472,A27203DC664657DF4BBDCCF4AC9D93B1,49201,0,1,1,7,41,391
7473,7473,A27203DC664657DF4BBDCCF4AC9D93B1,12921,3,21,18,9,41,491
7474,7474,A27203DC664657DF4BBDCCF4AC9D93B1,19181,22,23,1,8,40,440
7479,7479,86877F32D6D32D1728C272FD8E7855F4,11861,0,12,12,32,47,1647
7480,7480,86877F32D6D32D1728C272FD8E7855F4,10281,12,16,4,33,48,1698
7481,7481,86877F32D6D32D1728C272FD8E7855F4,11861,16,22,6,32,47,1647
7485,7485,FC3794BA86CF22CB019DA7FB9AB33807,10107,9,10,1,38,49,1949
7486,7486,FC3794BA86CF22CB019DA7FB9AB33807,11231,12,15,3,37,49,1899
7487,7487,FC3794BA86CF22CB019DA7FB9AB33807,40463,15,17,2,38,49,1949
7488,7488,FC3794BA86CF22CB019DA7FB9AB33807,11231,18,21,3,37,49,1899
7489,7489,505FF343C6E446E7F99CFC0B5C13724B,42631,4,9,5,43,45,2195
7490,7490,505FF343C6E446E7F99CFC0B5C13724B,13341,9,21,12,44,45,2245
7491,7491,505FF343C6E446E7F99CFC0B5C13724B,42631,21,23,2,43,45,2195
7495,7495,70BC072844C7CA9E90555B310CFF3C22,42161,1,8,7,36,47,1847
7496,7496,70BC072844C7CA9E90555B310CFF3C22,11081,10,13,3,35,46,1796
7497,7497,70BC072844C7CA9E90555B310CFF3C22,43731,16,23,7,34,47,1747
7502,7502,540311DE1F12F752C637697C87C1492F,43951,0,6,6,49,41,2491
7503,7503,540311DE1F12F752C637697C87C1492F,43101,8,11,3,46,40,2340
7504,7504,540311DE1F12F752C637697C87C1492F,43951,11,23,12,49,41,2491
7518,7518,351176EA2081A4F4EC9558DE9BEC78B4,10371,0,9,9,37,49,1899
7519,7519,351176EA2081A4F4EC9558DE9BEC78B4,10781,10,11,1,35,47,1797
7520,7520,351176EA2081A4F4EC9558DE9BEC78B4,10371,12,23,11,37,49,1899
7528,7528,9B6B73877F33AB3E9F8AF9AD1EB06F71,10111,0,2,2,37,47,1897
7529,7529,9B6B73877F33AB3E9F8AF9AD1EB06F71,40637,2,9,7,36,47,1847
7530,7530,9B6B73877F33AB3E9F8AF9AD1EB06F71,10111,9,22,13,37,47,1897
7542,7542,267988E92E70704346099D85792A0EFB,11271,0,8,8,37,48,1898
7543,7543,267988E92E70704346099D85792A0EFB,10661,9,11,2,37,49,1899
7544,7544,267988E92E70704346099D85792A0EFB,40463,14,21,7,38,49,1949
7545,7545,31100BE8BDE5B74B2D64B60F8888BAE5,10111,0,13,13,37,47,1897
7546,7546,31100BE8BDE5B74B2D64B60F8888BAE5,40637,13,15,2,36,47,1847
7547,7547,31100BE8BDE5B74B2D64B60F8888BAE5,10111,16,23,7,37,47,1897
7563,7563,7B27DF400F344F6F46338A9F907AAD49,12641,6,7,1,10,43,543
7564,7564,7B27DF400F344F6F46338A9F907AAD49,19114,8,10,2,7,43,393
7565,7565,7B27DF400F344F6F46338A9F907AAD49,12641,10,19,9,10,43,543
7569,7569,25B6AD6E6A0FC6B9342D4FFF9B399EB2,42531,1,4,3,31,45,1595
7570,7570,25B6AD6E6A0FC6B9342D4FFF9B399EB2,12311,5,6,1,30,44,1544
7571,7571,25B6AD6E6A0FC6B9342D4FFF9B399EB2,42531,6,20,14,31,45,1595
7572,7572,ADA9A722DAF1AADCFC014F67AA9E279E,11301,0,11,11,41,49,2099
7573,7573,ADA9A722DAF1AADCFC014F67AA9E279E,11551,15,16,1,39,49,1999
7574,7574,ADA9A722DAF1AADCFC014F67AA9E279E,11301,21,23,2,41,49,2099
7592,7592,AA6D4A35F81446E34CB45D0775B9D6B5,11231,3,13,10,37,49,1899
7593,7593,AA6D4A35F81446E34CB45D0775B9D6B5,10471,13,20,7,37,48,1898
7594,7594,AA6D4A35F81446E34CB45D0775B9D6B5,11231,20,22,2,37,49,1899
7604,7604,600D7AE0D829582E691D7BDBD387E918,19441,2,6,4,8,46,446
7605,7605,600D7AE0D829582E691D7BDBD387E918,42041,9,10,1,10,47,547
7606,7606,600D7AE0D829582E691D7BDBD387E918,19441,15,20,5,8,46,446
7607,7607,7BF529F423A6C51BF619B13381E16746,42071,9,11,2,31,49,1599
7608,7608,7BF529F423A6C51BF619B13381E16746,43761,12,13,1,32,47,1647
7609,7609,7BF529F423A6C51BF619B13381E16746,42071,15,17,2,31,49,1599
7610,7610,7BF529F423A6C51BF619B13381E16746,10281,20,21,1,33,48,1698
7631,7631,9564935971289F596991F6745924CC71,19114,0,12,12,7,43,393
7632,7632,9564935971289F596991F6745924CC71,19441,12,15,3,8,46,446
7633,7633,9564935971289F596991F6745924CC71,19114,18,23,5,7,43,393
7638,7638,C994B0BB00A5F5442EEA247C000D74C5,42531,0,12,12,31,45,1595
7639,7639,C994B0BB00A5F5442EEA247C000D74C5,12311,14,17,3,30,44,1544
7640,7640,C994B0BB00A5F5442EEA247C000D74C5,42141,18,20,2,32,47,1647
7641,7641,C994B0BB00A5F5442EEA247C000D74C5,12311,22,23,1,30,44,1544
7642,7642,512965DC7E2584D886D6B5F50766448D,42141,0,6,6,32,47,1647
7643,7643,512965DC7E2584D886D6B5F50766448D,10281,18,21,3,33,48,1698
7644,7644,512965DC7E2584D886D6B5F50766448D,42141,21,23,2,32,47,1647
7645,7645,D3BA93132970408B526D24B9AE7BC619,42971,2,18,16,43,49,2199
7646,7646,D3BA93132970408B526D24B9AE7BC619,10921,19,21,2,43,48,2198
7647,7647,D3BA93132970408B526D24B9AE7BC619,42971,22,23,1,43,49,2199
7654,7654,6FAC7BB08E665D69B9DFE624BBEE190F,11021,0,3,3,36,49,1849
7655,7655,6FAC7BB08E665D69B9DFE624BBEE190F,10107,6,16,10,38,49,1949
7656,7656,6FAC7BB08E665D69B9DFE624BBEE190F,11021,16,23,7,36,49,1849
7664,7664,9C6C1ADF25AAC9C3CF37F22C1275241A,10901,0,1,1,35,48,1798
7665,7665,9C6C1ADF25AAC9C3CF37F22C1275241A,43581,2,11,9,33,48,1698
7666,7666,9C6C1ADF25AAC9C3CF37F22C1275241A,10901,14,19,5,35,48,1798
7667,7667,9C6C1ADF25AAC9C3CF37F22C1275241A,43581,20,23,3,33,48,1698
7668,7668,863536ED4B92FD4394237691B551892C,12381,0,10,10,32,48,1648
7669,7669,863536ED4B92FD4394237691B551892C,10161,13,15,2,35,49,1799
7670,7670,863536ED4B92FD4394237691B551892C,10721,16,18,2,31,48,1598
7671,7671,D9F24020F509475723D0E535CFE87F2D,11431,0,10,10,29,47,1497
7672,7672,D9F24020F509475723D0E535CFE87F2D,13651,12,13,1,30,47,1547
7673,7673,D9F24020F509475723D0E535CFE87F2D,11431,15,23,8,29,47,1497
7694,7694,0F11B5CA889ADAC68664648A25492433,42523,0,12,12,31,47,1597
7695,7695,0F11B5CA889ADAC68664648A25492433,43761,15,16,1,32,47,1647
7696,7696,0F11B5CA889ADAC68664648A25492433,10341,17,20,3,31,47,1597
7706,7706,3DAF31DB1DFDD7FA7EE0727CC0FC2507,13231,0,13,13,39,46,1996
7707,7707,3DAF31DB1DFDD7FA7EE0727CC0FC2507,11261,13,16,3,36,46,1846
7708,7708,3DAF31DB1DFDD7FA7EE0727CC0FC2507,10811,19,23,4,38,46,1946
7709,7709,6D11D3FEB14395619B2C8DA34BCD86CD,11001,0,15,15,42,47,2147
7710,7710,6D11D3FEB14395619B2C8DA34BCD86CD,13371,16,17,1,41,47,2097
7711,7711,6D11D3FEB14395619B2C8DA34BCD86CD,11001,17,22,5,42,47,2147
7712,7712,1420486C9FFB0F1C4F47BBAE2CD15BC4,13141,1,9,8,23,30,1180
7713,7713,1420486C9FFB0F1C4F47BBAE2CD15BC4,49181,11,12,1,21,31,1081
7714,7714,1420486C9FFB0F1C4F47BBAE2CD15BC4,13141,14,16,2,23,30,1180
7715,7715,1420486C9FFB0F1C4F47BBAE2CD15BC4,49181,21,22,1,21,31,1081
7719,7719,D96B7C7CD287FA6B8B147D58E43FFB7B,10801,2,15,13,42,47,2147
7720,7720,D96B7C7CD287FA6B8B147D58E43FFB7B,42321,19,21,2,43,47,2197
7721,7721,D96B7C7CD287FA6B8B147D58E43FFB7B,10801,22,23,1,42,47,2147
7725,7725,283D32F18C3BA6BD8207C085157E283B,12311,0,8,8,30,44,1544
7726,7726,283D32F18C3BA6BD8207C085157E283B,42871,11,12,1,30,45,1545
7727,7727,283D32F18C3BA6BD8207C085157E283B,12311,15,23,8,30,44,1544
7742,7742,0DD480B5A13E261C7A404CA1C7C938C6,13121,0,17,17,38,46,1946
7743,7743,0DD480B5A13E261C7A404CA1C7C938C6,42511,18,20,2,37,47,1897
7744,7744,0DD480B5A13E261C7A404CA1C7C938C6,13121,21,22,1,38,46,1946
7748,7748,5701B8A7837527B587A0C3425928E82E,42921,0,7,7,33,47,1697
7749,7749,5701B8A7837527B587A0C3425928E82E,42161,11,15,4,36,47,1847
7750,7750,5701B8A7837527B587A0C3425928E82E,10251,17,19,2,35,47,1797
7751,7751,5701B8A7837527B587A0C3425928E82E,13601,21,22,1,34,47,1747
7752,7752,A4159DFA1F52CBB73D407E98B2AEC323,12971,0,14,14,32,48,1648
7753,7753,A4159DFA1F52CBB73D407E98B2AEC323,11201,14,17,3,35,49,1799
7754,7754,A4159DFA1F52CBB73D407E98B2AEC323,12971,18,20,2,32,48,1648
7755,7755,5AF26FD3EDD59D73F20E2AE7E3BEDAFF,49201,0,9,9,7,41,391
7756,7756,5AF26FD3EDD59D73F20E2AE7E3BEDAFF,12921,12,18,6,9,41,491
7757,7757,5AF26FD3EDD59D73F20E2AE7E3BEDAFF,49201,20,23,3,7,41,391
7758,7758,65161D8F8A2EE0E4F87D9472311EE576,12514,0,2,2,38,47,1947
7759,7759,65161D8F8A2EE0E4F87D9472311EE576,10841,2,19,17,37,47,1897
7760,7760,65161D8F8A2EE0E4F87D9472311EE576,12514,20,23,3,38,47,1947
7774,7774,7AB7808A497636952D0CCE900063C9AF,19024,0,1,1,9,45,495
7775,7775,7AB7808A497636952D0CCE900063C9AF,19021,2,5,3,10,45,545
7776,7776,7AB7808A497636952D0CCE900063C9AF,12641,7,18,11,10,43,543
7777,7777,507C264A3FC1C39E70D178529DA708EA,11074,0,13,13,37,47,1897
7778,7778,507C264A3FC1C39E70D178529DA708EA,12391,14,15,1,36,49,1849
7779,7779,507C264A3FC1C39E70D178529DA708EA,41091,20,21,1,35,49,1799
7825,7825,9345FA61569E568C2515B3E1C680E214,42551,0,2,2,14,48,748
7826,7826,9345FA61569E568C2515B3E1C680E214,11631,4,18,14,12,49,649
7827,7827,9345FA61569E568C2515B3E1C680E214,42551,19,22,3,14,48,748
7828,7828,B64386F8532B164D8BD72E201ACF3412,43061,0,5,5,43,46,2196
7829,7829,B64386F8532B164D8BD72E201ACF3412,13371,6,18,12,41,47,2097
7830,7830,B64386F8532B164D8BD72E201ACF3412,43061,21,23,2,43,46,2196
7847,7847,D3BD56A91B629CB820A9599473E8A9CF,10221,0,16,16,34,49,1749
7848,7848,D3BD56A91B629CB820A9599473E8A9CF,11781,17,18,1,38,49,1949
7849,7849,D3BD56A91B629CB820A9599473E8A9CF,10221,21,23,2,34,49,1749
7850,7850,974AC7FE92CE73F874A47A41CE1DC034,10251,0,11,11,35,47,1797
7851,7851,974AC7FE92CE73F874A47A41CE1DC034,11201,12,13,1,35,49,1799
7852,7852,974AC7FE92CE73F874A47A41CE1DC034,40951,14,15,1,36,49,1849
7853,7853,974AC7FE92CE73F874A47A41CE1DC034,10251,16,23,7,35,47,1797
7854,7854,EB723F2604EF7AE7C37A9459E67C1BA0,10171,4,10,6,26,47,1347
7855,7855,EB723F2604EF7AE7C37A9459E67C1BA0,12601,12,17,5,25,47,1297
7856,7856,EB723F2604EF7AE7C37A9459E67C1BA0,10171,22,23,1,26,47,1347
7868,7868,FBC8CAB3D4C7648EA4217AFECE2654AA,42471,0,10,10,35,49,1799
7869,7869,FBC8CAB3D4C7648EA4217AFECE2654AA,12021,12,13,1,37,49,1899
7870,7870,FBC8CAB3D4C7648EA4217AFECE2654AA,42471,17,23,6,35,49,1799
7876,7876,AA94328A21E669C14B53998CC009A981,43951,6,8,2,49,41,2491
7877,7877,AA94328A21E669C14B53998CC009A981,13821,9,16,7,49,45,2495
7878,7878,AA94328A21E669C14B53998CC009A981,43951,19,22,3,49,41,2491
7879,7879,42FFB951EFF49B3A7C7FEF1D95A0CC7C,11074,0,7,7,37,47,1897
7880,7880,42FFB951EFF49B3A7C7FEF1D95A0CC7C,10591,9,11,2,39,48,1998
7881,7881,42FFB951EFF49B3A7C7FEF1D95A0CC7C,11074,12,20,8,37,47,1897
7882,7882,CEF1ABFE94920422247AC22399F7761F,11001,0,8,8,42,47,2147
7883,7883,CEF1ABFE94920422247AC22399F7761F,42601,8,10,2,44,48,2248
7884,7884,CEF1ABFE94920422247AC22399F7761F,11001,10,22,12,42,47,2147
7890,7890,E45BFF8A7B42DBE312092B84982F68A3,11861,0,7,7,32,47,1647
7891,7891,E45BFF8A7B42DBE312092B84982F68A3,11871,8,17,9,29,46,1496
7892,7892,E45BFF8A7B42DBE312092B84982F68A3,11861,19,23,4,32,47,1647
7898,7898,3B597FC7FC5EC5DDABC4900E7F291292,11061,0,9,9,29,48,1498
7899,7899,3B597FC7FC5EC5DDABC4900E7F291292,11381,14,18,4,30,47,1547
7900,7900,3B597FC7FC5EC5DDABC4900E7F291292,11061,20,22,2,29,48,1498
7905,7905,65D4345A2D3576315A5C944F8DDA0CFE,42864,0,13,13,38,44,1944
7906,7906,65D4345A2D3576315A5C944F8DDA0CFE,11261,14,21,7,36,46,1846
7907,7907,65D4345A2D3576315A5C944F8DDA0CFE,42864,21,23,2,38,44,1944
7908,7908,B9E52D07F5AA84B0FEC3B2146C780B6A,11231,0,16,16,37,49,1899
7909,7909,B9E52D07F5AA84B0FEC3B2146C780B6A,10121,16,18,2,36,49,1849
7910,7910,B9E52D07F5AA84B0FEC3B2146C780B6A,11231,18,23,5,37,49,1899
7911,7911,B32952569BD11113AE8B69EB8DFA8258,42231,3,9,6,37,46,1896
7912,7912,B32952569BD11113AE8B69EB8DFA8258,42351,10,12,2,38,45,1945
7913,7913,B32952569BD11113AE8B69EB8DFA8258,42231,13,15,2,37,46,1896
7914,7914,B32952569BD11113AE8B69EB8DFA8258,42351,16,18,2,38,45,1945
7926,7926,36E4D456967ADF7C503C23EAE8460AAD,42523,9,17,8,31,47,1597
7927,7927,36E4D456967ADF7C503C23EAE8460AAD,13651,17,18,1,30,47,1547
7928,7928,36E4D456967ADF7C503C23EAE8460AAD,42523,19,23,4,31,47,1597
7929,7929,618896F224A0529F89C7C4458771EBFC,42151,0,4,4,35,45,1795
7930,7930,618896F224A0529F89C7C4458771EBFC,42371,6,7,1,34,46,1746
7931,7931,618896F224A0529F89C7C4458771EBFC,13121,9,17,8,38,46,1946
7932,7932,618896F224A0529F89C7C4458771EBFC,11261,19,21,2,36,46,1846
7946,7946,6460FC216A34C188FE4998AEEFF35C56,12521,9,14,5,35,41,1791
7947,7947,6460FC216A34C188FE4998AEEFF35C56,43451,15,18,3,37,40,1890
7948,7948,6460FC216A34C188FE4998AEEFF35C56,12521,19,21,2,35,41,1791
7954,7954,ACD7D06D699A88B2E7BB7970CE635C80,11381,3,6,3,30,47,1547
7955,7955,ACD7D06D699A88B2E7BB7970CE635C80,42521,6,7,1,31,47,1597
7956,7956,ACD7D06D699A88B2E7BB7970CE635C80,11381,7,22,15,30,47,1547
7957,7957,B4384B03AA2ADCFD4B5B44E462DB395A,43761,2,12,10,32,47,1647
7958,7958,B4384B03AA2ADCFD4B5B44E462DB395A,42523,14,16,2,31,47,1597
7959,7959,B4384B03AA2ADCFD4B5B44E462DB395A,43761,17,22,5,32,47,1647
7988,7988,F86245840859ECAC4FECC44520BE08E0,42031,0,18,18,40,46,2046
7989,7989,F86245840859ECAC4FECC44520BE08E0,13221,19,20,1,40,47,2047
7990,7990,F86245840859ECAC4FECC44520BE08E0,42031,21,23,2,40,46,2046
8007,8007,24CACF86A8CD21A17E28510F56598929,11021,0,14,14,36,49,1849
8008,8008,24CACF86A8CD21A17E28510F56598929,40073,14,17,3,37,48,1898
8009,8009,24CACF86A8CD21A17E28510F56598929,11021,18,23,5,36,49,1849
8043,8043,E06FC86426E546DF6B8D146F4C749C15,11861,0,8,8,32,47,1647
8044,8044,E06FC86426E546DF6B8D146F4C749C15,42523,8,10,2,31,47,1597
8045,8045,E06FC86426E546DF6B8D146F4C749C15,11861,11,23,12,32,47,1647
8046,8046,696A9A59A99FC4046807849DE62A1492,10491,0,7,7,33,48,1698
8047,8047,696A9A59A99FC4046807849DE62A1492,10221,10,17,7,34,49,1749
8048,8048,696A9A59A99FC4046807849DE62A1492,10491,17,18,1,33,48,1698
8049,8049,696A9A59A99FC4046807849DE62A1492,10221,19,22,3,34,49,1749
8080,8080,4C6EBE1C4B2FAAFACD17B57BF7692986,10531,0,2,2,34,46,1746
8081,8081,4C6EBE1C4B2FAAFACD17B57BF7692986,43731,3,8,5,34,47,1747
8082,8082,4C6EBE1C4B2FAAFACD17B57BF7692986,10531,12,19,7,34,46,1746
8083,8083,4C6EBE1C4B2FAAFACD17B57BF7692986,43731,22,23,1,34,47,1747
8084,8084,68A24D68E1EE6F85D7484BA18462FF82,12971,0,15,15,32,48,1648
8085,8085,68A24D68E1EE6F85D7484BA18462FF82,42523,17,18,1,31,47,1597
8086,8086,68A24D68E1EE6F85D7484BA18462FF82,13651,20,21,1,30,47,1547
8087,8087,68A24D68E1EE6F85D7484BA18462FF82,42523,21,23,2,31,47,1597
8100,8100,5C131EF968E57EC59474A18DB0FA22A2,11211,0,7,7,34,49,1749
8101,8101,5C131EF968E57EC59474A18DB0FA22A2,11541,7,14,7,35,49,1799
8102,8102,5C131EF968E57EC59474A18DB0FA22A2,43311,17,23,6,31,48,1598
8103,8103,2898255842570985047C3D77FE88DD08,11541,0,12,12,35,49,1799
8104,8104,2898255842570985047C3D77FE88DD08,11021,15,16,1,36,49,1849
8105,8105,2898255842570985047C3D77FE88DD08,11541,20,23,3,35,49,1799
8106,8106,CB579DD97897DF1DB10CC5796044D08A,42871,2,5,3,30,45,1545
8107,8107,CB579DD97897DF1DB10CC5796044D08A,12311,5,20,15,30,44,1544
8108,8108,CB579DD97897DF1DB10CC5796044D08A,10301,20,23,3,31,45,1595
8109,8109,8C7DCF60D5A91C4294A8C14ABFA5CFBF,42581,1,5,4,38,48,1948
8110,8110,8C7DCF60D5A91C4294A8C14ABFA5CFBF,11271,7,18,11,37,48,1898
8111,8111,8C7DCF60D5A91C4294A8C14ABFA5CFBF,40171,20,21,1,38,48,1948
8112,8112,34B0487DA91675A6216B605C367EE35D,11061,0,1,1,29,48,1498
8113,8113,34B0487DA91675A6216B605C367EE35D,11151,4,5,1,30,48,1548
8114,8114,34B0487DA91675A6216B605C367EE35D,43311,9,11,2,31,48,1598
8115,8115,34B0487DA91675A6216B605C367EE35D,11061,12,20,8,29,48,1498
8121,8121,9E74C4204DF0368A301BB287E42AE5CC,13371,1,6,5,41,47,2097
8122,8122,9E74C4204DF0368A301BB287E42AE5CC,10231,10,17,7,39,49,1999
8123,8123,9E74C4204DF0368A301BB287E42AE5CC,13371,18,23,5,41,47,2097
8138,8138,61CD021E6A7838BDB314063DA6F5F60D,42291,0,10,10,29,48,1498
8139,8139,61CD021E6A7838BDB314063DA6F5F60D,10381,10,16,6,31,49,1599
8140,8140,61CD021E6A7838BDB314063DA6F5F60D,11381,18,21,3,30,47,1547
8141,8141,1F6BCFEB56D245CBF5160F742055C8A2,11151,3,6,3,30,48,1548
8142,8142,1F6BCFEB56D245CBF5160F742055C8A2,11061,7,10,3,29,48,1498
8143,8143,1F6BCFEB56D245CBF5160F742055C8A2,11151,10,11,1,30,48,1548
8144,8144,1F6BCFEB56D245CBF5160F742055C8A2,11061,17,20,3,29,48,1498
8152,8152,F301F28E060FD662C38A084F1AEDCE9B,12121,0,8,8,29,47,1497
8153,8153,F301F28E060FD662C38A084F1AEDCE9B,11381,9,11,2,30,47,1547
8154,8154,F301F28E060FD662C38A084F1AEDCE9B,12121,12,14,2,29,47,1497
8155,8155,F301F28E060FD662C38A084F1AEDCE9B,11061,18,21,3,29,48,1498
8162,8162,41BEA9D7D7C433E67F41ED8F3F4B85D2,11074,7,15,8,37,47,1897
8163,8163,41BEA9D7D7C433E67F41ED8F3F4B85D2,11331,16,17,1,37,48,1898
8164,8164,41BEA9D7D7C433E67F41ED8F3F4B85D2,11074,17,20,3,37,47,1897
8165,8165,A3A77D2599A2BF9F99F7B68059141180,12221,0,8,8,43,44,2194
8166,8166,A3A77D2599A2BF9F99F7B68059141180,12211,12,17,5,41,44,2094
8167,8167,A3A77D2599A2BF9F99F7B68059141180,12221,18,19,1,43,44,2194
8168,8168,A3A77D2599A2BF9F99F7B68059141180,12211,19,21,2,41,44,2094
8177,8177,87379335B9F8B40032BE74AE6A224DE6,10107,9,10,1,38,49,1949
8178,8178,87379335B9F8B40032BE74AE6A224DE6,11231,11,15,4,37,49,1899
8179,8179,87379335B9F8B40032BE74AE6A224DE6,11794,15,18,3,38,49,1949
8180,8180,87379335B9F8B40032BE74AE6A224DE6,11231,18,21,3,37,49,1899
8184,8184,1030D8F4FE8CF10A7F5B83AE8CE6624F,42401,0,16,16,36,47,1847
8185,8185,1030D8F4FE8CF10A7F5B83AE8CE6624F,10111,18,20,2,37,47,1897
8186,8186,1030D8F4FE8CF10A7F5B83AE8CE6624F,11331,20,21,1,37,48,1898
8187,8187,1030D8F4FE8CF10A7F5B83AE8CE6624F,42401,22,23,1,36,47,1847
8202,8202,D60AFBB5753ACF5E9088CA162DADDBC2,42861,1,8,7,37,44,1894
8203,8203,D60AFBB5753ACF5E9088CA162DADDBC2,11261,12,20,8,36,46,1846
8204,8204,D60AFBB5753ACF5E9088CA162DADDBC2,13711,21,23,2,38,46,1946
8231,8231,F8C1432856D9260FBF1DC6D3982A96BB,10111,0,5,5,37,47,1897
8232,8232,F8C1432856D9260FBF1DC6D3982A96BB,42301,5,10,5,36,47,1847
8233,8233,F8C1432856D9260FBF1DC6D3982A96BB,10111,11,22,11,37,47,1897
8237,8237,4FF00BF3407B9A1F2FB89B661DFCF590,10111,0,8,8,37,47,1897
8238,8238,4FF00BF3407B9A1F2FB89B661DFCF590,40951,12,13,1,36,49,1849
8239,8239,4FF00BF3407B9A1F2FB89B661DFCF590,13561,14,17,3,37,49,1899
8240,8240,4FF00BF3407B9A1F2FB89B661DFCF590,12841,19,23,4,37,47,1897
8252,8252,292C54710FB21A50B273EFB2F0804791,42623,4,7,3,22,49,1149
8253,8253,292C54710FB21A50B273EFB2F0804791,40341,8,12,4,23,49,1199
8254,8254,292C54710FB21A50B273EFB2F0804791,42623,17,23,6,22,49,1149
8255,8255,1C346B8F39A0224A8EDBA10AEC88A4FF,10471,0,16,16,37,48,1898
8256,8256,1C346B8F39A0224A8EDBA10AEC88A4FF,12401,16,19,3,39,49,1999
8257,8257,1C346B8F39A0224A8EDBA10AEC88A4FF,10471,20,23,3,37,48,1898
8263,8263,04F832571F2FA91E6613526630C6992E,10471,0,10,10,37,48,1898
8264,8264,04F832571F2FA91E6613526630C6992E,40951,11,12,1,36,49,1849
8265,8265,04F832571F2FA91E6613526630C6992E,10471,12,23,11,37,48,1898
8269,8269,1F09C23C59213E0540595711EB92591F,10111,10,13,3,37,47,1897
8270,8270,1F09C23C59213E0540595711EB92591F,42161,13,14,1,36,47,1847
8271,8271,1F09C23C59213E0540595711EB92591F,10111,19,20,1,37,47,1897
8272,8272,1F09C23C59213E0540595711EB92591F,42161,21,22,1,36,47,1847
8273,8273,2FC852B4FFDF067DECF04814ED84AACA,42511,0,10,10,37,47,1897
8274,8274,2FC852B4FFDF067DECF04814ED84AACA,10271,14,16,2,37,46,1896
8275,8275,2FC852B4FFDF067DECF04814ED84AACA,42511,19,22,3,37,47,1897
8281,8281,F8EA0C68F3C8266C3E7BA4F2FCE6F8BC,19441,0,14,14,8,46,446
8282,8282,F8EA0C68F3C8266C3E7BA4F2FCE6F8BC,42041,15,16,1,10,47,547
8283,8283,F8EA0C68F3C8266C3E7BA4F2FCE6F8BC,19441,18,23,5,8,46,446
8284,8284,3DA0BCC83518894F0CE5D638362ECC1B,43731,0,18,18,34,47,1747
8285,8285,3DA0BCC83518894F0CE5D638362ECC1B,10971,20,21,1,35,47,1797
8286,8286,3DA0BCC83518894F0CE5D638362ECC1B,43731,21,23,2,34,47,1747
8287,8287,C75781F60799DE2652DF86EC8BB9A296,42401,4,5,1,36,47,1847
8288,8288,C75781F60799DE2652DF86EC8BB9A296,10111,7,11,4,37,47,1897
8289,8289,C75781F60799DE2652DF86EC8BB9A296,42401,14,21,7,36,47,1847
8290,8290,1E80787B69718C7476B2A0E1C06850FD,42161,0,17,17,36,47,1847
8291,8291,1E80787B69718C7476B2A0E1C06850FD,11074,17,18,1,37,47,1897
8292,8292,1E80787B69718C7476B2A0E1C06850FD,42301,18,23,5,36,47,1847
8293,8293,E70BC232E8B1A5A1F2185A70B4D8F157,12083,0,9,9,36,49,1849
8294,8294,E70BC232E8B1A5A1F2185A70B4D8F157,10841,9,10,1,37,47,1897
8295,8295,E70BC232E8B1A5A1F2185A70B4D8F157,40242,14,19,5,36,49,1849
8296,8296,E70BC232E8B1A5A1F2185A70B4D8F157,10251,21,22,1,35,47,1797
8310,8310,3C5BF8354C7B22C00BFA5438C070BC0F,13711,0,10,10,38,46,1946
8311,8311,3C5BF8354C7B22C00BFA5438C070BC0F,43241,10,12,2,36,46,1846
8312,8312,3C5BF8354C7B22C00BFA5438C070BC0F,13711,12,17,5,38,46,1946
8313,8313,3C5BF8354C7B22C00BFA5438C070BC0F,10271,20,21,1,37,46,1896
8314,8314,9C296E00685C67F2E51639B04AC3C641,11491,0,8,8,36,47,1847
8315,8315,9C296E00685C67F2E51639B04AC3C641,12021,12,13,1,37,49,1899
8316,8316,9C296E00685C67F2E51639B04AC3C641,11491,19,23,4,36,47,1847
8317,8317,12E01B69FD8D8861D07F22563B5D772F,10491,0,10,10,33,48,1698
8318,8318,12E01B69FD8D8861D07F22563B5D772F,11751,14,15,1,35,48,1798
8319,8319,12E01B69FD8D8861D07F22563B5D772F,40951,15,20,5,36,49,1849
8320,8320,12E01B69FD8D8861D07F22563B5D772F,11751,20,22,2,35,48,1798
8321,8321,57FE556E4AD0A97ED79E805A0557CF4C,43761,0,14,14,32,47,1647
8322,8322,57FE556E4AD0A97ED79E805A0557CF4C,10281,14,18,4,33,48,1698
8323,8323,57FE556E4AD0A97ED79E805A0557CF4C,43761,19,23,4,32,47,1647
8340,8340,DF024120283FDE8016AF9FC23AD5DBDA,40961,1,13,12,35,47,1797
8341,8341,DF024120283FDE8016AF9FC23AD5DBDA,11491,14,15,1,36,47,1847
8342,8342,DF024120283FDE8016AF9FC23AD5DBDA,43161,16,18,2,35,47,1797
8343,8343,F031FD2F854EE78DC74B73079D5A136F,12121,0,13,13,29,47,1497
8344,8344,F031FD2F854EE78DC74B73079D5A136F,11061,17,18,1,29,48,1498
8345,8345,F031FD2F854EE78DC74B73079D5A136F,11381,19,20,1,30,47,1547
8346,8346,186BCCF3E4C291B31BC4BB9662DF9417,42141,0,5,5,32,47,1647
8347,8347,186BCCF3E4C291B31BC4BB9662DF9417,42523,6,7,1,31,47,1597
8348,8348,186BCCF3E4C291B31BC4BB9662DF9417,43761,7,19,12,32,47,1647
8349,8349,09F64A9A641B3F2B92615DE97B925264,10351,9,10,1,28,45,1445
8350,8350,09F64A9A641B3F2B92615DE97B925264,10634,11,13,2,27,45,1395
8351,8351,09F64A9A641B3F2B92615DE97B925264,10351,13,22,9,28,45,1445
8352,8352,E941171791F32E7DC6FDB1B33BA8525C,11021,0,13,13,36,49,1849
8353,8353,E941171791F32E7DC6FDB1B33BA8525C,42471,13,14,1,35,49,1799
8354,8354,E941171791F32E7DC6FDB1B33BA8525C,11021,15,23,8,36,49,1849
8359,8359,EDBEDCDD3729803D79956D4495DD48D8,11261,5,6,1,36,46,1846
8360,8360,EDBEDCDD3729803D79956D4495DD48D8,42864,9,17,8,38,44,1944
8361,8361,EDBEDCDD3729803D79956D4495DD48D8,11261,19,21,2,36,46,1846
8378,8378,EF9C99EE076D9702EF73224BC1A91C21,43621,0,8,8,46,48,2348
8379,8379,EF9C99EE076D9702EF73224BC1A91C21,42601,13,15,2,44,48,2248
8380,8380,EF9C99EE076D9702EF73224BC1A91C21,43621,18,23,5,46,48,2348
8381,8381,6B8DE8A3608C0DB250B3BFEEF5771B47,11061,0,11,11,29,48,1498
8382,8382,6B8DE8A3608C0DB250B3BFEEF5771B47,11381,11,13,2,30,47,1547
8383,8383,6B8DE8A3608C0DB250B3BFEEF5771B47,11061,15,16,1,29,48,1498
8384,8384,6B8DE8A3608C0DB250B3BFEEF5771B47,11381,18,22,4,30,47,1547
8399,8399,0AC4FBF50E87AA3C104AFFBF99DA4D60,10531,0,10,10,34,46,1746
8400,8400,0AC4FBF50E87AA3C104AFFBF99DA4D60,13711,12,13,1,38,46,1946
8401,8401,0AC4FBF50E87AA3C104AFFBF99DA4D60,42231,17,18,1,37,46,1896
8402,8402,0AC4FBF50E87AA3C104AFFBF99DA4D60,10531,19,23,4,34,46,1746
8422,8422,DEE5888BD7E461DD868275DE6FB19D26,10921,0,13,13,43,48,2198
8423,8423,DEE5888BD7E461DD868275DE6FB19D26,42201,13,15,2,43,46,2196
8424,8424,DEE5888BD7E461DD868275DE6FB19D26,10921,18,23,5,43,48,2198
8441,8441,377BD5B9C037AF000CC29F45169CD1E4,11231,0,9,9,37,49,1899
8442,8442,377BD5B9C037AF000CC29F45169CD1E4,11201,11,19,8,35,49,1799
8443,8443,377BD5B9C037AF000CC29F45169CD1E4,11231,19,23,4,37,49,1899
8448,8448,EA6B8CBE634579C9093B157538F58AA2,42021,7,9,2,33,47,1697
8449,8449,EA6B8CBE634579C9093B157538F58AA2,43761,11,12,1,32,47,1647
8450,8450,EA6B8CBE634579C9093B157538F58AA2,42021,12,22,10,33,47,1697
8451,8451,EA6B8CBE634579C9093B157538F58AA2,43761,22,23,1,32,47,1647
8452,8452,C1896697E8F9082F3C179E6CB902F84B,49181,0,2,2,21,31,1081
8453,8453,C1896697E8F9082F3C179E6CB902F84B,13141,2,5,3,23,30,1180
8454,8454,C1896697E8F9082F3C179E6CB902F84B,49181,6,20,14,21,31,1081
8458,8458,36B9A094E8D22C518990766A8F925428,19901,0,4,4,7,44,394
8459,8459,36B9A094E8D22C518990766A8F925428,19621,9,21,12,5,46,296
8460,8460,36B9A094E8D22C518990766A8F925428,12641,21,22,1,10,43,543
8464,8464,B53C313F28E9C152305715765AEEF04B,42151,0,7,7,35,45,1795
8465,8465,B53C313F28E9C152305715765AEEF04B,42861,8,12,4,37,44,1894
8466,8466,B53C313F28E9C152305715765AEEF04B,42151,15,18,3,35,45,1795
8467,8467,BE3AECD016F8A1FBFAF949C87F9A7762,42041,1,2,1,10,47,547
8468,8468,BE3AECD016F8A1FBFAF949C87F9A7762,19441,2,3,1,8,46,446
8469,8469,BE3AECD016F8A1FBFAF949C87F9A7762,42041,4,21,17,10,47,547
8482,8482,F209A399D7060EB5C592C672B5567F86,12921,3,14,11,9,41,491
8483,8483,F209A399D7060EB5C592C672B5567F86,12641,18,19,1,10,43,543
8484,8484,F209A399D7060EB5C592C672B5567F86,12921,20,21,1,9,41,491
8500,8500,AE82EBF6DD7C64D947348E1A85E8443E,11811,1,6,5,38,49,1949
8501,8501,AE82EBF6DD7C64D947348E1A85E8443E,11074,17,20,3,37,47,1897
8502,8502,AE82EBF6DD7C64D947348E1A85E8443E,11461,21,22,1,37,49,1899
8564,8564,AFF2B1944207762129EB0E25C3502ADB,11941,0,10,10,37,46,1896
8565,8565,AFF2B1944207762129EB0E25C3502ADB,13711,11,12,1,38,46,1946
8566,8566,AFF2B1944207762129EB0E25C3502ADB,11941,14,20,6,37,46,1896
8567,8567,AFF2B1944207762129EB0E25C3502ADB,13711,20,22,2,38,46,1946
8568,8568,895085FE0B62D7BCDF8725B5DB48E546,43971,0,6,6,30,48,1548
8569,8569,895085FE0B62D7BCDF8725B5DB48E546,11061,6,15,9,29,48,1498
8570,8570,895085FE0B62D7BCDF8725B5DB48E546,43971,16,23,7,30,48,1548
8577,8577,E41EFAEAC6CC7189E20FB98542ADB1CF,13101,0,14,14,40,47,2047
8578,8578,E41EFAEAC6CC7189E20FB98542ADB1CF,13271,14,16,2,41,47,2097
8579,8579,E41EFAEAC6CC7189E20FB98542ADB1CF,11801,19,20,1,42,48,2148
8580,8580,6FFBA4022D4D56F7F7F886454DFAC04B,11231,0,17,17,37,49,1899
8581,8581,6FFBA4022D4D56F7F7F886454DFAC04B,11541,18,20,2,35,49,1799
8582,8582,6FFBA4022D4D56F7F7F886454DFAC04B,11021,21,23,2,36,49,1849
8586,8586,2D7ACF8AD7E4B49F2A7FD23DB75DC6F1,42971,0,6,6,43,49,2199
8587,8587,2D7ACF8AD7E4B49F2A7FD23DB75DC6F1,11741,16,18,2,42,49,2149
8588,8588,2D7ACF8AD7E4B49F2A7FD23DB75DC6F1,42341,21,23,2,43,49,2199
8589,8589,A3BFED7EBC8273A150663075EB9361B2,12391,7,8,1,36,49,1849
8590,8590,A3BFED7EBC8273A150663075EB9361B2,40181,10,11,1,37,49,1899
8591,8591,A3BFED7EBC8273A150663075EB9361B2,11921,14,22,8,38,48,1948
8596,8596,E733E2BCFA57BF507E7D4380A7C2C282,42221,0,6,6,38,48,1948
8597,8597,E733E2BCFA57BF507E7D4380A7C2C282,12514,7,8,1,38,47,1947
8598,8598,E733E2BCFA57BF507E7D4380A7C2C282,10841,11,22,11,37,47,1897
8599,8599,9FC853D14B199D9AE09B3905110E90BD,12514,0,7,7,38,47,1947
8600,8600,9FC853D14B199D9AE09B3905110E90BD,42221,8,11,3,38,48,1948
8601,8601,9FC853D14B199D9AE09B3905110E90BD,12514,12,23,11,38,47,1947
8602,8602,2AD1CEE5B0B23E5C1879F637B5FB2BCE,40445,1,6,5,30,48,1548
8603,8603,2AD1CEE5B0B23E5C1879F637B5FB2BCE,11061,11,13,2,29,48,1498
8604,8604,2AD1CEE5B0B23E5C1879F637B5FB2BCE,40445,13,22,9,30,48,1548
8605,8605,8DE15D34A0DAE0CE5FABCABC75057336,10491,0,11,11,33,48,1698
8606,8606,8DE15D34A0DAE0CE5FABCABC75057336,42161,13,14,1,36,47,1847
8607,8607,8DE15D34A0DAE0CE5FABCABC75057336,10491,16,22,6,33,48,1698
8608,8608,C13EDA65C3B019881628338CF4BA6FEF,42491,0,8,8,32,46,1646
8609,8609,C13EDA65C3B019881628338CF4BA6FEF,42523,8,10,2,31,47,1597
8610,8610,C13EDA65C3B019881628338CF4BA6FEF,42491,13,14,1,32,46,1646
8611,8611,C13EDA65C3B019881628338CF4BA6FEF,10341,14,21,7,31,47,1597
8624,8624,85A9063F7506C2E51076A4190DDE5AA8,11261,7,13,6,36,46,1846
8625,8625,85A9063F7506C2E51076A4190DDE5AA8,42351,13,14,1,38,45,1945
8626,8626,85A9063F7506C2E51076A4190DDE5AA8,11261,16,22,6,36,46,1846
8627,8627,EFD3CD287097CC7EB227645070325EE5,42491,1,8,7,32,46,1646
8628,8628,EFD3CD287097CC7EB227645070325EE5,42523,9,19,10,31,47,1597
8629,8629,EFD3CD287097CC7EB227645070325EE5,13651,19,21,2,30,47,1547
8633,8633,A0E829F4319BFCF37BA7414AFCB09FF1,11074,0,2,2,37,47,1897
8634,8634,A0E829F4319BFCF37BA7414AFCB09FF1,42221,2,12,10,38,48,1948
8635,8635,A0E829F4319BFCF37BA7414AFCB09FF1,11074,14,22,8,37,47,1897
8640,8640,700A8469B8648E235281334EF5CC8DA1,10371,0,10,10,37,49,1899
8641,8641,700A8469B8648E235281334EF5CC8DA1,10471,10,11,1,37,48,1898
8642,8642,700A8469B8648E235281334EF5CC8DA1,10371,12,23,11,37,49,1899
8643,8643,2F3FBE39EE4E3AB748593134D6A2A772,42231,0,8,8,37,46,1896
8644,8644,2F3FBE39EE4E3AB748593134D6A2A772,42351,9,11,2,38,45,1945
8645,8645,2F3FBE39EE4E3AB748593134D6A2A772,42231,12,23,11,37,46,1896
8646,8646,E1B8B389FB89A6FD4C4FFE9BDF0E0F7E,11381,0,9,9,30,47,1547
8647,8647,E1B8B389FB89A6FD4C4FFE9BDF0E0F7E,10951,13,17,4,29,48,1498
8648,8648,E1B8B389FB89A6FD4C4FFE9BDF0E0F7E,11381,18,22,4,30,47,1547
8665,8665,5B9E09F094541824399F39AB61F4C681,11381,0,7,7,30,47,1547
8666,8666,5B9E09F094541824399F39AB61F4C681,11861,7,15,8,32,47,1647
8667,8667,5B9E09F094541824399F39AB61F4C681,10951,15,17,2,29,48,1498
8668,8668,5B9E09F094541824399F39AB61F4C681,42521,19,20,1,31,47,1597
8669,8669,E835E54D31E2053FF59F5E3D61ABCD72,11151,0,7,7,30,48,1548
8670,8670,E835E54D31E2053FF59F5E3D61ABCD72,10544,8,10,2,28,48,1448
8671,8671,E835E54D31E2053FF59F5E3D61ABCD72,11151,11,22,11,30,48,1548
8678,8678,13BC89BF4CB2126BDBED6033269CBB6A,12641,0,3,3,10,43,543
8679,8679,13BC89BF4CB2126BDBED6033269CBB6A,19021,3,5,2,10,45,545
8680,8680,13BC89BF4CB2126BDBED6033269CBB6A,12921,6,10,4,9,41,491
8681,8681,13BC89BF4CB2126BDBED6033269CBB6A,12641,13,23,10,10,43,543
8682,8682,0CA0351BEE42A6C50E3C657DDA4ED8A9,11021,0,3,3,36,49,1849
8683,8683,0CA0351BEE42A6C50E3C657DDA4ED8A9,11271,3,6,3,37,48,1898
8684,8684,0CA0351BEE42A6C50E3C657DDA4ED8A9,10221,9,18,9,34,49,1749
8685,8685,0CA0351BEE42A6C50E3C657DDA4ED8A9,12391,19,23,4,36,49,1849
8696,8696,7598D32DC332293D35F2F6ACB7EBDD15,10251,0,14,14,35,47,1797
8697,8697,7598D32DC332293D35F2F6ACB7EBDD15,10901,14,16,2,35,48,1798
8698,8698,7598D32DC332293D35F2F6ACB7EBDD15,42161,17,22,5,36,47,1847
8732,8732,1CE5F4D10EE2FB173CB9F2BC0746661A,42531,0,1,1,31,45,1595
8733,8733,1CE5F4D10EE2FB173CB9F2BC0746661A,12311,1,6,5,30,44,1544
8734,8734,1CE5F4D10EE2FB173CB9F2BC0746661A,42531,6,12,6,31,45,1595
8735,8735,1CE5F4D10EE2FB173CB9F2BC0746661A,12311,13,21,8,30,44,1544
8739,8739,A2939A88D49E89644FEBA8B1C0E8B435,42941,0,6,6,37,47,1897
8740,8740,A2939A88D49E89644FEBA8B1C0E8B435,42161,8,18,10,36,47,1847
8741,8741,A2939A88D49E89644FEBA8B1C0E8B435,10251,18,22,4,35,47,1797
8742,8742,CD55B44A3FD4B718A673CC03711FD344,12921,1,10,9,9,41,491
8743,8743,CD55B44A3FD4B718A673CC03711FD344,12641,12,15,3,10,43,543
8744,8744,CD55B44A3FD4B718A673CC03711FD344,12921,17,21,4,9,41,491
8749,8749,B2776B9BEABD3ABCB638E17CEC766404,42521,0,14,14,31,47,1597
8750,8750,B2776B9BEABD3ABCB638E17CEC766404,12121,16,18,2,29,47,1497
8751,8751,B2776B9BEABD3ABCB638E17CEC766404,42521,20,22,2,31,47,1597
8752,8752,D3E46B15B35DC3C198E6EE945D227259,11806,4,5,1,41,48,2098
8753,8753,D3E46B15B35DC3C198E6EE945D227259,42271,6,21,15,40,47,2047
8754,8754,D3E46B15B35DC3C198E6EE945D227259,13381,21,23,2,39,47,1997
8770,8770,394B81CC36B31D897120A6153D7C1457,12121,10,11,1,29,47,1497
8771,8771,394B81CC36B31D897120A6153D7C1457,42501,11,16,5,28,47,1447
8772,8772,394B81CC36B31D897120A6153D7C1457,11061,17,20,3,29,48,1498
8773,8773,C852CB2CA270AB3595E954B93C5AFE90,10111,0,10,10,37,47,1897
8774,8774,C852CB2CA270AB3595E954B93C5AFE90,11331,12,20,8,37,48,1898
8775,8775,C852CB2CA270AB3595E954B93C5AFE90,42161,21,22,1,36,47,1847
8776,8776,E1FEFC73B10470789CF2DE3A27A0EAB7,42961,0,8,8,35,49,1799
8777,8777,E1FEFC73B10470789CF2DE3A27A0EAB7,40951,12,14,2,36,49,1849
8778,8778,E1FEFC73B10470789CF2DE3A27A0EAB7,42961,17,19,2,35,49,1799
8782,8782,354BD264A9E3427AF445BDA947BFDA83,11771,8,14,6,39,49,1999
8783,8783,354BD264A9E3427AF445BDA947BFDA83,10191,16,17,1,40,48,2048
8784,8784,354BD264A9E3427AF445BDA947BFDA83,11771,17,20,3,39,49,1999
8785,8785,BA285F01E6926591864F1F3184565800,42581,5,8,3,38,48,1948
8786,8786,BA285F01E6926591864F1F3184565800,10107,12,15,3,38,49,1949
8787,8787,BA285F01E6926591864F1F3184565800,42581,18,20,2,38,48,1948
8788,8788,BA285F01E6926591864F1F3184565800,11914,20,21,1,37,48,1898
8789,8789,F0325CEF852754DCE2C27B3EFD10E96B,12221,1,4,3,43,44,2194
8790,8790,F0325CEF852754DCE2C27B3EFD10E96B,42631,4,9,5,43,45,2195
8791,8791,F0325CEF852754DCE2C27B3EFD10E96B,13341,12,18,6,44,45,2245
8792,8792,F0325CEF852754DCE2C27B3EFD10E96B,43061,19,20,1,43,46,2196
8803,8803,70E50AA138C0538910E5623295B506D8,42151,4,5,1,35,45,1795
8804,8804,70E50AA138C0538910E5623295B506D8,11261,9,11,2,36,46,1846
8805,8805,70E50AA138C0538910E5623295B506D8,42351,16,20,4,38,45,1945
8806,8806,F44F236AAC6ECBC643A7E2993D2952C9,12083,0,14,14,36,49,1849
8807,8807,F44F236AAC6ECBC643A7E2993D2952C9,11541,14,17,3,35,49,1799
8808,8808,F44F236AAC6ECBC643A7E2993D2952C9,12083,22,23,1,36,49,1849
8832,8832,C9D18F84DE09060EAAE7ED1445E46CDD,11021,5,6,1,36,49,1849
8833,8833,C9D18F84DE09060EAAE7ED1445E46CDD,13731,16,17,1,33,49,1699
8834,8834,C9D18F84DE09060EAAE7ED1445E46CDD,11021,18,19,1,36,49,1849
8835,8835,12C9531EEC0658A07CF1E8CD6DB0C2CF,42941,2,5,3,37,47,1897
8836,8836,12C9531EEC0658A07CF1E8CD6DB0C2CF,11081,9,11,2,35,46,1796
8837,8837,12C9531EEC0658A07CF1E8CD6DB0C2CF,10731,13,23,10,33,47,1697
8849,8849,D8063B7C8CAA23F18B002D2A443A5135,43101,2,8,6,46,40,2340
8850,8850,D8063B7C8CAA23F18B002D2A443A5135,43951,8,10,2,49,41,2491
8851,8851,D8063B7C8CAA23F18B002D2A443A5135,43101,14,22,8,46,40,2340
8876,8876,7F683BD350227B09C7ECC1328A0C4739,13711,0,6,6,38,46,1946
8877,8877,7F683BD350227B09C7ECC1328A0C4739,42011,9,14,5,36,46,1846
8878,8878,7F683BD350227B09C7ECC1328A0C4739,13121,17,18,1,38,46,1946
8879,8879,7F683BD350227B09C7ECC1328A0C4739,42011,19,23,4,36,46,1846
8884,8884,5C7F8A03755C44742187CEE0EDAF92C8,11571,1,6,5,13,46,696
8885,8885,5C7F8A03755C44742187CEE0EDAF92C8,19021,8,9,1,10,45,545
8886,8886,5C7F8A03755C44742187CEE0EDAF92C8,11571,11,23,12,13,46,696
8892,8892,DDF363C64B8F6ACF3450F0B1AA087EA1,19441,0,4,4,8,46,446
8893,8893,DDF363C64B8F6ACF3450F0B1AA087EA1,19621,5,6,1,5,46,296
8894,8894,DDF363C64B8F6ACF3450F0B1AA087EA1,19441,7,21,14,8,46,446
8908,8908,9B8E3A84EF821A3E9564A6D6EAEA0FE5,11914,5,6,1,37,48,1898
8909,8909,9B8E3A84EF821A3E9564A6D6EAEA0FE5,42581,7,8,1,38,48,1948
8910,8910,9B8E3A84EF821A3E9564A6D6EAEA0FE5,11914,11,23,12,37,48,1898
8916,8916,E979F973CF39B14032128387DFAAB582,10251,0,10,10,35,47,1797
8917,8917,E979F973CF39B14032128387DFAAB582,10111,12,15,3,37,47,1897
8918,8918,E979F973CF39B14032128387DFAAB582,42401,18,23,5,36,47,1847
8924,8924,400659CE2E6F8BFF6D95D6F52F73DF5B,42921,0,5,5,33,47,1697
8925,8925,400659CE2E6F8BFF6D95D6F52F73DF5B,11861,5,18,13,32,47,1647
8926,8926,400659CE2E6F8BFF6D95D6F52F73DF5B,42921,18,23,5,33,47,1697
8933,8933,017E7601FB9C9C3C9E5F1FE87B4C9BCD,42231,1,11,10,37,46,1896
8934,8934,017E7601FB9C9C3C9E5F1FE87B4C9BCD,42351,12,13,1,38,45,1945
8935,8935,017E7601FB9C9C3C9E5F1FE87B4C9BCD,42231,16,17,1,37,46,1896
8936,8936,017E7601FB9C9C3C9E5F1FE87B4C9BCD,13911,20,21,1,39,46,1996
8940,8940,647D85F41DB91010F5EBA85FDA450BC1,13911,0,3,3,39,46,1996
8941,8941,647D85F41DB91010F5EBA85FDA450BC1,11261,7,17,10,36,46,1846
8942,8942,647D85F41DB91010F5EBA85FDA450BC1,13911,17,21,4,39,46,1996
8946,8946,49913D060F497A2E80EBAA132C3ADF88,10544,0,8,8,28,48,1448
8947,8947,49913D060F497A2E80EBAA132C3ADF88,11061,9,14,5,29,48,1498
8948,8948,49913D060F497A2E80EBAA132C3ADF88,10544,14,23,9,28,48,1448
8952,8952,5E8BB1A9FDE1AFD08848003FB8A60E0E,40673,0,13,13,36,48,1848
8953,8953,5E8BB1A9FDE1AFD08848003FB8A60E0E,10971,14,17,3,35,47,1797
8954,8954,5E8BB1A9FDE1AFD08848003FB8A60E0E,40673,18,23,5,36,48,1848
8955,8955,E4DC5BA4E90CD8A7BCCBC3E7AC2ABE5B,10691,0,6,6,33,48,1698
8956,8956,E4DC5BA4E90CD8A7BCCBC3E7AC2ABE5B,42021,8,15,7,33,47,1697
8957,8957,E4DC5BA4E90CD8A7BCCBC3E7AC2ABE5B,10431,15,16,1,33,49,1699
8958,8958,E4DC5BA4E90CD8A7BCCBC3E7AC2ABE5B,10691,20,23,3,33,48,1698
8971,8971,E68BA5F61F8B211BFB4BF381E08CC8FA,10841,5,10,5,37,47,1897
8972,8972,E68BA5F61F8B211BFB4BF381E08CC8FA,42301,14,18,4,36,47,1847
8973,8973,E68BA5F61F8B211BFB4BF381E08CC8FA,11074,19,21,2,37,47,1897
8989,8989,445A90121514A82FCCD431DD3088A581,43731,0,4,4,34,47,1747
8990,8990,445A90121514A82FCCD431DD3088A581,11861,9,18,9,32,47,1647
8991,8991,445A90121514A82FCCD431DD3088A581,40951,20,21,1,36,49,1849
8992,8992,445A90121514A82FCCD431DD3088A581,11861,22,23,1,32,47,1647
9023,9023,E21AB700E8BE04F896E7CA6BA8292DA0,13951,0,6,6,47,45,2395
9024,9024,E21AB700E8BE04F896E7CA6BA8292DA0,43051,11,13,2,46,45,2345
9025,9025,E21AB700E8BE04F896E7CA6BA8292DA0,42461,17,18,1,45,47,2297
9026,9026,E21AB700E8BE04F896E7CA6BA8292DA0,43051,19,23,4,46,45,2345
9027,9027,504467700DDD1C036193CD82D6D3619F,43761,7,12,5,32,47,1647
9028,9028,504467700DDD1C036193CD82D6D3619F,42521,12,22,10,31,47,1597
9029,9029,504467700DDD1C036193CD82D6D3619F,43761,22,23,1,32,47,1647
9033,9033,53173294ED5BF12AABAED82F9B761816,10161,0,13,13,35,49,1799
9034,9034,53173294ED5BF12AABAED82F9B761816,10731,17,19,2,33,47,1697
9035,9035,53173294ED5BF12AABAED82F9B761816,10161,22,23,1,35,49,1799
9043,9043,BB301AA472F946C16B8EF1B57802FA13,42141,2,12,10,32,47,1647
9044,9044,BB301AA472F946C16B8EF1B57802FA13,10281,14,16,2,33,48,1698
9045,9045,BB301AA472F946C16B8EF1B57802FA13,43761,16,20,4,32,47,1647
9046,9046,E7233A336FF6DC7015F36A96AF40FCB1,11941,0,15,15,37,46,1896
9047,9047,E7233A336FF6DC7015F36A96AF40FCB1,13711,16,17,1,38,46,1946
9048,9048,E7233A336FF6DC7015F36A96AF40FCB1,11941,18,23,5,37,46,1896
9049,9049,C12DD644AAA0C0B1CFC20CC5C965BD9B,12641,0,1,1,10,43,543
9050,9050,C12DD644AAA0C0B1CFC20CC5C965BD9B,19744,4,6,2,6,43,343
9051,9051,C12DD644AAA0C0B1CFC20CC5C965BD9B,12921,6,20,14,9,41,491
9052,9052,C12DD644AAA0C0B1CFC20CC5C965BD9B,12641,20,22,2,10,43,543
9053,9053,535378523E09141D94880FBA59BB7297,42301,0,1,1,36,47,1847
9054,9054,535378523E09141D94880FBA59BB7297,11331,3,6,3,37,48,1898
9055,9055,535378523E09141D94880FBA59BB7297,10111,8,11,3,37,47,1897
9056,9056,535378523E09141D94880FBA59BB7297,42301,11,23,12,36,47,1847
9077,9077,EC4330687AFAD23F392FAEF4FB4107B7,10781,0,8,8,35,47,1797
9078,9078,EC4330687AFAD23F392FAEF4FB4107B7,11331,12,14,2,37,48,1898
9079,9079,EC4330687AFAD23F392FAEF4FB4107B7,11541,19,20,1,35,49,1799
9080,9080,EC4330687AFAD23F392FAEF4FB4107B7,10781,21,22,1,35,47,1797
9081,9081,B11C90C30BACC34A74EC12A03A75D4DA,11261,7,13,6,36,46,1846
9082,9082,B11C90C30BACC34A74EC12A03A75D4DA,10331,14,16,2,39,46,1996
9083,9083,B11C90C30BACC34A74EC12A03A75D4DA,11261,17,19,2,36,46,1846
9084,9084,85A3472C760B288249587BF2433B560B,40123,3,9,6,38,47,1947
9085,9085,85A3472C760B288249587BF2433B560B,10841,11,15,4,37,47,1897
9086,9086,85A3472C760B288249587BF2433B560B,40123,17,18,1,38,47,1947
9087,9087,64EA873D359181A561255128009EB239,42581,2,6,4,38,48,1948
9088,9088,64EA873D359181A561255128009EB239,11914,6,10,4,37,48,1898
9089,9089,64EA873D359181A561255128009EB239,40171,14,23,9,38,48,1948
9090,9090,FCC81FB1D89F2E284C3312E5101F2149,42151,0,17,17,35,45,1795
9091,9091,FCC81FB1D89F2E284C3312E5101F2149,42861,20,21,1,37,44,1894
9092,9092,FCC81FB1D89F2E284C3312E5101F2149,42151,21,23,2,35,45,1795
9093,9093,5C96E9B05EB3EFE9DE3B43368A9F3BB9,42161,1,7,6,36,47,1847
9094,9094,5C96E9B05EB3EFE9DE3B43368A9F3BB9,12131,12,14,2,32,47,1647
9095,9095,5C96E9B05EB3EFE9DE3B43368A9F3BB9,42401,18,23,5,36,47,1847
9106,9106,A486521758A27268CCD3905C2122B6F8,11861,0,4,4,32,47,1647
9107,9107,A486521758A27268CCD3905C2122B6F8,10281,9,16,7,33,48,1698
9108,9108,A486521758A27268CCD3905C2122B6F8,11861,19,23,4,32,47,1647
9109,9109,6889E705B5CE1C782539658A206F3A4E,10971,9,16,7,35,47,1797
9110,9110,6889E705B5CE1C782539658A206F3A4E,43361,19,20,1,38,48,1948
9111,9111,6889E705B5CE1C782539658A206F3A4E,11231,21,23,2,37,49,1899
9127,9127,C70FF977FA3BD2286D57535D98EFE336,10111,1,11,10,37,47,1897
9128,9128,C70FF977FA3BD2286D57535D98EFE336,42161,15,16,1,36,47,1847
9129,9129,C70FF977FA3BD2286D57535D98EFE336,10251,18,21,3,35,47,1797
9130,9130,C70FF977FA3BD2286D57535D98EFE336,42161,21,23,2,36,47,1847
9131,9131,B0559EE5210193B113FE4887C51E2384,42301,0,10,10,36,47,1847
9132,9132,B0559EE5210193B113FE4887C51E2384,10111,11,12,1,37,47,1897
9133,9133,B0559EE5210193B113FE4887C51E2384,42301,14,16,2,36,47,1847
9134,9134,B0559EE5210193B113FE4887C51E2384,11074,17,21,4,37,47,1897
9143,9143,DB454EC736815F52D72FAFDE9B09A183,42351,1,6,5,38,45,1945
9144,9144,DB454EC736815F52D72FAFDE9B09A183,42231,9,10,1,37,46,1896
9145,9145,DB454EC736815F52D72FAFDE9B09A183,13911,13,19,6,39,46,1996
9146,9146,F6D5F0720A4C82E72FD0C591B5570DDC,11951,0,6,6,31,49,1599
9147,9147,F6D5F0720A4C82E72FD0C591B5570DDC,10431,10,15,5,33,49,1699
9148,9148,F6D5F0720A4C82E72FD0C591B5570DDC,11951,16,23,7,31,49,1599
9160,9160,08B8CB3410391A409AD6F561C9C850B1,42341,9,12,3,43,49,2199
9161,9161,08B8CB3410391A409AD6F561C9C850B1,11031,15,17,2,42,49,2149
9162,9162,08B8CB3410391A409AD6F561C9C850B1,42341,17,18,1,43,49,2199
9172,9172,232A65D7E72D31ED563D0041FCDF23A8,12491,0,7,7,36,43,1843
9173,9173,232A65D7E72D31ED563D0041FCDF23A8,42151,9,15,6,35,45,1795
9174,9174,232A65D7E72D31ED563D0041FCDF23A8,12491,17,21,4,36,43,1843
9175,9175,E24F34B965BE1054DCE4AF1C1CD48137,11861,0,14,14,32,47,1647
9176,9176,E24F34B965BE1054DCE4AF1C1CD48137,11875,14,17,3,30,46,1546
9177,9177,E24F34B965BE1054DCE4AF1C1CD48137,11861,18,23,5,32,47,1647
9178,9178,58098C95EBB5313B1B7006269C40D97A,10121,0,13,13,36,49,1849
9179,9179,58098C95EBB5313B1B7006269C40D97A,11231,13,17,4,37,49,1899
9180,9180,58098C95EBB5313B1B7006269C40D97A,10121,18,23,5,36,49,1849
9199,9199,D7B4DEFCB86C55D027A1210EEC02063B,11231,0,1,1,37,49,1899
9200,9200,D7B4DEFCB86C55D027A1210EEC02063B,10471,1,3,2,37,48,1898
9201,9201,D7B4DEFCB86C55D027A1210EEC02063B,11021,3,19,16,36,49,1849
9202,9202,D7B4DEFCB86C55D027A1210EEC02063B,11231,20,23,3,37,49,1899
9203,9203,7A3B81BDAFB4DD2FC896155A8BEFF9BB,42411,0,9,9,40,49,2049
9204,9204,7A3B81BDAFB4DD2FC896155A8BEFF9BB,11301,10,11,1,41,49,2099
9205,9205,7A3B81BDAFB4DD2FC896155A8BEFF9BB,13941,12,16,4,41,47,2097
9206,9206,7A3B81BDAFB4DD2FC896155A8BEFF9BB,42411,20,23,3,40,49,2049
9207,9207,B8CB58C24E169269E8ABC8B36E47359B,11651,0,8,8,33,47,1697
9208,9208,B8CB58C24E169269E8ABC8B36E47359B,42071,10,18,8,31,49,1599
9209,9209,B8CB58C24E169269E8ABC8B36E47359B,11651,19,23,4,33,47,1697
9216,9216,35723ED4710E1E8F2E5C2C1A6C7B0443,10716,0,6,6,30,46,1546
9217,9217,35723ED4710E1E8F2E5C2C1A6C7B0443,11061,7,8,1,29,48,1498
9218,9218,35723ED4710E1E8F2E5C2C1A6C7B0443,10711,18,19,1,29,46,1496
9230,9230,DE980DACA70C6198972643EFAF0AD63A,11831,0,6,6,32,45,1645
9231,9231,DE980DACA70C6198972643EFAF0AD63A,42531,8,11,3,31,45,1595
9232,9232,DE980DACA70C6198972643EFAF0AD63A,11831,14,15,1,32,45,1645
9233,9233,DE980DACA70C6198972643EFAF0AD63A,42531,17,20,3,31,45,1595
9249,9249,D3F18133881188A01FA675132E824AEA,11361,1,2,1,22,48,1148
9250,9250,D3F18133881188A01FA675132E824AEA,42481,4,7,3,22,49,1149
9251,9251,D3F18133881188A01FA675132E824AEA,42081,9,11,2,24,49,1249
9252,9252,D3F18133881188A01FA675132E824AEA,42481,12,19,7,22,49,1149
9258,9258,3EA1DA94379F7679CA011B08D7D44EE7,13911,0,3,3,39,46,1996
9259,9259,3EA1DA94379F7679CA011B08D7D44EE7,42351,3,19,16,38,45,1945
9260,9260,3EA1DA94379F7679CA011B08D7D44EE7,13911,19,20,1,39,46,1996
9271,9271,3D50CF8DA80A4761FAF974D4CBB0A177,19114,0,8,8,7,43,393
9272,9272,3D50CF8DA80A4761FAF974D4CBB0A177,12921,8,10,2,9,41,491
9273,9273,3D50CF8DA80A4761FAF974D4CBB0A177,19114,11,21,10,7,43,393
9279,9279,DFD67893B33D33FDAA92DC71D5732DAF,10111,0,7,7,37,47,1897
9280,9280,DFD67893B33D33FDAA92DC71D5732DAF,42161,10,18,8,36,47,1847
9281,9281,DFD67893B33D33FDAA92DC71D5732DAF,42941,18,19,1,37,47,1897
9282,9282,DFD67893B33D33FDAA92DC71D5732DAF,42161,21,23,2,36,47,1847
9286,9286,7D98A45A2A63975DDA0D630EA5B92C75,10801,2,5,3,42,47,2147
9287,9287,7D98A45A2A63975DDA0D630EA5B92C75,13941,5,19,14,41,47,2097
9288,9288,7D98A45A2A63975DDA0D630EA5B92C75,10801,21,22,1,42,47,2147
9289,9289,A1BDF95E9D3FC1D1F9602700F7A63FC0,42461,0,12,12,45,47,2297
9290,9290,A1BDF95E9D3FC1D1F9602700F7A63FC0,42321,14,15,1,43,47,2197
9291,9291,A1BDF95E9D3FC1D1F9602700F7A63FC0,42461,18,23,5,45,47,2297
9297,9297,C1162F2C909CCC1C0B397E5287703D92,42523,0,6,6,31,47,1597
9298,9298,C1162F2C909CCC1C0B397E5287703D92,42491,6,16,10,32,46,1646
9299,9299,C1162F2C909CCC1C0B397E5287703D92,10341,17,20,3,31,47,1597
9316,9316,F58A6BA375AD1293B95B27D538977CC9,11161,0,12,12,32,48,1648
9317,9317,F58A6BA375AD1293B95B27D538977CC9,42523,13,15,2,31,47,1597
9318,9318,F58A6BA375AD1293B95B27D538977CC9,11161,16,18,2,32,48,1648
9319,9319,F58A6BA375AD1293B95B27D538977CC9,42141,18,23,5,32,47,1647
9320,9320,0ACD42FBA28A767F44D73783967C8C23,10731,0,7,7,33,47,1697
9321,9321,0ACD42FBA28A767F44D73783967C8C23,12381,15,17,2,32,48,1648
9322,9322,0ACD42FBA28A767F44D73783967C8C23,11651,17,21,4,33,47,1697
9337,9337,72A693B275AEEE80DFC1575ACBF6AEFD,42481,6,13,7,22,49,1149
9338,9338,72A693B275AEEE80DFC1575ACBF6AEFD,12051,13,14,1,20,47,1047
9339,9339,72A693B275AEEE80DFC1575ACBF6AEFD,42481,15,21,6,22,49,1149
9340,9340,8AA4A8CCD104CA281FD495C84503BAAA,40123,0,7,7,38,47,1947
9341,9341,8AA4A8CCD104CA281FD495C84503BAAA,10841,10,16,6,37,47,1897
9342,9342,8AA4A8CCD104CA281FD495C84503BAAA,42801,17,18,1,40,49,2049
9343,9343,8AA4A8CCD104CA281FD495C84503BAAA,10841,19,20,1,37,47,1897
9348,9348,9BBBC00C93BA6A3176E2B008E6F8A88E,11261,0,3,3,36,46,1846
9349,9349,9BBBC00C93BA6A3176E2B008E6F8A88E,13911,4,7,3,39,46,1996
9350,9350,9BBBC00C93BA6A3176E2B008E6F8A88E,42351,9,13,4,38,45,1945
9351,9351,9BBBC00C93BA6A3176E2B008E6F8A88E,13911,17,18,1,39,46,1996
9352,9352,2B3A1B042736E5D9812DEE43B9AD0851,43951,5,16,11,49,41,2491
9353,9353,2B3A1B042736E5D9812DEE43B9AD0851,13411,17,18,1,49,42,2492
9354,9354,2B3A1B042736E5D9812DEE43B9AD0851,43951,19,21,2,49,41,2491
9360,9360,184C01DF5AF7FEEE2B90AA7395647187,42151,0,10,10,35,45,1795
9361,9361,184C01DF5AF7FEEE2B90AA7395647187,42861,15,16,1,37,44,1894
9362,9362,184C01DF5AF7FEEE2B90AA7395647187,42151,16,21,5,35,45,1795
9367,9367,034D77C839A67222E8B1A8EEDF34A7D6,11061,8,9,1,29,48,1498
9368,9368,034D77C839A67222E8B1A8EEDF34A7D6,10681,9,10,1,30,48,1548
9369,9369,034D77C839A67222E8B1A8EEDF34A7D6,11061,10,14,4,29,48,1498
9370,9370,034D77C839A67222E8B1A8EEDF34A7D6,10681,15,20,5,30,48,1548
9396,9396,9CF16D35CBBB6D43AD3AFEFE9A0A13CD,42831,3,7,4,27,48,1398
9397,9397,9CF16D35CBBB6D43AD3AFEFE9A0A13CD,11151,9,10,1,30,48,1548
9398,9398,9CF16D35CBBB6D43AD3AFEFE9A0A13CD,11061,14,15,1,29,48,1498
9399,9399,9CF16D35CBBB6D43AD3AFEFE9A0A13CD,11151,18,22,4,30,48,1548
9416,9416,D9B08428B230A26F9D8108567961B570,13671,0,8,8,27,43,1393
9417,9417,D9B08428B230A26F9D8108567961B570,11281,10,16,6,27,40,1390
9418,9418,D9B08428B230A26F9D8108567961B570,13671,16,23,7,27,43,1393
9431,9431,780CF605B987CE4335E0B64DFA86ACBF,12514,1,7,6,38,47,1947
9432,9432,780CF605B987CE4335E0B64DFA86ACBF,10841,8,18,10,37,47,1897
9433,9433,780CF605B987CE4335E0B64DFA86ACBF,11921,18,19,1,38,48,1948
9437,9437,0781E535CBB143640477269330BEC7EE,10251,0,7,7,35,47,1797
9438,9438,0781E535CBB143640477269330BEC7EE,10221,9,18,9,34,49,1749
9439,9439,0781E535CBB143640477269330BEC7EE,42161,22,23,1,36,47,1847
9449,9449,FD8C757A10FC8342CB9359B3B019D044,10901,0,8,8,35,48,1798
9450,9450,FD8C757A10FC8342CB9359B3B019D044,11231,10,16,6,37,49,1899
9451,9451,FD8C757A10FC8342CB9359B3B019D044,12083,19,20,1,36,49,1849
9452,9452,FD8C757A10FC8342CB9359B3B019D044,10901,22,23,1,35,48,1798
9453,9453,F2ED260BEE0CFBD7C0D8D1BC36233DE2,12121,0,9,9,29,47,1497
9454,9454,F2ED260BEE0CFBD7C0D8D1BC36233DE2,11381,10,12,2,30,47,1547
9455,9455,F2ED260BEE0CFBD7C0D8D1BC36233DE2,42521,13,16,3,31,47,1597
9456,9456,F2ED260BEE0CFBD7C0D8D1BC36233DE2,11381,19,21,2,30,47,1547
9457,9457,07E8F527E3C22F701EF1E12272A919B5,42221,2,13,11,38,48,1948
9458,9458,07E8F527E3C22F701EF1E12272A919B5,11074,16,18,2,37,47,1897
9459,9459,07E8F527E3C22F701EF1E12272A919B5,12514,19,21,2,38,47,1947
9465,9465,17E799A48287B85AC81D92C5CCE72266,10151,0,11,11,34,47,1747
9466,9466,17E799A48287B85AC81D92C5CCE72266,10971,14,19,5,35,47,1797
9467,9467,17E799A48287B85AC81D92C5CCE72266,10151,19,23,4,34,47,1747
9468,9468,FB6D357AE6E744B7566081ADA8598AEB,42161,1,6,5,36,47,1847
9469,9469,FB6D357AE6E744B7566081ADA8598AEB,40463,9,18,9,38,49,1949
9470,9470,FB6D357AE6E744B7566081ADA8598AEB,13511,20,21,1,34,48,1748
9487,9487,FCA3C665B5BF337F331669EDB597A6AC,42151,0,7,7,35,45,1795
9488,9488,FCA3C665B5BF337F331669EDB597A6AC,10271,9,10,1,37,46,1896
9489,9489,FCA3C665B5BF337F331669EDB597A6AC,13121,15,16,1,38,46,1946
9490,9490,FCA3C665B5BF337F331669EDB597A6AC,42791,21,23,2,35,45,1795
9498,9498,A4B7DD584753163300A222AEAD5EBBBD,40637,0,8,8,36,47,1847
9499,9499,A4B7DD584753163300A222AEAD5EBBBD,11231,8,18,10,37,49,1899
9500,9500,A4B7DD584753163300A222AEAD5EBBBD,42401,19,20,1,36,47,1847
9501,9501,170A0AC014DC9BA930EAA0E56A2C9D03,42321,0,6,6,43,47,2197
9502,9502,170A0AC014DC9BA930EAA0E56A2C9D03,11701,6,19,13,43,48,2198
9503,9503,170A0AC014DC9BA930EAA0E56A2C9D03,42461,19,20,1,45,47,2297
9504,9504,170A0AC014DC9BA930EAA0E56A2C9D03,42321,21,23,2,43,47,2197
9505,9505,AC9A35D001464E087369411DD671E08D,42301,0,7,7,36,47,1847
9506,9506,AC9A35D001464E087369411DD671E08D,42941,10,15,5,37,47,1897
9507,9507,AC9A35D001464E087369411DD671E08D,42301,19,23,4,36,47,1847
9508,9508,1899D07D2F340D4B48BCB4A99E15E781,11741,0,13,13,42,49,2149
9509,9509,1899D07D2F340D4B48BCB4A99E15E781,11301,14,15,1,41,49,2099
9510,9510,1899D07D2F340D4B48BCB4A99E15E781,11741,17,23,6,42,49,2149
9520,9520,209A6AEB64B02C42571A1BA2F553C339,11381,0,12,12,30,47,1547
9521,9521,209A6AEB64B02C42571A1BA2F553C339,10951,13,21,8,29,48,1498
9522,9522,209A6AEB64B02C42571A1BA2F553C339,11381,22,23,1,30,47,1547
9526,9526,91D7F1CF32E890EDD3961F448450E5FB,42401,0,7,7,36,47,1847
9527,9527,91D7F1CF32E890EDD3961F448450E5FB,43731,7,9,2,34,47,1747
9528,9528,91D7F1CF32E890EDD3961F448450E5FB,10371,13,17,4,37,49,1899
9529,9529,91D7F1CF32E890EDD3961F448450E5FB,42161,21,23,2,36,47,1847
9542,9542,2DF13F3C6B51FEAFB9527CE1523C2712,11381,0,8,8,30,47,1547
9543,9543,2DF13F3C6B51FEAFB9527CE1523C2712,10951,9,10,1,29,48,1498
9544,9544,2DF13F3C6B51FEAFB9527CE1523C2712,11381,12,18,6,30,47,1547
9545,9545,2DF13F3C6B51FEAFB9527CE1523C2712,10711,19,20,1,29,46,1496
9556,9556,214AC1F3D5605C0D7130343B840F5E8C,11151,0,7,7,30,48,1548
9557,9557,214AC1F3D5605C0D7130343B840F5E8C,11061,7,19,12,29,48,1498
9558,9558,214AC1F3D5605C0D7130343B840F5E8C,11151,19,20,1,30,48,1548
9559,9559,214AC1F3D5605C0D7130343B840F5E8C,11061,22,23,1,29,48,1498
9575,9575,7AFF3AE389680B660B260F1E6B0BF0D8,10544,0,15,15,28,48,1448
9576,9576,7AFF3AE389680B660B260F1E6B0BF0D8,43391,19,20,1,29,48,1498
9577,9577,7AFF3AE389680B660B260F1E6B0BF0D8,10544,22,23,1,28,48,1448
9605,9605,C2938F6FA2A943D6DFC754D5D6C219D6,42221,0,1,1,38,48,1948
9606,9606,C2938F6FA2A943D6DFC754D5D6C219D6,12514,3,5,2,38,47,1947
9607,9607,C2938F6FA2A943D6DFC754D5D6C219D6,11074,9,12,3,37,47,1897
9608,9608,C2938F6FA2A943D6DFC754D5D6C219D6,42221,14,22,8,38,48,1948
9619,9619,612F18F83615AD18C521C0260D4FB623,11914,0,7,7,37,48,1898
9620,9620,612F18F83615AD18C521C0260D4FB623,42581,7,8,1,38,48,1948
9621,9621,612F18F83615AD18C521C0260D4FB623,11914,8,23,15,37,48,1898
9622,9622,ADC90DB17DC6528D7857A92E7C29E01C,13791,0,6,6,42,47,2147
9623,9623,ADC90DB17DC6528D7857A92E7C29E01C,12211,7,10,3,41,44,2094
9624,9624,ADC90DB17DC6528D7857A92E7C29E01C,13791,12,21,9,42,47,2147
9625,9625,2F8CA12038D8BFDAC42D43FF94213821,42381,0,3,3,39,41,1991
9626,9626,2F8CA12038D8BFDAC42D43FF94213821,13071,3,4,1,41,41,2091
9627,9627,2F8CA12038D8BFDAC42D43FF94213821,43451,6,16,10,37,40,1890
9628,9628,2F8CA12038D8BFDAC42D43FF94213821,42381,19,21,2,39,41,1991
9653,9653,FF4C546FA5246002B1E2D4C2504FFE25,10371,0,7,7,37,49,1899
9654,9654,FF4C546FA5246002B1E2D4C2504FFE25,40502,8,16,8,36,48,1848
9655,9655,FF4C546FA5246002B1E2D4C2504FFE25,11231,17,23,6,37,49,1899
9656,9656,B3E3F7F4BB39DF4D783E592F9F0BB965,10281,0,7,7,33,48,1698
9657,9657,B3E3F7F4BB39DF4D783E592F9F0BB965,43731,9,13,4,34,47,1747
9658,9658,B3E3F7F4BB39DF4D783E592F9F0BB965,43161,13,17,4,35,47,1797
9659,9659,B3E3F7F4BB39DF4D783E592F9F0BB965,10281,19,23,4,33,48,1698
9667,9667,618888EB1B52E086D59170F9E48F47F3,10471,0,9,9,37,48,1898
9668,9668,618888EB1B52E086D59170F9E48F47F3,10331,12,18,6,39,46,1996
9669,9669,618888EB1B52E086D59170F9E48F47F3,12514,18,20,2,38,47,1947
9675,9675,28C2D2FE4D28624F13409918B749F4EA,42231,0,6,6,37,46,1896
9676,9676,28C2D2FE4D28624F13409918B749F4EA,13711,8,9,1,38,46,1946
9677,9677,28C2D2FE4D28624F13409918B749F4EA,10271,10,11,1,37,46,1896
9678,9678,28C2D2FE4D28624F13409918B749F4EA,13711,16,22,6,38,46,1946
9684,9684,FE84C5B6FD29AD1D9C75D32BF19FA780,11261,10,11,1,36,46,1846
9685,9685,FE84C5B6FD29AD1D9C75D32BF19FA780,42861,13,14,1,37,44,1894
9686,9686,FE84C5B6FD29AD1D9C75D32BF19FA780,11261,17,18,1,36,46,1846
9687,9687,994BA369046D8B99F80604E02227FCEB,42581,2,5,3,38,48,1948
9688,9688,994BA369046D8B99F80604E02227FCEB,11914,10,17,7,37,48,1898
9689,9689,994BA369046D8B99F80604E02227FCEB,42581,18,20,2,38,48,1948
9724,9724,4E8CF0BE1A57E085938ED2B5916A9E34,11381,0,1,1,30,47,1547
9725,9725,4E8CF0BE1A57E085938ED2B5916A9E34,11061,3,10,7,29,48,1498
9726,9726,4E8CF0BE1A57E085938ED2B5916A9E34,43661,14,19,5,33,47,1697
9734,9734,79F70A1AE08CEE215DA71360DE1B25EA,42191,0,6,6,38,49,1949
9735,9735,79F70A1AE08CEE215DA71360DE1B25EA,42231,7,20,13,37,46,1896
9736,9736,79F70A1AE08CEE215DA71360DE1B25EA,11811,20,23,3,38,49,1949
9753,9753,3624837A8CEE8FA380EBBA166C2E7021,42091,0,6,6,43,46,2196
9754,9754,3624837A8CEE8FA380EBBA166C2E7021,13341,6,9,3,44,45,2245
9755,9755,3624837A8CEE8FA380EBBA166C2E7021,42201,13,23,10,43,46,2196
9756,9756,1DD07CF7FD5B3CCCB4E85025836774E4,11074,1,7,6,37,47,1897
9757,9757,1DD07CF7FD5B3CCCB4E85025836774E4,11231,7,18,11,37,49,1899
9758,9758,1DD07CF7FD5B3CCCB4E85025836774E4,42021,18,19,1,33,47,1697
9759,9759,1DD07CF7FD5B3CCCB4E85025836774E4,12841,21,23,2,37,47,1897
9769,9769,57E38E75C3154FA28FE7B22CE29AF775,11151,1,3,2,30,48,1548
9770,9770,57E38E75C3154FA28FE7B22CE29AF775,11061,4,5,1,29,48,1498
9771,9771,57E38E75C3154FA28FE7B22CE29AF775,11151,7,12,5,30,48,1548
9772,9772,57E38E75C3154FA28FE7B22CE29AF775,11061,14,23,9,29,48,1498
9784,9784,4A7EF801268FA87DD49AA705DCA560E1,11914,9,12,3,37,48,1898
9785,9785,4A7EF801268FA87DD49AA705DCA560E1,42581,13,15,2,38,48,1948
9786,9786,4A7EF801268FA87DD49AA705DCA560E1,11914,16,17,1,37,48,1898
9787,9787,4A7EF801268FA87DD49AA705DCA560E1,42581,20,21,1,38,48,1948
9788,9788,048BEC0EA2F5315537AEA18CE86AC412,11021,0,18,18,36,49,1849
9789,9789,048BEC0EA2F5315537AEA18CE86AC412,10107,19,20,1,38,49,1949
9790,9790,048BEC0EA2F5315537AEA18CE86AC412,11021,20,23,3,36,49,1849
9796,9796,9951832C875ED15346443116F8C6A7D1,10331,5,7,2,39,46,1996
9797,9797,9951832C875ED15346443116F8C6A7D1,10191,9,13,4,40,48,2048
9798,9798,9951832C875ED15346443116F8C6A7D1,10811,18,23,5,38,46,1946
9804,9804,1311B127203B575B7C2B7AFD78C2A24A,11491,0,8,8,36,47,1847
9805,9805,1311B127203B575B7C2B7AFD78C2A24A,12021,12,13,1,37,49,1899
9806,9806,1311B127203B575B7C2B7AFD78C2A24A,11491,19,23,4,36,47,1847
9807,9807,44456DB2F546B5FE9E15EA75927471A8,42521,0,7,7,31,47,1597
9808,9808,44456DB2F546B5FE9E15EA75927471A8,11321,8,11,3,31,46,1596
9809,9809,44456DB2F546B5FE9E15EA75927471A8,43761,15,18,3,32,47,1647
9810,9810,44456DB2F546B5FE9E15EA75927471A8,42523,21,23,2,31,47,1597
9819,9819,4395C6E2ABA59930045C5FB0134BA180,10711,0,8,8,29,46,1496
9820,9820,4395C6E2ABA59930045C5FB0134BA180,12311,9,12,3,30,44,1544
9821,9821,4395C6E2ABA59930045C5FB0134BA180,10711,14,19,5,29,46,1496
9827,9827,751B7CB9C035034746EB082217066F97,10351,1,12,11,28,45,1445
9828,9828,751B7CB9C035034746EB082217066F97,13671,14,15,1,27,43,1393
9829,9829,751B7CB9C035034746EB082217066F97,10351,20,21,1,28,45,1445
9830,9830,D46D481AE4A1808392E89F68BF1C527D,11061,0,4,4,29,48,1498
9831,9831,D46D481AE4A1808392E89F68BF1C527D,40441,4,8,4,30,48,1548
9832,9832,D46D481AE4A1808392E89F68BF1C527D,11061,12,23,11,29,48,1498
9833,9833,73C431267E9D15126DD630F092950C8C,42111,0,12,12,44,46,2246
9834,9834,73C431267E9D15126DD630F092950C8C,42461,14,16,2,45,47,2297
9835,9835,73C431267E9D15126DD630F092950C8C,42111,19,20,1,44,46,2246
9836,9836,4FA7E2AF35091649A8D61648BF92F5C0,42581,0,6,6,38,48,1948
9837,9837,4FA7E2AF35091649A8D61648BF92F5C0,10471,7,12,5,37,48,1898
9838,9838,4FA7E2AF35091649A8D61648BF92F5C0,42581,12,14,2,38,48,1948
9839,9839,4FA7E2AF35091649A8D61648BF92F5C0,10471,14,21,7,37,48,1898
9840,9840,25D7A02E36F2606193AA6545F1D088D2,19441,2,11,9,8,46,446
9841,9841,25D7A02E36F2606193AA6545F1D088D2,42041,13,14,1,10,47,547
9842,9842,25D7A02E36F2606193AA6545F1D088D2,19441,15,19,4,8,46,446
9849,9849,FD5EF28EAD4BB7B6215FEE28B08DAD3E,12661,0,13,13,32,45,1645
9850,9850,FD5EF28EAD4BB7B6215FEE28B08DAD3E,12311,14,17,3,30,44,1544
9851,9851,FD5EF28EAD4BB7B6215FEE28B08DAD3E,10281,19,22,3,33,48,1698
9864,9864,CF0E6F8B160D86156EE9F4AC4DCADB7E,19441,0,4,4,8,46,446
9865,9865,CF0E6F8B160D86156EE9F4AC4DCADB7E,19621,5,7,2,5,46,296
9866,9866,CF0E6F8B160D86156EE9F4AC4DCADB7E,19441,11,15,4,8,46,446
9867,9867,CF0E6F8B160D86156EE9F4AC4DCADB7E,42041,16,18,2,10,47,547
9871,9871,CF6A7AF612D2CFA2B8383868CF93735B,42921,0,8,8,33,47,1697
9872,9872,CF6A7AF612D2CFA2B8383868CF93735B,42523,10,12,2,31,47,1597
9873,9873,CF6A7AF612D2CFA2B8383868CF93735B,42921,17,18,1,33,47,1697
9874,9874,CF6A7AF612D2CFA2B8383868CF93735B,42523,19,21,2,31,47,1597
9875,9875,5B985E49A96AC1F29BC71E54AB886B64,10351,2,7,5,28,45,1445
9876,9876,5B985E49A96AC1F29BC71E54AB886B64,10634,9,17,8,27,45,1395
9877,9877,5B985E49A96AC1F29BC71E54AB886B64,10351,18,19,1,28,45,1445
9878,9878,33EC6862A4D3A83DD8E8B00DCA26EE3C,43241,0,6,6,36,46,1846
9879,9879,33EC6862A4D3A83DD8E8B00DCA26EE3C,13711,9,16,7,38,46,1946
9880,9880,33EC6862A4D3A83DD8E8B00DCA26EE3C,43241,17,19,2,36,46,1846
9886,9886,D4B4B4E3A7A4BCB80292B7DC4CB75F9E,11351,1,6,5,36,48,1848
9887,9887,D4B4B4E3A7A4BCB80292B7DC4CB75F9E,42771,7,12,5,36,47,1847
9888,9888,D4B4B4E3A7A4BCB80292B7DC4CB75F9E,11271,12,13,1,37,48,1898
9889,9889,D4B4B4E3A7A4BCB80292B7DC4CB75F9E,42771,17,18,1,36,47,1847
9895,9895,BA68D19087DD7682E8C396165511A278,11381,0,14,14,30,47,1547
9896,9896,BA68D19087DD7682E8C396165511A278,11161,17,18,1,32,48,1648
9897,9897,BA68D19087DD7682E8C396165511A278,11381,18,23,5,30,47,1547
9898,9898,E1531D1016DAB55BA101619305B887D8,11361,0,5,5,22,48,1148
9899,9899,E1531D1016DAB55BA101619305B887D8,42691,5,6,1,24,48,1248
9900,9900,E1531D1016DAB55BA101619305B887D8,11361,6,8,2,22,48,1148
9901,9901,E1531D1016DAB55BA101619305B887D8,42691,11,22,11,24,48,1248
9905,9905,FE289D23B7E617AD349A76499E85C77F,42921,2,7,5,33,47,1697
9906,9906,FE289D23B7E617AD349A76499E85C77F,10431,10,15,5,33,49,1699
9907,9907,FE289D23B7E617AD349A76499E85C77F,10731,17,23,6,33,47,1697
9908,9908,D75C3445749887B99DC8ABBE45C13D9A,13271,0,9,9,41,47,2097
9909,9909,D75C3445749887B99DC8ABBE45C13D9A,11481,9,11,2,41,48,2098
9910,9910,D75C3445749887B99DC8ABBE45C13D9A,13101,15,16,1,40,47,2047
9911,9911,D75C3445749887B99DC8ABBE45C13D9A,13271,17,19,2,41,47,2097
9912,9912,67EEF12624F5A3B71954681C5774CEB1,42331,0,7,7,39,46,1996
9913,9913,67EEF12624F5A3B71954681C5774CEB1,10811,9,10,1,38,46,1946
9914,9914,67EEF12624F5A3B71954681C5774CEB1,42331,13,19,6,39,46,1996
9921,9921,FB139DC262006B2925BE60B194637182,13841,0,7,7,40,46,2046
9922,9922,FB139DC262006B2925BE60B194637182,11001,8,18,10,42,47,2147
9923,9923,FB139DC262006B2925BE60B194637182,13841,19,20,1,40,46,2046
9924,9924,FB139DC262006B2925BE60B194637182,11001,21,23,2,42,47,2147
9933,9933,529C1F312D75882B80279F97DB4BC76C,10111,0,14,14,37,47,1897
9934,9934,529C1F312D75882B80279F97DB4BC76C,10251,15,17,2,35,47,1797
9935,9935,529C1F312D75882B80279F97DB4BC76C,42401,18,19,1,36,47,1847
9936,9936,529C1F312D75882B80279F97DB4BC76C,11074,22,23,1,37,47,1897
9940,9940,82FC52EE0064301BB5255C3B5ED793DB,42341,0,6,6,43,49,2199
9941,9941,82FC52EE0064301BB5255C3B5ED793DB,11741,8,9,1,42,49,2149
9942,9942,82FC52EE0064301BB5255C3B5ED793DB,42971,12,23,11,43,49,2199
9943,9943,77EA23FEBF1AF98A4F6293E826F27BD4,11806,0,2,2,41,48,2098
9944,9944,77EA23FEBF1AF98A4F6293E826F27BD4,42271,4,11,7,40,47,2047
9945,9945,77EA23FEBF1AF98A4F6293E826F27BD4,11806,14,19,5,41,48,2098
9946,9946,77EA23FEBF1AF98A4F6293E826F27BD4,42271,20,23,3,40,47,2047
9954,9954,25A0E61F1DC4EDCA55BC31768CCB616A,13941,1,2,1,41,47,2097
9955,9955,25A0E61F1DC4EDCA55BC31768CCB616A,11001,2,6,4,42,47,2147
9956,9956,25A0E61F1DC4EDCA55BC31768CCB616A,13941,6,23,17,41,47,2097
9957,9957,256716E7BC700918221B302D675AB769,42921,2,7,5,33,47,1697
9958,9958,256716E7BC700918221B302D675AB769,43311,12,15,3,31,48,1598
9959,9959,256716E7BC700918221B302D675AB769,11861,18,19,1,32,47,1647
9960,9960,256716E7BC700918221B302D675AB769,12381,19,23,4,32,48,1648
9961,9961,E8C2391DA6D45D7659D6871A0F1C6C82,11834,0,8,8,32,45,1645
9962,9962,E8C2391DA6D45D7659D6871A0F1C6C82,42531,11,13,2,31,45,1595
9963,9963,E8C2391DA6D45D7659D6871A0F1C6C82,42151,15,17,2,35,45,1795
9964,9964,E8C2391DA6D45D7659D6871A0F1C6C82,42531,18,20,2,31,45,1595
9965,9965,56380B9BCFA6857A7D3E4BBFC0E5BBBD,12514,0,4,4,38,47,1947
9966,9966,56380B9BCFA6857A7D3E4BBFC0E5BBBD,11074,4,14,10,37,47,1897
9967,9967,56380B9BCFA6857A7D3E4BBFC0E5BBBD,41005,14,16,2,38,47,1947
9968,9968,56380B9BCFA6857A7D3E4BBFC0E5BBBD,12841,17,20,3,37,47,1897
9972,9972,FC707C73D6614611D82A13C2F325D332,11074,2,10,8,37,47,1897
9973,9973,FC707C73D6614611D82A13C2F325D332,11021,13,18,5,36,49,1849
9974,9974,FC707C73D6614611D82A13C2F325D332,42861,18,20,2,37,44,1894
9987,9987,4DAFB85C918047225CA596E4134A09D3,42141,0,16,16,32,47,1647
9988,9988,4DAFB85C918047225CA596E4134A09D3,13651,16,18,2,30,47,1547
9989,9989,4DAFB85C918047225CA596E4134A09D3,42141,19,23,4,32,47,1647
9993,9993,C6E39197478B854A74FABF400B391655,43761,0,8,8,32,47,1647
9994,9994,C6E39197478B854A74FABF400B391655,10281,12,13,1,33,48,1698
9995,9995,C6E39197478B854A74FABF400B391655,42141,17,22,5,32,47,1647
10004,10004,DD4D28FDBCFFE930AF28BD3956ED9308,11381,0,7,7,30,47,1547
10005,10005,DD4D28FDBCFFE930AF28BD3956ED9308,11831,8,10,2,32,45,1645
10006,10006,DD4D28FDBCFFE930AF28BD3956ED9308,40331,11,23,12,30,47,1547
10010,10010,2AEA8CD7C7441A2139369CE4AFCCE79A,40964,0,8,8,35,48,1798
10011,10011,2AEA8CD7C7441A2139369CE4AFCCE79A,41081,9,12,3,36,49,1849
10012,10012,2AEA8CD7C7441A2139369CE4AFCCE79A,40964,21,23,2,35,48,1798
10013,10013,619B4993323BBB76F010058331D5BCE1,13911,0,6,6,39,46,1996
10014,10014,619B4993323BBB76F010058331D5BCE1,11261,10,12,2,36,46,1846
10015,10015,619B4993323BBB76F010058331D5BCE1,13911,17,20,3,39,46,1996
10016,10016,619B4993323BBB76F010058331D5BCE1,11261,21,23,2,36,46,1846
10017,10017,99F5BEE34C277EC7BBBEB92C558829F6,13711,0,12,12,38,46,1946
10018,10018,99F5BEE34C277EC7BBBEB92C558829F6,42231,12,15,3,37,46,1896
10019,10019,99F5BEE34C277EC7BBBEB92C558829F6,13711,18,23,5,38,46,1946
10020,10020,302E13281DC08AB4B0CB613D73ADA12A,11381,0,7,7,30,47,1547
10021,10021,302E13281DC08AB4B0CB613D73ADA12A,42501,7,17,10,28,47,1447
10022,10022,302E13281DC08AB4B0CB613D73ADA12A,11381,20,23,3,30,47,1547
10023,10023,FF14C557FCDFD40935266940A2E12C15,13101,0,1,1,40,47,2047
10024,10024,FF14C557FCDFD40935266940A2E12C15,42583,3,18,15,40,48,2048
10025,10025,FF14C557FCDFD40935266940A2E12C15,13271,20,23,3,41,47,2097
10053,10053,9118236113ABD2907EA8C4297C93D9B6,10471,0,16,16,37,48,1898
10054,10054,9118236113ABD2907EA8C4297C93D9B6,11231,18,19,1,37,49,1899
10055,10055,9118236113ABD2907EA8C4297C93D9B6,10471,19,20,1,37,48,1898
10056,10056,5EC66C5A4B87D37344B296F73CB04D80,11231,0,11,11,37,49,1899
10057,10057,5EC66C5A4B87D37344B296F73CB04D80,10471,11,16,5,37,48,1898
10058,10058,5EC66C5A4B87D37344B296F73CB04D80,11231,16,23,7,37,49,1899
10059,10059,BB44A13BCAB0B022B18D7F4EDDEC4037,11231,0,1,1,37,49,1899
10060,10060,BB44A13BCAB0B022B18D7F4EDDEC4037,42301,1,19,18,36,47,1847
10061,10061,BB44A13BCAB0B022B18D7F4EDDEC4037,11231,20,23,3,37,49,1899
10074,10074,C7E5E104390805F5D4E4CF7148150C16,10341,1,7,6,31,47,1597
10075,10075,C7E5E104390805F5D4E4CF7148150C16,42491,9,11,2,32,46,1646
10076,10076,C7E5E104390805F5D4E4CF7148150C16,10341,12,13,1,31,47,1597
10077,10077,C7E5E104390805F5D4E4CF7148150C16,42491,20,21,1,32,46,1646
10078,10078,C5FAF90C34968999A63CFDAD0562DDBD,10841,6,8,2,37,47,1897
10079,10079,C5FAF90C34968999A63CFDAD0562DDBD,12083,9,11,2,36,49,1849
10080,10080,C5FAF90C34968999A63CFDAD0562DDBD,10841,12,23,11,37,47,1897
10081,10081,B2FF699F2D213EDD8D43D893134155CA,10951,0,16,16,29,48,1498
10082,10082,B2FF699F2D213EDD8D43D893134155CA,11381,16,22,6,30,47,1547
10083,10083,B2FF699F2D213EDD8D43D893134155CA,10951,22,23,1,29,48,1498
10084,10084,0A252836FA6DFCFDFC50B5267919BF05,12641,0,3,3,10,43,543
10085,10085,0A252836FA6DFCFDFC50B5267919BF05,12921,3,11,8,9,41,491
10086,10086,0A252836FA6DFCFDFC50B5267919BF05,12641,14,21,7,10,43,543
10087,10087,35DE934E09014E3A56964C528E95BB57,12121,0,7,7,29,47,1497
10088,10088,35DE934E09014E3A56964C528E95BB57,10731,16,18,2,33,47,1697
10089,10089,35DE934E09014E3A56964C528E95BB57,12121,18,20,2,29,47,1497
10090,10090,B4CB7D775FD49872112583081BADF0AF,11001,1,18,17,42,47,2147
10091,10091,B4CB7D775FD49872112583081BADF0AF,13941,19,20,1,41,47,2097
10092,10092,B4CB7D775FD49872112583081BADF0AF,11001,20,23,3,42,47,2147
10099,10099,EBCADA6271FF8F52F5A24BDA163DB501,11261,0,1,1,36,46,1846
10100,10100,EBCADA6271FF8F52F5A24BDA163DB501,42161,2,13,11,36,47,1847
10101,10101,EBCADA6271FF8F52F5A24BDA163DB501,40981,15,23,8,34,47,1747
10105,10105,1E78C6812CC13AC596F7D7BD80A5DD70,11921,0,13,13,38,48,1948
10106,10106,1E78C6812CC13AC596F7D7BD80A5DD70,11914,17,18,1,37,48,1898
10107,10107,1E78C6812CC13AC596F7D7BD80A5DD70,11074,20,22,2,37,47,1897
10108,10108,3D0F2BCCE75D465843155D0427A87610,42271,2,7,5,40,47,2047
10109,10109,3D0F2BCCE75D465843155D0427A87610,11806,10,11,1,41,48,2098
10110,10110,3D0F2BCCE75D465843155D0427A87610,42271,11,12,1,40,47,2047
10111,10111,3D0F2BCCE75D465843155D0427A87610,11806,12,21,9,41,48,2098
10112,10112,E880DD3703242558096D10770FE10A54,42861,3,4,1,37,44,1894
10113,10113,E880DD3703242558096D10770FE10A54,11261,7,12,5,36,46,1846
10114,10114,E880DD3703242558096D10770FE10A54,42861,15,19,4,37,44,1894
10133,10133,86877F32D6D32D1728C272FD8E7855F4,10281,0,14,14,33,48,1698
10134,10134,86877F32D6D32D1728C272FD8E7855F4,11861,14,18,4,32,47,1647
10135,10135,86877F32D6D32D1728C272FD8E7855F4,10281,19,23,4,33,48,1698
10140,10140,DE853A305AE6D9B2B164CCE8A37DB023,11261,0,7,7,36,46,1846
10141,10141,DE853A305AE6D9B2B164CCE8A37DB023,13911,7,8,1,39,46,1996
10142,10142,DE853A305AE6D9B2B164CCE8A37DB023,11261,9,21,12,36,46,1846
10159,10159,BD7F8AE2121E328FD649FC14D4784D1F,11281,0,12,12,27,40,1390
10160,10160,BD7F8AE2121E328FD649FC14D4784D1F,13671,16,18,2,27,43,1393
10161,10161,BD7F8AE2121E328FD649FC14D4784D1F,11281,20,23,3,27,40,1390
10162,10162,70BC072844C7CA9E90555B310CFF3C22,13601,0,8,8,34,47,1747
10163,10163,70BC072844C7CA9E90555B310CFF3C22,12381,9,18,9,32,48,1648
10164,10164,70BC072844C7CA9E90555B310CFF3C22,13601,19,22,3,34,47,1747
10165,10165,F7F6E311089E545E2ADE21E1CFF4D206,43761,1,2,1,32,47,1647
10166,10166,F7F6E311089E545E2ADE21E1CFF4D206,42921,5,13,8,33,47,1697
10167,10167,F7F6E311089E545E2ADE21E1CFF4D206,43761,16,21,5,32,47,1647
10173,10173,A05E50C8250D6971328B3F8C4CFB1D1A,42291,1,9,8,29,48,1498
10174,10174,A05E50C8250D6971328B3F8C4CFB1D1A,11381,12,13,1,30,47,1547
10175,10175,A05E50C8250D6971328B3F8C4CFB1D1A,11061,13,16,3,29,48,1498
10176,10176,A05E50C8250D6971328B3F8C4CFB1D1A,11381,16,20,4,30,47,1547
10177,10177,540311DE1F12F752C637697C87C1492F,43951,0,6,6,49,41,2491
10178,10178,540311DE1F12F752C637697C87C1492F,43101,7,9,2,46,40,2340
10179,10179,540311DE1F12F752C637697C87C1492F,43951,12,23,11,49,41,2491
10180,10180,089202C74F7A5B708A3906BDD594D636,10634,0,1,1,27,45,1395
10181,10181,089202C74F7A5B708A3906BDD594D636,10351,2,7,5,28,45,1445
10182,10182,089202C74F7A5B708A3906BDD594D636,10634,11,12,1,27,45,1395
10183,10183,089202C74F7A5B708A3906BDD594D636,12601,17,23,6,25,47,1297
10184,10184,D2A48FC60ADAD9E2BF11727867EF8CE8,11074,1,15,14,37,47,1897
10185,10185,D2A48FC60ADAD9E2BF11727867EF8CE8,12514,16,18,2,38,47,1947
10186,10186,D2A48FC60ADAD9E2BF11727867EF8CE8,11074,21,22,1,37,47,1897
10191,10191,3BD30092E78F928C91E4887B7831932C,42161,0,5,5,36,47,1847
10192,10192,3BD30092E78F928C91E4887B7831932C,10111,6,10,4,37,47,1897
10193,10193,3BD30092E78F928C91E4887B7831932C,42161,14,23,9,36,47,1847
10199,10199,89218D7844F451E8441D19010F1C02CD,42081,6,7,1,24,49,1249
10200,10200,89218D7844F451E8441D19010F1C02CD,42623,8,11,3,22,49,1149
10201,10201,89218D7844F451E8441D19010F1C02CD,42081,12,18,6,24,49,1249
10207,10207,0DFD98C5BF618352145AEF64606DF221,10251,0,10,10,35,47,1797
10208,10208,0DFD98C5BF618352145AEF64606DF221,40673,11,12,1,36,48,1848
10209,10209,0DFD98C5BF618352145AEF64606DF221,42161,12,22,10,36,47,1847
10225,10225,4290A01FCBC2456E9D2F061E9D5E5D68,11331,0,7,7,37,48,1898
10226,10226,4290A01FCBC2456E9D2F061E9D5E5D68,11074,9,11,2,37,47,1897
10227,10227,4290A01FCBC2456E9D2F061E9D5E5D68,11331,18,23,5,37,48,1898
10232,10232,31100BE8BDE5B74B2D64B60F8888BAE5,10111,0,7,7,37,47,1897
10233,10233,31100BE8BDE5B74B2D64B60F8888BAE5,42161,8,12,4,36,47,1847
10234,10234,31100BE8BDE5B74B2D64B60F8888BAE5,10111,12,23,11,37,47,1897
10235,10235,9AF6F4C6C4937C91C918EC9853CABA28,42861,0,13,13,37,44,1894
10236,10236,9AF6F4C6C4937C91C918EC9853CABA28,11261,13,16,3,36,46,1846
10237,10237,9AF6F4C6C4937C91C918EC9853CABA28,13911,16,18,2,39,46,1996
10238,10238,9AF6F4C6C4937C91C918EC9853CABA28,42864,20,23,3,38,44,1944
10239,10239,93C87ADE4FBD02048670A9DCD4C6ECEA,11261,0,2,2,36,46,1846
10240,10240,93C87ADE4FBD02048670A9DCD4C6ECEA,42861,5,17,12,37,44,1894
10241,10241,93C87ADE4FBD02048670A9DCD4C6ECEA,11261,19,20,1,36,46,1846
10242,10242,93C87ADE4FBD02048670A9DCD4C6ECEA,42864,22,23,1,38,44,1944
10247,10247,586F3AD64B483C4FDBF6963F85B66D9A,13271,0,6,6,41,47,2097
10248,10248,586F3AD64B483C4FDBF6963F85B66D9A,11481,12,14,2,41,48,2098
10249,10249,586F3AD64B483C4FDBF6963F85B66D9A,13271,18,23,5,41,47,2097
10262,10262,3717F18D88C40095DBADE8C95C390E6F,42151,0,9,9,35,45,1795
10263,10263,3717F18D88C40095DBADE8C95C390E6F,42861,11,13,2,37,44,1894
10264,10264,3717F18D88C40095DBADE8C95C390E6F,42151,13,16,3,35,45,1795
10265,10265,3717F18D88C40095DBADE8C95C390E6F,42861,16,20,4,37,44,1894
10266,10266,CC9B563274FADBC11530657F755F072F,42161,0,18,18,36,47,1847
10267,10267,CC9B563274FADBC11530657F755F072F,12514,18,20,2,38,47,1947
10268,10268,CC9B563274FADBC11530657F755F072F,11491,21,23,2,36,47,1847
10279,10279,0EC18AC0EBC3E7C437756EE316287D8F,11061,0,9,9,29,48,1498
10280,10280,0EC18AC0EBC3E7C437756EE316287D8F,11151,9,10,1,30,48,1548
10281,10281,0EC18AC0EBC3E7C437756EE316287D8F,11061,11,20,9,29,48,1498
10282,10282,5767DCB7927C2A22DA225038742C1BCE,13561,0,13,13,37,49,1899
10283,10283,5767DCB7927C2A22DA225038742C1BCE,11021,14,17,3,36,49,1849
10284,10284,5767DCB7927C2A22DA225038742C1BCE,13561,17,23,6,37,49,1899
10285,10285,D41FED47C1014BB03A5F6A9B0F872050,40421,1,10,9,37,48,1898
10286,10286,D41FED47C1014BB03A5F6A9B0F872050,42401,11,17,6,36,47,1847
10287,10287,D41FED47C1014BB03A5F6A9B0F872050,40951,20,21,1,36,49,1849
10288,10288,D41FED47C1014BB03A5F6A9B0F872050,42401,22,23,1,36,47,1847
10289,10289,1D9B3BEAA73444A543D0673D1FBABCFF,10251,0,8,8,35,47,1797
10290,10290,1D9B3BEAA73444A543D0673D1FBABCFF,42511,8,11,3,37,47,1897
10291,10291,1D9B3BEAA73444A543D0673D1FBABCFF,42161,12,23,11,36,47,1847
10320,10320,1C4DD184F2771AF8D9B0216E0C8822D3,10251,10,11,1,35,47,1797
10321,10321,1C4DD184F2771AF8D9B0216E0C8822D3,42401,12,16,4,36,47,1847
10322,10322,1C4DD184F2771AF8D9B0216E0C8822D3,10661,20,21,1,37,49,1899
10328,10328,0DC30FA0CCDAD859C724130675369152,42351,1,13,12,38,45,1945
10329,10329,0DC30FA0CCDAD859C724130675369152,11261,15,16,1,36,46,1846
10330,10330,0DC30FA0CCDAD859C724130675369152,42351,20,22,2,38,45,1945
10338,10338,05F5E1C40665B68C77ECAABF0F951B28,11751,0,6,6,35,48,1798
10339,10339,05F5E1C40665B68C77ECAABF0F951B28,10661,7,18,11,37,49,1899
10340,10340,05F5E1C40665B68C77ECAABF0F951B28,40951,18,21,3,36,49,1849
10341,10341,31D4ECBF6E20300058A6DBF4B1DCA2FB,42523,0,4,4,31,47,1597
10342,10342,31D4ECBF6E20300058A6DBF4B1DCA2FB,13651,9,14,5,30,47,1547
10343,10343,31D4ECBF6E20300058A6DBF4B1DCA2FB,11861,19,20,1,32,47,1647
10344,10344,31D4ECBF6E20300058A6DBF4B1DCA2FB,13651,22,23,1,30,47,1547
10348,10348,1BA9D996B3A19A747EE7BB60C0D1E1A7,12521,0,8,8,35,41,1791
10349,10349,1BA9D996B3A19A747EE7BB60C0D1E1A7,43451,10,11,1,37,40,1890
10350,10350,1BA9D996B3A19A747EE7BB60C0D1E1A7,12521,11,23,12,35,41,1791
10356,10356,906075D6233195F1F9099F6FBB81286D,43761,0,5,5,32,47,1647
10357,10357,906075D6233195F1F9099F6FBB81286D,42523,5,11,6,31,47,1597
10358,10358,906075D6233195F1F9099F6FBB81286D,43761,13,14,1,32,47,1647
10359,10359,906075D6233195F1F9099F6FBB81286D,42523,15,20,5,31,47,1597
10367,10367,FE72309A49FBEB6B76C0E42028E74707,42041,0,9,9,10,47,547
10368,10368,FE72309A49FBEB6B76C0E42028E74707,19441,11,12,1,8,46,446
10369,10369,FE72309A49FBEB6B76C0E42028E74707,42041,13,19,6,10,47,547
10374,10374,B4CF5575585A81D8047EC86B2FC8CF53,42861,0,14,14,37,44,1894
10375,10375,B4CF5575585A81D8047EC86B2FC8CF53,11261,14,17,3,36,46,1846
10376,10376,B4CF5575585A81D8047EC86B2FC8CF53,42861,17,23,6,37,44,1894
10377,10377,8447DB7A499BC9F77C36AE17CABAC8E3,12514,0,6,6,38,47,1947
10378,10378,8447DB7A499BC9F77C36AE17CABAC8E3,43181,8,12,4,39,48,1998
10379,10379,8447DB7A499BC9F77C36AE17CABAC8E3,10191,17,18,1,40,48,2048
10380,10380,8447DB7A499BC9F77C36AE17CABAC8E3,10841,19,23,4,37,47,1897
10381,10381,246CC93CB32541ED64BE76C965AA4ACC,42321,0,15,15,43,47,2197
10382,10382,246CC93CB32541ED64BE76C965AA4ACC,10801,15,17,2,42,47,2147
10383,10383,246CC93CB32541ED64BE76C965AA4ACC,42321,17,18,1,43,47,2197
10390,10390,A1E490700FE526497C6D06909C6A4A1B,42371,0,14,14,34,46,1746
10391,10391,A1E490700FE526497C6D06909C6A4A1B,10881,15,17,2,34,48,1748
10392,10392,A1E490700FE526497C6D06909C6A4A1B,10281,18,19,1,33,48,1698
10393,10393,A1E490700FE526497C6D06909C6A4A1B,11861,19,23,4,32,47,1647
10394,10394,6C198628670566C9C9E08532404064D2,13601,0,6,6,34,47,1747
10395,10395,6C198628670566C9C9E08532404064D2,12131,7,9,2,32,47,1647
10396,10396,6C198628670566C9C9E08532404064D2,13601,11,20,9,34,47,1747
10397,10397,6C198628670566C9C9E08532404064D2,11861,21,23,2,32,47,1647
10409,10409,9DA070EEB47EB5C73C0FDBCDF75D18DE,42921,0,10,10,33,47,1697
10410,10410,9DA070EEB47EB5C73C0FDBCDF75D18DE,10971,14,15,1,35,47,1797
10411,10411,9DA070EEB47EB5C73C0FDBCDF75D18DE,11151,19,20,1,30,48,1548
10412,10412,9DA070EEB47EB5C73C0FDBCDF75D18DE,13511,21,22,1,34,48,1748
10417,10417,2B30FE33FBF3AFAE54A80917AD235B85,11591,0,6,6,36,49,1849
10418,10418,2B30FE33FBF3AFAE54A80917AD235B85,11231,8,18,10,37,49,1899
10419,10419,2B30FE33FBF3AFAE54A80917AD235B85,11021,20,22,2,36,49,1849
10427,10427,66B7AB5F3784B988607BE36040E97BD0,11491,0,8,8,36,47,1847
10428,10428,66B7AB5F3784B988607BE36040E97BD0,12021,12,13,1,37,49,1899
10429,10429,66B7AB5F3784B988607BE36040E97BD0,11491,19,23,4,36,47,1847
10430,10430,F7992155E293FB3067087BE21378AFA4,43621,7,9,2,46,48,2348
10431,10431,F7992155E293FB3067087BE21378AFA4,42601,12,13,1,44,48,2248
10432,10432,F7992155E293FB3067087BE21378AFA4,43621,14,19,5,46,48,2348
10433,10433,454A0AB6A7ADBC9F5D76E05824AC7428,40123,1,16,15,38,47,1947
10434,10434,454A0AB6A7ADBC9F5D76E05824AC7428,42801,17,18,1,40,49,2049
10435,10435,454A0AB6A7ADBC9F5D76E05824AC7428,10841,19,20,1,37,47,1897
10461,10461,71DEDDA4C7B0A707CDBFFEF21A2BD210,10491,0,18,18,33,48,1698
10462,10462,71DEDDA4C7B0A707CDBFFEF21A2BD210,40094,19,21,2,29,48,1498
10463,10463,71DEDDA4C7B0A707CDBFFEF21A2BD210,10491,21,23,2,33,48,1698
10468,10468,7041DACC5845DDE2B8D8A11FCA80EDC3,42221,0,8,8,38,48,1948
10469,10469,7041DACC5845DDE2B8D8A11FCA80EDC3,42281,12,15,3,40,48,2048
10470,10470,7041DACC5845DDE2B8D8A11FCA80EDC3,11074,15,22,7,37,47,1897
10481,10481,FDEB991F197D09BEFBCB8EC007D54430,11301,0,8,8,41,49,2099
10482,10482,FDEB991F197D09BEFBCB8EC007D54430,12401,18,19,1,39,49,1999
10483,10483,FDEB991F197D09BEFBCB8EC007D54430,40302,22,23,1,40,49,2049
10484,10484,92E340B82C56A45F91D53CD2B709557E,11914,1,2,1,37,48,1898
10485,10485,92E340B82C56A45F91D53CD2B709557E,42581,4,5,1,38,48,1948
10486,10486,92E340B82C56A45F91D53CD2B709557E,11914,7,20,13,37,48,1898
10487,10487,92E340B82C56A45F91D53CD2B709557E,40171,21,23,2,38,48,1948
10492,10492,0635F9DF2EA1E946C4F55221676132EF,43761,0,1,1,32,47,1647
10493,10493,0635F9DF2EA1E946C4F55221676132EF,10281,2,8,6,33,48,1698
10494,10494,0635F9DF2EA1E946C4F55221676132EF,43761,12,22,10,32,47,1647
10499,10499,C54D86E5520DA9763CF81E383AB734CE,11021,5,6,1,36,49,1849
10500,10500,C54D86E5520DA9763CF81E383AB734CE,13731,14,15,1,33,49,1699
10501,10501,C54D86E5520DA9763CF81E383AB734CE,11021,19,22,3,36,49,1849
10508,10508,8FAD0C1D7595BBC5604BC21FB1B8075D,43061,0,14,14,43,46,2196
10509,10509,8FAD0C1D7595BBC5604BC21FB1B8075D,42461,15,16,1,45,47,2297
10510,10510,8FAD0C1D7595BBC5604BC21FB1B8075D,43061,18,19,1,43,46,2196
10519,10519,C6869A64CA9EF97A25D7192A00726FC2,42401,0,6,6,36,47,1847
10520,10520,C6869A64CA9EF97A25D7192A00726FC2,10251,6,18,12,35,47,1797
10521,10521,C6869A64CA9EF97A25D7192A00726FC2,42401,19,23,4,36,47,1847
10522,10522,C2E9303BB2E1C1330D762CE12F5B26AC,43311,0,7,7,31,48,1598
10523,10523,C2E9303BB2E1C1330D762CE12F5B26AC,11061,9,14,5,29,48,1498
10524,10524,C2E9303BB2E1C1330D762CE12F5B26AC,43311,15,17,2,31,48,1598
10525,10525,C2E9303BB2E1C1330D762CE12F5B26AC,11061,19,22,3,29,48,1498
10530,10530,283D32F18C3BA6BD8207C085157E283B,12311,0,10,10,30,44,1544
10531,10531,283D32F18C3BA6BD8207C085157E283B,42531,11,13,2,31,45,1595
10532,10532,283D32F18C3BA6BD8207C085157E283B,12311,14,23,9,30,44,1544
10533,10533,E1C859FD8CC74565ED07635B54DBAB6A,43761,2,4,2,32,47,1647
10534,10534,E1C859FD8CC74565ED07635B54DBAB6A,11061,10,14,4,29,48,1498
10535,10535,E1C859FD8CC74565ED07635B54DBAB6A,43761,17,23,6,32,47,1647
10545,10545,056EED222407FE89673500B918E36977,11381,8,14,6,30,47,1547
10546,10546,056EED222407FE89673500B918E36977,10951,14,15,1,29,48,1498
10547,10547,056EED222407FE89673500B918E36977,11381,18,23,5,30,47,1547
10551,10551,E311A49FD79CE1E67702DBA9B7887B92,12641,0,2,2,10,43,543
10552,10552,E311A49FD79CE1E67702DBA9B7887B92,12921,4,6,2,9,41,491
10553,10553,E311A49FD79CE1E67702DBA9B7887B92,19021,6,17,11,10,45,545
10554,10554,E311A49FD79CE1E67702DBA9B7887B92,12641,19,23,4,10,43,543
10575,10575,716FBFB227B51AA05D4F812E328391F3,19441,0,16,16,8,46,446
10576,10576,716FBFB227B51AA05D4F812E328391F3,42041,17,18,1,10,47,547
10577,10577,716FBFB227B51AA05D4F812E328391F3,19441,18,23,5,8,46,446
10591,10591,1B83FAC3F59813014CE45FBC6E21E9E8,11074,8,14,6,37,47,1897
10592,10592,1B83FAC3F59813014CE45FBC6E21E9E8,13331,18,20,2,38,47,1947
10593,10593,1B83FAC3F59813014CE45FBC6E21E9E8,10841,20,21,1,37,47,1897
10597,10597,0AA9A21AE5592E43C5386C31A83CC971,11021,0,7,7,36,49,1849
10598,10598,0AA9A21AE5592E43C5386C31A83CC971,11751,11,15,4,35,48,1798
10599,10599,0AA9A21AE5592E43C5386C31A83CC971,11021,19,23,4,36,49,1849
10600,10600,5498DED191446DAF33C9E5D38A60FB7C,10544,0,8,8,28,48,1448
10601,10601,5498DED191446DAF33C9E5D38A60FB7C,10381,9,14,5,31,49,1599
10602,10602,5498DED191446DAF33C9E5D38A60FB7C,10544,18,22,4,28,48,1448
10607,10607,7636C02B931F5033A3275CA34FA4048C,42961,0,8,8,35,49,1799
10608,10608,7636C02B931F5033A3275CA34FA4048C,11231,8,18,10,37,49,1899
10609,10609,7636C02B931F5033A3275CA34FA4048C,10121,20,22,2,36,49,1849
10610,10610,78B8E3C473918893D1F1AE571105838F,11381,10,13,3,30,47,1547
10611,10611,78B8E3C473918893D1F1AE571105838F,42521,15,16,1,31,47,1597
10612,10612,78B8E3C473918893D1F1AE571105838F,12381,20,22,2,32,48,1648
10613,10613,03FE0D0BD52A528C1B4DF1F3C44F085B,43241,0,4,4,36,46,1846
10614,10614,03FE0D0BD52A528C1B4DF1F3C44F085B,42231,5,6,1,37,46,1896
10615,10615,03FE0D0BD52A528C1B4DF1F3C44F085B,42351,10,16,6,38,45,1945
10616,10616,03FE0D0BD52A528C1B4DF1F3C44F085B,11941,19,22,3,37,46,1896
10617,10617,A0ABB6B6CBBF7812210D9E6FA5915038,19181,3,4,1,8,40,440
10618,10618,A0ABB6B6CBBF7812210D9E6FA5915038,12921,4,5,1,9,41,491
10619,10619,A0ABB6B6CBBF7812210D9E6FA5915038,19181,9,10,1,8,40,440
10620,10620,A0ABB6B6CBBF7812210D9E6FA5915038,12921,13,23,10,9,41,491
10621,10621,876879B97871A707BFC83782E0A7AC58,11231,0,13,13,37,49,1899
10622,10622,876879B97871A707BFC83782E0A7AC58,10971,14,15,1,35,47,1797
10623,10623,876879B97871A707BFC83782E0A7AC58,11231,15,23,8,37,49,1899
10635,10635,F270E2429049EC12B817A3B7398AF53A,42301,0,2,2,36,47,1847
10636,10636,F270E2429049EC12B817A3B7398AF53A,10111,2,17,15,37,47,1897
10637,10637,F270E2429049EC12B817A3B7398AF53A,42401,19,23,4,36,47,1847
10661,10661,19CFADE53A4E618D30CBCE45D478F0C7,12921,0,6,6,9,41,491
10662,10662,19CFADE53A4E618D30CBCE45D478F0C7,49201,7,9,2,7,41,391
10663,10663,19CFADE53A4E618D30CBCE45D478F0C7,12921,10,22,12,9,41,491
10674,10674,769FD0BE2B6EAC2DA6DBF5A1D4BD64DB,11861,5,14,9,32,47,1647
10675,10675,769FD0BE2B6EAC2DA6DBF5A1D4BD64DB,42301,15,17,2,36,47,1847
10676,10676,769FD0BE2B6EAC2DA6DBF5A1D4BD64DB,11861,18,20,2,32,47,1647
10677,10677,769FD0BE2B6EAC2DA6DBF5A1D4BD64DB,42301,20,22,2,36,47,1847
10678,10678,A99656E991272E2D0207AAB7A175C1B5,42981,0,8,8,36,49,1849
10679,10679,A99656E991272E2D0207AAB7A175C1B5,11781,10,11,1,38,49,1949
10680,10680,A99656E991272E2D0207AAB7A175C1B5,42981,12,23,11,36,49,1849
10681,10681,8E1B59B1D093F12DCE92DD7FCED5EC72,42511,0,8,8,37,47,1897
10682,10682,8E1B59B1D093F12DCE92DD7FCED5EC72,13331,8,9,1,38,47,1947
10683,10683,8E1B59B1D093F12DCE92DD7FCED5EC72,42511,10,20,10,37,47,1897
10684,10684,3721C10D7F23925FE3E8F643424A718E,11914,0,17,17,37,48,1898
10685,10685,3721C10D7F23925FE3E8F643424A718E,10841,17,19,2,37,47,1897
10686,10686,3721C10D7F23925FE3E8F643424A718E,11914,21,23,2,37,48,1898
10687,10687,1CD741282378ACECE229BFA3E57C9431,19441,1,13,12,8,46,446
10688,10688,1CD741282378ACECE229BFA3E57C9431,42041,15,18,3,10,47,547
10689,10689,1CD741282378ACECE229BFA3E57C9431,19441,18,21,3,8,46,446
10690,10690,5C2B763013F3453FD43407A455CBD2B2,13651,0,7,7,30,47,1547
10691,10691,5C2B763013F3453FD43407A455CBD2B2,10951,7,8,1,29,48,1498
10692,10692,5C2B763013F3453FD43407A455CBD2B2,11381,9,18,9,30,47,1547
10693,10693,5C2B763013F3453FD43407A455CBD2B2,10951,19,20,1,29,48,1498
10694,10694,7258BD809B9533F9D882FC2A6D37FD1F,13371,0,10,10,41,47,2097
10695,10695,7258BD809B9533F9D882FC2A6D37FD1F,10601,13,21,8,39,47,1997
10696,10696,7258BD809B9533F9D882FC2A6D37FD1F,13371,21,23,2,41,47,2097
10697,10697,E3EF3D7EF93CC9E529BB5EE547514ED6,11861,0,1,1,32,47,1647
10698,10698,E3EF3D7EF93CC9E529BB5EE547514ED6,42921,3,9,6,33,47,1697
10699,10699,E3EF3D7EF93CC9E529BB5EE547514ED6,40981,11,19,8,34,47,1747
10700,10700,90BDA16C4F6281AE9AFB01EAEB1C60F5,10292,0,9,9,30,47,1547
10701,10701,90BDA16C4F6281AE9AFB01EAEB1C60F5,42491,11,13,2,32,46,1646
10702,10702,90BDA16C4F6281AE9AFB01EAEB1C60F5,10295,16,18,2,30,47,1547
10712,10712,95471D684DB585D0049B7AB0C8B83123,11061,2,7,5,29,48,1498
10713,10713,95471D684DB585D0049B7AB0C8B83123,40445,9,10,1,30,48,1548
10714,10714,95471D684DB585D0049B7AB0C8B83123,11061,11,19,8,29,48,1498
10722,10722,64C897065E9EDCA8A69F38A94EFB9055,10151,0,14,14,34,47,1747
10723,10723,64C897065E9EDCA8A69F38A94EFB9055,10651,16,17,1,36,49,1849
10724,10724,64C897065E9EDCA8A69F38A94EFB9055,10151,18,23,5,34,47,1747
10729,10729,27B6DDFE3A356062F221ABD7AD70BB14,11061,0,10,10,29,48,1498
10730,10730,27B6DDFE3A356062F221ABD7AD70BB14,10681,10,14,4,30,48,1548
10731,10731,27B6DDFE3A356062F221ABD7AD70BB14,11061,15,23,8,29,48,1498
10738,10738,97EED02186157B67ACCA35C5CC13851D,10251,7,11,4,35,47,1797
10739,10739,97EED02186157B67ACCA35C5CC13851D,11331,12,18,6,37,48,1898
10740,10740,97EED02186157B67ACCA35C5CC13851D,13601,19,22,3,34,47,1747
10741,10741,AA94328A21E669C14B53998CC009A981,13411,0,1,1,49,42,2492
10742,10742,AA94328A21E669C14B53998CC009A981,43951,1,3,2,49,41,2491
10743,10743,AA94328A21E669C14B53998CC009A981,13821,8,18,10,49,45,2495
10744,10744,AA94328A21E669C14B53998CC009A981,43951,21,22,1,49,41,2491
10753,10753,FAA298AF107D9B6221B0548A6789EBBC,10171,0,8,8,26,47,1347
10754,10754,FAA298AF107D9B6221B0548A6789EBBC,40094,10,13,3,29,48,1498
10755,10755,FAA298AF107D9B6221B0548A6789EBBC,10171,14,23,9,26,47,1347
10760,10760,CEF1ABFE94920422247AC22399F7761F,11001,0,6,6,42,47,2147
10761,10761,CEF1ABFE94920422247AC22399F7761F,42091,8,10,2,43,46,2196
10762,10762,CEF1ABFE94920422247AC22399F7761F,11001,11,12,1,42,47,2147
10763,10763,CEF1ABFE94920422247AC22399F7761F,42461,16,18,2,45,47,2297
10764,10764,1A9DAEEEE45E6D6064E98B4F317D57C3,42271,0,15,15,40,47,2047
10765,10765,1A9DAEEEE45E6D6064E98B4F317D57C3,12514,16,18,2,38,47,1947
10766,10766,1A9DAEEEE45E6D6064E98B4F317D57C3,42271,18,23,5,40,47,2047
10781,10781,0CEDFC599FE515911C8AF1ADD0F867C7,42511,5,6,1,37,47,1897
10782,10782,0CEDFC599FE515911C8AF1ADD0F867C7,42301,9,12,3,36,47,1847
10783,10783,0CEDFC599FE515911C8AF1ADD0F867C7,10841,12,22,10,37,47,1897
10784,10784,EE2263C7C7ABF2C8EEA82DD87831D098,10881,1,8,7,34,48,1748
10785,10785,EE2263C7C7ABF2C8EEA82DD87831D098,11201,9,10,1,35,49,1799
10786,10786,EE2263C7C7ABF2C8EEA82DD87831D098,43731,14,18,4,34,47,1747
10787,10787,EE2263C7C7ABF2C8EEA82DD87831D098,40171,18,20,2,38,48,1948
10791,10791,B95202C76CD4286A3C9F87108125087E,42523,0,14,14,31,47,1597
10792,10792,B95202C76CD4286A3C9F87108125087E,10292,14,16,2,30,47,1547
10793,10793,B95202C76CD4286A3C9F87108125087E,11161,16,18,2,32,48,1648
10802,10802,936F3EAEFFE6D40274671E4FB3E6BD97,11941,0,6,6,37,46,1896
10803,10803,936F3EAEFFE6D40274671E4FB3E6BD97,10841,9,17,8,37,47,1897
10804,10804,936F3EAEFFE6D40274671E4FB3E6BD97,11941,19,23,4,37,46,1896
10819,10819,EE90AC07F32E2A1C202B40D69F71501C,12491,0,13,13,36,43,1843
10820,10820,EE90AC07F32E2A1C202B40D69F71501C,43451,14,16,2,37,40,1890
10821,10821,EE90AC07F32E2A1C202B40D69F71501C,12491,19,23,4,36,43,1843
10832,10832,01CD6BF877551B8319D2A3600B409A38,12121,1,10,9,29,47,1497
10833,10833,01CD6BF877551B8319D2A3600B409A38,11381,12,15,3,30,47,1547
10834,10834,01CD6BF877551B8319D2A3600B409A38,11061,19,20,1,29,48,1498
10835,10835,01CD6BF877551B8319D2A3600B409A38,40445,20,21,1,30,48,1548
10836,10836,4D239E998445105BB1DB28C4CB8040D2,42581,1,6,5,38,48,1948
10837,10837,4D239E998445105BB1DB28C4CB8040D2,10471,7,17,10,37,48,1898
10838,10838,4D239E998445105BB1DB28C4CB8040D2,42581,18,23,5,38,48,1948
10844,10844,B4384B03AA2ADCFD4B5B44E462DB395A,43761,3,5,2,32,47,1647
10845,10845,B4384B03AA2ADCFD4B5B44E462DB395A,42523,6,8,2,31,47,1597
10846,10846,B4384B03AA2ADCFD4B5B44E462DB395A,43761,8,22,14,32,47,1647
10847,10847,B7F88F70D1C21229F59E90B88D6BA4E9,12921,0,1,1,9,41,491
10848,10848,B7F88F70D1C21229F59E90B88D6BA4E9,19181,2,4,2,8,40,440
10849,10849,B7F88F70D1C21229F59E90B88D6BA4E9,12921,4,13,9,9,41,491
10850,10850,B7F88F70D1C21229F59E90B88D6BA4E9,49201,17,19,2,7,41,391
10856,10856,EA76F6018E37635F2D98F3C61FC7376D,13331,1,8,7,38,47,1947
10857,10857,EA76F6018E37635F2D98F3C61FC7376D,11074,10,11,1,37,47,1897
10858,10858,EA76F6018E37635F2D98F3C61FC7376D,13331,12,16,4,38,47,1947
10859,10859,EA76F6018E37635F2D98F3C61FC7376D,11074,19,20,1,37,47,1897
10870,10870,2D082606BA6B389D2ADB4E6E15C5D25F,42141,1,15,14,32,47,1647
10871,10871,2D082606BA6B389D2ADB4E6E15C5D25F,13601,16,17,1,34,47,1747
10872,10872,2D082606BA6B389D2ADB4E6E15C5D25F,43761,22,23,1,32,47,1647
10873,10873,9027D7BCCA8B9488D727103093A0EE77,13341,1,14,13,44,45,2245
10874,10874,9027D7BCCA8B9488D727103093A0EE77,42631,17,19,2,43,45,2195
10875,10875,9027D7BCCA8B9488D727103093A0EE77,13341,19,20,1,44,45,2245
10876,10876,4FEDDE4724DDA61E19979F6B8E0B84B5,42301,0,7,7,36,47,1847
10877,10877,4FEDDE4724DDA61E19979F6B8E0B84B5,10271,8,15,7,37,46,1896
10878,10878,4FEDDE4724DDA61E19979F6B8E0B84B5,13121,15,17,2,38,46,1946
10879,10879,4FEDDE4724DDA61E19979F6B8E0B84B5,42511,19,22,3,37,47,1897
10880,10880,D0819644627AC00B1760F57708B6F7FF,41393,2,16,14,43,49,2199
10881,10881,D0819644627AC00B1760F57708B6F7FF,43621,19,21,2,46,48,2348
10882,10882,D0819644627AC00B1760F57708B6F7FF,41393,21,22,1,43,49,2199
10888,10888,A18E604F6E21B36C655ED57648BC9F76,10121,1,9,8,36,49,1849
10889,10889,A18E604F6E21B36C655ED57648BC9F76,11231,11,12,1,37,49,1899
10890,10890,A18E604F6E21B36C655ED57648BC9F76,11591,14,17,3,36,49,1849
10891,10891,A18E604F6E21B36C655ED57648BC9F76,11231,17,22,5,37,49,1899
10897,10897,597064D826C3E01F204980F028CA1A17,42861,0,14,14,37,44,1894
10898,10898,597064D826C3E01F204980F028CA1A17,11261,16,17,1,36,46,1846
10899,10899,597064D826C3E01F204980F028CA1A17,42861,19,22,3,37,44,1894
10925,10925,5CD91E60AE04D9AB04DFAC1F5D36AFBF,11021,0,8,8,36,49,1849
10926,10926,5CD91E60AE04D9AB04DFAC1F5D36AFBF,11531,12,13,1,34,49,1749
10927,10927,5CD91E60AE04D9AB04DFAC1F5D36AFBF,11231,19,20,1,37,49,1899
10928,10928,5CD91E60AE04D9AB04DFAC1F5D36AFBF,40637,21,23,2,36,47,1847
10942,10942,4F69DAC3A21C54E36EAB2A3789180EF9,13271,0,7,7,41,47,2097
10943,10943,4F69DAC3A21C54E36EAB2A3789180EF9,13101,18,19,1,40,47,2047
10944,10944,4F69DAC3A21C54E36EAB2A3789180EF9,13271,20,21,1,41,47,2097
10945,10945,7593D7AED856FF2FC2E20D8E8570438A,40171,1,2,1,38,48,1948
10946,10946,7593D7AED856FF2FC2E20D8E8570438A,10471,6,14,8,37,48,1898
10947,10947,7593D7AED856FF2FC2E20D8E8570438A,12514,14,15,1,38,47,1947
10948,10948,7593D7AED856FF2FC2E20D8E8570438A,11914,18,23,5,37,48,1898
10949,10949,E06FC86426E546DF6B8D146F4C749C15,10281,0,7,7,33,48,1698
10950,10950,E06FC86426E546DF6B8D146F4C749C15,11861,11,18,7,32,47,1647
10951,10951,E06FC86426E546DF6B8D146F4C749C15,11271,19,20,1,37,48,1898
10952,10952,E06FC86426E546DF6B8D146F4C749C15,11861,21,22,1,32,47,1647
10959,10959,EE6B8585E25BB845D2DA0A95F88FAB79,13911,1,15,14,39,46,1996
10960,10960,EE6B8585E25BB845D2DA0A95F88FAB79,42231,15,17,2,37,46,1896
10961,10961,EE6B8585E25BB845D2DA0A95F88FAB79,13911,17,23,6,39,46,1996
10962,10962,435E98F8E4BA1C5ED5B064CF22D1AAF1,40302,0,15,15,40,49,2049
10963,10963,435E98F8E4BA1C5ED5B064CF22D1AAF1,11771,18,19,1,39,49,1999
10964,10964,435E98F8E4BA1C5ED5B064CF22D1AAF1,11461,21,22,1,37,49,1899
10968,10968,FC32FCDE5EA162E6A3931CE10EF22190,11021,1,2,1,36,49,1849
10969,10969,FC32FCDE5EA162E6A3931CE10EF22190,11231,7,11,4,37,49,1899
10970,10970,FC32FCDE5EA162E6A3931CE10EF22190,11021,12,23,11,36,49,1849
10978,10978,52DE1B5B29EB088C4F7CC0D4865B38F5,42861,2,15,13,37,44,1894
10979,10979,52DE1B5B29EB088C4F7CC0D4865B38F5,42151,15,16,1,35,45,1795
10980,10980,52DE1B5B29EB088C4F7CC0D4865B38F5,42861,21,22,1,37,44,1894
11026,11026,66F421352C22D8571066F0AF8EA7BD0D,10251,1,9,8,35,47,1797
11027,11027,66F421352C22D8571066F0AF8EA7BD0D,10491,10,11,1,33,48,1698
11028,11028,66F421352C22D8571066F0AF8EA7BD0D,10251,15,17,2,35,47,1797
11029,11029,66F421352C22D8571066F0AF8EA7BD0D,11861,19,22,3,32,47,1647
11053,11053,34B0487DA91675A6216B605C367EE35D,40094,3,5,2,29,48,1498
11054,11054,34B0487DA91675A6216B605C367EE35D,43581,8,18,10,33,48,1698
11055,11055,34B0487DA91675A6216B605C367EE35D,40094,19,23,4,29,48,1498
11065,11065,63E113647B076FC93CF9833FECFEFE8C,11381,5,17,12,30,47,1547
11066,11066,63E113647B076FC93CF9833FECFEFE8C,10951,17,19,2,29,48,1498
11067,11067,63E113647B076FC93CF9833FECFEFE8C,11381,19,20,1,30,47,1547
11081,11081,8EDC20F0B510B8C789B21A1A5BF0D26C,10471,0,7,7,37,48,1898
11082,11082,8EDC20F0B510B8C789B21A1A5BF0D26C,12391,9,11,2,36,49,1849
11083,11083,8EDC20F0B510B8C789B21A1A5BF0D26C,10471,12,21,9,37,48,1898
11084,11084,B06807506E2AFABFBA9544E9199E7345,40302,0,6,6,40,49,2049
11085,11085,B06807506E2AFABFBA9544E9199E7345,10107,7,16,9,38,49,1949
11086,11086,B06807506E2AFABFBA9544E9199E7345,40302,17,19,2,40,49,2049
11087,11087,50A8D48EEDC025C19A5AA5E39B3A8340,43761,1,17,16,32,47,1647
11088,11088,50A8D48EEDC025C19A5AA5E39B3A8340,43731,17,19,2,34,47,1747
11089,11089,50A8D48EEDC025C19A5AA5E39B3A8340,11861,19,23,4,32,47,1647
11102,11102,4C13C3D7416FEE47C7E01DACD89CC954,10301,0,13,13,31,45,1595
11103,11103,4C13C3D7416FEE47C7E01DACD89CC954,12311,14,15,1,30,44,1544
11104,11104,4C13C3D7416FEE47C7E01DACD89CC954,10301,17,20,3,31,45,1595
11134,11134,6F3F4688F888FF4011915135083334C6,19114,0,6,6,7,43,393
11135,11135,6F3F4688F888FF4011915135083334C6,12921,6,7,1,9,41,491
11136,11136,6F3F4688F888FF4011915135083334C6,19114,8,18,10,7,43,393
11137,11137,2E5B93B6FE04610C56A0B33EE6E9E88D,11361,0,9,9,22,48,1148
11138,11138,2E5B93B6FE04610C56A0B33EE6E9E88D,42691,11,14,3,24,48,1248
11139,11139,2E5B93B6FE04610C56A0B33EE6E9E88D,11361,16,18,2,22,48,1148
11140,11140,2E5B93B6FE04610C56A0B33EE6E9E88D,43751,19,22,3,19,48,998
11149,11149,5A8308F9DAAF40265186D4E63F2640C9,12381,0,7,7,32,48,1648
11150,11150,5A8308F9DAAF40265186D4E63F2640C9,13731,7,17,10,33,49,1699
11151,11151,5A8308F9DAAF40265186D4E63F2640C9,12381,19,23,4,32,48,1648
11152,11152,4C0C7E2E98D34BFC05A247F4B04AD70C,13381,0,18,18,39,47,1997
11153,11153,4C0C7E2E98D34BFC05A247F4B04AD70C,13941,18,20,2,41,47,2097
11154,11154,4C0C7E2E98D34BFC05A247F4B04AD70C,13381,21,23,2,39,47,1997
11155,11155,C2DA48245CD941C09EA1CD154E210FD0,42301,0,17,17,36,47,1847
11156,11156,C2DA48245CD941C09EA1CD154E210FD0,10841,17,19,2,37,47,1897
11157,11157,C2DA48245CD941C09EA1CD154E210FD0,42161,22,23,1,36,47,1847
11166,11166,AA1231BD9F0A305E6AC7CD5DF0C0F2A0,42301,0,11,11,36,47,1847
11167,11167,AA1231BD9F0A305E6AC7CD5DF0C0F2A0,10841,15,16,1,37,47,1897
11168,11168,AA1231BD9F0A305E6AC7CD5DF0C0F2A0,42301,17,23,6,36,47,1847
11201,11201,DEF2119ECB90D4385AD1A45A0B2C7A35,43761,0,3,3,32,47,1647
11202,11202,DEF2119ECB90D4385AD1A45A0B2C7A35,42523,6,9,3,31,47,1597
11203,11203,DEF2119ECB90D4385AD1A45A0B2C7A35,43761,9,22,13,32,47,1647
11204,11204,5ADA9660158083BA681D3EABE7C6BBBF,42864,0,4,4,38,44,1944
11205,11205,5ADA9660158083BA681D3EABE7C6BBBF,42861,6,9,3,37,44,1894
11206,11206,5ADA9660158083BA681D3EABE7C6BBBF,42231,10,11,1,37,46,1896
11207,11207,5ADA9660158083BA681D3EABE7C6BBBF,42864,16,23,7,38,44,1944
11211,11211,08ED71CE24650E4C5871DE9F1B7827AF,13941,0,13,13,41,47,2097
11212,11212,08ED71CE24650E4C5871DE9F1B7827AF,11001,14,16,2,42,47,2147
11213,11213,08ED71CE24650E4C5871DE9F1B7827AF,13941,18,20,2,41,47,2097
11224,11224,E199B3085D360FC080BC4E15FA4A56AD,43581,0,6,6,33,48,1698
11225,11225,E199B3085D360FC080BC4E15FA4A56AD,11861,8,15,7,32,47,1647
11226,11226,E199B3085D360FC080BC4E15FA4A56AD,12031,19,22,3,33,48,1698
11227,11227,A0A00D4FFCF39B121347488247DF3626,12311,0,5,5,30,44,1544
11228,11228,A0A00D4FFCF39B121347488247DF3626,11875,6,13,7,30,46,1546
11229,11229,A0A00D4FFCF39B121347488247DF3626,12311,16,19,3,30,44,1544
11234,11234,26E97CCAAB10F50751FB25FC2D6D6457,42861,5,11,6,37,44,1894
11235,11235,26E97CCAAB10F50751FB25FC2D6D6457,11261,11,13,2,36,46,1846
11236,11236,26E97CCAAB10F50751FB25FC2D6D6457,42861,14,18,4,37,44,1894
11237,11237,26E97CCAAB10F50751FB25FC2D6D6457,11261,19,20,1,36,46,1846
11238,11238,16C7E2BB7A5E5EDDEB0437BAEEE6DA98,42161,0,8,8,36,47,1847
11239,11239,16C7E2BB7A5E5EDDEB0437BAEEE6DA98,43241,18,20,2,36,46,1846
11240,11240,16C7E2BB7A5E5EDDEB0437BAEEE6DA98,42771,20,23,3,36,47,1847
11249,11249,1C346B8F39A0224A8EDBA10AEC88A4FF,10471,0,16,16,37,48,1898
11250,11250,1C346B8F39A0224A8EDBA10AEC88A4FF,11771,16,19,3,39,49,1999
11251,11251,1C346B8F39A0224A8EDBA10AEC88A4FF,10471,20,23,3,37,48,1898
11275,11275,C21989F99D3B120EE23386DE2361CA67,42231,0,8,8,37,46,1896
11276,11276,C21989F99D3B120EE23386DE2361CA67,10841,11,12,1,37,47,1897
11277,11277,C21989F99D3B120EE23386DE2361CA67,42231,17,22,5,37,46,1896
11278,11278,A584DB5FF6EE02AE16BAE873BBEDDAA1,12921,0,10,10,9,41,491
11279,11279,A584DB5FF6EE02AE16BAE873BBEDDAA1,19181,10,16,6,8,40,440
11280,11280,A584DB5FF6EE02AE16BAE873BBEDDAA1,12921,17,23,6,9,41,491
11281,11281,0277E6ABE6E23FB8B51E9078601CBBC1,42491,0,8,8,32,46,1646
11282,11282,0277E6ABE6E23FB8B51E9078601CBBC1,42523,10,16,6,31,47,1597
11283,11283,0277E6ABE6E23FB8B51E9078601CBBC1,42491,21,22,1,32,46,1646
11284,11284,2FC852B4FFDF067DECF04814ED84AACA,42511,0,9,9,37,47,1897
11285,11285,2FC852B4FFDF067DECF04814ED84AACA,10271,10,16,6,37,46,1896
11286,11286,2FC852B4FFDF067DECF04814ED84AACA,42511,20,22,2,37,47,1897
11292,11292,F8EA0C68F3C8266C3E7BA4F2FCE6F8BC,19441,0,7,7,8,46,446
11293,11293,F8EA0C68F3C8266C3E7BA4F2FCE6F8BC,42041,7,9,2,10,47,547
11294,11294,F8EA0C68F3C8266C3E7BA4F2FCE6F8BC,19441,12,20,8,8,46,446
11295,11295,3DA0BCC83518894F0CE5D638362ECC1B,43731,0,17,17,34,47,1747
11296,11296,3DA0BCC83518894F0CE5D638362ECC1B,10971,17,21,4,35,47,1797
11297,11297,3DA0BCC83518894F0CE5D638362ECC1B,43731,21,22,1,34,47,1747
11298,11298,B46F7CFBF42B8DF5990A028C3A15EF50,42531,0,10,10,31,45,1595
11299,11299,B46F7CFBF42B8DF5990A028C3A15EF50,12311,11,14,3,30,44,1544
11300,11300,B46F7CFBF42B8DF5990A028C3A15EF50,42531,16,21,5,31,45,1595
11301,11301,53B252291F2CAD2164BB97EE14FF9349,13071,2,14,12,41,41,2091
11302,11302,53B252291F2CAD2164BB97EE14FF9349,43011,16,18,2,40,42,2042
11303,11303,53B252291F2CAD2164BB97EE14FF9349,13071,19,22,3,41,41,2091
11323,11323,968616CCBF964040CCE17F91EF27B356,12511,10,12,2,39,47,1997
11324,11324,968616CCBF964040CCE17F91EF27B356,10411,13,18,5,36,48,1848
11325,11325,968616CCBF964040CCE17F91EF27B356,42321,20,21,1,43,47,2197
11326,11326,968616CCBF964040CCE17F91EF27B356,13371,21,23,2,41,47,2097
11341,11341,C7FD2E7279929E720FB03466CB10E8E1,12514,6,9,3,38,47,1947
11342,11342,C7FD2E7279929E720FB03466CB10E8E1,42511,11,16,5,37,47,1897
11343,11343,C7FD2E7279929E720FB03466CB10E8E1,12514,17,19,2,38,47,1947
11344,11344,C7FD2E7279929E720FB03466CB10E8E1,42221,20,22,2,38,48,1948
11345,11345,186BCCF3E4C291B31BC4BB9662DF9417,42141,0,14,14,32,47,1647
11346,11346,186BCCF3E4C291B31BC4BB9662DF9417,10281,16,17,1,33,48,1698
11347,11347,186BCCF3E4C291B31BC4BB9662DF9417,43761,18,23,5,32,47,1647
11361,11361,884C9210F61ADBFD1EDE89A3EAB05C30,13101,0,7,7,40,47,2047
11362,11362,884C9210F61ADBFD1EDE89A3EAB05C30,13271,7,9,2,41,47,2097
11363,11363,884C9210F61ADBFD1EDE89A3EAB05C30,13101,10,16,6,40,47,2047
11364,11364,884C9210F61ADBFD1EDE89A3EAB05C30,13271,17,21,4,41,47,2097
11365,11365,572FC1924B3D406C6B95088F85214228,19441,8,11,3,8,46,446
11366,11366,572FC1924B3D406C6B95088F85214228,42041,12,13,1,10,47,547
11367,11367,572FC1924B3D406C6B95088F85214228,19441,13,18,5,8,46,446
11368,11368,572FC1924B3D406C6B95088F85214228,42041,19,23,4,10,47,547
11391,11391,E6EB0FFE7655FB9A9B77EC908104A8C3,11381,0,8,8,30,47,1547
11392,11392,E6EB0FFE7655FB9A9B77EC908104A8C3,10951,9,16,7,29,48,1498
11393,11393,E6EB0FFE7655FB9A9B77EC908104A8C3,11381,19,22,3,30,47,1547
11402,11402,7BC84DBBA2D73C605C4D8BBF11C620B2,42231,0,6,6,37,46,1896
11403,11403,7BC84DBBA2D73C605C4D8BBF11C620B2,43241,10,12,2,36,46,1846
11404,11404,7BC84DBBA2D73C605C4D8BBF11C620B2,13121,15,16,1,38,46,1946
11405,11405,7BC84DBBA2D73C605C4D8BBF11C620B2,13911,18,19,1,39,46,1996
11409,11409,06447D7C67D558233065F1766A844E28,13411,0,12,12,49,42,2492
11410,11410,06447D7C67D558233065F1766A844E28,43951,16,17,1,49,41,2491
11411,11411,06447D7C67D558233065F1766A844E28,13411,18,23,5,49,42,2492
11412,11412,F2091902BA005B733C221C2A68412BCF,43751,0,3,3,19,48,998
11413,11413,F2091902BA005B733C221C2A68412BCF,11361,6,8,2,22,48,1148
11414,11414,F2091902BA005B733C221C2A68412BCF,43751,8,22,14,19,48,998
11415,11415,964156E683797EC321E31C806CD19178,11914,0,11,11,37,48,1898
11416,11416,964156E683797EC321E31C806CD19178,11921,16,17,1,38,48,1948
11417,11417,964156E683797EC321E31C806CD19178,11914,19,22,3,37,48,1898
11421,11421,A300EE82D3804DCD52238D1B3DB8649A,11074,0,8,8,37,47,1897
11422,11422,A300EE82D3804DCD52238D1B3DB8649A,11261,8,11,3,36,46,1846
11423,11423,A300EE82D3804DCD52238D1B3DB8649A,42864,13,14,1,38,44,1944
11424,11424,A300EE82D3804DCD52238D1B3DB8649A,11074,18,23,5,37,47,1897
11425,11425,377BD5B9C037AF000CC29F45169CD1E4,11231,0,9,9,37,49,1899
11426,11426,377BD5B9C037AF000CC29F45169CD1E4,10471,10,12,2,37,48,1898
11427,11427,377BD5B9C037AF000CC29F45169CD1E4,41091,13,16,3,35,49,1799
11428,11428,377BD5B9C037AF000CC29F45169CD1E4,11231,16,23,7,37,49,1899
11429,11429,4FA33CD13B40E0CA97628D6E7FA3E1FD,42581,3,7,4,38,48,1948
11430,11430,4FA33CD13B40E0CA97628D6E7FA3E1FD,11914,11,12,1,37,48,1898
11431,11431,4FA33CD13B40E0CA97628D6E7FA3E1FD,42581,15,22,7,38,48,1948
11432,11432,698E1A34C01E7972A66B3ED2C9BEE544,40637,0,7,7,36,47,1847
11433,11433,698E1A34C01E7972A66B3ED2C9BEE544,10251,12,14,2,35,47,1797
11434,11434,698E1A34C01E7972A66B3ED2C9BEE544,40637,18,20,2,36,47,1847
11435,11435,53650105F7F25F79263F92D3A7D439AB,42461,0,14,14,45,47,2297
11436,11436,53650105F7F25F79263F92D3A7D439AB,11001,15,16,1,42,47,2147
11437,11437,53650105F7F25F79263F92D3A7D439AB,42461,17,19,2,45,47,2297
11447,11447,4CA28E087D95A72AF97BE17DAF5BCBF2,13091,1,2,1,20,42,1042
11448,11448,4CA28E087D95A72AF97BE17DAF5BCBF2,12731,5,17,12,22,40,1140
11449,11449,4CA28E087D95A72AF97BE17DAF5BCBF2,13091,18,19,1,20,42,1042
11450,11450,4CA28E087D95A72AF97BE17DAF5BCBF2,12731,20,23,3,22,40,1140
11456,11456,FC0936587C74EF8144A5D7B54D78302D,19021,1,3,2,10,45,545
11457,11457,FC0936587C74EF8144A5D7B54D78302D,11571,7,15,8,13,46,696
11458,11458,FC0936587C74EF8144A5D7B54D78302D,19021,16,22,6,10,45,545
11465,11465,9B6852556CEBC93A71C86A94C097F1AF,10971,5,12,7,35,47,1797
11466,11466,9B6852556CEBC93A71C86A94C097F1AF,42021,12,14,2,33,47,1697
11467,11467,9B6852556CEBC93A71C86A94C097F1AF,10971,15,16,1,35,47,1797
11468,11468,9B6852556CEBC93A71C86A94C097F1AF,42021,16,22,6,33,47,1697
11469,11469,C113C3BFA8200BB19492C01042EDAB2E,10351,2,5,3,28,45,1445
11470,11470,C113C3BFA8200BB19492C01042EDAB2E,10634,7,9,2,27,45,1395
11471,11471,C113C3BFA8200BB19492C01042EDAB2E,10351,13,23,10,28,45,1445
11472,11472,ED389B0738C21DFCB029EF12B67F5260,42271,0,3,3,40,47,2047
11473,11473,ED389B0738C21DFCB029EF12B67F5260,11806,5,6,1,41,48,2098
11474,11474,ED389B0738C21DFCB029EF12B67F5260,42271,6,20,14,40,47,2047
11478,11478,F4A6A402BBA57C6D1D28948641A481D2,19114,8,9,1,7,43,393
11479,11479,F4A6A402BBA57C6D1D28948641A481D2,12641,9,19,10,10,43,543
11480,11480,F4A6A402BBA57C6D1D28948641A481D2,19114,21,23,2,7,43,393
11485,11485,111CDDD5FA2E313735C2BD7B109AA3EE,42151,5,10,5,35,45,1795
11486,11486,111CDDD5FA2E313735C2BD7B109AA3EE,42861,11,13,2,37,44,1894
11487,11487,111CDDD5FA2E313735C2BD7B109AA3EE,42151,15,21,6,35,45,1795
11488,11488,4E22CAE8774A9F064D48507CF8FECB20,11901,0,8,8,42,49,2149
11489,11489,4E22CAE8774A9F064D48507CF8FECB20,11481,9,10,1,41,48,2098
11490,11490,4E22CAE8774A9F064D48507CF8FECB20,11901,13,23,10,42,49,2149
11491,11491,ACB823DB33D22CC4344D979C1DDF92F4,42861,8,11,3,37,44,1894
11492,11492,ACB823DB33D22CC4344D979C1DDF92F4,11261,13,14,1,36,46,1846
11493,11493,ACB823DB33D22CC4344D979C1DDF92F4,42861,15,19,4,37,44,1894
11506,11506,440A5BC995406F5A39B97937FE6675EC,12641,0,14,14,10,43,543
11507,11507,440A5BC995406F5A39B97937FE6675EC,12921,14,16,2,9,41,491
11508,11508,440A5BC995406F5A39B97937FE6675EC,12641,18,22,4,10,43,543
11514,11514,E2543039870B29734FB2F812D1412F40,43581,0,6,6,33,48,1698
11515,11515,E2543039870B29734FB2F812D1412F40,11861,7,16,9,32,47,1647
11516,11516,E2543039870B29734FB2F812D1412F40,12031,19,23,4,33,48,1698
11525,11525,43DBC097DABD3DD07A95B28C32F20D40,13371,0,6,6,41,47,2097
11526,11526,43DBC097DABD3DD07A95B28C32F20D40,11661,7,10,3,40,49,2049
11527,11527,43DBC097DABD3DD07A95B28C32F20D40,13371,12,23,11,41,47,2097
11540,11540,190C9871035218EA70C46D6AA28FE512,11951,0,10,10,31,49,1599
11541,11541,190C9871035218EA70C46D6AA28FE512,11954,16,20,4,32,49,1649
11542,11542,190C9871035218EA70C46D6AA28FE512,43471,22,23,1,31,49,1599
11543,11543,CB5E46995B8492D52A7DD5D4E7BE7539,11954,0,2,2,32,49,1649
11544,11544,CB5E46995B8492D52A7DD5D4E7BE7539,11951,4,6,2,31,49,1599
11545,11545,CB5E46995B8492D52A7DD5D4E7BE7539,13731,18,20,2,33,49,1699
11546,11546,CB5E46995B8492D52A7DD5D4E7BE7539,11951,20,22,2,31,49,1599
11547,11547,895085FE0B62D7BCDF8725B5DB48E546,42521,0,6,6,31,47,1597
11548,11548,895085FE0B62D7BCDF8725B5DB48E546,11061,8,15,7,29,48,1498
11549,11549,895085FE0B62D7BCDF8725B5DB48E546,42521,15,23,8,31,47,1597
11555,11555,E41EFAEAC6CC7189E20FB98542ADB1CF,13101,0,8,8,40,47,2047
11556,11556,E41EFAEAC6CC7189E20FB98542ADB1CF,11804,10,11,1,41,48,2098
11557,11557,E41EFAEAC6CC7189E20FB98542ADB1CF,13101,21,23,2,40,47,2047
11564,11564,2D7ACF8AD7E4B49F2A7FD23DB75DC6F1,42971,0,6,6,43,49,2199
11565,11565,2D7ACF8AD7E4B49F2A7FD23DB75DC6F1,10921,9,11,2,43,48,2198
11566,11566,2D7ACF8AD7E4B49F2A7FD23DB75DC6F1,42971,12,23,11,43,49,2199
11567,11567,37D12B9A785069D9567B986D8917ECC5,10351,1,14,13,28,45,1445
11568,11568,37D12B9A785069D9567B986D8917ECC5,10634,18,20,2,27,45,1395
11569,11569,37D12B9A785069D9567B986D8917ECC5,10351,20,23,3,28,45,1445
11573,11573,A3BFED7EBC8273A150663075EB9361B2,11271,3,4,1,37,48,1898
11574,11574,A3BFED7EBC8273A150663075EB9361B2,12391,4,20,16,36,49,1849
11575,11575,A3BFED7EBC8273A150663075EB9361B2,11271,20,22,2,37,48,1898
11583,11583,EC3702B6D1EF3E2036629A2FF6DCF74A,43761,0,8,8,32,47,1647
11584,11584,EC3702B6D1EF3E2036629A2FF6DCF74A,42021,12,13,1,33,47,1697
11585,11585,EC3702B6D1EF3E2036629A2FF6DCF74A,10531,17,19,2,34,46,1746
11586,11586,75B6D91479467607B0BA166BDAF35CA1,10431,0,6,6,33,49,1699
11587,11587,75B6D91479467607B0BA166BDAF35CA1,43581,9,10,1,33,48,1698
11588,11588,75B6D91479467607B0BA166BDAF35CA1,10431,11,23,12,33,49,1699
11602,11602,19277B7E69AB8390412A422FFAA1C16F,10301,0,1,1,31,45,1595
11603,11603,19277B7E69AB8390412A422FFAA1C16F,42871,1,8,7,30,45,1545
11604,11604,19277B7E69AB8390412A422FFAA1C16F,10711,13,14,1,29,46,1496
11605,11605,19277B7E69AB8390412A422FFAA1C16F,42871,16,20,4,30,45,1545
11614,11614,720B1030F9AA451F5DB7F94C393FD381,11801,0,2,2,42,48,2148
11615,11615,720B1030F9AA451F5DB7F94C393FD381,12651,2,13,11,43,47,2197
11616,11616,720B1030F9AA451F5DB7F94C393FD381,11701,16,19,3,43,48,2198
11617,11617,C13EDA65C3B019881628338CF4BA6FEF,42523,9,10,1,31,47,1597
11618,11618,C13EDA65C3B019881628338CF4BA6FEF,42491,11,14,3,32,46,1646
11619,11619,C13EDA65C3B019881628338CF4BA6FEF,42523,18,21,3,31,47,1597
11620,11620,D1348284A12247DBF7195CE953852CD8,43311,0,14,14,31,48,1598
11621,11621,D1348284A12247DBF7195CE953852CD8,11061,15,17,2,29,48,1498
11622,11622,D1348284A12247DBF7195CE953852CD8,11161,19,21,2,32,48,1648
11626,11626,DC6F2750E1589D9E93BB09689CD15111,10401,1,5,4,33,49,1699
11627,11627,DC6F2750E1589D9E93BB09689CD15111,11954,10,15,5,32,49,1649
11628,11628,DC6F2750E1589D9E93BB09689CD15111,13731,20,22,2,33,49,1699
11655,11655,2F3FBE39EE4E3AB748593134D6A2A772,42231,2,11,9,37,46,1896
11656,11656,2F3FBE39EE4E3AB748593134D6A2A772,42351,11,12,1,38,45,1945
11657,11657,2F3FBE39EE4E3AB748593134D6A2A772,42231,13,22,9,37,46,1896
11658,11658,5B9E09F094541824399F39AB61F4C681,11381,0,9,9,30,47,1547
11659,11659,5B9E09F094541824399F39AB61F4C681,11861,13,15,2,32,47,1647
11660,11660,5B9E09F094541824399F39AB61F4C681,11381,16,17,1,30,47,1547
11661,11661,5B9E09F094541824399F39AB61F4C681,11861,20,21,1,32,47,1647
11666,11666,E835E54D31E2053FF59F5E3D61ABCD72,11061,1,2,1,29,48,1498
11667,11667,E835E54D31E2053FF59F5E3D61ABCD72,11151,5,13,8,30,48,1548
11668,11668,E835E54D31E2053FF59F5E3D61ABCD72,11061,13,15,2,29,48,1498
11669,11669,E835E54D31E2053FF59F5E3D61ABCD72,11151,16,23,7,30,48,1548
11677,11677,7DFCA2932B390D69ABC0E415A2260097,42531,0,1,1,31,45,1595
11678,11678,7DFCA2932B390D69ABC0E415A2260097,10351,2,16,14,28,45,1445
11679,11679,7DFCA2932B390D69ABC0E415A2260097,12311,20,21,1,30,44,1544
11688,11688,BC3DA9BAF9B0A0C935A79D91ECBDA067,19441,0,2,2,8,46,446
11689,11689,BC3DA9BAF9B0A0C935A79D91ECBDA067,42041,2,3,1,10,47,547
11690,11690,BC3DA9BAF9B0A0C935A79D91ECBDA067,19441,3,13,10,8,46,446
11691,11691,BC3DA9BAF9B0A0C935A79D91ECBDA067,19901,18,23,5,7,44,394
11692,11692,7598D32DC332293D35F2F6ACB7EBDD15,10251,2,10,8,35,47,1797
11693,11693,7598D32DC332293D35F2F6ACB7EBDD15,42161,12,20,8,36,47,1847
11694,11694,7598D32DC332293D35F2F6ACB7EBDD15,10251,20,23,3,35,47,1797
11695,11695,E9DE0465C25ACD29F5AA7BA8CFD57DED,10295,0,1,1,30,47,1547
11696,11696,E9DE0465C25ACD29F5AA7BA8CFD57DED,42521,3,7,4,31,47,1597
11697,11697,E9DE0465C25ACD29F5AA7BA8CFD57DED,10295,9,11,2,30,47,1547
11698,11698,E9DE0465C25ACD29F5AA7BA8CFD57DED,42521,12,22,10,31,47,1597
11699,11699,1DA79481C6B6D1D9223A378A0D81757A,42401,0,8,8,36,47,1847
11700,11700,1DA79481C6B6D1D9223A378A0D81757A,40882,8,17,9,34,49,1749
11701,11701,1DA79481C6B6D1D9223A378A0D81757A,42401,18,19,1,36,47,1847
11702,11702,1DA79481C6B6D1D9223A378A0D81757A,10111,22,23,1,37,47,1897
11721,11721,09B258FCC1A04CEAAFFB93000EF42A6F,10811,0,6,6,38,46,1946
11722,11722,09B258FCC1A04CEAAFFB93000EF42A6F,11074,6,9,3,37,47,1897
11723,11723,09B258FCC1A04CEAAFFB93000EF42A6F,10811,11,14,3,38,46,1946
11724,11724,09B258FCC1A04CEAAFFB93000EF42A6F,10601,15,22,7,39,47,1997
11725,11725,CD55B44A3FD4B718A673CC03711FD344,12641,3,4,1,10,43,543
11726,11726,CD55B44A3FD4B718A673CC03711FD344,12921,6,8,2,9,41,491
11727,11727,CD55B44A3FD4B718A673CC03711FD344,12641,8,9,1,10,43,543
11728,11728,CD55B44A3FD4B718A673CC03711FD344,12921,10,22,12,9,41,491
11733,11733,FEE5ACDB24DFF6E9A25C550C618C43AE,40673,3,8,5,36,48,1848
11734,11734,FEE5ACDB24DFF6E9A25C550C618C43AE,10251,12,21,9,35,47,1797
11735,11735,FEE5ACDB24DFF6E9A25C550C618C43AE,42401,22,23,1,36,47,1847
11736,11736,394B81CC36B31D897120A6153D7C1457,11061,0,4,4,29,48,1498
11737,11737,394B81CC36B31D897120A6153D7C1457,13651,5,13,8,30,47,1547
11738,11738,394B81CC36B31D897120A6153D7C1457,11061,16,22,6,29,48,1498
11739,11739,3882732CE5A944DE472431CF8FF3AB74,11161,0,7,7,32,48,1648
11740,11740,3882732CE5A944DE472431CF8FF3AB74,11531,15,16,1,34,49,1749
11741,11741,3882732CE5A944DE472431CF8FF3AB74,11161,21,23,2,32,48,1648
11748,11748,A3101ED0D202540751378392D86B2618,12121,0,10,10,29,47,1497
11749,11749,A3101ED0D202540751378392D86B2618,11061,11,12,1,29,48,1498
11750,11750,A3101ED0D202540751378392D86B2618,11381,13,18,5,30,47,1547
11751,11751,A3101ED0D202540751378392D86B2618,12121,18,23,5,29,47,1497
11766,11766,7ADBB8E9FCA8E3DF1FC6BCDD3D87665B,10411,7,10,3,36,48,1848
11767,11767,7ADBB8E9FCA8E3DF1FC6BCDD3D87665B,13121,12,15,3,38,46,1946
11768,11768,7ADBB8E9FCA8E3DF1FC6BCDD3D87665B,10841,16,17,1,37,47,1897
11769,11769,7ADBB8E9FCA8E3DF1FC6BCDD3D87665B,10411,19,21,2,36,48,1848
11788,11788,53D8E731DA65650E5B825C52CF592433,10151,0,10,10,34,47,1747
11789,11789,53D8E731DA65650E5B825C52CF592433,11261,13,14,1,36,46,1846
11790,11790,53D8E731DA65650E5B825C52CF592433,11201,14,23,9,35,49,1799
11794,11794,E969EC1FA6E19F3F5A602F2FE47F2E7D,13911,0,5,5,39,46,1996
11795,11795,E969EC1FA6E19F3F5A602F2FE47F2E7D,11261,5,7,2,36,46,1846
11796,11796,E969EC1FA6E19F3F5A602F2FE47F2E7D,13911,7,23,16,39,46,1996
11813,11813,D8063B7C8CAA23F18B002D2A443A5135,43101,6,12,6,46,40,2340
11814,11814,D8063B7C8CAA23F18B002D2A443A5135,43951,13,18,5,49,41,2491
11815,11815,D8063B7C8CAA23F18B002D2A443A5135,43101,19,21,2,46,40,2340
11816,11816,B008950D13439AAF34B6D4BE3B059216,13651,1,17,16,30,47,1547
11817,11817,B008950D13439AAF34B6D4BE3B059216,42523,18,19,1,31,47,1597
11818,11818,B008950D13439AAF34B6D4BE3B059216,13651,19,21,2,30,47,1547
11819,11819,B008950D13439AAF34B6D4BE3B059216,42523,22,23,1,31,47,1597
11820,11820,6AD981E757B177FB5B64F1D1D2EAA27F,42961,0,8,8,35,49,1799
11821,11821,6AD981E757B177FB5B64F1D1D2EAA27F,10901,9,14,5,35,48,1798
11822,11822,6AD981E757B177FB5B64F1D1D2EAA27F,11201,16,18,2,35,49,1799
11823,11823,A7D9C28461137D2FC40006F87C9506F9,12311,0,3,3,30,44,1544
11824,11824,A7D9C28461137D2FC40006F87C9506F9,42531,3,5,2,31,45,1595
11825,11825,A7D9C28461137D2FC40006F87C9506F9,12311,6,23,17,30,44,1544
11833,11833,924C94FEA337955066B022FCC7607D38,11361,0,5,5,22,48,1148
11834,11834,924C94FEA337955066B022FCC7607D38,42691,6,13,7,24,48,1248
11835,11835,924C94FEA337955066B022FCC7607D38,11361,14,17,3,22,48,1148
11836,11836,924C94FEA337955066B022FCC7607D38,12581,18,20,2,24,48,1248
11847,11847,8E0D20320C5276BDD797BA6D65B9C51D,11074,0,7,7,37,47,1897
11848,11848,8E0D20320C5276BDD797BA6D65B9C51D,11231,8,17,9,37,49,1899
11849,11849,8E0D20320C5276BDD797BA6D65B9C51D,11074,19,23,4,37,47,1897
11850,11850,749DC7B5C5BEE0359B55DD79F33CBC79,41007,0,13,13,37,47,1897
11851,11851,749DC7B5C5BEE0359B55DD79F33CBC79,42401,14,16,2,36,47,1847
11852,11852,749DC7B5C5BEE0359B55DD79F33CBC79,11074,16,23,7,37,47,1897
11853,11853,A6555ADD1FDD22671BB225447AB03AF9,12641,1,2,1,10,43,543
11854,11854,A6555ADD1FDD22671BB225447AB03AF9,19744,5,6,1,6,43,343
11855,11855,A6555ADD1FDD22671BB225447AB03AF9,12641,6,18,12,10,43,543
11861,11861,10B8A2D44211CACA01D59967B38E8576,40637,0,11,11,36,47,1847
11862,11862,10B8A2D44211CACA01D59967B38E8576,10511,12,13,1,35,46,1796
11863,11863,10B8A2D44211CACA01D59967B38E8576,42161,13,18,5,36,47,1847
11864,11864,10B8A2D44211CACA01D59967B38E8576,10251,19,23,4,35,47,1797
11870,11870,3F92550AE7FA536C6ED9DF3D484ADD7A,10811,0,14,14,38,46,1946
11871,11871,3F92550AE7FA536C6ED9DF3D484ADD7A,11261,15,16,1,36,46,1846
11872,11872,3F92550AE7FA536C6ED9DF3D484ADD7A,10811,18,20,2,38,46,1946
11873,11873,3F92550AE7FA536C6ED9DF3D484ADD7A,13231,21,23,2,39,46,1996
11899,11899,A3D3C7116EF7FC5DF272DB42BBFA000C,12491,3,13,10,36,43,1843
11900,11900,A3D3C7116EF7FC5DF272DB42BBFA000C,42151,13,15,2,35,45,1795
11901,11901,A3D3C7116EF7FC5DF272DB42BBFA000C,12491,19,23,4,36,43,1843
11909,11909,0C653DC860B823A0FBD73915967D7A74,43051,0,3,3,46,45,2345
11910,11910,0C653DC860B823A0FBD73915967D7A74,12221,6,8,2,43,44,2194
11911,11911,0C653DC860B823A0FBD73915967D7A74,42631,8,17,9,43,45,2195
11912,11912,0C653DC860B823A0FBD73915967D7A74,43051,19,22,3,46,45,2345
11913,11913,5E8BB1A9FDE1AFD08848003FB8A60E0E,40673,0,8,8,36,48,1848
11914,11914,5E8BB1A9FDE1AFD08848003FB8A60E0E,10971,10,19,9,35,47,1797
11915,11915,5E8BB1A9FDE1AFD08848003FB8A60E0E,40673,19,23,4,36,48,1848
11916,11916,A09953F67FED80A8C2308F84F83FE6DA,13711,0,10,10,38,46,1946
11917,11917,A09953F67FED80A8C2308F84F83FE6DA,42011,14,16,2,36,46,1846
11918,11918,A09953F67FED80A8C2308F84F83FE6DA,13711,19,20,1,38,46,1946
11919,11919,D83A3E3103AE521669D7D5F8A4C5417F,10331,0,12,12,39,46,1996
11920,11920,D83A3E3103AE521669D7D5F8A4C5417F,11074,13,15,2,37,47,1897
11921,11921,D83A3E3103AE521669D7D5F8A4C5417F,10331,16,23,7,39,46,1996
11922,11922,9E981569C6718F42D2105C2620CE51EF,42461,0,6,6,45,47,2297
11923,11923,9E981569C6718F42D2105C2620CE51EF,42321,10,14,4,43,47,2197
11924,11924,9E981569C6718F42D2105C2620CE51EF,11701,17,19,2,43,48,2198
11925,11925,9E981569C6718F42D2105C2620CE51EF,42321,21,23,2,43,47,2197
11942,11942,288D369FF27C2F58011E60F4D93BD67B,11061,0,7,7,29,48,1498
11943,11943,288D369FF27C2F58011E60F4D93BD67B,11381,8,9,1,30,47,1547
11944,11944,288D369FF27C2F58011E60F4D93BD67B,11061,11,21,10,29,48,1498
11960,11960,4515D69DA9DF7C67BD58AB71BAA57E58,11231,0,1,1,37,49,1899
11961,11961,4515D69DA9DF7C67BD58AB71BAA57E58,10471,1,17,16,37,48,1898
11962,11962,4515D69DA9DF7C67BD58AB71BAA57E58,40171,18,19,1,38,48,1948
11963,11963,4515D69DA9DF7C67BD58AB71BAA57E58,11911,19,22,3,37,48,1898
11964,11964,C18CBB9E77D2C327D1101B4B354D9880,11021,0,9,9,36,49,1849
11965,11965,C18CBB9E77D2C327D1101B4B354D9880,11231,10,17,7,37,49,1899
11966,11966,C18CBB9E77D2C327D1101B4B354D9880,11021,17,23,6,36,49,1849
11967,11967,24CACD73BA8D75767DDD668E5EA165E2,40171,0,14,14,38,48,1948
11968,11968,24CACD73BA8D75767DDD668E5EA165E2,11914,14,19,5,37,48,1898
11969,11969,24CACD73BA8D75767DDD668E5EA165E2,40171,22,23,1,38,48,1948
11983,11983,582FCEF67ED9C80E5B2E8667690F61FB,42221,0,9,9,38,48,1948
11984,11984,582FCEF67ED9C80E5B2E8667690F61FB,42401,10,19,9,36,47,1847
11985,11985,582FCEF67ED9C80E5B2E8667690F61FB,42221,21,23,2,38,48,1948
11993,11993,504467700DDD1C036193CD82D6D3619F,42141,9,11,2,32,47,1647
11994,11994,504467700DDD1C036193CD82D6D3619F,42521,12,13,1,31,47,1597
11995,11995,504467700DDD1C036193CD82D6D3619F,43761,15,18,3,32,47,1647
11999,11999,BB84F849A5F794F98ED9E8F635142ED5,10471,7,13,6,37,48,1898
12000,12000,BB84F849A5F794F98ED9E8F635142ED5,40171,15,17,2,38,48,1948
12001,12001,BB84F849A5F794F98ED9E8F635142ED5,11914,20,22,2,37,48,1898
12002,12002,823BB637426A4B64F4A56D087D45C241,12641,1,7,6,10,43,543
12003,12003,823BB637426A4B64F4A56D087D45C241,12921,7,18,11,9,41,491
12004,12004,823BB637426A4B64F4A56D087D45C241,19114,18,20,2,7,43,393
12005,12005,823BB637426A4B64F4A56D087D45C241,12641,21,23,2,10,43,543
12006,12006,93A06D06DA0CE827AEF2B3BC6BB6925B,10154,0,11,11,33,47,1697
12007,12007,93A06D06DA0CE827AEF2B3BC6BB6925B,11861,12,16,4,32,47,1647
12008,12008,93A06D06DA0CE827AEF2B3BC6BB6925B,42021,16,17,1,33,47,1697
12009,12009,93A06D06DA0CE827AEF2B3BC6BB6925B,11861,20,22,2,32,47,1647
12013,12013,B3D3247264CC59DE8B1DE47660D9C8A8,11161,3,4,1,32,48,1648
12014,12014,B3D3247264CC59DE8B1DE47660D9C8A8,43761,7,18,11,32,47,1647
12015,12015,B3D3247264CC59DE8B1DE47660D9C8A8,11161,19,20,1,32,48,1648
12016,12016,FE5BD9848E0FBBF0629F9C0576D0DEBF,13231,0,15,15,39,46,1996
12017,12017,FE5BD9848E0FBBF0629F9C0576D0DEBF,42301,16,18,2,36,47,1847
12018,12018,FE5BD9848E0FBBF0629F9C0576D0DEBF,13231,21,23,2,39,46,1996
12039,12039,6F5D79A5FCF9030A20DEBC733E9A15F5,12641,0,16,16,10,43,543
12040,12040,6F5D79A5FCF9030A20DEBC733E9A15F5,19111,18,19,1,9,45,495
12041,12041,6F5D79A5FCF9030A20DEBC733E9A15F5,19114,22,23,1,7,43,393
12042,12042,DC9866094212A637CCAC17CF01FE4B5F,42861,0,6,6,37,44,1894
12043,12043,DC9866094212A637CCAC17CF01FE4B5F,11261,6,15,9,36,46,1846
12044,12044,DC9866094212A637CCAC17CF01FE4B5F,42861,19,23,4,37,44,1894
12045,12045,A06465C33822DBAACCFCA67CF792360D,10295,0,15,15,30,47,1547
12046,12046,A06465C33822DBAACCFCA67CF792360D,42921,18,20,2,33,47,1697
12047,12047,A06465C33822DBAACCFCA67CF792360D,42523,21,22,1,31,47,1597
12048,12048,A06465C33822DBAACCFCA67CF792360D,10295,22,23,1,30,47,1547
12049,12049,B3D330CB8F1681F4BBCB951D5F414D22,42021,1,7,6,33,47,1697
12050,12050,B3D330CB8F1681F4BBCB951D5F414D22,10971,7,8,1,35,47,1797
12051,12051,B3D330CB8F1681F4BBCB951D5F414D22,10411,8,20,12,36,48,1848
12052,12052,B3D330CB8F1681F4BBCB951D5F414D22,11861,21,22,1,32,47,1647
12053,12053,ADA4A0694EC851291BBE6D1AE8EAB630,42201,0,6,6,43,46,2196
12054,12054,ADA4A0694EC851291BBE6D1AE8EAB630,13341,8,20,12,44,45,2245
12055,12055,ADA4A0694EC851291BBE6D1AE8EAB630,42201,21,23,2,43,46,2196
12056,12056,0BC1BC9FA127A76D4558FF0A0EC8FEFB,13601,1,6,5,34,47,1747
12057,12057,0BC1BC9FA127A76D4558FF0A0EC8FEFB,10281,7,10,3,33,48,1698
12058,12058,0BC1BC9FA127A76D4558FF0A0EC8FEFB,42021,12,19,7,33,47,1697
12064,12064,D9FB9F3F4820A4EF951566780A770C45,11261,7,10,3,36,46,1846
12065,12065,D9FB9F3F4820A4EF951566780A770C45,13911,12,13,1,39,46,1996
12066,12066,D9FB9F3F4820A4EF951566780A770C45,11261,14,20,6,36,46,1846
12067,12067,746607B162E7EB25AA57FCC2A7B9163E,11861,0,8,8,32,47,1647
12068,12068,746607B162E7EB25AA57FCC2A7B9163E,43671,8,11,3,35,48,1798
12069,12069,746607B162E7EB25AA57FCC2A7B9163E,43731,12,13,1,34,47,1747
12070,12070,746607B162E7EB25AA57FCC2A7B9163E,11861,13,23,10,32,47,1647
12086,12086,7C98BDF484E2B085C51A4945E804FC0C,42151,0,1,1,35,45,1795
12087,12087,7C98BDF484E2B085C51A4945E804FC0C,12491,6,10,4,36,43,1843
12088,12088,7C98BDF484E2B085C51A4945E804FC0C,42151,12,23,11,35,45,1795
12098,12098,387C2BFABED9CD0C7C45EBAD5F5242F9,10251,0,1,1,35,47,1797
12099,12099,387C2BFABED9CD0C7C45EBAD5F5242F9,40637,1,3,2,36,47,1847
12100,12100,387C2BFABED9CD0C7C45EBAD5F5242F9,10251,3,16,13,35,47,1797
12101,12101,387C2BFABED9CD0C7C45EBAD5F5242F9,13511,20,21,1,34,48,1748
12102,12102,00ED2280FB2BEC22D8FB36F8A7AFB1A5,42791,0,7,7,35,45,1795
12103,12103,00ED2280FB2BEC22D8FB36F8A7AFB1A5,13121,9,12,3,38,46,1946
12104,12104,00ED2280FB2BEC22D8FB36F8A7AFB1A5,10271,13,17,4,37,46,1896
12105,12105,00ED2280FB2BEC22D8FB36F8A7AFB1A5,42791,19,22,3,35,45,1795
12106,12106,714E2EDF27DC98DF83450DCBAEE3E6CD,13561,0,6,6,37,49,1899
12107,12107,714E2EDF27DC98DF83450DCBAEE3E6CD,11021,7,16,9,36,49,1849
12108,12108,714E2EDF27DC98DF83450DCBAEE3E6CD,13561,20,23,3,37,49,1899
12109,12109,6B33C993B739D337E981CD19E6D27BBE,42091,0,8,8,43,46,2196
12110,12110,6B33C993B739D337E981CD19E6D27BBE,42461,10,11,1,45,47,2297
12111,12111,6B33C993B739D337E981CD19E6D27BBE,42091,14,23,9,43,46,2196
12112,12112,1C12FD1823A36FA85667FC8316128B0A,13331,0,9,9,38,47,1947
12113,12113,1C12FD1823A36FA85667FC8316128B0A,42301,12,13,1,36,47,1847
12114,12114,1C12FD1823A36FA85667FC8316128B0A,13331,14,19,5,38,47,1947
12118,12118,5E269639C787C5D2BDF7F359B5257597,13381,0,7,7,39,47,1997
12119,12119,5E269639C787C5D2BDF7F359B5257597,11481,7,18,11,41,48,2098
12120,12120,5E269639C787C5D2BDF7F359B5257597,13381,20,23,3,39,47,1997
12131,12131,A7B31109557B4ACE77F31639500C61E8,10431,0,15,15,33,49,1699
12132,12132,A7B31109557B4ACE77F31639500C61E8,11541,18,20,2,35,49,1799
12133,12133,A7B31109557B4ACE77F31639500C61E8,12971,21,23,2,32,48,1648
12134,12134,BEE853049D28B67DAA1CF8A47B438594,12921,0,7,7,9,41,491
12135,12135,BEE853049D28B67DAA1CF8A47B438594,12641,12,13,1,10,43,543
12136,12136,BEE853049D28B67DAA1CF8A47B438594,12921,15,18,3,9,41,491
12137,12137,BEE853049D28B67DAA1CF8A47B438594,49201,20,21,1,7,41,391
12138,12138,8CD5156CF883DA15618BAFE58DDCF2A7,42581,0,6,6,38,48,1948
12139,12139,8CD5156CF883DA15618BAFE58DDCF2A7,11914,8,14,6,37,48,1898
12140,12140,8CD5156CF883DA15618BAFE58DDCF2A7,42581,14,21,7,38,48,1948
12141,12141,8CD5156CF883DA15618BAFE58DDCF2A7,11914,21,22,1,37,48,1898
12142,12142,70001957DCF2B9125DCB996733DDF49B,11381,0,10,10,30,47,1547
12143,12143,70001957DCF2B9125DCB996733DDF49B,11061,12,13,1,29,48,1498
12144,12144,70001957DCF2B9125DCB996733DDF49B,11381,14,22,8,30,47,1547
12145,12145,D7349708A10855AEF98FEB8D22C33E59,10601,0,7,7,39,47,1997
12146,12146,D7349708A10855AEF98FEB8D22C33E59,11231,11,17,6,37,49,1899
12147,12147,D7349708A10855AEF98FEB8D22C33E59,10601,19,23,4,39,47,1997
12148,12148,E24F34B965BE1054DCE4AF1C1CD48137,11861,0,8,8,32,47,1647
12149,12149,E24F34B965BE1054DCE4AF1C1CD48137,11875,10,19,9,30,46,1546
12150,12150,E24F34B965BE1054DCE4AF1C1CD48137,11861,21,23,2,32,47,1647
12163,12163,4B5C492CF16B079882322240829D6566,11231,0,13,13,37,49,1899
12164,12164,4B5C492CF16B079882322240829D6566,11271,16,18,2,37,48,1898
12165,12165,4B5C492CF16B079882322240829D6566,11231,18,20,2,37,49,1899
12166,12166,08722D7A095C90179DDD0BE38D45C8CB,42523,5,12,7,31,47,1597
12167,12167,08722D7A095C90179DDD0BE38D45C8CB,42491,14,18,4,32,46,1646
12168,12168,08722D7A095C90179DDD0BE38D45C8CB,42523,18,22,4,31,47,1597
12177,12177,558A6887C0D5899B43E75BBD844A7C64,42461,0,5,5,45,47,2297
12178,12178,558A6887C0D5899B43E75BBD844A7C64,42321,8,15,7,43,47,2197
12179,12179,558A6887C0D5899B43E75BBD844A7C64,42461,19,21,2,45,47,2297
12184,12184,91FB7E11CCB9539E71578F3DFA4AFBA7,12921,8,9,1,9,41,491
12185,12185,91FB7E11CCB9539E71578F3DFA4AFBA7,49201,13,14,1,7,41,391
12186,12186,91FB7E11CCB9539E71578F3DFA4AFBA7,12921,15,19,4,9,41,491
12187,12187,E45B0EC44E00842EDD865C65A561543D,11791,0,8,8,38,49,1949
12188,12188,E45B0EC44E00842EDD865C65A561543D,11231,8,14,6,37,49,1899
12189,12189,E45B0EC44E00842EDD865C65A561543D,10471,14,20,6,37,48,1898
12195,12195,D8B46FFCD15B641FB93B8219A29A7205,10251,0,3,3,35,47,1797
12196,12196,D8B46FFCD15B641FB93B8219A29A7205,42401,3,7,4,36,47,1847
12197,12197,D8B46FFCD15B641FB93B8219A29A7205,10251,8,23,15,35,47,1797
12209,12209,F004825C5EEC7F8B7A184D4985895C55,13341,0,7,7,44,45,2245
12210,12210,F004825C5EEC7F8B7A184D4985895C55,42631,7,12,5,43,45,2195
12211,12211,F004825C5EEC7F8B7A184D4985895C55,13341,14,20,6,44,45,2245
12217,12217,537B866E49840CD2552EC8B3E30E45EA,42921,0,6,6,33,47,1697
12218,12218,537B866E49840CD2552EC8B3E30E45EA,11861,8,9,1,32,47,1647
12219,12219,537B866E49840CD2552EC8B3E30E45EA,42921,12,22,10,33,47,1697
12220,12220,3F29D0D409D1B6D4E7D2087740FD0BBC,42161,0,9,9,36,47,1847
12221,12221,3F29D0D409D1B6D4E7D2087740FD0BBC,10251,12,14,2,35,47,1797
12222,12222,3F29D0D409D1B6D4E7D2087740FD0BBC,42161,18,23,5,36,47,1847
12235,12235,E8F5F4A78C0DE5C1EE8D56EB7226C7B2,11651,0,8,8,33,47,1697
12236,12236,E8F5F4A78C0DE5C1EE8D56EB7226C7B2,10161,11,18,7,35,49,1799
12237,12237,E8F5F4A78C0DE5C1EE8D56EB7226C7B2,11131,19,22,3,33,48,1698
12242,12242,5389F9A5B99CC6D060A9E0142590C4F2,12921,0,15,15,9,41,491
12243,12243,5389F9A5B99CC6D060A9E0142590C4F2,12641,17,18,1,10,43,543
12244,12244,5389F9A5B99CC6D060A9E0142590C4F2,19111,20,22,2,9,45,495
12252,12252,0C993A1B5BD23944DD153F92F92FAA1E,10351,1,6,5,28,45,1445
12253,12253,0C993A1B5BD23944DD153F92F92FAA1E,10634,10,11,1,27,45,1395
12254,12254,0C993A1B5BD23944DD153F92F92FAA1E,10351,12,18,6,28,45,1445
12255,12255,0C993A1B5BD23944DD153F92F92FAA1E,10634,21,23,2,27,45,1395
12256,12256,B93C16A242FE2C6BDA83A87AD4FAA434,10501,1,8,7,22,46,1146
12257,12257,B93C16A242FE2C6BDA83A87AD4FAA434,12601,8,16,8,25,47,1297
12258,12258,B93C16A242FE2C6BDA83A87AD4FAA434,10501,16,19,3,22,46,1146
12259,12259,B93C16A242FE2C6BDA83A87AD4FAA434,12601,22,23,1,25,47,1297
12264,12264,C540F2B6026ACBB1CB632D85BE56DB87,11914,4,6,2,37,48,1898
12265,12265,C540F2B6026ACBB1CB632D85BE56DB87,10901,7,8,1,35,48,1798
12266,12266,C540F2B6026ACBB1CB632D85BE56DB87,11914,9,18,9,37,48,1898
12267,12267,C540F2B6026ACBB1CB632D85BE56DB87,42961,19,21,2,35,49,1799
12274,12274,BDA67F5B71597181E331845AE88C939C,42161,2,9,7,36,47,1847
12275,12275,BDA67F5B71597181E331845AE88C939C,10901,12,14,2,35,48,1798
12276,12276,BDA67F5B71597181E331845AE88C939C,42161,17,20,3,36,47,1847
12277,12277,BDA67F5B71597181E331845AE88C939C,11074,20,21,1,37,47,1897
12289,12289,9C853A4D5C7B5210EB733E5032A36376,11021,6,15,9,36,49,1849
12290,12290,9C853A4D5C7B5210EB733E5032A36376,43731,18,20,2,34,47,1747
12291,12291,9C853A4D5C7B5210EB733E5032A36376,11021,21,23,2,36,49,1849
12292,12292,60DB2F1E5C63BE640D47B87EE3CFB05B,42461,0,6,6,45,47,2297
12293,12293,60DB2F1E5C63BE640D47B87EE3CFB05B,13951,7,8,1,47,45,2395
12294,12294,60DB2F1E5C63BE640D47B87EE3CFB05B,42461,19,20,1,45,47,2297
12295,12295,60DB2F1E5C63BE640D47B87EE3CFB05B,10801,21,23,2,42,47,2147
12296,12296,C4756871D2BA9B211E8D9E7A9316C910,11231,0,14,14,37,49,1899
12297,12297,C4756871D2BA9B211E8D9E7A9316C910,11201,18,20,2,35,49,1799
12298,12298,C4756871D2BA9B211E8D9E7A9316C910,11231,21,23,2,37,49,1899
12304,12304,F177C252F712783B4F52D4F3F64FBA5B,42151,1,7,6,35,45,1795
12305,12305,F177C252F712783B4F52D4F3F64FBA5B,11261,11,12,1,36,46,1846
12306,12306,F177C252F712783B4F52D4F3F64FBA5B,42151,16,20,4,35,45,1795
12307,12307,AC604569EDEC121EE97D76ACCBB6C578,12521,0,14,14,35,41,1791
12308,12308,AC604569EDEC121EE97D76ACCBB6C578,43451,14,17,3,37,40,1890
12309,12309,AC604569EDEC121EE97D76ACCBB6C578,12521,18,23,5,35,41,1791
12310,12310,B2584A092AD221CA137486F4C6E3058C,42121,9,10,1,26,49,1349
12311,12311,B2584A092AD221CA137486F4C6E3058C,40341,14,16,2,23,49,1199
12312,12312,B2584A092AD221CA137486F4C6E3058C,11061,21,22,1,29,48,1498
12318,12318,9BBBC00C93BA6A3176E2B008E6F8A88E,42351,0,5,5,38,45,1945
12319,12319,9BBBC00C93BA6A3176E2B008E6F8A88E,11261,5,8,3,36,46,1846
12320,12320,9BBBC00C93BA6A3176E2B008E6F8A88E,13911,8,9,1,39,46,1996
12321,12321,9BBBC00C93BA6A3176E2B008E6F8A88E,11261,10,20,10,36,46,1846
12322,12322,01067BD464140B42D6F1D4D82F8B8EE7,43481,0,10,10,39,48,1998
12323,12323,01067BD464140B42D6F1D4D82F8B8EE7,11551,12,14,2,39,49,1999
12324,12324,01067BD464140B42D6F1D4D82F8B8EE7,11231,14,18,4,37,49,1899
12325,12325,01067BD464140B42D6F1D4D82F8B8EE7,43481,20,23,3,39,48,1998
12331,12331,A1B1493AD1E4959D25E397CB780FB65E,42531,0,14,14,31,45,1595
12332,12332,A1B1493AD1E4959D25E397CB780FB65E,12311,14,15,1,30,44,1544
12333,12333,A1B1493AD1E4959D25E397CB780FB65E,11875,15,16,1,30,46,1546
12334,12334,A1B1493AD1E4959D25E397CB780FB65E,42531,18,23,5,31,45,1595
12345,12345,7D5000772E957DD3A483CE8963A15A13,42501,2,3,1,28,47,1447
12346,12346,7D5000772E957DD3A483CE8963A15A13,11381,5,10,5,30,47,1547
12347,12347,7D5000772E957DD3A483CE8963A15A13,12121,12,21,9,29,47,1497
12348,12348,7D5000772E957DD3A483CE8963A15A13,11381,22,23,1,30,47,1547
12349,12349,449E7811DCD6E8CD500501049B5A906E,13911,0,6,6,39,46,1996
12350,12350,449E7811DCD6E8CD500501049B5A906E,11261,6,7,1,36,46,1846
12351,12351,449E7811DCD6E8CD500501049B5A906E,13911,7,22,15,39,46,1996
12363,12363,68D66AC2F31097852E1113FCAC38B096,12311,8,9,1,30,44,1544
12364,12364,68D66AC2F31097852E1113FCAC38B096,42531,11,18,7,31,45,1595
12365,12365,68D66AC2F31097852E1113FCAC38B096,12311,19,22,3,30,44,1544
12369,12369,AC53AC1081295BD08CBE443768C823D4,11151,0,8,8,30,48,1548
12370,12370,AC53AC1081295BD08CBE443768C823D4,11061,12,17,5,29,48,1498
12371,12371,AC53AC1081295BD08CBE443768C823D4,11151,19,22,3,30,48,1548
12397,12397,780CF605B987CE4335E0B64DFA86ACBF,12514,0,8,8,38,47,1947
12398,12398,780CF605B987CE4335E0B64DFA86ACBF,10841,9,18,9,37,47,1897
12399,12399,780CF605B987CE4335E0B64DFA86ACBF,12514,22,23,1,38,47,1947
12400,12400,21214DF25ABBFE57C13DD19922691751,42351,0,4,4,38,45,1945
12401,12401,21214DF25ABBFE57C13DD19922691751,13911,4,12,8,39,46,1996
12402,12402,21214DF25ABBFE57C13DD19922691751,11261,12,20,8,36,46,1846
12403,12403,22300DEAB3F7A20A2F8DD7892A11C5B7,13271,0,2,2,41,47,2097
12404,12404,22300DEAB3F7A20A2F8DD7892A11C5B7,13101,3,4,1,40,47,2047
12405,12405,22300DEAB3F7A20A2F8DD7892A11C5B7,13271,4,22,18,41,47,2097
12414,12414,EE8CBFDDBC1BECE90A865B77A182BB7F,10634,0,12,12,27,45,1395
12415,12415,EE8CBFDDBC1BECE90A865B77A182BB7F,12311,14,17,3,30,44,1544
12416,12416,EE8CBFDDBC1BECE90A865B77A182BB7F,10634,19,23,4,27,45,1395
12417,12417,01308B72F71E3AACC045F922DA6CAE4D,43761,2,13,11,32,47,1647
12418,12418,01308B72F71E3AACC045F922DA6CAE4D,42523,15,16,1,31,47,1597
12419,12419,01308B72F71E3AACC045F922DA6CAE4D,43761,18,20,2,32,47,1647
12420,12420,FD8C757A10FC8342CB9359B3B019D044,10901,1,13,12,35,48,1798
12421,12421,FD8C757A10FC8342CB9359B3B019D044,11231,13,17,4,37,49,1899
12422,12422,FD8C757A10FC8342CB9359B3B019D044,10901,18,23,5,35,48,1798
12426,12426,788B844105D5B8E7F811E684725914FC,11491,2,12,10,36,47,1847
12427,12427,788B844105D5B8E7F811E684725914FC,10107,13,16,3,38,49,1949
12428,12428,788B844105D5B8E7F811E684725914FC,42511,19,22,3,37,47,1897
12429,12429,7C715FFD8A4BAD934A322B8DA7E771CE,13101,0,10,10,40,47,2047
12430,12430,7C715FFD8A4BAD934A322B8DA7E771CE,11481,12,18,6,41,48,2098
12431,12431,7C715FFD8A4BAD934A322B8DA7E771CE,40833,20,22,2,41,47,2097
12444,12444,775CA947FF37432092AA3395F5AA137B,42161,0,7,7,36,47,1847
12445,12445,775CA947FF37432092AA3395F5AA137B,10971,9,13,4,35,47,1797
12446,12446,775CA947FF37432092AA3395F5AA137B,43731,16,18,2,34,47,1747
12447,12447,775CA947FF37432092AA3395F5AA137B,10971,22,23,1,35,47,1797
12453,12453,C51E252CF4E3CCE91DAD548C30F00035,42021,0,8,8,33,47,1697
12454,12454,C51E252CF4E3CCE91DAD548C30F00035,10281,12,16,4,33,48,1698
12455,12455,C51E252CF4E3CCE91DAD548C30F00035,11751,19,23,4,35,48,1798
12456,12456,71FDEFC3187A3CF24BA939D7B11B9629,12391,1,17,16,36,49,1849
12457,12457,71FDEFC3187A3CF24BA939D7B11B9629,42961,19,20,1,35,49,1799
12458,12458,71FDEFC3187A3CF24BA939D7B11B9629,11461,22,23,1,37,49,1899
12459,12459,56227FF845C9CE8AE284F46F05334346,10121,0,13,13,36,49,1849
12460,12460,56227FF845C9CE8AE284F46F05334346,11231,13,20,7,37,49,1899
12461,12461,56227FF845C9CE8AE284F46F05334346,12083,21,22,1,36,49,1849
12462,12462,A4B7DD584753163300A222AEAD5EBBBD,42401,0,8,8,36,47,1847
12463,12463,A4B7DD584753163300A222AEAD5EBBBD,11231,8,18,10,37,49,1899
12464,12464,A4B7DD584753163300A222AEAD5EBBBD,42401,19,23,4,36,47,1847
12465,12465,170A0AC014DC9BA930EAA0E56A2C9D03,11001,1,6,5,42,47,2147
12466,12466,170A0AC014DC9BA930EAA0E56A2C9D03,11701,8,13,5,43,48,2198
12467,12467,170A0AC014DC9BA930EAA0E56A2C9D03,42601,17,18,1,44,48,2248
12468,12468,170A0AC014DC9BA930EAA0E56A2C9D03,42321,20,22,2,43,47,2197
12472,12472,9ECA5557B94DDF8D494B58216329A377,42864,2,13,11,38,44,1944
12473,12473,9ECA5557B94DDF8D494B58216329A377,11261,17,18,1,36,46,1846
12474,12474,9ECA5557B94DDF8D494B58216329A377,42864,19,20,1,38,44,1944
12480,12480,F0E73403448DB83F822D52BA48555EF6,13911,1,10,9,39,46,1996
12481,12481,F0E73403448DB83F822D52BA48555EF6,42231,11,12,1,37,46,1896
12482,12482,F0E73403448DB83F822D52BA48555EF6,13231,15,17,2,39,46,1996
12483,12483,F0E73403448DB83F822D52BA48555EF6,42231,22,23,1,37,46,1896
12499,12499,36A5DA74A38B0FD57799D67573348D49,42511,0,6,6,37,47,1897
12500,12500,36A5DA74A38B0FD57799D67573348D49,10411,9,15,6,36,48,1848
12501,12501,36A5DA74A38B0FD57799D67573348D49,42511,18,23,5,37,47,1897
12534,12534,7C11C7CBC4724062CEFCE060A70E0F2E,12641,0,8,8,10,43,543
12535,12535,7C11C7CBC4724062CEFCE060A70E0F2E,12921,8,10,2,9,41,491
12536,12536,7C11C7CBC4724062CEFCE060A70E0F2E,12641,10,18,8,10,43,543
12537,12537,7C11C7CBC4724062CEFCE060A70E0F2E,12921,18,21,3,9,41,491
12538,12538,6869A5F90DBC32E3AB5337DBC7DAA2BA,43951,7,10,3,49,41,2491
12539,12539,6869A5F90DBC32E3AB5337DBC7DAA2BA,13411,11,12,1,49,42,2492
12540,12540,6869A5F90DBC32E3AB5337DBC7DAA2BA,43951,13,18,5,49,41,2491
12562,12562,F0A1BB763F378032A1CC33E7783B3D13,10661,0,7,7,37,49,1899
12563,12563,F0A1BB763F378032A1CC33E7783B3D13,11021,7,11,4,36,49,1849
12564,12564,F0A1BB763F378032A1CC33E7783B3D13,11914,14,16,2,37,48,1898
12565,12565,F0A1BB763F378032A1CC33E7783B3D13,11021,19,21,2,36,49,1849
12587,12587,10D6E07CB2A92B35A37820638A6643C4,11771,0,4,4,39,49,1999
12588,12588,10D6E07CB2A92B35A37820638A6643C4,12514,7,11,4,38,47,1947
12589,12589,10D6E07CB2A92B35A37820638A6643C4,11771,13,23,10,39,49,1999
12602,12602,7EA20FBAC6304528CA4D807CDFD1BC6B,42531,0,1,1,31,45,1595
12603,12603,7EA20FBAC6304528CA4D807CDFD1BC6B,12311,1,16,15,30,44,1544
12604,12604,7EA20FBAC6304528CA4D807CDFD1BC6B,10301,17,18,1,31,45,1595
12605,12605,7EA20FBAC6304528CA4D807CDFD1BC6B,12311,19,20,1,30,44,1544
12606,12606,5D1BB4BD5245AEC96C608C67FBF10EDF,11061,7,13,6,29,48,1498
12607,12607,5D1BB4BD5245AEC96C608C67FBF10EDF,40445,13,18,5,30,48,1548
12608,12608,5D1BB4BD5245AEC96C608C67FBF10EDF,11061,20,21,1,29,48,1498
12609,12609,B3E3F7F4BB39DF4D783E592F9F0BB965,10281,0,7,7,33,48,1698
12610,12610,B3E3F7F4BB39DF4D783E592F9F0BB965,43161,8,12,4,35,47,1797
12611,12611,B3E3F7F4BB39DF4D783E592F9F0BB965,43731,14,15,1,34,47,1747
12612,12612,B3E3F7F4BB39DF4D783E592F9F0BB965,10281,20,23,3,33,48,1698
12613,12613,45E2591DDB181830E886EA4FBDDB1E4F,43161,0,2,2,35,47,1797
12614,12614,45E2591DDB181830E886EA4FBDDB1E4F,10151,3,21,18,34,47,1747
12615,12615,45E2591DDB181830E886EA4FBDDB1E4F,11651,21,23,2,33,47,1697
12616,12616,CDA1EB7B89E47C48A7CAC823B0773234,12661,0,15,15,32,45,1645
12617,12617,CDA1EB7B89E47C48A7CAC823B0773234,43581,16,17,1,33,48,1698
12618,12618,CDA1EB7B89E47C48A7CAC823B0773234,12661,18,22,4,32,45,1645
12619,12619,5358E9F8F0F992AFA66CAEFAFD90ADED,11261,6,7,1,36,46,1846
12620,12620,5358E9F8F0F992AFA66CAEFAFD90ADED,42351,8,9,1,38,45,1945
12621,12621,5358E9F8F0F992AFA66CAEFAFD90ADED,11261,9,22,13,36,46,1846
12626,12626,BD517E29BD7069EA61B2CA0844AA760E,42021,0,6,6,33,47,1697
12627,12627,BD517E29BD7069EA61B2CA0844AA760E,43761,8,21,13,32,47,1647
12628,12628,BD517E29BD7069EA61B2CA0844AA760E,10731,22,23,1,33,47,1697
12629,12629,2DBE50C130345C870C7C5520C3DB1B66,42871,0,5,5,30,45,1545
12630,12630,2DBE50C130345C870C7C5520C3DB1B66,12311,7,16,9,30,44,1544
12631,12631,2DBE50C130345C870C7C5520C3DB1B66,42871,17,21,4,30,45,1545
12641,12641,FE0FFC246F39C2C39928F11916677E47,42301,3,5,2,36,47,1847
12642,12642,FE0FFC246F39C2C39928F11916677E47,42511,5,13,8,37,47,1897
12643,12643,FE0FFC246F39C2C39928F11916677E47,42301,14,20,6,36,47,1847
12644,12644,D511994F01F94DCFC72D9B68CBD83EAB,13601,0,7,7,34,47,1747
12645,12645,D511994F01F94DCFC72D9B68CBD83EAB,42511,7,12,5,37,47,1897
12646,12646,D511994F01F94DCFC72D9B68CBD83EAB,10151,12,22,10,34,47,1747
12650,12650,4C8E92DBB85921608C1C92929A7A8C92,42521,0,7,7,31,47,1597
12651,12651,4C8E92DBB85921608C1C92929A7A8C92,13651,7,9,2,30,47,1547
12652,12652,4C8E92DBB85921608C1C92929A7A8C92,42521,12,13,1,31,47,1597
12653,12653,4C8E92DBB85921608C1C92929A7A8C92,13651,14,22,8,30,47,1547
12700,12700,D429753EEB35077FBB0F7FD7B24671DA,42381,0,6,6,39,41,1991
12701,12701,D429753EEB35077FBB0F7FD7B24671DA,43451,6,11,5,37,40,1890
12702,12702,D429753EEB35077FBB0F7FD7B24671DA,42381,12,22,10,39,41,1991
12703,12703,24C52F5FD3AA43CF1A9BAB6BC0B1DF40,42021,2,5,3,33,47,1697
12704,12704,24C52F5FD3AA43CF1A9BAB6BC0B1DF40,43161,8,9,1,35,47,1797
12705,12705,24C52F5FD3AA43CF1A9BAB6BC0B1DF40,42021,9,16,7,33,47,1697
12706,12706,24C52F5FD3AA43CF1A9BAB6BC0B1DF40,43731,16,18,2,34,47,1747
12720,12720,04E25EABAF57B3731144C024B2F68618,42631,1,8,7,43,45,2195
12721,12721,04E25EABAF57B3731144C024B2F68618,13341,9,16,7,44,45,2245
12722,12722,04E25EABAF57B3731144C024B2F68618,42631,18,20,2,43,45,2195
12723,12723,1DD07CF7FD5B3CCCB4E85025836774E4,12841,0,7,7,37,47,1897
12724,12724,1DD07CF7FD5B3CCCB4E85025836774E4,11231,7,17,10,37,49,1899
12725,12725,1DD07CF7FD5B3CCCB4E85025836774E4,12841,22,23,1,37,47,1897
12747,12747,57E38E75C3154FA28FE7B22CE29AF775,11061,1,3,2,29,48,1498
12748,12748,57E38E75C3154FA28FE7B22CE29AF775,11151,4,12,8,30,48,1548
12749,12749,57E38E75C3154FA28FE7B22CE29AF775,11061,14,18,4,29,48,1498
12754,12754,069BAE5FB0899ED72A584CDA4220BCCF,12581,0,6,6,24,48,1248
12755,12755,069BAE5FB0899ED72A584CDA4220BCCF,12601,6,10,4,25,47,1297
12756,12756,069BAE5FB0899ED72A584CDA4220BCCF,11361,14,19,5,22,48,1148
12757,12757,D2007E56CDD263F500CAE75A804D6B50,42871,1,6,5,30,45,1545
12758,12758,D2007E56CDD263F500CAE75A804D6B50,12311,8,9,1,30,44,1544
12759,12759,D2007E56CDD263F500CAE75A804D6B50,11324,9,19,10,31,46,1596
12760,12760,D2007E56CDD263F500CAE75A804D6B50,12311,20,21,1,30,44,1544
12761,12761,CACCA958326BD145289AA6A855FE199B,11381,0,7,7,30,47,1547
12762,12762,CACCA958326BD145289AA6A855FE199B,43971,8,11,3,30,48,1548
12763,12763,CACCA958326BD145289AA6A855FE199B,11061,15,19,4,29,48,1498
12764,12764,CACCA958326BD145289AA6A855FE199B,43971,22,23,1,30,48,1548
12765,12765,58FF60972C1637520443DC5766A2AB67,13411,0,5,5,49,42,2492
12766,12766,58FF60972C1637520443DC5766A2AB67,43951,6,21,15,49,41,2491
12767,12767,58FF60972C1637520443DC5766A2AB67,13411,21,23,2,49,42,2492
12777,12777,83B65A620AA8887006B94BCE755E769B,10351,1,2,1,28,45,1445
12778,12778,83B65A620AA8887006B94BCE755E769B,10634,2,13,11,27,45,1395
12779,12779,83B65A620AA8887006B94BCE755E769B,10351,16,23,7,28,45,1445
12784,12784,5513A4EBEB51AF5647B29C75D8B8CC2C,10281,0,8,8,33,48,1698
12785,12785,5513A4EBEB51AF5647B29C75D8B8CC2C,12971,13,15,2,32,48,1648
12786,12786,5513A4EBEB51AF5647B29C75D8B8CC2C,11531,18,20,2,34,49,1749
12787,12787,5513A4EBEB51AF5647B29C75D8B8CC2C,10901,21,23,2,35,48,1798
12792,12792,9A519709635398D7673DD5F4D42C6C46,42151,0,13,13,35,45,1795
12793,12793,9A519709635398D7673DD5F4D42C6C46,12491,15,18,3,36,43,1843
12794,12794,9A519709635398D7673DD5F4D42C6C46,42151,22,23,1,35,45,1795
12807,12807,D46D481AE4A1808392E89F68BF1C527D,11061,0,4,4,29,48,1498
12808,12808,D46D481AE4A1808392E89F68BF1C527D,11381,4,7,3,30,47,1547
12809,12809,D46D481AE4A1808392E89F68BF1C527D,40441,9,10,1,30,48,1548
12810,12810,D46D481AE4A1808392E89F68BF1C527D,11061,13,22,9,29,48,1498
12811,12811,649D537EAF2002D83012C69B3CA759A0,11161,1,12,11,32,48,1648
12812,12812,649D537EAF2002D83012C69B3CA759A0,43311,15,16,1,31,48,1598
12813,12813,649D537EAF2002D83012C69B3CA759A0,11161,18,19,1,32,48,1648
12817,12817,EC1141E725A7198CD46488DFBB2FD884,12311,3,5,2,30,44,1544
12818,12818,EC1141E725A7198CD46488DFBB2FD884,42531,6,11,5,31,45,1595
12819,12819,EC1141E725A7198CD46488DFBB2FD884,12311,14,15,1,30,44,1544
12820,12820,EC1141E725A7198CD46488DFBB2FD884,42531,19,23,4,31,45,1595
12821,12821,25D7A02E36F2606193AA6545F1D088D2,42041,0,1,1,10,47,547
12822,12822,25D7A02E36F2606193AA6545F1D088D2,19441,2,5,3,8,46,446
12823,12823,25D7A02E36F2606193AA6545F1D088D2,42041,8,9,1,10,47,547
12824,12824,25D7A02E36F2606193AA6545F1D088D2,19441,12,22,10,8,46,446
12830,12830,FD5EF28EAD4BB7B6215FEE28B08DAD3E,12661,0,8,8,32,45,1645
12831,12831,FD5EF28EAD4BB7B6215FEE28B08DAD3E,12311,8,10,2,30,44,1544
12832,12832,FD5EF28EAD4BB7B6215FEE28B08DAD3E,12661,12,22,10,32,45,1645
12833,12833,BC76CCD190FA1A5238AAD9129E2B96C9,40463,3,8,5,38,49,1949
12834,12834,BC76CCD190FA1A5238AAD9129E2B96C9,43281,9,12,3,37,48,1898
12835,12835,BC76CCD190FA1A5238AAD9129E2B96C9,11231,14,20,6,37,49,1899
12836,12836,A8DFAF39A5A26AE1BCD9E9DE060BB315,11091,0,6,6,29,47,1497
12837,12837,A8DFAF39A5A26AE1BCD9E9DE060BB315,13651,7,8,1,30,47,1547
12838,12838,A8DFAF39A5A26AE1BCD9E9DE060BB315,11091,12,23,11,29,47,1497
12839,12839,2FC158799FF19F821FBD3DC4EFE863DB,13551,3,4,1,45,38,2288
12840,12840,2FC158799FF19F821FBD3DC4EFE863DB,43101,8,16,8,46,40,2340
12841,12841,2FC158799FF19F821FBD3DC4EFE863DB,13551,17,23,6,45,38,2288
12853,12853,5B985E49A96AC1F29BC71E54AB886B64,10351,1,5,4,28,45,1445
12854,12854,5B985E49A96AC1F29BC71E54AB886B64,10634,8,20,12,27,45,1395
12855,12855,5B985E49A96AC1F29BC71E54AB886B64,10351,21,23,2,28,45,1445
12862,12862,5B7D20533455968081F1917AE3C512DE,13711,0,8,8,38,46,1946
12863,12863,5B7D20533455968081F1917AE3C512DE,10841,8,20,12,37,47,1897
12864,12864,5B7D20533455968081F1917AE3C512DE,13121,22,23,1,38,46,1946
12865,12865,E798B778C510EAE2B47A353D8CC843E2,10491,0,7,7,33,48,1698
12866,12866,E798B778C510EAE2B47A353D8CC843E2,12083,8,10,2,36,49,1849
12867,12867,E798B778C510EAE2B47A353D8CC843E2,11751,15,18,3,35,48,1798
12868,12868,E798B778C510EAE2B47A353D8CC843E2,40951,19,22,3,36,49,1849
12869,12869,1F287FE4E3311A3DAAF9576E84DED638,13651,0,18,18,30,47,1547
12870,12870,1F287FE4E3311A3DAAF9576E84DED638,11861,19,20,1,32,47,1647
12871,12871,1F287FE4E3311A3DAAF9576E84DED638,13651,20,22,2,30,47,1547
12877,12877,FCF6425DA3F542476DF1F93935C075D8,42581,0,9,9,38,48,1948
12878,12878,FCF6425DA3F542476DF1F93935C075D8,11914,11,20,9,37,48,1898
12879,12879,FCF6425DA3F542476DF1F93935C075D8,42581,21,23,2,38,48,1948
12880,12880,F3DCE8C3C3FF003CDF3D27C94852CCE1,11951,0,6,6,31,49,1599
12881,12881,F3DCE8C3C3FF003CDF3D27C94852CCE1,13731,9,20,11,33,49,1699
12882,12882,F3DCE8C3C3FF003CDF3D27C94852CCE1,11954,22,23,1,32,49,1649
12894,12894,D64DF2C2FAB80CB42859AD7194DBB705,11921,0,9,9,38,48,1948
12895,12895,D64DF2C2FAB80CB42859AD7194DBB705,11751,11,15,4,35,48,1798
12896,12896,D64DF2C2FAB80CB42859AD7194DBB705,11921,20,23,3,38,48,1948
12897,12897,DC7FAF072C0466482465CF89FB10D518,40951,4,7,3,36,49,1849
12898,12898,DC7FAF072C0466482465CF89FB10D518,11751,7,15,8,35,48,1798
12899,12899,DC7FAF072C0466482465CF89FB10D518,40951,18,22,4,36,49,1849
12900,12900,BA68D19087DD7682E8C396165511A278,11381,0,9,9,30,47,1547
12901,12901,BA68D19087DD7682E8C396165511A278,11161,13,18,5,32,48,1648
12902,12902,BA68D19087DD7682E8C396165511A278,11381,18,23,5,30,47,1547
12911,12911,705C51D8F089C59467951CA7C8D9F6AF,43761,0,9,9,32,47,1647
12912,12912,705C51D8F089C59467951CA7C8D9F6AF,11381,10,11,1,30,47,1547
12913,12913,705C51D8F089C59467951CA7C8D9F6AF,43761,12,22,10,32,47,1647
12914,12914,67EEF12624F5A3B71954681C5774CEB1,42331,0,8,8,39,46,1996
12915,12915,67EEF12624F5A3B71954681C5774CEB1,42221,9,11,2,38,48,1948
12916,12916,67EEF12624F5A3B71954681C5774CEB1,42331,11,13,2,39,46,1996
12917,12917,67EEF12624F5A3B71954681C5774CEB1,11011,18,21,3,39,49,1999
12924,12924,63A1194DA67A916294F825B4249AD293,42161,0,8,8,36,47,1847
12925,12925,63A1194DA67A916294F825B4249AD293,11261,8,17,9,36,46,1846
12926,12926,63A1194DA67A916294F825B4249AD293,42351,22,23,1,38,45,1945
12927,12927,7F73EEE1198B300F5190B9A740E251E3,13911,0,5,5,39,46,1996
12928,12928,7F73EEE1198B300F5190B9A740E251E3,11261,5,8,3,36,46,1846
12929,12929,7F73EEE1198B300F5190B9A740E251E3,13911,11,13,2,39,46,1996
12930,12930,7F73EEE1198B300F5190B9A740E251E3,11261,14,21,7,36,46,1846
12946,12946,2DAFA17DB11790D4EE4B19E2BC259374,13101,0,12,12,40,47,2047
12947,12947,2DAFA17DB11790D4EE4B19E2BC259374,40833,13,15,2,41,47,2097
12948,12948,2DAFA17DB11790D4EE4B19E2BC259374,13101,15,18,3,40,47,2047
12949,12949,2DAFA17DB11790D4EE4B19E2BC259374,43481,20,23,3,39,48,1998
12950,12950,2B75D649D733D42AAC85CA634BF0D07B,11914,0,9,9,37,48,1898
12951,12951,2B75D649D733D42AAC85CA634BF0D07B,42581,11,13,2,38,48,1948
12952,12952,2B75D649D733D42AAC85CA634BF0D07B,11914,14,19,5,37,48,1898
12956,12956,77EA23FEBF1AF98A4F6293E826F27BD4,42271,0,15,15,40,47,2047
12957,12957,77EA23FEBF1AF98A4F6293E826F27BD4,11806,17,18,1,41,48,2098
12958,12958,77EA23FEBF1AF98A4F6293E826F27BD4,42271,20,23,3,40,47,2047
12966,12966,B207D5D3140535CF644F21B83755D02D,10471,0,8,8,37,48,1898
12967,12967,B207D5D3140535CF644F21B83755D02D,43361,9,19,10,38,48,1948
12968,12968,B207D5D3140535CF644F21B83755D02D,10471,19,22,3,37,48,1898
12969,12969,45007D53CD893CF2B9EAC0FEF51E66DB,43761,0,9,9,32,47,1647
12970,12970,45007D53CD893CF2B9EAC0FEF51E66DB,10901,9,12,3,35,48,1798
12971,12971,45007D53CD893CF2B9EAC0FEF51E66DB,12161,12,20,8,32,46,1646
12975,12975,FC707C73D6614611D82A13C2F325D332,11074,1,18,17,37,47,1897
12976,12976,FC707C73D6614611D82A13C2F325D332,11021,18,21,3,36,49,1849
12977,12977,FC707C73D6614611D82A13C2F325D332,11074,22,23,1,37,47,1897
12985,12985,608C90ED7FC76CF7CE6E88782DED1A61,42301,0,1,1,36,47,1847
12986,12986,608C90ED7FC76CF7CE6E88782DED1A61,10841,4,8,4,37,47,1897
12987,12987,608C90ED7FC76CF7CE6E88782DED1A61,42301,10,18,8,36,47,1847
12988,12988,608C90ED7FC76CF7CE6E88782DED1A61,10841,21,22,1,37,47,1897
12992,12992,5ED8949BAC5CDF05EDA1019FB7CA4B17,42401,0,11,11,36,47,1847
12993,12993,5ED8949BAC5CDF05EDA1019FB7CA4B17,10471,13,21,8,37,48,1898
12994,12994,5ED8949BAC5CDF05EDA1019FB7CA4B17,42301,21,22,1,36,47,1847
12998,12998,61D4369B95803102112EEFE32BD36465,10295,0,5,5,30,47,1547
12999,12999,61D4369B95803102112EEFE32BD36465,43761,6,16,10,32,47,1647
13000,13000,61D4369B95803102112EEFE32BD36465,10295,16,23,7,30,47,1547
13004,13004,302E13281DC08AB4B0CB613D73ADA12A,11381,0,6,6,30,47,1547
13005,13005,302E13281DC08AB4B0CB613D73ADA12A,10711,8,10,2,29,46,1496
13006,13006,302E13281DC08AB4B0CB613D73ADA12A,42501,12,16,4,28,47,1447
13007,13007,302E13281DC08AB4B0CB613D73ADA12A,11381,20,23,3,30,47,1547
13025,13025,C5EDB329BEFB6B7051ADFEFF7BA35C16,10731,0,11,11,33,47,1697
13026,13026,C5EDB329BEFB6B7051ADFEFF7BA35C16,13601,18,19,1,34,47,1747
13027,13027,C5EDB329BEFB6B7051ADFEFF7BA35C16,10731,20,23,3,33,47,1697
13031,13031,C1664BA564BC8FF7C20F47733006D06C,40302,0,1,1,40,49,2049
13032,13032,C1664BA564BC8FF7C20F47733006D06C,11301,2,7,5,41,49,2099
13033,13033,C1664BA564BC8FF7C20F47733006D06C,11291,19,23,4,40,49,2049
13034,13034,91EB59FA0D03DF92CD974EF6C6B73426,11381,1,7,6,30,47,1547
13035,13035,91EB59FA0D03DF92CD974EF6C6B73426,10951,8,15,7,29,48,1498
13036,13036,91EB59FA0D03DF92CD974EF6C6B73426,43971,15,17,2,30,48,1548
13037,13037,91EB59FA0D03DF92CD974EF6C6B73426,11061,18,19,1,29,48,1498
13038,13038,4D92520D1E60176F5F81838CD0F00070,10681,0,13,13,30,48,1548
13039,13039,4D92520D1E60176F5F81838CD0F00070,42523,14,16,2,31,47,1597
13040,13040,4D92520D1E60176F5F81838CD0F00070,40094,19,23,4,29,48,1498
13044,13044,55536669E97AF41ACDE427113BB85731,10691,0,6,6,33,48,1698
13045,13045,55536669E97AF41ACDE427113BB85731,11861,7,18,11,32,47,1647
13046,13046,55536669E97AF41ACDE427113BB85731,10491,19,23,4,33,48,1698
13047,13047,0CEC3D7EB4E938500D3BE15F068C3654,13121,0,9,9,38,46,1946
13048,13048,0CEC3D7EB4E938500D3BE15F068C3654,42511,11,22,11,37,47,1897
13049,13049,0CEC3D7EB4E938500D3BE15F068C3654,13121,22,23,1,38,46,1946
13050,13050,2EB3873FC04DE2FE7DCCB48F35926C6A,11021,0,15,15,36,49,1849
13051,13051,2EB3873FC04DE2FE7DCCB48F35926C6A,40637,15,21,6,36,47,1847
13052,13052,2EB3873FC04DE2FE7DCCB48F35926C6A,11021,21,23,2,36,49,1849
13063,13063,0F4C8C9CC15A29E7FC40E31F5D2234AD,11151,0,5,5,30,48,1548
13064,13064,0F4C8C9CC15A29E7FC40E31F5D2234AD,10951,5,15,10,29,48,1498
13065,13065,0F4C8C9CC15A29E7FC40E31F5D2234AD,43761,19,20,1,32,47,1647
13066,13066,0F4C8C9CC15A29E7FC40E31F5D2234AD,11151,21,23,2,30,48,1548
13070,13070,E092CE32A450CAD83DD7127F7D30A592,10121,0,12,12,36,49,1849
13071,13071,E092CE32A450CAD83DD7127F7D30A592,11781,12,14,2,38,49,1949
13072,13072,E092CE32A450CAD83DD7127F7D30A592,10121,14,23,9,36,49,1849
13084,13084,86877F32D6D32D1728C272FD8E7855F4,10281,0,8,8,33,48,1698
13085,13085,86877F32D6D32D1728C272FD8E7855F4,11861,8,19,11,32,47,1647
13086,13086,86877F32D6D32D1728C272FD8E7855F4,42021,19,21,2,33,47,1697
13087,13087,F4C8F856DD638BBA75F52C720E10C05D,12921,0,12,12,9,41,491
13088,13088,F4C8F856DD638BBA75F52C720E10C05D,12641,15,17,2,10,43,543
13089,13089,F4C8F856DD638BBA75F52C720E10C05D,12921,20,22,2,9,41,491
13094,13094,1788FF83230593384DFEF88881720D90,13551,0,5,5,45,38,2288
13095,13095,1788FF83230593384DFEF88881720D90,43101,6,10,4,46,40,2340
13096,13096,1788FF83230593384DFEF88881720D90,13551,13,16,3,45,38,2288
13097,13097,1788FF83230593384DFEF88881720D90,43101,17,23,6,46,40,2340
13101,13101,D3870A8F0725CD9DDC6F7F06DC3D6803,11531,0,15,15,34,49,1749
13102,13102,D3870A8F0725CD9DDC6F7F06DC3D6803,11491,16,18,2,36,47,1847
13103,13103,D3870A8F0725CD9DDC6F7F06DC3D6803,42471,19,20,1,35,49,1799
13104,13104,D3870A8F0725CD9DDC6F7F06DC3D6803,41061,20,23,3,34,49,1749
13105,13105,540311DE1F12F752C637697C87C1492F,43951,0,7,7,49,41,2491
13106,13106,540311DE1F12F752C637697C87C1492F,43101,8,10,2,46,40,2340
13107,13107,540311DE1F12F752C637697C87C1492F,43951,11,23,12,49,41,2491
13120,13120,0DFD98C5BF618352145AEF64606DF221,40673,3,5,2,36,48,1848
13121,13121,0DFD98C5BF618352145AEF64606DF221,10251,9,16,7,35,47,1797
13122,13122,0DFD98C5BF618352145AEF64606DF221,40637,16,19,3,36,47,1847
13123,13123,0DFD98C5BF618352145AEF64606DF221,10251,19,23,4,35,47,1797
13129,13129,0A8AE3881F70E69B30592EBEF611BA81,11271,0,14,14,37,48,1898
13130,13130,0A8AE3881F70E69B30592EBEF611BA81,11731,15,17,2,36,48,1848
13131,13131,0A8AE3881F70E69B30592EBEF611BA81,10471,18,21,3,37,48,1898
13132,13132,852E3B3147C49E24C4E8F895185E331E,13711,0,18,18,38,46,1946
13133,13133,852E3B3147C49E24C4E8F895185E331E,11941,19,21,2,37,46,1896
13134,13134,852E3B3147C49E24C4E8F895185E331E,13711,22,23,1,38,46,1946
13135,13135,1DD5E3CBE74991223EA5E7C350F82331,42271,2,5,3,40,47,2047
13136,13136,1DD5E3CBE74991223EA5E7C350F82331,11806,6,7,1,41,48,2098
13137,13137,1DD5E3CBE74991223EA5E7C350F82331,42511,9,18,9,37,47,1897
13138,13138,D73B2854AD737668DCBFC2AD5E22AA5A,42864,0,16,16,38,44,1944
13139,13139,D73B2854AD737668DCBFC2AD5E22AA5A,11261,16,20,4,36,46,1846
13140,13140,D73B2854AD737668DCBFC2AD5E22AA5A,42864,20,23,3,38,44,1944
13141,13141,DF5678A2D82F170D018446CB4502486B,12083,0,9,9,36,49,1849
13142,13142,DF5678A2D82F170D018446CB4502486B,11271,11,12,1,37,48,1898
13143,13143,DF5678A2D82F170D018446CB4502486B,12083,14,23,9,36,49,1849
13144,13144,522EF83A0BB6C187BC51EA021D98EB82,10781,0,8,8,35,47,1797
13145,13145,522EF83A0BB6C187BC51EA021D98EB82,10161,9,11,2,35,49,1799
13146,13146,522EF83A0BB6C187BC51EA021D98EB82,40101,12,15,3,34,49,1749
13147,13147,522EF83A0BB6C187BC51EA021D98EB82,40611,20,23,3,35,47,1797
13148,13148,050DDEC4D8CD45F98B317044CE5D05E1,42521,0,3,3,31,47,1597
13149,13149,050DDEC4D8CD45F98B317044CE5D05E1,11381,3,12,9,30,47,1547
13150,13150,050DDEC4D8CD45F98B317044CE5D05E1,42521,12,14,2,31,47,1597
13151,13151,050DDEC4D8CD45F98B317044CE5D05E1,40331,19,20,1,30,47,1547
13152,13152,4CCB55254B52DB3F5A81A19CE1E78374,11231,0,8,8,37,49,1899
13153,13153,4CCB55254B52DB3F5A81A19CE1E78374,10121,10,20,10,36,49,1849
13154,13154,4CCB55254B52DB3F5A81A19CE1E78374,10661,21,22,1,37,49,1899
13185,13185,5767DCB7927C2A22DA225038742C1BCE,13561,0,6,6,37,49,1899
13186,13186,5767DCB7927C2A22DA225038742C1BCE,11021,7,16,9,36,49,1849
13187,13187,5767DCB7927C2A22DA225038742C1BCE,13561,19,23,4,37,49,1899
13188,13188,CADE9ADEC7B1B2F6454293174DEADF86,10681,1,7,6,30,48,1548
13189,13189,CADE9ADEC7B1B2F6454293174DEADF86,43391,12,19,7,29,48,1498
13190,13190,CADE9ADEC7B1B2F6454293174DEADF86,11151,20,23,3,30,48,1548
13199,13199,6CC24D921FE70D79D98FA5B7890BCB55,42041,0,1,1,10,47,547
13200,13200,6CC24D921FE70D79D98FA5B7890BCB55,19441,2,18,16,8,46,446
13201,13201,6CC24D921FE70D79D98FA5B7890BCB55,42041,20,21,1,10,47,547
13202,13202,98E87BDE72475940AB2A29AC7A54FAE2,13101,1,9,8,40,47,2047
13203,13203,98E87BDE72475940AB2A29AC7A54FAE2,11481,14,15,1,41,48,2098
13204,13204,98E87BDE72475940AB2A29AC7A54FAE2,13101,17,19,2,40,47,2047
13214,13214,1C4DD184F2771AF8D9B0216E0C8822D3,42401,9,10,1,36,47,1847
13215,13215,1C4DD184F2771AF8D9B0216E0C8822D3,10251,11,13,2,35,47,1797
13216,13216,1C4DD184F2771AF8D9B0216E0C8822D3,42401,14,16,2,36,47,1847
13217,13217,1C4DD184F2771AF8D9B0216E0C8822D3,11461,19,20,1,37,49,1899
13238,13238,2F1F7798F5E8889B4080CA59D71F0274,10271,5,6,1,37,46,1896
13239,13239,2F1F7798F5E8889B4080CA59D71F0274,11081,7,9,2,35,46,1796
13240,13240,2F1F7798F5E8889B4080CA59D71F0274,10271,9,16,7,37,46,1896
13241,13241,2F1F7798F5E8889B4080CA59D71F0274,13711,19,20,1,38,46,1946
13242,13242,EBCAFED47778B422FDE48CF06630FC82,13941,0,6,6,41,47,2097
13243,13243,EBCAFED47778B422FDE48CF06630FC82,11301,8,17,9,41,49,2099
13244,13244,EBCAFED47778B422FDE48CF06630FC82,13941,19,23,4,41,47,2097
13245,13245,1BA9D996B3A19A747EE7BB60C0D1E1A7,12521,0,14,14,35,41,1791
13246,13246,1BA9D996B3A19A747EE7BB60C0D1E1A7,43451,16,19,3,37,40,1890
13247,13247,1BA9D996B3A19A747EE7BB60C0D1E1A7,12521,20,21,1,35,41,1791
13248,13248,CCCD2290FB632A48009771412BE68ADD,10691,0,6,6,33,48,1698
13249,13249,CCCD2290FB632A48009771412BE68ADD,11861,6,18,12,32,47,1647
13250,13250,CCCD2290FB632A48009771412BE68ADD,11171,20,22,2,33,48,1698
13264,13264,600D7AE0D829582E691D7BDBD387E918,19441,0,5,5,8,46,446
13265,13265,600D7AE0D829582E691D7BDBD387E918,42041,8,11,3,10,47,547
13266,13266,600D7AE0D829582E691D7BDBD387E918,19441,14,20,6,8,46,446
13267,13267,00AF64C30DD1AF7B063E67637E648889,10271,1,14,13,37,46,1896
13268,13268,00AF64C30DD1AF7B063E67637E648889,42301,16,17,1,36,47,1847
13269,13269,00AF64C30DD1AF7B063E67637E648889,10271,18,21,3,37,46,1896
13278,13278,5D7734B1178D7780B618167D253CC3A3,42864,0,4,4,38,44,1944
13279,13279,5D7734B1178D7780B618167D253CC3A3,42861,7,8,1,37,44,1894
13280,13280,5D7734B1178D7780B618167D253CC3A3,42864,10,23,13,38,44,1944
13281,13281,7E6F1057729DFB8EE8B59466F9245966,13911,0,6,6,39,46,1996
13282,13282,7E6F1057729DFB8EE8B59466F9245966,42231,7,16,9,37,46,1896
13283,13283,7E6F1057729DFB8EE8B59466F9245966,13911,17,19,2,39,46,1996
13299,13299,C994B0BB00A5F5442EEA247C000D74C5,42531,0,13,13,31,45,1595
13300,13300,C994B0BB00A5F5442EEA247C000D74C5,12311,14,16,2,30,44,1544
13301,13301,C994B0BB00A5F5442EEA247C000D74C5,42531,20,23,3,31,45,1595
13302,13302,7EBD3BA762C40F1F8A712F803B7D8FD3,12491,0,4,4,36,43,1843
13303,13303,7EBD3BA762C40F1F8A712F803B7D8FD3,42861,6,18,12,37,44,1894
13304,13304,7EBD3BA762C40F1F8A712F803B7D8FD3,42151,19,22,3,35,45,1795
13305,13305,5E3291503FC27DAA0248AA453FC4D60A,19021,0,7,7,10,45,545
13306,13306,5E3291503FC27DAA0248AA453FC4D60A,19441,12,19,7,8,46,446
13307,13307,5E3291503FC27DAA0248AA453FC4D60A,19021,19,22,3,10,45,545
13313,13313,430321AE9E516EF323C9C38031CC170C,13351,1,2,1,48,48,2448
13314,13314,430321AE9E516EF323C9C38031CC170C,13471,4,21,17,47,49,2399
13315,13315,430321AE9E516EF323C9C38031CC170C,42601,21,22,1,44,48,2248
13322,13322,F238E4BCD894635E3C09F75844D0698F,42231,0,4,4,37,46,1896
13323,13323,F238E4BCD894635E3C09F75844D0698F,13711,4,5,1,38,46,1946
13324,13324,F238E4BCD894635E3C09F75844D0698F,42231,6,21,15,37,46,1896
13325,13325,53B9F7992DB29A9E3000FDBC39A3F0DF,11074,0,12,12,37,47,1897
13326,13326,53B9F7992DB29A9E3000FDBC39A3F0DF,42221,12,13,1,38,48,1948
13327,13327,53B9F7992DB29A9E3000FDBC39A3F0DF,11074,13,20,7,37,47,1897
13328,13328,839E5B2416DDB60AF8D62A7EA6186138,42021,0,1,1,33,47,1697
13329,13329,839E5B2416DDB60AF8D62A7EA6186138,13601,3,8,5,34,47,1747
13330,13330,839E5B2416DDB60AF8D62A7EA6186138,42021,8,23,15,33,47,1697
13331,13331,90600528B50BB7149D64FE0866090771,11954,0,6,6,32,49,1649
13332,13332,90600528B50BB7149D64FE0866090771,13731,7,10,3,33,49,1699
13333,13333,90600528B50BB7149D64FE0866090771,11954,22,23,1,32,49,1649
13348,13348,325F6E45B1DFC860919AE71795AA4212,13511,0,7,7,34,48,1748
13349,13349,325F6E45B1DFC860919AE71795AA4212,11861,12,14,2,32,47,1647
13350,13350,325F6E45B1DFC860919AE71795AA4212,42523,15,17,2,31,47,1597
13351,13351,325F6E45B1DFC860919AE71795AA4212,11861,17,23,6,32,47,1647
13373,13373,C6869A64CA9EF97A25D7192A00726FC2,42401,0,9,9,36,47,1847
13374,13374,C6869A64CA9EF97A25D7192A00726FC2,10781,10,19,9,35,47,1797
13375,13375,C6869A64CA9EF97A25D7192A00726FC2,42401,20,23,3,36,47,1847
13388,13388,181B5103F0FBF120AFF5BEC3A26A3DB7,43761,0,1,1,32,47,1647
13389,13389,181B5103F0FBF120AFF5BEC3A26A3DB7,11161,2,5,3,32,48,1648
13390,13390,181B5103F0FBF120AFF5BEC3A26A3DB7,42141,7,22,15,32,47,1647
13391,13391,FE5EF0C2F4B69A84D6BDB6109B4735F8,42301,0,1,1,36,47,1847
13392,13392,FE5EF0C2F4B69A84D6BDB6109B4735F8,11331,1,4,3,37,48,1898
13393,13393,FE5EF0C2F4B69A84D6BDB6109B4735F8,42161,5,17,12,36,47,1847
13394,13394,FE5EF0C2F4B69A84D6BDB6109B4735F8,10111,22,23,1,37,47,1897
13395,13395,D8963F7C81A647B0DB7A8BBF70036A0B,10471,8,16,8,37,48,1898
13396,13396,D8963F7C81A647B0DB7A8BBF70036A0B,11231,18,20,2,37,49,1899
13397,13397,D8963F7C81A647B0DB7A8BBF70036A0B,12514,21,23,2,38,47,1947
13408,13408,7BE642EB4F7306096A07AB46584D1F89,42071,6,8,2,31,49,1599
13409,13409,7BE642EB4F7306096A07AB46584D1F89,43391,8,10,2,29,48,1498
13410,13410,7BE642EB4F7306096A07AB46584D1F89,42071,10,21,11,31,49,1599
13411,13411,90568B514F9B63E4374F225CB87C45A4,11021,0,9,9,36,49,1849
13412,13412,90568B514F9B63E4374F225CB87C45A4,40271,9,11,2,35,49,1799
13413,13413,90568B514F9B63E4374F225CB87C45A4,11021,12,22,10,36,49,1849
13418,13418,F8E5692DC64F594EE622EF21A4844BEB,19114,1,5,4,7,43,393
13419,13419,F8E5692DC64F594EE622EF21A4844BEB,12921,7,19,12,9,41,491
13420,13420,F8E5692DC64F594EE622EF21A4844BEB,19114,19,23,4,7,43,393
13424,13424,C135D0CC048BFF7E971403A8703667AE,11871,0,7,7,29,46,1496
13425,13425,C135D0CC048BFF7E971403A8703667AE,10351,11,13,2,28,45,1445
13426,13426,C135D0CC048BFF7E971403A8703667AE,42501,15,16,1,28,47,1447
13427,13427,C135D0CC048BFF7E971403A8703667AE,10351,21,23,2,28,45,1445
13431,13431,F82B0744060E830A6F1F73EAFE27E504,42461,0,2,2,45,47,2297
13432,13432,F82B0744060E830A6F1F73EAFE27E504,42321,5,11,6,43,47,2197
13433,13433,F82B0744060E830A6F1F73EAFE27E504,42461,13,18,5,45,47,2297
13434,13434,7CF8DBF6631714E9AE321164C994CF85,42151,0,11,11,35,45,1795
13435,13435,7CF8DBF6631714E9AE321164C994CF85,42861,11,14,3,37,44,1894
13436,13436,7CF8DBF6631714E9AE321164C994CF85,42151,16,19,3,35,45,1795
13437,13437,D75A7C42E9DBEC266E4BBCF60E6957AB,13331,0,14,14,38,47,1947
13438,13438,D75A7C42E9DBEC266E4BBCF60E6957AB,42511,15,16,1,37,47,1897
13439,13439,D75A7C42E9DBEC266E4BBCF60E6957AB,12514,16,19,3,38,47,1947
13440,13440,D75A7C42E9DBEC266E4BBCF60E6957AB,42511,19,20,1,37,47,1897
13449,13449,441E401293D6FFC8E080552D376784E1,42581,0,5,5,38,48,1948
13450,13450,441E401293D6FFC8E080552D376784E1,11914,6,9,3,37,48,1898
13451,13451,441E401293D6FFC8E080552D376784E1,42581,10,23,13,38,48,1948
13452,13452,4CCA23C849E6CF72B9F5665583603418,42041,0,1,1,10,47,547
13453,13453,4CCA23C849E6CF72B9F5665583603418,19441,5,20,15,8,46,446
13454,13454,4CCA23C849E6CF72B9F5665583603418,19024,21,22,1,9,45,495
13455,13455,05EC089A039EAFCC5C0761E74BD23505,42021,0,7,7,33,47,1697
13456,13456,05EC089A039EAFCC5C0761E74BD23505,10491,7,18,11,33,48,1698
13457,13457,05EC089A039EAFCC5C0761E74BD23505,10731,19,23,4,33,47,1697
13463,13463,7636C02B931F5033A3275CA34FA4048C,10161,0,9,9,35,49,1799
13464,13464,7636C02B931F5033A3275CA34FA4048C,11231,10,19,9,37,49,1899
13465,13465,7636C02B931F5033A3275CA34FA4048C,12083,20,22,2,36,49,1849
13476,13476,560DFCBDB07F2D026230A41F510B3170,40945,0,7,7,32,48,1648
13477,13477,560DFCBDB07F2D026230A41F510B3170,10901,11,13,2,35,48,1798
13478,13478,560DFCBDB07F2D026230A41F510B3170,12381,17,23,6,32,48,1648
13492,13492,1392C8E19F85085262C8C4C5B019D410,11074,1,13,12,37,47,1897
13493,13493,1392C8E19F85085262C8C4C5B019D410,11271,17,20,3,37,48,1898
13494,13494,1392C8E19F85085262C8C4C5B019D410,11074,21,23,2,37,47,1897
13498,13498,7416ABA9B70926119329485C1E15D038,11531,2,5,3,34,49,1749
13499,13499,7416ABA9B70926119329485C1E15D038,13731,8,10,2,33,49,1699
13500,13500,7416ABA9B70926119329485C1E15D038,40882,14,16,2,34,49,1749
13501,13501,7416ABA9B70926119329485C1E15D038,13731,17,19,2,33,49,1699
13502,13502,2B742D33ECA5D739DE9809C030EAA6E5,13911,3,4,1,39,46,1996
13503,13503,2B742D33ECA5D739DE9809C030EAA6E5,42351,6,10,4,38,45,1945
13504,13504,2B742D33ECA5D739DE9809C030EAA6E5,13911,14,18,4,39,46,1996
13505,13505,2B742D33ECA5D739DE9809C030EAA6E5,42351,18,22,4,38,45,1945
13511,13511,B7783E40C231BF2A915C5200F2E2562A,12031,0,9,9,33,48,1698
13512,13512,B7783E40C231BF2A915C5200F2E2562A,40951,12,13,1,36,49,1849
13513,13513,B7783E40C231BF2A915C5200F2E2562A,10901,15,18,3,35,48,1798
13514,13514,B7783E40C231BF2A915C5200F2E2562A,10491,19,23,4,33,48,1698
13515,13515,8F8152ABCDBBD4CE857B1EFCB582F5D2,11074,0,14,14,37,47,1897
13516,13516,8F8152ABCDBBD4CE857B1EFCB582F5D2,10251,16,17,1,35,47,1797
13517,13517,8F8152ABCDBBD4CE857B1EFCB582F5D2,42511,18,19,1,37,47,1897
13521,13521,3E17C9F881E8F571652BFE5E841845EF,11861,0,10,10,32,47,1647
13522,13522,3E17C9F881E8F571652BFE5E841845EF,10281,11,12,1,33,48,1698
13523,13523,3E17C9F881E8F571652BFE5E841845EF,11861,12,23,11,32,47,1647
13532,13532,5C2B763013F3453FD43407A455CBD2B2,13651,1,7,6,30,47,1547
13533,13533,5C2B763013F3453FD43407A455CBD2B2,42523,7,11,4,31,47,1597
13534,13534,5C2B763013F3453FD43407A455CBD2B2,13651,13,21,8,30,47,1547
13535,13535,90BDA16C4F6281AE9AFB01EAEB1C60F5,42491,0,4,4,32,46,1646
13536,13536,90BDA16C4F6281AE9AFB01EAEB1C60F5,10292,4,13,9,30,47,1547
13537,13537,90BDA16C4F6281AE9AFB01EAEB1C60F5,11834,17,18,1,32,45,1645
13538,13538,90BDA16C4F6281AE9AFB01EAEB1C60F5,10295,19,23,4,30,47,1547
13544,13544,878DD44EE8FA6A43A619DDA4A892D760,11806,3,12,9,41,48,2098
13545,13545,878DD44EE8FA6A43A619DDA4A892D760,42271,15,16,1,40,47,2047
13546,13546,878DD44EE8FA6A43A619DDA4A892D760,11806,21,22,1,41,48,2098
13550,13550,89E9D5A5271FF46B57D9025356B7D83E,12511,0,3,3,39,47,1997
13551,13551,89E9D5A5271FF46B57D9025356B7D83E,10251,3,10,7,35,47,1797
13552,13552,89E9D5A5271FF46B57D9025356B7D83E,12511,14,17,3,39,47,1997
13553,13553,89E9D5A5271FF46B57D9025356B7D83E,10251,18,23,5,35,47,1797
13584,13584,27B6DDFE3A356062F221ABD7AD70BB14,11061,0,11,11,29,48,1498
13585,13585,27B6DDFE3A356062F221ABD7AD70BB14,10681,13,14,1,30,48,1548
13586,13586,27B6DDFE3A356062F221ABD7AD70BB14,11061,16,23,7,29,48,1498
13593,13593,2F399A698BEA43598809D8DBB3D9EDAE,10251,0,9,9,35,47,1797
13594,13594,2F399A698BEA43598809D8DBB3D9EDAE,42161,10,15,5,36,47,1847
13595,13595,2F399A698BEA43598809D8DBB3D9EDAE,11074,15,16,1,37,47,1897
13596,13596,2F399A698BEA43598809D8DBB3D9EDAE,42161,16,22,6,36,47,1847
13642,13642,1DD1A250791E8DE9D0B949B1DAE230C8,11861,0,12,12,32,47,1647
13643,13643,1DD1A250791E8DE9D0B949B1DAE230C8,42921,15,16,1,33,47,1697
13644,13644,1DD1A250791E8DE9D0B949B1DAE230C8,11861,18,23,5,32,47,1647
13651,13651,AF2C6BFE514EA88D5A42A7C3651D6C39,10521,0,6,6,41,47,2097
13652,13652,AF2C6BFE514EA88D5A42A7C3651D6C39,42031,7,8,1,40,46,2046
13653,13653,AF2C6BFE514EA88D5A42A7C3651D6C39,10521,11,23,12,41,47,2097
13654,13654,F375472DEA772AB5B5D461F4E41453CE,11531,2,3,1,34,49,1749
13655,13655,F375472DEA772AB5B5D461F4E41453CE,10107,8,13,5,38,49,1949
13656,13656,F375472DEA772AB5B5D461F4E41453CE,40073,14,15,1,37,48,1898
13657,13657,F375472DEA772AB5B5D461F4E41453CE,11531,18,23,5,34,49,1749
13670,13670,B2542631715105DE17F7E7EFAA92BF3C,10634,0,5,5,27,45,1395
13671,13671,B2542631715105DE17F7E7EFAA92BF3C,10351,6,7,1,28,45,1445
13672,13672,B2542631715105DE17F7E7EFAA92BF3C,10634,10,14,4,27,45,1395
13673,13673,B2542631715105DE17F7E7EFAA92BF3C,10351,14,22,8,28,45,1445
13684,13684,A142A9884E67106A6220A3EE51BBA9B4,43391,0,17,17,29,48,1498
13685,13685,A142A9884E67106A6220A3EE51BBA9B4,42071,20,21,1,31,49,1599
13686,13686,A142A9884E67106A6220A3EE51BBA9B4,10544,21,23,2,28,48,1448
13693,13693,1228A94EA6C2D4622CFEAC816DA2851D,12083,10,13,3,36,49,1849
13694,13694,1228A94EA6C2D4622CFEAC816DA2851D,10901,14,16,2,35,48,1798
13695,13695,1228A94EA6C2D4622CFEAC816DA2851D,11914,18,23,5,37,48,1898
13700,13700,5B4A62417F5A4F9410202233EBE759A1,42161,0,11,11,36,47,1847
13701,13701,5B4A62417F5A4F9410202233EBE759A1,10251,13,17,4,35,47,1797
13702,13702,5B4A62417F5A4F9410202233EBE759A1,11201,18,22,4,35,49,1799
13712,13712,8CD04C997EB95D4B4DE5A204C23AD401,11061,0,7,7,29,48,1498
13713,13713,8CD04C997EB95D4B4DE5A204C23AD401,11381,10,12,2,30,47,1547
13714,13714,8CD04C997EB95D4B4DE5A204C23AD401,11061,13,23,10,29,48,1498
13715,13715,4D239E998445105BB1DB28C4CB8040D2,42581,0,6,6,38,48,1948
13716,13716,4D239E998445105BB1DB28C4CB8040D2,11914,10,11,1,37,48,1898
13717,13717,4D239E998445105BB1DB28C4CB8040D2,42581,11,21,10,38,48,1948
13718,13718,6D2C11DB3E76C2943C7F716A3AF725C0,12921,0,6,6,9,41,491
13719,13719,6D2C11DB3E76C2943C7F716A3AF725C0,49201,7,15,8,7,41,391
13720,13720,6D2C11DB3E76C2943C7F716A3AF725C0,12921,17,18,1,9,41,491
13729,13729,ACD7D06D699A88B2E7BB7970CE635C80,42291,0,1,1,29,48,1498
13730,13730,ACD7D06D699A88B2E7BB7970CE635C80,11381,2,12,10,30,47,1547
13731,13731,ACD7D06D699A88B2E7BB7970CE635C80,42521,18,19,1,31,47,1597
13732,13732,ACD7D06D699A88B2E7BB7970CE635C80,10951,22,23,1,29,48,1498
13733,13733,AE21E38BEFF88B1BA1578ED2E6E5DC28,11074,9,10,1,37,47,1897
13734,13734,AE21E38BEFF88B1BA1578ED2E6E5DC28,42281,11,13,2,40,48,2048
13735,13735,AE21E38BEFF88B1BA1578ED2E6E5DC28,11074,15,23,8,37,47,1897
13736,13736,B4384B03AA2ADCFD4B5B44E462DB395A,42141,0,2,2,32,47,1647
13737,13737,B4384B03AA2ADCFD4B5B44E462DB395A,42523,3,5,2,31,47,1597
13738,13738,B4384B03AA2ADCFD4B5B44E462DB395A,43761,6,23,17,32,47,1647
13739,13739,21AC65A8AD6DD1CC1B08784723EC34D0,42491,9,11,2,32,46,1646
13740,13740,21AC65A8AD6DD1CC1B08784723EC34D0,43471,13,14,1,31,49,1599
13741,13741,21AC65A8AD6DD1CC1B08784723EC34D0,12121,17,22,5,29,47,1497
13745,13745,EA76F6018E37635F2D98F3C61FC7376D,10841,0,1,1,37,47,1897
13746,13746,EA76F6018E37635F2D98F3C61FC7376D,13331,2,17,15,38,47,1947
13747,13747,EA76F6018E37635F2D98F3C61FC7376D,10841,17,22,5,37,47,1897
13748,13748,DFA44588B9F7612E59AB24A1351E5F4F,12921,0,7,7,9,41,491
13749,13749,DFA44588B9F7612E59AB24A1351E5F4F,49201,11,16,5,7,41,391
13750,13750,DFA44588B9F7612E59AB24A1351E5F4F,12921,19,20,1,9,41,491
13769,13769,73109D29A83EBAB3020EBE70AADA7F4C,11231,0,19,19,37,49,1899
13770,13770,73109D29A83EBAB3020EBE70AADA7F4C,10111,20,21,1,37,47,1897
13771,13771,73109D29A83EBAB3020EBE70AADA7F4C,11231,21,23,2,37,49,1899
13772,13772,AF35FEF982B809F3290F56D79493C34D,43311,0,7,7,31,48,1598
13773,13773,AF35FEF982B809F3290F56D79493C34D,10681,8,12,4,30,48,1548
13774,13774,AF35FEF982B809F3290F56D79493C34D,10901,19,20,1,35,48,1798
13775,13775,6CD008CBF5332727B7FB0E79DB4BAD66,43761,1,9,8,32,47,1647
13776,13776,6CD008CBF5332727B7FB0E79DB4BAD66,10901,10,21,11,35,48,1798
13777,13777,6CD008CBF5332727B7FB0E79DB4BAD66,43761,21,23,2,32,47,1647
13778,13778,D01D236B816B958BA0840FB83B5A7890,13711,0,5,5,38,46,1946
13779,13779,D01D236B816B958BA0840FB83B5A7890,10271,6,8,2,37,46,1896
13780,13780,D01D236B816B958BA0840FB83B5A7890,13711,13,23,10,38,46,1946
13784,13784,5C68005FCE275073B922C918E043BC34,42521,0,9,9,31,47,1597
13785,13785,5C68005FCE275073B922C918E043BC34,11151,11,14,3,30,48,1548
13786,13786,5C68005FCE275073B922C918E043BC34,11061,17,21,4,29,48,1498
13792,13792,0D7924567492FFCAAF3EE449A4BEBE16,11941,0,11,11,37,46,1896
13793,13793,0D7924567492FFCAAF3EE449A4BEBE16,13711,12,14,2,38,46,1946
13794,13794,0D7924567492FFCAAF3EE449A4BEBE16,11941,14,23,9,37,46,1896
13798,13798,AC414DB8853E95A441FB40B4893530F7,11871,0,4,4,29,46,1496
13799,13799,AC414DB8853E95A441FB40B4893530F7,10634,8,9,1,27,45,1395
13800,13800,AC414DB8853E95A441FB40B4893530F7,10711,13,14,1,29,46,1496
13801,13801,AC414DB8853E95A441FB40B4893530F7,10634,17,19,2,27,45,1395
13802,13802,7519688F2823ACD139AD98518D6F0074,42941,0,6,6,37,47,1897
13803,13803,7519688F2823ACD139AD98518D6F0074,11261,7,14,7,36,46,1846
13804,13804,7519688F2823ACD139AD98518D6F0074,11011,18,22,4,39,49,1999
13811,13811,09C2A5500F5ABAEEAC932C07F5628EC4,11021,0,2,2,36,49,1849
13812,13812,09C2A5500F5ABAEEAC932C07F5628EC4,10251,9,12,3,35,47,1797
13813,13813,09C2A5500F5ABAEEAC932C07F5628EC4,42161,14,18,4,36,47,1847
13814,13814,09C2A5500F5ABAEEAC932C07F5628EC4,11021,19,23,4,36,49,1849
13843,13843,D4FB6B465C87A5D763D7E62820C6F264,42041,0,6,6,10,47,547
13844,13844,D4FB6B465C87A5D763D7E62820C6F264,19441,8,12,4,8,46,446
13845,13845,D4FB6B465C87A5D763D7E62820C6F264,42041,13,14,1,10,47,547
13846,13846,D4FB6B465C87A5D763D7E62820C6F264,19441,16,20,4,8,46,446
13847,13847,60B3904EE9AFD7C630994F95D4C927AC,40925,2,3,1,35,49,1799
13848,13848,60B3904EE9AFD7C630994F95D4C927AC,13561,4,6,2,37,49,1899
13849,13849,60B3904EE9AFD7C630994F95D4C927AC,10121,7,14,7,36,49,1849
13850,13850,60B3904EE9AFD7C630994F95D4C927AC,13561,14,23,9,37,49,1899
13851,13851,35CAA8E33B432720CDD3C14AE49DEBFD,43751,0,7,7,19,48,998
13852,13852,35CAA8E33B432720CDD3C14AE49DEBFD,11641,9,12,3,22,49,1149
13853,13853,35CAA8E33B432720CDD3C14AE49DEBFD,43751,12,22,10,19,48,998
13854,13854,105A3B72395833D152D1F67AE98737D7,12921,7,8,1,9,41,491
13855,13855,105A3B72395833D152D1F67AE98737D7,49201,10,19,9,7,41,391
13856,13856,105A3B72395833D152D1F67AE98737D7,12921,19,20,1,9,41,491
13857,13857,BE782842408BDDB8513DF8B66BC1C78B,42523,8,9,1,31,47,1597
13858,13858,BE782842408BDDB8513DF8B66BC1C78B,43761,11,17,6,32,47,1647
13859,13859,BE782842408BDDB8513DF8B66BC1C78B,42523,17,18,1,31,47,1597
13869,13869,CABDD8B2A8DF9C3C6F2F674E6DD5C884,40445,0,8,8,30,48,1548
13870,13870,CABDD8B2A8DF9C3C6F2F674E6DD5C884,11061,8,12,4,29,48,1498
13871,13871,CABDD8B2A8DF9C3C6F2F674E6DD5C884,11381,15,17,2,30,47,1547
13872,13872,CABDD8B2A8DF9C3C6F2F674E6DD5C884,11061,17,21,4,29,48,1498
13873,13873,435E98F8E4BA1C5ED5B064CF22D1AAF1,40302,0,8,8,40,49,2049
13874,13874,435E98F8E4BA1C5ED5B064CF22D1AAF1,11301,13,18,5,41,49,2099
13875,13875,435E98F8E4BA1C5ED5B064CF22D1AAF1,10191,20,22,2,40,48,2048
13876,13876,435E98F8E4BA1C5ED5B064CF22D1AAF1,11291,22,23,1,40,49,2049
13880,13880,E4FD608720CF14FACCAF73A22E758728,13671,0,8,8,27,43,1393
13881,13881,E4FD608720CF14FACCAF73A22E758728,13311,10,13,3,27,39,1389
13882,13882,E4FD608720CF14FACCAF73A22E758728,13671,14,22,8,27,43,1393
13886,13886,FC32FCDE5EA162E6A3931CE10EF22190,11021,0,7,7,36,49,1849
13887,13887,FC32FCDE5EA162E6A3931CE10EF22190,11231,7,15,8,37,49,1899
13888,13888,FC32FCDE5EA162E6A3931CE10EF22190,11021,18,23,5,36,49,1849
13889,13889,52DE1B5B29EB088C4F7CC0D4865B38F5,42861,5,6,1,37,44,1894
13890,13890,52DE1B5B29EB088C4F7CC0D4865B38F5,42151,9,11,2,35,45,1795
13891,13891,52DE1B5B29EB088C4F7CC0D4865B38F5,42861,15,23,8,37,44,1894
13904,13904,36BD4D1212166D07A10E6E1B76B9BF34,11521,0,7,7,41,48,2098
13905,13905,36BD4D1212166D07A10E6E1B76B9BF34,42221,7,10,3,38,48,1948
13906,13906,36BD4D1212166D07A10E6E1B76B9BF34,11521,12,23,11,41,48,2098
13907,13907,935FCB4619C3634B9AF35CE40D9BEC6A,13341,0,17,17,44,45,2245
13908,13908,935FCB4619C3634B9AF35CE40D9BEC6A,42631,19,20,1,43,45,2195
13909,13909,935FCB4619C3634B9AF35CE40D9BEC6A,13341,21,22,1,44,45,2245
13910,13910,D1DADBAFF8F1838CF54C306F30C9CCE9,10691,0,7,7,33,48,1698
13911,13911,D1DADBAFF8F1838CF54C306F30C9CCE9,11861,10,16,6,32,47,1647
13912,13912,D1DADBAFF8F1838CF54C306F30C9CCE9,10691,19,23,4,33,48,1698
13913,13913,36C68D591F1BB1615F00290E59A07445,42041,0,3,3,10,47,547
13914,13914,36C68D591F1BB1615F00290E59A07445,11851,4,5,1,13,47,697
13915,13915,36C68D591F1BB1615F00290E59A07445,19441,6,10,4,8,46,446
13916,13916,36C68D591F1BB1615F00290E59A07445,42041,11,23,12,10,47,547
13923,13923,2D3690DEC9F54FBE2FC691FE6D82B79A,11161,0,13,13,32,48,1648
13924,13924,2D3690DEC9F54FBE2FC691FE6D82B79A,43761,15,18,3,32,47,1647
13925,13925,2D3690DEC9F54FBE2FC691FE6D82B79A,11161,21,23,2,32,48,1648
13926,13926,D48C648C1D8E99D79DDC90BDE949351A,13231,0,7,7,39,46,1996
13927,13927,D48C648C1D8E99D79DDC90BDE949351A,11261,7,10,3,36,46,1846
13928,13928,D48C648C1D8E99D79DDC90BDE949351A,42351,18,19,1,38,45,1945
13940,13940,1E478A5FEF40D5F63DF757696B4C9EAC,42871,0,10,10,30,45,1545
13941,13941,1E478A5FEF40D5F63DF757696B4C9EAC,11061,12,14,2,29,48,1498
13942,13942,1E478A5FEF40D5F63DF757696B4C9EAC,42871,18,22,4,30,45,1545
13943,13943,A920D999A0B06519620C1851A2CE26C7,11701,10,11,1,43,48,2198
13944,13944,A920D999A0B06519620C1851A2CE26C7,43621,15,16,1,46,48,2348
13945,13945,A920D999A0B06519620C1851A2CE26C7,40691,20,21,1,42,48,2148
13946,13946,FDF3A555382668B3FCFD730AFF8664D2,10411,0,7,7,36,48,1848
13947,13947,FDF3A555382668B3FCFD730AFF8664D2,11231,8,10,2,37,49,1899
13948,13948,FDF3A555382668B3FCFD730AFF8664D2,10471,11,19,8,37,48,1898
13949,13949,FDF3A555382668B3FCFD730AFF8664D2,10411,20,23,3,36,48,1848
13950,13950,C2539EA3F2A1403A8C1A6FE89182F173,42461,0,6,6,45,47,2297
13951,13951,C2539EA3F2A1403A8C1A6FE89182F173,42111,7,10,3,44,46,2246
13952,13952,C2539EA3F2A1403A8C1A6FE89182F173,42461,13,18,5,45,47,2297
13953,13953,C2539EA3F2A1403A8C1A6FE89182F173,42111,21,23,2,44,46,2246
13954,13954,4CCA51CA034FB7B0EC31A2469527D4D6,42981,0,7,7,36,49,1849
13955,13955,4CCA51CA034FB7B0EC31A2469527D4D6,40171,7,15,8,38,48,1948
13956,13956,4CCA51CA034FB7B0EC31A2469527D4D6,11021,17,20,3,36,49,1849
13957,13957,EAAB672210C677BA2879CCE67BDB7DF5,11151,0,13,13,30,48,1548
13958,13958,EAAB672210C677BA2879CCE67BDB7DF5,42831,15,17,2,27,48,1398
13959,13959,EAAB672210C677BA2879CCE67BDB7DF5,11151,21,23,2,30,48,1548
13976,13976,8C7DCF60D5A91C4294A8C14ABFA5CFBF,42581,0,9,9,38,48,1948
13977,13977,8C7DCF60D5A91C4294A8C14ABFA5CFBF,11914,11,13,2,37,48,1898
13978,13978,8C7DCF60D5A91C4294A8C14ABFA5CFBF,40171,13,15,2,38,48,1948
13979,13979,8C7DCF60D5A91C4294A8C14ABFA5CFBF,11914,19,20,1,37,48,1898
13995,13995,A8C0E319CF806B3860CE270F9D93D0BD,11531,0,5,5,34,49,1749
13996,13996,A8C0E319CF806B3860CE270F9D93D0BD,10724,14,16,2,32,48,1648
13997,13997,A8C0E319CF806B3860CE270F9D93D0BD,11531,21,23,2,34,49,1749
14002,14002,7B722A5E06E4F7720DE99CC5059B80F0,10716,0,12,12,30,46,1546
14003,14003,7B722A5E06E4F7720DE99CC5059B80F0,11091,12,13,1,29,47,1497
14004,14004,7B722A5E06E4F7720DE99CC5059B80F0,10716,19,21,2,30,46,1546
14005,14005,BE22ACF7666FB7D08B11F10FC4FFD88E,42011,0,1,1,36,46,1846
14006,14006,BE22ACF7666FB7D08B11F10FC4FFD88E,10271,1,14,13,37,46,1896
14007,14007,BE22ACF7666FB7D08B11F10FC4FFD88E,13711,20,21,1,38,46,1946
14008,14008,BE22ACF7666FB7D08B11F10FC4FFD88E,11941,22,23,1,37,46,1896
14009,14009,FF0C11254BA355CCA708C36EE5C4353D,11381,0,8,8,30,47,1547
14010,14010,FF0C11254BA355CCA708C36EE5C4353D,11831,10,12,2,32,45,1645
14011,14011,FF0C11254BA355CCA708C36EE5C4353D,11061,14,19,5,29,48,1498
14012,14012,9F344971AFB0848D22FABB2D34666ADF,40833,3,10,7,41,47,2097
14013,14013,9F344971AFB0848D22FABB2D34666ADF,42321,14,16,2,43,47,2197
14014,14014,9F344971AFB0848D22FABB2D34666ADF,10801,17,21,4,42,47,2147
14028,14028,8DB35B739E2FE5E0F3ED8AA494F0D7AC,13651,1,9,8,30,47,1547
14029,14029,8DB35B739E2FE5E0F3ED8AA494F0D7AC,11324,9,10,1,31,46,1596
14030,14030,8DB35B739E2FE5E0F3ED8AA494F0D7AC,10292,10,19,9,30,47,1547
14031,14031,8DB35B739E2FE5E0F3ED8AA494F0D7AC,11324,21,22,1,31,46,1596
14032,14032,2446E8F15BFC2A49F5E456D12DC187B8,42071,0,5,5,31,49,1599
14033,14033,2446E8F15BFC2A49F5E456D12DC187B8,43391,10,11,1,29,48,1498
14034,14034,2446E8F15BFC2A49F5E456D12DC187B8,42071,13,19,6,31,49,1599
14035,14035,2446E8F15BFC2A49F5E456D12DC187B8,43391,19,22,3,29,48,1498
14046,14046,F49F5A0F1C44EBAB5BE16379854ACBEE,11061,0,8,8,29,48,1498
14047,14047,F49F5A0F1C44EBAB5BE16379854ACBEE,43971,11,17,6,30,48,1548
14048,14048,F49F5A0F1C44EBAB5BE16379854ACBEE,11381,18,23,5,30,47,1547
14061,14061,54C3FA0AC5E4AF7DFE8A2D92EF7E9AF3,43321,7,8,1,36,49,1849
14062,14062,54C3FA0AC5E4AF7DFE8A2D92EF7E9AF3,11531,11,13,2,34,49,1749
14063,14063,54C3FA0AC5E4AF7DFE8A2D92EF7E9AF3,43321,21,23,2,36,49,1849
14073,14073,EF70B819C0B2D97BD4189E099D0FE5A9,11861,0,9,9,32,47,1647
14074,14074,EF70B819C0B2D97BD4189E099D0FE5A9,10281,12,15,3,33,48,1698
14075,14075,EF70B819C0B2D97BD4189E099D0FE5A9,11861,15,23,8,32,47,1647
14076,14076,905AFBF8C9D2DC6B48AC77C3F506268E,13561,0,6,6,37,49,1899
14077,14077,905AFBF8C9D2DC6B48AC77C3F506268E,11021,8,17,9,36,49,1849
14078,14078,905AFBF8C9D2DC6B48AC77C3F506268E,13561,18,19,1,37,49,1899
14079,14079,905AFBF8C9D2DC6B48AC77C3F506268E,11021,21,23,2,36,49,1849
14084,14084,C35FFF479AFA41CBA0BE0F746C2360BC,11871,0,6,6,29,46,1496
14085,14085,C35FFF479AFA41CBA0BE0F746C2360BC,12311,7,10,3,30,44,1544
14086,14086,C35FFF479AFA41CBA0BE0F746C2360BC,11875,12,23,11,30,46,1546
14113,14113,1D20B498D42204F7DA0BA75047AF3620,10471,0,14,14,37,48,1898
14114,14114,1D20B498D42204F7DA0BA75047AF3620,11201,18,19,1,35,49,1799
14115,14115,1D20B498D42204F7DA0BA75047AF3620,10971,21,23,2,35,47,1797
14125,14125,0A501EA010779C8F9EB8C2F8834C3F4F,10351,1,2,1,28,45,1445
14126,14126,0A501EA010779C8F9EB8C2F8834C3F4F,10301,4,15,11,31,45,1595
14127,14127,0A501EA010779C8F9EB8C2F8834C3F4F,10351,15,23,8,28,45,1445
14128,14128,CE3F81446CD14A2DF1A7AFAE577526FC,11061,0,6,6,29,48,1498
14129,14129,CE3F81446CD14A2DF1A7AFAE577526FC,11381,10,16,6,30,47,1547
14130,14130,CE3F81446CD14A2DF1A7AFAE577526FC,11061,19,21,2,29,48,1498
14136,14136,26E97CCAAB10F50751FB25FC2D6D6457,42861,8,10,2,37,44,1894
14137,14137,26E97CCAAB10F50751FB25FC2D6D6457,11261,11,12,1,36,46,1846
14138,14138,26E97CCAAB10F50751FB25FC2D6D6457,42861,15,21,6,37,44,1894
14139,14139,26E97CCAAB10F50751FB25FC2D6D6457,11261,21,22,1,36,46,1846
14140,14140,FE157E2906F39F22EFF42EFD9B7DC358,11061,0,8,8,29,48,1498
14141,14141,FE157E2906F39F22EFF42EFD9B7DC358,11381,12,16,4,30,47,1547
14142,14142,FE157E2906F39F22EFF42EFD9B7DC358,10681,20,21,1,30,48,1548
14150,14150,737EEA850139715BDA79A2EDECCDCA7A,42861,1,9,8,37,44,1894
14151,14151,737EEA850139715BDA79A2EDECCDCA7A,11261,12,15,3,36,46,1846
14152,14152,737EEA850139715BDA79A2EDECCDCA7A,42864,17,22,5,38,44,1944
14153,14153,3C89D3E050BD396C6E176628C3E38174,10471,0,7,7,37,48,1898
14154,14154,3C89D3E050BD396C6E176628C3E38174,42161,10,19,9,36,47,1847
14155,14155,3C89D3E050BD396C6E176628C3E38174,10471,20,23,3,37,48,1898
14172,14172,CC9D6055E50B8BEAE50E7B56B0FCD1E7,10471,0,14,14,37,48,1898
14173,14173,CC9D6055E50B8BEAE50E7B56B0FCD1E7,11781,15,17,2,38,49,1949
14174,14174,CC9D6055E50B8BEAE50E7B56B0FCD1E7,10121,21,22,1,36,49,1849
14175,14175,C21989F99D3B120EE23386DE2361CA67,42231,0,9,9,37,46,1896
14176,14176,C21989F99D3B120EE23386DE2361CA67,10841,12,14,2,37,47,1897
14177,14177,C21989F99D3B120EE23386DE2361CA67,13711,15,16,1,38,46,1946
14178,14178,C21989F99D3B120EE23386DE2361CA67,10841,17,18,1,37,47,1897
14179,14179,D746519213A28242D49759FCE6B0BCB4,19441,0,14,14,8,46,446
14180,14180,D746519213A28242D49759FCE6B0BCB4,42041,15,18,3,10,47,547
14181,14181,D746519213A28242D49759FCE6B0BCB4,19441,18,22,4,8,46,446
14196,14196,12F3D6E4C8E8EBBA3996FD8CF832F757,43391,0,18,18,29,48,1498
14197,14197,12F3D6E4C8E8EBBA3996FD8CF832F757,10381,20,21,1,31,49,1599
14198,14198,12F3D6E4C8E8EBBA3996FD8CF832F757,43391,21,23,2,29,48,1498
14199,14199,E1ADA5D6F54060F04D34C1A2CB8FE108,13381,9,13,4,39,47,1997
14200,14200,E1ADA5D6F54060F04D34C1A2CB8FE108,42221,17,19,2,38,48,1948
14201,14201,E1ADA5D6F54060F04D34C1A2CB8FE108,11074,19,21,2,37,47,1897
14202,14202,1449A57E713CB22C1F60F422E04F70F8,42861,7,13,6,37,44,1894
14203,14203,1449A57E713CB22C1F60F422E04F70F8,11261,17,19,2,36,46,1846
14204,14204,1449A57E713CB22C1F60F422E04F70F8,42151,20,21,1,35,45,1795
14205,14205,916BC4263959BF562E5C6764781E4744,42531,2,8,6,31,45,1595
14206,14206,916BC4263959BF562E5C6764781E4744,12311,9,19,10,30,44,1544
14207,14207,916BC4263959BF562E5C6764781E4744,42531,22,23,1,31,45,1595
14208,14208,3C5BF8354C7B22C00BFA5438C070BC0F,13711,0,14,14,38,46,1946
14209,14209,3C5BF8354C7B22C00BFA5438C070BC0F,42011,14,17,3,36,46,1846
14210,14210,3C5BF8354C7B22C00BFA5438C070BC0F,13711,21,23,2,38,46,1946
14224,14224,76780BDA1CE8853E5C6D6B4A56C0AC5B,11381,7,12,5,30,47,1547
14225,14225,76780BDA1CE8853E5C6D6B4A56C0AC5B,12121,12,13,1,29,47,1497
14226,14226,76780BDA1CE8853E5C6D6B4A56C0AC5B,11381,14,22,8,30,47,1547
14227,14227,186BCCF3E4C291B31BC4BB9662DF9417,42141,0,5,5,32,47,1647
14228,14228,186BCCF3E4C291B31BC4BB9662DF9417,10281,8,9,1,33,48,1698
14229,14229,186BCCF3E4C291B31BC4BB9662DF9417,43761,10,19,9,32,47,1647
14230,14230,186BCCF3E4C291B31BC4BB9662DF9417,11161,22,23,1,32,48,1648
14239,14239,7BB31A1D059FD6D88C054A61BB3B7FB1,42531,0,8,8,31,45,1595
14240,14240,7BB31A1D059FD6D88C054A61BB3B7FB1,10351,9,12,3,28,45,1445
14241,14241,7BB31A1D059FD6D88C054A61BB3B7FB1,42531,14,17,3,31,45,1595
14242,14242,7BB31A1D059FD6D88C054A61BB3B7FB1,10351,18,22,4,28,45,1445
14252,14252,B0DB1916CBE4951CF5091A191DB66ADA,13101,10,18,8,40,47,2047
14253,14253,B0DB1916CBE4951CF5091A191DB66ADA,13271,18,20,2,41,47,2097
14254,14254,B0DB1916CBE4951CF5091A191DB66ADA,13101,22,23,1,40,47,2047
14255,14255,EF9C99EE076D9702EF73224BC1A91C21,43621,0,6,6,46,48,2348
14256,14256,EF9C99EE076D9702EF73224BC1A91C21,11701,6,12,6,43,48,2198
14257,14257,EF9C99EE076D9702EF73224BC1A91C21,43621,13,23,10,46,48,2348
14296,14296,CFCD9FFE1C722F184C3074182556F64A,10471,0,15,15,37,48,1898
14297,14297,CFCD9FFE1C722F184C3074182556F64A,43361,15,16,1,38,48,1948
14298,14298,CFCD9FFE1C722F184C3074182556F64A,10471,18,21,3,37,48,1898
14310,14310,377BD5B9C037AF000CC29F45169CD1E4,11231,0,8,8,37,49,1899
14311,14311,377BD5B9C037AF000CC29F45169CD1E4,11201,9,19,10,35,49,1799
14312,14312,377BD5B9C037AF000CC29F45169CD1E4,11231,19,23,4,37,49,1899
14313,14313,EA6B8CBE634579C9093B157538F58AA2,42021,3,6,3,33,47,1697
14314,14314,EA6B8CBE634579C9093B157538F58AA2,43761,9,10,1,32,47,1647
14315,14315,EA6B8CBE634579C9093B157538F58AA2,10731,12,19,7,33,47,1697
14316,14316,EA6B8CBE634579C9093B157538F58AA2,10491,19,21,2,33,48,1698
14334,14334,DD5F8A74300A882C9276D44B0BD9BA94,10491,0,6,6,33,48,1698
14335,14335,DD5F8A74300A882C9276D44B0BD9BA94,11861,7,14,7,32,47,1647
14336,14336,DD5F8A74300A882C9276D44B0BD9BA94,10491,18,23,5,33,48,1698
14337,14337,B53C313F28E9C152305715765AEEF04B,42151,3,7,4,35,45,1795
14338,14338,B53C313F28E9C152305715765AEEF04B,42861,10,11,1,37,44,1894
14339,14339,B53C313F28E9C152305715765AEEF04B,42151,13,17,4,35,45,1795
14340,14340,B53C313F28E9C152305715765AEEF04B,42861,18,22,4,37,44,1894
14353,14353,751637010376FF10A15374FA98F99F38,13601,0,6,6,34,47,1747
14354,14354,751637010376FF10A15374FA98F99F38,11861,7,16,9,32,47,1647
14355,14355,751637010376FF10A15374FA98F99F38,13601,16,17,1,34,47,1747
14356,14356,751637010376FF10A15374FA98F99F38,11861,19,23,4,32,47,1647
14361,14361,8C77E624D8AFCC432BD5DA6A66C68868,42071,0,7,7,31,49,1599
14362,14362,8C77E624D8AFCC432BD5DA6A66C68868,42641,8,16,8,33,49,1699
14363,14363,8C77E624D8AFCC432BD5DA6A66C68868,10381,21,23,2,31,49,1599
14364,14364,D2EE9F87EBFF1ACD786B8CD58B0AEA62,10271,0,10,10,37,46,1896
14365,14365,D2EE9F87EBFF1ACD786B8CD58B0AEA62,13121,12,13,1,38,46,1946
14366,14366,D2EE9F87EBFF1ACD786B8CD58B0AEA62,10271,21,23,2,37,46,1896
14370,14370,A4B13605C78797589D9B98BC8787EDD0,12921,7,9,2,9,41,491
14371,14371,A4B13605C78797589D9B98BC8787EDD0,19114,11,13,2,7,43,393
14372,14372,A4B13605C78797589D9B98BC8787EDD0,12641,14,15,1,10,43,543
14373,14373,A4B13605C78797589D9B98BC8787EDD0,19114,18,21,3,7,43,393
14395,14395,47A3620469BCEB8AD217A6815034111E,43061,4,6,2,43,46,2196
14396,14396,47A3620469BCEB8AD217A6815034111E,13341,10,12,2,44,45,2245
14397,14397,47A3620469BCEB8AD217A6815034111E,43061,13,19,6,43,46,2196
14398,14398,644074FAED2D07B771DBBC3C2ED7ABF4,13411,0,5,5,49,42,2492
14399,14399,644074FAED2D07B771DBBC3C2ED7ABF4,43951,6,18,12,49,41,2491
14400,14400,644074FAED2D07B771DBBC3C2ED7ABF4,13411,19,23,4,49,42,2492
14412,14412,895085FE0B62D7BCDF8725B5DB48E546,42521,0,14,14,31,47,1597
14413,14413,895085FE0B62D7BCDF8725B5DB48E546,11061,14,18,4,29,48,1498
14414,14414,895085FE0B62D7BCDF8725B5DB48E546,11381,18,19,1,30,47,1547
14415,14415,895085FE0B62D7BCDF8725B5DB48E546,11061,20,21,1,29,48,1498
14419,14419,AD3EDA3142ED65E7DCEA2ECC9D2EC5AC,12641,1,10,9,10,43,543
14420,14420,AD3EDA3142ED65E7DCEA2ECC9D2EC5AC,12921,10,11,1,9,41,491
14421,14421,AD3EDA3142ED65E7DCEA2ECC9D2EC5AC,12641,13,14,1,10,43,543
14422,14422,AD3EDA3142ED65E7DCEA2ECC9D2EC5AC,12921,17,23,6,9,41,491
14423,14423,B3D9D8E72FD92A77A76B6490766A3C36,19901,2,5,3,7,44,394
14424,14424,B3D9D8E72FD92A77A76B6490766A3C36,12641,6,8,2,10,43,543
14425,14425,B3D9D8E72FD92A77A76B6490766A3C36,19114,9,21,12,7,43,393
14426,14426,E41EFAEAC6CC7189E20FB98542ADB1CF,13101,0,7,7,40,47,2047
14427,14427,E41EFAEAC6CC7189E20FB98542ADB1CF,11801,10,11,1,42,48,2148
14428,14428,E41EFAEAC6CC7189E20FB98542ADB1CF,13101,12,22,10,40,47,2047
14429,14429,C3C651BE2C45C097C74DDD0AF65FA400,11431,1,9,8,29,47,1497
14430,14430,C3C651BE2C45C097C74DDD0AF65FA400,13651,10,18,8,30,47,1547
14431,14431,C3C651BE2C45C097C74DDD0AF65FA400,11861,20,23,3,32,47,1647
14435,14435,A8491B4932A74BB29E61F0906E6D23DE,42201,0,14,14,43,46,2196
14436,14436,A8491B4932A74BB29E61F0906E6D23DE,42461,14,16,2,45,47,2297
14437,14437,A8491B4932A74BB29E61F0906E6D23DE,40691,17,19,2,42,48,2148
14438,14438,A8491B4932A74BB29E61F0906E6D23DE,42461,19,21,2,45,47,2297
14442,14442,ED387BC9729A0D8CA1364378D6AA6E43,10634,0,14,14,27,45,1395
14443,14443,ED387BC9729A0D8CA1364378D6AA6E43,10351,18,20,2,28,45,1445
14444,14444,ED387BC9729A0D8CA1364378D6AA6E43,10634,21,23,2,27,45,1395
14465,14465,75B6D91479467607B0BA166BDAF35CA1,10431,0,6,6,33,49,1699
14466,14466,75B6D91479467607B0BA166BDAF35CA1,43581,7,9,2,33,48,1698
14467,14467,75B6D91479467607B0BA166BDAF35CA1,13601,14,16,2,34,47,1747
14468,14468,75B6D91479467607B0BA166BDAF35CA1,10431,17,23,6,33,49,1699
14482,14482,720B1030F9AA451F5DB7F94C393FD381,13371,0,3,3,41,47,2097
14483,14483,720B1030F9AA451F5DB7F94C393FD381,12651,5,15,10,43,47,2197
14484,14484,720B1030F9AA451F5DB7F94C393FD381,12511,17,20,3,39,47,1997
14491,14491,CCAA623A39508D04DCE98490576D39EC,11211,0,9,9,34,49,1749
14492,14492,CCAA623A39508D04DCE98490576D39EC,42471,12,14,2,35,49,1799
14493,14493,CCAA623A39508D04DCE98490576D39EC,11021,19,23,4,36,49,1849
14494,14494,204ADEEB5391E5CE917489F3568579F3,10121,0,8,8,36,49,1849
14495,14495,204ADEEB5391E5CE917489F3568579F3,11231,8,12,4,37,49,1899
14496,14496,204ADEEB5391E5CE917489F3568579F3,10121,14,17,3,36,49,1849
14497,14497,204ADEEB5391E5CE917489F3568579F3,11231,21,23,2,37,49,1899
14503,14503,E38766DD374EA01B3BEE541EEE369F35,10271,0,11,11,37,46,1896
14504,14504,E38766DD374EA01B3BEE541EEE369F35,13911,11,12,1,39,46,1996
14505,14505,E38766DD374EA01B3BEE541EEE369F35,10271,14,23,9,37,46,1896
14506,14506,6EF69708DD923556D4EF232AA0406F1C,42231,0,14,14,37,46,1896
14507,14507,6EF69708DD923556D4EF232AA0406F1C,10841,14,16,2,37,47,1897
14508,14508,6EF69708DD923556D4EF232AA0406F1C,11941,18,23,5,37,46,1896
14509,14509,E1F8F8050A277810881A1D7B70FD5922,12661,0,13,13,32,45,1645
14510,14510,E1F8F8050A277810881A1D7B70FD5922,12311,14,15,1,30,44,1544
14511,14511,E1F8F8050A277810881A1D7B70FD5922,12661,19,23,4,32,45,1645
14512,14512,A0E829F4319BFCF37BA7414AFCB09FF1,42221,0,8,8,38,48,1948
14513,14513,A0E829F4319BFCF37BA7414AFCB09FF1,11074,9,12,3,37,47,1897
14514,14514,A0E829F4319BFCF37BA7414AFCB09FF1,42221,16,21,5,38,48,1948
14519,14519,C0EC240E36490D1263D83D45770C29BF,42321,0,6,6,43,47,2197
14520,14520,C0EC240E36490D1263D83D45770C29BF,42091,6,20,14,43,46,2196
14521,14521,C0EC240E36490D1263D83D45770C29BF,42321,21,22,1,43,47,2197
14522,14522,6DFA48F81EF42083077B44FC80706865,10971,5,6,1,35,47,1797
14523,14523,6DFA48F81EF42083077B44FC80706865,42161,6,8,2,36,47,1847
14524,14524,6DFA48F81EF42083077B44FC80706865,10971,11,23,12,35,47,1797
14536,14536,D8DCFF78BA67097F4D9471927F4813FD,11361,0,5,5,22,48,1148
14537,14537,D8DCFF78BA67097F4D9471927F4813FD,12581,7,19,12,24,48,1248
14538,14538,D8DCFF78BA67097F4D9471927F4813FD,43751,20,21,1,19,48,998
14539,14539,9F5215EB6F19506AA8AED2CAA1CBC8E6,43761,6,7,1,32,47,1647
14540,14540,9F5215EB6F19506AA8AED2CAA1CBC8E6,42371,9,10,1,34,46,1746
14541,14541,9F5215EB6F19506AA8AED2CAA1CBC8E6,10511,15,19,4,35,46,1796
14542,14542,E1B8B389FB89A6FD4C4FFE9BDF0E0F7E,11381,0,16,16,30,47,1547
14543,14543,E1B8B389FB89A6FD4C4FFE9BDF0E0F7E,10951,18,20,2,29,48,1498
14544,14544,E1B8B389FB89A6FD4C4FFE9BDF0E0F7E,11381,20,22,2,30,47,1547
14549,14549,981FF39DB0050476FC5E5BA7D49F90F5,42861,1,8,7,37,44,1894
14550,14550,981FF39DB0050476FC5E5BA7D49F90F5,11261,12,13,1,36,46,1846
14551,14551,981FF39DB0050476FC5E5BA7D49F90F5,42864,17,18,1,38,44,1944
14558,14558,B0E329B00E3FA297B870177AA9BA63AC,42141,0,6,6,32,47,1647
14559,14559,B0E329B00E3FA297B870177AA9BA63AC,42523,9,16,7,31,47,1597
14560,14560,B0E329B00E3FA297B870177AA9BA63AC,42141,18,23,5,32,47,1647
14561,14561,5B9E09F094541824399F39AB61F4C681,11861,0,2,2,32,47,1647
14562,14562,5B9E09F094541824399F39AB61F4C681,42521,3,17,14,31,47,1597
14563,14563,5B9E09F094541824399F39AB61F4C681,11861,19,20,1,32,47,1647
14567,14567,E835E54D31E2053FF59F5E3D61ABCD72,11151,6,12,6,30,48,1548
14568,14568,E835E54D31E2053FF59F5E3D61ABCD72,11061,14,16,2,29,48,1498
14569,14569,E835E54D31E2053FF59F5E3D61ABCD72,11151,16,22,6,30,48,1548
14570,14570,613F07A1ACC407D56CA084FBF1CED078,42301,0,7,7,36,47,1847
14571,14571,613F07A1ACC407D56CA084FBF1CED078,42941,9,10,1,37,47,1897
14572,14572,613F07A1ACC407D56CA084FBF1CED078,42301,12,21,9,36,47,1847
14573,14573,0CA0351BEE42A6C50E3C657DDA4ED8A9,10121,0,8,8,36,49,1849
14574,14574,0CA0351BEE42A6C50E3C657DDA4ED8A9,11201,10,18,8,35,49,1799
14575,14575,0CA0351BEE42A6C50E3C657DDA4ED8A9,11021,19,21,2,36,49,1849
14580,14580,0CF6CC5FF24D6A6AB1B738BADBD1459E,10431,9,14,5,33,49,1699
14581,14581,0CF6CC5FF24D6A6AB1B738BADBD1459E,11201,14,16,2,35,49,1799
14582,14582,0CF6CC5FF24D6A6AB1B738BADBD1459E,11531,19,20,1,34,49,1749
14583,14583,119196C18578341D0084AF6B48A62632,12641,0,1,1,10,43,543
14584,14584,119196C18578341D0084AF6B48A62632,19114,18,20,2,7,43,393
14585,14585,119196C18578341D0084AF6B48A62632,12641,20,23,3,10,43,543
14591,14591,8022990AE31C9584DEB8AC231685A64C,42491,5,7,2,32,46,1646
14592,14592,8022990AE31C9584DEB8AC231685A64C,42523,10,11,1,31,47,1597
14593,14593,8022990AE31C9584DEB8AC231685A64C,42491,14,15,1,32,46,1646
14594,14594,8022990AE31C9584DEB8AC231685A64C,10341,17,20,3,31,47,1597
14624,14624,D6553FC98A27307181CDBCB3E58A1E0C,10331,1,8,7,39,46,1996
14625,14625,D6553FC98A27307181CDBCB3E58A1E0C,11791,10,12,2,38,49,1949
14626,14626,D6553FC98A27307181CDBCB3E58A1E0C,10331,12,14,2,39,46,1996
14627,14627,D6553FC98A27307181CDBCB3E58A1E0C,42031,19,22,3,40,46,2046
14638,14638,BBB180103068E98D503C4D3D2B6186F0,40302,0,14,14,40,49,2049
14639,14639,BBB180103068E98D503C4D3D2B6186F0,13911,14,15,1,39,46,1996
14640,14640,BBB180103068E98D503C4D3D2B6186F0,42221,21,22,1,38,48,1948
14641,14641,B27430939D82FA287A878AA074D2C2ED,10841,0,2,2,37,47,1897
14642,14642,B27430939D82FA287A878AA074D2C2ED,42301,3,13,10,36,47,1847
14643,14643,B27430939D82FA287A878AA074D2C2ED,12514,14,16,2,38,47,1947
14644,14644,B27430939D82FA287A878AA074D2C2ED,42511,18,19,1,37,47,1897
14645,14645,F3E280D806C0279BCC08880D6A71DAC7,42471,0,9,9,35,49,1799
14646,14646,F3E280D806C0279BCC08880D6A71DAC7,11231,15,17,2,37,49,1899
14647,14647,F3E280D806C0279BCC08880D6A71DAC7,11074,19,23,4,37,47,1897
14648,14648,5B606639B0DDA81D89C67819EC5B7D64,13271,0,6,6,41,47,2097
14649,14649,5B606639B0DDA81D89C67819EC5B7D64,12514,9,18,9,38,47,1947
14650,14650,5B606639B0DDA81D89C67819EC5B7D64,13271,18,19,1,41,47,2097
14651,14651,A4A8A17ADDEADCAC8025633329473810,12971,0,9,9,32,48,1648
14652,14652,A4A8A17ADDEADCAC8025633329473810,10221,13,14,1,34,49,1749
14653,14653,A4A8A17ADDEADCAC8025633329473810,12971,17,23,6,32,48,1648
14665,14665,D3E46B15B35DC3C198E6EE945D227259,42271,6,12,6,40,47,2047
14666,14666,D3E46B15B35DC3C198E6EE945D227259,13381,13,17,4,39,47,1997
14667,14667,D3E46B15B35DC3C198E6EE945D227259,11806,17,19,2,41,48,2098
14668,14668,D3E46B15B35DC3C198E6EE945D227259,42271,19,22,3,40,47,2047
14674,14674,3E1FC4D135BB13FEB2589C9806D420B1,12514,1,4,3,38,47,1947
14675,14675,3E1FC4D135BB13FEB2589C9806D420B1,42581,4,16,12,38,48,1948
14676,14676,3E1FC4D135BB13FEB2589C9806D420B1,11914,19,21,2,37,48,1898
14677,14677,394B81CC36B31D897120A6153D7C1457,11061,0,4,4,29,48,1498
14678,14678,394B81CC36B31D897120A6153D7C1457,12121,6,7,1,29,47,1497
14679,14679,394B81CC36B31D897120A6153D7C1457,42501,8,16,8,28,47,1447
14680,14680,394B81CC36B31D897120A6153D7C1457,11061,18,23,5,29,48,1498
14686,14686,0E44B8203565C08C4FE28AB9B72AEA81,40637,0,7,7,36,47,1847
14687,14687,0E44B8203565C08C4FE28AB9B72AEA81,11351,8,18,10,36,48,1848
14688,14688,0E44B8203565C08C4FE28AB9B72AEA81,10971,18,19,1,35,47,1797
14689,14689,384EBE8B0466F623B706DB371094FC98,43481,0,7,7,39,48,1998
14690,14690,384EBE8B0466F623B706DB371094FC98,42271,10,11,1,40,47,2047
14691,14691,384EBE8B0466F623B706DB371094FC98,11806,12,13,1,41,48,2098
14692,14692,384EBE8B0466F623B706DB371094FC98,13101,15,18,3,40,47,2047
14693,14693,405F80E4DB047BF65667610085A0E1FB,19441,0,15,15,8,46,446
14694,14694,405F80E4DB047BF65667610085A0E1FB,42041,17,18,1,10,47,547
14695,14695,405F80E4DB047BF65667610085A0E1FB,19441,19,23,4,8,46,446
14696,14696,9B3CEEB5258D8C7EE02AB18106A0FB98,42864,8,9,1,38,44,1944
14697,14697,9B3CEEB5258D8C7EE02AB18106A0FB98,13911,12,13,1,39,46,1996
14698,14698,9B3CEEB5258D8C7EE02AB18106A0FB98,11261,14,16,2,36,46,1846
14699,14699,9B3CEEB5258D8C7EE02AB18106A0FB98,42864,16,18,2,38,44,1944
14704,14704,E4C01519C4C6DA1BA93B12F2E4473E7E,42351,0,7,7,38,45,1945
14705,14705,E4C01519C4C6DA1BA93B12F2E4473E7E,13461,7,9,2,39,44,1994
14706,14706,E4C01519C4C6DA1BA93B12F2E4473E7E,42351,10,23,13,38,45,1945
14707,14707,B74B3DCD8F19C67166A66D0048B31F03,13331,0,9,9,38,47,1947
14708,14708,B74B3DCD8F19C67166A66D0048B31F03,10841,10,11,1,37,47,1897
14709,14709,B74B3DCD8F19C67166A66D0048B31F03,13711,13,14,1,38,46,1946
14710,14710,B74B3DCD8F19C67166A66D0048B31F03,10911,19,23,4,39,46,1996
14714,14714,4A63BD8790639E943B30CD82E5123621,11151,0,14,14,30,48,1548
14715,14715,4A63BD8790639E943B30CD82E5123621,12971,15,16,1,32,48,1648
14716,14716,4A63BD8790639E943B30CD82E5123621,11151,18,20,2,30,48,1548
14717,14717,4A63BD8790639E943B30CD82E5123621,12971,21,23,2,32,48,1648
14724,14724,E56F9D415B3A7776422BFD56BCA059EF,42151,0,7,7,35,45,1795
14725,14725,E56F9D415B3A7776422BFD56BCA059EF,12491,8,10,2,36,43,1843
14726,14726,E56F9D415B3A7776422BFD56BCA059EF,42151,11,23,12,35,45,1795
14727,14727,53D8E731DA65650E5B825C52CF592433,11201,0,12,12,35,49,1799
14728,14728,53D8E731DA65650E5B825C52CF592433,11751,14,18,4,35,48,1798
14729,14729,53D8E731DA65650E5B825C52CF592433,11201,21,23,2,35,49,1799
14730,14730,E1D9DCC26BD9E70C84DC1D28D9FFAAE6,12641,0,9,9,10,43,543
14731,14731,E1D9DCC26BD9E70C84DC1D28D9FFAAE6,19904,14,16,2,9,44,494
14732,14732,E1D9DCC26BD9E70C84DC1D28D9FFAAE6,19114,21,22,1,7,43,393
14733,14733,FB50763582318761FD514D72ADA73CC2,11074,0,1,1,37,47,1897
14734,14734,FB50763582318761FD514D72ADA73CC2,11921,2,9,7,38,48,1948
14735,14735,FB50763582318761FD514D72ADA73CC2,10651,20,22,2,36,49,1849
14736,14736,8E6F323BA70C6AFB89E795BE6C3D0D4B,10721,0,9,9,31,48,1598
14737,14737,8E6F323BA70C6AFB89E795BE6C3D0D4B,42021,13,15,2,33,47,1697
14738,14738,8E6F323BA70C6AFB89E795BE6C3D0D4B,10721,20,23,3,31,48,1598
14739,14739,5B36AF3FB8DFBC06F69C87BD2C6C60CC,11111,0,14,14,26,48,1348
14740,14740,5B36AF3FB8DFBC06F69C87BD2C6C60CC,12601,15,17,2,25,47,1297
14741,14741,5B36AF3FB8DFBC06F69C87BD2C6C60CC,11111,21,23,2,26,48,1348
14750,14750,D8063B7C8CAA23F18B002D2A443A5135,43951,6,7,1,49,41,2491
14751,14751,D8063B7C8CAA23F18B002D2A443A5135,43101,7,10,3,46,40,2340
14752,14752,D8063B7C8CAA23F18B002D2A443A5135,43951,10,11,1,49,41,2491
14753,14753,D8063B7C8CAA23F18B002D2A443A5135,43101,12,21,9,46,40,2340
14765,14765,B7E1FA8163F9E5C37489B32682514507,10295,0,15,15,30,47,1547
14766,14766,B7E1FA8163F9E5C37489B32682514507,42523,15,17,2,31,47,1597
14767,14767,B7E1FA8163F9E5C37489B32682514507,10295,17,23,6,30,47,1547
14768,14768,924C94FEA337955066B022FCC7607D38,11361,2,8,6,22,48,1148
14769,14769,924C94FEA337955066B022FCC7607D38,12581,10,11,1,24,48,1248
14770,14770,924C94FEA337955066B022FCC7607D38,11361,12,19,7,22,48,1148
14771,14771,924C94FEA337955066B022FCC7607D38,12581,19,21,2,24,48,1248
14775,14775,9B8E3A84EF821A3E9564A6D6EAEA0FE5,42581,3,4,1,38,48,1948
14776,14776,9B8E3A84EF821A3E9564A6D6EAEA0FE5,11914,5,12,7,37,48,1898
14777,14777,9B8E3A84EF821A3E9564A6D6EAEA0FE5,40171,14,15,1,38,48,1948
14778,14778,9B8E3A84EF821A3E9564A6D6EAEA0FE5,10471,16,22,6,37,48,1898
14779,14779,58B59FD7AA0814C0C6E50CF40955E7AA,10634,10,12,2,27,45,1395
14780,14780,58B59FD7AA0814C0C6E50CF40955E7AA,12601,13,21,8,25,47,1297
14781,14781,58B59FD7AA0814C0C6E50CF40955E7AA,10634,21,23,2,27,45,1395
14793,14793,F8FD16629819B20972FEBA21A43C5924,42921,0,18,18,33,47,1697
14794,14794,F8FD16629819B20972FEBA21A43C5924,11861,20,22,2,32,47,1647
14795,14795,F8FD16629819B20972FEBA21A43C5924,42021,22,23,1,33,47,1697
14799,14799,10B8A2D44211CACA01D59967B38E8576,42161,0,7,7,36,47,1847
14800,14800,10B8A2D44211CACA01D59967B38E8576,10251,8,10,2,35,47,1797
14801,14801,10B8A2D44211CACA01D59967B38E8576,42161,22,23,1,36,47,1847
14802,14802,7446641F73809A823733CBB6864B4050,42861,7,11,4,37,44,1894
14803,14803,7446641F73809A823733CBB6864B4050,11261,12,19,7,36,46,1846
14804,14804,7446641F73809A823733CBB6864B4050,42861,21,22,1,37,44,1894
14805,14805,D59A7D67E6A2D306517724C5A50D5385,10351,6,13,7,28,45,1445
14806,14806,D59A7D67E6A2D306517724C5A50D5385,10301,14,20,6,31,45,1595
14807,14807,D59A7D67E6A2D306517724C5A50D5385,10351,20,23,3,28,45,1445
14817,14817,671FB010BDB8AB18F1C7C189D2A5B267,42871,0,6,6,30,45,1545
14818,14818,671FB010BDB8AB18F1C7C189D2A5B267,11875,7,17,10,30,46,1546
14819,14819,671FB010BDB8AB18F1C7C189D2A5B267,42871,19,23,4,30,45,1545
14828,14828,39BBEF64C110B28293452839586DC4E1,10531,0,10,10,34,46,1746
14829,14829,39BBEF64C110B28293452839586DC4E1,42301,12,13,1,36,47,1847
14830,14830,39BBEF64C110B28293452839586DC4E1,10151,14,16,2,34,47,1747
14831,14831,39BBEF64C110B28293452839586DC4E1,10531,19,23,4,34,46,1746
14832,14832,E234B5120D56DA23234C53D64CFEED38,11491,0,13,13,36,47,1847
14833,14833,E234B5120D56DA23234C53D64CFEED38,13121,17,19,2,38,46,1946
14834,14834,E234B5120D56DA23234C53D64CFEED38,11491,19,23,4,36,47,1847
14835,14835,261E578A9ADD5DB5F1BF8D1F93100799,42864,1,5,4,38,44,1944
14836,14836,261E578A9ADD5DB5F1BF8D1F93100799,11261,5,7,2,36,46,1846
14837,14837,261E578A9ADD5DB5F1BF8D1F93100799,42864,7,9,2,38,44,1944
14838,14838,261E578A9ADD5DB5F1BF8D1F93100799,11261,13,23,10,36,46,1846
14851,14851,50897C798DD981F790935635A0EC3137,10171,10,11,1,26,47,1347
14852,14852,50897C798DD981F790935635A0EC3137,42501,12,17,5,28,47,1447
14853,14853,50897C798DD981F790935635A0EC3137,12601,18,22,4,25,47,1297
14859,14859,ED63CD6A523ED82BABC0C283513656AA,19441,1,12,11,8,46,446
14860,14860,ED63CD6A523ED82BABC0C283513656AA,42041,16,17,1,10,47,547
14861,14861,ED63CD6A523ED82BABC0C283513656AA,19441,22,23,1,8,46,446
14866,14866,5D26554B1FC70D170F1FCBF45044ABD6,11231,0,18,18,37,49,1899
14867,14867,5D26554B1FC70D170F1FCBF45044ABD6,10471,18,19,1,37,48,1898
14868,14868,5D26554B1FC70D170F1FCBF45044ABD6,11231,20,23,3,37,49,1899
14869,14869,91764B4567AC3A3991286EF06C97A20D,42161,0,9,9,36,47,1847
14870,14870,91764B4567AC3A3991286EF06C97A20D,10251,9,19,10,35,47,1797
14871,14871,91764B4567AC3A3991286EF06C97A20D,42161,19,23,4,36,47,1847
14877,14877,10EF731AC04D9ABA15B2A1CF1540EBA5,42201,0,9,9,43,46,2196
14878,14878,10EF731AC04D9ABA15B2A1CF1540EBA5,42111,12,13,1,44,46,2246
14879,14879,10EF731AC04D9ABA15B2A1CF1540EBA5,42461,14,23,9,45,47,2297
14880,14880,4515D69DA9DF7C67BD58AB71BAA57E58,10471,3,12,9,37,48,1898
14881,14881,4515D69DA9DF7C67BD58AB71BAA57E58,40171,12,19,7,38,48,1948
14882,14882,4515D69DA9DF7C67BD58AB71BAA57E58,11331,19,23,4,37,48,1898
14883,14883,69E543DFF7ABD4903EB302CAAC6962DA,12083,0,2,2,36,49,1849
14884,14884,69E543DFF7ABD4903EB302CAAC6962DA,11921,3,7,4,38,48,1948
14885,14885,69E543DFF7ABD4903EB302CAAC6962DA,42471,9,18,9,35,49,1799
14886,14886,69E543DFF7ABD4903EB302CAAC6962DA,11914,19,22,3,37,48,1898
14887,14887,9D486DC7D7603579E9B1ED91F8F65D4F,42521,0,1,1,31,47,1597
14888,14888,9D486DC7D7603579E9B1ED91F8F65D4F,43761,1,13,12,32,47,1647
14889,14889,9D486DC7D7603579E9B1ED91F8F65D4F,42521,15,16,1,31,47,1597
14890,14890,9D486DC7D7603579E9B1ED91F8F65D4F,43761,20,22,2,32,47,1647
14907,14907,1B79245B436C345735362D622A1E5B6E,10471,9,11,2,37,48,1898
14908,14908,1B79245B436C345735362D622A1E5B6E,41271,11,17,6,38,48,1948
14909,14909,1B79245B436C345735362D622A1E5B6E,10901,18,21,3,35,48,1798
14910,14910,823BB637426A4B64F4A56D087D45C241,49201,0,6,6,7,41,391
14911,14911,823BB637426A4B64F4A56D087D45C241,12921,7,11,4,9,41,491
14912,14912,823BB637426A4B64F4A56D087D45C241,49201,12,14,2,7,41,391
14913,14913,823BB637426A4B64F4A56D087D45C241,12921,17,19,2,9,41,491
14914,14914,6AE2FA19F90C6BBDAB69E2E1C7BD408D,11921,0,2,2,38,48,1948
14915,14915,6AE2FA19F90C6BBDAB69E2E1C7BD408D,11914,2,8,6,37,48,1898
14916,14916,6AE2FA19F90C6BBDAB69E2E1C7BD408D,11921,12,19,7,38,48,1948
14917,14917,6AE2FA19F90C6BBDAB69E2E1C7BD408D,11914,20,21,1,37,48,1898
14918,14918,BB301AA472F946C16B8EF1B57802FA13,43761,1,7,6,32,47,1647
14919,14919,BB301AA472F946C16B8EF1B57802FA13,10281,7,10,3,33,48,1698
14920,14920,BB301AA472F946C16B8EF1B57802FA13,43761,14,19,5,32,47,1647
14927,14927,82D1CEDE24E0792F5B9EEC9BCF1BF69B,43951,0,11,11,49,41,2491
14928,14928,82D1CEDE24E0792F5B9EEC9BCF1BF69B,43101,11,12,1,46,40,2340
14929,14929,82D1CEDE24E0792F5B9EEC9BCF1BF69B,43951,13,19,6,49,41,2491
14930,14930,82D1CEDE24E0792F5B9EEC9BCF1BF69B,43101,20,22,2,46,40,2340
14931,14931,A349D8C83E1914464A7CDA23A563E70B,42523,0,9,9,31,47,1597
14932,14932,A349D8C83E1914464A7CDA23A563E70B,43761,16,17,1,32,47,1647
14933,14933,A349D8C83E1914464A7CDA23A563E70B,42523,17,19,2,31,47,1597
14941,14941,4A68C1945FCC1868E3DBF0CF909E5429,43471,0,8,8,31,49,1599
14942,14942,4A68C1945FCC1868E3DBF0CF909E5429,11151,11,20,9,30,48,1548
14943,14943,4A68C1945FCC1868E3DBF0CF909E5429,40872,20,23,3,30,49,1549
14944,14944,78C0E1E992CFF9ECB9C6D46D3E929FD4,12121,0,14,14,29,47,1497
14945,14945,78C0E1E992CFF9ECB9C6D46D3E929FD4,11381,16,19,3,30,47,1547
14946,14946,78C0E1E992CFF9ECB9C6D46D3E929FD4,12121,19,21,2,29,47,1497
14947,14947,B3D330CB8F1681F4BBCB951D5F414D22,43161,0,8,8,35,47,1797
14948,14948,B3D330CB8F1681F4BBCB951D5F414D22,10731,8,10,2,33,47,1697
14949,14949,B3D330CB8F1681F4BBCB951D5F414D22,43161,13,14,1,35,47,1797
14950,14950,B3D330CB8F1681F4BBCB951D5F414D22,10411,15,22,7,36,48,1848
14955,14955,FBED60795FCFB63636BCD315FA3FE656,43761,1,11,10,32,47,1647
14956,14956,FBED60795FCFB63636BCD315FA3FE656,42521,13,17,4,31,47,1597
14957,14957,FBED60795FCFB63636BCD315FA3FE656,43761,21,22,1,32,47,1647
14958,14958,D9FB9F3F4820A4EF951566780A770C45,13911,3,5,2,39,46,1996
14959,14959,D9FB9F3F4820A4EF951566780A770C45,11261,7,18,11,36,46,1846
14960,14960,D9FB9F3F4820A4EF951566780A770C45,42351,19,21,2,38,45,1945
14961,14961,B11C90C30BACC34A74EC12A03A75D4DA,42864,0,12,12,38,44,1944
14962,14962,B11C90C30BACC34A74EC12A03A75D4DA,11261,12,16,4,36,46,1846
14963,14963,B11C90C30BACC34A74EC12A03A75D4DA,42864,19,23,4,38,44,1944
14970,14970,9582B0C41CE65E76B09E8491AC26676B,11871,0,6,6,29,46,1496
14971,14971,9582B0C41CE65E76B09E8491AC26676B,12311,6,15,9,30,44,1544
14972,14972,9582B0C41CE65E76B09E8491AC26676B,11875,19,23,4,30,46,1546
14977,14977,A1454305F9DD47B0B2AD331201B14599,43971,0,6,6,30,48,1548
14978,14978,A1454305F9DD47B0B2AD331201B14599,43311,10,11,1,31,48,1598
14979,14979,A1454305F9DD47B0B2AD331201B14599,42491,12,13,1,32,46,1646
14980,14980,A1454305F9DD47B0B2AD331201B14599,43971,13,23,10,30,48,1548
14981,14981,FCC81FB1D89F2E284C3312E5101F2149,42151,0,6,6,35,45,1795
14982,14982,FCC81FB1D89F2E284C3312E5101F2149,42861,9,11,2,37,44,1894
14983,14983,FCC81FB1D89F2E284C3312E5101F2149,42151,12,23,11,35,45,1795
14994,14994,7C98BDF484E2B085C51A4945E804FC0C,42151,0,2,2,35,45,1795
14995,14995,7C98BDF484E2B085C51A4945E804FC0C,12491,2,3,1,36,43,1843
14996,14996,7C98BDF484E2B085C51A4945E804FC0C,42151,5,20,15,35,45,1795
15005,15005,E52FCCDAB7096C6174405D20815A7387,11021,0,16,16,36,49,1849
15006,15006,E52FCCDAB7096C6174405D20815A7387,10971,19,20,1,35,47,1797
15007,15007,E52FCCDAB7096C6174405D20815A7387,11021,22,23,1,36,49,1849
15018,15018,B7832DB383CB1E7DD6C87A81AAE89D66,11914,3,11,8,37,48,1898
15019,15019,B7832DB383CB1E7DD6C87A81AAE89D66,42221,12,19,7,38,48,1948
15020,15020,B7832DB383CB1E7DD6C87A81AAE89D66,11331,19,21,2,37,48,1898
15021,15021,C96AF7724AE07D1D1BE56C246C9FE7FC,13341,0,13,13,44,45,2245
15022,15022,C96AF7724AE07D1D1BE56C246C9FE7FC,42631,15,17,2,43,45,2195
15023,15023,C96AF7724AE07D1D1BE56C246C9FE7FC,13341,19,21,2,44,45,2245
15024,15024,0C3EDD26A7ED891A1146E2AB7A623C19,10151,1,8,7,34,47,1747
15025,15025,0C3EDD26A7ED891A1146E2AB7A623C19,10971,9,16,7,35,47,1797
15026,15026,0C3EDD26A7ED891A1146E2AB7A623C19,43731,17,23,6,34,47,1747
15027,15027,B0559EE5210193B113FE4887C51E2384,42301,0,8,8,36,47,1847
15028,15028,B0559EE5210193B113FE4887C51E2384,10111,9,12,3,37,47,1897
15029,15029,B0559EE5210193B113FE4887C51E2384,42301,12,21,9,36,47,1847
15030,15030,A233EC2C10A5C170549589E5B7B99B60,42221,2,10,8,38,48,1948
15031,15031,A233EC2C10A5C170549589E5B7B99B60,11074,11,19,8,37,47,1897
15032,15032,A233EC2C10A5C170549589E5B7B99B60,42221,22,23,1,38,48,1948
15042,15042,CD0009511C5E53DE8682EFA081D652E9,11151,0,7,7,30,48,1548
15043,15043,CD0009511C5E53DE8682EFA081D652E9,11061,7,9,2,29,48,1498
15044,15044,CD0009511C5E53DE8682EFA081D652E9,11151,14,16,2,30,48,1548
15045,15045,CD0009511C5E53DE8682EFA081D652E9,11061,18,19,1,29,48,1498
15046,15046,6EE33A4158B91E73941C475D6213D143,43101,8,9,1,46,40,2340
15047,15047,6EE33A4158B91E73941C475D6213D143,43951,12,13,1,49,41,2491
15048,15048,6EE33A4158B91E73941C475D6213D143,43101,16,21,5,46,40,2340
15049,15049,31CDF80C6F6D99CDF02165EC65D6A959,42041,1,4,3,10,47,547
15050,15050,31CDF80C6F6D99CDF02165EC65D6A959,19441,5,13,8,8,46,446
15051,15051,31CDF80C6F6D99CDF02165EC65D6A959,42041,17,18,1,10,47,547
15052,15052,31CDF80C6F6D99CDF02165EC65D6A959,19441,18,22,4,8,46,446
15053,15053,A7B31109557B4ACE77F31639500C61E8,12971,0,12,12,32,48,1648
15054,15054,A7B31109557B4ACE77F31639500C61E8,10431,13,15,2,33,49,1699
15055,15055,A7B31109557B4ACE77F31639500C61E8,11751,19,20,1,35,48,1798
15056,15056,A7B31109557B4ACE77F31639500C61E8,12971,21,23,2,32,48,1648
15066,15066,7C25276FDFEE61F55EFE0CD20CA4F5F9,11061,2,3,1,29,48,1498
15067,15067,7C25276FDFEE61F55EFE0CD20CA4F5F9,10681,6,16,10,30,48,1548
15068,15068,7C25276FDFEE61F55EFE0CD20CA4F5F9,11061,21,22,1,29,48,1498
15069,15069,70001957DCF2B9125DCB996733DDF49B,11381,0,11,11,30,47,1547
15070,15070,70001957DCF2B9125DCB996733DDF49B,11061,12,13,1,29,48,1498
15071,15071,70001957DCF2B9125DCB996733DDF49B,11381,13,23,10,30,47,1547
15085,15085,E24F34B965BE1054DCE4AF1C1CD48137,11861,0,9,9,32,47,1647
15086,15086,E24F34B965BE1054DCE4AF1C1CD48137,11875,10,18,8,30,46,1546
15087,15087,E24F34B965BE1054DCE4AF1C1CD48137,11861,19,23,4,32,47,1647
15094,15094,9561ABDECCD36C7236B43D7186F9954F,10681,1,15,14,30,48,1548
15095,15095,9561ABDECCD36C7236B43D7186F9954F,11061,16,18,2,29,48,1498
15096,15096,9561ABDECCD36C7236B43D7186F9954F,10681,20,23,3,30,48,1548
15097,15097,3BF62D1292DE5E4C5AE213431E617E8C,11791,0,13,13,38,49,1949
15098,15098,3BF62D1292DE5E4C5AE213431E617E8C,43671,14,19,5,35,48,1798
15099,15099,3BF62D1292DE5E4C5AE213431E617E8C,12514,20,21,1,38,47,1947
15108,15108,4B5C492CF16B079882322240829D6566,43281,0,5,5,37,48,1898
15109,15109,4B5C492CF16B079882322240829D6566,11231,6,8,2,37,49,1899
15110,15110,4B5C492CF16B079882322240829D6566,10471,9,16,7,37,48,1898
15111,15111,4B5C492CF16B079882322240829D6566,10661,19,22,3,37,49,1899
15118,15118,7A3B81BDAFB4DD2FC896155A8BEFF9BB,42411,0,9,9,40,49,2049
15119,15119,7A3B81BDAFB4DD2FC896155A8BEFF9BB,11301,10,11,1,41,49,2099
15120,15120,7A3B81BDAFB4DD2FC896155A8BEFF9BB,11001,16,18,2,42,47,2147
15121,15121,7A3B81BDAFB4DD2FC896155A8BEFF9BB,42411,20,23,3,40,49,2049
15125,15125,B24DFEF6BEA91CB0AE942579D8124FCB,10971,1,2,1,35,47,1797
15126,15126,B24DFEF6BEA91CB0AE942579D8124FCB,42161,3,7,4,36,47,1847
15127,15127,B24DFEF6BEA91CB0AE942579D8124FCB,10781,17,23,6,35,47,1797
15141,15141,D8B46FFCD15B641FB93B8219A29A7205,10251,8,13,5,35,47,1797
15142,15142,D8B46FFCD15B641FB93B8219A29A7205,42161,14,15,1,36,47,1847
15143,15143,D8B46FFCD15B641FB93B8219A29A7205,10251,18,20,2,35,47,1797
15144,15144,D8B46FFCD15B641FB93B8219A29A7205,42161,21,22,1,36,47,1847
15153,15153,2FC977AAECB05F28AE0C53353C4DD1FC,13121,0,1,1,38,46,1946
15154,15154,2FC977AAECB05F28AE0C53353C4DD1FC,10271,4,11,7,37,46,1896
15155,15155,2FC977AAECB05F28AE0C53353C4DD1FC,13121,15,22,7,38,46,1946
15160,15160,5A45F00505D10CE6F80144DAC647FEEE,19024,0,6,6,9,45,495
15161,15161,5A45F00505D10CE6F80144DAC647FEEE,19904,8,10,2,9,44,494
15162,15162,5A45F00505D10CE6F80144DAC647FEEE,19114,12,15,3,7,43,393
15163,15163,5A45F00505D10CE6F80144DAC647FEEE,12641,18,20,2,10,43,543
15175,15175,83DF2DC67F792D97F66715470F9922B2,43761,0,13,13,32,47,1647
15176,15176,83DF2DC67F792D97F66715470F9922B2,42521,16,21,5,31,47,1597
15177,15177,83DF2DC67F792D97F66715470F9922B2,43761,22,23,1,32,47,1647
15181,15181,B93C16A242FE2C6BDA83A87AD4FAA434,10501,0,8,8,22,46,1146
15182,15182,B93C16A242FE2C6BDA83A87AD4FAA434,12601,13,14,1,25,47,1297
15183,15183,B93C16A242FE2C6BDA83A87AD4FAA434,10501,15,16,1,22,46,1146
15184,15184,B93C16A242FE2C6BDA83A87AD4FAA434,12601,17,21,4,25,47,1297
15193,15193,C1162F2C909CCC1C0B397E5287703D92,42491,0,6,6,32,46,1646
15194,15194,C1162F2C909CCC1C0B397E5287703D92,42523,7,13,6,31,47,1597
15195,15195,C1162F2C909CCC1C0B397E5287703D92,42491,13,22,9,32,46,1646
15232,15232,BDA67F5B71597181E331845AE88C939C,42161,0,15,15,36,47,1847
15233,15233,BDA67F5B71597181E331845AE88C939C,10111,17,18,1,37,47,1897
15234,15234,BDA67F5B71597181E331845AE88C939C,11861,19,21,2,32,47,1647
15281,15281,649CA0B4C9C73F10630BCAC6C100E533,42151,6,7,1,35,45,1795
15282,15282,649CA0B4C9C73F10630BCAC6C100E533,12661,7,9,2,32,45,1645
15283,15283,649CA0B4C9C73F10630BCAC6C100E533,42151,11,22,11,35,45,1795
15287,15287,4ED77B13FDF08CD25FE17FE483A9C8C7,11161,0,8,8,32,48,1648
15288,15288,4ED77B13FDF08CD25FE17FE483A9C8C7,11861,12,13,1,32,47,1647
15289,15289,4ED77B13FDF08CD25FE17FE483A9C8C7,11161,17,23,6,32,48,1648
15302,15302,68D66AC2F31097852E1113FCAC38B096,12121,5,6,1,29,47,1497
15303,15303,68D66AC2F31097852E1113FCAC38B096,42531,9,12,3,31,45,1595
15304,15304,68D66AC2F31097852E1113FCAC38B096,12311,12,18,6,30,44,1544
15305,15305,68D66AC2F31097852E1113FCAC38B096,42531,22,23,1,31,45,1595
15306,15306,D9B08428B230A26F9D8108567961B570,13671,0,15,15,27,43,1393
15307,15307,D9B08428B230A26F9D8108567961B570,11281,15,19,4,27,40,1390
15308,15308,D9B08428B230A26F9D8108567961B570,13671,20,22,2,27,43,1393
15309,15309,D9B08428B230A26F9D8108567961B570,11281,22,23,1,27,40,1390
15318,15318,780CF605B987CE4335E0B64DFA86ACBF,12514,0,6,6,38,47,1947
15319,15319,780CF605B987CE4335E0B64DFA86ACBF,10841,8,18,10,37,47,1897
15320,15320,780CF605B987CE4335E0B64DFA86ACBF,12514,19,22,3,38,47,1947
15321,15321,21214DF25ABBFE57C13DD19922691751,42351,0,7,7,38,45,1945
15322,15322,21214DF25ABBFE57C13DD19922691751,11261,10,11,1,36,46,1846
15323,15323,21214DF25ABBFE57C13DD19922691751,13231,15,17,2,39,46,1996
15324,15324,21214DF25ABBFE57C13DD19922691751,11261,17,20,3,36,46,1846
15339,15339,01308B72F71E3AACC045F922DA6CAE4D,43761,1,9,8,32,47,1647
15340,15340,01308B72F71E3AACC045F922DA6CAE4D,42523,13,17,4,31,47,1597
15341,15341,01308B72F71E3AACC045F922DA6CAE4D,43761,17,19,2,32,47,1647
15342,15342,01308B72F71E3AACC045F922DA6CAE4D,42521,20,21,1,31,47,1597
15343,15343,D5746F30DC8775BC56CB551C6292738D,11021,0,7,7,36,49,1849
15344,15344,D5746F30DC8775BC56CB551C6292738D,11731,11,12,1,36,48,1848
15345,15345,D5746F30DC8775BC56CB551C6292738D,11201,18,22,4,35,49,1799
15346,15346,FD8C757A10FC8342CB9359B3B019D044,10901,0,8,8,35,48,1798
15347,15347,FD8C757A10FC8342CB9359B3B019D044,11231,8,17,9,37,49,1899
15348,15348,FD8C757A10FC8342CB9359B3B019D044,10901,18,23,5,35,48,1798
15354,15354,F2ED260BEE0CFBD7C0D8D1BC36233DE2,12121,0,8,8,29,47,1497
15355,15355,F2ED260BEE0CFBD7C0D8D1BC36233DE2,11381,11,18,7,30,47,1547
15356,15356,F2ED260BEE0CFBD7C0D8D1BC36233DE2,12121,18,19,1,29,47,1497
15361,15361,9C95D6292421E6B801C911060D75482F,12921,2,3,1,9,41,491
15362,15362,9C95D6292421E6B801C911060D75482F,12641,4,5,1,10,43,543
15363,15363,9C95D6292421E6B801C911060D75482F,12921,6,20,14,9,41,491
15364,15364,9C95D6292421E6B801C911060D75482F,49201,20,22,2,7,41,391
15365,15365,2D914C2EB253165A5763D18FAE5FB6D2,43061,0,14,14,43,46,2196
15366,15366,2D914C2EB253165A5763D18FAE5FB6D2,42461,14,17,3,45,47,2297
15367,15367,2D914C2EB253165A5763D18FAE5FB6D2,43061,17,22,5,43,46,2196
15368,15368,03C19F5F9D7D397AE6E9F2FD16BA994D,10251,0,11,11,35,47,1797
15369,15369,03C19F5F9D7D397AE6E9F2FD16BA994D,42401,15,17,2,36,47,1847
15370,15370,03C19F5F9D7D397AE6E9F2FD16BA994D,10251,17,23,6,35,47,1797
15382,15382,E6F8B18996A93B41942201687916F106,11231,0,11,11,37,49,1899
15383,15383,E6F8B18996A93B41942201687916F106,10471,13,15,2,37,48,1898
15384,15384,E6F8B18996A93B41942201687916F106,11231,15,23,8,37,49,1899
15391,15391,4784D97F3C276E4A1D7A7813E1000E1E,10811,0,14,14,38,46,1946
15392,15392,4784D97F3C276E4A1D7A7813E1000E1E,13911,15,17,2,39,46,1996
15393,15393,4784D97F3C276E4A1D7A7813E1000E1E,10811,21,23,2,38,46,1946
15394,15394,85061C43999146706723F4E0700EE955,42351,0,2,2,38,45,1945
15395,15395,85061C43999146706723F4E0700EE955,13911,5,8,3,39,46,1996
15396,15396,85061C43999146706723F4E0700EE955,42231,9,10,1,37,46,1896
15397,15397,85061C43999146706723F4E0700EE955,13911,11,20,9,39,46,1996
15401,15401,170A0AC014DC9BA930EAA0E56A2C9D03,42321,0,6,6,43,47,2197
15402,15402,170A0AC014DC9BA930EAA0E56A2C9D03,11701,9,20,11,43,48,2198
15403,15403,170A0AC014DC9BA930EAA0E56A2C9D03,42321,21,23,2,43,47,2197
15419,15419,19B7F0CF3E3FD886B38254D17C1F93A2,10351,4,5,1,28,45,1445
15420,15420,19B7F0CF3E3FD886B38254D17C1F93A2,10301,10,12,2,31,45,1595
15421,15421,19B7F0CF3E3FD886B38254D17C1F93A2,12311,12,22,10,30,44,1544
15433,15433,824CB1B1B23572593ECC1D95EF328196,42321,1,15,14,43,47,2197
15434,15434,824CB1B1B23572593ECC1D95EF328196,13941,20,21,1,41,47,2097
15435,15435,824CB1B1B23572593ECC1D95EF328196,42321,21,23,2,43,47,2197
15447,15447,F627F3EBF20FB78EAFD0A2284AEED359,10451,4,6,2,25,48,1298
15448,15448,F627F3EBF20FB78EAFD0A2284AEED359,42081,8,12,4,24,49,1249
15449,15449,F627F3EBF20FB78EAFD0A2284AEED359,10451,12,23,11,25,48,1298
15450,15450,D0016644D08E46EAD736BEE805BD7ECD,11491,0,14,14,36,47,1847
15451,15451,D0016644D08E46EAD736BEE805BD7ECD,11261,16,17,1,36,46,1846
15452,15452,D0016644D08E46EAD736BEE805BD7ECD,40431,19,23,4,36,47,1847
15453,15453,60268F7A02ED65A28DFDDFCBD631880E,42351,0,6,6,38,45,1945
15454,15454,60268F7A02ED65A28DFDDFCBD631880E,42231,8,10,2,37,46,1896
15455,15455,60268F7A02ED65A28DFDDFCBD631880E,42351,10,13,3,38,45,1945
15456,15456,60268F7A02ED65A28DFDDFCBD631880E,42231,15,20,5,37,46,1896
15479,15479,831CEF471029417D091D2BE9F78234DD,42321,6,13,7,43,47,2197
15480,15480,831CEF471029417D091D2BE9F78234DD,10801,17,18,1,42,47,2147
15481,15481,831CEF471029417D091D2BE9F78234DD,13941,22,23,1,41,47,2097
15482,15482,6EF3FF760E19F4779DBA83689DEC9B2B,42521,0,14,14,31,47,1597
15483,15483,6EF3FF760E19F4779DBA83689DEC9B2B,13651,15,17,2,30,47,1547
15484,15484,6EF3FF760E19F4779DBA83689DEC9B2B,42521,18,23,5,31,47,1597
15485,15485,C16CC3D35D6024AFDDA799BE12486CFB,42864,1,6,5,38,44,1944
15486,15486,C16CC3D35D6024AFDDA799BE12486CFB,11261,6,15,9,36,46,1846
15487,15487,C16CC3D35D6024AFDDA799BE12486CFB,42864,15,20,5,38,44,1944
15493,15493,E253AEBFCDC09653244FFFC8BCC6FDFD,42531,0,5,5,31,45,1595
15494,15494,E253AEBFCDC09653244FFFC8BCC6FDFD,12311,8,9,1,30,44,1544
15495,15495,E253AEBFCDC09653244FFFC8BCC6FDFD,42531,12,23,11,31,45,1595
15496,15496,6869A5F90DBC32E3AB5337DBC7DAA2BA,43951,7,9,2,49,41,2491
15497,15497,6869A5F90DBC32E3AB5337DBC7DAA2BA,13411,10,11,1,49,42,2492
15498,15498,6869A5F90DBC32E3AB5337DBC7DAA2BA,43951,13,23,10,49,41,2491
15499,15499,9C2C2A9A5923C3E8476FE17BB2B155DD,19114,0,13,13,7,43,393
15500,15500,9C2C2A9A5923C3E8476FE17BB2B155DD,12641,14,15,1,10,43,543
15501,15501,9C2C2A9A5923C3E8476FE17BB2B155DD,19114,15,16,1,7,43,393
15502,15502,9C2C2A9A5923C3E8476FE17BB2B155DD,12641,16,18,2,10,43,543
15512,15512,656752102BA99654C7060CE5B2133D72,19114,0,4,4,7,43,393
15513,15513,656752102BA99654C7060CE5B2133D72,49201,6,16,10,7,41,391
15514,15514,656752102BA99654C7060CE5B2133D72,19114,20,23,3,7,43,393
15515,15515,6EBCE758753264C9295661224EE7DDA0,10881,1,7,6,34,48,1748
15516,15516,6EBCE758753264C9295661224EE7DDA0,43731,8,10,2,34,47,1747
15517,15517,6EBCE758753264C9295661224EE7DDA0,42161,10,12,2,36,47,1847
15518,15518,6EBCE758753264C9295661224EE7DDA0,43731,15,18,3,34,47,1747
15524,15524,20CD9E3A1B77E936B4A35B7A2F14CDE6,42271,0,2,2,40,47,2047
15525,15525,20CD9E3A1B77E936B4A35B7A2F14CDE6,12514,5,14,9,38,47,1947
15526,15526,20CD9E3A1B77E936B4A35B7A2F14CDE6,11074,15,19,4,37,47,1897
15527,15527,20CD9E3A1B77E936B4A35B7A2F14CDE6,12514,22,23,1,38,47,1947
15542,15542,EB7EB6074C1F2A07A41462E31EDA6629,42161,1,15,14,36,47,1847
15543,15543,EB7EB6074C1F2A07A41462E31EDA6629,10111,17,20,3,37,47,1897
15544,15544,EB7EB6074C1F2A07A41462E31EDA6629,42161,20,23,3,36,47,1847
15545,15545,ED0EE3E9960BCEF6967F4298DBD60F07,12641,0,1,1,10,43,543
15546,15546,ED0EE3E9960BCEF6967F4298DBD60F07,19114,4,17,13,7,43,393
15547,15547,ED0EE3E9960BCEF6967F4298DBD60F07,12641,20,22,2,10,43,543
15548,15548,96056246DD9856C2DDE7E703B0D16D68,11381,0,11,11,30,47,1547
15549,15549,96056246DD9856C2DDE7E703B0D16D68,12121,12,15,3,29,47,1497
15550,15550,96056246DD9856C2DDE7E703B0D16D68,42523,19,23,4,31,47,1597
15571,15571,1A439866C72DC101B5B9389EACAD1E10,10681,1,16,15,30,48,1548
15572,15572,1A439866C72DC101B5B9389EACAD1E10,11061,17,18,1,29,48,1498
15573,15573,1A439866C72DC101B5B9389EACAD1E10,10681,19,20,1,30,48,1548
15574,15574,4EABE655BE26B3EDCCD7B6B2C89F187F,40861,0,2,2,34,48,1748
15575,15575,4EABE655BE26B3EDCCD7B6B2C89F187F,10161,2,8,6,35,49,1799
15576,15576,4EABE655BE26B3EDCCD7B6B2C89F187F,12391,8,19,11,36,49,1849
15577,15577,4EABE655BE26B3EDCCD7B6B2C89F187F,10161,21,23,2,35,49,1799
15578,15578,B9287F02ABAC7483714B47918ABD611A,11161,0,7,7,32,48,1648
15579,15579,B9287F02ABAC7483714B47918ABD611A,11384,8,10,2,30,47,1547
15580,15580,B9287F02ABAC7483714B47918ABD611A,11161,12,22,10,32,48,1648
15581,15581,B7C33B5C4F6E6D84F66DE44CC367A266,42861,0,5,5,37,44,1894
15582,15582,B7C33B5C4F6E6D84F66DE44CC367A266,42151,6,11,5,35,45,1795
15583,15583,B7C33B5C4F6E6D84F66DE44CC367A266,42861,15,21,6,37,44,1894
15584,15584,CC3FA096FA296BC301B8FB82BD507846,42471,4,7,3,35,49,1799
15585,15585,CC3FA096FA296BC301B8FB82BD507846,11531,8,9,1,34,49,1749
15586,15586,CC3FA096FA296BC301B8FB82BD507846,42471,10,18,8,35,49,1799
15587,15587,FE84C5B6FD29AD1D9C75D32BF19FA780,42861,0,9,9,37,44,1894
15588,15588,FE84C5B6FD29AD1D9C75D32BF19FA780,11261,10,11,1,36,46,1846
15589,15589,FE84C5B6FD29AD1D9C75D32BF19FA780,42861,14,17,3,37,44,1894
15590,15590,FE84C5B6FD29AD1D9C75D32BF19FA780,11261,17,18,1,36,46,1846
15591,15591,BD517E29BD7069EA61B2CA0844AA760E,10731,0,6,6,33,47,1697
15592,15592,BD517E29BD7069EA61B2CA0844AA760E,43761,7,15,8,32,47,1647
15593,15593,BD517E29BD7069EA61B2CA0844AA760E,42523,16,18,2,31,47,1597
15594,15594,BD517E29BD7069EA61B2CA0844AA760E,11171,19,21,2,33,48,1698
15595,15595,9ECA591AD7D8E4A5C049EB031A81CC99,12311,10,12,2,30,44,1544
15596,15596,9ECA591AD7D8E4A5C049EB031A81CC99,10351,12,13,1,28,45,1445
15597,15597,9ECA591AD7D8E4A5C049EB031A81CC99,12311,16,18,2,30,44,1544
15598,15598,72CCFF68A8139FE3616EAEC5752357DB,10251,0,13,13,35,47,1797
15599,15599,72CCFF68A8139FE3616EAEC5752357DB,42471,15,16,1,35,49,1799
15600,15600,72CCFF68A8139FE3616EAEC5752357DB,10251,20,23,3,35,47,1797
15601,15601,EDBE9058BB0B28E0915A84395E9226D9,11261,1,5,4,36,46,1846
15602,15602,EDBE9058BB0B28E0915A84395E9226D9,42861,6,15,9,37,44,1894
15603,15603,EDBE9058BB0B28E0915A84395E9226D9,11261,16,19,3,36,46,1846
15604,15604,994BA369046D8B99F80604E02227FCEB,42581,0,13,13,38,48,1948
15605,15605,994BA369046D8B99F80604E02227FCEB,11914,16,17,1,37,48,1898
15606,15606,994BA369046D8B99F80604E02227FCEB,42581,21,23,2,38,48,1948
15607,15607,DE3E54BB176520C8599DB39C6B8B34A3,43951,0,10,10,49,41,2491
15608,15608,DE3E54BB176520C8599DB39C6B8B34A3,13411,12,16,4,49,42,2492
15609,15609,DE3E54BB176520C8599DB39C6B8B34A3,43951,16,23,7,49,41,2491
15636,15636,05B51695B375DD3A2259BF2668AD8716,42161,0,8,8,36,47,1847
15637,15637,05B51695B375DD3A2259BF2668AD8716,12511,9,10,1,39,47,1997
15638,15638,05B51695B375DD3A2259BF2668AD8716,42771,10,23,13,36,47,1847
15643,15643,B0E6E3EED3BB7AD6CDE2928BF07C7B4F,12514,1,3,2,38,47,1947
15644,15644,B0E6E3EED3BB7AD6CDE2928BF07C7B4F,42221,3,5,2,38,48,1948
15645,15645,B0E6E3EED3BB7AD6CDE2928BF07C7B4F,12514,8,14,6,38,47,1947
15646,15646,B0E6E3EED3BB7AD6CDE2928BF07C7B4F,11074,16,18,2,37,47,1897
15650,15650,22A9DCD20E3D0F6B8EE783191AF51ADE,42531,0,8,8,31,45,1595
15651,15651,22A9DCD20E3D0F6B8EE783191AF51ADE,10351,9,18,9,28,45,1445
15652,15652,22A9DCD20E3D0F6B8EE783191AF51ADE,42531,21,23,2,31,45,1595
15653,15653,4C8E92DBB85921608C1C92929A7A8C92,42521,0,7,7,31,47,1597
15654,15654,4C8E92DBB85921608C1C92929A7A8C92,13651,7,8,1,30,47,1547
15655,15655,4C8E92DBB85921608C1C92929A7A8C92,42521,11,23,12,31,47,1597
15671,15671,25C497B4D4DF884DBD8CBD5B228DA42D,10811,0,7,7,38,46,1946
15672,15672,25C497B4D4DF884DBD8CBD5B228DA42D,11261,8,13,5,36,46,1846
15673,15673,25C497B4D4DF884DBD8CBD5B228DA42D,13231,17,23,6,39,46,1996
15677,15677,5B105ADD9BC39D9388FE233BAD1ECEBC,10331,0,16,16,39,46,1996
15678,15678,5B105ADD9BC39D9388FE233BAD1ECEBC,11074,19,20,1,37,47,1897
15679,15679,5B105ADD9BC39D9388FE233BAD1ECEBC,10331,21,23,2,39,46,1996
15694,15694,79F70A1AE08CEE215DA71360DE1B25EA,42191,0,5,5,38,49,1949
15695,15695,79F70A1AE08CEE215DA71360DE1B25EA,42231,6,19,13,37,46,1896
15696,15696,79F70A1AE08CEE215DA71360DE1B25EA,42191,20,23,3,38,49,1949
15705,15705,CC04DF57CD476D56A9C2711AACC54374,42861,1,3,2,37,44,1894
15706,15706,CC04DF57CD476D56A9C2711AACC54374,11261,8,16,8,36,46,1846
15707,15707,CC04DF57CD476D56A9C2711AACC54374,42861,18,19,1,37,44,1894
15712,15712,04E25EABAF57B3731144C024B2F68618,42631,10,11,1,43,45,2195
15713,15713,04E25EABAF57B3731144C024B2F68618,13341,12,14,2,44,45,2245
15714,15714,04E25EABAF57B3731144C024B2F68618,42631,17,18,1,43,45,2195
15715,15715,04E25EABAF57B3731144C024B2F68618,13341,19,23,4,44,45,2245
15720,15720,179C9FE89AB1A0E7249FE171F554F068,42523,0,9,9,31,47,1597
15721,15721,179C9FE89AB1A0E7249FE171F554F068,43761,13,14,1,32,47,1647
15722,15722,179C9FE89AB1A0E7249FE171F554F068,42523,18,23,5,31,47,1597
15728,15728,05286C4B5017A260B39768783F7D4555,42581,0,5,5,38,48,1948
15729,15729,05286C4B5017A260B39768783F7D4555,11331,8,10,2,37,48,1898
15730,15730,05286C4B5017A260B39768783F7D4555,40171,13,23,10,38,48,1948
15734,15734,E3950B228FF57BC4F70CD2EC3D90B5FF,42231,2,7,5,37,46,1896
15735,15735,E3950B228FF57BC4F70CD2EC3D90B5FF,42151,10,15,5,35,45,1795
15736,15736,E3950B228FF57BC4F70CD2EC3D90B5FF,11941,19,21,2,37,46,1896
15740,15740,DC2D0973DF8C3E1058E57B71AEBEAAB2,10841,0,9,9,37,47,1897
15741,15741,DC2D0973DF8C3E1058E57B71AEBEAAB2,10971,13,14,1,35,47,1797
15742,15742,DC2D0973DF8C3E1058E57B71AEBEAAB2,40637,17,19,2,36,47,1847
15743,15743,DC2D0973DF8C3E1058E57B71AEBEAAB2,10411,21,23,2,36,48,1848
15752,15752,F6EA870D7BC56578EF709CB9EF29623C,11161,0,11,11,32,48,1648
15753,15753,F6EA870D7BC56578EF709CB9EF29623C,42523,13,16,3,31,47,1597
15754,15754,F6EA870D7BC56578EF709CB9EF29623C,42491,16,18,2,32,46,1646
15755,15755,F6EA870D7BC56578EF709CB9EF29623C,11161,18,23,5,32,48,1648
15760,15760,58FF60972C1637520443DC5766A2AB67,13411,0,5,5,49,42,2492
15761,15761,58FF60972C1637520443DC5766A2AB67,43951,7,18,11,49,41,2491
15762,15762,58FF60972C1637520443DC5766A2AB67,13411,18,23,5,49,42,2492
15771,15771,9EBD792C30B963491A648A1AF083878E,12641,6,10,4,10,43,543
15772,15772,9EBD792C30B963491A648A1AF083878E,19111,11,13,2,9,45,495
15773,15773,9EBD792C30B963491A648A1AF083878E,19021,17,18,1,10,45,545
15774,15774,9EBD792C30B963491A648A1AF083878E,12641,18,23,5,10,43,543
15775,15775,8E1DB9D4ECEC1F108A151A8D21BA1A04,42231,0,4,4,37,46,1896
15776,15776,8E1DB9D4ECEC1F108A151A8D21BA1A04,13911,4,8,4,39,46,1996
15777,15777,8E1DB9D4ECEC1F108A151A8D21BA1A04,42231,10,22,12,37,46,1896
15781,15781,FDF009FD71AC6332D7401DDEC6102385,11461,0,8,8,37,49,1899
15782,15782,FDF009FD71AC6332D7401DDEC6102385,10471,9,17,8,37,48,1898
15783,15783,FDF009FD71AC6332D7401DDEC6102385,11201,18,19,1,35,49,1799
15784,15784,FDF009FD71AC6332D7401DDEC6102385,10471,21,23,2,37,48,1898
15795,15795,28AE6FF44E8686DC354D2E3DF7700FCC,43001,3,4,1,47,47,2397
15796,15796,28AE6FF44E8686DC354D2E3DF7700FCC,42321,7,18,11,43,47,2197
15797,15797,28AE6FF44E8686DC354D2E3DF7700FCC,43621,19,20,1,46,48,2348
15803,15803,D46D481AE4A1808392E89F68BF1C527D,11061,0,11,11,29,48,1498
15804,15804,D46D481AE4A1808392E89F68BF1C527D,11381,13,15,2,30,47,1547
15805,15805,D46D481AE4A1808392E89F68BF1C527D,11061,15,23,8,29,48,1498
15806,15806,93385A44FB64392F87A63CBA23C74FC5,13731,5,6,1,33,49,1699
15807,15807,93385A44FB64392F87A63CBA23C74FC5,11951,11,14,3,31,49,1599
15808,15808,93385A44FB64392F87A63CBA23C74FC5,13731,15,21,6,33,49,1699
15822,15822,AF5140B00273B874DD47CFF400890B83,43951,0,1,1,49,41,2491
15823,15823,AF5140B00273B874DD47CFF400890B83,10751,2,6,4,47,43,2393
15824,15824,AF5140B00273B874DD47CFF400890B83,43951,8,23,15,49,41,2491
15825,15825,6F3F0614427F6E0615C071A6AD947088,10691,0,7,7,33,48,1698
15826,15826,6F3F0614427F6E0615C071A6AD947088,10431,11,18,7,33,49,1699
15827,15827,6F3F0614427F6E0615C071A6AD947088,10491,20,23,3,33,48,1698
15836,15836,94A66B099C3B286235DEE73BAE7FEB6C,11861,1,9,8,32,47,1647
15837,15837,94A66B099C3B286235DEE73BAE7FEB6C,10281,11,12,1,33,48,1698
15838,15838,94A66B099C3B286235DEE73BAE7FEB6C,11861,14,21,7,32,47,1647
15839,15839,BC76CCD190FA1A5238AAD9129E2B96C9,40463,2,7,5,38,49,1949
15840,15840,BC76CCD190FA1A5238AAD9129E2B96C9,10471,9,12,3,37,48,1898
15841,15841,BC76CCD190FA1A5238AAD9129E2B96C9,11231,15,17,2,37,49,1899
15842,15842,BC76CCD190FA1A5238AAD9129E2B96C9,10107,18,19,1,38,49,1949
15843,15843,A6F4E0A14DDF72AB1602B3834CD2AC43,11914,2,5,3,37,48,1898
15844,15844,A6F4E0A14DDF72AB1602B3834CD2AC43,11921,7,8,1,38,48,1948
15845,15845,A6F4E0A14DDF72AB1602B3834CD2AC43,11914,10,13,3,37,48,1898
15846,15846,A6F4E0A14DDF72AB1602B3834CD2AC43,11921,14,22,8,38,48,1948
15847,15847,E0F3A68E2935541E84AD4E1526A976E8,11481,0,2,2,41,48,2098
15848,15848,E0F3A68E2935541E84AD4E1526A976E8,13381,2,16,14,39,47,1997
15849,15849,E0F3A68E2935541E84AD4E1526A976E8,10107,21,22,1,38,49,1949
15855,15855,790CA71BBC53353AABCB9BB22BDF58BD,11021,0,11,11,36,49,1849
15856,15856,790CA71BBC53353AABCB9BB22BDF58BD,40277,14,19,5,35,49,1799
15857,15857,790CA71BBC53353AABCB9BB22BDF58BD,11021,21,23,2,36,49,1849
15862,15862,C54B7E894D1C5CD6E84B2182058F9208,42861,2,5,3,37,44,1894
15863,15863,C54B7E894D1C5CD6E84B2182058F9208,42864,9,10,1,38,44,1944
15864,15864,C54B7E894D1C5CD6E84B2182058F9208,42861,12,23,11,37,44,1894
15877,15877,2CB194F5C88F15739C3E83AF93DF02DF,11161,0,8,8,32,48,1648
15878,15878,2CB194F5C88F15739C3E83AF93DF02DF,11541,9,16,7,35,49,1799
15879,15879,2CB194F5C88F15739C3E83AF93DF02DF,10281,18,19,1,33,48,1698
15880,15880,2CB194F5C88F15739C3E83AF93DF02DF,11161,22,23,1,32,48,1648
15881,15881,872EA7042E221A40D168D3255557BABA,42521,7,8,1,31,47,1597
15882,15882,872EA7042E221A40D168D3255557BABA,43761,12,13,1,32,47,1647
15883,15883,872EA7042E221A40D168D3255557BABA,11381,15,17,2,30,47,1547
15884,15884,872EA7042E221A40D168D3255557BABA,43761,18,22,4,32,47,1647
15885,15885,D6DF6508961D56D6ADF21B3B5E7B843B,10841,9,11,2,37,47,1897
15886,15886,D6DF6508961D56D6ADF21B3B5E7B843B,13601,14,16,2,34,47,1747
15887,15887,D6DF6508961D56D6ADF21B3B5E7B843B,42921,16,18,2,33,47,1697
15897,15897,D830EADED353A151E570961C9E6F25C0,40034,0,6,6,32,48,1648
15898,15898,D830EADED353A151E570961C9E6F25C0,10721,9,16,7,31,48,1598
15899,15899,D830EADED353A151E570961C9E6F25C0,12381,20,23,3,32,48,1648
15905,15905,D4B4B4E3A7A4BCB80292B7DC4CB75F9E,42161,0,13,13,36,47,1847
15906,15906,D4B4B4E3A7A4BCB80292B7DC4CB75F9E,11351,14,16,2,36,48,1848
15907,15907,D4B4B4E3A7A4BCB80292B7DC4CB75F9E,43481,21,22,1,39,48,1998
15928,15928,62CCEC3A9273DF4F8900CB768852BE5C,42601,8,9,1,44,48,2248
15929,15929,62CCEC3A9273DF4F8900CB768852BE5C,42341,13,14,1,43,49,2199
15930,15930,62CCEC3A9273DF4F8900CB768852BE5C,11701,18,20,2,43,48,2198
15946,15946,A00BC5B5000B986C70EA1A50458DBEB0,13121,0,7,7,38,46,1946
15947,15947,A00BC5B5000B986C70EA1A50458DBEB0,11074,9,10,1,37,47,1897
15948,15948,A00BC5B5000B986C70EA1A50458DBEB0,13121,21,23,2,38,46,1946
15954,15954,49C79AB3305EA0BDD0BE79CDFA7582CD,11074,0,6,6,37,47,1897
15955,15955,49C79AB3305EA0BDD0BE79CDFA7582CD,42221,8,15,7,38,48,1948
15956,15956,49C79AB3305EA0BDD0BE79CDFA7582CD,11074,17,21,4,37,47,1897
15957,15957,49C79AB3305EA0BDD0BE79CDFA7582CD,42221,22,23,1,38,48,1948
15964,15964,BD46F993BAF091448095C617023E59A4,10251,0,4,4,35,47,1797
15965,15965,BD46F993BAF091448095C617023E59A4,42161,4,8,4,36,47,1847
15966,15966,BD46F993BAF091448095C617023E59A4,10251,9,23,14,35,47,1797
15976,15976,63A1194DA67A916294F825B4249AD293,42351,0,7,7,38,45,1945
15977,15977,63A1194DA67A916294F825B4249AD293,11261,9,17,8,36,46,1846
15978,15978,63A1194DA67A916294F825B4249AD293,42301,22,23,1,36,47,1847
15982,15982,7F73EEE1198B300F5190B9A740E251E3,13911,10,14,4,39,46,1996
15983,15983,7F73EEE1198B300F5190B9A740E251E3,11261,14,16,2,36,46,1846
15984,15984,7F73EEE1198B300F5190B9A740E251E3,12211,17,18,1,41,44,2094
15993,15993,D7EF0E90530B44C571779CF0024CB0FF,13941,1,8,7,41,47,2097
15994,15994,D7EF0E90530B44C571779CF0024CB0FF,11001,9,10,1,42,47,2147
15995,15995,D7EF0E90530B44C571779CF0024CB0FF,13941,14,16,2,41,47,2097
15996,15996,D7EF0E90530B44C571779CF0024CB0FF,11001,17,22,5,42,47,2147
15997,15997,2AEF3373591CEEB04DA500F23433FEC5,11321,1,9,8,31,46,1596
15998,15998,2AEF3373591CEEB04DA500F23433FEC5,11871,10,13,3,29,46,1496
15999,15999,2AEF3373591CEEB04DA500F23433FEC5,11061,14,23,9,29,48,1498
16000,16000,ABA31A886DA5135F00BAFC3DAD048D98,41551,0,6,6,37,46,1896
16001,16001,ABA31A886DA5135F00BAFC3DAD048D98,11231,10,12,2,37,49,1899
16002,16002,ABA31A886DA5135F00BAFC3DAD048D98,12391,12,22,10,36,49,1849
16006,16006,63D46256AD6F86C8491C2B2581A93893,42961,0,10,10,35,49,1799
16007,16007,63D46256AD6F86C8491C2B2581A93893,10251,12,14,2,35,47,1797
16008,16008,63D46256AD6F86C8491C2B2581A93893,40271,17,18,1,35,49,1799
16009,16009,63D46256AD6F86C8491C2B2581A93893,10731,19,21,2,33,47,1697
16019,16019,7F73A642AA11134206C46BA15C785E40,42521,8,10,2,31,47,1597
16020,16020,7F73A642AA11134206C46BA15C785E40,10295,10,21,11,30,47,1547
16021,16021,7F73A642AA11134206C46BA15C785E40,42521,21,23,2,31,47,1597
16033,16033,B207D5D3140535CF644F21B83755D02D,10471,0,10,10,37,48,1898
16034,16034,B207D5D3140535CF644F21B83755D02D,43361,15,19,4,38,48,1948
16035,16035,B207D5D3140535CF644F21B83755D02D,10471,20,23,3,37,48,1898
16043,16043,2D0988A9AAF5B7E7801809924C7B16D4,11074,0,9,9,37,47,1897
16044,16044,2D0988A9AAF5B7E7801809924C7B16D4,11771,12,13,1,39,49,1999
16045,16045,2D0988A9AAF5B7E7801809924C7B16D4,11911,18,23,5,37,48,1898
16055,16055,4DAFB85C918047225CA596E4134A09D3,42141,0,5,5,32,47,1647
16056,16056,4DAFB85C918047225CA596E4134A09D3,13651,9,11,2,30,47,1547
16057,16057,4DAFB85C918047225CA596E4134A09D3,42523,12,13,1,31,47,1597
16058,16058,4DAFB85C918047225CA596E4134A09D3,43761,18,23,5,32,47,1647
16070,16070,54E9147B0F88496112EA8083546467E6,42531,0,6,6,31,45,1595
16071,16071,54E9147B0F88496112EA8083546467E6,12311,9,20,11,30,44,1544
16072,16072,54E9147B0F88496112EA8083546467E6,11834,20,22,2,32,45,1645
16073,16073,4816BD058D7E8FE1C2189282274CB8E1,10801,1,2,1,42,47,2147
16074,16074,4816BD058D7E8FE1C2189282274CB8E1,42321,5,14,9,43,47,2197
16075,16075,4816BD058D7E8FE1C2189282274CB8E1,42461,14,23,9,45,47,2297
16076,16076,A5DEEBB2A80DA4A946704DB84A952200,42523,1,2,1,31,47,1597
16077,16077,A5DEEBB2A80DA4A946704DB84A952200,43761,3,10,7,32,47,1647
16078,16078,A5DEEBB2A80DA4A946704DB84A952200,42523,10,11,1,31,47,1597
16079,16079,A5DEEBB2A80DA4A946704DB84A952200,43761,12,23,11,32,47,1647
16080,16080,C26F0AB1B8AD896B177DE30E7C0A729F,11381,0,9,9,30,47,1547
16081,16081,C26F0AB1B8AD896B177DE30E7C0A729F,11061,13,15,2,29,48,1498
16082,16082,C26F0AB1B8AD896B177DE30E7C0A729F,11381,15,21,6,30,47,1547
16083,16083,C26F0AB1B8AD896B177DE30E7C0A729F,11061,21,23,2,29,48,1498
16087,16087,5569A307420E2CA6F6C658F17F34D127,11261,0,15,15,36,46,1846
16088,16088,5569A307420E2CA6F6C658F17F34D127,13231,16,18,2,39,46,1996
16089,16089,5569A307420E2CA6F6C658F17F34D127,42864,18,23,5,38,44,1944
16090,16090,9BCD563089A1D0EF43A278605DE25081,42231,5,6,1,37,46,1896
16091,16091,9BCD563089A1D0EF43A278605DE25081,42351,7,18,11,38,45,1945
16092,16092,9BCD563089A1D0EF43A278605DE25081,42231,19,20,1,37,46,1896
16112,16112,2ED0EAEC5E72F7DC65DFDFB4B66840DD,13461,1,7,6,39,44,1994
16113,16113,2ED0EAEC5E72F7DC65DFDFB4B66840DD,42864,7,11,4,38,44,1944
16114,16114,2ED0EAEC5E72F7DC65DFDFB4B66840DD,42031,21,22,1,40,46,2046
16115,16115,1940CC384468326D0591B825867214FA,10271,0,7,7,37,46,1896
16116,16116,1940CC384468326D0591B825867214FA,42511,8,10,2,37,47,1897
16117,16117,1940CC384468326D0591B825867214FA,10271,12,22,10,37,46,1896
16131,16131,5EC66C5A4B87D37344B296F73CB04D80,11231,0,10,10,37,49,1899
16132,16132,5EC66C5A4B87D37344B296F73CB04D80,10471,10,19,9,37,48,1898
16133,16133,5EC66C5A4B87D37344B296F73CB04D80,11231,19,23,4,37,49,1899
16138,16138,4F0631F4673317A16DCB59F5A84B3918,13711,2,14,12,38,46,1946
16139,16139,4F0631F4673317A16DCB59F5A84B3918,42511,16,20,4,37,47,1897
16140,16140,4F0631F4673317A16DCB59F5A84B3918,13711,22,23,1,38,46,1946
16145,16145,55536669E97AF41ACDE427113BB85731,10691,0,6,6,33,48,1698
16146,16146,55536669E97AF41ACDE427113BB85731,11861,6,15,9,32,47,1647
16147,16147,55536669E97AF41ACDE427113BB85731,10691,19,23,4,33,48,1698
16171,16171,34FB5BF239A7B5016E3CA81F47968839,42161,0,6,6,36,47,1847
16172,16172,34FB5BF239A7B5016E3CA81F47968839,40961,10,15,5,35,47,1797
16173,16173,34FB5BF239A7B5016E3CA81F47968839,11751,18,20,2,35,48,1798
16174,16174,34FB5BF239A7B5016E3CA81F47968839,43731,21,23,2,34,47,1747
16175,16175,27974FFED1FEA6C307087BA19F6FC924,10544,0,12,12,28,48,1448
16176,16176,27974FFED1FEA6C307087BA19F6FC924,11151,12,14,2,30,48,1548
16177,16177,27974FFED1FEA6C307087BA19F6FC924,10544,14,23,9,28,48,1448
16188,16188,99A92AD24D04D2EBCBD0E2108B572F74,11061,2,9,7,29,48,1498
16189,16189,99A92AD24D04D2EBCBD0E2108B572F74,11431,10,12,2,29,47,1497
16190,16190,99A92AD24D04D2EBCBD0E2108B572F74,11061,12,22,10,29,48,1498
16218,16218,3B7BCECE438857C5FA767F063E978A55,10931,0,5,5,41,48,2098
16219,16219,3B7BCECE438857C5FA767F063E978A55,13101,7,8,1,40,47,2047
16220,16220,3B7BCECE438857C5FA767F063E978A55,42583,12,17,5,40,48,2048
16221,16221,3B7BCECE438857C5FA767F063E978A55,10421,19,23,4,41,48,2098
16228,16228,86877F32D6D32D1728C272FD8E7855F4,10281,0,8,8,33,48,1698
16229,16229,86877F32D6D32D1728C272FD8E7855F4,11861,9,13,4,32,47,1647
16230,16230,86877F32D6D32D1728C272FD8E7855F4,10281,13,14,1,33,48,1698
16231,16231,86877F32D6D32D1728C272FD8E7855F4,11861,15,23,8,32,47,1647
16235,16235,F4C8F856DD638BBA75F52C720E10C05D,12921,10,19,9,9,41,491
16236,16236,F4C8F856DD638BBA75F52C720E10C05D,12641,19,21,2,10,43,543
16237,16237,F4C8F856DD638BBA75F52C720E10C05D,12921,21,23,2,9,41,491
16249,16249,81D5034BB335E907C610C1F19BE8547C,10801,0,6,6,42,47,2147
16250,16250,81D5034BB335E907C610C1F19BE8547C,13371,8,12,4,41,47,2097
16251,16251,81D5034BB335E907C610C1F19BE8547C,10801,13,15,2,42,47,2147
16252,16252,81D5034BB335E907C610C1F19BE8547C,13371,15,23,8,41,47,2097
16253,16253,3D2B6E5392F9F9C30BA70AF7A5672793,11914,9,11,2,37,48,1898
16254,16254,3D2B6E5392F9F9C30BA70AF7A5672793,42581,12,13,1,38,48,1948
16255,16255,3D2B6E5392F9F9C30BA70AF7A5672793,11911,13,21,8,37,48,1898
16256,16256,3D2B6E5392F9F9C30BA70AF7A5672793,42581,22,23,1,38,48,1948
16257,16257,958D2F4CB99C769C3768CD7459979CC4,40882,0,13,13,34,49,1749
16258,16258,958D2F4CB99C769C3768CD7459979CC4,11861,14,18,4,32,47,1647
16259,16259,958D2F4CB99C769C3768CD7459979CC4,10431,19,20,1,33,49,1699
16260,16260,958D2F4CB99C769C3768CD7459979CC4,40882,20,23,3,34,49,1749
16270,16270,11C5ACA60B0246DE7069023057E8285F,11381,0,1,1,30,47,1547
16271,16271,11C5ACA60B0246DE7069023057E8285F,11061,4,11,7,29,48,1498
16272,16272,11C5ACA60B0246DE7069023057E8285F,11381,12,23,11,30,47,1547
16273,16273,540311DE1F12F752C637697C87C1492F,43951,0,13,13,49,41,2491
16274,16274,540311DE1F12F752C637697C87C1492F,43101,15,17,2,46,40,2340
16275,16275,540311DE1F12F752C637697C87C1492F,43951,18,23,5,49,41,2491
16281,16281,40332F05BDDE464A3027D1BB9B325A5D,12401,0,6,6,39,49,1999
16282,16282,40332F05BDDE464A3027D1BB9B325A5D,42961,7,14,7,35,49,1799
16283,16283,40332F05BDDE464A3027D1BB9B325A5D,11021,16,19,3,36,49,1849
16284,16284,46E0FBCD15EB69B63AD77A98F1B15C43,43761,9,10,1,32,47,1647
16285,16285,46E0FBCD15EB69B63AD77A98F1B15C43,10971,12,17,5,35,47,1797
16286,16286,46E0FBCD15EB69B63AD77A98F1B15C43,10731,17,23,6,33,47,1697
16287,16287,C328A2915A4792A71AC58E7C60675781,42581,0,1,1,38,48,1948
16288,16288,C328A2915A4792A71AC58E7C60675781,11914,3,8,5,37,48,1898
16289,16289,C328A2915A4792A71AC58E7C60675781,42581,8,20,12,38,48,1948
16316,16316,91255D06927B960CDE2D40EA37EEC3E2,11381,3,9,6,30,47,1547
16317,16317,91255D06927B960CDE2D40EA37EEC3E2,11431,9,11,2,29,47,1497
16318,16318,91255D06927B960CDE2D40EA37EEC3E2,42141,13,21,8,32,47,1647
16324,16324,D73B2854AD737668DCBFC2AD5E22AA5A,42864,2,8,6,38,44,1944
16325,16325,D73B2854AD737668DCBFC2AD5E22AA5A,11261,8,20,12,36,46,1846
16326,16326,D73B2854AD737668DCBFC2AD5E22AA5A,42864,22,23,1,38,44,1944
16347,16347,9AF6F4C6C4937C91C918EC9853CABA28,11261,0,1,1,36,46,1846
16348,16348,9AF6F4C6C4937C91C918EC9853CABA28,42861,4,5,1,37,44,1894
16349,16349,9AF6F4C6C4937C91C918EC9853CABA28,11261,8,11,3,36,46,1846
16350,16350,9AF6F4C6C4937C91C918EC9853CABA28,42861,12,21,9,37,44,1894
16356,16356,CFD70B56FA65C02C4B76645FBAC9B18F,11491,0,13,13,36,47,1847
16357,16357,CFD70B56FA65C02C4B76645FBAC9B18F,11351,13,14,1,36,48,1848
16358,16358,CFD70B56FA65C02C4B76645FBAC9B18F,40431,15,19,4,36,47,1847
16359,16359,21709F7FFA433548AE3C0AA8A76FE0E7,11151,0,4,4,30,48,1548
16360,16360,21709F7FFA433548AE3C0AA8A76FE0E7,42831,5,8,3,27,48,1398
16361,16361,21709F7FFA433548AE3C0AA8A76FE0E7,11151,10,23,13,30,48,1548
16365,16365,CC9B563274FADBC11530657F755F072F,40637,0,18,18,36,47,1847
16366,16366,CC9B563274FADBC11530657F755F072F,11074,19,20,1,37,47,1897
16367,16367,CC9B563274FADBC11530657F755F072F,11491,21,23,2,36,47,1847
16376,16376,C7DABDD3B30538BA528E17648006549E,42161,7,9,2,36,47,1847
16377,16377,C7DABDD3B30538BA528E17648006549E,42511,10,11,1,37,47,1897
16378,16378,C7DABDD3B30538BA528E17648006549E,42301,12,23,11,36,47,1847
16386,16386,6E3A482A59CE9925DB19971C6ACB206A,42191,0,7,7,38,49,1949
16387,16387,6E3A482A59CE9925DB19971C6ACB206A,10471,10,17,7,37,48,1898
16388,16388,6E3A482A59CE9925DB19971C6ACB206A,11811,21,23,2,38,49,1949
16401,16401,1C461F1E440C54F9A8141510311D9FF7,10151,1,11,10,34,47,1747
16402,16402,1C461F1E440C54F9A8141510311D9FF7,42921,13,18,5,33,47,1697
16403,16403,1C461F1E440C54F9A8141510311D9FF7,10151,18,19,1,34,47,1747
16415,16415,B6E06BECFD200E305BD11D4E181199C8,11951,0,10,10,31,49,1599
16416,16416,B6E06BECFD200E305BD11D4E181199C8,10401,12,15,3,33,49,1699
16417,16417,B6E06BECFD200E305BD11D4E181199C8,11951,19,23,4,31,49,1599
16418,16418,2F1F7798F5E8889B4080CA59D71F0274,10271,1,16,15,37,46,1896
16419,16419,2F1F7798F5E8889B4080CA59D71F0274,43241,17,19,2,36,46,1846
16420,16420,2F1F7798F5E8889B4080CA59D71F0274,10271,21,23,2,37,46,1896
16421,16421,018A1CC117B204501E34F73B68B137CB,42581,0,6,6,38,48,1948
16422,16422,018A1CC117B204501E34F73B68B137CB,11914,9,10,1,37,48,1898
16423,16423,018A1CC117B204501E34F73B68B137CB,42581,13,22,9,38,48,1948
16435,16435,57B328CB2D89A1ADE1479C7CF9C033FB,10971,2,7,5,35,47,1797
16436,16436,57B328CB2D89A1ADE1479C7CF9C033FB,10531,7,14,7,34,46,1746
16437,16437,57B328CB2D89A1ADE1479C7CF9C033FB,10151,15,16,1,34,47,1747
16438,16438,57B328CB2D89A1ADE1479C7CF9C033FB,10971,18,22,4,35,47,1797
16439,16439,CCCD2290FB632A48009771412BE68ADD,10691,0,5,5,33,48,1698
16440,16440,CCCD2290FB632A48009771412BE68ADD,11861,7,17,10,32,47,1647
16441,16441,CCCD2290FB632A48009771412BE68ADD,10491,19,23,4,33,48,1698
16448,16448,B4CF5575585A81D8047EC86B2FC8CF53,42861,0,8,8,37,44,1894
16449,16449,B4CF5575585A81D8047EC86B2FC8CF53,11261,9,10,1,36,46,1846
16450,16450,B4CF5575585A81D8047EC86B2FC8CF53,42861,11,23,12,37,44,1894
16461,16461,726D8BF6FE9D2B730CE8E7DD26F779CD,11381,1,2,1,30,47,1547
16462,16462,726D8BF6FE9D2B730CE8E7DD26F779CD,12121,2,12,10,29,47,1497
16463,16463,726D8BF6FE9D2B730CE8E7DD26F779CD,11381,14,20,6,30,47,1547
16464,16464,726D8BF6FE9D2B730CE8E7DD26F779CD,10491,21,23,2,33,48,1698
16468,16468,7BF529F423A6C51BF619B13381E16746,42141,0,6,6,32,47,1647
16469,16469,7BF529F423A6C51BF619B13381E16746,42071,10,18,8,31,49,1599
16470,16470,7BF529F423A6C51BF619B13381E16746,43761,21,23,2,32,47,1647
16474,16474,3387C82215AFBAC0B57EFF2A942EF29E,13331,1,8,7,38,47,1947
16475,16475,3387C82215AFBAC0B57EFF2A942EF29E,42281,14,17,3,40,48,2048
16476,16476,3387C82215AFBAC0B57EFF2A942EF29E,13331,20,21,1,38,47,1947
16477,16477,1522BDE7E05C3ADAA9D8391F632D7715,11361,0,14,14,22,48,1148
16478,16478,1522BDE7E05C3ADAA9D8391F632D7715,12581,19,20,1,24,48,1248
16479,16479,1522BDE7E05C3ADAA9D8391F632D7715,11361,21,23,2,22,48,1148
16483,16483,C994B0BB00A5F5442EEA247C000D74C5,42531,0,9,9,31,45,1595
16484,16484,C994B0BB00A5F5442EEA247C000D74C5,12311,14,15,1,30,44,1544
16485,16485,C994B0BB00A5F5442EEA247C000D74C5,42531,19,21,2,31,45,1595
16491,16491,7EBD3BA762C40F1F8A712F803B7D8FD3,42864,7,10,3,38,44,1944
16492,16492,7EBD3BA762C40F1F8A712F803B7D8FD3,42861,14,18,4,37,44,1894
16493,16493,7EBD3BA762C40F1F8A712F803B7D8FD3,42151,20,21,1,35,45,1795
16494,16494,7EBD3BA762C40F1F8A712F803B7D8FD3,12491,22,23,1,36,43,1843
16499,16499,2B30FE33FBF3AFAE54A80917AD235B85,11791,1,3,2,38,49,1949
16500,16500,2B30FE33FBF3AFAE54A80917AD235B85,11591,4,6,2,36,49,1849
16501,16501,2B30FE33FBF3AFAE54A80917AD235B85,11231,7,19,12,37,49,1899
16502,16502,D9026A3CE10A3841EFEE0C49DAE389C6,12641,0,5,5,10,43,543
16503,16503,D9026A3CE10A3841EFEE0C49DAE389C6,19114,6,17,11,7,43,393
16504,16504,D9026A3CE10A3841EFEE0C49DAE389C6,12641,20,21,1,10,43,543
16523,16523,B25570B41BE43EDFDB526BAD98D552B1,13341,0,7,7,44,45,2245
16524,16524,B25570B41BE43EDFDB526BAD98D552B1,42631,7,8,1,43,45,2195
16525,16525,B25570B41BE43EDFDB526BAD98D552B1,13341,8,17,9,44,45,2245
16526,16526,B25570B41BE43EDFDB526BAD98D552B1,42631,19,21,2,43,45,2195
16527,16527,839E5B2416DDB60AF8D62A7EA6186138,13601,0,6,6,34,47,1747
16528,16528,839E5B2416DDB60AF8D62A7EA6186138,42021,8,17,9,33,47,1697
16529,16529,839E5B2416DDB60AF8D62A7EA6186138,12971,19,20,1,32,48,1648
16530,16530,839E5B2416DDB60AF8D62A7EA6186138,42021,22,23,1,33,47,1697
16531,16531,F93D646A1BCE1AFF390EB78A01863C9E,40171,1,9,8,38,48,1948
16532,16532,F93D646A1BCE1AFF390EB78A01863C9E,11914,10,11,1,37,48,1898
16533,16533,F93D646A1BCE1AFF390EB78A01863C9E,40171,15,19,4,38,48,1948
16534,16534,DAF070E37522449552E837969D087804,10491,0,6,6,33,48,1698
16535,16535,DAF070E37522449552E837969D087804,10471,6,18,12,37,48,1898
16536,16536,DAF070E37522449552E837969D087804,10491,19,23,4,33,48,1698
16555,16555,280A825D237E9CE7CB403628403E758B,11261,0,7,7,36,46,1846
16556,16556,280A825D237E9CE7CB403628403E758B,42351,7,8,1,38,45,1945
16557,16557,280A825D237E9CE7CB403628403E758B,13911,10,20,10,39,46,1996
16558,16558,280A825D237E9CE7CB403628403E758B,42351,21,23,2,38,45,1945
16568,16568,2C19FDC386B0B2E924F75B25676D719F,42231,1,2,1,37,46,1896
16569,16569,2C19FDC386B0B2E924F75B25676D719F,42351,3,10,7,38,45,1945
16570,16570,2C19FDC386B0B2E924F75B25676D719F,42231,10,12,2,37,46,1896
16571,16571,2C19FDC386B0B2E924F75B25676D719F,42351,14,18,4,38,45,1945
16576,16576,F2229754FABF7F398D6839D6208AC86F,10544,0,7,7,28,48,1448
16577,16577,F2229754FABF7F398D6839D6208AC86F,10951,9,10,1,29,48,1498
16578,16578,F2229754FABF7F398D6839D6208AC86F,10544,12,23,11,28,48,1448
16583,16583,943D8FF4E7261713DF48B616A73AC90F,11461,2,8,6,37,49,1899
16584,16584,943D8FF4E7261713DF48B616A73AC90F,10107,13,14,1,38,49,1949
16585,16585,943D8FF4E7261713DF48B616A73AC90F,11231,16,23,7,37,49,1899
16586,16586,6C96EE989846ABECA961FEB7DAD4E3B3,40171,0,6,6,38,48,1948
16587,16587,6C96EE989846ABECA961FEB7DAD4E3B3,10471,7,8,1,37,48,1898
16588,16588,6C96EE989846ABECA961FEB7DAD4E3B3,40171,9,12,3,38,48,1948
16589,16589,6C96EE989846ABECA961FEB7DAD4E3B3,10471,17,22,5,37,48,1898
16590,16590,EA60FF611A17A14C1FADA7F86EE9429F,42151,0,17,17,35,45,1795
16591,16591,EA60FF611A17A14C1FADA7F86EE9429F,42231,18,19,1,37,46,1896
16592,16592,EA60FF611A17A14C1FADA7F86EE9429F,13121,19,21,2,38,46,1946
16593,16593,EA60FF611A17A14C1FADA7F86EE9429F,42151,21,22,1,35,45,1795
16594,16594,C6869A64CA9EF97A25D7192A00726FC2,42401,0,9,9,36,47,1847
16595,16595,C6869A64CA9EF97A25D7192A00726FC2,10781,9,17,8,35,47,1797
16596,16596,C6869A64CA9EF97A25D7192A00726FC2,42401,18,23,5,36,47,1847
16603,16603,70ECF37312EC06DA6D7AE85509DBF5FE,10471,0,10,10,37,48,1898
16604,16604,70ECF37312EC06DA6D7AE85509DBF5FE,11781,11,13,2,38,49,1949
16605,16605,70ECF37312EC06DA6D7AE85509DBF5FE,10471,14,17,3,37,48,1898
16606,16606,70ECF37312EC06DA6D7AE85509DBF5FE,10121,21,23,2,36,49,1849
16628,16628,13EC49946717F7E7B7D897EA14259B47,42921,0,9,9,33,47,1697
16629,16629,13EC49946717F7E7B7D897EA14259B47,12131,12,19,7,32,47,1647
16630,16630,13EC49946717F7E7B7D897EA14259B47,42021,19,20,1,33,47,1697
16631,16631,0DD480B5A13E261C7A404CA1C7C938C6,42511,0,5,5,37,47,1897
16632,16632,0DD480B5A13E261C7A404CA1C7C938C6,13121,6,16,10,38,46,1946
16633,16633,0DD480B5A13E261C7A404CA1C7C938C6,12021,19,21,2,37,49,1899
16634,16634,0DD480B5A13E261C7A404CA1C7C938C6,42511,22,23,1,37,47,1897
16635,16635,508A53F3E777F5ECDE2E5B976BFD7315,42231,6,10,4,37,46,1896
16636,16636,508A53F3E777F5ECDE2E5B976BFD7315,42351,10,12,2,38,45,1945
16637,16637,508A53F3E777F5ECDE2E5B976BFD7315,42231,13,23,10,37,46,1896
16646,16646,8EA53D8E1525E5DC764AA8B750C1926A,43951,7,18,11,49,41,2491
16647,16647,8EA53D8E1525E5DC764AA8B750C1926A,13411,18,19,1,49,42,2492
16648,16648,8EA53D8E1525E5DC764AA8B750C1926A,43951,19,21,2,49,41,2491
16649,16649,E311A49FD79CE1E67702DBA9B7887B92,12641,1,2,1,10,43,543
16650,16650,E311A49FD79CE1E67702DBA9B7887B92,19021,6,8,2,10,45,545
16651,16651,E311A49FD79CE1E67702DBA9B7887B92,12641,8,12,4,10,43,543
16652,16652,E311A49FD79CE1E67702DBA9B7887B92,19021,13,18,5,10,45,545
16653,16653,2B05CC2BC211341FBD9F6EA8966B4690,42581,2,9,7,38,48,1948
16654,16654,2B05CC2BC211341FBD9F6EA8966B4690,11914,11,13,2,37,48,1898
16655,16655,2B05CC2BC211341FBD9F6EA8966B4690,42581,14,22,8,38,48,1948
16656,16656,2B05CC2BC211341FBD9F6EA8966B4690,11914,22,23,1,37,48,1898
16657,16657,D8963F7C81A647B0DB7A8BBF70036A0B,42221,0,7,7,38,48,1948
16658,16658,D8963F7C81A647B0DB7A8BBF70036A0B,10471,8,17,9,37,48,1898
16659,16659,D8963F7C81A647B0DB7A8BBF70036A0B,12514,18,23,5,38,47,1947
16660,16660,6E71207F40ABEC46B7131A267F90969E,19114,3,17,14,7,43,393
16661,16661,6E71207F40ABEC46B7131A267F90969E,12641,20,21,1,10,43,543
16662,16662,6E71207F40ABEC46B7131A267F90969E,19114,21,23,2,7,43,393
16663,16663,90568B514F9B63E4374F225CB87C45A4,11021,0,9,9,36,49,1849
16664,16664,90568B514F9B63E4374F225CB87C45A4,13561,9,11,2,37,49,1899
16665,16665,90568B514F9B63E4374F225CB87C45A4,11021,12,22,10,36,49,1849
16666,16666,F725A3F859B25741A70E1B3AC0517A8A,10111,0,12,12,37,47,1897
16667,16667,F725A3F859B25741A70E1B3AC0517A8A,42301,12,13,1,36,47,1847
16668,16668,F725A3F859B25741A70E1B3AC0517A8A,10111,15,19,4,37,47,1897
16669,16669,F725A3F859B25741A70E1B3AC0517A8A,43171,21,22,1,39,49,1999
16670,16670,EC587A8D735A15FBFAB055D919B57FFC,43181,0,13,13,39,48,1998
16671,16671,EC587A8D735A15FBFAB055D919B57FFC,11781,16,18,2,38,49,1949
16672,16672,EC587A8D735A15FBFAB055D919B57FFC,43181,19,23,4,39,48,1998
16673,16673,C5AC3744EA191771220A3FE471A7FACC,42161,0,2,2,36,47,1847
16674,16674,C5AC3744EA191771220A3FE471A7FACC,10251,2,14,12,35,47,1797
16675,16675,C5AC3744EA191771220A3FE471A7FACC,10661,14,15,1,37,49,1899
16676,16676,C5AC3744EA191771220A3FE471A7FACC,42161,16,23,7,36,47,1847
16681,16681,D246B107853B0F4D941EBF1F8081E653,42523,7,11,4,31,47,1597
16682,16682,D246B107853B0F4D941EBF1F8081E653,43761,12,14,2,32,47,1647
16683,16683,D246B107853B0F4D941EBF1F8081E653,10295,14,18,4,30,47,1547
16684,16684,F714E7BCDABF2B2F99991B80BC6098B2,19904,0,5,5,9,44,494
16685,16685,F714E7BCDABF2B2F99991B80BC6098B2,12641,6,15,9,10,43,543
16686,16686,F714E7BCDABF2B2F99991B80BC6098B2,19114,16,17,1,7,43,393
16687,16687,F714E7BCDABF2B2F99991B80BC6098B2,12641,18,19,1,10,43,543
16691,16691,6C7DE4B4696563CBDA9D3C6E4FCAB652,42523,0,13,13,31,47,1597
16692,16692,6C7DE4B4696563CBDA9D3C6E4FCAB652,10292,14,16,2,30,47,1547
16693,16693,6C7DE4B4696563CBDA9D3C6E4FCAB652,42521,19,23,4,31,47,1597
16694,16694,0AA9A21AE5592E43C5386C31A83CC971,11021,0,9,9,36,49,1849
16695,16695,0AA9A21AE5592E43C5386C31A83CC971,11751,9,18,9,35,48,1798
16696,16696,0AA9A21AE5592E43C5386C31A83CC971,11021,22,23,1,36,49,1849
16697,16697,7636C02B931F5033A3275CA34FA4048C,11231,0,4,4,37,49,1899
16698,16698,7636C02B931F5033A3275CA34FA4048C,10121,4,9,5,36,49,1849
16699,16699,7636C02B931F5033A3275CA34FA4048C,11231,9,18,9,37,49,1899
16734,16734,03CC5102FB306C3254027D35E65D966E,42581,1,9,8,38,48,1948
16735,16735,03CC5102FB306C3254027D35E65D966E,11914,10,12,2,37,48,1898
16736,16736,03CC5102FB306C3254027D35E65D966E,42581,15,17,2,38,48,1948
16737,16737,03CC5102FB306C3254027D35E65D966E,11914,18,22,4,37,48,1898
16738,16738,A60E51B2BB36D63F6E34260285BCBDB6,42531,0,1,1,31,45,1595
16739,16739,A60E51B2BB36D63F6E34260285BCBDB6,12661,2,10,8,32,45,1645
16740,16740,A60E51B2BB36D63F6E34260285BCBDB6,42531,14,23,9,31,45,1595
16759,16759,D051A53A52187B78CF6DA99F6B3FF9C4,40637,0,16,16,36,47,1847
16760,16760,D051A53A52187B78CF6DA99F6B3FF9C4,10251,17,18,1,35,47,1797
16761,16761,D051A53A52187B78CF6DA99F6B3FF9C4,42401,19,21,2,36,47,1847
16762,16762,3E17C9F881E8F571652BFE5E841845EF,11861,0,9,9,32,47,1647
16763,16763,3E17C9F881E8F571652BFE5E841845EF,10281,9,10,1,33,48,1698
16764,16764,3E17C9F881E8F571652BFE5E841845EF,11861,11,23,12,32,47,1647
16771,16771,5C2B763013F3453FD43407A455CBD2B2,13651,1,5,4,30,47,1547
16772,16772,5C2B763013F3453FD43407A455CBD2B2,42523,9,11,2,31,47,1597
16773,16773,5C2B763013F3453FD43407A455CBD2B2,13651,12,23,11,30,47,1547
16792,16792,69E733DE4C2A7A294CFA07F4F32678A0,11914,0,1,1,37,48,1898
16793,16793,69E733DE4C2A7A294CFA07F4F32678A0,42231,3,14,11,37,46,1896
16794,16794,69E733DE4C2A7A294CFA07F4F32678A0,13911,14,15,1,39,46,1996
16795,16795,69E733DE4C2A7A294CFA07F4F32678A0,43161,19,22,3,35,47,1797
16807,16807,AA94328A21E669C14B53998CC009A981,43951,5,6,1,49,41,2491
16808,16808,AA94328A21E669C14B53998CC009A981,13821,7,16,9,49,45,2495
16809,16809,AA94328A21E669C14B53998CC009A981,43951,17,23,6,49,41,2491
16836,16836,8B7C73BA6B2D95910FBCFDF137038C2A,19114,0,7,7,7,43,393
16837,16837,8B7C73BA6B2D95910FBCFDF137038C2A,12641,9,13,4,10,43,543
16838,16838,8B7C73BA6B2D95910FBCFDF137038C2A,19114,17,23,6,7,43,393
16839,16839,1DD1A250791E8DE9D0B949B1DAE230C8,10281,0,11,11,33,48,1698
16840,16840,1DD1A250791E8DE9D0B949B1DAE230C8,11861,11,12,1,32,47,1647
16841,16841,1DD1A250791E8DE9D0B949B1DAE230C8,10281,13,14,1,33,48,1698
16842,16842,1DD1A250791E8DE9D0B949B1DAE230C8,11861,18,23,5,32,47,1647
16856,16856,E45BFF8A7B42DBE312092B84982F68A3,11861,0,7,7,32,47,1647
16857,16857,E45BFF8A7B42DBE312092B84982F68A3,10711,9,19,10,29,46,1496
16858,16858,E45BFF8A7B42DBE312092B84982F68A3,11861,19,23,4,32,47,1647
16859,16859,9F589AB01E58B6B2CA9FB997F96CB7F3,42381,0,6,6,39,41,1991
16860,16860,9F589AB01E58B6B2CA9FB997F96CB7F3,43451,8,11,3,37,40,1890
16861,16861,9F589AB01E58B6B2CA9FB997F96CB7F3,42381,12,14,2,39,41,1991
16862,16862,9F589AB01E58B6B2CA9FB997F96CB7F3,43451,14,20,6,37,40,1890
16872,16872,B3E65E9B8C8CAC02E61922EDB0A62E7D,42511,0,8,8,37,47,1897
16873,16873,B3E65E9B8C8CAC02E61922EDB0A62E7D,41021,9,13,4,38,47,1947
16874,16874,B3E65E9B8C8CAC02E61922EDB0A62E7D,13121,18,19,1,38,46,1946
16875,16875,1228A94EA6C2D4622CFEAC816DA2851D,11914,0,7,7,37,48,1898
16876,16876,1228A94EA6C2D4622CFEAC816DA2851D,10901,9,15,6,35,48,1798
16877,16877,1228A94EA6C2D4622CFEAC816DA2851D,13221,19,23,4,40,47,2047
16882,16882,F18C7871BFB82CA1A349E44A5DE6D0B7,11021,0,10,10,36,49,1849
16883,16883,F18C7871BFB82CA1A349E44A5DE6D0B7,10221,11,12,1,34,49,1749
16884,16884,F18C7871BFB82CA1A349E44A5DE6D0B7,11021,13,22,9,36,49,1849
16901,16901,AE21E38BEFF88B1BA1578ED2E6E5DC28,42281,8,14,6,40,48,2048
16902,16902,AE21E38BEFF88B1BA1578ED2E6E5DC28,11074,16,18,2,37,47,1897
16903,16903,AE21E38BEFF88B1BA1578ED2E6E5DC28,42221,19,20,1,38,48,1948
16911,16911,66026EF77CBEF7186A8C71238274BA4B,11381,0,4,4,30,47,1547
16912,16912,66026EF77CBEF7186A8C71238274BA4B,11061,9,17,8,29,48,1498
16913,16913,66026EF77CBEF7186A8C71238274BA4B,10681,17,21,4,30,48,1548
16914,16914,24576DC2C63BF30A46BA06C33A71F868,12491,0,2,2,36,43,1843
16915,16915,24576DC2C63BF30A46BA06C33A71F868,11261,6,10,4,36,46,1846
16916,16916,24576DC2C63BF30A46BA06C33A71F868,12491,11,13,2,36,43,1843
16917,16917,24576DC2C63BF30A46BA06C33A71F868,11261,14,18,4,36,46,1846
16931,16931,D2729AB4C70132F423F41A3669BBCC53,42521,0,2,2,31,47,1597
16932,16932,D2729AB4C70132F423F41A3669BBCC53,43761,2,11,9,32,47,1647
16933,16933,D2729AB4C70132F423F41A3669BBCC53,42521,12,13,1,31,47,1597
16934,16934,D2729AB4C70132F423F41A3669BBCC53,43761,14,22,8,32,47,1647
16935,16935,6CD008CBF5332727B7FB0E79DB4BAD66,43761,0,8,8,32,47,1647
16936,16936,6CD008CBF5332727B7FB0E79DB4BAD66,10901,9,18,9,35,48,1798
16937,16937,6CD008CBF5332727B7FB0E79DB4BAD66,11861,19,21,2,32,47,1647
16949,16949,0D3CD827A1181C3C1B665AF25454E6A9,40112,0,7,7,32,48,1648
16950,16950,0D3CD827A1181C3C1B665AF25454E6A9,10161,10,11,1,35,49,1799
16951,16951,0D3CD827A1181C3C1B665AF25454E6A9,10221,12,13,1,34,49,1749
16952,16952,0D3CD827A1181C3C1B665AF25454E6A9,12971,13,23,10,32,48,1648
16953,16953,54869B905D9FE5BDC4D6EE5F69644AAC,10421,0,6,6,41,48,2098
16954,16954,54869B905D9FE5BDC4D6EE5F69644AAC,42321,6,17,11,43,47,2197
16955,16955,54869B905D9FE5BDC4D6EE5F69644AAC,11701,18,20,2,43,48,2198
16960,16960,D898D6DC20CF464A2D30925DB7843B70,19441,1,2,1,8,46,446
16961,16961,D898D6DC20CF464A2D30925DB7843B70,42041,2,6,4,10,47,547
16962,16962,D898D6DC20CF464A2D30925DB7843B70,19441,11,18,7,8,46,446
16963,16963,AC414DB8853E95A441FB40B4893530F7,11875,2,4,2,30,46,1546
16964,16964,AC414DB8853E95A441FB40B4893530F7,10351,8,16,8,28,45,1445
16965,16965,AC414DB8853E95A441FB40B4893530F7,10634,16,18,2,27,45,1395
16969,16969,A18E604F6E21B36C655ED57648BC9F76,11591,2,6,4,36,49,1849
16970,16970,A18E604F6E21B36C655ED57648BC9F76,11231,8,15,7,37,49,1899
16971,16971,A18E604F6E21B36C655ED57648BC9F76,10121,15,17,2,36,49,1849
16972,16972,A18E604F6E21B36C655ED57648BC9F76,11231,18,22,4,37,49,1899
16982,16982,B3B147972ECD6C8A2C0FDDE3D7D5F774,13371,0,12,12,41,47,2097
16983,16983,B3B147972ECD6C8A2C0FDDE3D7D5F774,13221,12,14,2,40,47,2047
16984,16984,B3B147972ECD6C8A2C0FDDE3D7D5F774,13941,17,23,6,41,47,2097
16985,16985,D4FB6B465C87A5D763D7E62820C6F264,19441,1,12,11,8,46,446
16986,16986,D4FB6B465C87A5D763D7E62820C6F264,42041,15,16,1,10,47,547
16987,16987,D4FB6B465C87A5D763D7E62820C6F264,19441,16,20,4,8,46,446
16992,16992,1331EB294578A8B5035A897C4CDC8F40,43761,0,12,12,32,47,1647
16993,16993,1331EB294578A8B5035A897C4CDC8F40,42523,12,14,2,31,47,1597
16994,16994,1331EB294578A8B5035A897C4CDC8F40,43761,18,23,5,32,47,1647
16998,16998,7593D7AED856FF2FC2E20D8E8570438A,10471,0,18,18,37,48,1898
16999,16999,7593D7AED856FF2FC2E20D8E8570438A,11811,19,20,1,38,49,1949
17000,17000,7593D7AED856FF2FC2E20D8E8570438A,40171,21,23,2,38,48,1948
17008,17008,AD235EE6A83CA7956AB86E8BC887D3C7,11541,0,5,5,35,49,1799
17009,17009,AD235EE6A83CA7956AB86E8BC887D3C7,11021,7,17,10,36,49,1849
17010,17010,AD235EE6A83CA7956AB86E8BC887D3C7,11541,18,23,5,35,49,1799
17016,17016,EE6B8585E25BB845D2DA0A95F88FAB79,42231,0,10,10,37,46,1896
17017,17017,EE6B8585E25BB845D2DA0A95F88FAB79,42351,10,12,2,38,45,1945
17018,17018,EE6B8585E25BB845D2DA0A95F88FAB79,13911,14,17,3,39,46,1996
17019,17019,EE6B8585E25BB845D2DA0A95F88FAB79,42231,20,22,2,37,46,1896
17025,17025,1EF65F9DBDC1402BAA31164960F0EECD,10801,0,3,3,42,47,2147
17026,17026,1EF65F9DBDC1402BAA31164960F0EECD,42321,5,17,12,43,47,2197
17027,17027,1EF65F9DBDC1402BAA31164960F0EECD,42461,20,22,2,45,47,2297
17031,17031,5B005239AD91B224060A740123F8C94E,13231,0,12,12,39,46,1996
17032,17032,5B005239AD91B224060A740123F8C94E,42231,13,15,2,37,46,1896
17033,17033,5B005239AD91B224060A740123F8C94E,13911,15,16,1,39,46,1996
17034,17034,5B005239AD91B224060A740123F8C94E,42231,18,19,1,37,46,1896
17041,17041,52DE1B5B29EB088C4F7CC0D4865B38F5,42861,0,5,5,37,44,1894
17042,17042,52DE1B5B29EB088C4F7CC0D4865B38F5,42151,8,9,1,35,45,1795
17043,17043,52DE1B5B29EB088C4F7CC0D4865B38F5,42861,13,22,9,37,44,1894
17044,17044,132BAF41704DD845C2F70543C3732C4E,13711,0,5,5,38,46,1946
17045,17045,132BAF41704DD845C2F70543C3732C4E,42231,7,10,3,37,46,1896
17046,17046,132BAF41704DD845C2F70543C3732C4E,13711,14,20,6,38,46,1946
17047,17047,FAA7FFABBE3049DD3E16783E7695AC95,43311,0,5,5,31,48,1598
17048,17048,FAA7FFABBE3049DD3E16783E7695AC95,10681,7,11,4,30,48,1548
17049,17049,FAA7FFABBE3049DD3E16783E7695AC95,43311,13,14,1,31,48,1598
17050,17050,FAA7FFABBE3049DD3E16783E7695AC95,11751,16,19,3,35,48,1798
17051,17051,6DEC9870D93E3E64EEA903D7BB614FCC,40101,0,13,13,34,49,1749
17052,17052,6DEC9870D93E3E64EEA903D7BB614FCC,13561,15,17,2,37,49,1899
17053,17053,6DEC9870D93E3E64EEA903D7BB614FCC,40101,20,22,2,34,49,1749
17054,17054,A633655235449D63DF9FCC21A84BEF59,12381,0,8,8,32,48,1648
17055,17055,A633655235449D63DF9FCC21A84BEF59,10721,12,14,2,31,48,1598
17056,17056,A633655235449D63DF9FCC21A84BEF59,12381,21,23,2,32,48,1648
17068,17068,6B9B8D827AD1E80848E05B71B545DCBC,10681,0,8,8,30,48,1548
17069,17069,6B9B8D827AD1E80848E05B71B545DCBC,11061,9,10,1,29,48,1498
17070,17070,6B9B8D827AD1E80848E05B71B545DCBC,10681,15,23,8,30,48,1548
17071,17071,B7D6EFF1A712C97E66620534B8D3DEAE,10471,0,11,11,37,48,1898
17072,17072,B7D6EFF1A712C97E66620534B8D3DEAE,41271,11,12,1,38,48,1948
17073,17073,B7D6EFF1A712C97E66620534B8D3DEAE,10471,18,21,3,37,48,1898
17084,17084,E2FC80C995A3EFA4B2AF01BAD4B24C1C,42221,0,4,4,38,48,1948
17085,17085,E2FC80C995A3EFA4B2AF01BAD4B24C1C,11074,4,5,1,37,47,1897
17086,17086,E2FC80C995A3EFA4B2AF01BAD4B24C1C,42221,5,7,2,38,48,1948
17087,17087,E2FC80C995A3EFA4B2AF01BAD4B24C1C,12083,12,18,6,36,49,1849
17093,17093,C49A9758546D4A1E535835DF12DB9652,42491,0,10,10,32,46,1646
17094,17094,C49A9758546D4A1E535835DF12DB9652,10295,10,16,6,30,47,1547
17095,17095,C49A9758546D4A1E535835DF12DB9652,42491,18,22,4,32,46,1646
17096,17096,EAAB672210C677BA2879CCE67BDB7DF5,11151,0,13,13,30,48,1548
17097,17097,EAAB672210C677BA2879CCE67BDB7DF5,42831,13,15,2,27,48,1398
17098,17098,EAAB672210C677BA2879CCE67BDB7DF5,11151,19,23,4,30,48,1548
17099,17099,538631A6190277898984781481DE297B,42091,0,8,8,43,46,2196
17100,17100,538631A6190277898984781481DE297B,11701,9,10,1,43,48,2198
17101,17101,538631A6190277898984781481DE297B,42091,15,23,8,43,46,2196
17113,17113,F587555054424F7ED0D63829AAEB0C06,42271,0,8,8,40,47,2047
17114,17114,F587555054424F7ED0D63829AAEB0C06,11806,9,10,1,41,48,2098
17115,17115,F587555054424F7ED0D63829AAEB0C06,42271,10,18,8,40,47,2047
17123,17123,C094282B525E0208A246EB62395EA9F5,10251,2,13,11,35,47,1797
17124,17124,C094282B525E0208A246EB62395EA9F5,12511,15,17,2,39,47,1997
17125,17125,C094282B525E0208A246EB62395EA9F5,10251,18,20,2,35,47,1797
17126,17126,0B48A85C2E63306F2732FBA1CEDC76FB,11021,1,8,7,36,49,1849
17127,17127,0B48A85C2E63306F2732FBA1CEDC76FB,10221,9,11,2,34,49,1749
17128,17128,0B48A85C2E63306F2732FBA1CEDC76FB,11021,17,22,5,36,49,1849
17129,17129,9E74C4204DF0368A301BB287E42AE5CC,13371,0,6,6,41,47,2097
17130,17130,9E74C4204DF0368A301BB287E42AE5CC,10231,9,15,6,39,49,1999
17131,17131,9E74C4204DF0368A301BB287E42AE5CC,13371,17,21,4,41,47,2097
17132,17132,9E74C4204DF0368A301BB287E42AE5CC,13791,22,23,1,42,47,2147
17157,17157,63E113647B076FC93CF9833FECFEFE8C,11381,2,3,1,30,47,1547
17158,17158,63E113647B076FC93CF9833FECFEFE8C,10951,3,13,10,29,48,1498
17159,17159,63E113647B076FC93CF9833FECFEFE8C,11381,13,23,10,30,47,1547
17160,17160,1DDBA4173A1A82CE4A25CA162B8D11CB,42381,0,5,5,39,41,1991
17161,17161,1DDBA4173A1A82CE4A25CA162B8D11CB,13071,7,9,2,41,41,2091
17162,17162,1DDBA4173A1A82CE4A25CA162B8D11CB,42381,12,14,2,39,41,1991
17163,17163,1DDBA4173A1A82CE4A25CA162B8D11CB,13071,15,20,5,41,41,2091
17172,17172,56F7236209B5943366167DCDA9EF00BB,10681,0,1,1,30,48,1548
17173,17173,56F7236209B5943366167DCDA9EF00BB,11061,3,10,7,29,48,1498
17174,17174,56F7236209B5943366167DCDA9EF00BB,10681,13,15,2,30,48,1548
17175,17175,56F7236209B5943366167DCDA9EF00BB,11061,16,22,6,29,48,1498
17176,17176,56B7F738C7A79602F60EE945AE193910,10661,0,8,8,37,49,1899
17177,17177,56B7F738C7A79602F60EE945AE193910,43281,12,13,1,37,48,1898
17178,17178,56B7F738C7A79602F60EE945AE193910,11231,13,22,9,37,49,1899
17179,17179,56B7F738C7A79602F60EE945AE193910,43281,22,23,1,37,48,1898
17183,17183,1F6BCFEB56D245CBF5160F742055C8A2,11061,6,11,5,29,48,1498
17184,17184,1F6BCFEB56D245CBF5160F742055C8A2,11151,11,14,3,30,48,1548
17185,17185,1F6BCFEB56D245CBF5160F742055C8A2,11061,15,20,5,29,48,1498
17186,17186,1F6BCFEB56D245CBF5160F742055C8A2,11151,21,23,2,30,48,1548
17191,17191,59F99AD9A04D6F91F4E80FA7D2485889,42351,0,7,7,38,45,1945
17192,17192,59F99AD9A04D6F91F4E80FA7D2485889,11261,8,17,9,36,46,1846
17193,17193,59F99AD9A04D6F91F4E80FA7D2485889,42231,20,22,2,37,46,1896
17200,17200,7BF71B893274BD2453B5FAE00144C714,41612,0,13,13,36,47,1847
17201,17201,7BF71B893274BD2453B5FAE00144C714,11331,15,17,2,37,48,1898
17202,17202,7BF71B893274BD2453B5FAE00144C714,40673,18,20,2,36,48,1848
17203,17203,7BF71B893274BD2453B5FAE00144C714,41612,21,23,2,36,47,1847
17207,17207,36A32F5B66FF074693C1BB33949A4900,10841,0,14,14,37,47,1897
17208,17208,36A32F5B66FF074693C1BB33949A4900,10251,16,18,2,35,47,1797
17209,17209,36A32F5B66FF074693C1BB33949A4900,40891,19,21,2,37,47,1897
17210,17210,9DB4729D532CD77BC570C66AAC50DE60,10251,0,11,11,35,47,1797
17211,17211,9DB4729D532CD77BC570C66AAC50DE60,42401,12,14,2,36,47,1847
17212,17212,9DB4729D532CD77BC570C66AAC50DE60,10251,17,23,6,35,47,1797
17213,17213,8820D655222FFDC13E2E08EC252AACD5,43161,0,7,7,35,47,1797
17214,17214,8820D655222FFDC13E2E08EC252AACD5,43731,10,11,1,34,47,1747
17215,17215,8820D655222FFDC13E2E08EC252AACD5,10971,12,20,8,35,47,1797
17216,17216,8820D655222FFDC13E2E08EC252AACD5,42161,22,23,1,36,47,1847
17217,17217,9F344971AFB0848D22FABB2D34666ADF,42321,0,1,1,43,47,2197
17218,17218,9F344971AFB0848D22FABB2D34666ADF,10801,2,10,8,42,47,2147
17219,17219,9F344971AFB0848D22FABB2D34666ADF,42321,14,23,9,43,47,2197
17220,17220,7200E84AEDCA7E085FE069DDCE5F2702,42401,0,7,7,36,47,1847
17221,17221,7200E84AEDCA7E085FE069DDCE5F2702,41081,8,18,10,36,49,1849
17222,17222,7200E84AEDCA7E085FE069DDCE5F2702,42401,18,23,5,36,47,1847
17223,17223,C1D79A070CFCF442F4B341637205D8DD,12221,0,1,1,43,44,2194
17224,17224,C1D79A070CFCF442F4B341637205D8DD,13341,3,8,5,44,45,2245
17225,17225,C1D79A070CFCF442F4B341637205D8DD,12211,8,10,2,41,44,2094
17226,17226,C1D79A070CFCF442F4B341637205D8DD,13341,14,23,9,44,45,2245
17238,17238,675E14475BB1E43D277D9A5E27CBF03A,42041,1,2,1,10,47,547
17239,17239,675E14475BB1E43D277D9A5E27CBF03A,19441,3,6,3,8,46,446
17240,17240,675E14475BB1E43D277D9A5E27CBF03A,42041,20,21,1,10,47,547
17241,17241,E528C1BCF7730647027A4A7EFB058975,42631,2,7,5,43,45,2195
17242,17242,E528C1BCF7730647027A4A7EFB058975,13341,12,17,5,44,45,2245
17243,17243,E528C1BCF7730647027A4A7EFB058975,42631,19,21,2,43,45,2195
17244,17244,46B3DE812748722328FAB277775E5F5A,42221,1,9,8,38,48,1948
17245,17245,46B3DE812748722328FAB277775E5F5A,10841,10,11,1,37,47,1897
17246,17246,46B3DE812748722328FAB277775E5F5A,12514,12,22,10,38,47,1947
17247,17247,04FC279D8763FD0D52EBF8F599CB8F45,10121,1,7,6,36,49,1849
17248,17248,04FC279D8763FD0D52EBF8F599CB8F45,10841,7,14,7,37,47,1897
17249,17249,04FC279D8763FD0D52EBF8F599CB8F45,10121,19,21,2,36,49,1849
17250,17250,8DB35B739E2FE5E0F3ED8AA494F0D7AC,11324,2,7,5,31,46,1596
17251,17251,8DB35B739E2FE5E0F3ED8AA494F0D7AC,10295,7,9,2,30,47,1547
17252,17252,8DB35B739E2FE5E0F3ED8AA494F0D7AC,11324,10,12,2,31,46,1596
17253,17253,8DB35B739E2FE5E0F3ED8AA494F0D7AC,10292,13,21,8,30,47,1547
17254,17254,A8C72576137B380AF09E0CA637D89EDF,40094,1,3,2,29,48,1498
17255,17255,A8C72576137B380AF09E0CA637D89EDF,10721,3,8,5,31,48,1598
17256,17256,A8C72576137B380AF09E0CA637D89EDF,11061,9,16,7,29,48,1498
17257,17257,A8C72576137B380AF09E0CA637D89EDF,11151,16,23,7,30,48,1548
17274,17274,5084492A6A758A3CF1EF2B8D58F59187,11875,0,6,6,30,46,1546
17275,17275,5084492A6A758A3CF1EF2B8D58F59187,12311,6,15,9,30,44,1544
17276,17276,5084492A6A758A3CF1EF2B8D58F59187,11875,19,23,4,30,46,1546
17277,17277,C35FFF479AFA41CBA0BE0F746C2360BC,11875,0,6,6,30,46,1546
17278,17278,C35FFF479AFA41CBA0BE0F746C2360BC,12311,7,14,7,30,44,1544
17279,17279,C35FFF479AFA41CBA0BE0F746C2360BC,11871,19,20,1,29,46,1496
17280,17280,CDDA9D2F8DFE80A26EF0E394C3C9A4D7,40861,0,2,2,34,48,1748
17281,17281,CDDA9D2F8DFE80A26EF0E394C3C9A4D7,10221,15,16,1,34,49,1749
17282,17282,CDDA9D2F8DFE80A26EF0E394C3C9A4D7,10251,17,21,4,35,47,1797
17287,17287,DEF2119ECB90D4385AD1A45A0B2C7A35,43761,3,12,9,32,47,1647
17288,17288,DEF2119ECB90D4385AD1A45A0B2C7A35,42523,13,18,5,31,47,1597
17289,17289,DEF2119ECB90D4385AD1A45A0B2C7A35,42141,19,20,1,32,47,1647
17290,17290,2E6ECF3A2D9F0F99E9DEBA2062D89A0D,10634,0,10,10,27,45,1395
17291,17291,2E6ECF3A2D9F0F99E9DEBA2062D89A0D,10351,12,22,10,28,45,1445
17292,17292,2E6ECF3A2D9F0F99E9DEBA2062D89A0D,12601,22,23,1,25,47,1297
17299,17299,E8A3A2F2678AE58B36D710FCF037760E,11231,0,1,1,37,49,1899
17300,17300,E8A3A2F2678AE58B36D710FCF037760E,10411,2,14,12,36,48,1848
17301,17301,E8A3A2F2678AE58B36D710FCF037760E,11231,20,23,3,37,49,1899
17302,17302,37E258DC4E7618201141B05799F860F1,10351,0,9,9,28,45,1445
17303,17303,37E258DC4E7618201141B05799F860F1,10634,14,15,1,27,45,1395
17304,17304,37E258DC4E7618201141B05799F860F1,10351,16,23,7,28,45,1445
17320,17320,916372516345A8080A54990615FD92CF,11481,9,11,2,41,48,2098
17321,17321,916372516345A8080A54990615FD92CF,11301,12,14,2,41,49,2099
17322,17322,916372516345A8080A54990615FD92CF,11481,17,21,4,41,48,2098
17323,17323,916372516345A8080A54990615FD92CF,13101,21,22,1,40,47,2047
17333,17333,C21989F99D3B120EE23386DE2361CA67,42231,0,9,9,37,46,1896
17334,17334,C21989F99D3B120EE23386DE2361CA67,10841,11,13,2,37,47,1897
17335,17335,C21989F99D3B120EE23386DE2361CA67,42771,14,16,2,36,47,1847
17336,17336,C21989F99D3B120EE23386DE2361CA67,42231,20,23,3,37,46,1896
17337,17337,D746519213A28242D49759FCE6B0BCB4,19441,0,7,7,8,46,446
17338,17338,D746519213A28242D49759FCE6B0BCB4,42041,8,9,1,10,47,547
17339,17339,D746519213A28242D49759FCE6B0BCB4,19441,10,22,12,8,46,446
17349,17349,0277E6ABE6E23FB8B51E9078601CBBC1,42491,0,7,7,32,46,1646
17350,17350,0277E6ABE6E23FB8B51E9078601CBBC1,42523,10,17,7,31,47,1597
17351,17351,0277E6ABE6E23FB8B51E9078601CBBC1,42491,19,23,4,32,46,1646
17352,17352,2FC852B4FFDF067DECF04814ED84AACA,42511,0,10,10,37,47,1897
17353,17353,2FC852B4FFDF067DECF04814ED84AACA,10271,11,12,1,37,46,1896
17354,17354,2FC852B4FFDF067DECF04814ED84AACA,13121,12,14,2,38,46,1946
17355,17355,2FC852B4FFDF067DECF04814ED84AACA,42511,14,19,5,37,47,1897
17356,17356,14C205DF57BD0AA586E26BE4ED695846,42581,1,8,7,38,48,1948
17357,17357,14C205DF57BD0AA586E26BE4ED695846,11914,8,11,3,37,48,1898
17358,17358,14C205DF57BD0AA586E26BE4ED695846,42581,12,23,11,38,48,1948
17359,17359,15BA009B68D87958E0A9656ADB01E7D6,10511,2,4,2,35,46,1796
17360,17360,15BA009B68D87958E0A9656ADB01E7D6,42371,4,6,2,34,46,1746
17361,17361,15BA009B68D87958E0A9656ADB01E7D6,10511,9,23,14,35,46,1796
17370,17370,FF54487E0B5C80FA4088AB1638FB8194,42581,0,8,8,38,48,1948
17371,17371,FF54487E0B5C80FA4088AB1638FB8194,11914,9,10,1,37,48,1898
17372,17372,FF54487E0B5C80FA4088AB1638FB8194,42581,12,16,4,38,48,1948
17373,17373,FF54487E0B5C80FA4088AB1638FB8194,11914,17,19,2,37,48,1898
17374,17374,71485E72C597A1C45D53854C1B340753,11074,10,11,1,37,47,1897
17375,17375,71485E72C597A1C45D53854C1B340753,13121,11,16,5,38,46,1946
17376,17376,71485E72C597A1C45D53854C1B340753,11074,18,23,5,37,47,1897
17377,17377,D96C351A2D3BF2CB9C84E8F01C9997B6,12641,3,4,1,10,43,543
17378,17378,D96C351A2D3BF2CB9C84E8F01C9997B6,12921,7,9,2,9,41,491
17379,17379,D96C351A2D3BF2CB9C84E8F01C9997B6,19021,14,17,3,10,45,545
17380,17380,D96C351A2D3BF2CB9C84E8F01C9997B6,12641,20,23,3,10,43,543
17381,17381,D75859C5199E26E4E069299921FEC112,42921,1,6,5,33,47,1697
17382,17382,D75859C5199E26E4E069299921FEC112,43761,7,9,2,32,47,1647
17383,17383,D75859C5199E26E4E069299921FEC112,42021,12,14,2,33,47,1697
17384,17384,D75859C5199E26E4E069299921FEC112,43761,14,23,9,32,47,1647
17398,17398,F89ADFE97D04FFE2BC6B5436081F1700,13711,2,6,4,38,46,1946
17399,17399,F89ADFE97D04FFE2BC6B5436081F1700,40124,8,9,1,38,47,1947
17400,17400,F89ADFE97D04FFE2BC6B5436081F1700,13711,9,17,8,38,46,1946
17401,17401,F89ADFE97D04FFE2BC6B5436081F1700,43241,18,19,1,36,46,1846
17435,17435,E27666DBA5763DDAABCA463F0844803E,11831,0,7,7,32,45,1645
17436,17436,E27666DBA5763DDAABCA463F0844803E,12311,7,10,3,30,44,1544
17437,17437,E27666DBA5763DDAABCA463F0844803E,42871,10,11,1,30,45,1545
17438,17438,E27666DBA5763DDAABCA463F0844803E,11831,12,23,11,32,45,1645
17445,17445,D9803D3FD2338A5AC0B4965C5175094E,10121,0,7,7,36,49,1849
17446,17446,D9803D3FD2338A5AC0B4965C5175094E,10841,11,12,1,37,47,1897
17447,17447,D9803D3FD2338A5AC0B4965C5175094E,12514,12,18,6,38,47,1947
17448,17448,D9803D3FD2338A5AC0B4965C5175094E,10121,20,23,3,36,49,1849
17454,17454,A8D6EA87C0BC63208FB058AFC990DEB0,42921,0,5,5,33,47,1697
17455,17455,A8D6EA87C0BC63208FB058AFC990DEB0,13601,8,9,1,34,47,1747
17456,17456,A8D6EA87C0BC63208FB058AFC990DEB0,42921,17,23,6,33,47,1697
17476,17476,29C8E1CEEB99D291B032FE41409AB789,42141,0,1,1,32,47,1647
17477,17477,29C8E1CEEB99D291B032FE41409AB789,42021,1,7,6,33,47,1697
17478,17478,29C8E1CEEB99D291B032FE41409AB789,11861,9,23,14,32,47,1647
17485,17485,964156E683797EC321E31C806CD19178,11331,2,14,12,37,48,1898
17486,17486,964156E683797EC321E31C806CD19178,42581,17,19,2,38,48,1948
17487,17487,964156E683797EC321E31C806CD19178,11914,21,23,2,37,48,1898
17493,17493,55A8EC0A18A4778C5DB6D75F6A105E30,13731,0,7,7,33,49,1699
17494,17494,55A8EC0A18A4778C5DB6D75F6A105E30,40112,10,11,1,32,48,1648
17495,17495,55A8EC0A18A4778C5DB6D75F6A105E30,13731,14,23,9,33,49,1699
17496,17496,FC0936587C74EF8144A5D7B54D78302D,19021,0,13,13,10,45,545
17497,17497,FC0936587C74EF8144A5D7B54D78302D,11571,14,18,4,13,46,696
17498,17498,FC0936587C74EF8144A5D7B54D78302D,19021,21,22,1,10,45,545
17499,17499,9959510844B7DBCF60F72B672E5449A4,11231,0,12,12,37,49,1899
17500,17500,9959510844B7DBCF60F72B672E5449A4,12391,13,16,3,36,49,1849
17501,17501,9959510844B7DBCF60F72B672E5449A4,11461,17,23,6,37,49,1899
17507,17507,29E682BF994B2ACA314777BEAEB90BB7,13911,0,9,9,39,46,1996
17508,17508,29E682BF994B2ACA314777BEAEB90BB7,42231,10,11,1,37,46,1896
17509,17509,29E682BF994B2ACA314777BEAEB90BB7,42351,15,17,2,38,45,1945
17510,17510,29E682BF994B2ACA314777BEAEB90BB7,42231,19,21,2,37,46,1896
17511,17511,893C8C9EC963E44D975714E55D96225A,12841,0,11,11,37,47,1897
17512,17512,893C8C9EC963E44D975714E55D96225A,11231,11,18,7,37,49,1899
17513,17513,893C8C9EC963E44D975714E55D96225A,12841,22,23,1,37,47,1897
17514,17514,4CA28E087D95A72AF97BE17DAF5BCBF2,12731,5,6,1,22,40,1140
17515,17515,4CA28E087D95A72AF97BE17DAF5BCBF2,13091,6,14,8,20,42,1042
17516,17516,4CA28E087D95A72AF97BE17DAF5BCBF2,12731,14,23,9,22,40,1140
17520,17520,4E22CAE8774A9F064D48507CF8FECB20,11901,0,7,7,42,49,2149
17521,17521,4E22CAE8774A9F064D48507CF8FECB20,42271,12,16,4,40,47,2047
17522,17522,4E22CAE8774A9F064D48507CF8FECB20,40302,18,20,2,40,49,2049
17523,17523,4E22CAE8774A9F064D48507CF8FECB20,11901,20,23,3,42,49,2149
17524,17524,ACB823DB33D22CC4344D979C1DDF92F4,11261,0,6,6,36,46,1846
17525,17525,ACB823DB33D22CC4344D979C1DDF92F4,42861,6,18,12,37,44,1894
17526,17526,ACB823DB33D22CC4344D979C1DDF92F4,11261,22,23,1,36,46,1846
17527,17527,F209A399D7060EB5C592C672B5567F86,12921,8,12,4,9,41,491
17528,17528,F209A399D7060EB5C592C672B5567F86,12641,14,16,2,10,43,543
17529,17529,F209A399D7060EB5C592C672B5567F86,12921,16,23,7,9,41,491
17548,17548,A4B13605C78797589D9B98BC8787EDD0,19931,0,6,6,7,43,393
17549,17549,A4B13605C78797589D9B98BC8787EDD0,12921,7,8,1,9,41,491
17550,17550,A4B13605C78797589D9B98BC8787EDD0,19931,12,23,11,7,43,393
17551,17551,A30C3A4D08AE45D5E2F0083CE1F142DF,13111,0,9,9,42,46,2146
17552,17552,A30C3A4D08AE45D5E2F0083CE1F142DF,13791,12,13,1,42,47,2147
17553,17553,A30C3A4D08AE45D5E2F0083CE1F142DF,13111,14,15,1,42,46,2146
17554,17554,A30C3A4D08AE45D5E2F0083CE1F142DF,42461,17,18,1,45,47,2297
17555,17555,041A30FB702D12495C71CA3403357BA5,10911,0,2,2,39,46,1996
17556,17556,041A30FB702D12495C71CA3403357BA5,13941,3,19,16,41,47,2097
17557,17557,041A30FB702D12495C71CA3403357BA5,11001,21,22,1,42,47,2147
17579,17579,AA51DE94270AE4663B2578A38D4EECC9,13961,0,13,13,42,48,2148
17580,17580,AA51DE94270AE4663B2578A38D4EECC9,42581,16,17,1,38,48,1948
17581,17581,AA51DE94270AE4663B2578A38D4EECC9,13961,19,23,4,42,48,2148
17582,17582,B9E927B8C825AF1AC2891B310330CB7E,42011,0,7,7,36,46,1846
17583,17583,B9E927B8C825AF1AC2891B310330CB7E,13511,9,10,1,34,48,1748
17584,17584,B9E927B8C825AF1AC2891B310330CB7E,11753,13,21,8,35,48,1798
17590,17590,7CB984CC0E6ABE59C1C741CAADBD1FA0,10431,0,13,13,33,49,1699
17591,17591,7CB984CC0E6ABE59C1C741CAADBD1FA0,11861,13,14,1,32,47,1647
17592,17592,7CB984CC0E6ABE59C1C741CAADBD1FA0,10431,17,18,1,33,49,1699
17593,17593,7CB984CC0E6ABE59C1C741CAADBD1FA0,42491,21,23,2,32,46,1646
17594,17594,895085FE0B62D7BCDF8725B5DB48E546,43971,0,6,6,30,48,1548
17595,17595,895085FE0B62D7BCDF8725B5DB48E546,11061,6,15,9,29,48,1498
17596,17596,895085FE0B62D7BCDF8725B5DB48E546,42521,16,23,7,31,47,1597
17603,17603,2D7ACF8AD7E4B49F2A7FD23DB75DC6F1,42971,0,5,5,43,49,2199
17604,17604,2D7ACF8AD7E4B49F2A7FD23DB75DC6F1,11741,6,17,11,42,49,2149
17605,17605,2D7ACF8AD7E4B49F2A7FD23DB75DC6F1,42971,19,23,4,43,49,2199
17609,17609,697EB06F67653D08CFE9378AC3AAB5E4,11001,1,14,13,42,47,2147
17610,17610,697EB06F67653D08CFE9378AC3AAB5E4,13941,14,17,3,41,47,2097
17611,17611,697EB06F67653D08CFE9378AC3AAB5E4,11001,20,22,2,42,47,2147
17616,17616,E3D1E9331AB064DD32729EADF02F9A93,42161,5,16,11,36,47,1847
17617,17617,E3D1E9331AB064DD32729EADF02F9A93,10881,16,17,1,34,48,1748
17618,17618,E3D1E9331AB064DD32729EADF02F9A93,43581,20,21,1,33,48,1698
17632,17632,8F79DEBEC2513ED357831F892A2CF021,11541,1,4,3,35,49,1799
17633,17633,8F79DEBEC2513ED357831F892A2CF021,11211,5,18,13,34,49,1749
17634,17634,8F79DEBEC2513ED357831F892A2CF021,11541,21,23,2,35,49,1799
17640,17640,0EA80F49CAFA9BFC58CF0D20F7967BFF,42871,0,13,13,30,45,1545
17641,17641,0EA80F49CAFA9BFC58CF0D20F7967BFF,12311,15,17,2,30,44,1544
17642,17642,0EA80F49CAFA9BFC58CF0D20F7967BFF,42871,21,23,2,30,45,1545
17648,17648,CCAA623A39508D04DCE98490576D39EC,11021,0,7,7,36,49,1849
17649,17649,CCAA623A39508D04DCE98490576D39EC,42961,12,14,2,35,49,1799
17650,17650,CCAA623A39508D04DCE98490576D39EC,11021,17,23,6,36,49,1849
17651,17651,ACC212F9390F71663929160BC19E9163,11781,3,9,6,38,49,1949
17652,17652,ACC212F9390F71663929160BC19E9163,13121,13,14,1,38,46,1946
17653,17653,ACC212F9390F71663929160BC19E9163,11551,15,23,8,39,49,1999
17654,17654,6A3C5AB1F21EE138396D905A47ECFBD7,11291,0,16,16,40,49,2049
17655,17655,6A3C5AB1F21EE138396D905A47ECFBD7,11791,17,19,2,38,49,1949
17656,17656,6A3C5AB1F21EE138396D905A47ECFBD7,13371,19,23,4,41,47,2097
17657,17657,6EF69708DD923556D4EF232AA0406F1C,11941,0,16,16,37,46,1896
17658,17658,6EF69708DD923556D4EF232AA0406F1C,13911,19,21,2,39,46,1996
17659,17659,6EF69708DD923556D4EF232AA0406F1C,42231,21,23,2,37,46,1896
17660,17660,ACC7AC3B8DE3474C386625E5186B4C58,42941,0,7,7,37,47,1897
17661,17661,ACC7AC3B8DE3474C386625E5186B4C58,40637,9,10,1,36,47,1847
17662,17662,ACC7AC3B8DE3474C386625E5186B4C58,42941,11,23,12,37,47,1897
17668,17668,0A61C8BC2E2F3B8A439DFBB7542FD5B0,13371,0,10,10,41,47,2097
17669,17669,0A61C8BC2E2F3B8A439DFBB7542FD5B0,11074,11,13,2,37,47,1897
17670,17670,0A61C8BC2E2F3B8A439DFBB7542FD5B0,13371,17,23,6,41,47,2097
17678,17678,700A8469B8648E235281334EF5CC8DA1,10371,0,10,10,37,49,1899
17679,17679,700A8469B8648E235281334EF5CC8DA1,10471,11,17,6,37,48,1898
17680,17680,700A8469B8648E235281334EF5CC8DA1,11231,18,19,1,37,49,1899
17681,17681,700A8469B8648E235281334EF5CC8DA1,43281,20,23,3,37,48,1898
17686,17686,D8DCFF78BA67097F4D9471927F4813FD,11361,0,5,5,22,48,1148
17687,17687,D8DCFF78BA67097F4D9471927F4813FD,12581,7,18,11,24,48,1248
17688,17688,D8DCFF78BA67097F4D9471927F4813FD,43751,21,23,2,19,48,998
17689,17689,2F3FBE39EE4E3AB748593134D6A2A772,42231,0,7,7,37,46,1896
17690,17690,2F3FBE39EE4E3AB748593134D6A2A772,42351,7,10,3,38,45,1945
17691,17691,2F3FBE39EE4E3AB748593134D6A2A772,42231,12,21,9,37,46,1896
17698,17698,ABC9186267E71F28FA785B0F903DDD72,40171,0,2,2,38,48,1948
17699,17699,ABC9186267E71F28FA785B0F903DDD72,10471,4,19,15,37,48,1898
17700,17700,ABC9186267E71F28FA785B0F903DDD72,40171,21,23,2,38,48,1948
17701,17701,3457AFD1000C37A689F1A73ADB9321A9,12521,0,9,9,35,41,1791
17702,17702,3457AFD1000C37A689F1A73ADB9321A9,43451,9,10,1,37,40,1890
17703,17703,3457AFD1000C37A689F1A73ADB9321A9,12521,10,22,12,35,41,1791
17704,17704,0CA0351BEE42A6C50E3C657DDA4ED8A9,11021,0,7,7,36,49,1849
17705,17705,0CA0351BEE42A6C50E3C657DDA4ED8A9,40101,8,11,3,34,49,1749
17706,17706,0CA0351BEE42A6C50E3C657DDA4ED8A9,11201,12,19,7,35,49,1799
17707,17707,0CA0351BEE42A6C50E3C657DDA4ED8A9,11021,21,22,1,36,49,1849
17708,17708,E9DE0465C25ACD29F5AA7BA8CFD57DED,42521,0,2,2,31,47,1597
17709,17709,E9DE0465C25ACD29F5AA7BA8CFD57DED,10295,4,9,5,30,47,1547
17710,17710,E9DE0465C25ACD29F5AA7BA8CFD57DED,42521,11,16,5,31,47,1597
17711,17711,E9DE0465C25ACD29F5AA7BA8CFD57DED,10295,17,23,6,30,47,1547
17721,17721,E9E990F48245ACFDBDC8F1C95015FE95,42511,0,8,8,37,47,1897
17722,17722,E9E990F48245ACFDBDC8F1C95015FE95,13121,8,17,9,38,46,1946
17723,17723,E9E990F48245ACFDBDC8F1C95015FE95,42511,22,23,1,37,47,1897
17737,17737,1CE5F4D10EE2FB173CB9F2BC0746661A,42531,0,16,16,31,45,1595
17738,17738,1CE5F4D10EE2FB173CB9F2BC0746661A,12311,16,19,3,30,44,1544
17739,17739,1CE5F4D10EE2FB173CB9F2BC0746661A,42531,21,22,1,31,45,1595
17743,17743,CD55B44A3FD4B718A673CC03711FD344,12921,2,5,3,9,41,491
17744,17744,CD55B44A3FD4B718A673CC03711FD344,12641,6,10,4,10,43,543
17745,17745,CD55B44A3FD4B718A673CC03711FD344,12921,10,19,9,9,41,491
17746,17746,CD55B44A3FD4B718A673CC03711FD344,12641,19,20,1,10,43,543
17747,17747,E259E36EE859D4C4C9374127A836D38A,10171,0,10,10,26,47,1347
17748,17748,E259E36EE859D4C4C9374127A836D38A,12601,12,14,2,25,47,1297
17749,17749,E259E36EE859D4C4C9374127A836D38A,10171,14,17,3,26,47,1347
17750,17750,E259E36EE859D4C4C9374127A836D38A,12601,18,19,1,25,47,1297
17751,17751,05A52A7A7C35023EA789CA712FC9D5F7,42401,0,14,14,36,47,1847
17752,17752,05A52A7A7C35023EA789CA712FC9D5F7,13331,19,20,1,38,47,1947
17753,17753,05A52A7A7C35023EA789CA712FC9D5F7,42401,22,23,1,36,47,1847
17754,17754,62DDFD12FD80957CA0268CDDC1A48DA2,11151,8,9,1,30,48,1548
17755,17755,62DDFD12FD80957CA0268CDDC1A48DA2,43391,13,14,1,29,48,1498
17756,17756,62DDFD12FD80957CA0268CDDC1A48DA2,11151,14,23,9,30,48,1548
17757,17757,D3E46B15B35DC3C198E6EE945D227259,11806,0,4,4,41,48,2098
17758,17758,D3E46B15B35DC3C198E6EE945D227259,42271,5,10,5,40,47,2047
17759,17759,D3E46B15B35DC3C198E6EE945D227259,13381,12,23,11,39,47,1997
17760,17760,394B81CC36B31D897120A6153D7C1457,11061,0,2,2,29,48,1498
17761,17761,394B81CC36B31D897120A6153D7C1457,42501,6,10,4,28,47,1447
17762,17762,394B81CC36B31D897120A6153D7C1457,12121,12,14,2,29,47,1497
17763,17763,394B81CC36B31D897120A6153D7C1457,11061,18,20,2,29,48,1498
17764,17764,3E1FC4D135BB13FEB2589C9806D420B1,12514,0,3,3,38,47,1947
17765,17765,3E1FC4D135BB13FEB2589C9806D420B1,42581,4,8,4,38,48,1948
17766,17766,3E1FC4D135BB13FEB2589C9806D420B1,11914,8,20,12,37,48,1898
17782,17782,9D5FAD2D946916458AB09D98B7F6CB85,42621,0,5,5,24,49,1249
17783,17783,9D5FAD2D946916458AB09D98B7F6CB85,11641,6,8,2,22,49,1149
17784,17784,9D5FAD2D946916458AB09D98B7F6CB85,42621,12,13,1,24,49,1249
17785,17785,9D5FAD2D946916458AB09D98B7F6CB85,11641,15,23,8,22,49,1149
17786,17786,B74B3DCD8F19C67166A66D0048B31F03,13331,1,8,7,38,47,1947
17787,17787,B74B3DCD8F19C67166A66D0048B31F03,13711,9,10,1,38,46,1946
17788,17788,B74B3DCD8F19C67166A66D0048B31F03,10841,20,21,1,37,47,1897
17789,17789,B74B3DCD8F19C67166A66D0048B31F03,13331,21,23,2,38,47,1947
17790,17790,5AC2D6E8C66247063F49530DBE7AF221,10251,0,7,7,35,47,1797
17791,17791,5AC2D6E8C66247063F49530DBE7AF221,11081,12,19,7,35,46,1796
17792,17792,5AC2D6E8C66247063F49530DBE7AF221,10251,22,23,1,35,47,1797
17793,17793,AC212CABCB9D1B61385C305C0F8B2007,11201,0,1,1,35,49,1799
17794,17794,AC212CABCB9D1B61385C305C0F8B2007,42301,3,10,7,36,47,1847
17795,17795,AC212CABCB9D1B61385C305C0F8B2007,11791,13,20,7,38,49,1949
17796,17796,AC212CABCB9D1B61385C305C0F8B2007,42301,20,23,3,36,47,1847
17797,17797,70E50AA138C0538910E5623295B506D8,42351,2,8,6,38,45,1945
17798,17798,70E50AA138C0538910E5623295B506D8,13911,12,14,2,39,46,1996
17799,17799,70E50AA138C0538910E5623295B506D8,42351,16,18,2,38,45,1945
17800,17800,70E50AA138C0538910E5623295B506D8,11261,18,19,1,36,46,1846
17801,17801,784B731FB48DA266D31BFD4ACBDB8A39,10661,0,1,1,37,49,1899
17802,17802,784B731FB48DA266D31BFD4ACBDB8A39,11021,2,14,12,36,49,1849
17803,17803,784B731FB48DA266D31BFD4ACBDB8A39,12021,14,17,3,37,49,1899
17804,17804,784B731FB48DA266D31BFD4ACBDB8A39,11021,18,23,5,36,49,1849
17811,17811,C40228FCC30706D765AACFB310DC8B74,43621,2,6,4,46,48,2348
17812,17812,C40228FCC30706D765AACFB310DC8B74,42321,9,10,1,43,47,2197
17813,17813,C40228FCC30706D765AACFB310DC8B74,43621,15,22,7,46,48,2348
17814,17814,E969EC1FA6E19F3F5A602F2FE47F2E7D,13911,1,16,15,39,46,1996
17815,17815,E969EC1FA6E19F3F5A602F2FE47F2E7D,11261,19,20,1,36,46,1846
17816,17816,E969EC1FA6E19F3F5A602F2FE47F2E7D,13911,21,22,1,39,46,1996
17817,17817,F4C7290798862F6B2ED53B8936E4B945,19021,6,7,1,10,45,545
17818,17818,F4C7290798862F6B2ED53B8936E4B945,12641,8,9,1,10,43,543
17819,17819,F4C7290798862F6B2ED53B8936E4B945,19021,10,23,13,10,45,545
17820,17820,C6DF57F9AD220FA45128DF32BD0D316B,10881,0,20,20,34,48,1748
17821,17821,C6DF57F9AD220FA45128DF32BD0D316B,40951,20,21,1,36,49,1849
17822,17822,C6DF57F9AD220FA45128DF32BD0D316B,10881,22,23,1,34,48,1748
17823,17823,2A390FA3111AB7FAB5AA7BEB153F5323,13711,2,3,1,38,46,1946
17824,17824,2A390FA3111AB7FAB5AA7BEB153F5323,10271,3,6,3,37,46,1896
17825,17825,2A390FA3111AB7FAB5AA7BEB153F5323,13711,16,18,2,38,46,1946
17826,17826,2A390FA3111AB7FAB5AA7BEB153F5323,13911,19,20,1,39,46,1996
17827,17827,FB50763582318761FD514D72ADA73CC2,11921,0,11,11,38,48,1948
17828,17828,FB50763582318761FD514D72ADA73CC2,11074,13,18,5,37,47,1897
17829,17829,FB50763582318761FD514D72ADA73CC2,10821,19,20,1,40,47,2047
17840,17840,475FEE58BFECDABC48E06181432362EF,11171,0,10,10,33,48,1698
17841,17841,475FEE58BFECDABC48E06181432362EF,10431,17,19,2,33,49,1699
17842,17842,475FEE58BFECDABC48E06181432362EF,10691,19,23,4,33,48,1698
17843,17843,7FD9072832AAE29AE2915CDEF233B942,10801,0,14,14,42,47,2147
17844,17844,7FD9072832AAE29AE2915CDEF233B942,42321,14,15,1,43,47,2197
17845,17845,7FD9072832AAE29AE2915CDEF233B942,10801,17,19,2,42,47,2147
17859,17859,DE6709015B79F307E57CED7DDDF807DA,12491,1,5,4,36,43,1843
17860,17860,DE6709015B79F307E57CED7DDDF807DA,42861,8,10,2,37,44,1894
17861,17861,DE6709015B79F307E57CED7DDDF807DA,12491,12,14,2,36,43,1843
17862,17862,DE6709015B79F307E57CED7DDDF807DA,42151,16,20,4,35,45,1795
17867,17867,662B4DE10B5E46302328673CD9C61795,10111,0,7,7,37,47,1897
17868,17868,662B4DE10B5E46302328673CD9C61795,11491,8,17,9,36,47,1847
17869,17869,662B4DE10B5E46302328673CD9C61795,40261,20,21,1,35,49,1799
17870,17870,DDF363C64B8F6ACF3450F0B1AA087EA1,19441,0,3,3,8,46,446
17871,17871,DDF363C64B8F6ACF3450F0B1AA087EA1,19621,4,7,3,5,46,296
17872,17872,DDF363C64B8F6ACF3450F0B1AA087EA1,19441,11,23,12,8,46,446
17876,17876,924C94FEA337955066B022FCC7607D38,12581,0,4,4,24,48,1248
17877,17877,924C94FEA337955066B022FCC7607D38,11361,6,8,2,22,48,1148
17878,17878,924C94FEA337955066B022FCC7607D38,12581,8,13,5,24,48,1248
17879,17879,924C94FEA337955066B022FCC7607D38,11361,13,23,10,22,48,1148
17884,17884,8671664FCEA72D44791A077CF27C82B3,12921,2,7,5,9,41,491
17885,17885,8671664FCEA72D44791A077CF27C82B3,12641,7,12,5,10,43,543
17886,17886,8671664FCEA72D44791A077CF27C82B3,12921,13,14,1,9,41,491
17887,17887,8671664FCEA72D44791A077CF27C82B3,12641,15,20,5,10,43,543
17888,17888,E940BE4D41CC0CB4C8FE35BF5D7A199F,11481,0,14,14,41,48,2098
17889,17889,E940BE4D41CC0CB4C8FE35BF5D7A199F,11551,16,17,1,39,49,1999
17890,17890,E940BE4D41CC0CB4C8FE35BF5D7A199F,13101,18,23,5,40,47,2047
17891,17891,F8FD16629819B20972FEBA21A43C5924,42021,0,13,13,33,47,1697
17892,17892,F8FD16629819B20972FEBA21A43C5924,11861,13,15,2,32,47,1647
17893,17893,F8FD16629819B20972FEBA21A43C5924,42021,20,21,1,33,47,1697
17894,17894,8E0D20320C5276BDD797BA6D65B9C51D,11074,0,7,7,37,47,1897
17895,17895,8E0D20320C5276BDD797BA6D65B9C51D,11231,8,17,9,37,49,1899
17896,17896,8E0D20320C5276BDD797BA6D65B9C51D,40491,19,21,2,39,49,1999
17897,17897,8E0D20320C5276BDD797BA6D65B9C51D,11074,21,23,2,37,47,1897
17898,17898,2A0992E271C7BA45FB386AAF3150EA6F,10611,0,1,1,32,48,1648
17899,17899,2A0992E271C7BA45FB386AAF3150EA6F,10721,1,8,7,31,48,1598
17900,17900,2A0992E271C7BA45FB386AAF3150EA6F,11861,13,15,2,32,47,1647
17901,17901,2A0992E271C7BA45FB386AAF3150EA6F,11381,15,20,5,30,47,1547
17902,17902,CCE6FF71F1C58ADC8D7C29AFD1955DDD,12601,0,7,7,25,47,1297
17903,17903,CCE6FF71F1C58ADC8D7C29AFD1955DDD,10634,12,15,3,27,45,1395
17904,17904,CCE6FF71F1C58ADC8D7C29AFD1955DDD,12601,18,23,5,25,47,1297
17905,17905,400659CE2E6F8BFF6D95D6F52F73DF5B,42021,1,5,4,33,47,1697
17906,17906,400659CE2E6F8BFF6D95D6F52F73DF5B,11861,5,19,14,32,47,1647
17907,17907,400659CE2E6F8BFF6D95D6F52F73DF5B,42921,20,23,3,33,47,1697
17922,17922,7446641F73809A823733CBB6864B4050,42861,0,6,6,37,44,1894
17923,17923,7446641F73809A823733CBB6864B4050,11261,8,17,9,36,46,1846
17924,17924,7446641F73809A823733CBB6864B4050,42861,21,23,2,37,44,1894
17925,17925,017E7601FB9C9C3C9E5F1FE87B4C9BCD,42351,0,5,5,38,45,1945
17926,17926,017E7601FB9C9C3C9E5F1FE87B4C9BCD,42231,6,17,11,37,46,1896
17927,17927,017E7601FB9C9C3C9E5F1FE87B4C9BCD,13911,21,23,2,39,46,1996
17928,17928,3F92550AE7FA536C6ED9DF3D484ADD7A,13231,0,5,5,39,46,1996
17929,17929,3F92550AE7FA536C6ED9DF3D484ADD7A,11261,6,15,9,36,46,1846
17930,17930,3F92550AE7FA536C6ED9DF3D484ADD7A,42861,16,20,4,37,44,1894
17931,17931,3F92550AE7FA536C6ED9DF3D484ADD7A,11261,21,23,2,36,46,1846
17932,17932,B9F4C9D18F82BAF4FF50860E0E28B6F2,42401,2,10,8,36,47,1847
17933,17933,B9F4C9D18F82BAF4FF50860E0E28B6F2,42981,12,18,6,36,49,1849
17934,17934,B9F4C9D18F82BAF4FF50860E0E28B6F2,42401,21,23,2,36,47,1847
17935,17935,DA48F6EEC4784B4505CA1BBB58EA121A,10341,0,7,7,31,47,1597
17936,17936,DA48F6EEC4784B4505CA1BBB58EA121A,10292,9,18,9,30,47,1547
17937,17937,DA48F6EEC4784B4505CA1BBB58EA121A,10341,19,22,3,31,47,1597
17938,17938,325B301C16FB3DB9C4CED544F7B2E787,42191,1,5,4,38,49,1949
17939,17939,325B301C16FB3DB9C4CED544F7B2E787,11271,5,12,7,37,48,1898
17940,17940,325B301C16FB3DB9C4CED544F7B2E787,42191,12,18,6,38,49,1949
17941,17941,325B301C16FB3DB9C4CED544F7B2E787,11271,19,21,2,37,48,1898
17950,17950,E234B5120D56DA23234C53D64CFEED38,11491,0,15,15,36,47,1847
17951,17951,E234B5120D56DA23234C53D64CFEED38,13121,15,18,3,38,46,1946
17952,17952,E234B5120D56DA23234C53D64CFEED38,11491,21,23,2,36,47,1847
17956,17956,261E578A9ADD5DB5F1BF8D1F93100799,11261,1,17,16,36,46,1846
17957,17957,261E578A9ADD5DB5F1BF8D1F93100799,42864,19,20,1,38,44,1944
17958,17958,261E578A9ADD5DB5F1BF8D1F93100799,11261,21,23,2,36,46,1846
17982,17982,A09953F67FED80A8C2308F84F83FE6DA,13711,0,4,4,38,46,1946
17983,17983,A09953F67FED80A8C2308F84F83FE6DA,43241,4,10,6,36,46,1846
17984,17984,A09953F67FED80A8C2308F84F83FE6DA,13711,11,23,12,38,46,1946
17985,17985,0004E9A02B9F97024FE46D8B36381EE9,12311,0,7,7,30,44,1544
17986,17986,0004E9A02B9F97024FE46D8B36381EE9,10301,12,13,1,31,45,1595
17987,17987,0004E9A02B9F97024FE46D8B36381EE9,42491,17,18,1,32,46,1646
17988,17988,AB344DE4B941A811FEF62BEEA16971A6,43471,1,7,6,31,49,1599
17989,17989,AB344DE4B941A811FEF62BEEA16971A6,42491,8,17,9,32,46,1646
17990,17990,AB344DE4B941A811FEF62BEEA16971A6,43471,21,23,2,31,49,1599
17994,17994,D27AD15B109272EBC96B3A5E9E02000F,13911,0,5,5,39,46,1996
17995,17995,D27AD15B109272EBC96B3A5E9E02000F,11261,5,10,5,36,46,1846
17996,17996,D27AD15B109272EBC96B3A5E9E02000F,13911,12,15,3,39,46,1996
17997,17997,D27AD15B109272EBC96B3A5E9E02000F,11261,16,19,3,36,46,1846
18004,18004,288D369FF27C2F58011E60F4D93BD67B,11061,0,9,9,29,48,1498
18005,18005,288D369FF27C2F58011E60F4D93BD67B,11381,11,12,1,30,47,1547
18006,18006,288D369FF27C2F58011E60F4D93BD67B,11061,13,23,10,29,48,1498
18012,18012,5C81004482023832AD545CD8F1DA1576,13911,0,17,17,39,46,1996
18013,18013,5C81004482023832AD545CD8F1DA1576,42231,18,20,2,37,46,1896
18014,18014,5C81004482023832AD545CD8F1DA1576,13911,21,23,2,39,46,1996
18022,18022,E5EB6B8EDC8E30C301B14AF46D17D359,13651,0,8,8,30,47,1547
18023,18023,E5EB6B8EDC8E30C301B14AF46D17D359,42521,19,21,2,31,47,1597
18024,18024,E5EB6B8EDC8E30C301B14AF46D17D359,13651,21,23,2,30,47,1547
18030,18030,4515D69DA9DF7C67BD58AB71BAA57E58,10471,1,11,10,37,48,1898
18031,18031,4515D69DA9DF7C67BD58AB71BAA57E58,40171,12,13,1,38,48,1948
18032,18032,4515D69DA9DF7C67BD58AB71BAA57E58,11231,15,18,3,37,49,1899
18033,18033,4515D69DA9DF7C67BD58AB71BAA57E58,11914,20,23,3,37,48,1898
18039,18039,9793A85FD5F8245DB87C881D3A802622,12661,0,5,5,32,45,1645
18040,18040,9793A85FD5F8245DB87C881D3A802622,10351,7,19,12,28,45,1445
18041,18041,9793A85FD5F8245DB87C881D3A802622,12661,21,23,2,32,45,1645
18042,18042,F360DCE1DC2200F78634A510E4686654,11201,9,16,7,35,49,1799
18043,18043,F360DCE1DC2200F78634A510E4686654,11231,16,17,1,37,49,1899
18044,18044,F360DCE1DC2200F78634A510E4686654,10841,18,23,5,37,47,1897
18045,18045,520F9ABAA156FE9FB29070D4A540240C,40673,0,6,6,36,48,1848
18046,18046,520F9ABAA156FE9FB29070D4A540240C,10111,6,18,12,37,47,1897
18047,18047,520F9ABAA156FE9FB29070D4A540240C,10107,19,21,2,38,49,1949
18048,18048,520F9ABAA156FE9FB29070D4A540240C,40673,22,23,1,36,48,1848
18049,18049,24CACD73BA8D75767DDD668E5EA165E2,40171,0,6,6,38,48,1948
18050,18050,24CACD73BA8D75767DDD668E5EA165E2,11914,7,11,4,37,48,1898
18051,18051,24CACD73BA8D75767DDD668E5EA165E2,42191,12,13,1,38,49,1949
18052,18052,24CACD73BA8D75767DDD668E5EA165E2,11914,14,22,8,37,48,1898
18053,18053,582FCEF67ED9C80E5B2E8667690F61FB,42221,0,6,6,38,48,1948
18054,18054,582FCEF67ED9C80E5B2E8667690F61FB,42401,7,12,5,36,47,1847
18055,18055,582FCEF67ED9C80E5B2E8667690F61FB,42221,12,16,4,38,48,1948
18056,18056,582FCEF67ED9C80E5B2E8667690F61FB,42401,17,22,5,36,47,1847
18068,18068,B3D3247264CC59DE8B1DE47660D9C8A8,43761,4,5,1,32,47,1647
18069,18069,B3D3247264CC59DE8B1DE47660D9C8A8,42523,7,8,1,31,47,1597
18070,18070,B3D3247264CC59DE8B1DE47660D9C8A8,43761,12,22,10,32,47,1647
18079,18079,6ACC9074DFDB9D8D0BCD53913B584369,42201,1,9,8,43,46,2196
18080,18080,6ACC9074DFDB9D8D0BCD53913B584369,13341,10,12,2,44,45,2245
18081,18081,6ACC9074DFDB9D8D0BCD53913B584369,42201,15,21,6,43,46,2196
18082,18082,6ACC9074DFDB9D8D0BCD53913B584369,13341,21,23,2,44,45,2245
18083,18083,A86A2549CD02B65958808F3EC9B7BFBD,13911,1,5,4,39,46,1996
18084,18084,A86A2549CD02B65958808F3EC9B7BFBD,11261,8,11,3,36,46,1846
18085,18085,A86A2549CD02B65958808F3EC9B7BFBD,13911,12,13,1,39,46,1996
18086,18086,A86A2549CD02B65958808F3EC9B7BFBD,11261,15,21,6,36,46,1846
18087,18087,2B9665471DCE8731A1ECCE589E803B48,42071,9,10,1,31,49,1599
18088,18088,2B9665471DCE8731A1ECCE589E803B48,43311,12,13,1,31,48,1598
18089,18089,2B9665471DCE8731A1ECCE589E803B48,42071,15,19,4,31,49,1599
18090,18090,4DF3C091EB814BBFB3CE5DF6F2B4BD49,12641,0,12,12,10,43,543
18091,18091,4DF3C091EB814BBFB3CE5DF6F2B4BD49,19114,17,18,1,7,43,393
18092,18092,4DF3C091EB814BBFB3CE5DF6F2B4BD49,12641,20,21,1,10,43,543
18093,18093,4DF3C091EB814BBFB3CE5DF6F2B4BD49,19114,22,23,1,7,43,393
18115,18115,708A4F12BEA1831D76DB6ADD88020A06,13221,0,9,9,40,47,2047
18116,18116,708A4F12BEA1831D76DB6ADD88020A06,12511,10,11,1,39,47,1997
18117,18117,708A4F12BEA1831D76DB6ADD88020A06,12514,13,14,1,38,47,1947
18118,18118,708A4F12BEA1831D76DB6ADD88020A06,13221,17,23,6,40,47,2047
18119,18119,D9FB9F3F4820A4EF951566780A770C45,11261,5,10,5,36,46,1846
18120,18120,D9FB9F3F4820A4EF951566780A770C45,13911,13,16,3,39,46,1996
18121,18121,D9FB9F3F4820A4EF951566780A770C45,11261,16,19,3,36,46,1846
18173,18173,B7832DB383CB1E7DD6C87A81AAE89D66,42221,2,9,7,38,48,1948
18174,18174,B7832DB383CB1E7DD6C87A81AAE89D66,11074,10,11,1,37,47,1897
18175,18175,B7832DB383CB1E7DD6C87A81AAE89D66,42221,16,22,6,38,48,1948
18176,18176,387C2BFABED9CD0C7C45EBAD5F5242F9,10251,0,4,4,35,47,1797
18177,18177,387C2BFABED9CD0C7C45EBAD5F5242F9,42161,5,15,10,36,47,1847
18178,18178,387C2BFABED9CD0C7C45EBAD5F5242F9,43731,19,20,1,34,47,1747
18179,18179,EBE74CAA370851CCC599E73574A1082B,42221,1,3,2,38,48,1948
18180,18180,EBE74CAA370851CCC599E73574A1082B,11074,4,9,5,37,47,1897
18181,18181,EBE74CAA370851CCC599E73574A1082B,42221,10,11,1,38,48,1948
18182,18182,EBE74CAA370851CCC599E73574A1082B,11074,12,23,11,37,47,1897
18183,18183,442785976ECE3A21AB2E12E8FCC04E3B,42491,0,4,4,32,46,1646
18184,18184,442785976ECE3A21AB2E12E8FCC04E3B,42523,5,13,8,31,47,1597
18185,18185,442785976ECE3A21AB2E12E8FCC04E3B,42491,16,18,2,32,46,1646
18186,18186,442785976ECE3A21AB2E12E8FCC04E3B,42523,20,21,1,31,47,1597
18187,18187,0C3EDD26A7ED891A1146E2AB7A623C19,10151,0,9,9,34,47,1747
18188,18188,0C3EDD26A7ED891A1146E2AB7A623C19,10971,12,17,5,35,47,1797
18189,18189,0C3EDD26A7ED891A1146E2AB7A623C19,10151,18,23,5,34,47,1747
18213,18213,EF12ABD5368F4BA03A1D1D8F7D0239AB,10681,1,2,1,30,48,1548
18214,18214,EF12ABD5368F4BA03A1D1D8F7D0239AB,11061,3,11,8,29,48,1498
18215,18215,EF12ABD5368F4BA03A1D1D8F7D0239AB,11151,13,14,1,30,48,1548
18216,18216,EF12ABD5368F4BA03A1D1D8F7D0239AB,11061,14,23,9,29,48,1498
18222,18222,3B1D37FA24D284D734B133FDBE5EFF2B,11641,0,9,9,22,49,1149
18223,18223,3B1D37FA24D284D734B133FDBE5EFF2B,40341,10,14,4,23,49,1199
18224,18224,3B1D37FA24D284D734B133FDBE5EFF2B,11641,15,23,8,22,49,1149
18225,18225,C3C3C38B385ADAF8774873D6729826EC,10681,3,4,1,30,48,1548
18226,18226,C3C3C38B385ADAF8774873D6729826EC,10951,5,7,2,29,48,1498
18227,18227,C3C3C38B385ADAF8774873D6729826EC,10381,8,23,15,31,49,1599
18235,18235,E24F34B965BE1054DCE4AF1C1CD48137,11861,0,14,14,32,47,1647
18236,18236,E24F34B965BE1054DCE4AF1C1CD48137,11875,16,19,3,30,46,1546
18237,18237,E24F34B965BE1054DCE4AF1C1CD48137,11861,19,23,4,32,47,1647
18238,18238,C64854E86A3681C3669A53990E16514C,10111,0,6,6,37,47,1897
18239,18239,C64854E86A3681C3669A53990E16514C,42161,7,11,4,36,47,1847
18240,18240,C64854E86A3681C3669A53990E16514C,10111,11,22,11,37,47,1897
18241,18241,51B36D67A1ACB097C61E398C8B8124AC,11861,2,8,6,32,47,1647
18242,18242,51B36D67A1ACB097C61E398C8B8124AC,42523,12,13,1,31,47,1597
18243,18243,51B36D67A1ACB097C61E398C8B8124AC,11861,17,23,6,32,47,1647
18261,18261,1B16AD0182878B49E352925C1FB99700,12514,0,13,13,38,47,1947
18262,18262,1B16AD0182878B49E352925C1FB99700,10591,13,16,3,39,48,1998
18263,18263,1B16AD0182878B49E352925C1FB99700,12514,18,22,4,38,47,1947
18264,18264,558A6887C0D5899B43E75BBD844A7C64,42461,0,7,7,45,47,2297
18265,18265,558A6887C0D5899B43E75BBD844A7C64,11701,10,12,2,43,48,2198
18266,18266,558A6887C0D5899B43E75BBD844A7C64,42461,14,23,9,45,47,2297
18283,18283,265C224D92E7E6C53279B97D4CCB34D3,11061,0,8,8,29,48,1498
18284,18284,265C224D92E7E6C53279B97D4CCB34D3,42523,13,14,1,31,47,1597
18285,18285,265C224D92E7E6C53279B97D4CCB34D3,11061,17,20,3,29,48,1498
18291,18291,0E4B3B25FE0CAB1DCA768980553C13E7,42791,0,7,7,35,45,1795
18292,18292,0E4B3B25FE0CAB1DCA768980553C13E7,12661,12,14,2,32,45,1645
18293,18293,0E4B3B25FE0CAB1DCA768980553C13E7,42151,18,19,1,35,45,1795
18294,18294,0E4B3B25FE0CAB1DCA768980553C13E7,12661,19,21,2,32,45,1645
18295,18295,3EA1DA94379F7679CA011B08D7D44EE7,42231,9,12,3,37,46,1896
18296,18296,3EA1DA94379F7679CA011B08D7D44EE7,42351,14,19,5,38,45,1945
18297,18297,3EA1DA94379F7679CA011B08D7D44EE7,13911,19,23,4,39,46,1996
18298,18298,9552ADEB6DCDC64B46CF1570AC45DA60,13411,0,6,6,49,42,2492
18299,18299,9552ADEB6DCDC64B46CF1570AC45DA60,43951,8,18,10,49,41,2491
18300,18300,9552ADEB6DCDC64B46CF1570AC45DA60,13411,18,20,2,49,42,2492
18301,18301,3F29D0D409D1B6D4E7D2087740FD0BBC,42161,0,13,13,36,47,1847
18302,18302,3F29D0D409D1B6D4E7D2087740FD0BBC,10251,13,21,8,35,47,1797
18303,18303,3F29D0D409D1B6D4E7D2087740FD0BBC,42161,21,23,2,36,47,1847
18314,18314,4D612171EFC0CC62760B288E2C2A7B43,42941,1,5,4,37,47,1897
18315,18315,4D612171EFC0CC62760B288E2C2A7B43,42301,8,19,11,36,47,1847
18316,18316,4D612171EFC0CC62760B288E2C2A7B43,10841,20,22,2,37,47,1897
18317,18317,878056C296B20CAD11EA9623EF308C26,11074,1,7,6,37,47,1897
18318,18318,878056C296B20CAD11EA9623EF308C26,13561,8,11,3,37,49,1899
18319,18319,878056C296B20CAD11EA9623EF308C26,11074,11,23,12,37,47,1897
18320,18320,5EB37BA64FF627FB0C27FB0C1FE91F5D,11731,8,10,2,36,48,1848
18321,18321,5EB37BA64FF627FB0C27FB0C1FE91F5D,42021,11,12,1,33,47,1697
18322,18322,5EB37BA64FF627FB0C27FB0C1FE91F5D,40637,13,18,5,36,47,1847
18323,18323,5EB37BA64FF627FB0C27FB0C1FE91F5D,11551,21,23,2,39,49,1999
18324,18324,F49EE04071D0B4FCCD4263F4C2BBEA7A,11061,0,16,16,29,48,1498
18325,18325,F49EE04071D0B4FCCD4263F4C2BBEA7A,43761,17,18,1,32,47,1647
18326,18326,F49EE04071D0B4FCCD4263F4C2BBEA7A,11061,21,23,2,29,48,1498
18327,18327,A1BDF95E9D3FC1D1F9602700F7A63FC0,42461,0,13,13,45,47,2297
18328,18328,A1BDF95E9D3FC1D1F9602700F7A63FC0,42321,13,15,2,43,47,2197
18329,18329,A1BDF95E9D3FC1D1F9602700F7A63FC0,42461,18,23,5,45,47,2297
18330,18330,83DF2DC67F792D97F66715470F9922B2,43761,0,5,5,32,47,1647
18331,18331,83DF2DC67F792D97F66715470F9922B2,42521,7,10,3,31,47,1597
18332,18332,83DF2DC67F792D97F66715470F9922B2,43761,12,13,1,32,47,1647
18333,18333,83DF2DC67F792D97F66715470F9922B2,42521,14,23,9,31,47,1597
18345,18345,47E88EEB0ACD8A050A018340BD482B6B,11074,0,16,16,37,47,1897
18346,18346,47E88EEB0ACD8A050A018340BD482B6B,11921,16,20,4,38,48,1948
18347,18347,47E88EEB0ACD8A050A018340BD482B6B,11074,22,23,1,37,47,1897
18361,18361,0F3B9D51ABEBD568D2353EE492F4DCAE,40171,0,7,7,38,48,1948
18362,18362,0F3B9D51ABEBD568D2353EE492F4DCAE,10421,7,11,4,41,48,2098
18363,18363,0F3B9D51ABEBD568D2353EE492F4DCAE,42581,13,18,5,38,48,1948
18364,18364,0F3B9D51ABEBD568D2353EE492F4DCAE,10471,21,22,1,37,48,1898
18380,18380,C4756871D2BA9B211E8D9E7A9316C910,11231,2,10,8,37,49,1899
18381,18381,C4756871D2BA9B211E8D9E7A9316C910,10121,10,12,2,36,49,1849
18382,18382,C4756871D2BA9B211E8D9E7A9316C910,11231,12,19,7,37,49,1899
18383,18383,C4756871D2BA9B211E8D9E7A9316C910,10121,22,23,1,36,49,1849
18384,18384,29B536EE93C2E266619D50C15F53EE29,42531,0,15,15,31,45,1595
18385,18385,29B536EE93C2E266619D50C15F53EE29,12311,15,17,2,30,44,1544
18386,18386,29B536EE93C2E266619D50C15F53EE29,42531,17,23,6,31,45,1595
18402,18402,2CC13EA906DAB3CB7AF83A3C71EAF8F6,10292,0,9,9,30,47,1547
18403,18403,2CC13EA906DAB3CB7AF83A3C71EAF8F6,42521,10,21,11,31,47,1597
18404,18404,2CC13EA906DAB3CB7AF83A3C71EAF8F6,10292,22,23,1,30,47,1547
18426,18426,A1B1493AD1E4959D25E397CB780FB65E,42531,2,13,11,31,45,1595
18427,18427,A1B1493AD1E4959D25E397CB780FB65E,12311,14,15,1,30,44,1544
18428,18428,A1B1493AD1E4959D25E397CB780FB65E,10301,15,21,6,31,45,1595
18479,18479,1F2EEABE111E8F6AD1CE439041F72B5B,13911,2,8,6,39,46,1996
18480,18480,1F2EEABE111E8F6AD1CE439041F72B5B,42231,8,10,2,37,46,1896
18481,18481,1F2EEABE111E8F6AD1CE439041F72B5B,13911,11,20,9,39,46,1996
18482,18482,C83A24549690919D158BD0CE80AE31F4,11261,9,15,6,36,46,1846
18483,18483,C83A24549690919D158BD0CE80AE31F4,42864,17,18,1,38,44,1944
18484,18484,C83A24549690919D158BD0CE80AE31F4,11261,20,22,2,36,46,1846
18488,18488,14221EE63F6EE55805EE5B3069F379DA,42581,0,6,6,38,48,1948
18489,18489,14221EE63F6EE55805EE5B3069F379DA,11914,9,11,2,37,48,1898
18490,18490,14221EE63F6EE55805EE5B3069F379DA,42581,12,19,7,38,48,1948
18491,18491,14221EE63F6EE55805EE5B3069F379DA,11914,19,21,2,37,48,1898
18492,18492,CF7DA1891D00F069E0E0214450037183,11381,0,6,6,30,47,1547
18493,18493,CF7DA1891D00F069E0E0214450037183,11061,10,16,6,29,48,1498
18494,18494,CF7DA1891D00F069E0E0214450037183,11381,17,23,6,30,47,1547
18512,18512,FD8C757A10FC8342CB9359B3B019D044,10901,0,8,8,35,48,1798
18513,18513,FD8C757A10FC8342CB9359B3B019D044,11231,8,18,10,37,49,1899
18514,18514,FD8C757A10FC8342CB9359B3B019D044,10901,21,23,2,35,48,1798
18515,18515,01308B72F71E3AACC045F922DA6CAE4D,42523,0,3,3,31,47,1597
18516,18516,01308B72F71E3AACC045F922DA6CAE4D,43761,6,14,8,32,47,1647
18517,18517,01308B72F71E3AACC045F922DA6CAE4D,42523,15,16,1,31,47,1597
18518,18518,01308B72F71E3AACC045F922DA6CAE4D,43761,17,21,4,32,47,1647
18519,18519,462680341AF9CFA8A0AEFA8A8882CAA2,40833,2,7,5,41,47,2097
18520,18520,462680341AF9CFA8A0AEFA8A8882CAA2,11481,8,11,3,41,48,2098
18521,18521,462680341AF9CFA8A0AEFA8A8882CAA2,13941,14,15,1,41,47,2097
18522,18522,462680341AF9CFA8A0AEFA8A8882CAA2,11481,16,18,2,41,48,2098
18527,18527,1B1AA14FCBEAAD141CA6FAC7B338917E,42861,0,2,2,37,44,1894
18528,18528,1B1AA14FCBEAAD141CA6FAC7B338917E,11261,4,13,9,36,46,1846
18529,18529,1B1AA14FCBEAAD141CA6FAC7B338917E,42861,15,18,3,37,44,1894
18530,18530,1B1AA14FCBEAAD141CA6FAC7B338917E,11261,19,21,2,36,46,1846
18531,18531,2D914C2EB253165A5763D18FAE5FB6D2,42461,6,9,3,45,47,2297
18532,18532,2D914C2EB253165A5763D18FAE5FB6D2,43061,9,14,5,43,46,2196
18533,18533,2D914C2EB253165A5763D18FAE5FB6D2,42461,20,22,2,45,47,2297
18534,18534,2D914C2EB253165A5763D18FAE5FB6D2,43061,22,23,1,43,46,2196
18535,18535,CEAC6C818D7651ADBA37DD2B6097C732,42231,1,6,5,37,46,1896
18536,18536,CEAC6C818D7651ADBA37DD2B6097C732,13911,8,9,1,39,46,1996
18537,18537,CEAC6C818D7651ADBA37DD2B6097C732,42351,10,12,2,38,45,1945
18538,18538,CEAC6C818D7651ADBA37DD2B6097C732,42231,12,23,11,37,46,1896
18594,18594,E09A2EB70E1320F8C58EBB2C4083C66B,13371,0,4,4,41,47,2097
18595,18595,E09A2EB70E1320F8C58EBB2C4083C66B,13221,4,9,5,40,47,2047
18596,18596,E09A2EB70E1320F8C58EBB2C4083C66B,13941,11,13,2,41,47,2097
18597,18597,E09A2EB70E1320F8C58EBB2C4083C66B,13221,15,21,6,40,47,2047
18608,18608,6E9349B8A3D65DDCD99336144FE8839B,13371,0,7,7,41,47,2097
18609,18609,6E9349B8A3D65DDCD99336144FE8839B,11074,7,15,8,37,47,1897
18610,18610,6E9349B8A3D65DDCD99336144FE8839B,12511,16,17,1,39,47,1997
18611,18611,6E9349B8A3D65DDCD99336144FE8839B,13371,20,22,2,41,47,2097
18624,18624,F0E73403448DB83F822D52BA48555EF6,42351,0,2,2,38,45,1945
18625,18625,F0E73403448DB83F822D52BA48555EF6,13231,7,10,3,39,46,1996
18626,18626,F0E73403448DB83F822D52BA48555EF6,42231,13,23,10,37,46,1896
18630,18630,A82EF90EFC2E4C8E36D65CBF0ADF5C03,13341,0,7,7,44,45,2245
18631,18631,A82EF90EFC2E4C8E36D65CBF0ADF5C03,43061,7,9,2,43,46,2196
18632,18632,A82EF90EFC2E4C8E36D65CBF0ADF5C03,13341,11,22,11,44,45,2245
18637,18637,DBE9B20C58C08C2F0466AF924A872358,42523,8,10,2,31,47,1597
18638,18638,DBE9B20C58C08C2F0466AF924A872358,12131,10,11,1,32,47,1647
18639,18639,DBE9B20C58C08C2F0466AF924A872358,42523,11,19,8,31,47,1597
18640,18640,36A5DA74A38B0FD57799D67573348D49,13741,0,9,9,37,49,1899
18641,18641,36A5DA74A38B0FD57799D67573348D49,10411,10,11,1,36,48,1848
18642,18642,36A5DA74A38B0FD57799D67573348D49,10841,14,16,2,37,47,1897
18643,18643,36A5DA74A38B0FD57799D67573348D49,40123,18,23,5,38,47,1947
18644,18644,3E470010F25AA8473B85A9651953143C,11381,0,9,9,30,47,1547
18645,18645,3E470010F25AA8473B85A9651953143C,43311,10,14,4,31,48,1598
18646,18646,3E470010F25AA8473B85A9651953143C,11381,18,23,5,30,47,1547
18672,18672,E9F5D0C2382D0D17DF61B7A5284E6ABD,12641,0,1,1,10,43,543
18673,18673,E9F5D0C2382D0D17DF61B7A5284E6ABD,19904,2,3,1,9,44,494
18674,18674,E9F5D0C2382D0D17DF61B7A5284E6ABD,19931,8,9,1,7,43,393
18675,18675,E9F5D0C2382D0D17DF61B7A5284E6ABD,12641,11,23,12,10,43,543
18692,18692,669B791A7C200EC505502C4F2F67D21D,10151,2,8,6,34,47,1747
18693,18693,669B791A7C200EC505502C4F2F67D21D,10971,10,17,7,35,47,1797
18694,18694,669B791A7C200EC505502C4F2F67D21D,43731,18,19,1,34,47,1747
18695,18695,669B791A7C200EC505502C4F2F67D21D,10971,20,23,3,35,47,1797
18696,18696,7B5C1B1A4A07A5F7DC9574BA27D188D8,40872,0,8,8,30,49,1549
18697,18697,7B5C1B1A4A07A5F7DC9574BA27D188D8,11061,8,14,6,29,48,1498
18698,18698,7B5C1B1A4A07A5F7DC9574BA27D188D8,43471,15,16,1,31,49,1599
18699,18699,7B5C1B1A4A07A5F7DC9574BA27D188D8,40872,16,23,7,30,49,1549
18700,18700,B0FBA72251F80516E1A92D1893B7FB04,11061,0,7,7,29,48,1498
18701,18701,B0FBA72251F80516E1A92D1893B7FB04,10681,11,12,1,30,48,1548
18702,18702,B0FBA72251F80516E1A92D1893B7FB04,11061,14,23,9,29,48,1498
18720,18720,C2938F6FA2A943D6DFC754D5D6C219D6,42221,3,10,7,38,48,1948
18721,18721,C2938F6FA2A943D6DFC754D5D6C219D6,12514,12,18,6,38,47,1947
18722,18722,C2938F6FA2A943D6DFC754D5D6C219D6,42221,20,21,1,38,48,1948
18727,18727,F0A1BB763F378032A1CC33E7783B3D13,10121,1,3,2,36,49,1849
18728,18728,F0A1BB763F378032A1CC33E7783B3D13,10661,4,5,1,37,49,1899
18729,18729,F0A1BB763F378032A1CC33E7783B3D13,11021,8,21,13,36,49,1849
18734,18734,38D78BE4254A482C8C7B0132A8666EFC,10451,0,8,8,25,48,1298
18735,18735,38D78BE4254A482C8C7B0132A8666EFC,11061,12,14,2,29,48,1498
18736,18736,38D78BE4254A482C8C7B0132A8666EFC,10451,15,23,8,25,48,1298
18750,18750,EB7EB6074C1F2A07A41462E31EDA6629,42161,0,9,9,36,47,1847
18751,18751,EB7EB6074C1F2A07A41462E31EDA6629,10251,12,15,3,35,47,1797
18752,18752,EB7EB6074C1F2A07A41462E31EDA6629,42161,16,23,7,36,47,1847
18759,18759,7A6C1F91C08B692A643E0B4791AE2CE6,12521,0,9,9,35,41,1791
18760,18760,7A6C1F91C08B692A643E0B4791AE2CE6,43451,9,10,1,37,40,1890
18761,18761,7A6C1F91C08B692A643E0B4791AE2CE6,12521,13,23,10,35,41,1791
18772,18772,FB473FBE3EAFD3A14A7452241F377171,12641,5,9,4,10,43,543
18773,18773,FB473FBE3EAFD3A14A7452241F377171,19901,9,14,5,7,44,394
18774,18774,FB473FBE3EAFD3A14A7452241F377171,12641,18,19,1,10,43,543
18775,18775,16BAD33B20C7648C9A02C79BE6BC76F5,11331,0,10,10,37,48,1898
18776,18776,16BAD33B20C7648C9A02C79BE6BC76F5,11231,11,18,7,37,49,1899
18777,18777,16BAD33B20C7648C9A02C79BE6BC76F5,12841,22,23,1,37,47,1897
18778,18778,7CB0961C94983A29B61F525E3C087476,13651,0,7,7,30,47,1547
18779,18779,7CB0961C94983A29B61F525E3C087476,10716,12,13,1,30,46,1546
18780,18780,7CB0961C94983A29B61F525E3C087476,42523,14,19,5,31,47,1597
18781,18781,7CB0961C94983A29B61F525E3C087476,13651,19,21,2,30,47,1547
18795,18795,5E3DAD543888AED453CFEE13BBCB613D,42351,1,18,17,38,45,1945
18796,18796,5E3DAD543888AED453CFEE13BBCB613D,13911,20,21,1,39,46,1996
18797,18797,5E3DAD543888AED453CFEE13BBCB613D,42351,22,23,1,38,45,1945
18798,18798,F9709077B789E6394963CB5FEFC850BC,11211,1,10,9,34,49,1749
18799,18799,F9709077B789E6394963CB5FEFC850BC,11541,10,12,2,35,49,1799
18800,18800,F9709077B789E6394963CB5FEFC850BC,13561,13,16,3,37,49,1899
18801,18801,F9709077B789E6394963CB5FEFC850BC,11541,18,19,1,35,49,1799
18806,18806,994BA369046D8B99F80604E02227FCEB,11921,10,11,1,38,48,1948
18807,18807,994BA369046D8B99F80604E02227FCEB,11914,13,16,3,37,48,1898
18808,18808,994BA369046D8B99F80604E02227FCEB,42581,17,23,6,38,48,1948
18809,18809,3A0717F80AEB3C262F1A2AE57406414A,10841,0,8,8,37,47,1897
18810,18810,3A0717F80AEB3C262F1A2AE57406414A,42301,12,17,5,36,47,1847
18811,18811,3A0717F80AEB3C262F1A2AE57406414A,11074,17,23,6,37,47,1897
18812,18812,82F2B503E5C7E7DD72E2EFA0AEE5FAC9,10281,0,13,13,33,48,1698
18813,18813,82F2B503E5C7E7DD72E2EFA0AEE5FAC9,11861,14,17,3,32,47,1647
18814,18814,82F2B503E5C7E7DD72E2EFA0AEE5FAC9,10281,17,22,5,33,48,1698
18815,18815,895659D9FA28504F9B770B1F5FD056BF,42351,0,5,5,38,45,1945
18816,18816,895659D9FA28504F9B770B1F5FD056BF,13911,6,16,10,39,46,1996
18817,18817,895659D9FA28504F9B770B1F5FD056BF,11261,16,18,2,36,46,1846
18818,18818,895659D9FA28504F9B770B1F5FD056BF,42351,19,20,1,38,45,1945
18819,18819,1BE4AA4992469C65F84E3B75B4A845BE,11381,0,3,3,30,47,1547
18820,18820,1BE4AA4992469C65F84E3B75B4A845BE,12121,3,5,2,29,47,1497
18821,18821,1BE4AA4992469C65F84E3B75B4A845BE,11381,7,20,13,30,47,1547
18822,18822,1EFF3BEB5ED2D9539260B857859353BB,13221,0,10,10,40,47,2047
18823,18823,1EFF3BEB5ED2D9539260B857859353BB,11001,14,16,2,42,47,2147
18824,18824,1EFF3BEB5ED2D9539260B857859353BB,13221,17,23,6,40,47,2047
18833,18833,D511994F01F94DCFC72D9B68CBD83EAB,13601,0,16,16,34,47,1747
18834,18834,D511994F01F94DCFC72D9B68CBD83EAB,10251,17,20,3,35,47,1797
18835,18835,D511994F01F94DCFC72D9B68CBD83EAB,13601,20,23,3,34,47,1747
18845,18845,2ADCF428548E73CC98C7E324C7C8C16C,42491,0,11,11,32,46,1646
18846,18846,2ADCF428548E73CC98C7E324C7C8C16C,42523,12,15,3,31,47,1597
18847,18847,2ADCF428548E73CC98C7E324C7C8C16C,42491,17,23,6,32,46,1646
18848,18848,9DC91D232D50433A658EA6D7AAF8AD23,11324,0,3,3,31,46,1596
18849,18849,9DC91D232D50433A658EA6D7AAF8AD23,42491,3,10,7,32,46,1646
18850,18850,9DC91D232D50433A658EA6D7AAF8AD23,11324,12,21,9,31,46,1596
18851,18851,783830684F507956AA5F3D7BB08AF322,10601,0,8,8,39,47,1997
18852,18852,783830684F507956AA5F3D7BB08AF322,10191,9,17,8,40,48,2048
18853,18853,783830684F507956AA5F3D7BB08AF322,13941,22,23,1,41,47,2097
18854,18854,1F49E26C341B3738FA1E54F232E557D3,11074,0,14,14,37,47,1897
18855,18855,1F49E26C341B3738FA1E54F232E557D3,11751,16,18,2,35,48,1798
18856,18856,1F49E26C341B3738FA1E54F232E557D3,10411,18,20,2,36,48,1848
18857,18857,1F49E26C341B3738FA1E54F232E557D3,10841,20,23,3,37,47,1897
18858,18858,3F458F6ABA1F2A91C8D3DACF4A48895B,11381,0,7,7,30,47,1547
18859,18859,3F458F6ABA1F2A91C8D3DACF4A48895B,11061,7,10,3,29,48,1498
18860,18860,3F458F6ABA1F2A91C8D3DACF4A48895B,11381,15,17,2,30,47,1547
18861,18861,3F458F6ABA1F2A91C8D3DACF4A48895B,11061,17,18,1,29,48,1498
18872,18872,2FCEA8AFEE1EB24BBCF386268B1232AC,11061,6,8,2,29,48,1498
18873,18873,2FCEA8AFEE1EB24BBCF386268B1232AC,11161,9,10,1,32,48,1648
18874,18874,2FCEA8AFEE1EB24BBCF386268B1232AC,11061,12,18,6,29,48,1498
18875,18875,2FCEA8AFEE1EB24BBCF386268B1232AC,43311,20,23,3,31,48,1598
18876,18876,79F70A1AE08CEE215DA71360DE1B25EA,42191,0,5,5,38,49,1949
18877,18877,79F70A1AE08CEE215DA71360DE1B25EA,42231,6,19,13,37,46,1896
18878,18878,79F70A1AE08CEE215DA71360DE1B25EA,42191,20,23,3,38,49,1949
18884,18884,B289C6428E0D98B8D720F0FA5499A67A,15271,6,8,2,14,20,720
18885,18885,B289C6428E0D98B8D720F0FA5499A67A,15371,10,11,1,15,22,772
18886,18886,B289C6428E0D98B8D720F0FA5499A67A,15271,11,20,9,14,20,720
18892,18892,50673603A4E10F5F55E83AA75E1A8A25,10691,0,7,7,33,48,1698
18893,18893,50673603A4E10F5F55E83AA75E1A8A25,11021,8,17,9,36,49,1849
18894,18894,50673603A4E10F5F55E83AA75E1A8A25,10691,18,23,5,33,48,1698
18913,18913,1DD07CF7FD5B3CCCB4E85025836774E4,12841,0,7,7,37,47,1897
18914,18914,1DD07CF7FD5B3CCCB4E85025836774E4,11231,7,17,10,37,49,1899
18915,18915,1DD07CF7FD5B3CCCB4E85025836774E4,12841,21,23,2,37,47,1897
18916,18916,CACCA958326BD145289AA6A855FE199B,43971,0,17,17,30,48,1548
18917,18917,CACCA958326BD145289AA6A855FE199B,11061,18,21,3,29,48,1498
18918,18918,CACCA958326BD145289AA6A855FE199B,43971,22,23,1,30,48,1548
18919,18919,1C18101ADA4B02F048DFDA93997493B8,42491,0,14,14,32,46,1646
18920,18920,1C18101ADA4B02F048DFDA93997493B8,42523,15,17,2,31,47,1597
18921,18921,1C18101ADA4B02F048DFDA93997493B8,42491,21,22,1,32,46,1646
18936,18936,333863A2CE0A7D471D7CF76BFFDAB0D7,12641,1,16,15,10,43,543
18937,18937,333863A2CE0A7D471D7CF76BFFDAB0D7,19931,18,20,2,7,43,393
18938,18938,333863A2CE0A7D471D7CF76BFFDAB0D7,12641,21,23,2,10,43,543
18943,18943,6AB42127ACC3D218941F4B32618CB82A,11781,0,8,8,38,49,1949
18944,18944,6AB42127ACC3D218941F4B32618CB82A,43234,9,18,9,37,49,1899
18945,18945,6AB42127ACC3D218941F4B32618CB82A,11781,22,23,1,38,49,1949
18946,18946,8E1DB9D4ECEC1F108A151A8D21BA1A04,42231,0,4,4,37,46,1896
18947,18947,8E1DB9D4ECEC1F108A151A8D21BA1A04,13911,5,6,1,39,46,1996
18948,18948,8E1DB9D4ECEC1F108A151A8D21BA1A04,42231,10,23,13,37,46,1896
18959,18959,BC415555D98D18CBF281B54A45414433,19021,10,13,3,10,45,545
18960,18960,BC415555D98D18CBF281B54A45414433,11571,13,14,1,13,46,696
18961,18961,BC415555D98D18CBF281B54A45414433,19021,16,18,2,10,45,545
18965,18965,BDA2CBDA960A369194390D221502EFE8,12511,2,10,8,39,47,1997
18966,18966,BDA2CBDA960A369194390D221502EFE8,11806,11,13,2,41,48,2098
18967,18967,BDA2CBDA960A369194390D221502EFE8,12514,15,16,1,38,47,1947
18968,18968,BDA2CBDA960A369194390D221502EFE8,12511,21,23,2,39,47,1997
18988,18988,27C8C8C59A45FD62972467F08CD2763D,11231,0,9,9,37,49,1899
18989,18989,27C8C8C59A45FD62972467F08CD2763D,11074,12,20,8,37,47,1897
18990,18990,27C8C8C59A45FD62972467F08CD2763D,11231,21,23,2,37,49,1899
18991,18991,F34BB6ACFCE210E7291D20313D1902FC,19441,0,4,4,8,46,446
18992,18992,F34BB6ACFCE210E7291D20313D1902FC,42041,7,8,1,10,47,547
18993,18993,F34BB6ACFCE210E7291D20313D1902FC,19441,12,23,11,8,46,446
18998,18998,94A66B099C3B286235DEE73BAE7FEB6C,11861,1,7,6,32,47,1647
18999,18999,94A66B099C3B286235DEE73BAE7FEB6C,11651,7,8,1,33,47,1697
19000,19000,94A66B099C3B286235DEE73BAE7FEB6C,11861,8,20,12,32,47,1647
19001,19001,94A66B099C3B286235DEE73BAE7FEB6C,10281,20,23,3,33,48,1698
19002,19002,BC76CCD190FA1A5238AAD9129E2B96C9,11271,0,11,11,37,48,1898
19003,19003,BC76CCD190FA1A5238AAD9129E2B96C9,11231,11,18,7,37,49,1899
19004,19004,BC76CCD190FA1A5238AAD9129E2B96C9,40463,20,22,2,38,49,1949
19005,19005,BF8BEDF4778260D0DC1C3ADA89649FAD,11061,0,13,13,29,48,1498
19006,19006,BF8BEDF4778260D0DC1C3ADA89649FAD,11381,16,17,1,30,47,1547
19007,19007,BF8BEDF4778260D0DC1C3ADA89649FAD,11061,18,23,5,29,48,1498
19028,19028,CF0E6F8B160D86156EE9F4AC4DCADB7E,19441,0,1,1,8,46,446
19029,19029,CF0E6F8B160D86156EE9F4AC4DCADB7E,19621,1,6,5,5,46,296
19030,19030,CF0E6F8B160D86156EE9F4AC4DCADB7E,19441,6,23,17,8,46,446
19035,19035,CF6A7AF612D2CFA2B8383868CF93735B,42921,0,10,10,33,47,1697
19036,19036,CF6A7AF612D2CFA2B8383868CF93735B,42523,12,13,1,31,47,1597
19037,19037,CF6A7AF612D2CFA2B8383868CF93735B,42921,13,18,5,33,47,1697
19038,19038,F3511549D491F30F1B587648EB3F832C,11061,0,6,6,29,48,1498
19039,19039,F3511549D491F30F1B587648EB3F832C,10681,7,15,8,30,48,1548
19040,19040,F3511549D491F30F1B587648EB3F832C,11061,16,22,6,29,48,1498
19053,19053,D81A6DC953A97133873AEB5C2CBBA405,42161,0,2,2,36,47,1847
19054,19054,D81A6DC953A97133873AEB5C2CBBA405,10111,2,21,19,37,47,1897
19055,19055,D81A6DC953A97133873AEB5C2CBBA405,42161,22,23,1,36,47,1847
19056,19056,790457C5143568F0FC168A94781493E9,19114,0,6,6,7,43,393
19057,19057,790457C5143568F0FC168A94781493E9,12641,7,15,8,10,43,543
19058,19058,790457C5143568F0FC168A94781493E9,19114,18,23,5,7,43,393
19064,19064,FCF6425DA3F542476DF1F93935C075D8,42581,0,14,14,38,48,1948
19065,19065,FCF6425DA3F542476DF1F93935C075D8,11914,14,20,6,37,48,1898
19066,19066,FCF6425DA3F542476DF1F93935C075D8,42581,21,23,2,38,48,1948
19067,19067,D830EADED353A151E570961C9E6F25C0,40034,0,17,17,32,48,1648
19068,19068,D830EADED353A151E570961C9E6F25C0,12131,18,19,1,32,47,1647
19069,19069,D830EADED353A151E570961C9E6F25C0,40034,22,23,1,32,48,1648
19075,19075,0BB9DC41D7DF7A2695FAED0932FBBC64,11021,0,9,9,36,49,1849
19076,19076,0BB9DC41D7DF7A2695FAED0932FBBC64,40925,12,13,1,35,49,1799
19077,19077,0BB9DC41D7DF7A2695FAED0932FBBC64,11021,14,15,1,36,49,1849
19078,19078,0BB9DC41D7DF7A2695FAED0932FBBC64,11201,17,19,2,35,49,1799
19079,19079,B0CA59461CE535DA6C80DC6682EBEAFB,42271,0,16,16,40,47,2047
19080,19080,B0CA59461CE535DA6C80DC6682EBEAFB,11806,17,20,3,41,48,2098
19081,19081,B0CA59461CE535DA6C80DC6682EBEAFB,42271,21,23,2,40,47,2047
19082,19082,019A9F9DCF7D618AF8B3F50718B7A3D3,40673,0,5,5,36,48,1848
19083,19083,019A9F9DCF7D618AF8B3F50718B7A3D3,10251,6,7,1,35,47,1797
19084,19084,019A9F9DCF7D618AF8B3F50718B7A3D3,10281,12,14,2,33,48,1698
19085,19085,019A9F9DCF7D618AF8B3F50718B7A3D3,10251,16,23,7,35,47,1797
19089,19089,FE289D23B7E617AD349A76499E85C77F,42021,0,12,12,33,47,1697
19090,19090,FE289D23B7E617AD349A76499E85C77F,10431,12,20,8,33,49,1699
19091,19091,FE289D23B7E617AD349A76499E85C77F,42021,21,23,2,33,47,1697
19104,19104,B45CB2E1B244B3B7583778DACAAA9799,11074,0,18,18,37,47,1897
19105,19105,B45CB2E1B244B3B7583778DACAAA9799,12514,19,21,2,38,47,1947
19106,19106,B45CB2E1B244B3B7583778DACAAA9799,11074,21,23,2,37,47,1897
19111,19111,7F73EEE1198B300F5190B9A740E251E3,13911,0,5,5,39,46,1996
19112,19112,7F73EEE1198B300F5190B9A740E251E3,11261,5,10,5,36,46,1846
19113,19113,7F73EEE1198B300F5190B9A740E251E3,13911,11,13,2,39,46,1996
19114,19114,7F73EEE1198B300F5190B9A740E251E3,11261,14,19,5,36,46,1846
19115,19115,2163009C55B05ECD83E44729736749E5,11381,0,2,2,30,47,1547
19116,19116,2163009C55B05ECD83E44729736749E5,42291,5,7,2,29,48,1498
19117,19117,2163009C55B05ECD83E44729736749E5,11381,7,23,16,30,47,1547
19118,19118,AA541C733BB5F99408992FE5EC11F72D,42351,0,1,1,38,45,1945
19119,19119,AA541C733BB5F99408992FE5EC11F72D,42861,6,15,9,37,44,1894
19120,19120,AA541C733BB5F99408992FE5EC11F72D,11261,16,19,3,36,46,1846
19130,19130,7562F0D9D2DFDDDA6FEBBDD3673B0F76,13941,0,7,7,41,47,2097
19131,19131,7562F0D9D2DFDDDA6FEBBDD3673B0F76,10911,8,9,1,39,46,1996
19132,19132,7562F0D9D2DFDDDA6FEBBDD3673B0F76,13711,13,18,5,38,46,1946
19133,19133,7562F0D9D2DFDDDA6FEBBDD3673B0F76,13941,22,23,1,41,47,2097
19134,19134,2B75D649D733D42AAC85CA634BF0D07B,11914,7,15,8,37,48,1898
19135,19135,2B75D649D733D42AAC85CA634BF0D07B,42581,18,19,1,38,48,1948
19136,19136,2B75D649D733D42AAC85CA634BF0D07B,11914,22,23,1,37,48,1898
19143,19143,7F73A642AA11134206C46BA15C785E40,42521,7,10,3,31,47,1597
19144,19144,7F73A642AA11134206C46BA15C785E40,10292,10,20,10,30,47,1547
19145,19145,7F73A642AA11134206C46BA15C785E40,42521,20,21,1,31,47,1597
19146,19146,7F73A642AA11134206C46BA15C785E40,10295,22,23,1,30,47,1547
19147,19147,5CE4BD076974CDFDBB29CBFC6C974D60,12514,0,1,1,38,47,1947
19148,19148,5CE4BD076974CDFDBB29CBFC6C974D60,10841,1,3,2,37,47,1897
19149,19149,5CE4BD076974CDFDBB29CBFC6C974D60,12514,3,23,20,38,47,1947
19180,19180,D048F4DA46E2BE459D38C00513A81B07,40171,6,9,3,38,48,1948
19181,19181,D048F4DA46E2BE459D38C00513A81B07,11271,10,11,1,37,48,1898
19182,19182,D048F4DA46E2BE459D38C00513A81B07,40171,13,15,2,38,48,1948
19183,19183,D048F4DA46E2BE459D38C00513A81B07,11914,17,18,1,37,48,1898
19206,19206,61D4369B95803102112EEFE32BD36465,43761,5,12,7,32,47,1647
19207,19207,61D4369B95803102112EEFE32BD36465,42523,14,16,2,31,47,1597
19208,19208,61D4369B95803102112EEFE32BD36465,43761,17,20,3,32,47,1647
19209,19209,61D4369B95803102112EEFE32BD36465,10295,21,23,2,30,47,1547
19210,19210,619B4993323BBB76F010058331D5BCE1,13911,8,17,9,39,46,1996
19211,19211,619B4993323BBB76F010058331D5BCE1,11261,18,19,1,36,46,1846
19212,19212,619B4993323BBB76F010058331D5BCE1,13911,19,21,2,39,46,1996
19213,19213,5569A307420E2CA6F6C658F17F34D127,42864,0,3,3,38,44,1944
19214,19214,5569A307420E2CA6F6C658F17F34D127,11261,5,10,5,36,46,1846
19215,19215,5569A307420E2CA6F6C658F17F34D127,13231,12,14,2,39,46,1996
19216,19216,5569A307420E2CA6F6C658F17F34D127,42864,18,19,1,38,44,1944
19217,19217,9BCD563089A1D0EF43A278605DE25081,13911,0,10,10,39,46,1996
19218,19218,9BCD563089A1D0EF43A278605DE25081,42231,10,12,2,37,46,1896
19219,19219,9BCD563089A1D0EF43A278605DE25081,13911,13,21,8,39,46,1996
19220,19220,9BCD563089A1D0EF43A278605DE25081,42231,21,22,1,37,46,1896
19229,19229,30C0B23C34E9959F6A4FEC1908ADB011,11171,0,6,6,33,48,1698
19230,19230,30C0B23C34E9959F6A4FEC1908ADB011,12971,6,13,7,32,48,1648
19231,19231,30C0B23C34E9959F6A4FEC1908ADB011,11171,14,16,2,33,48,1698
19232,19232,30C0B23C34E9959F6A4FEC1908ADB011,11591,21,22,1,36,49,1849
19237,19237,1940CC384468326D0591B825867214FA,10271,0,14,14,37,46,1896
19238,19238,1940CC384468326D0591B825867214FA,42301,16,18,2,36,47,1847
19239,19239,1940CC384468326D0591B825867214FA,10271,18,23,5,37,46,1896
19240,19240,91C200FA50F01171E8296964B3C63730,43761,2,6,4,32,47,1647
19241,19241,91C200FA50F01171E8296964B3C63730,43471,9,12,3,31,49,1599
19242,19242,91C200FA50F01171E8296964B3C63730,11861,12,20,8,32,47,1647
19257,19257,5EC66C5A4B87D37344B296F73CB04D80,10471,0,10,10,37,48,1898
19258,19258,5EC66C5A4B87D37344B296F73CB04D80,11231,11,15,4,37,49,1899
19259,19259,5EC66C5A4B87D37344B296F73CB04D80,10471,17,23,6,37,48,1898
19260,19260,D36AEACA0F7F1CDCA98412CDD0F8BA1D,13941,1,9,8,41,47,2097
19261,19261,D36AEACA0F7F1CDCA98412CDD0F8BA1D,11001,13,18,5,42,47,2147
19262,19262,D36AEACA0F7F1CDCA98412CDD0F8BA1D,13941,21,23,2,41,47,2097
19272,19272,34FB5BF239A7B5016E3CA81F47968839,42161,0,7,7,36,47,1847
19273,19273,34FB5BF239A7B5016E3CA81F47968839,10251,9,11,2,35,47,1797
19274,19274,34FB5BF239A7B5016E3CA81F47968839,10107,12,17,5,38,49,1949
19275,19275,34FB5BF239A7B5016E3CA81F47968839,10251,19,23,4,35,47,1797
19276,19276,1BDB1D4CDA7F5AD203462A91AC7884E4,42161,0,8,8,36,47,1847
19277,19277,1BDB1D4CDA7F5AD203462A91AC7884E4,42511,8,9,1,37,47,1897
19278,19278,1BDB1D4CDA7F5AD203462A91AC7884E4,42161,13,23,10,36,47,1847
19289,19289,156B2F1B30E803720F8929E38D424718,40673,0,8,8,36,48,1848
19290,19290,156B2F1B30E803720F8929E38D424718,11331,9,16,7,37,48,1898
19291,19291,156B2F1B30E803720F8929E38D424718,13711,18,22,4,38,46,1946
19292,19292,0A252836FA6DFCFDFC50B5267919BF05,12641,0,5,5,10,43,543
19293,19293,0A252836FA6DFCFDFC50B5267919BF05,12921,6,9,3,9,41,491
19294,19294,0A252836FA6DFCFDFC50B5267919BF05,12641,9,23,14,10,43,543
19295,19295,6F1358C6526C9CA4FB50AA20B6B16B03,11001,0,7,7,42,47,2147
19296,19296,6F1358C6526C9CA4FB50AA20B6B16B03,13371,7,19,12,41,47,2097
19297,19297,6F1358C6526C9CA4FB50AA20B6B16B03,11001,20,22,2,42,47,2147
19308,19308,464DF91C83D752715121CBA55775E029,11381,0,4,4,30,47,1547
19309,19309,464DF91C83D752715121CBA55775E029,42523,5,8,3,31,47,1597
19310,19310,464DF91C83D752715121CBA55775E029,11381,10,23,13,30,47,1547
19322,19322,A27203DC664657DF4BBDCCF4AC9D93B1,12921,0,15,15,9,41,491
19323,19323,A27203DC664657DF4BBDCCF4AC9D93B1,49201,15,16,1,7,41,391
19324,19324,A27203DC664657DF4BBDCCF4AC9D93B1,12921,17,20,3,9,41,491
19325,19325,3D0F2BCCE75D465843155D0427A87610,11806,0,8,8,41,48,2098
19326,19326,3D0F2BCCE75D465843155D0427A87610,42271,8,9,1,40,47,2047
19327,19327,3D0F2BCCE75D465843155D0427A87610,11806,13,14,1,41,48,2098
19328,19328,3D0F2BCCE75D465843155D0427A87610,42271,16,19,3,40,47,2047
19358,19358,958D2F4CB99C769C3768CD7459979CC4,11861,9,10,1,32,47,1647
19359,19359,958D2F4CB99C769C3768CD7459979CC4,40882,12,13,1,34,49,1749
19360,19360,958D2F4CB99C769C3768CD7459979CC4,10431,17,18,1,33,49,1699
19361,19361,958D2F4CB99C769C3768CD7459979CC4,40882,19,23,4,34,49,1749
19362,19362,6562297688D8CD63CE654B7524AA8368,11861,1,14,13,32,47,1647
19363,19363,6562297688D8CD63CE654B7524AA8368,10281,15,19,4,33,48,1698
19364,19364,6562297688D8CD63CE654B7524AA8368,11861,20,23,3,32,47,1647
19365,19365,7E9368BE135995970A8FED4756447D8D,10801,1,13,12,42,47,2147
19366,19366,7E9368BE135995970A8FED4756447D8D,42111,14,15,1,44,46,2246
19367,19367,7E9368BE135995970A8FED4756447D8D,43061,17,19,2,43,46,2196
19368,19368,1788FF83230593384DFEF88881720D90,43101,2,12,10,46,40,2340
19369,19369,1788FF83230593384DFEF88881720D90,13551,12,14,2,45,38,2288
19370,19370,1788FF83230593384DFEF88881720D90,43101,15,17,2,46,40,2340
19371,19371,1788FF83230593384DFEF88881720D90,13551,18,23,5,45,38,2288
19372,19372,EB3F1E97C488E972B65B1AF3C2A86B31,10841,1,7,6,37,47,1897
19373,19373,EB3F1E97C488E972B65B1AF3C2A86B31,12514,18,20,2,38,47,1947
19374,19374,EB3F1E97C488E972B65B1AF3C2A86B31,10841,21,23,2,37,47,1897
19378,19378,F7F6E311089E545E2ADE21E1CFF4D206,43761,5,7,2,32,47,1647
19379,19379,F7F6E311089E545E2ADE21E1CFF4D206,43161,9,16,7,35,47,1797
19380,19380,F7F6E311089E545E2ADE21E1CFF4D206,43761,18,20,2,32,47,1647
19381,19381,11C5ACA60B0246DE7069023057E8285F,11381,1,6,5,30,47,1547
19382,19382,11C5ACA60B0246DE7069023057E8285F,11061,9,11,2,29,48,1498
19383,19383,11C5ACA60B0246DE7069023057E8285F,11381,13,23,10,30,47,1547
19393,19393,540311DE1F12F752C637697C87C1492F,43951,0,4,4,49,41,2491
19394,19394,540311DE1F12F752C637697C87C1492F,43101,8,10,2,46,40,2340
19395,19395,540311DE1F12F752C637697C87C1492F,43951,11,23,12,49,41,2491
19396,19396,4C3E8C1CDF60EC341D8B9147E6C7B114,10691,0,6,6,33,48,1698
19397,19397,4C3E8C1CDF60EC341D8B9147E6C7B114,11861,9,11,2,32,47,1647
19398,19398,4C3E8C1CDF60EC341D8B9147E6C7B114,42491,15,17,2,32,46,1646
19399,19399,4C3E8C1CDF60EC341D8B9147E6C7B114,10691,19,23,4,33,48,1698
19450,19450,99E7A69682ADA3DC350489A1187F33F9,43761,0,17,17,32,47,1647
19451,19451,99E7A69682ADA3DC350489A1187F33F9,10281,17,20,3,33,48,1698
19452,19452,99E7A69682ADA3DC350489A1187F33F9,43761,21,23,2,32,47,1647
19457,19457,9397083C419903E30A62F5C06D299D5C,42381,0,5,5,39,41,1991
19458,19458,9397083C419903E30A62F5C06D299D5C,13071,7,8,1,41,41,2091
19459,19459,9397083C419903E30A62F5C06D299D5C,43451,12,15,3,37,40,1890
19460,19460,9397083C419903E30A62F5C06D299D5C,13071,19,22,3,41,41,2091
19464,19464,CADE9ADEC7B1B2F6454293174DEADF86,10681,0,13,13,30,48,1548
19465,19465,CADE9ADEC7B1B2F6454293174DEADF86,11061,14,18,4,29,48,1498
19466,19466,CADE9ADEC7B1B2F6454293174DEADF86,11151,22,23,1,30,48,1548
19467,19467,61AF80679359D43A0E6925D92F08EE37,12641,5,6,1,10,43,543
19468,19468,61AF80679359D43A0E6925D92F08EE37,19931,10,12,2,7,43,393
19469,19469,61AF80679359D43A0E6925D92F08EE37,12641,12,13,1,10,43,543
19470,19470,61AF80679359D43A0E6925D92F08EE37,19931,17,22,5,7,43,393
19475,19475,66C0548F02598D44AE0CA78CDFFA7E48,10401,0,8,8,33,49,1699
19476,19476,66C0548F02598D44AE0CA78CDFFA7E48,11954,10,13,3,32,49,1649
19477,19477,66C0548F02598D44AE0CA78CDFFA7E48,10401,21,23,2,33,49,1699
19478,19478,AAED9BE930876CCFBFDFA351B63D61EF,10841,1,10,9,37,47,1897
19479,19479,AAED9BE930876CCFBFDFA351B63D61EF,10107,13,15,2,38,49,1949
19480,19480,AAED9BE930876CCFBFDFA351B63D61EF,40891,18,23,5,37,47,1897
19490,19490,6AC93D8B9EA318464A26923604ECDF03,10431,9,11,2,33,49,1699
19491,19491,6AC93D8B9EA318464A26923604ECDF03,11954,11,12,1,32,49,1649
19492,19492,6AC93D8B9EA318464A26923604ECDF03,10431,13,18,5,33,49,1699
19493,19493,6AC93D8B9EA318464A26923604ECDF03,42471,19,21,2,35,49,1799
19500,19500,0DC30FA0CCDAD859C724130675369152,42351,0,10,10,38,45,1945
19501,19501,0DC30FA0CCDAD859C724130675369152,42864,14,15,1,38,44,1944
19502,19502,0DC30FA0CCDAD859C724130675369152,42351,19,20,1,38,45,1945
19507,19507,BCCA36AC6DE92B5D284204C1D312B82A,43161,0,7,7,35,47,1797
19508,19508,BCCA36AC6DE92B5D284204C1D312B82A,10431,8,18,10,33,49,1699
19509,19509,BCCA36AC6DE92B5D284204C1D312B82A,43161,20,23,3,35,47,1797
19510,19510,A61D0F5D6E4730E77483BB5A83F54B2C,42771,0,7,7,36,47,1847
19511,19511,A61D0F5D6E4730E77483BB5A83F54B2C,13911,11,16,5,39,46,1996
19512,19512,A61D0F5D6E4730E77483BB5A83F54B2C,40171,19,20,1,38,48,1948
19513,19513,A61D0F5D6E4730E77483BB5A83F54B2C,42401,21,23,2,36,47,1847
19514,19514,31D4ECBF6E20300058A6DBF4B1DCA2FB,42491,5,6,1,32,46,1646
19515,19515,31D4ECBF6E20300058A6DBF4B1DCA2FB,13651,9,12,3,30,47,1547
19516,19516,31D4ECBF6E20300058A6DBF4B1DCA2FB,42523,13,17,4,31,47,1597
19517,19517,31D4ECBF6E20300058A6DBF4B1DCA2FB,11324,19,21,2,31,46,1596
19518,19518,2F1F7798F5E8889B4080CA59D71F0274,10271,4,8,4,37,46,1896
19519,19519,2F1F7798F5E8889B4080CA59D71F0274,11081,10,11,1,35,46,1796
19520,19520,2F1F7798F5E8889B4080CA59D71F0274,10271,12,23,11,37,46,1896
19521,19521,018A1CC117B204501E34F73B68B137CB,42581,0,6,6,38,48,1948
19522,19522,018A1CC117B204501E34F73B68B137CB,10471,8,9,1,37,48,1898
19523,19523,018A1CC117B204501E34F73B68B137CB,42581,14,22,8,38,48,1948
19524,19524,AA6D4A35F81446E34CB45D0775B9D6B5,11231,0,5,5,37,49,1899
19525,19525,AA6D4A35F81446E34CB45D0775B9D6B5,10471,6,9,3,37,48,1898
19526,19526,AA6D4A35F81446E34CB45D0775B9D6B5,11231,11,19,8,37,49,1899
19530,19530,AD24687CE009DD38418E30D2A06E4D4E,10121,0,13,13,36,49,1849
19531,19531,AD24687CE009DD38418E30D2A06E4D4E,11751,18,19,1,35,48,1798
19532,19532,AD24687CE009DD38418E30D2A06E4D4E,10121,20,23,3,36,49,1849
19533,19533,20A7975366758E3C48A8CB4E3CD0626C,40343,1,6,5,24,49,1249
19534,19534,20A7975366758E3C48A8CB4E3CD0626C,42121,6,12,6,26,49,1349
19535,19535,20A7975366758E3C48A8CB4E3CD0626C,40343,13,22,9,24,49,1249
19540,19540,8EBCC2B157B4BDD13F1A526542723CAD,40421,0,9,9,37,48,1898
19541,19541,8EBCC2B157B4BDD13F1A526542723CAD,11261,9,14,5,36,46,1846
19542,19542,8EBCC2B157B4BDD13F1A526542723CAD,10221,15,20,5,34,49,1749
19543,19543,8EBCC2B157B4BDD13F1A526542723CAD,11331,21,23,2,37,48,1898
19544,19544,B4CF5575585A81D8047EC86B2FC8CF53,42861,0,6,6,37,44,1894
19545,19545,B4CF5575585A81D8047EC86B2FC8CF53,11261,7,10,3,36,46,1846
19546,19546,B4CF5575585A81D8047EC86B2FC8CF53,42861,10,20,10,37,44,1894
19547,19547,B4CF5575585A81D8047EC86B2FC8CF53,42864,21,23,2,38,44,1944
19551,19551,70884D19952CA4B432FAA84B8636A296,13351,0,11,11,48,48,2448
19552,19552,70884D19952CA4B432FAA84B8636A296,43621,13,14,1,46,48,2348
19553,19553,70884D19952CA4B432FAA84B8636A296,13351,14,21,7,48,48,2448
19554,19554,487315C9A10EA017D67B443311820F7A,42581,0,5,5,38,48,1948
19555,19555,487315C9A10EA017D67B443311820F7A,11914,7,16,9,37,48,1898
19556,19556,487315C9A10EA017D67B443311820F7A,42581,18,19,1,38,48,1948
19557,19557,487315C9A10EA017D67B443311820F7A,10191,20,23,3,40,48,2048
19558,19558,180C57D9A40178E5B15186C701804F1B,42931,1,13,12,41,49,2099
19559,19559,180C57D9A40178E5B15186C701804F1B,11771,16,17,1,39,49,1999
19560,19560,180C57D9A40178E5B15186C701804F1B,11741,20,21,1,42,49,2149
19564,19564,672E46CD1A2289C6109AAA4160C503F8,13911,1,5,4,39,46,1996
19565,19565,672E46CD1A2289C6109AAA4160C503F8,42351,8,10,2,38,45,1945
19566,19566,672E46CD1A2289C6109AAA4160C503F8,13911,11,12,1,39,46,1996
19567,19567,672E46CD1A2289C6109AAA4160C503F8,11261,17,18,1,36,46,1846
19609,19609,181802B57A29F4FAE1E7EF60B334A9D5,11261,4,11,7,36,46,1846
19610,19610,181802B57A29F4FAE1E7EF60B334A9D5,42861,12,13,1,37,44,1894
19611,19611,181802B57A29F4FAE1E7EF60B334A9D5,11261,14,20,6,36,46,1846
19616,19616,78F90AA6A75AEF1689FC79D56BBC2594,42351,0,6,6,38,45,1945
19617,19617,78F90AA6A75AEF1689FC79D56BBC2594,42231,9,13,4,37,46,1896
19618,19618,78F90AA6A75AEF1689FC79D56BBC2594,42351,14,16,2,38,45,1945
19619,19619,78F90AA6A75AEF1689FC79D56BBC2594,13911,19,20,1,39,46,1996
19628,19628,53BED426E3030287F564655ACD249D2C,11324,0,12,12,31,46,1596
19629,19629,53BED426E3030287F564655ACD249D2C,10711,16,20,4,29,46,1496
19630,19630,53BED426E3030287F564655ACD249D2C,11324,21,23,2,31,46,1596
19652,19652,7EFF4C1F410EC0093C0E819DD0DC2E31,10471,0,12,12,37,48,1898
19653,19653,7EFF4C1F410EC0093C0E819DD0DC2E31,42581,13,15,2,38,48,1948
19654,19654,7EFF4C1F410EC0093C0E819DD0DC2E31,10471,15,23,8,37,48,1898
19665,19665,4EE0BD84C5458EF10D4B4A93E54F4FE2,11351,0,6,6,36,48,1848
19666,19666,4EE0BD84C5458EF10D4B4A93E54F4FE2,10371,7,10,3,37,49,1899
19667,19667,4EE0BD84C5458EF10D4B4A93E54F4FE2,10901,12,20,8,35,48,1798
19668,19668,4EE0BD84C5458EF10D4B4A93E54F4FE2,11351,21,23,2,36,48,1848
19669,19669,B8DB030E6F574F75DC469AA0B11A44D5,10151,0,12,12,34,47,1747
19670,19670,B8DB030E6F574F75DC469AA0B11A44D5,42921,14,17,3,33,47,1697
19671,19671,B8DB030E6F574F75DC469AA0B11A44D5,10151,19,23,4,34,47,1747
19672,19672,280A825D237E9CE7CB403628403E758B,42351,1,6,5,38,45,1945
19673,19673,280A825D237E9CE7CB403628403E758B,13911,10,11,1,39,46,1996
19674,19674,280A825D237E9CE7CB403628403E758B,42351,12,23,11,38,45,1945
19675,19675,92E340B82C56A45F91D53CD2B709557E,42581,2,3,1,38,48,1948
19676,19676,92E340B82C56A45F91D53CD2B709557E,11914,7,9,2,37,48,1898
19677,19677,92E340B82C56A45F91D53CD2B709557E,42581,12,14,2,38,48,1948
19678,19678,92E340B82C56A45F91D53CD2B709557E,11914,17,18,1,37,48,1898
19679,19679,0635F9DF2EA1E946C4F55221676132EF,10281,0,10,10,33,48,1698
19680,19680,0635F9DF2EA1E946C4F55221676132EF,43761,13,20,7,32,47,1647
19681,19681,0635F9DF2EA1E946C4F55221676132EF,42523,21,22,1,31,47,1597
19689,19689,99F72F15E40C6CA9B587DDE0EF7BC174,40632,0,7,7,35,48,1798
19690,19690,99F72F15E40C6CA9B587DDE0EF7BC174,11914,8,12,4,37,48,1898
19691,19691,99F72F15E40C6CA9B587DDE0EF7BC174,10121,13,16,3,36,49,1849
19692,19692,99F72F15E40C6CA9B587DDE0EF7BC174,40637,19,20,1,36,47,1847
19693,19693,2C19FDC386B0B2E924F75B25676D719F,42231,0,1,1,37,46,1896
19694,19694,2C19FDC386B0B2E924F75B25676D719F,42351,1,10,9,38,45,1945
19695,19695,2C19FDC386B0B2E924F75B25676D719F,42231,12,13,1,37,46,1896
19696,19696,2C19FDC386B0B2E924F75B25676D719F,11351,18,23,5,36,48,1848
19697,19697,F2229754FABF7F398D6839D6208AC86F,10544,0,8,8,28,48,1448
19698,19698,F2229754FABF7F398D6839D6208AC86F,10381,9,11,2,31,49,1599
19699,19699,F2229754FABF7F398D6839D6208AC86F,10544,12,23,11,28,48,1448
19722,19722,6C96EE989846ABECA961FEB7DAD4E3B3,40171,0,6,6,38,48,1948
19723,19723,6C96EE989846ABECA961FEB7DAD4E3B3,10471,7,17,10,37,48,1898
19724,19724,6C96EE989846ABECA961FEB7DAD4E3B3,40171,17,23,6,38,48,1948
19725,19725,C6869A64CA9EF97A25D7192A00726FC2,42401,0,9,9,36,47,1847
19726,19726,C6869A64CA9EF97A25D7192A00726FC2,10781,9,15,6,35,47,1797
19727,19727,C6869A64CA9EF97A25D7192A00726FC2,42401,15,23,8,36,47,1847
19728,19728,8C29E031FB5956E038F5FE7083F4864A,42861,1,14,13,37,44,1894
19729,19729,8C29E031FB5956E038F5FE7083F4864A,11261,14,21,7,36,46,1846
19730,19730,8C29E031FB5956E038F5FE7083F4864A,42861,21,22,1,37,44,1894
19731,19731,078D744FD5840DE4508E7DD5C66617FF,42351,1,8,7,38,45,1945
19732,19732,078D744FD5840DE4508E7DD5C66617FF,11261,10,12,2,36,46,1846
19733,19733,078D744FD5840DE4508E7DD5C66617FF,42351,14,20,6,38,45,1945
19734,19734,078D744FD5840DE4508E7DD5C66617FF,11261,20,21,1,36,46,1846
19746,19746,181B5103F0FBF120AFF5BEC3A26A3DB7,11161,0,5,5,32,48,1648
19747,19747,181B5103F0FBF120AFF5BEC3A26A3DB7,42141,7,22,15,32,47,1647
19748,19748,181B5103F0FBF120AFF5BEC3A26A3DB7,11161,22,23,1,32,48,1648
19749,19749,B5391EB928DCC81C49BEFA3E95DDD82D,42191,0,13,13,38,49,1949
19750,19750,B5391EB928DCC81C49BEFA3E95DDD82D,11271,14,18,4,37,48,1898
19751,19751,B5391EB928DCC81C49BEFA3E95DDD82D,42191,18,21,3,38,49,1949
19758,19758,1211E691D3C595AFBB037C54F55B9F54,43161,2,14,12,35,47,1797
19759,19759,1211E691D3C595AFBB037C54F55B9F54,42161,15,16,1,36,47,1847
19760,19760,1211E691D3C595AFBB037C54F55B9F54,10251,17,22,5,35,47,1797
19761,19761,D8963F7C81A647B0DB7A8BBF70036A0B,40171,8,12,4,38,48,1948
19762,19762,D8963F7C81A647B0DB7A8BBF70036A0B,10471,12,17,5,37,48,1898
19763,19763,D8963F7C81A647B0DB7A8BBF70036A0B,12514,19,22,3,38,47,1947
19775,19775,2B05CC2BC211341FBD9F6EA8966B4690,11914,0,2,2,37,48,1898
19776,19776,2B05CC2BC211341FBD9F6EA8966B4690,42581,6,21,15,38,48,1948
19777,19777,2B05CC2BC211341FBD9F6EA8966B4690,11914,22,23,1,37,48,1898
19784,19784,F725A3F859B25741A70E1B3AC0517A8A,10111,1,10,9,37,47,1897
19785,19785,F725A3F859B25741A70E1B3AC0517A8A,42301,13,14,1,36,47,1847
19786,19786,F725A3F859B25741A70E1B3AC0517A8A,10111,14,17,3,37,47,1897
19787,19787,F725A3F859B25741A70E1B3AC0517A8A,10107,19,22,3,38,49,1949
19788,19788,01AD8678560B948D0F150F181F8839DC,42401,0,10,10,36,47,1847
19789,19789,01AD8678560B948D0F150F181F8839DC,11074,11,12,1,37,47,1897
19790,19790,01AD8678560B948D0F150F181F8839DC,42401,12,23,11,36,47,1847
19800,19800,716FBFB227B51AA05D4F812E328391F3,19441,0,1,1,8,46,446
19801,19801,716FBFB227B51AA05D4F812E328391F3,19621,1,2,1,5,46,296
19802,19802,716FBFB227B51AA05D4F812E328391F3,19441,3,21,18,8,46,446
19803,19803,AE4A6270CFE8D53376809A1F5BCB61EF,40421,2,4,2,37,48,1898
19804,19804,AE4A6270CFE8D53376809A1F5BCB61EF,11074,7,16,9,37,47,1897
19805,19805,AE4A6270CFE8D53376809A1F5BCB61EF,40421,19,21,2,37,48,1898
19806,19806,F82B0744060E830A6F1F73EAFE27E504,42321,3,5,2,43,47,2197
19807,19807,F82B0744060E830A6F1F73EAFE27E504,11701,5,6,1,43,48,2198
19808,19808,F82B0744060E830A6F1F73EAFE27E504,42321,8,11,3,43,47,2197
19809,19809,F82B0744060E830A6F1F73EAFE27E504,42461,14,18,4,45,47,2297
19828,19828,7636C02B931F5033A3275CA34FA4048C,42961,0,1,1,35,49,1799
19829,19829,7636C02B931F5033A3275CA34FA4048C,42981,6,7,1,36,49,1849
19830,19830,7636C02B931F5033A3275CA34FA4048C,11231,8,19,11,37,49,1899
19831,19831,7636C02B931F5033A3275CA34FA4048C,10901,20,21,1,35,48,1798
19839,19839,03FE0D0BD52A528C1B4DF1F3C44F085B,11941,0,13,13,37,46,1896
19840,19840,03FE0D0BD52A528C1B4DF1F3C44F085B,42351,15,16,1,38,45,1945
19841,19841,03FE0D0BD52A528C1B4DF1F3C44F085B,11941,16,18,2,37,46,1896
19842,19842,03FE0D0BD52A528C1B4DF1F3C44F085B,42351,21,22,1,38,45,1945
19843,19843,3536272718DEA79ABD008A016BEF1A97,10721,0,14,14,31,48,1598
19844,19844,3536272718DEA79ABD008A016BEF1A97,11751,16,17,1,35,48,1798
19845,19845,3536272718DEA79ABD008A016BEF1A97,12381,22,23,1,32,48,1648
19846,19846,F8D8BFDE805181B5C105945C04A6F321,11061,0,13,13,29,48,1498
19847,19847,F8D8BFDE805181B5C105945C04A6F321,11151,14,15,1,30,48,1548
19848,19848,F8D8BFDE805181B5C105945C04A6F321,11061,16,19,3,29,48,1498
19849,19849,20538B8C1777892DA77867D1D04B5D49,43761,1,3,2,32,47,1647
19850,19850,20538B8C1777892DA77867D1D04B5D49,11161,3,9,6,32,48,1648
19851,19851,20538B8C1777892DA77867D1D04B5D49,43761,10,23,13,32,47,1647
19857,19857,617CDCBB763C8E42460705E2218A65BF,42141,0,7,7,32,47,1647
19858,19858,617CDCBB763C8E42460705E2218A65BF,42523,9,11,2,31,47,1597
19859,19859,617CDCBB763C8E42460705E2218A65BF,43761,11,23,12,32,47,1647
19876,19876,2220ACECA44CDD6B643C1166EB143787,12641,0,6,6,10,43,543
19877,19877,2220ACECA44CDD6B643C1166EB143787,19114,8,10,2,7,43,393
19878,19878,2220ACECA44CDD6B643C1166EB143787,12641,11,23,12,10,43,543
19888,19888,0BA677AEFA1FE879EC9FCA98466C3A1A,11641,0,5,5,22,49,1149
19889,19889,0BA677AEFA1FE879EC9FCA98466C3A1A,40343,6,8,2,24,49,1249
19890,19890,0BA677AEFA1FE879EC9FCA98466C3A1A,11641,9,22,13,22,49,1149
19891,19891,C0570363D945AD563B5483C8E4053ECC,11231,0,6,6,37,49,1899
19892,19892,C0570363D945AD563B5483C8E4053ECC,12083,7,9,2,36,49,1849
19893,19893,C0570363D945AD563B5483C8E4053ECC,11231,12,23,11,37,49,1899
19894,19894,8F8152ABCDBBD4CE857B1EFCB582F5D2,11074,10,11,1,37,47,1897
19895,19895,8F8152ABCDBBD4CE857B1EFCB582F5D2,10251,15,17,2,35,47,1797
19896,19896,8F8152ABCDBBD4CE857B1EFCB582F5D2,11074,22,23,1,37,47,1897
19902,19902,B969FE7CA88FA294C8201CFC44CC669E,12121,0,8,8,29,47,1497
19903,19903,B969FE7CA88FA294C8201CFC44CC669E,12601,11,12,1,25,47,1297
19904,19904,B969FE7CA88FA294C8201CFC44CC669E,13651,15,17,2,30,47,1547
19905,19905,B969FE7CA88FA294C8201CFC44CC669E,12121,17,23,6,29,47,1497
19906,19906,88182B8F0A08A7B6CD3790FE87C79F47,42231,0,1,1,37,46,1896
19907,19907,88182B8F0A08A7B6CD3790FE87C79F47,42351,3,15,12,38,45,1945
19908,19908,88182B8F0A08A7B6CD3790FE87C79F47,42231,17,21,4,37,46,1896
19909,19909,88182B8F0A08A7B6CD3790FE87C79F47,42351,21,23,2,38,45,1945
19910,19910,3E17C9F881E8F571652BFE5E841845EF,11861,0,14,14,32,47,1647
19911,19911,3E17C9F881E8F571652BFE5E841845EF,10281,14,15,1,33,48,1698
19912,19912,3E17C9F881E8F571652BFE5E841845EF,11861,16,23,7,32,47,1647
19913,19913,1CD741282378ACECE229BFA3E57C9431,42041,2,9,7,10,47,547
19914,19914,1CD741282378ACECE229BFA3E57C9431,19441,13,14,1,8,46,446
19915,19915,1CD741282378ACECE229BFA3E57C9431,42041,14,18,4,10,47,547
19916,19916,1CD741282378ACECE229BFA3E57C9431,19441,19,23,4,8,46,446
19920,19920,FD400E5E5D48DD38D9BF2DF0674CF1A6,12311,0,1,1,30,44,1544
19921,19921,FD400E5E5D48DD38D9BF2DF0674CF1A6,13671,1,2,1,27,43,1393
19922,19922,FD400E5E5D48DD38D9BF2DF0674CF1A6,12311,3,6,3,30,44,1544
19923,19923,FD400E5E5D48DD38D9BF2DF0674CF1A6,13671,6,21,15,27,43,1393
19924,19924,A65229EBB0F3925DDB0136EBBA9276B5,10421,0,10,10,41,48,2098
19925,19925,A65229EBB0F3925DDB0136EBBA9276B5,11301,11,13,2,41,49,2099
19926,19926,A65229EBB0F3925DDB0136EBBA9276B5,11741,19,21,2,42,49,2149
19927,19927,A65229EBB0F3925DDB0136EBBA9276B5,13961,21,22,1,42,48,2148
19948,19948,27B6DDFE3A356062F221ABD7AD70BB14,11061,0,8,8,29,48,1498
19949,19949,27B6DDFE3A356062F221ABD7AD70BB14,10681,9,11,2,30,48,1548
19950,19950,27B6DDFE3A356062F221ABD7AD70BB14,11061,13,23,10,29,48,1498
19955,19955,C48AF9FD92249AFBDE30934410FF853B,10471,0,9,9,37,48,1898
19956,19956,C48AF9FD92249AFBDE30934410FF853B,11781,10,11,1,38,49,1949
19957,19957,C48AF9FD92249AFBDE30934410FF853B,10471,12,23,11,37,48,1898
19967,19967,62E083FD6CCFD94FFA49C92986AAE56D,10281,1,7,6,33,48,1698
19968,19968,62E083FD6CCFD94FFA49C92986AAE56D,43761,7,19,12,32,47,1647
19969,19969,62E083FD6CCFD94FFA49C92986AAE56D,10281,20,22,2,33,48,1698
19970,19970,05662DE2D50DAC04B608AC546D5181FB,10471,0,9,9,37,48,1898
19971,19971,05662DE2D50DAC04B608AC546D5181FB,10107,10,11,1,38,49,1949
19972,19972,05662DE2D50DAC04B608AC546D5181FB,10471,11,23,12,37,48,1898
19984,19984,A097EFDEB971DC4619BAD49839C54BAE,42521,0,6,6,31,47,1597
19985,19985,A097EFDEB971DC4619BAD49839C54BAE,13651,9,11,2,30,47,1547
19986,19986,A097EFDEB971DC4619BAD49839C54BAE,42521,12,23,11,31,47,1597
19990,19990,8F904CBC6B1FF161729D8B767981EA0F,12311,4,13,9,30,44,1544
19991,19991,8F904CBC6B1FF161729D8B767981EA0F,42531,16,17,1,31,45,1595
19992,19992,8F904CBC6B1FF161729D8B767981EA0F,12311,19,20,1,30,44,1544
19997,19997,4B50E3EFF8633FBE01E31B5F6F8477A0,42091,0,16,16,43,46,2196
19998,19998,4B50E3EFF8633FBE01E31B5F6F8477A0,42461,17,18,1,45,47,2297
19999,19999,4B50E3EFF8633FBE01E31B5F6F8477A0,42091,21,23,2,43,46,2196
20006,20006,6166F4BC9B2530F6FDAD5A0233FBAAD6,42581,3,4,1,38,48,1948
20007,20007,6166F4BC9B2530F6FDAD5A0233FBAAD6,11914,7,10,3,37,48,1898
20008,20008,6166F4BC9B2530F6FDAD5A0233FBAAD6,42581,11,13,2,38,48,1948
20009,20009,6166F4BC9B2530F6FDAD5A0233FBAAD6,10471,16,18,2,37,48,1898
20017,20017,2C9F9127F2AECFBA8069624790D23C60,10471,0,15,15,37,48,1898
20018,20018,2C9F9127F2AECFBA8069624790D23C60,40171,17,19,2,38,48,1948
20019,20019,2C9F9127F2AECFBA8069624790D23C60,10471,19,23,4,37,48,1898
20023,20023,5BF45B486C4CF16F8A7FCFB6A5FB4FA5,40034,0,7,7,32,48,1648
20024,20024,5BF45B486C4CF16F8A7FCFB6A5FB4FA5,10251,11,19,8,35,47,1797
20025,20025,5BF45B486C4CF16F8A7FCFB6A5FB4FA5,12381,21,23,2,32,48,1648
20029,20029,DB699608F69692D75B6DFCC5CFECBADF,10381,2,7,5,31,49,1599
20030,20030,DB699608F69692D75B6DFCC5CFECBADF,11151,8,9,1,30,48,1548
20031,20031,DB699608F69692D75B6DFCC5CFECBADF,10381,11,23,12,31,49,1599
20050,20050,90AC20E6CC0B4ABA3A4EAC5C3086C030,13741,0,14,14,37,49,1899
20051,20051,90AC20E6CC0B4ABA3A4EAC5C3086C030,10841,18,19,1,37,47,1897
20052,20052,90AC20E6CC0B4ABA3A4EAC5C3086C030,11231,20,22,2,37,49,1899
20056,20056,89A682732B19C12B4550489712947EEA,42161,0,11,11,36,47,1847
20057,20057,89A682732B19C12B4550489712947EEA,42941,13,14,1,37,47,1897
20058,20058,89A682732B19C12B4550489712947EEA,42161,15,23,8,36,47,1847
20062,20062,5232A1F9DD43FADD1ACE9CE9BD82FED1,43581,0,5,5,33,48,1698
20063,20063,5232A1F9DD43FADD1ACE9CE9BD82FED1,11021,8,9,1,36,49,1849
20064,20064,5232A1F9DD43FADD1ACE9CE9BD82FED1,43581,18,23,5,33,48,1698
20072,20072,3FEEDFDB7512A2E0A9F8F242EB33F0A3,42321,3,6,3,43,47,2197
20073,20073,3FEEDFDB7512A2E0A9F8F242EB33F0A3,11001,10,11,1,42,47,2147
20074,20074,3FEEDFDB7512A2E0A9F8F242EB33F0A3,13941,12,19,7,41,47,2097
20085,20085,7D108BFB051387A341F75FDC13929BC0,10381,0,8,8,31,49,1599
20086,20086,7D108BFB051387A341F75FDC13929BC0,42521,12,13,1,31,47,1597
20087,20087,7D108BFB051387A341F75FDC13929BC0,10381,13,23,10,31,49,1599
20091,20091,C46CDF3840B783157CCBA7C0D999F0A9,10295,0,16,16,30,47,1547
20092,20092,C46CDF3840B783157CCBA7C0D999F0A9,10381,18,19,1,31,49,1599
20093,20093,C46CDF3840B783157CCBA7C0D999F0A9,10292,20,22,2,30,47,1547
20098,20098,0D7924567492FFCAAF3EE449A4BEBE16,11941,0,9,9,37,46,1896
20099,20099,0D7924567492FFCAAF3EE449A4BEBE16,13711,14,17,3,38,46,1946
20100,20100,0D7924567492FFCAAF3EE449A4BEBE16,11941,19,22,3,37,46,1896
20106,20106,AC414DB8853E95A441FB40B4893530F7,10351,6,9,3,28,45,1445
20107,20107,AC414DB8853E95A441FB40B4893530F7,11871,12,13,1,29,46,1496
20108,20108,AC414DB8853E95A441FB40B4893530F7,10634,18,19,1,27,45,1395
20109,20109,5E1BBAE6A1AB78C09E8201C8FF351A4E,43481,0,3,3,39,48,1998
20110,20110,5E1BBAE6A1AB78C09E8201C8FF351A4E,12514,3,17,14,38,47,1947
20111,20111,5E1BBAE6A1AB78C09E8201C8FF351A4E,42301,19,21,2,36,47,1847
20112,20112,09C2A5500F5ABAEEAC932C07F5628EC4,43161,9,12,3,35,47,1797
20113,20113,09C2A5500F5ABAEEAC932C07F5628EC4,11021,12,14,2,36,49,1849
20114,20114,09C2A5500F5ABAEEAC932C07F5628EC4,43161,15,18,3,35,47,1797
20115,20115,09C2A5500F5ABAEEAC932C07F5628EC4,11021,21,23,2,36,49,1849
20120,20120,086873B6FDDAA95F5D97B0E7D1FDE099,42271,0,7,7,40,47,2047
20121,20121,086873B6FDDAA95F5D97B0E7D1FDE099,12514,8,13,5,38,47,1947
20122,20122,086873B6FDDAA95F5D97B0E7D1FDE099,13941,17,19,2,41,47,2097
20123,20123,086873B6FDDAA95F5D97B0E7D1FDE099,42511,21,22,1,37,47,1897
20146,20146,AD235EE6A83CA7956AB86E8BC887D3C7,11541,0,5,5,35,49,1799
20147,20147,AD235EE6A83CA7956AB86E8BC887D3C7,13561,7,8,1,37,49,1899
20148,20148,AD235EE6A83CA7956AB86E8BC887D3C7,11021,10,17,7,36,49,1849
20149,20149,AD235EE6A83CA7956AB86E8BC887D3C7,11541,19,23,4,35,49,1799
20165,20165,132BAF41704DD845C2F70543C3732C4E,42231,0,3,3,37,46,1896
20166,20166,132BAF41704DD845C2F70543C3732C4E,13711,5,9,4,38,46,1946
20167,20167,132BAF41704DD845C2F70543C3732C4E,42231,11,21,10,37,46,1896
20168,20168,B1886EF8F5487F8E8F1A6E89D17F4DF6,12311,0,5,5,30,44,1544
20169,20169,B1886EF8F5487F8E8F1A6E89D17F4DF6,42531,6,10,4,31,45,1595
20170,20170,B1886EF8F5487F8E8F1A6E89D17F4DF6,12311,11,18,7,30,44,1544
20177,20177,A633655235449D63DF9FCC21A84BEF59,10721,0,9,9,31,48,1598
20178,20178,A633655235449D63DF9FCC21A84BEF59,12381,13,14,1,32,48,1648
20179,20179,A633655235449D63DF9FCC21A84BEF59,10721,19,23,4,31,48,1598
20183,20183,15D46EC570105A948AAA5BD130B0DCB7,10111,0,7,7,37,47,1897
20184,20184,15D46EC570105A948AAA5BD130B0DCB7,42161,10,13,3,36,47,1847
20185,20185,15D46EC570105A948AAA5BD130B0DCB7,10111,18,23,5,37,47,1897
20186,20186,51BC336998B7C1707612FC61253356A7,11261,0,11,11,36,46,1846
20187,20187,51BC336998B7C1707612FC61253356A7,42861,12,13,1,37,44,1894
20188,20188,51BC336998B7C1707612FC61253356A7,11261,13,21,8,36,46,1846
20206,20206,B7D6EFF1A712C97E66620534B8D3DEAE,10471,1,9,8,37,48,1898
20207,20207,B7D6EFF1A712C97E66620534B8D3DEAE,41271,12,13,1,38,48,1948
20208,20208,B7D6EFF1A712C97E66620534B8D3DEAE,10471,14,17,3,37,48,1898
20209,20209,B7D6EFF1A712C97E66620534B8D3DEAE,41271,17,18,1,38,48,1948
20224,20224,4E7614A4B91A30F096E19E723EE62442,10634,0,12,12,27,45,1395
20225,20225,4E7614A4B91A30F096E19E723EE62442,11875,14,15,1,30,46,1546
20226,20226,4E7614A4B91A30F096E19E723EE62442,10351,16,17,1,28,45,1445
20227,20227,4E7614A4B91A30F096E19E723EE62442,10634,21,23,2,27,45,1395
20232,20232,182A42BB7961D14AD940FD065D4EDF33,13121,4,5,1,38,46,1946
20233,20233,182A42BB7961D14AD940FD065D4EDF33,43241,10,11,1,36,46,1846
20234,20234,182A42BB7961D14AD940FD065D4EDF33,11941,13,14,1,37,46,1896
20235,20235,182A42BB7961D14AD940FD065D4EDF33,42011,15,18,3,36,46,1846
20236,20236,538631A6190277898984781481DE297B,42091,0,10,10,43,46,2196
20237,20237,538631A6190277898984781481DE297B,12651,13,14,1,43,47,2197
20238,20238,538631A6190277898984781481DE297B,42091,14,23,9,43,46,2196
20239,20239,4CCA51CA034FB7B0EC31A2469527D4D6,11021,4,7,3,36,49,1849
20240,20240,4CCA51CA034FB7B0EC31A2469527D4D6,40171,8,16,8,38,48,1948
20241,20241,4CCA51CA034FB7B0EC31A2469527D4D6,11021,17,23,6,36,49,1849
20266,20266,E16EBF9DB1B661AB3BA331BB1570A330,12491,0,4,4,36,43,1843
20267,20267,E16EBF9DB1B661AB3BA331BB1570A330,42861,9,10,1,37,44,1894
20268,20268,E16EBF9DB1B661AB3BA331BB1570A330,43451,14,17,3,37,40,1890
20269,20269,E16EBF9DB1B661AB3BA331BB1570A330,12491,19,23,4,36,43,1843
20276,20276,2A299573B8ADE5EDDBBA5F82D87A0B34,13601,1,13,12,34,47,1747
20277,20277,2A299573B8ADE5EDDBBA5F82D87A0B34,42921,15,16,1,33,47,1697
20278,20278,2A299573B8ADE5EDDBBA5F82D87A0B34,13601,16,19,3,34,47,1747
20279,20279,2A299573B8ADE5EDDBBA5F82D87A0B34,42921,19,23,4,33,47,1697
20283,20283,BAE761F181336B6EFEB3593DBB531554,11331,0,13,13,37,48,1898
20284,20284,BAE761F181336B6EFEB3593DBB531554,42221,13,15,2,38,48,1948
20285,20285,BAE761F181336B6EFEB3593DBB531554,11911,17,19,2,37,48,1898
20297,20297,A8C0E319CF806B3860CE270F9D93D0BD,11531,0,5,5,34,49,1749
20298,20298,A8C0E319CF806B3860CE270F9D93D0BD,10724,8,16,8,32,48,1648
20299,20299,A8C0E319CF806B3860CE270F9D93D0BD,11531,19,22,3,34,49,1749
20300,20300,FA5E97B8E90C5A955BBD79C61D708804,10431,0,7,7,33,49,1699
20301,20301,FA5E97B8E90C5A955BBD79C61D708804,11561,11,15,4,32,49,1649
20302,20302,FA5E97B8E90C5A955BBD79C61D708804,10431,18,23,5,33,49,1699
20303,20303,04C024AD6716C59AEF71765CE69E1D56,10781,0,14,14,35,47,1797
20304,20304,04C024AD6716C59AEF71765CE69E1D56,42521,18,20,2,31,47,1597
20305,20305,04C024AD6716C59AEF71765CE69E1D56,10971,21,23,2,35,47,1797
20306,20306,084BF03A4036944C4343989334A067D3,13381,0,8,8,39,47,1997
20307,20307,084BF03A4036944C4343989334A067D3,11074,8,9,1,37,47,1897
20308,20308,084BF03A4036944C4343989334A067D3,13381,10,23,13,39,47,1997
20313,20313,A4BC16FDE84BA1A928A7C6E482678E7C,10634,0,11,11,27,45,1395
20314,20314,A4BC16FDE84BA1A928A7C6E482678E7C,10351,14,15,1,28,45,1445
20315,20315,A4BC16FDE84BA1A928A7C6E482678E7C,10634,15,19,4,27,45,1395
20326,20326,04FC279D8763FD0D52EBF8F599CB8F45,10121,0,8,8,36,49,1849
20327,20327,04FC279D8763FD0D52EBF8F599CB8F45,42511,9,19,10,37,47,1897
20328,20328,04FC279D8763FD0D52EBF8F599CB8F45,11021,19,23,4,36,49,1849
20334,20334,6D3D88C57BAED90EED5783D123F38AA1,10251,0,15,15,35,47,1797
20335,20335,6D3D88C57BAED90EED5783D123F38AA1,10901,18,19,1,35,48,1798
20336,20336,6D3D88C57BAED90EED5783D123F38AA1,10251,20,23,3,35,47,1797
20348,20348,AA1231BD9F0A305E6AC7CD5DF0C0F2A0,42301,0,13,13,36,47,1847
20349,20349,AA1231BD9F0A305E6AC7CD5DF0C0F2A0,10841,13,16,3,37,47,1897
20350,20350,AA1231BD9F0A305E6AC7CD5DF0C0F2A0,42301,18,22,4,36,47,1847
20351,20351,7FB0BECF94785662E7EDF31BC7377329,13101,0,4,4,40,47,2047
20352,20352,7FB0BECF94785662E7EDF31BC7377329,11481,9,10,1,41,48,2098
20353,20353,7FB0BECF94785662E7EDF31BC7377329,42281,12,13,1,40,48,2048
20354,20354,7FB0BECF94785662E7EDF31BC7377329,11481,17,22,5,41,48,2098
20355,20355,E4A99F1C3E7ED34FBD67066F6ADB6F92,12311,0,6,6,30,44,1544
20356,20356,E4A99F1C3E7ED34FBD67066F6ADB6F92,10301,6,11,5,31,45,1595
20357,20357,E4A99F1C3E7ED34FBD67066F6ADB6F92,12311,12,22,10,30,44,1544
20358,20358,320F0142A6A8D98142B47BD5D35CD593,42141,0,7,7,32,47,1647
20359,20359,320F0142A6A8D98142B47BD5D35CD593,42161,10,15,5,36,47,1847
20360,20360,320F0142A6A8D98142B47BD5D35CD593,43761,19,22,3,32,47,1647
20368,20368,C35FFF479AFA41CBA0BE0F746C2360BC,11875,0,13,13,30,46,1546
20369,20369,C35FFF479AFA41CBA0BE0F746C2360BC,12311,14,15,1,30,44,1544
20370,20370,C35FFF479AFA41CBA0BE0F746C2360BC,11875,20,23,3,30,46,1546
20376,20376,3922FD238DD5D48F7D9D1E9687F957C1,43161,0,11,11,35,47,1797
20377,20377,3922FD238DD5D48F7D9D1E9687F957C1,42021,15,17,2,33,47,1697
20378,20378,3922FD238DD5D48F7D9D1E9687F957C1,11861,19,22,3,32,47,1647
20379,20379,EAEFCB977DEDF23C1346736B36A6F67B,42351,0,5,5,38,45,1945
20380,20380,EAEFCB977DEDF23C1346736B36A6F67B,11261,8,10,2,36,46,1846
20381,20381,EAEFCB977DEDF23C1346736B36A6F67B,13911,12,15,3,39,46,1996
20382,20382,EAEFCB977DEDF23C1346736B36A6F67B,42231,15,23,8,37,46,1896
20383,20383,DFDD3FE0C2251404AC997151A5933E97,43761,5,13,8,32,47,1647
20384,20384,DFDD3FE0C2251404AC997151A5933E97,42523,16,18,2,31,47,1597
20385,20385,DFDD3FE0C2251404AC997151A5933E97,43761,19,20,1,32,47,1647
20386,20386,0A501EA010779C8F9EB8C2F8834C3F4F,10351,0,6,6,28,45,1445
20387,20387,0A501EA010779C8F9EB8C2F8834C3F4F,10301,6,7,1,31,45,1595
20388,20388,0A501EA010779C8F9EB8C2F8834C3F4F,10634,8,16,8,27,45,1395
20389,20389,0A501EA010779C8F9EB8C2F8834C3F4F,10351,17,23,6,28,45,1445
20395,20395,2344F6440A984E70584E8BA0FFAFD3F6,11541,0,9,9,35,49,1799
20396,20396,2344F6440A984E70584E8BA0FFAFD3F6,10221,12,13,1,34,49,1749
20397,20397,2344F6440A984E70584E8BA0FFAFD3F6,11021,14,23,9,36,49,1849
20398,20398,C56F88E442CA52D12F7DED656C94C0A5,42231,0,10,10,37,46,1896
20399,20399,C56F88E442CA52D12F7DED656C94C0A5,13911,13,14,1,39,46,1996
20400,20400,C56F88E442CA52D12F7DED656C94C0A5,42231,15,23,8,37,46,1896
20417,20417,737EEA850139715BDA79A2EDECCDCA7A,11261,0,5,5,36,46,1846
20418,20418,737EEA850139715BDA79A2EDECCDCA7A,42861,5,7,2,37,44,1894
20419,20419,737EEA850139715BDA79A2EDECCDCA7A,11261,10,15,5,36,46,1846
20420,20420,737EEA850139715BDA79A2EDECCDCA7A,42511,19,21,2,37,47,1897
20434,20434,916372516345A8080A54990615FD92CF,11481,0,1,1,41,48,2098
20435,20435,916372516345A8080A54990615FD92CF,13271,2,10,8,41,47,2097
20436,20436,916372516345A8080A54990615FD92CF,11481,10,17,7,41,48,2098
20437,20437,916372516345A8080A54990615FD92CF,13101,18,23,5,40,47,2047
20442,20442,A0B07DBD7CFEABE1E4A0E9444C496CF6,42271,0,3,3,40,47,2047
20443,20443,A0B07DBD7CFEABE1E4A0E9444C496CF6,13381,3,20,17,39,47,1997
20444,20444,A0B07DBD7CFEABE1E4A0E9444C496CF6,42271,20,23,3,40,47,2047
20452,20452,D746519213A28242D49759FCE6B0BCB4,19441,0,2,2,8,46,446
20453,20453,D746519213A28242D49759FCE6B0BCB4,42041,5,10,5,10,47,547
20454,20454,D746519213A28242D49759FCE6B0BCB4,19441,13,22,9,8,46,446
20459,20459,39B67DC39A8ED7B06231FF29E273DA57,13371,0,7,7,41,47,2097
20460,20460,39B67DC39A8ED7B06231FF29E273DA57,11074,8,13,5,37,47,1897
20461,20461,39B67DC39A8ED7B06231FF29E273DA57,13371,15,23,8,41,47,2097
20462,20462,14C205DF57BD0AA586E26BE4ED695846,42581,0,5,5,38,48,1948
20463,20463,14C205DF57BD0AA586E26BE4ED695846,10471,7,11,4,37,48,1898
20464,20464,14C205DF57BD0AA586E26BE4ED695846,42581,11,14,3,38,48,1948
20465,20465,14C205DF57BD0AA586E26BE4ED695846,11914,17,19,2,37,48,1898
20466,20466,08B76115004F6EB3AEFC7DEF1A1E7865,10251,0,10,10,35,47,1797
20467,20467,08B76115004F6EB3AEFC7DEF1A1E7865,42161,11,19,8,36,47,1847
20468,20468,08B76115004F6EB3AEFC7DEF1A1E7865,10251,20,22,2,35,47,1797
20469,20469,3C5BF8354C7B22C00BFA5438C070BC0F,13711,0,8,8,38,46,1946
20470,20470,3C5BF8354C7B22C00BFA5438C070BC0F,43241,8,11,3,36,46,1846
20471,20471,3C5BF8354C7B22C00BFA5438C070BC0F,13711,12,14,2,38,46,1946
20472,20472,3C5BF8354C7B22C00BFA5438C070BC0F,43241,15,19,4,36,46,1846
20476,20476,D96C351A2D3BF2CB9C84E8F01C9997B6,19904,0,6,6,9,44,494
20477,20477,D96C351A2D3BF2CB9C84E8F01C9997B6,19021,6,10,4,10,45,545
20478,20478,D96C351A2D3BF2CB9C84E8F01C9997B6,12641,10,23,13,10,43,543
20494,20494,ACFB892F60074737B9E0F9A496FA6823,42151,0,14,14,35,45,1795
20495,20495,ACFB892F60074737B9E0F9A496FA6823,42861,15,16,1,37,44,1894
20496,20496,ACFB892F60074737B9E0F9A496FA6823,42151,19,23,4,35,45,1795
20497,20497,8E56A2D7B8313A9FB3CAF238A13A9C29,11541,0,1,1,35,49,1799
20498,20498,8E56A2D7B8313A9FB3CAF238A13A9C29,11021,2,10,8,36,49,1849
20499,20499,8E56A2D7B8313A9FB3CAF238A13A9C29,11541,12,20,8,35,49,1799
20517,20517,7BB31A1D059FD6D88C054A61BB3B7FB1,42531,0,8,8,31,45,1595
20518,20518,7BB31A1D059FD6D88C054A61BB3B7FB1,10351,12,14,2,28,45,1445
20519,20519,7BB31A1D059FD6D88C054A61BB3B7FB1,42531,15,18,3,31,45,1595
20520,20520,B8DCAC0FC6FA981D871032E55C240C8E,11914,0,5,5,37,48,1898
20521,20521,B8DCAC0FC6FA981D871032E55C240C8E,42581,6,7,1,38,48,1948
20522,20522,B8DCAC0FC6FA981D871032E55C240C8E,11914,8,23,15,37,48,1898
20531,20531,B0DB1916CBE4951CF5091A191DB66ADA,13101,0,1,1,40,47,2047
20532,20532,B0DB1916CBE4951CF5091A191DB66ADA,13271,2,10,8,41,47,2097
20533,20533,B0DB1916CBE4951CF5091A191DB66ADA,13101,14,15,1,40,47,2047
20534,20534,B0DB1916CBE4951CF5091A191DB66ADA,12651,16,18,2,43,47,2197
20535,20535,09111B635170EC4072310ADB48522169,11021,0,14,14,36,49,1849
20536,20536,09111B635170EC4072310ADB48522169,40271,15,17,2,35,49,1799
20537,20537,09111B635170EC4072310ADB48522169,11021,19,23,4,36,49,1849
20545,20545,139E705FEB960DA0C2327BA21AC8A84C,11481,1,3,2,41,48,2098
20546,20546,139E705FEB960DA0C2327BA21AC8A84C,42271,4,19,15,40,47,2047
20547,20547,139E705FEB960DA0C2327BA21AC8A84C,13381,20,23,3,39,47,1997
20564,20564,246B9DA3EFDA0E64D291387D5A19302A,12641,4,5,1,10,43,543
20565,20565,246B9DA3EFDA0E64D291387D5A19302A,19931,5,12,7,7,43,393
20566,20566,246B9DA3EFDA0E64D291387D5A19302A,12641,13,19,6,10,43,543
20567,20567,CFCD9FFE1C722F184C3074182556F64A,11461,0,16,16,37,49,1899
20568,20568,CFCD9FFE1C722F184C3074182556F64A,11271,18,20,2,37,48,1898
20569,20569,CFCD9FFE1C722F184C3074182556F64A,11231,20,22,2,37,49,1899
20574,20574,A300EE82D3804DCD52238D1B3DB8649A,11074,0,8,8,37,47,1897
20575,20575,A300EE82D3804DCD52238D1B3DB8649A,11261,11,12,1,36,46,1846
20576,20576,A300EE82D3804DCD52238D1B3DB8649A,11074,16,23,7,37,47,1897
20577,20577,FE004681BB28BF06C917204F0243DDB4,10531,0,7,7,34,46,1746
20578,20578,FE004681BB28BF06C917204F0243DDB4,42161,8,9,1,36,47,1847
20579,20579,FE004681BB28BF06C917204F0243DDB4,10251,10,17,7,35,47,1797
20580,20580,FE004681BB28BF06C917204F0243DDB4,42161,20,23,3,36,47,1847
20585,20585,C1896697E8F9082F3C179E6CB902F84B,12871,2,3,1,22,33,1133
20586,20586,C1896697E8F9082F3C179E6CB902F84B,13141,5,14,9,23,30,1180
20587,20587,C1896697E8F9082F3C179E6CB902F84B,49181,17,20,3,21,31,1081
20588,20588,C1896697E8F9082F3C179E6CB902F84B,12871,20,22,2,22,33,1133
20589,20589,3B9989389C2FB72384F3330F9A990AB0,13911,0,1,1,39,46,1996
20590,20590,3B9989389C2FB72384F3330F9A990AB0,42351,1,7,6,38,45,1945
20591,20591,3B9989389C2FB72384F3330F9A990AB0,42231,7,20,13,37,46,1896
20592,20592,C113C3BFA8200BB19492C01042EDAB2E,10351,0,14,14,28,45,1445
20593,20593,C113C3BFA8200BB19492C01042EDAB2E,10634,15,16,1,27,45,1395
20594,20594,C113C3BFA8200BB19492C01042EDAB2E,10351,18,21,3,28,45,1445
20595,20595,565E911568BF499034CE3AB0C1F32A25,42231,0,14,14,37,46,1896
20596,20596,565E911568BF499034CE3AB0C1F32A25,42351,18,19,1,38,45,1945
20597,20597,565E911568BF499034CE3AB0C1F32A25,42231,21,23,2,37,46,1896
20598,20598,BE3AECD016F8A1FBFAF949C87F9A7762,19441,0,13,13,8,46,446
20599,20599,BE3AECD016F8A1FBFAF949C87F9A7762,42041,15,16,1,10,47,547
20600,20600,BE3AECD016F8A1FBFAF949C87F9A7762,19441,18,21,3,8,46,446
20601,20601,BE3AECD016F8A1FBFAF949C87F9A7762,42041,21,23,2,10,47,547
20602,20602,9D0C016FAC9B03B23F695C0F283D602D,11914,5,7,2,37,48,1898
20603,20603,9D0C016FAC9B03B23F695C0F283D602D,42581,11,15,4,38,48,1948
20604,20604,9D0C016FAC9B03B23F695C0F283D602D,11914,18,22,4,37,48,1898
20619,20619,C6A8E88AF4FAB8E3B900B709C1644500,42021,0,7,7,33,47,1697
20620,20620,C6A8E88AF4FAB8E3B900B709C1644500,10411,16,17,1,36,48,1848
20621,20621,C6A8E88AF4FAB8E3B900B709C1644500,10251,20,22,2,35,47,1797
20625,20625,44A1B2095028F2B1D6198AB3D390B206,11061,0,13,13,29,48,1498
20626,20626,44A1B2095028F2B1D6198AB3D390B206,43971,13,17,4,30,48,1548
20627,20627,44A1B2095028F2B1D6198AB3D390B206,11061,17,22,5,29,48,1498
20633,20633,3FBA130DE96D19DDB92B7C1710211CF0,10611,0,7,7,32,48,1648
20634,20634,3FBA130DE96D19DDB92B7C1710211CF0,10251,7,10,3,35,47,1797
20635,20635,3FBA130DE96D19DDB92B7C1710211CF0,10611,13,23,10,32,48,1648
20636,20636,90B0E217395AF7C30211514D28752EB6,11061,7,8,1,29,48,1498
20637,20637,90B0E217395AF7C30211514D28752EB6,11151,8,17,9,30,48,1548
20638,20638,90B0E217395AF7C30211514D28752EB6,11381,18,19,1,30,47,1547
20639,20639,90B0E217395AF7C30211514D28752EB6,11151,20,22,2,30,48,1548
20662,20662,AFF2B1944207762129EB0E25C3502ADB,13711,0,10,10,38,46,1946
20663,20663,AFF2B1944207762129EB0E25C3502ADB,11941,11,12,1,37,46,1896
20664,20664,AFF2B1944207762129EB0E25C3502ADB,13711,14,20,6,38,46,1946
20665,20665,8420BC80E057341A3D646D0572754A34,11074,0,7,7,37,47,1897
20666,20666,8420BC80E057341A3D646D0572754A34,12083,12,13,1,36,49,1849
20667,20667,8420BC80E057341A3D646D0572754A34,11074,18,20,2,37,47,1897
20668,20668,895085FE0B62D7BCDF8725B5DB48E546,42521,0,14,14,31,47,1597
20669,20669,895085FE0B62D7BCDF8725B5DB48E546,11381,14,15,1,30,47,1547
20670,20670,895085FE0B62D7BCDF8725B5DB48E546,11061,16,22,6,29,48,1498
20671,20671,B3D9D8E72FD92A77A76B6490766A3C36,19114,1,2,1,7,43,393
20672,20672,B3D9D8E72FD92A77A76B6490766A3C36,12641,5,7,2,10,43,543
20673,20673,B3D9D8E72FD92A77A76B6490766A3C36,19114,10,21,11,7,43,393
20674,20674,47F2C03C91E1D89BDD89B2581C85F965,42321,0,1,1,43,47,2197
20675,20675,47F2C03C91E1D89BDD89B2581C85F965,11701,2,8,6,43,48,2198
20676,20676,47F2C03C91E1D89BDD89B2581C85F965,42321,10,21,11,43,47,2197
20677,20677,2D7ACF8AD7E4B49F2A7FD23DB75DC6F1,42971,0,6,6,43,49,2199
20678,20678,2D7ACF8AD7E4B49F2A7FD23DB75DC6F1,11741,8,9,1,42,49,2149
20679,20679,2D7ACF8AD7E4B49F2A7FD23DB75DC6F1,42971,12,23,11,43,49,2199
20685,20685,E4C6AC1011BAABFAC606344007830EAF,11861,0,9,9,32,47,1647
20686,20686,E4C6AC1011BAABFAC606344007830EAF,11381,10,12,2,30,47,1547
20687,20687,E4C6AC1011BAABFAC606344007830EAF,11861,13,14,1,32,47,1647
20688,20688,E4C6AC1011BAABFAC606344007830EAF,11381,17,19,2,30,47,1547
20689,20689,DE4C0B316DF5DF13453EB34FBFEEFD72,13511,0,9,9,34,48,1748
20690,20690,DE4C0B316DF5DF13453EB34FBFEEFD72,40951,10,19,9,36,49,1849
20691,20691,DE4C0B316DF5DF13453EB34FBFEEFD72,11751,19,21,2,35,48,1798
20696,20696,EC3702B6D1EF3E2036629A2FF6DCF74A,43761,1,18,17,32,47,1647
20697,20697,EC3702B6D1EF3E2036629A2FF6DCF74A,42021,18,19,1,33,47,1697
20698,20698,EC3702B6D1EF3E2036629A2FF6DCF74A,43761,20,21,1,32,47,1647
20699,20699,ECD1768E70E5706355D045A9A7240640,42141,1,5,4,32,47,1647
20700,20700,ECD1768E70E5706355D045A9A7240640,42521,7,8,1,31,47,1597
20701,20701,ECD1768E70E5706355D045A9A7240640,43761,8,23,15,32,47,1647
20702,20702,E56B98C0AC63789B55BFF8C5158D18DC,10341,0,14,14,31,47,1597
20703,20703,E56B98C0AC63789B55BFF8C5158D18DC,11861,14,17,3,32,47,1647
20704,20704,E56B98C0AC63789B55BFF8C5158D18DC,10341,18,23,5,31,47,1597
20705,20705,ED765AC07D21387339B2A29ECDD013E0,10251,0,7,7,35,47,1797
20706,20706,ED765AC07D21387339B2A29ECDD013E0,11531,7,15,8,34,49,1749
20707,20707,ED765AC07D21387339B2A29ECDD013E0,11541,17,19,2,35,49,1799
20716,20716,5FB7FCDE8733B3DE0082FB61D42FC13D,13941,0,7,7,41,47,2097
20717,20717,5FB7FCDE8733B3DE0082FB61D42FC13D,42321,8,20,12,43,47,2197
20718,20718,5FB7FCDE8733B3DE0082FB61D42FC13D,11001,22,23,1,42,47,2147
20719,20719,F4D1CACDA44EA0B56E4022B1E4015F81,11261,0,16,16,36,46,1846
20720,20720,F4D1CACDA44EA0B56E4022B1E4015F81,42351,17,19,2,38,45,1945
20721,20721,F4D1CACDA44EA0B56E4022B1E4015F81,42511,19,23,4,37,47,1897
20732,20732,CCAA623A39508D04DCE98490576D39EC,11021,0,8,8,36,49,1849
20733,20733,CCAA623A39508D04DCE98490576D39EC,11541,12,16,4,35,49,1799
20734,20734,CCAA623A39508D04DCE98490576D39EC,11211,17,22,5,34,49,1749
20760,20760,6DFA48F81EF42083077B44FC80706865,43731,1,7,6,34,47,1747
20761,20761,6DFA48F81EF42083077B44FC80706865,10161,8,16,8,35,49,1799
20762,20762,6DFA48F81EF42083077B44FC80706865,13511,18,19,1,34,48,1748
20763,20763,2F3FBE39EE4E3AB748593134D6A2A772,42231,0,5,5,37,46,1896
20764,20764,2F3FBE39EE4E3AB748593134D6A2A772,42351,6,11,5,38,45,1945
20765,20765,2F3FBE39EE4E3AB748593134D6A2A772,42231,12,14,2,37,46,1896
20766,20766,2F3FBE39EE4E3AB748593134D6A2A772,42351,15,19,4,38,45,1945
20770,20770,ABC9186267E71F28FA785B0F903DDD72,10471,5,10,5,37,48,1898
20771,20771,ABC9186267E71F28FA785B0F903DDD72,11811,10,11,1,38,49,1949
20772,20772,ABC9186267E71F28FA785B0F903DDD72,10471,14,21,7,37,48,1898
20773,20773,0AE1F060A9917578AF6CC39BEF4A5FD7,11074,1,6,5,37,47,1897
20774,20774,0AE1F060A9917578AF6CC39BEF4A5FD7,10371,9,18,9,37,49,1899
20775,20775,0AE1F060A9917578AF6CC39BEF4A5FD7,11074,21,23,2,37,47,1897
20781,20781,350909571DAF40BC1326F0871B6F4AC2,42371,0,6,6,34,46,1746
20782,20782,350909571DAF40BC1326F0871B6F4AC2,10341,11,12,1,31,47,1597
20783,20783,350909571DAF40BC1326F0871B6F4AC2,12131,14,16,2,32,47,1647
20784,20784,350909571DAF40BC1326F0871B6F4AC2,42371,18,23,5,34,46,1746
20785,20785,C7E598BFED6FB574843E537970B28C08,11151,5,15,10,30,48,1548
20786,20786,C7E598BFED6FB574843E537970B28C08,43391,17,19,2,29,48,1498
20787,20787,C7E598BFED6FB574843E537970B28C08,11151,19,20,1,30,48,1548
20798,20798,5477DAEBD0FCFC2099E2393C03601EFB,40673,0,8,8,36,48,1848
20799,20799,5477DAEBD0FCFC2099E2393C03601EFB,12021,14,15,1,37,49,1899
20800,20800,5477DAEBD0FCFC2099E2393C03601EFB,40673,16,17,1,36,48,1848
20801,20801,5477DAEBD0FCFC2099E2393C03601EFB,11331,18,23,5,37,48,1898
20802,20802,32809330ABBE3BDC7EDF41259F0307C9,12083,3,5,2,36,49,1849
20803,20803,32809330ABBE3BDC7EDF41259F0307C9,11231,7,9,2,37,49,1899
20804,20804,32809330ABBE3BDC7EDF41259F0307C9,10651,11,23,12,36,49,1849
20805,20805,5A1FB078DC3D794E4EC9A5B5577C84F5,10111,1,8,7,37,47,1897
20806,20806,5A1FB078DC3D794E4EC9A5B5577C84F5,13681,8,9,1,38,47,1947
20807,20807,5A1FB078DC3D794E4EC9A5B5577C84F5,10111,12,23,11,37,47,1897
20808,20808,64BD805F6D9361B926D90DA2610BBB4F,12921,0,6,6,9,41,491
20809,20809,64BD805F6D9361B926D90DA2610BBB4F,49201,8,10,2,7,41,391
20810,20810,64BD805F6D9361B926D90DA2610BBB4F,12921,12,23,11,9,41,491
20811,20811,1CE5F4D10EE2FB173CB9F2BC0746661A,42531,0,11,11,31,45,1595
20812,20812,1CE5F4D10EE2FB173CB9F2BC0746661A,12311,15,18,3,30,44,1544
20813,20813,1CE5F4D10EE2FB173CB9F2BC0746661A,42531,19,20,1,31,45,1595
20814,20814,1CE5F4D10EE2FB173CB9F2BC0746661A,12311,20,21,1,30,44,1544
20815,20815,09B258FCC1A04CEAAFFB93000EF42A6F,13231,0,6,6,39,46,1996
20816,20816,09B258FCC1A04CEAAFFB93000EF42A6F,11074,6,11,5,37,47,1897
20817,20817,09B258FCC1A04CEAAFFB93000EF42A6F,13231,13,14,1,39,46,1996
20818,20818,09B258FCC1A04CEAAFFB93000EF42A6F,10601,17,22,5,39,47,1997
20826,20826,E259E36EE859D4C4C9374127A836D38A,10171,0,10,10,26,47,1347
20827,20827,E259E36EE859D4C4C9374127A836D38A,12601,13,14,1,25,47,1297
20828,20828,E259E36EE859D4C4C9374127A836D38A,10171,14,23,9,26,47,1347
20829,20829,62DDFD12FD80957CA0268CDDC1A48DA2,11151,0,15,15,30,48,1548
20830,20830,62DDFD12FD80957CA0268CDDC1A48DA2,11061,17,18,1,29,48,1498
20831,20831,62DDFD12FD80957CA0268CDDC1A48DA2,11151,20,23,3,30,48,1548
20838,20838,394B81CC36B31D897120A6153D7C1457,11061,0,2,2,29,48,1498
20839,20839,394B81CC36B31D897120A6153D7C1457,12121,6,15,9,29,47,1497
20840,20840,394B81CC36B31D897120A6153D7C1457,11061,16,19,3,29,48,1498
20841,20841,394B81CC36B31D897120A6153D7C1457,11151,19,20,1,30,48,1548
20842,20842,303626C6E95A1B9EBF7351AEEA69D0DF,10821,0,10,10,40,47,2047
20843,20843,303626C6E95A1B9EBF7351AEEA69D0DF,13011,12,14,2,39,47,1997
20844,20844,303626C6E95A1B9EBF7351AEEA69D0DF,13841,21,22,1,40,46,2046
20845,20845,185D56D388FE8A96E07F52D610C68C9B,12514,0,8,8,38,47,1947
20846,20846,185D56D388FE8A96E07F52D610C68C9B,11074,11,16,5,37,47,1897
20847,20847,185D56D388FE8A96E07F52D610C68C9B,12514,18,23,5,38,47,1947
20848,20848,06DA10A5127707E5C949D4A6A9073869,10301,0,14,14,31,45,1595
20849,20849,06DA10A5127707E5C949D4A6A9073869,12311,15,16,1,30,44,1544
20850,20850,06DA10A5127707E5C949D4A6A9073869,42531,16,23,7,31,45,1595
20851,20851,80D61A8862AE6C2B33986072BBFE37A1,42941,0,7,7,37,47,1897
20852,20852,80D61A8862AE6C2B33986072BBFE37A1,42301,8,17,9,36,47,1847
20853,20853,80D61A8862AE6C2B33986072BBFE37A1,11074,20,21,1,37,47,1897
20862,20862,9D5FAD2D946916458AB09D98B7F6CB85,11641,0,10,10,22,49,1149
20863,20863,9D5FAD2D946916458AB09D98B7F6CB85,42081,14,19,5,24,49,1249
20864,20864,9D5FAD2D946916458AB09D98B7F6CB85,11641,20,23,3,22,49,1149
20865,20865,0A026519DFB36EBDF50838029C8182A2,13741,0,16,16,37,49,1899
20866,20866,0A026519DFB36EBDF50838029C8182A2,11811,18,19,1,38,49,1949
20867,20867,0A026519DFB36EBDF50838029C8182A2,11231,20,23,3,37,49,1899
20868,20868,5AC2D6E8C66247063F49530DBE7AF221,10251,0,6,6,35,47,1797
20869,20869,5AC2D6E8C66247063F49530DBE7AF221,43731,6,8,2,34,47,1747
20870,20870,5AC2D6E8C66247063F49530DBE7AF221,10251,12,23,11,35,47,1797
20874,20874,70E50AA138C0538910E5623295B506D8,10601,1,2,1,39,47,1997
20875,20875,70E50AA138C0538910E5623295B506D8,42351,3,20,17,38,45,1945
20876,20876,70E50AA138C0538910E5623295B506D8,11261,20,21,1,36,46,1846
20881,20881,B9B3660EABE6D031242D915A3C01CD0E,11914,0,1,1,37,48,1898
20882,20882,B9B3660EABE6D031242D915A3C01CD0E,42581,2,17,15,38,48,1948
20883,20883,B9B3660EABE6D031242D915A3C01CD0E,11914,20,21,1,37,48,1898
20884,20884,B9B3660EABE6D031242D915A3C01CD0E,42581,22,23,1,38,48,1948
20885,20885,53D8E731DA65650E5B825C52CF592433,10221,1,11,10,34,49,1749
20886,20886,53D8E731DA65650E5B825C52CF592433,11751,13,17,4,35,48,1798
20887,20887,53D8E731DA65650E5B825C52CF592433,10431,18,19,1,33,49,1699
20888,20888,BDA85A3FC7D0CADE7856E29E49F9DA05,10251,0,8,8,35,47,1797
20889,20889,BDA85A3FC7D0CADE7856E29E49F9DA05,11331,10,11,1,37,48,1898
20890,20890,BDA85A3FC7D0CADE7856E29E49F9DA05,43731,12,23,11,34,47,1747
20901,20901,0C134BBDF0E747CDC722AF46574039EB,40123,0,7,7,38,47,1947
20902,20902,0C134BBDF0E747CDC722AF46574039EB,12511,9,12,3,39,47,1997
20903,20903,0C134BBDF0E747CDC722AF46574039EB,12514,13,23,10,38,47,1947
20937,20937,662B4DE10B5E46302328673CD9C61795,10111,0,7,7,37,47,1897
20938,20938,662B4DE10B5E46302328673CD9C61795,11491,8,17,9,36,47,1847
20939,20939,662B4DE10B5E46302328673CD9C61795,10111,18,23,5,37,47,1897
20950,20950,8E0D20320C5276BDD797BA6D65B9C51D,11074,0,7,7,37,47,1897
20951,20951,8E0D20320C5276BDD797BA6D65B9C51D,11231,8,18,10,37,49,1899
20952,20952,8E0D20320C5276BDD797BA6D65B9C51D,11074,19,23,4,37,47,1897
20953,20953,541F648F1B8E5FD6A32D32095FA2CB17,43581,0,6,6,33,48,1698
20954,20954,541F648F1B8E5FD6A32D32095FA2CB17,10471,7,20,13,37,48,1898
20955,20955,541F648F1B8E5FD6A32D32095FA2CB17,43581,21,23,2,33,48,1698
20956,20956,31CBC77871B7612C90BD0F8F8FF24A20,42321,0,5,5,43,47,2197
20957,20957,31CBC77871B7612C90BD0F8F8FF24A20,10801,6,10,4,42,47,2147
20958,20958,31CBC77871B7612C90BD0F8F8FF24A20,42321,12,20,8,43,47,2197
20959,20959,A6555ADD1FDD22671BB225447AB03AF9,19744,1,5,4,6,43,343
20960,20960,A6555ADD1FDD22671BB225447AB03AF9,12641,6,14,8,10,43,543
20961,20961,A6555ADD1FDD22671BB225447AB03AF9,19744,16,17,1,6,43,343
20962,20962,A6555ADD1FDD22671BB225447AB03AF9,12641,20,23,3,10,43,543
20963,20963,6208F04ACBBEEA201495DAD5BCF1C3B9,11381,0,7,7,30,47,1547
20964,20964,6208F04ACBBEEA201495DAD5BCF1C3B9,10951,10,12,2,29,48,1498
20965,20965,6208F04ACBBEEA201495DAD5BCF1C3B9,11381,15,22,7,30,47,1547
20971,20971,5D3AB87CDE152EA5E956E4DDC06AC59B,43361,0,16,16,38,48,1948
20972,20972,5D3AB87CDE152EA5E956E4DDC06AC59B,11914,16,18,2,37,48,1898
20973,20973,5D3AB87CDE152EA5E956E4DDC06AC59B,43361,19,23,4,38,48,1948
20974,20974,A955024C13C335C918DDAA4433DE2B4B,12514,0,13,13,38,47,1947
20975,20975,A955024C13C335C918DDAA4433DE2B4B,11074,16,17,1,37,47,1897
20976,20976,A955024C13C335C918DDAA4433DE2B4B,12514,21,22,1,38,47,1947
20977,20977,10B8A2D44211CACA01D59967B38E8576,10251,0,10,10,35,47,1797
20978,20978,10B8A2D44211CACA01D59967B38E8576,42161,10,16,6,36,47,1847
20979,20979,10B8A2D44211CACA01D59967B38E8576,10251,20,23,3,35,47,1797
20980,20980,017E7601FB9C9C3C9E5F1FE87B4C9BCD,42351,0,6,6,38,45,1945
20981,20981,017E7601FB9C9C3C9E5F1FE87B4C9BCD,42231,6,21,15,37,46,1896
20982,20982,017E7601FB9C9C3C9E5F1FE87B4C9BCD,13231,21,23,2,39,46,1996
20983,20983,9D1D6C8F3B399A8A61F31E1610AD3A2B,43731,8,10,2,34,47,1747
20984,20984,9D1D6C8F3B399A8A61F31E1610AD3A2B,10971,11,14,3,35,47,1797
20985,20985,9D1D6C8F3B399A8A61F31E1610AD3A2B,43731,15,16,1,34,47,1747
20986,20986,9D1D6C8F3B399A8A61F31E1610AD3A2B,10491,17,20,3,33,48,1698
20987,20987,7A8F9786100F8F4E166FF0614007C794,43761,8,9,1,32,47,1647
20988,20988,7A8F9786100F8F4E166FF0614007C794,42523,14,16,2,31,47,1597
20989,20989,7A8F9786100F8F4E166FF0614007C794,43761,17,18,1,32,47,1647
20990,20990,671FB010BDB8AB18F1C7C189D2A5B267,11875,1,5,4,30,46,1546
20991,20991,671FB010BDB8AB18F1C7C189D2A5B267,42871,10,15,5,30,45,1545
20992,20992,671FB010BDB8AB18F1C7C189D2A5B267,11871,20,21,1,29,46,1496
21008,21008,2D3B83C92B0AAE4695063FEE06A33C52,13371,0,9,9,41,47,2097
21009,21009,2D3B83C92B0AAE4695063FEE06A33C52,42511,12,14,2,37,47,1897
21010,21010,2D3B83C92B0AAE4695063FEE06A33C52,13371,15,23,8,41,47,2097
21015,21015,5E8BB1A9FDE1AFD08848003FB8A60E0E,40673,0,8,8,36,48,1848
21016,21016,5E8BB1A9FDE1AFD08848003FB8A60E0E,43731,11,17,6,34,47,1747
21017,21017,5E8BB1A9FDE1AFD08848003FB8A60E0E,40673,19,23,4,36,48,1848
21018,21018,95C3BB78DE416328BA70D50C2D75E645,43361,0,8,8,38,48,1948
21019,21019,95C3BB78DE416328BA70D50C2D75E645,10901,14,15,1,35,48,1798
21020,21020,95C3BB78DE416328BA70D50C2D75E645,12021,16,17,1,37,49,1899
21021,21021,95C3BB78DE416328BA70D50C2D75E645,43361,17,23,6,38,48,1948
21022,21022,2C6531D8CAACF4559C29978513C22EB6,13331,1,4,3,38,47,1947
21023,21023,2C6531D8CAACF4559C29978513C22EB6,13121,8,13,5,38,46,1946
21024,21024,2C6531D8CAACF4559C29978513C22EB6,42511,15,16,1,37,47,1897
21025,21025,2C6531D8CAACF4559C29978513C22EB6,13121,18,20,2,38,46,1946
21026,21026,89084C54499EDD168F6753B4E522A173,42581,0,11,11,38,48,1948
21027,21027,89084C54499EDD168F6753B4E522A173,11914,16,17,1,37,48,1898
21028,21028,89084C54499EDD168F6753B4E522A173,42581,18,22,4,38,48,1948
21029,21029,D27AD15B109272EBC96B3A5E9E02000F,13911,3,6,3,39,46,1996
21030,21030,D27AD15B109272EBC96B3A5E9E02000F,11261,8,10,2,36,46,1846
21031,21031,D27AD15B109272EBC96B3A5E9E02000F,13381,13,18,5,39,47,1997
21036,21036,2353E24278CC2C352AD768571A17B8C0,49201,9,13,4,7,41,391
21037,21037,2353E24278CC2C352AD768571A17B8C0,19181,15,16,1,8,40,440
21038,21038,2353E24278CC2C352AD768571A17B8C0,49201,18,19,1,7,41,391
21039,21039,2353E24278CC2C352AD768571A17B8C0,12921,21,23,2,9,41,491
21044,21044,445A90121514A82FCCD431DD3088A581,40637,0,5,5,36,47,1847
21045,21045,445A90121514A82FCCD431DD3088A581,11861,13,20,7,32,47,1647
21046,21046,445A90121514A82FCCD431DD3088A581,43731,21,22,1,34,47,1747
21047,21047,AE90EDC73CD3AB48171CB83F36609EE7,11914,0,6,6,37,48,1898
21048,21048,AE90EDC73CD3AB48171CB83F36609EE7,42581,6,8,2,38,48,1948
21049,21049,AE90EDC73CD3AB48171CB83F36609EE7,11914,12,23,11,37,48,1898
21050,21050,4515D69DA9DF7C67BD58AB71BAA57E58,10471,2,12,10,37,48,1898
21051,21051,4515D69DA9DF7C67BD58AB71BAA57E58,40171,13,15,2,38,48,1948
21052,21052,4515D69DA9DF7C67BD58AB71BAA57E58,11231,17,19,2,37,49,1899
21053,21053,4515D69DA9DF7C67BD58AB71BAA57E58,11331,19,22,3,37,48,1898
21059,21059,CA5A17D561EB9E25269F629C4481540B,19441,0,11,11,8,46,446
21060,21060,CA5A17D561EB9E25269F629C4481540B,42041,12,13,1,10,47,547
21061,21061,CA5A17D561EB9E25269F629C4481540B,19441,15,17,2,8,46,446
21062,21062,CA5A17D561EB9E25269F629C4481540B,42041,18,20,2,10,47,547
21063,21063,0FCC9992AE8D71AAE404BB0E597A281E,11861,0,5,5,32,47,1647
21064,21064,0FCC9992AE8D71AAE404BB0E597A281E,10221,6,18,12,34,49,1749
21065,21065,0FCC9992AE8D71AAE404BB0E597A281E,11861,19,23,4,32,47,1647
21075,21075,2D698F0A1356711606949EFF3DBD69C1,11151,0,1,1,30,48,1548
21076,21076,2D698F0A1356711606949EFF3DBD69C1,11061,1,15,14,29,48,1498
21077,21077,2D698F0A1356711606949EFF3DBD69C1,12971,16,17,1,32,48,1648
21078,21078,2D698F0A1356711606949EFF3DBD69C1,11151,18,23,5,30,48,1548
21085,21085,E4E76AD2D2D6C820B909ACF4B7D59874,42231,0,6,6,37,46,1896
21086,21086,E4E76AD2D2D6C820B909ACF4B7D59874,12391,6,17,11,36,49,1849
21087,21087,E4E76AD2D2D6C820B909ACF4B7D59874,10107,20,22,2,38,49,1949
21109,21109,F49185C5E99D83C9DDF9416C77837C12,12921,3,6,3,9,41,491
21110,21110,F49185C5E99D83C9DDF9416C77837C12,12641,10,11,1,10,43,543
21111,21111,F49185C5E99D83C9DDF9416C77837C12,12921,12,22,10,9,41,491
21118,21118,78C0E1E992CFF9ECB9C6D46D3E929FD4,12121,2,4,2,29,47,1497
21119,21119,78C0E1E992CFF9ECB9C6D46D3E929FD4,11381,4,14,10,30,47,1547
21120,21120,78C0E1E992CFF9ECB9C6D46D3E929FD4,12121,17,20,3,29,47,1497
21125,21125,535378523E09141D94880FBA59BB7297,42301,0,8,8,36,47,1847
21126,21126,535378523E09141D94880FBA59BB7297,10111,10,13,3,37,47,1897
21127,21127,535378523E09141D94880FBA59BB7297,42301,13,23,10,36,47,1847
21128,21128,A06465C33822DBAACCFCA67CF792360D,10295,0,6,6,30,47,1547
21129,21129,A06465C33822DBAACCFCA67CF792360D,42523,8,10,2,31,47,1597
21130,21130,A06465C33822DBAACCFCA67CF792360D,10295,11,17,6,30,47,1547
21131,21131,A06465C33822DBAACCFCA67CF792360D,42523,18,23,5,31,47,1597
21136,21136,D9FB9F3F4820A4EF951566780A770C45,11261,5,10,5,36,46,1846
21137,21137,D9FB9F3F4820A4EF951566780A770C45,11941,15,16,1,37,46,1896
21138,21138,D9FB9F3F4820A4EF951566780A770C45,11261,20,21,1,36,46,1846
21139,21139,245BF0AC713EC7539F599FEB41303CFA,42111,0,4,4,44,46,2246
21140,21140,245BF0AC713EC7539F599FEB41303CFA,42601,5,6,1,44,48,2248
21141,21141,245BF0AC713EC7539F599FEB41303CFA,42461,9,17,8,45,47,2297
21142,21142,245BF0AC713EC7539F599FEB41303CFA,42201,20,23,3,43,46,2196
21143,21143,54B4EB2C537A71A8952B3AD64B201E5B,11531,0,1,1,34,49,1749
21144,21144,54B4EB2C537A71A8952B3AD64B201E5B,11271,2,12,10,37,48,1898
21145,21145,54B4EB2C537A71A8952B3AD64B201E5B,11231,13,14,1,37,49,1899
21146,21146,54B4EB2C537A71A8952B3AD64B201E5B,11271,15,19,4,37,48,1898
21147,21147,294FB4B8E5D6BF128BF9CA2E5243FA86,10161,0,12,12,35,49,1799
21148,21148,294FB4B8E5D6BF128BF9CA2E5243FA86,13561,13,14,1,37,49,1899
21149,21149,294FB4B8E5D6BF128BF9CA2E5243FA86,10161,19,23,4,35,49,1799
21150,21150,7C98BDF484E2B085C51A4945E804FC0C,12491,0,1,1,36,43,1843
21151,21151,7C98BDF484E2B085C51A4945E804FC0C,42151,2,15,13,35,45,1795
21152,21152,7C98BDF484E2B085C51A4945E804FC0C,12491,15,16,1,36,43,1843
21153,21153,7C98BDF484E2B085C51A4945E804FC0C,42151,17,23,6,35,45,1795
21154,21154,E95F165D16579FC368229CB18D709B87,10841,1,6,5,37,47,1897
21155,21155,E95F165D16579FC368229CB18D709B87,11771,8,9,1,39,49,1999
21156,21156,E95F165D16579FC368229CB18D709B87,11074,12,23,11,37,47,1897
21165,21165,B7832DB383CB1E7DD6C87A81AAE89D66,11914,5,9,4,37,48,1898
21166,21166,B7832DB383CB1E7DD6C87A81AAE89D66,11074,12,13,1,37,47,1897
21167,21167,B7832DB383CB1E7DD6C87A81AAE89D66,11914,17,18,1,37,48,1898
21168,21168,B7832DB383CB1E7DD6C87A81AAE89D66,42221,19,21,2,38,48,1948
21169,21169,00ED2280FB2BEC22D8FB36F8A7AFB1A5,42791,1,7,6,35,45,1795
21170,21170,00ED2280FB2BEC22D8FB36F8A7AFB1A5,10271,12,13,1,37,46,1896
21171,21171,00ED2280FB2BEC22D8FB36F8A7AFB1A5,13121,13,18,5,38,46,1946
21175,21175,5E269639C787C5D2BDF7F359B5257597,13381,0,8,8,39,47,1997
21176,21176,5E269639C787C5D2BDF7F359B5257597,13111,9,10,1,42,46,2146
21177,21177,5E269639C787C5D2BDF7F359B5257597,11481,11,18,7,41,48,2098
21178,21178,5E269639C787C5D2BDF7F359B5257597,13381,19,23,4,39,47,1997
21188,21188,91F5FE0D3D589B1C3F17EE6C429002BA,19441,0,8,8,8,46,446
21189,21189,91F5FE0D3D589B1C3F17EE6C429002BA,19821,12,14,2,4,46,246
21190,21190,91F5FE0D3D589B1C3F17EE6C429002BA,19441,14,22,8,8,46,446
21220,21220,ECE0FA03A797FCAE4E058BD1C3356073,42401,0,14,14,36,47,1847
21221,21221,ECE0FA03A797FCAE4E058BD1C3356073,10111,14,16,2,37,47,1897
21222,21222,ECE0FA03A797FCAE4E058BD1C3356073,42161,18,23,5,36,47,1847
21231,21231,5E77C0EE7040581005F78B7A0C9D1D93,13371,1,9,8,41,47,2097
21232,21232,5E77C0EE7040581005F78B7A0C9D1D93,10841,12,13,1,37,47,1897
21233,21233,5E77C0EE7040581005F78B7A0C9D1D93,13371,15,18,3,41,47,2097
21239,21239,51B36D67A1ACB097C61E398C8B8124AC,10731,1,10,9,33,47,1697
21240,21240,51B36D67A1ACB097C61E398C8B8124AC,11861,12,15,3,32,47,1647
21241,21241,51B36D67A1ACB097C61E398C8B8124AC,10731,16,18,2,33,47,1697
21242,21242,51B36D67A1ACB097C61E398C8B8124AC,11861,20,23,3,32,47,1647
21243,21243,D9B0439F3B0C81F4C0A4571FAB2A3A71,42021,0,7,7,33,47,1697
21244,21244,D9B0439F3B0C81F4C0A4571FAB2A3A71,10151,10,12,2,34,47,1747
21245,21245,D9B0439F3B0C81F4C0A4571FAB2A3A71,42021,17,20,3,33,47,1697
21250,21250,31C99BE35DAA7CC1D9A6D662CA3683F3,41021,7,8,1,38,47,1947
21251,21251,31C99BE35DAA7CC1D9A6D662CA3683F3,10841,11,13,2,37,47,1897
21252,21252,31C99BE35DAA7CC1D9A6D662CA3683F3,42331,16,17,1,39,46,1996
21253,21253,31C99BE35DAA7CC1D9A6D662CA3683F3,10841,18,19,1,37,47,1897
21261,21261,D7B4DEFCB86C55D027A1210EEC02063B,11231,0,2,2,37,49,1899
21262,21262,D7B4DEFCB86C55D027A1210EEC02063B,10471,2,4,2,37,48,1898
21263,21263,D7B4DEFCB86C55D027A1210EEC02063B,11591,4,19,15,36,49,1849
21264,21264,D7B4DEFCB86C55D027A1210EEC02063B,11231,21,23,2,37,49,1899
21272,21272,E45B0EC44E00842EDD865C65A561543D,11791,0,8,8,38,49,1949
21273,21273,E45B0EC44E00842EDD865C65A561543D,10471,9,11,2,37,48,1898
21274,21274,E45B0EC44E00842EDD865C65A561543D,11231,14,16,2,37,49,1899
21275,21275,E45B0EC44E00842EDD865C65A561543D,10471,17,21,4,37,48,1898
21276,21276,D8B46FFCD15B641FB93B8219A29A7205,40673,1,7,6,36,48,1848
21277,21277,D8B46FFCD15B641FB93B8219A29A7205,10251,7,14,7,35,47,1797
21278,21278,D8B46FFCD15B641FB93B8219A29A7205,11751,19,20,1,35,48,1798
21279,21279,D8B46FFCD15B641FB93B8219A29A7205,10251,22,23,1,35,47,1797
21280,21280,3B86E1CB99F9A063FEA255A004EE193F,42864,0,4,4,38,44,1944
21281,21281,3B86E1CB99F9A063FEA255A004EE193F,11261,6,11,5,36,46,1846
21282,21282,3B86E1CB99F9A063FEA255A004EE193F,12211,11,12,1,41,44,2094
21283,21283,3B86E1CB99F9A063FEA255A004EE193F,11261,13,22,9,36,46,1846
21284,21284,0262D446D971791F20E3BB61298CD2A6,11074,0,14,14,37,47,1897
21285,21285,0262D446D971791F20E3BB61298CD2A6,12514,16,17,1,38,47,1947
21286,21286,0262D446D971791F20E3BB61298CD2A6,11074,21,23,2,37,47,1897
21292,21292,23380E5607B1F49422924115A0CC13E5,40343,0,15,15,24,49,1249
21293,21293,23380E5607B1F49422924115A0CC13E5,12601,16,17,1,25,47,1297
21294,21294,23380E5607B1F49422924115A0CC13E5,40343,18,21,3,24,49,1249
21295,21295,068D43900393EE5A7A41177B91FB82C0,43321,4,12,8,36,49,1849
21296,21296,068D43900393EE5A7A41177B91FB82C0,11531,15,16,1,34,49,1749
21297,21297,068D43900393EE5A7A41177B91FB82C0,42641,17,18,1,33,49,1699
21298,21298,9577C3E7EE21DEF21D939B8D53DB646D,42091,0,10,10,43,46,2196
21299,21299,9577C3E7EE21DEF21D939B8D53DB646D,42461,12,14,2,45,47,2297
21300,21300,9577C3E7EE21DEF21D939B8D53DB646D,42091,14,18,4,43,46,2196
21311,21311,9080DF503ACF0ABF3EAE58FF37C4563F,11061,0,1,1,29,48,1498
21312,21312,9080DF503ACF0ABF3EAE58FF37C4563F,10681,2,7,5,30,48,1548
21313,21313,9080DF503ACF0ABF3EAE58FF37C4563F,11061,7,22,15,29,48,1498
21327,21327,0E1208E76DAA7EDCAA41CA6CF6A73776,11381,0,6,6,30,47,1547
21328,21328,0E1208E76DAA7EDCAA41CA6CF6A73776,42521,6,7,1,31,47,1597
21329,21329,0E1208E76DAA7EDCAA41CA6CF6A73776,11381,9,22,13,30,47,1547
21330,21330,3DA516A8A81F26FB478665A477628F88,10331,0,10,10,39,46,1996
21331,21331,3DA516A8A81F26FB478665A477628F88,10111,10,17,7,37,47,1897
21332,21332,3DA516A8A81F26FB478665A477628F88,42861,21,22,1,37,44,1894
21333,21333,FAA3F795EAFB9E0592080667B1BA282F,11001,1,8,7,42,47,2147
21334,21334,FAA3F795EAFB9E0592080667B1BA282F,13941,10,15,5,41,47,2097
21335,21335,FAA3F795EAFB9E0592080667B1BA282F,11001,16,17,1,42,47,2147
21336,21336,FAA3F795EAFB9E0592080667B1BA282F,13941,18,22,4,41,47,2097
21337,21337,0F3B9D51ABEBD568D2353EE492F4DCAE,11914,0,7,7,37,48,1898
21338,21338,0F3B9D51ABEBD568D2353EE492F4DCAE,10931,7,13,6,41,48,2098
21339,21339,0F3B9D51ABEBD568D2353EE492F4DCAE,42581,15,17,2,38,48,1948
21340,21340,0F3B9D51ABEBD568D2353EE492F4DCAE,10471,20,23,3,37,48,1898
21341,21341,79B5754532E0B50E66F26F447FE8D896,13371,0,9,9,41,47,2097
21342,21342,79B5754532E0B50E66F26F447FE8D896,42511,13,14,1,37,47,1897
21343,21343,79B5754532E0B50E66F26F447FE8D896,13371,15,18,3,41,47,2097
21349,21349,B15DB8F603CFB397A54409016D7EC648,13101,0,10,10,40,47,2047
21350,21350,B15DB8F603CFB397A54409016D7EC648,40833,11,13,2,41,47,2097
21351,21351,B15DB8F603CFB397A54409016D7EC648,13101,13,23,10,40,47,2047
21371,21371,8E04CA34920941791B1B2D80E2E36134,43581,0,14,14,33,48,1698
21372,21372,8E04CA34920941791B1B2D80E2E36134,10151,15,16,1,34,47,1747
21373,21373,8E04CA34920941791B1B2D80E2E36134,10221,18,19,1,34,49,1749
21374,21374,CC6A63734928B4CD8F414AAB01241B9F,10611,0,7,7,32,48,1648
21375,21375,CC6A63734928B4CD8F414AAB01241B9F,11541,12,13,1,35,49,1799
21376,21376,CC6A63734928B4CD8F414AAB01241B9F,12381,13,23,10,32,48,1648
21380,21380,7D5000772E957DD3A483CE8963A15A13,11381,1,2,1,30,47,1547
21381,21381,7D5000772E957DD3A483CE8963A15A13,12121,3,5,2,29,47,1497
21382,21382,7D5000772E957DD3A483CE8963A15A13,11381,7,8,1,30,47,1547
21383,21383,7D5000772E957DD3A483CE8963A15A13,12121,13,21,8,29,47,1497
21384,21384,449E7811DCD6E8CD500501049B5A906E,13231,7,8,1,39,46,1996
21385,21385,449E7811DCD6E8CD500501049B5A906E,11261,12,13,1,36,46,1846
21386,21386,449E7811DCD6E8CD500501049B5A906E,13911,15,20,5,39,46,1996
21390,21390,12D74476F053068F7D2533ADA7E34270,11911,0,9,9,37,48,1898
21391,21391,12D74476F053068F7D2533ADA7E34270,11751,11,12,1,35,48,1798
21392,21392,12D74476F053068F7D2533ADA7E34270,40951,13,19,6,36,49,1849
21393,21393,12D74476F053068F7D2533ADA7E34270,11751,20,23,3,35,48,1798
21394,21394,9C017418D67328D93FD696E6655B46ED,11541,0,6,6,35,49,1799
21395,21395,9C017418D67328D93FD696E6655B46ED,11211,11,18,7,34,49,1749
21396,21396,9C017418D67328D93FD696E6655B46ED,11541,19,23,4,35,49,1799
21404,21404,BA4F4CAA9829C92A824ABAF2840F531D,11381,0,10,10,30,47,1547
21405,21405,BA4F4CAA9829C92A824ABAF2840F531D,42291,11,15,4,29,48,1498
21406,21406,BA4F4CAA9829C92A824ABAF2840F531D,13651,18,23,5,30,47,1547
21423,21423,780CF605B987CE4335E0B64DFA86ACBF,11921,4,8,4,38,48,1948
21424,21424,780CF605B987CE4335E0B64DFA86ACBF,10841,8,17,9,37,47,1897
21425,21425,780CF605B987CE4335E0B64DFA86ACBF,11921,19,20,1,38,48,1948
21426,21426,21214DF25ABBFE57C13DD19922691751,42351,0,7,7,38,45,1945
21427,21427,21214DF25ABBFE57C13DD19922691751,11261,9,17,8,36,46,1846
21428,21428,21214DF25ABBFE57C13DD19922691751,13231,20,21,1,39,46,1996
21429,21429,1F2EEABE111E8F6AD1CE439041F72B5B,13911,0,9,9,39,46,1996
21430,21430,1F2EEABE111E8F6AD1CE439041F72B5B,42231,9,11,2,37,46,1896
21431,21431,1F2EEABE111E8F6AD1CE439041F72B5B,13911,12,17,5,39,46,1996
21432,21432,1F2EEABE111E8F6AD1CE439041F72B5B,42231,20,22,2,37,46,1896
21453,21453,01308B72F71E3AACC045F922DA6CAE4D,43761,0,12,12,32,47,1647
21454,21454,01308B72F71E3AACC045F922DA6CAE4D,42523,15,18,3,31,47,1597
21455,21455,01308B72F71E3AACC045F922DA6CAE4D,43761,18,22,4,32,47,1647
21460,21460,6D0799AB0F55190F6E5F774F154A9036,11481,0,12,12,41,48,2098
21461,21461,6D0799AB0F55190F6E5F774F154A9036,13271,13,14,1,41,47,2097
21462,21462,6D0799AB0F55190F6E5F774F154A9036,11481,14,21,7,41,48,2098
21463,21463,03C19F5F9D7D397AE6E9F2FD16BA994D,10251,0,12,12,35,47,1797
21464,21464,03C19F5F9D7D397AE6E9F2FD16BA994D,10111,13,15,2,37,47,1897
21465,21465,03C19F5F9D7D397AE6E9F2FD16BA994D,10251,18,23,5,35,47,1797
21477,21477,363ABC5369066213B7FD2684B30F86B8,10901,4,5,1,35,48,1798
21478,21478,363ABC5369066213B7FD2684B30F86B8,12083,7,15,8,36,49,1849
21479,21479,363ABC5369066213B7FD2684B30F86B8,11231,16,18,2,37,49,1899
21480,21480,F2971C3C111263F217176C0D8DBD4C49,40981,0,6,6,34,47,1747
21481,21481,F2971C3C111263F217176C0D8DBD4C49,10691,6,13,7,33,48,1698
21482,21482,F2971C3C111263F217176C0D8DBD4C49,40981,18,23,5,34,47,1747
21483,21483,85CC46EAA805F4481ACB92E952F93867,42523,0,2,2,31,47,1597
21484,21484,85CC46EAA805F4481ACB92E952F93867,43761,3,16,13,32,47,1647
21485,21485,85CC46EAA805F4481ACB92E952F93867,11161,16,20,4,32,48,1648
21490,21490,56227FF845C9CE8AE284F46F05334346,10121,0,9,9,36,49,1849
21491,21491,56227FF845C9CE8AE284F46F05334346,10107,13,15,2,38,49,1949
21492,21492,56227FF845C9CE8AE284F46F05334346,10121,17,20,3,36,49,1849
21496,21496,6F881E54FD8247C10253271465BFC769,10111,0,6,6,37,47,1897
21497,21497,6F881E54FD8247C10253271465BFC769,42161,7,10,3,36,47,1847
21498,21498,6F881E54FD8247C10253271465BFC769,10111,11,23,12,37,47,1897
21499,21499,8FFDEB2573593D2EBFD07303D94AB87F,42321,0,13,13,43,47,2197
21500,21500,8FFDEB2573593D2EBFD07303D94AB87F,42601,14,15,1,44,48,2248
21501,21501,8FFDEB2573593D2EBFD07303D94AB87F,42321,18,23,5,43,47,2197
21507,21507,19B7F0CF3E3FD886B38254D17C1F93A2,10351,0,6,6,28,45,1445
21508,21508,19B7F0CF3E3FD886B38254D17C1F93A2,10301,8,20,12,31,45,1595
21509,21509,19B7F0CF3E3FD886B38254D17C1F93A2,12311,21,22,1,30,44,1544
21510,21510,8DE4D252DA36E1365B15A8E9C0F92CC0,11151,0,16,16,30,48,1548
21511,21511,8DE4D252DA36E1365B15A8E9C0F92CC0,10881,20,21,1,34,48,1748
21512,21512,8DE4D252DA36E1365B15A8E9C0F92CC0,11151,21,23,2,30,48,1548
21513,21513,60268F7A02ED65A28DFDDFCBD631880E,13911,0,8,8,39,46,1996
21514,21514,60268F7A02ED65A28DFDDFCBD631880E,42351,11,14,3,38,45,1945
21515,21515,60268F7A02ED65A28DFDDFCBD631880E,42231,18,19,1,37,46,1896
21526,21526,6C9F87F97828894A3D9997BC74B7CE79,11914,0,15,15,37,48,1898
21527,21527,6C9F87F97828894A3D9997BC74B7CE79,12511,17,19,2,39,47,1997
21528,21528,6C9F87F97828894A3D9997BC74B7CE79,11914,20,21,1,37,48,1898
21532,21532,5C1E344007445EDD24F7AADB0B6F633B,13711,10,16,6,38,46,1946
21533,21533,5C1E344007445EDD24F7AADB0B6F633B,42231,16,17,1,37,46,1896
21534,21534,5C1E344007445EDD24F7AADB0B6F633B,13711,17,23,6,38,46,1946
21538,21538,DE5F96E34E99D2F6A2C0DEB645C43B1D,42221,0,8,8,38,48,1948
21539,21539,DE5F96E34E99D2F6A2C0DEB645C43B1D,42271,13,19,6,40,47,2047
21540,21540,DE5F96E34E99D2F6A2C0DEB645C43B1D,42221,22,23,1,38,48,1948
21556,21556,6869A5F90DBC32E3AB5337DBC7DAA2BA,43951,0,10,10,49,41,2491
21557,21557,6869A5F90DBC32E3AB5337DBC7DAA2BA,13411,10,11,1,49,42,2492
21558,21558,6869A5F90DBC32E3AB5337DBC7DAA2BA,43951,11,18,7,49,41,2491
21559,21559,EFDF708B3D6E1EB3ABAC8382014FD78E,19441,7,11,4,8,46,446
21560,21560,EFDF708B3D6E1EB3ABAC8382014FD78E,42041,12,13,1,10,47,547
21561,21561,EFDF708B3D6E1EB3ABAC8382014FD78E,19441,16,20,4,8,46,446
21566,21566,9C2C2A9A5923C3E8476FE17BB2B155DD,19114,1,10,9,7,43,393
21567,21567,9C2C2A9A5923C3E8476FE17BB2B155DD,12641,14,19,5,10,43,543
21568,21568,9C2C2A9A5923C3E8476FE17BB2B155DD,19114,20,23,3,7,43,393
21569,21569,89C5F5C036761FD2C32F64BC4CDE2E5B,19441,0,8,8,8,46,446
21570,21570,89C5F5C036761FD2C32F64BC4CDE2E5B,19024,12,13,1,9,45,495
21571,21571,89C5F5C036761FD2C32F64BC4CDE2E5B,19621,14,18,4,5,46,296
21572,21572,1D51AC4BBFB933A632C5A69F521FA887,11861,0,16,16,32,47,1647
21573,21573,1D51AC4BBFB933A632C5A69F521FA887,42523,18,19,1,31,47,1597
21574,21574,1D51AC4BBFB933A632C5A69F521FA887,11861,19,23,4,32,47,1647
21591,21591,A0E96E8A9AD818FBF087A431E03695B8,11914,0,6,6,37,48,1898
21592,21592,A0E96E8A9AD818FBF087A431E03695B8,11021,8,17,9,36,49,1849
21593,21593,A0E96E8A9AD818FBF087A431E03695B8,40171,19,21,2,38,48,1948
21598,21598,656752102BA99654C7060CE5B2133D72,19114,0,5,5,7,43,393
21599,21599,656752102BA99654C7060CE5B2133D72,12921,6,17,11,9,41,491
21600,21600,656752102BA99654C7060CE5B2133D72,49201,17,19,2,7,41,391
21601,21601,656752102BA99654C7060CE5B2133D72,19114,21,22,1,7,43,393
21611,21611,612F18F83615AD18C521C0260D4FB623,11914,0,7,7,37,48,1898
21612,21612,612F18F83615AD18C521C0260D4FB623,12514,7,8,1,38,47,1947
21613,21613,612F18F83615AD18C521C0260D4FB623,11914,10,23,13,37,48,1898
21614,21614,2F8CA12038D8BFDAC42D43FF94213821,42381,0,5,5,39,41,1991
21615,21615,2F8CA12038D8BFDAC42D43FF94213821,43451,6,17,11,37,40,1890
21616,21616,2F8CA12038D8BFDAC42D43FF94213821,42381,19,21,2,39,41,1991
21617,21617,583602182C31C8E2D985404EA5592339,12641,4,6,2,10,43,543
21618,21618,583602182C31C8E2D985404EA5592339,12921,6,7,1,9,41,491
21619,21619,583602182C31C8E2D985404EA5592339,12641,11,13,2,10,43,543
21620,21620,583602182C31C8E2D985404EA5592339,12921,14,23,9,9,41,491
21621,21621,EB7EB6074C1F2A07A41462E31EDA6629,42161,0,15,15,36,47,1847
21622,21622,EB7EB6074C1F2A07A41462E31EDA6629,10111,15,18,3,37,47,1897
21623,21623,EB7EB6074C1F2A07A41462E31EDA6629,42161,21,23,2,36,47,1847
21646,21646,43DBEEA61839592A95FC32BC8064AB85,12921,1,9,8,9,41,491
21647,21647,43DBEEA61839592A95FC32BC8064AB85,12641,11,14,3,10,43,543
21648,21648,43DBEEA61839592A95FC32BC8064AB85,12921,14,21,7,9,41,491
21652,21652,DD628D137A372FD9F2379158E8EE3966,12921,8,10,2,9,41,491
21653,21653,DD628D137A372FD9F2379158E8EE3966,49201,12,14,2,7,41,391
21654,21654,DD628D137A372FD9F2379158E8EE3966,12921,18,23,5,9,41,491
21664,21664,F9709077B789E6394963CB5FEFC850BC,11541,0,5,5,35,49,1799
21665,21665,F9709077B789E6394963CB5FEFC850BC,13561,7,15,8,37,49,1899
21666,21666,F9709077B789E6394963CB5FEFC850BC,11541,17,21,4,35,49,1799
21667,21667,82F2B503E5C7E7DD72E2EFA0AEE5FAC9,10281,1,9,8,33,48,1698
21668,21668,82F2B503E5C7E7DD72E2EFA0AEE5FAC9,11861,12,21,9,32,47,1647
21669,21669,82F2B503E5C7E7DD72E2EFA0AEE5FAC9,10281,22,23,1,33,48,1698
21670,21670,EDBE9058BB0B28E0915A84395E9226D9,11261,0,3,3,36,46,1846
21671,21671,EDBE9058BB0B28E0915A84395E9226D9,42861,4,17,13,37,44,1894
21672,21672,EDBE9058BB0B28E0915A84395E9226D9,42351,19,20,1,38,45,1945
21683,21683,994BA369046D8B99F80604E02227FCEB,42581,4,8,4,38,48,1948
21684,21684,994BA369046D8B99F80604E02227FCEB,11914,10,12,2,37,48,1898
21685,21685,994BA369046D8B99F80604E02227FCEB,42581,12,14,2,38,48,1948
21686,21686,994BA369046D8B99F80604E02227FCEB,11914,18,19,1,37,48,1898
21687,21687,C8AE21C26108F7AFBD515ED916A6E09A,42511,0,6,6,37,47,1897
21688,21688,C8AE21C26108F7AFBD515ED916A6E09A,12514,8,10,2,38,47,1947
21689,21689,C8AE21C26108F7AFBD515ED916A6E09A,10841,11,22,11,37,47,1897
21693,21693,7B4E6126570CADEFC5C95EC455FF20E3,11914,0,3,3,37,48,1898
21694,21694,7B4E6126570CADEFC5C95EC455FF20E3,43361,6,7,1,38,48,1948
21695,21695,7B4E6126570CADEFC5C95EC455FF20E3,11914,11,13,2,37,48,1898
21696,21696,7B4E6126570CADEFC5C95EC455FF20E3,11921,14,21,7,38,48,1948
21697,21697,8868A050B2675F1D16135ACF47FD7E3C,12641,3,6,3,10,43,543
21698,21698,8868A050B2675F1D16135ACF47FD7E3C,19111,7,17,10,9,45,495
21699,21699,8868A050B2675F1D16135ACF47FD7E3C,12641,20,23,3,10,43,543
21700,21700,BC3507BB18C0A44FC993D8B041281F6D,42161,1,11,10,36,47,1847
21701,21701,BC3507BB18C0A44FC993D8B041281F6D,10251,13,14,1,35,47,1797
21702,21702,BC3507BB18C0A44FC993D8B041281F6D,10731,18,22,4,33,47,1697
21706,21706,D454F61AD8B5A1CBE1E15CE597E2F528,11231,0,1,1,37,49,1899
21707,21707,D454F61AD8B5A1CBE1E15CE597E2F528,42301,3,6,3,36,47,1847
21708,21708,D454F61AD8B5A1CBE1E15CE597E2F528,11231,10,20,10,37,49,1899
21709,21709,D454F61AD8B5A1CBE1E15CE597E2F528,11491,22,23,1,36,47,1847
21714,21714,4DB0308FEE808EB4AB25FA1D5CC2FE73,42861,1,14,13,37,44,1894
21715,21715,4DB0308FEE808EB4AB25FA1D5CC2FE73,11261,14,15,1,36,46,1846
21716,21716,4DB0308FEE808EB4AB25FA1D5CC2FE73,42861,15,18,3,37,44,1894
21717,21717,BA06C6DB1A8D5242DF18546BCDE19F8A,13371,0,9,9,41,47,2097
21718,21718,BA06C6DB1A8D5242DF18546BCDE19F8A,11481,10,11,1,41,48,2098
21719,21719,BA06C6DB1A8D5242DF18546BCDE19F8A,42511,12,14,2,37,47,1897
21720,21720,BA06C6DB1A8D5242DF18546BCDE19F8A,13371,15,22,7,41,47,2097
21721,21721,2ADCF428548E73CC98C7E324C7C8C16C,42491,0,17,17,32,46,1646
21722,21722,2ADCF428548E73CC98C7E324C7C8C16C,42523,18,19,1,31,47,1597
21723,21723,2ADCF428548E73CC98C7E324C7C8C16C,42491,20,23,3,32,46,1646
21727,21727,80138FAE3CC4EDD6A1DF29A745B18CFD,11381,0,6,6,30,47,1547
21728,21728,80138FAE3CC4EDD6A1DF29A745B18CFD,11061,9,12,3,29,48,1498
21729,21729,80138FAE3CC4EDD6A1DF29A745B18CFD,43971,17,23,6,30,48,1548
21734,21734,3C11AAC1DAEEEE7C2DD9DD7B05CE3445,42351,1,6,5,38,45,1945
21735,21735,3C11AAC1DAEEEE7C2DD9DD7B05CE3445,42861,9,10,1,37,44,1894
21736,21736,3C11AAC1DAEEEE7C2DD9DD7B05CE3445,11261,13,22,9,36,46,1846
21745,21745,79F70A1AE08CEE215DA71360DE1B25EA,42191,0,5,5,38,49,1949
21746,21746,79F70A1AE08CEE215DA71360DE1B25EA,42231,6,19,13,37,46,1896
21747,21747,79F70A1AE08CEE215DA71360DE1B25EA,42191,20,23,3,38,49,1949
21748,21748,EC0EA0E5DC4559A23C03B307390C139A,10151,0,12,12,34,47,1747
21749,21749,EC0EA0E5DC4559A23C03B307390C139A,42791,13,17,4,35,45,1795
21750,21750,EC0EA0E5DC4559A23C03B307390C139A,10151,17,23,6,34,47,1747
21751,21751,097F51FF25DE30ECA33BE9B5FC852205,11074,8,10,2,37,47,1897
21752,21752,097F51FF25DE30ECA33BE9B5FC852205,40421,13,14,1,37,48,1898
21753,21753,097F51FF25DE30ECA33BE9B5FC852205,10841,18,23,5,37,47,1897
21754,21754,7C65B4C3DAC3D5E794C50992FFD2B4B8,13071,0,4,4,41,41,2091
21755,21755,7C65B4C3DAC3D5E794C50992FFD2B4B8,43011,6,9,3,40,42,2042
21756,21756,7C65B4C3DAC3D5E794C50992FFD2B4B8,13071,11,13,2,41,41,2091
21757,21757,7C65B4C3DAC3D5E794C50992FFD2B4B8,13441,14,23,9,39,39,1989
21768,21768,24C52F5FD3AA43CF1A9BAB6BC0B1DF40,43161,0,1,1,35,47,1797
21769,21769,24C52F5FD3AA43CF1A9BAB6BC0B1DF40,42161,1,3,2,36,47,1847
21770,21770,24C52F5FD3AA43CF1A9BAB6BC0B1DF40,43731,4,9,5,34,47,1747
21771,21771,24C52F5FD3AA43CF1A9BAB6BC0B1DF40,42021,10,23,13,33,47,1697
21772,21772,CC04DF57CD476D56A9C2711AACC54374,11261,3,4,1,36,46,1846
21773,21773,CC04DF57CD476D56A9C2711AACC54374,42861,5,6,1,37,44,1894
21774,21774,CC04DF57CD476D56A9C2711AACC54374,11261,10,11,1,36,46,1846
21775,21775,CC04DF57CD476D56A9C2711AACC54374,42861,11,19,8,37,44,1894
21787,21787,1DD07CF7FD5B3CCCB4E85025836774E4,12841,0,7,7,37,47,1897
21788,21788,1DD07CF7FD5B3CCCB4E85025836774E4,11231,7,18,11,37,49,1899
21789,21789,1DD07CF7FD5B3CCCB4E85025836774E4,12841,19,21,2,37,47,1897
21790,21790,05286C4B5017A260B39768783F7D4555,42581,0,12,12,38,48,1948
21791,21791,05286C4B5017A260B39768783F7D4555,11914,15,18,3,37,48,1898
21792,21792,05286C4B5017A260B39768783F7D4555,42581,21,22,1,38,48,1948
21793,21793,E3950B228FF57BC4F70CD2EC3D90B5FF,13711,0,7,7,38,46,1946
21794,21794,E3950B228FF57BC4F70CD2EC3D90B5FF,42151,11,19,8,35,45,1795
21795,21795,E3950B228FF57BC4F70CD2EC3D90B5FF,13711,21,22,1,38,46,1946
21801,21801,CACCA958326BD145289AA6A855FE199B,43971,0,14,14,30,48,1548
21802,21802,CACCA958326BD145289AA6A855FE199B,11061,15,21,6,29,48,1498
21803,21803,CACCA958326BD145289AA6A855FE199B,43971,22,23,1,30,48,1548
21813,21813,58FF60972C1637520443DC5766A2AB67,13411,0,5,5,49,42,2492
21814,21814,58FF60972C1637520443DC5766A2AB67,43951,6,11,5,49,41,2491
21815,21815,58FF60972C1637520443DC5766A2AB67,13411,11,23,12,49,42,2492
21816,21816,D3F6CC79419CB8E677F2F17C3DF072CD,13121,0,13,13,38,46,1946
21817,21817,D3F6CC79419CB8E677F2F17C3DF072CD,13331,13,19,6,38,47,1947
21818,21818,D3F6CC79419CB8E677F2F17C3DF072CD,13121,20,23,3,38,46,1946
21824,21824,83B65A620AA8887006B94BCE755E769B,10634,0,3,3,27,45,1395
21825,21825,83B65A620AA8887006B94BCE755E769B,10351,4,5,1,28,45,1445
21826,21826,83B65A620AA8887006B94BCE755E769B,10634,6,23,17,27,45,1395
21827,21827,9B373D18DF465A949571C2DC4D46B6D8,10295,0,13,13,30,47,1547
21828,21828,9B373D18DF465A949571C2DC4D46B6D8,42523,15,16,1,31,47,1597
21829,21829,9B373D18DF465A949571C2DC4D46B6D8,10292,18,22,4,30,47,1547
21830,21830,AE64A3DFBE9C3342907BF204A8902B7B,12311,1,3,2,30,44,1544
21831,21831,AE64A3DFBE9C3342907BF204A8902B7B,42531,4,5,1,31,45,1595
21832,21832,AE64A3DFBE9C3342907BF204A8902B7B,12311,7,22,15,30,44,1544
21863,21863,D46D481AE4A1808392E89F68BF1C527D,11061,0,8,8,29,48,1498
21864,21864,D46D481AE4A1808392E89F68BF1C527D,40441,10,16,6,30,48,1548
21865,21865,D46D481AE4A1808392E89F68BF1C527D,11061,20,23,3,29,48,1498
21866,21866,A0C13743AF441FE8099AA940DA71C612,42581,0,10,10,38,48,1948
21867,21867,A0C13743AF441FE8099AA940DA71C612,11914,10,11,1,37,48,1898
21868,21868,A0C13743AF441FE8099AA940DA71C612,42581,14,16,2,38,48,1948
21869,21869,A0C13743AF441FE8099AA940DA71C612,11914,17,19,2,37,48,1898
21870,21870,D3440D1508561AD99BDA68DC5ADE94F2,42471,0,6,6,35,49,1799
21871,21871,D3440D1508561AD99BDA68DC5ADE94F2,13731,6,7,1,33,49,1699
21872,21872,D3440D1508561AD99BDA68DC5ADE94F2,11541,11,23,12,35,49,1799
21873,21873,4FA7E2AF35091649A8D61648BF92F5C0,42581,0,6,6,38,48,1948
21874,21874,4FA7E2AF35091649A8D61648BF92F5C0,10471,7,9,2,37,48,1898
21875,21875,4FA7E2AF35091649A8D61648BF92F5C0,42581,12,23,11,38,48,1948
21885,21885,25D7A02E36F2606193AA6545F1D088D2,19441,0,8,8,8,46,446
21886,21886,25D7A02E36F2606193AA6545F1D088D2,42041,11,13,2,10,47,547
21887,21887,25D7A02E36F2606193AA6545F1D088D2,19441,14,23,9,8,46,446
21891,21891,A6F4E0A14DDF72AB1602B3834CD2AC43,43361,1,2,1,38,48,1948
21892,21892,A6F4E0A14DDF72AB1602B3834CD2AC43,11914,5,14,9,37,48,1898
21893,21893,A6F4E0A14DDF72AB1602B3834CD2AC43,42581,15,16,1,38,48,1948
21894,21894,A6F4E0A14DDF72AB1602B3834CD2AC43,11914,19,22,3,37,48,1898
21895,21895,6901A2FA8A437D0930BD81153BA3CF2B,13341,6,8,2,44,45,2245
21896,21896,6901A2FA8A437D0930BD81153BA3CF2B,42631,8,19,11,43,45,2195
21897,21897,6901A2FA8A437D0930BD81153BA3CF2B,13341,20,22,2,44,45,2245
21898,21898,2FC158799FF19F821FBD3DC4EFE863DB,13551,7,9,2,45,38,2288
21899,21899,2FC158799FF19F821FBD3DC4EFE863DB,43101,13,16,3,46,40,2340
21900,21900,2FC158799FF19F821FBD3DC4EFE863DB,13551,18,20,2,45,38,2288
21901,21901,2FC158799FF19F821FBD3DC4EFE863DB,43101,20,23,3,46,40,2340
21906,21906,CF0E6F8B160D86156EE9F4AC4DCADB7E,19441,0,7,7,8,46,446
21907,21907,CF0E6F8B160D86156EE9F4AC4DCADB7E,42041,8,9,1,10,47,547
21908,21908,CF0E6F8B160D86156EE9F4AC4DCADB7E,19441,12,22,10,8,46,446
21912,21912,A4CBFA774BBCB1E081978588796288CA,10901,0,8,8,35,48,1798
21913,21913,A4CBFA774BBCB1E081978588796288CA,11231,8,18,10,37,49,1899
21914,21914,A4CBFA774BBCB1E081978588796288CA,10901,19,23,4,35,48,1798
21919,21919,790457C5143568F0FC168A94781493E9,19114,0,6,6,7,43,393
21920,21920,790457C5143568F0FC168A94781493E9,12641,7,9,2,10,43,543
21921,21921,790457C5143568F0FC168A94781493E9,19114,13,21,8,7,43,393
21931,21931,D830EADED353A151E570961C9E6F25C0,40034,0,6,6,32,48,1648
21932,21932,D830EADED353A151E570961C9E6F25C0,43581,10,11,1,33,48,1698
21933,21933,D830EADED353A151E570961C9E6F25C0,10431,12,13,1,33,49,1699
21934,21934,D830EADED353A151E570961C9E6F25C0,40034,14,23,9,32,48,1648
21935,21935,95159962DBA3C17E7D24FCA7DC4A0CD1,11351,0,6,6,36,48,1848
21936,21936,95159962DBA3C17E7D24FCA7DC4A0CD1,13121,6,10,4,38,46,1946
21937,21937,95159962DBA3C17E7D24FCA7DC4A0CD1,11351,13,23,10,36,48,1848
21964,21964,7800B608DDC2CCA996240A48CBEA17DD,42231,6,16,10,37,46,1896
21965,21965,7800B608DDC2CCA996240A48CBEA17DD,13911,16,18,2,39,46,1996
21966,21966,7800B608DDC2CCA996240A48CBEA17DD,42351,19,21,2,38,45,1945
21967,21967,27289575C2D71F6A39E74F86EA523847,12731,0,5,5,22,40,1140
21968,21968,27289575C2D71F6A39E74F86EA523847,13094,7,15,8,21,42,1092
21969,21969,27289575C2D71F6A39E74F86EA523847,12731,16,18,2,22,40,1140
21974,21974,FE289D23B7E617AD349A76499E85C77F,42021,1,13,12,33,47,1697
21975,21975,FE289D23B7E617AD349A76499E85C77F,10431,17,20,3,33,49,1699
21976,21976,FE289D23B7E617AD349A76499E85C77F,42021,20,23,3,33,47,1697
21980,21980,BD46F993BAF091448095C617023E59A4,10251,0,12,12,35,47,1797
21981,21981,BD46F993BAF091448095C617023E59A4,42161,12,14,2,36,47,1847
21982,21982,BD46F993BAF091448095C617023E59A4,10251,16,23,7,35,47,1797
21989,21989,63A1194DA67A916294F825B4249AD293,10841,0,3,3,37,47,1897
21990,21990,63A1194DA67A916294F825B4249AD293,42161,4,5,1,36,47,1847
21991,21991,63A1194DA67A916294F825B4249AD293,11261,8,16,8,36,46,1846
21992,21992,63A1194DA67A916294F825B4249AD293,42771,20,23,3,36,47,1847
21993,21993,7F73EEE1198B300F5190B9A740E251E3,12491,0,6,6,36,43,1843
21994,21994,7F73EEE1198B300F5190B9A740E251E3,11261,7,18,11,36,46,1846
21995,21995,7F73EEE1198B300F5190B9A740E251E3,12491,21,23,2,36,43,1843
21996,21996,2D8E9CCEB5B1B76AE08CCCDEE4B92809,19114,0,6,6,7,43,393
21997,21997,2D8E9CCEB5B1B76AE08CCCDEE4B92809,12641,6,10,4,10,43,543
21998,21998,2D8E9CCEB5B1B76AE08CCCDEE4B92809,19114,11,23,12,7,43,393
21999,21999,20790761AC932F5FB5C6E4B51978A3C8,11701,0,7,7,43,48,2198
22000,22000,20790761AC932F5FB5C6E4B51978A3C8,43061,7,11,4,43,46,2196
22001,22001,20790761AC932F5FB5C6E4B51978A3C8,11701,12,13,1,43,48,2198
22002,22002,20790761AC932F5FB5C6E4B51978A3C8,42091,13,23,10,43,46,2196
22003,22003,7F73A642AA11134206C46BA15C785E40,42491,0,7,7,32,46,1646
22004,22004,7F73A642AA11134206C46BA15C785E40,42521,8,10,2,31,47,1597
22005,22005,7F73A642AA11134206C46BA15C785E40,13651,11,19,8,30,47,1547
22006,22006,7F73A642AA11134206C46BA15C785E40,42521,20,23,3,31,47,1597
22007,22007,BE784774CC06FCA1412486B5B9B18C26,13121,4,8,4,38,46,1946
22008,22008,BE784774CC06FCA1412486B5B9B18C26,11941,8,10,2,37,46,1896
22009,22009,BE784774CC06FCA1412486B5B9B18C26,13711,15,21,6,38,46,1946
22010,22010,BE784774CC06FCA1412486B5B9B18C26,11941,21,22,1,37,46,1896
22011,22011,9E8454E3BE651FEBAAD2CFCFB76D7A82,42921,0,5,5,33,47,1697
22012,22012,9E8454E3BE651FEBAAD2CFCFB76D7A82,10221,8,10,2,34,49,1749
22013,22013,9E8454E3BE651FEBAAD2CFCFB76D7A82,42921,12,23,11,33,47,1697
22022,22022,1B45CE98856B1ECD98CE353A134B44E7,10471,0,13,13,37,48,1898
22023,22023,1B45CE98856B1ECD98CE353A134B44E7,11461,13,14,1,37,49,1899
22024,22024,1B45CE98856B1ECD98CE353A134B44E7,10471,19,23,4,37,48,1898
22039,22039,5ED8949BAC5CDF05EDA1019FB7CA4B17,42941,2,7,5,37,47,1897
22040,22040,5ED8949BAC5CDF05EDA1019FB7CA4B17,42301,7,13,6,36,47,1847
22041,22041,5ED8949BAC5CDF05EDA1019FB7CA4B17,10471,16,18,2,37,48,1898
22042,22042,5ED8949BAC5CDF05EDA1019FB7CA4B17,42301,20,23,3,36,47,1847
22051,22051,DD4D28FDBCFFE930AF28BD3956ED9308,11381,0,10,10,30,47,1547
22052,22052,DD4D28FDBCFFE930AF28BD3956ED9308,11831,11,15,4,32,45,1645
22053,22053,DD4D28FDBCFFE930AF28BD3956ED9308,11381,17,23,6,30,47,1547
22061,22061,54E9147B0F88496112EA8083546467E6,12311,0,7,7,30,44,1544
22062,22062,54E9147B0F88496112EA8083546467E6,12661,11,14,3,32,45,1645
22063,22063,54E9147B0F88496112EA8083546467E6,12311,18,19,1,30,44,1544
22070,22070,3D39BFF619D555933510C63A4C03CAF1,13121,0,8,8,38,46,1946
22071,22071,3D39BFF619D555933510C63A4C03CAF1,10191,14,16,2,40,48,2048
22072,22072,3D39BFF619D555933510C63A4C03CAF1,13121,19,23,4,38,46,1946
22082,22082,01AC0A4D33D82D8BBF22F99622A8A450,11921,0,7,7,38,48,1948
22083,22083,01AC0A4D33D82D8BBF22F99622A8A450,42511,9,10,1,37,47,1897
22084,22084,01AC0A4D33D82D8BBF22F99622A8A450,42221,12,19,7,38,48,1948
22088,22088,D36AEACA0F7F1CDCA98412CDD0F8BA1D,13941,1,12,11,41,47,2097
22089,22089,D36AEACA0F7F1CDCA98412CDD0F8BA1D,11001,16,17,1,42,47,2147
22090,22090,D36AEACA0F7F1CDCA98412CDD0F8BA1D,13941,21,23,2,41,47,2097
22099,22099,91EB59FA0D03DF92CD974EF6C6B73426,11381,0,18,18,30,47,1547
22100,22100,91EB59FA0D03DF92CD974EF6C6B73426,10951,19,21,2,29,48,1498
22101,22101,91EB59FA0D03DF92CD974EF6C6B73426,11381,21,23,2,30,47,1547
22108,22108,53493041487B5321836147FAAD536213,40833,4,6,2,41,47,2097
22109,22109,53493041487B5321836147FAAD536213,13101,6,12,6,40,47,2047
22110,22110,53493041487B5321836147FAAD536213,11074,17,19,2,37,47,1897
22111,22111,53493041487B5321836147FAAD536213,13101,21,22,1,40,47,2047
22118,22118,5A5B2CBA296E90D3798147AFE5312824,13741,0,7,7,37,49,1899
22119,22119,5A5B2CBA296E90D3798147AFE5312824,42471,13,15,2,35,49,1799
22120,22120,5A5B2CBA296E90D3798147AFE5312824,40637,15,17,2,36,47,1847
22121,22121,5A5B2CBA296E90D3798147AFE5312824,13561,17,23,6,37,49,1899
22122,22122,4C0B4AC61D24A3A943FEC75230408343,10381,3,12,9,31,49,1599
22123,22123,4C0B4AC61D24A3A943FEC75230408343,40094,14,15,1,29,48,1498
22124,22124,4C0B4AC61D24A3A943FEC75230408343,11151,18,19,1,30,48,1548
22125,22125,4C0B4AC61D24A3A943FEC75230408343,43391,21,22,1,29,48,1498
22126,22126,34FB5BF239A7B5016E3CA81F47968839,42161,0,8,8,36,47,1847
22127,22127,34FB5BF239A7B5016E3CA81F47968839,40961,9,10,1,35,47,1797
22128,22128,34FB5BF239A7B5016E3CA81F47968839,42161,12,22,10,36,47,1847
22133,22133,DB16C83E14F7FA231AAD22BBD75847C5,11381,0,18,18,30,47,1547
22134,22134,DB16C83E14F7FA231AAD22BBD75847C5,10681,19,21,2,30,48,1548
22135,22135,DB16C83E14F7FA231AAD22BBD75847C5,11381,21,23,2,30,47,1547
22146,22146,CED2E140B216F950F7D7F7935269042E,11541,0,17,17,35,49,1799
22147,22147,CED2E140B216F950F7D7F7935269042E,12021,18,21,3,37,49,1899
22148,22148,CED2E140B216F950F7D7F7935269042E,11541,21,23,2,35,49,1799
22160,22160,1E78C6812CC13AC596F7D7BD80A5DD70,11921,0,16,16,38,48,1948
22161,22161,1E78C6812CC13AC596F7D7BD80A5DD70,11074,17,19,2,37,47,1897
22162,22162,1E78C6812CC13AC596F7D7BD80A5DD70,12514,20,21,1,38,47,1947
22163,22163,1E78C6812CC13AC596F7D7BD80A5DD70,11914,22,23,1,37,48,1898
22164,22164,39E8FB5C4AE9A0E0783441178F244CD5,10341,0,14,14,31,47,1597
22165,22165,39E8FB5C4AE9A0E0783441178F244CD5,43761,15,16,1,32,47,1647
22166,22166,39E8FB5C4AE9A0E0783441178F244CD5,10341,16,20,4,31,47,1597
22167,22167,C27CAD921E0A90627C5337FD9A33D6C8,10721,0,8,8,31,48,1598
22168,22168,C27CAD921E0A90627C5337FD9A33D6C8,11875,12,13,1,30,46,1546
22169,22169,C27CAD921E0A90627C5337FD9A33D6C8,10281,13,17,4,33,48,1698
22170,22170,C27CAD921E0A90627C5337FD9A33D6C8,11861,17,22,5,32,47,1647
22176,22176,1D604F5710A9E4979C670CB3E8F5518A,11381,0,16,16,30,47,1547
22177,22177,1D604F5710A9E4979C670CB3E8F5518A,11431,16,18,2,29,47,1497
22178,22178,1D604F5710A9E4979C670CB3E8F5518A,11381,19,23,4,30,47,1547
22179,22179,F013124D9273BD657C510566C98EAA28,13651,1,13,12,30,47,1547
22180,22180,F013124D9273BD657C510566C98EAA28,42523,16,17,1,31,47,1597
22181,22181,F013124D9273BD657C510566C98EAA28,13651,18,20,2,30,47,1547
22182,22182,F013124D9273BD657C510566C98EAA28,42523,20,21,1,31,47,1597
22183,22183,C7B7BC9315B26F0822B647A376C0B876,43321,0,5,5,36,49,1849
22184,22184,C7B7BC9315B26F0822B647A376C0B876,11531,6,7,1,34,49,1749
22185,22185,C7B7BC9315B26F0822B647A376C0B876,11591,7,23,16,36,49,1849
22189,22189,81D5034BB335E907C610C1F19BE8547C,13371,0,17,17,41,47,2097
22190,22190,81D5034BB335E907C610C1F19BE8547C,11001,19,21,2,42,47,2147
22191,22191,81D5034BB335E907C610C1F19BE8547C,13941,21,23,2,41,47,2097
22201,22201,2FC430E1448F290A8E229F5C2301E320,49201,0,6,6,7,41,391
22202,22202,2FC430E1448F290A8E229F5C2301E320,12921,6,17,11,9,41,491
22203,22203,2FC430E1448F290A8E229F5C2301E320,49201,17,23,6,7,41,391
22213,22213,E253B2B9512D99ED8C10EBC79E0769EF,12601,0,15,15,25,47,1297
22214,22214,E253B2B9512D99ED8C10EBC79E0769EF,10501,18,19,1,22,46,1146
22215,22215,E253B2B9512D99ED8C10EBC79E0769EF,12601,22,23,1,25,47,1297
22221,22221,540311DE1F12F752C637697C87C1492F,43951,0,13,13,49,41,2491
22222,22222,540311DE1F12F752C637697C87C1492F,43101,14,15,1,46,40,2340
22223,22223,540311DE1F12F752C637697C87C1492F,43951,20,22,2,49,41,2491
22224,22224,40332F05BDDE464A3027D1BB9B325A5D,11541,0,9,9,35,49,1799
22225,22225,40332F05BDDE464A3027D1BB9B325A5D,11561,9,10,1,32,49,1649
22226,22226,40332F05BDDE464A3027D1BB9B325A5D,42471,11,20,9,35,49,1799
22231,22231,C328A2915A4792A71AC58E7C60675781,42581,0,3,3,38,48,1948
22232,22232,C328A2915A4792A71AC58E7C60675781,11271,6,12,6,37,48,1898
22233,22233,C328A2915A4792A71AC58E7C60675781,42961,15,17,2,35,49,1799
22234,22234,C328A2915A4792A71AC58E7C60675781,42581,21,22,1,38,48,1948
22240,22240,0DFD98C5BF618352145AEF64606DF221,40673,2,16,14,36,48,1848
22241,22241,0DFD98C5BF618352145AEF64606DF221,10251,17,19,2,35,47,1797
22242,22242,0DFD98C5BF618352145AEF64606DF221,40637,20,23,3,36,47,1847
22267,22267,7B27DF400F344F6F46338A9F907AAD49,19021,0,4,4,10,45,545
22268,22268,7B27DF400F344F6F46338A9F907AAD49,12641,7,16,9,10,43,543
22269,22269,7B27DF400F344F6F46338A9F907AAD49,19021,18,23,5,10,45,545
22274,22274,F776CF5BFCBAFE40EFE079BFD8CF34A4,19901,2,14,12,7,44,394
22275,22275,F776CF5BFCBAFE40EFE079BFD8CF34A4,12641,19,20,1,10,43,543
22276,22276,F776CF5BFCBAFE40EFE079BFD8CF34A4,19901,21,23,2,7,44,394
22282,22282,6CC24D921FE70D79D98FA5B7890BCB55,19441,0,9,9,8,46,446
22283,22283,6CC24D921FE70D79D98FA5B7890BCB55,42041,13,15,2,10,47,547
22284,22284,6CC24D921FE70D79D98FA5B7890BCB55,19441,16,20,4,8,46,446
22285,22285,6E3A482A59CE9925DB19971C6ACB206A,40171,1,3,2,38,48,1948
22286,22286,6E3A482A59CE9925DB19971C6ACB206A,10471,6,18,12,37,48,1898
22287,22287,6E3A482A59CE9925DB19971C6ACB206A,40171,18,23,5,38,48,1948
22288,22288,4E1126CD1AF86FC47E3B081AF053FA88,42141,0,11,11,32,47,1647
22289,22289,4E1126CD1AF86FC47E3B081AF053FA88,10341,12,14,2,31,47,1597
22290,22290,4E1126CD1AF86FC47E3B081AF053FA88,43761,17,22,5,32,47,1647
22313,22313,AA6D4A35F81446E34CB45D0775B9D6B5,11231,4,14,10,37,49,1899
22314,22314,AA6D4A35F81446E34CB45D0775B9D6B5,10471,14,16,2,37,48,1898
22315,22315,AA6D4A35F81446E34CB45D0775B9D6B5,11231,16,23,7,37,49,1899
22316,22316,2AAB25F761EC63DDE0112C998558BEA7,12561,0,6,6,45,43,2293
22317,22317,2AAB25F761EC63DDE0112C998558BEA7,43051,6,8,2,46,45,2345
22318,22318,2AAB25F761EC63DDE0112C998558BEA7,13341,10,23,13,44,45,2245
22329,22329,4A1082E29116D07A4EA830C32D0BE5ED,12221,0,7,7,43,44,2194
22330,22330,4A1082E29116D07A4EA830C32D0BE5ED,42631,7,9,2,43,45,2195
22331,22331,4A1082E29116D07A4EA830C32D0BE5ED,12221,12,23,11,43,44,2194
22332,22332,600D7AE0D829582E691D7BDBD387E918,19441,0,7,7,8,46,446
22333,22333,600D7AE0D829582E691D7BDBD387E918,42041,9,11,2,10,47,547
22334,22334,600D7AE0D829582E691D7BDBD387E918,19441,15,16,1,8,46,446
22335,22335,600D7AE0D829582E691D7BDBD387E918,19901,19,21,2,7,44,394
22336,22336,726D8BF6FE9D2B730CE8E7DD26F779CD,12121,1,4,3,29,47,1497
22337,22337,726D8BF6FE9D2B730CE8E7DD26F779CD,11381,5,7,2,30,47,1547
22338,22338,726D8BF6FE9D2B730CE8E7DD26F779CD,12121,7,15,8,29,47,1497
22339,22339,726D8BF6FE9D2B730CE8E7DD26F779CD,11381,17,18,1,30,47,1547
22360,22360,18961728F310462F7858ADF1FBEB29F6,40833,1,8,7,41,47,2097
22361,22361,18961728F310462F7858ADF1FBEB29F6,10801,8,10,2,42,47,2147
22362,22362,18961728F310462F7858ADF1FBEB29F6,13941,13,23,10,41,47,2097
22367,22367,51E47FDE51716EB36BE96125516194AB,11021,1,11,10,36,49,1849
22368,22368,51E47FDE51716EB36BE96125516194AB,12401,11,14,3,39,49,1999
22369,22369,51E47FDE51716EB36BE96125516194AB,11021,14,23,9,36,49,1849
22375,22375,C5265646F81D46CAFC774C63090EB008,11331,2,10,8,37,48,1898
22376,22376,C5265646F81D46CAFC774C63090EB008,10107,14,16,2,38,49,1949
22377,22377,C5265646F81D46CAFC774C63090EB008,11074,16,17,1,37,47,1897
22378,22378,C5265646F81D46CAFC774C63090EB008,11331,18,21,3,37,48,1898
22379,22379,7EBD3BA762C40F1F8A712F803B7D8FD3,42151,8,9,1,35,45,1795
22380,22380,7EBD3BA762C40F1F8A712F803B7D8FD3,12491,12,14,2,36,43,1843
22381,22381,7EBD3BA762C40F1F8A712F803B7D8FD3,42151,15,19,4,35,45,1795
22382,22382,7EBD3BA762C40F1F8A712F803B7D8FD3,12491,20,22,2,36,43,1843
22383,22383,181802B57A29F4FAE1E7EF60B334A9D5,11261,9,10,1,36,46,1846
22384,22384,181802B57A29F4FAE1E7EF60B334A9D5,42864,12,14,2,38,44,1944
22385,22385,181802B57A29F4FAE1E7EF60B334A9D5,11261,16,21,5,36,46,1846
22394,22394,692AC6DE13BF1FE0F43D1EA4E139D774,10841,2,4,2,37,47,1897
22395,22395,692AC6DE13BF1FE0F43D1EA4E139D774,13331,6,8,2,38,47,1947
22396,22396,692AC6DE13BF1FE0F43D1EA4E139D774,10841,14,20,6,37,47,1897
22397,22397,DAF070E37522449552E837969D087804,10691,0,6,6,33,48,1698
22398,22398,DAF070E37522449552E837969D087804,10471,6,18,12,37,48,1898
22399,22399,DAF070E37522449552E837969D087804,11171,19,23,4,33,48,1698
22406,22406,280A825D237E9CE7CB403628403E758B,42351,0,7,7,38,45,1945
22407,22407,280A825D237E9CE7CB403628403E758B,12511,12,13,1,39,47,1997
22408,22408,280A825D237E9CE7CB403628403E758B,11261,18,20,2,36,46,1846
22409,22409,81E9C3858C44D7DA57E9FCCB87C1B34F,10251,0,14,14,35,47,1797
22410,22410,81E9C3858C44D7DA57E9FCCB87C1B34F,11231,18,20,2,37,49,1899
22411,22411,81E9C3858C44D7DA57E9FCCB87C1B34F,11861,20,22,2,32,47,1647
22415,22415,2A8CA6F11C450B23235B353369F9B4CE,42221,3,10,7,38,48,1948
22416,22416,2A8CA6F11C450B23235B353369F9B4CE,11914,11,13,2,37,48,1898
22417,22417,2A8CA6F11C450B23235B353369F9B4CE,12514,18,21,3,38,47,1947
22418,22418,325F6E45B1DFC860919AE71795AA4212,11861,0,8,8,32,47,1647
22419,22419,325F6E45B1DFC860919AE71795AA4212,10341,12,13,1,31,47,1597
22420,22420,325F6E45B1DFC860919AE71795AA4212,11861,18,23,5,32,47,1647
22430,22430,17A0B3FB3065726B16826025ECADE143,42623,1,10,9,22,49,1149
22431,22431,17A0B3FB3065726B16826025ECADE143,42081,14,15,1,24,49,1249
22432,22432,17A0B3FB3065726B16826025ECADE143,42623,16,23,7,22,49,1149
22437,22437,8C29E031FB5956E038F5FE7083F4864A,42861,3,5,2,37,44,1894
22438,22438,8C29E031FB5956E038F5FE7083F4864A,11261,9,12,3,36,46,1846
22439,22439,8C29E031FB5956E038F5FE7083F4864A,42861,17,19,2,37,44,1894
22440,22440,8C29E031FB5956E038F5FE7083F4864A,11261,19,20,1,36,46,1846
22441,22441,C6869A64CA9EF97A25D7192A00726FC2,10111,1,9,8,37,47,1897
22442,22442,C6869A64CA9EF97A25D7192A00726FC2,10781,10,16,6,35,47,1797
22443,22443,C6869A64CA9EF97A25D7192A00726FC2,40637,18,23,5,36,47,1847
22461,22461,E1C859FD8CC74565ED07635B54DBAB6A,43761,0,6,6,32,47,1647
22462,22462,E1C859FD8CC74565ED07635B54DBAB6A,11061,6,12,6,29,48,1498
22463,22463,E1C859FD8CC74565ED07635B54DBAB6A,43761,13,23,10,32,47,1647
22464,22464,0DD480B5A13E261C7A404CA1C7C938C6,13121,1,12,11,38,46,1946
22465,22465,0DD480B5A13E261C7A404CA1C7C938C6,42511,12,16,4,37,47,1897
22466,22466,0DD480B5A13E261C7A404CA1C7C938C6,13121,19,22,3,38,46,1946
22475,22475,DFD8BF631C440547C60772DE9273FCD9,42221,2,11,9,38,48,1948
22476,22476,DFD8BF631C440547C60772DE9273FCD9,12514,16,17,1,38,47,1947
22477,22477,DFD8BF631C440547C60772DE9273FCD9,11074,19,23,4,37,47,1897
22478,22478,4BE03AB7B88CA8091DBCEF6257C15779,43761,0,13,13,32,47,1647
22479,22479,4BE03AB7B88CA8091DBCEF6257C15779,42371,13,14,1,34,46,1746
22480,22480,4BE03AB7B88CA8091DBCEF6257C15779,43761,15,19,4,32,47,1647
22481,22481,55533B9612A041F560AB09E0A0C2A735,10251,0,8,8,35,47,1797
22482,22482,55533B9612A041F560AB09E0A0C2A735,43731,9,16,7,34,47,1747
22483,22483,55533B9612A041F560AB09E0A0C2A735,10251,21,23,2,35,47,1797
22484,22484,E8D9E959F97C7FD7CC901C0701D97F78,11541,0,1,1,35,49,1799
22485,22485,E8D9E959F97C7FD7CC901C0701D97F78,10221,2,12,10,34,49,1749
22486,22486,E8D9E959F97C7FD7CC901C0701D97F78,40112,17,23,6,32,48,1648
22496,22496,65161D8F8A2EE0E4F87D9472311EE576,13331,0,2,2,38,47,1947
22497,22497,65161D8F8A2EE0E4F87D9472311EE576,10841,2,11,9,37,47,1897
22498,22498,65161D8F8A2EE0E4F87D9472311EE576,12514,12,22,10,38,47,1947
22499,22499,177791B1BD9F9F1A23D0B9EF068F9A10,11161,0,7,7,32,48,1648
22500,22500,177791B1BD9F9F1A23D0B9EF068F9A10,11861,10,13,3,32,47,1647
22501,22501,177791B1BD9F9F1A23D0B9EF068F9A10,11161,13,18,5,32,48,1648
22502,22502,177791B1BD9F9F1A23D0B9EF068F9A10,11861,20,22,2,32,47,1647
22503,22503,13FE336F780D5F9F83776798BCE67144,11261,1,10,9,36,46,1846
22504,22504,13FE336F780D5F9F83776798BCE67144,42351,14,15,1,38,45,1945
22505,22505,13FE336F780D5F9F83776798BCE67144,11261,18,20,2,36,46,1846
22506,22506,13FE336F780D5F9F83776798BCE67144,42351,20,23,3,38,45,1945
22543,22543,BE4CDA819284119F77858D547E5A076D,11591,0,4,4,36,49,1849
22544,22544,BE4CDA819284119F77858D547E5A076D,11531,4,5,1,34,49,1749
22545,22545,BE4CDA819284119F77858D547E5A076D,40201,7,16,9,32,49,1649
22546,22546,BE4CDA819284119F77858D547E5A076D,11591,18,19,1,36,49,1849
22550,22550,617CDCBB763C8E42460705E2218A65BF,42141,0,6,6,32,47,1647
22551,22551,617CDCBB763C8E42460705E2218A65BF,42491,6,8,2,32,46,1646
22552,22552,617CDCBB763C8E42460705E2218A65BF,42523,16,17,1,31,47,1597
22553,22553,617CDCBB763C8E42460705E2218A65BF,43761,17,20,3,32,47,1647
22554,22554,479BB88DD9C776BA69F274C628C53893,13121,0,13,13,38,46,1946
22555,22555,479BB88DD9C776BA69F274C628C53893,10271,14,15,1,37,46,1896
22556,22556,479BB88DD9C776BA69F274C628C53893,13711,16,23,7,38,46,1946
22557,22557,FBFB039BFE202B4D733B8197A5DE9AA1,43751,0,5,5,19,48,998
22558,22558,FBFB039BFE202B4D733B8197A5DE9AA1,12051,9,14,5,20,47,1047
22559,22559,FBFB039BFE202B4D733B8197A5DE9AA1,43751,19,20,1,19,48,998
22570,22570,B7783E40C231BF2A915C5200F2E2562A,10491,1,13,12,33,48,1698
22571,22571,B7783E40C231BF2A915C5200F2E2562A,11381,13,17,4,30,47,1547
22572,22572,B7783E40C231BF2A915C5200F2E2562A,40951,18,19,1,36,49,1849
22573,22573,9345FA61569E568C2515B3E1C680E214,11631,2,3,1,12,49,649
22574,22574,9345FA61569E568C2515B3E1C680E214,42551,6,11,5,14,48,748
22575,22575,9345FA61569E568C2515B3E1C680E214,11631,13,23,10,12,49,649
22576,22576,8F8152ABCDBBD4CE857B1EFCB582F5D2,11074,0,8,8,37,47,1897
22577,22577,8F8152ABCDBBD4CE857B1EFCB582F5D2,10251,9,10,1,35,47,1797
22578,22578,8F8152ABCDBBD4CE857B1EFCB582F5D2,11074,13,18,5,37,47,1897
22610,22610,D1258C5EB0C025B5649F4B6138C5FC7C,13651,0,12,12,30,47,1547
22611,22611,D1258C5EB0C025B5649F4B6138C5FC7C,42523,15,16,1,31,47,1597
22612,22612,D1258C5EB0C025B5649F4B6138C5FC7C,13651,19,23,4,30,47,1547
22613,22613,BE0962E36708C29E65978ADB79B846A8,12661,2,6,4,32,45,1645
22614,22614,BE0962E36708C29E65978ADB79B846A8,10301,6,7,1,31,45,1595
22615,22615,BE0962E36708C29E65978ADB79B846A8,11834,10,23,13,32,45,1645
22634,22634,B2542631715105DE17F7E7EFAA92BF3C,10634,0,7,7,27,45,1395
22635,22635,B2542631715105DE17F7E7EFAA92BF3C,10351,10,12,2,28,45,1445
22636,22636,B2542631715105DE17F7E7EFAA92BF3C,10634,13,21,8,27,45,1395
22637,22637,90354A50079FB27E3BE2E280294F2D7C,10681,1,13,12,30,48,1548
22638,22638,90354A50079FB27E3BE2E280294F2D7C,11061,14,19,5,29,48,1498
22639,22639,90354A50079FB27E3BE2E280294F2D7C,10681,22,23,1,30,48,1548
22640,22640,24C1593E231EB4ED8C43A959F640BD76,42961,0,9,9,35,49,1799
22641,22641,24C1593E231EB4ED8C43A959F640BD76,11231,13,14,1,37,49,1899
22642,22642,24C1593E231EB4ED8C43A959F640BD76,12083,17,19,2,36,49,1849
22646,22646,36E4D456967ADF7C503C23EAE8460AAD,42523,8,9,1,31,47,1597
22647,22647,36E4D456967ADF7C503C23EAE8460AAD,13651,9,11,2,30,47,1547
22648,22648,36E4D456967ADF7C503C23EAE8460AAD,42523,12,19,7,31,47,1597
22649,22649,36E4D456967ADF7C503C23EAE8460AAD,13651,21,22,1,30,47,1547
22656,22656,C98F27F45547511D27F62F3280395BBB,10841,0,8,8,37,47,1897
22657,22657,C98F27F45547511D27F62F3280395BBB,40124,13,14,1,38,47,1947
22658,22658,C98F27F45547511D27F62F3280395BBB,13121,16,17,1,38,46,1946
22659,22659,C98F27F45547511D27F62F3280395BBB,42511,17,21,4,37,47,1897
22660,22660,424EA41F1DC8F019DCB89E6CE3B31FE9,10121,3,6,3,36,49,1849
22661,22661,424EA41F1DC8F019DCB89E6CE3B31FE9,13561,6,14,8,37,49,1899
22662,22662,424EA41F1DC8F019DCB89E6CE3B31FE9,40925,15,19,4,35,49,1799
22666,22666,2369138AAF9F76247DD6D470B27F22BF,12511,0,10,10,39,47,1997
22667,22667,2369138AAF9F76247DD6D470B27F22BF,40171,12,20,8,38,48,1948
22668,22668,2369138AAF9F76247DD6D470B27F22BF,10471,20,21,1,37,48,1898
22669,22669,12ADB141CA14BE5E4E819B1A4FBA459C,11941,2,3,1,37,46,1896
22670,22670,12ADB141CA14BE5E4E819B1A4FBA459C,13711,3,4,1,38,46,1946
22671,22671,12ADB141CA14BE5E4E819B1A4FBA459C,11941,4,19,15,37,46,1896
22672,22672,4D239E998445105BB1DB28C4CB8040D2,42581,0,6,6,38,48,1948
22673,22673,4D239E998445105BB1DB28C4CB8040D2,11914,11,19,8,37,48,1898
22674,22674,4D239E998445105BB1DB28C4CB8040D2,42581,22,23,1,38,48,1948
22675,22675,09803726F3C2A40BEF93389F75159E93,10281,0,7,7,33,48,1698
22676,22676,09803726F3C2A40BEF93389F75159E93,10251,10,11,1,35,47,1797
22677,22677,09803726F3C2A40BEF93389F75159E93,11161,13,19,6,32,48,1648
22678,22678,09803726F3C2A40BEF93389F75159E93,10281,19,23,4,33,48,1698
22689,22689,ACD7D06D699A88B2E7BB7970CE635C80,11381,0,2,2,30,47,1547
22690,22690,ACD7D06D699A88B2E7BB7970CE635C80,42521,2,7,5,31,47,1597
22691,22691,ACD7D06D699A88B2E7BB7970CE635C80,11381,7,21,14,30,47,1547
22692,22692,ACD7D06D699A88B2E7BB7970CE635C80,42291,22,23,1,29,48,1498
22723,22723,EA76F6018E37635F2D98F3C61FC7376D,10841,0,1,1,37,47,1897
22724,22724,EA76F6018E37635F2D98F3C61FC7376D,13331,3,16,13,38,47,1947
22725,22725,EA76F6018E37635F2D98F3C61FC7376D,10841,18,20,2,37,47,1897
22726,22726,EA76F6018E37635F2D98F3C61FC7376D,13601,21,23,2,34,47,1747
22727,22727,4EE5C60035D807126AEE0DC0CD563832,42581,0,3,3,38,48,1948
22728,22728,4EE5C60035D807126AEE0DC0CD563832,11914,7,14,7,37,48,1898
22729,22729,4EE5C60035D807126AEE0DC0CD563832,42581,15,16,1,38,48,1948
22730,22730,4EE5C60035D807126AEE0DC0CD563832,11914,20,21,1,37,48,1898
22731,22731,1BD58ED4C87C4E7FB266C3FDC7A25F87,10681,0,13,13,30,48,1548
22732,22732,1BD58ED4C87C4E7FB266C3FDC7A25F87,12971,14,16,2,32,48,1648
22733,22733,1BD58ED4C87C4E7FB266C3FDC7A25F87,10681,18,20,2,30,48,1548
22750,22750,AC414DB8853E95A441FB40B4893530F7,10351,2,4,2,28,45,1445
22751,22751,AC414DB8853E95A441FB40B4893530F7,12311,7,10,3,30,44,1544
22752,22752,AC414DB8853E95A441FB40B4893530F7,10634,14,15,1,27,45,1395
22753,22753,AC414DB8853E95A441FB40B4893530F7,10351,17,20,3,28,45,1445
22754,22754,09C2A5500F5ABAEEAC932C07F5628EC4,11021,0,8,8,36,49,1849
22755,22755,09C2A5500F5ABAEEAC932C07F5628EC4,43161,9,11,2,35,47,1797
22756,22756,09C2A5500F5ABAEEAC932C07F5628EC4,11021,12,14,2,36,49,1849
22757,22757,09C2A5500F5ABAEEAC932C07F5628EC4,42161,15,19,4,36,47,1847
22761,22761,FB4AEAA88384A48CA4B80CD8D56E51FF,13941,5,10,5,41,47,2097
22762,22762,FB4AEAA88384A48CA4B80CD8D56E51FF,11001,12,17,5,42,47,2147
22763,22763,FB4AEAA88384A48CA4B80CD8D56E51FF,13221,21,22,1,40,47,2047
22780,22780,35CAA8E33B432720CDD3C14AE49DEBFD,43751,0,1,1,19,48,998
22781,22781,35CAA8E33B432720CDD3C14AE49DEBFD,42481,6,8,2,22,49,1149
22782,22782,35CAA8E33B432720CDD3C14AE49DEBFD,43751,9,13,4,19,48,998
22783,22783,35CAA8E33B432720CDD3C14AE49DEBFD,11641,13,21,8,22,49,1149
22784,22784,7593D7AED856FF2FC2E20D8E8570438A,40171,0,10,10,38,48,1948
22785,22785,7593D7AED856FF2FC2E20D8E8570438A,10471,12,14,2,37,48,1898
22786,22786,7593D7AED856FF2FC2E20D8E8570438A,42581,14,17,3,38,48,1948
22787,22787,7593D7AED856FF2FC2E20D8E8570438A,11914,18,20,2,37,48,1898
22799,22799,CABDD8B2A8DF9C3C6F2F674E6DD5C884,11061,0,6,6,29,48,1498
22800,22800,CABDD8B2A8DF9C3C6F2F674E6DD5C884,11381,11,13,2,30,47,1547
22801,22801,CABDD8B2A8DF9C3C6F2F674E6DD5C884,11061,13,18,5,29,48,1498
22802,22802,30165500CA5F6A8CB10812947A58AC25,10251,0,14,14,35,47,1797
22803,22803,30165500CA5F6A8CB10812947A58AC25,42491,15,16,1,32,46,1646
22804,22804,30165500CA5F6A8CB10812947A58AC25,10251,19,23,4,35,47,1797
22820,22820,15D46EC570105A948AAA5BD130B0DCB7,10111,0,7,7,37,47,1897
22821,22821,15D46EC570105A948AAA5BD130B0DCB7,42161,7,10,3,36,47,1847
22822,22822,15D46EC570105A948AAA5BD130B0DCB7,10111,11,22,11,37,47,1897
22823,22823,4C6EBE1C4B2FAAFACD17B57BF7692986,43731,0,9,9,34,47,1747
22824,22824,4C6EBE1C4B2FAAFACD17B57BF7692986,42161,14,16,2,36,47,1847
22825,22825,4C6EBE1C4B2FAAFACD17B57BF7692986,43731,17,22,5,34,47,1747
22840,22840,FDF3A555382668B3FCFD730AFF8664D2,10411,0,8,8,36,48,1848
22841,22841,FDF3A555382668B3FCFD730AFF8664D2,11231,8,17,9,37,49,1899
22842,22842,FDF3A555382668B3FCFD730AFF8664D2,40925,18,21,3,35,49,1799
22843,22843,FDF3A555382668B3FCFD730AFF8664D2,10411,22,23,1,36,48,1848
22844,22844,EAAB672210C677BA2879CCE67BDB7DF5,11151,0,5,5,30,48,1548
22845,22845,EAAB672210C677BA2879CCE67BDB7DF5,42831,5,6,1,27,48,1398
22846,22846,EAAB672210C677BA2879CCE67BDB7DF5,11151,6,16,10,30,48,1548
22847,22847,EAAB672210C677BA2879CCE67BDB7DF5,42831,20,22,2,27,48,1398
22853,22853,D97F93CB7946C1399F01BAA588B11A0C,42351,0,8,8,38,45,1945
22854,22854,D97F93CB7946C1399F01BAA588B11A0C,11261,9,11,2,36,46,1846
22855,22855,D97F93CB7946C1399F01BAA588B11A0C,42351,12,23,11,38,45,1945
22862,22862,C094282B525E0208A246EB62395EA9F5,12511,0,2,2,39,47,1997
22863,22863,C094282B525E0208A246EB62395EA9F5,10251,2,21,19,35,47,1797
22864,22864,C094282B525E0208A246EB62395EA9F5,12511,21,23,2,39,47,1997
22875,22875,34B0487DA91675A6216B605C367EE35D,43761,0,6,6,32,47,1647
22876,22876,34B0487DA91675A6216B605C367EE35D,43581,8,17,9,33,48,1698
22877,22877,34B0487DA91675A6216B605C367EE35D,43761,21,22,1,32,47,1647
22887,22887,2A299573B8ADE5EDDBBA5F82D87A0B34,13601,0,13,13,34,47,1747
22888,22888,2A299573B8ADE5EDDBBA5F82D87A0B34,10731,13,17,4,33,47,1697
22889,22889,2A299573B8ADE5EDDBBA5F82D87A0B34,13601,18,19,1,34,47,1747
22890,22890,2A299573B8ADE5EDDBBA5F82D87A0B34,42921,22,23,1,33,47,1697
22894,22894,0A06E26D4B63B311703019BBFB7FEF42,10471,3,10,7,37,48,1898
22895,22895,0A06E26D4B63B311703019BBFB7FEF42,11021,14,17,3,36,49,1849
22896,22896,0A06E26D4B63B311703019BBFB7FEF42,42471,21,22,1,35,49,1799
22900,22900,FA5E97B8E90C5A955BBD79C61D708804,10431,0,6,6,33,49,1699
22901,22901,FA5E97B8E90C5A955BBD79C61D708804,42021,8,10,2,33,47,1697
22902,22902,FA5E97B8E90C5A955BBD79C61D708804,10431,12,23,11,33,49,1699
22903,22903,E99176074424BF1CA2C083C0DBF3C62C,42221,5,7,2,38,48,1948
22904,22904,E99176074424BF1CA2C083C0DBF3C62C,12514,7,9,2,38,47,1947
22905,22905,E99176074424BF1CA2C083C0DBF3C62C,12841,10,22,12,37,47,1897
22906,22906,A11021665283D6C62A5E3EE561A2FB8C,42351,0,8,8,38,45,1945
22907,22907,A11021665283D6C62A5E3EE561A2FB8C,12511,12,13,1,39,47,1997
22908,22908,A11021665283D6C62A5E3EE561A2FB8C,42351,14,17,3,38,45,1945
22909,22909,A11021665283D6C62A5E3EE561A2FB8C,11261,19,22,3,36,46,1846
22910,22910,F4D2972F8183CFAB035866813CF4C6D8,11231,8,11,3,37,49,1899
22911,22911,F4D2972F8183CFAB035866813CF4C6D8,40951,12,14,2,36,49,1849
22912,22912,F4D2972F8183CFAB035866813CF4C6D8,11231,14,19,5,37,49,1899
22913,22913,F4D2972F8183CFAB035866813CF4C6D8,11201,19,22,3,35,49,1799
22914,22914,8820D655222FFDC13E2E08EC252AACD5,42161,2,8,6,36,47,1847
22915,22915,8820D655222FFDC13E2E08EC252AACD5,10971,13,20,7,35,47,1797
22916,22916,8820D655222FFDC13E2E08EC252AACD5,42161,20,23,3,36,47,1847
22917,22917,A4BC16FDE84BA1A928A7C6E482678E7C,10634,0,9,9,27,45,1395
22918,22918,A4BC16FDE84BA1A928A7C6E482678E7C,10351,11,12,1,28,45,1445
22919,22919,A4BC16FDE84BA1A928A7C6E482678E7C,10634,13,20,7,27,45,1395
22923,22923,0FD69EC98BB3B9AFBB43D09AE442CEE9,43761,2,9,7,32,47,1647
22924,22924,0FD69EC98BB3B9AFBB43D09AE442CEE9,42523,12,15,3,31,47,1597
22925,22925,0FD69EC98BB3B9AFBB43D09AE442CEE9,10491,18,23,5,33,48,1698
22926,22926,6561265EB655B8B0AF69E03674D76359,11861,0,8,8,32,47,1647
22927,22927,6561265EB655B8B0AF69E03674D76359,11211,13,15,2,34,49,1749
22928,22928,6561265EB655B8B0AF69E03674D76359,10731,15,20,5,33,47,1697
22929,22929,6561265EB655B8B0AF69E03674D76359,11861,20,23,3,32,47,1647
22935,22935,EC8D784C19C185B8F2C30A9ECA831652,13911,0,13,13,39,46,1996
22936,22936,EC8D784C19C185B8F2C30A9ECA831652,11261,13,17,4,36,46,1846
22937,22937,EC8D784C19C185B8F2C30A9ECA831652,13911,17,21,4,39,46,1996
22947,22947,04FC279D8763FD0D52EBF8F599CB8F45,10121,0,8,8,36,49,1849
22948,22948,04FC279D8763FD0D52EBF8F599CB8F45,42511,8,18,10,37,47,1897
22949,22949,04FC279D8763FD0D52EBF8F599CB8F45,10121,19,23,4,36,49,1849
22955,22955,E4A99F1C3E7ED34FBD67066F6ADB6F92,12311,0,6,6,30,44,1544
22956,22956,E4A99F1C3E7ED34FBD67066F6ADB6F92,42531,9,10,1,31,45,1595
22957,22957,E4A99F1C3E7ED34FBD67066F6ADB6F92,12311,11,23,12,30,44,1544
22958,22958,ED57081FEDFCA9B3E2228C4E0C491121,10111,3,9,6,37,47,1897
22959,22959,ED57081FEDFCA9B3E2228C4E0C491121,42401,12,14,2,36,47,1847
22960,22960,ED57081FEDFCA9B3E2228C4E0C491121,10111,18,23,5,37,47,1897
22975,22975,5E3818F8D38E1BCB8C64D4B0C1893038,11281,9,11,2,27,40,1390
22976,22976,5E3818F8D38E1BCB8C64D4B0C1893038,12761,12,13,1,25,40,1290
22977,22977,5E3818F8D38E1BCB8C64D4B0C1893038,11281,16,18,2,27,40,1390
22978,22978,5E3818F8D38E1BCB8C64D4B0C1893038,13671,20,21,1,27,43,1393
22984,22984,2B796358390FD846EE57DE8924EDBF14,11914,5,7,2,37,48,1898
22985,22985,2B796358390FD846EE57DE8924EDBF14,42581,11,18,7,38,48,1948
22986,22986,2B796358390FD846EE57DE8924EDBF14,11914,18,19,1,37,48,1898
22987,22987,2B796358390FD846EE57DE8924EDBF14,42581,22,23,1,38,48,1948
22991,22991,0F18A9274445631256C7B0403CD7E0F0,42161,0,1,1,36,47,1847
22992,22992,0F18A9274445631256C7B0403CD7E0F0,10111,2,14,12,37,47,1897
22993,22993,0F18A9274445631256C7B0403CD7E0F0,42301,18,20,2,36,47,1847
22994,22994,0F18A9274445631256C7B0403CD7E0F0,10111,22,23,1,37,47,1897
22998,22998,DEF2119ECB90D4385AD1A45A0B2C7A35,43761,0,5,5,32,47,1647
22999,22999,DEF2119ECB90D4385AD1A45A0B2C7A35,42523,6,9,3,31,47,1597
23000,23000,DEF2119ECB90D4385AD1A45A0B2C7A35,43761,10,23,13,32,47,1647
23005,23005,DFDD3FE0C2251404AC997151A5933E97,43761,1,15,14,32,47,1647
23006,23006,DFDD3FE0C2251404AC997151A5933E97,42523,17,18,1,31,47,1597
23007,23007,DFDD3FE0C2251404AC997151A5933E97,43761,19,23,4,32,47,1647
23012,23012,E8A3A2F2678AE58B36D710FCF037760E,11231,0,1,1,37,49,1899
23013,23013,E8A3A2F2678AE58B36D710FCF037760E,10411,2,18,16,36,48,1848
23014,23014,E8A3A2F2678AE58B36D710FCF037760E,11231,20,23,3,37,49,1899
23023,23023,5ABE718167D46909D2BC05896CF8907B,11021,0,7,7,36,49,1849
23024,23024,5ABE718167D46909D2BC05896CF8907B,11011,11,13,2,39,49,1999
23025,23025,5ABE718167D46909D2BC05896CF8907B,10121,17,23,6,36,49,1849
23031,23031,A0B07DBD7CFEABE1E4A0E9444C496CF6,13381,0,8,8,39,47,1997
23032,23032,A0B07DBD7CFEABE1E4A0E9444C496CF6,43481,8,9,1,39,48,1998
23033,23033,A0B07DBD7CFEABE1E4A0E9444C496CF6,13381,10,20,10,39,47,1997
23034,23034,A266B45677C0A1829225C0896CE9C2C1,11074,0,13,13,37,47,1897
23035,23035,A266B45677C0A1829225C0896CE9C2C1,42221,14,15,1,38,48,1948
23036,23036,A266B45677C0A1829225C0896CE9C2C1,11074,20,23,3,37,47,1897
23053,23053,9A1CB6044954B6099E36F60F8EE95A99,11381,1,16,15,30,47,1547
23054,23054,9A1CB6044954B6099E36F60F8EE95A99,10951,17,18,1,29,48,1498
23055,23055,9A1CB6044954B6099E36F60F8EE95A99,11381,20,23,3,30,47,1547
23056,23056,14C205DF57BD0AA586E26BE4ED695846,42581,0,5,5,38,48,1948
23057,23057,14C205DF57BD0AA586E26BE4ED695846,11914,8,9,1,37,48,1898
23058,23058,14C205DF57BD0AA586E26BE4ED695846,42581,11,14,3,38,48,1948
23059,23059,14C205DF57BD0AA586E26BE4ED695846,11914,17,23,6,37,48,1898
23060,23060,F8EA0C68F3C8266C3E7BA4F2FCE6F8BC,19441,0,14,14,8,46,446
23061,23061,F8EA0C68F3C8266C3E7BA4F2FCE6F8BC,42041,14,16,2,10,47,547
23062,23062,F8EA0C68F3C8266C3E7BA4F2FCE6F8BC,19441,18,21,3,8,46,446
23063,23063,995514E74525DCE707CCE63893D938C0,42331,0,8,8,39,46,1996
23064,23064,995514E74525DCE707CCE63893D938C0,10841,9,12,3,37,47,1897
23065,23065,995514E74525DCE707CCE63893D938C0,13331,17,18,1,38,47,1947
23066,23066,995514E74525DCE707CCE63893D938C0,10841,18,20,2,37,47,1897
23067,23067,C75781F60799DE2652DF86EC8BB9A296,42401,2,13,11,36,47,1847
23068,23068,C75781F60799DE2652DF86EC8BB9A296,11911,16,18,2,37,48,1898
23069,23069,C75781F60799DE2652DF86EC8BB9A296,42401,20,23,3,36,47,1847
23073,23073,B46F7CFBF42B8DF5990A028C3A15EF50,42531,0,6,6,31,45,1595
23074,23074,B46F7CFBF42B8DF5990A028C3A15EF50,12311,9,11,2,30,44,1544
23075,23075,B46F7CFBF42B8DF5990A028C3A15EF50,42531,11,22,11,31,45,1595
23080,23080,F86B574DE594F93D742955F961AA708C,10924,6,10,4,43,49,2199
23081,23081,F86B574DE594F93D742955F961AA708C,11741,12,16,4,42,49,2149
23082,23082,F86B574DE594F93D742955F961AA708C,10924,21,22,1,43,49,2199
23083,23083,DAFE070AC8164EB683B9455E05DD84E1,13101,10,16,6,40,47,2047
23084,23084,DAFE070AC8164EB683B9455E05DD84E1,13271,19,21,2,41,47,2097
23085,23085,DAFE070AC8164EB683B9455E05DD84E1,13101,22,23,1,40,47,2047
23091,23091,3C5BF8354C7B22C00BFA5438C070BC0F,13711,0,12,12,38,46,1946
23092,23092,3C5BF8354C7B22C00BFA5438C070BC0F,43241,15,16,1,36,46,1846
23093,23093,3C5BF8354C7B22C00BFA5438C070BC0F,13711,17,18,1,38,46,1946
23094,23094,3C5BF8354C7B22C00BFA5438C070BC0F,10271,19,22,3,37,46,1896
23095,23095,17A6D2A092121A27FDCB1E978538D50A,13371,0,13,13,41,47,2097
23096,23096,17A6D2A092121A27FDCB1E978538D50A,42201,14,16,2,43,46,2196
23097,23097,17A6D2A092121A27FDCB1E978538D50A,13941,17,23,6,41,47,2097
23124,23124,D4DE28276D2C825AA4FE715AD291B466,13121,0,9,9,38,46,1946
23125,23125,D4DE28276D2C825AA4FE715AD291B466,42011,12,13,1,36,46,1846
23126,23126,D4DE28276D2C825AA4FE715AD291B466,13121,14,18,4,38,46,1946
23142,23142,ACFB892F60074737B9E0F9A496FA6823,42151,0,6,6,35,45,1795
23143,23143,ACFB892F60074737B9E0F9A496FA6823,42861,9,11,2,37,44,1894
23144,23144,ACFB892F60074737B9E0F9A496FA6823,42151,12,18,6,35,45,1795
23145,23145,ACFB892F60074737B9E0F9A496FA6823,42861,20,21,1,37,44,1894
23156,23156,C20496C873E4D6CBDAA003A1B830833C,11011,0,5,5,39,49,1999
23157,23157,C20496C873E4D6CBDAA003A1B830833C,42031,10,12,2,40,46,2046
23158,23158,C20496C873E4D6CBDAA003A1B830833C,11074,14,18,4,37,47,1897
23164,23164,946768BFA72752D5660750415178C67F,13601,3,10,7,34,47,1747
23165,23165,946768BFA72752D5660750415178C67F,11081,12,18,6,35,46,1796
23166,23166,946768BFA72752D5660750415178C67F,12971,20,22,2,32,48,1648
23170,23170,884C9210F61ADBFD1EDE89A3EAB05C30,13101,0,4,4,40,47,2047
23171,23171,884C9210F61ADBFD1EDE89A3EAB05C30,40833,9,10,1,41,47,2097
23172,23172,884C9210F61ADBFD1EDE89A3EAB05C30,13101,10,21,11,40,47,2047
23194,23194,E27666DBA5763DDAABCA463F0844803E,11831,0,7,7,32,45,1645
23195,23195,E27666DBA5763DDAABCA463F0844803E,12311,8,17,9,30,44,1544
23196,23196,E27666DBA5763DDAABCA463F0844803E,11831,19,23,4,32,45,1645
23197,23197,39179060954ADF536A44D5CDC3D7ADA4,42351,5,11,6,38,45,1945
23198,23198,39179060954ADF536A44D5CDC3D7ADA4,13911,13,17,4,39,46,1996
23199,23199,39179060954ADF536A44D5CDC3D7ADA4,11261,18,22,4,36,46,1846
23219,23219,E6EB0FFE7655FB9A9B77EC908104A8C3,11381,0,7,7,30,47,1547
23220,23220,E6EB0FFE7655FB9A9B77EC908104A8C3,12121,7,8,1,29,47,1497
23221,23221,E6EB0FFE7655FB9A9B77EC908104A8C3,11381,8,23,15,30,47,1547
23231,23231,06CD3EE92D2B17414D605CFC7A438D67,10271,0,7,7,37,46,1896
23232,23232,06CD3EE92D2B17414D605CFC7A438D67,11074,9,11,2,37,47,1897
23233,23233,06CD3EE92D2B17414D605CFC7A438D67,42011,15,16,1,36,46,1846
23234,23234,06CD3EE92D2B17414D605CFC7A438D67,40611,19,20,1,35,47,1797
23253,23253,C1896697E8F9082F3C179E6CB902F84B,49181,0,11,11,21,31,1081
23254,23254,C1896697E8F9082F3C179E6CB902F84B,13141,11,13,2,23,30,1180
23255,23255,C1896697E8F9082F3C179E6CB902F84B,49181,13,23,10,21,31,1081
23256,23256,3B9989389C2FB72384F3330F9A990AB0,13911,0,2,2,39,46,1996
23257,23257,3B9989389C2FB72384F3330F9A990AB0,42351,3,4,1,38,45,1945
23258,23258,3B9989389C2FB72384F3330F9A990AB0,42231,5,20,15,37,46,1896
23263,23263,9B6852556CEBC93A71C86A94C097F1AF,10881,9,10,1,34,48,1748
23264,23264,9B6852556CEBC93A71C86A94C097F1AF,10251,12,13,1,35,47,1797
23265,23265,9B6852556CEBC93A71C86A94C097F1AF,10881,14,17,3,34,48,1748
23266,23266,9B6852556CEBC93A71C86A94C097F1AF,10251,17,22,5,35,47,1797
23267,23267,E16566CAC1D2263C830A92E3D7A4B3A9,42351,0,17,17,38,45,1945
23268,23268,E16566CAC1D2263C830A92E3D7A4B3A9,42231,18,20,2,37,46,1896
23269,23269,E16566CAC1D2263C830A92E3D7A4B3A9,42351,21,22,1,38,45,1945
23283,23283,A910A64B88EF93AE4B4F67D39EA167CE,10471,0,8,8,37,48,1898
23284,23284,A910A64B88EF93AE4B4F67D39EA167CE,42581,9,12,3,38,48,1948
23285,23285,A910A64B88EF93AE4B4F67D39EA167CE,10471,12,14,2,37,48,1898
23286,23286,A910A64B88EF93AE4B4F67D39EA167CE,42581,14,23,9,38,48,1948
23287,23287,27E85AEC10BD13BABE08660D8F483253,42371,0,8,8,34,46,1746
23288,23288,27E85AEC10BD13BABE08660D8F483253,43241,8,14,6,36,46,1846
23289,23289,27E85AEC10BD13BABE08660D8F483253,11081,15,16,1,35,46,1796
23290,23290,27E85AEC10BD13BABE08660D8F483253,43241,17,18,1,36,46,1846
23291,23291,755A1FA6C962DCA1F0C6C27EDC12A160,13371,0,18,18,41,47,2097
23292,23292,755A1FA6C962DCA1F0C6C27EDC12A160,10591,19,20,1,39,48,1998
23293,23293,755A1FA6C962DCA1F0C6C27EDC12A160,13371,20,23,3,41,47,2097
23294,23294,D0578776338B1E2194484FEEECA0B95F,42523,6,11,5,31,47,1597
23295,23295,D0578776338B1E2194484FEEECA0B95F,12131,12,14,2,32,47,1647
23296,23296,D0578776338B1E2194484FEEECA0B95F,42491,15,18,3,32,46,1646
23297,23297,D0578776338B1E2194484FEEECA0B95F,12131,19,23,4,32,47,1647
23309,23309,AA71E9A6AEA764D2564D532D0321512B,42041,1,13,12,10,47,547
23310,23310,AA71E9A6AEA764D2564D532D0321512B,19441,15,18,3,8,46,446
23311,23311,AA71E9A6AEA764D2564D532D0321512B,42041,21,23,2,10,47,547
23312,23312,644074FAED2D07B771DBBC3C2ED7ABF4,13411,0,6,6,49,42,2492
23313,23313,644074FAED2D07B771DBBC3C2ED7ABF4,43951,6,17,11,49,41,2491
23314,23314,644074FAED2D07B771DBBC3C2ED7ABF4,13411,19,23,4,49,42,2492
23319,23319,7CB984CC0E6ABE59C1C741CAADBD1FA0,10431,0,13,13,33,49,1699
23320,23320,7CB984CC0E6ABE59C1C741CAADBD1FA0,11861,14,15,1,32,47,1647
23321,23321,7CB984CC0E6ABE59C1C741CAADBD1FA0,10431,17,23,6,33,49,1699
23322,23322,355C6EBBD0C4B3C86775F0028FAF63FE,42231,0,13,13,37,46,1896
23323,23323,355C6EBBD0C4B3C86775F0028FAF63FE,42351,14,15,1,38,45,1945
23324,23324,355C6EBBD0C4B3C86775F0028FAF63FE,42231,15,23,8,37,46,1896
23325,23325,AA8CC60B06B8E7A334E7FA04353D8EED,11261,0,6,6,36,46,1846
23326,23326,AA8CC60B06B8E7A334E7FA04353D8EED,10841,9,11,2,37,47,1897
23327,23327,AA8CC60B06B8E7A334E7FA04353D8EED,42864,13,14,1,38,44,1944
23328,23328,AA8CC60B06B8E7A334E7FA04353D8EED,11261,16,23,7,36,46,1846
23332,23332,E348AAFE4A29289B071092F6D1793503,11231,6,8,2,37,49,1899
23333,23333,E348AAFE4A29289B071092F6D1793503,43671,10,13,3,35,48,1798
23334,23334,E348AAFE4A29289B071092F6D1793503,10371,13,23,10,37,49,1899
23345,23345,80779C982E47128931C5479B9B9DAF80,11861,0,17,17,32,47,1647
23346,23346,80779C982E47128931C5479B9B9DAF80,11431,19,20,1,29,47,1497
23347,23347,80779C982E47128931C5479B9B9DAF80,11861,22,23,1,32,47,1647
23348,23348,1C6B014A9F7E5BF6538ED8D07E462CBD,11074,4,6,2,37,47,1897
23349,23349,1C6B014A9F7E5BF6538ED8D07E462CBD,42221,8,9,1,38,48,1948
23350,23350,1C6B014A9F7E5BF6538ED8D07E462CBD,11074,19,21,2,37,47,1897
23351,23351,A3BFED7EBC8273A150663075EB9361B2,12391,2,9,7,36,49,1849
23352,23352,A3BFED7EBC8273A150663075EB9361B2,40181,12,16,4,37,49,1899
23353,23353,A3BFED7EBC8273A150663075EB9361B2,11271,19,20,1,37,48,1898
23354,23354,DE4C0B316DF5DF13453EB34FBFEEFD72,11231,1,10,9,37,49,1899
23355,23355,DE4C0B316DF5DF13453EB34FBFEEFD72,40951,12,13,1,36,49,1849
23356,23356,DE4C0B316DF5DF13453EB34FBFEEFD72,11751,15,19,4,35,48,1798
23357,23357,3E472DF46A0442A58A41015A056A04AB,42231,0,8,8,37,46,1896
23358,23358,3E472DF46A0442A58A41015A056A04AB,42351,8,10,2,38,45,1945
23359,23359,3E472DF46A0442A58A41015A056A04AB,42231,12,23,11,37,46,1896
23360,23360,D5B8C5235ADB84B7998BAE6507D2CE64,10544,6,12,6,28,48,1448
23361,23361,D5B8C5235ADB84B7998BAE6507D2CE64,10381,12,14,2,31,49,1599
23362,23362,D5B8C5235ADB84B7998BAE6507D2CE64,10544,14,18,4,28,48,1448
23363,23363,DBB3053D29CCCA401EF3373AA2973F48,11941,0,6,6,37,46,1896
23364,23364,DBB3053D29CCCA401EF3373AA2973F48,13711,6,8,2,38,46,1946
23365,23365,DBB3053D29CCCA401EF3373AA2973F48,11941,10,22,12,37,46,1896
23380,23380,669C34237215178780FBCDB7F5444D7E,42521,1,10,9,31,47,1597
23381,23381,669C34237215178780FBCDB7F5444D7E,43971,12,15,3,30,48,1548
23382,23382,669C34237215178780FBCDB7F5444D7E,11061,15,23,8,29,48,1498
23383,23383,94625219796741AA1E7A2A8E50618E75,10271,6,17,11,37,46,1896
23384,23384,94625219796741AA1E7A2A8E50618E75,13121,18,21,3,38,46,1946
23385,23385,94625219796741AA1E7A2A8E50618E75,11074,22,23,1,37,47,1897
23389,23389,8DE15D34A0DAE0CE5FABCABC75057336,10491,1,2,1,33,48,1698
23390,23390,8DE15D34A0DAE0CE5FABCABC75057336,13601,2,5,3,34,47,1747
23391,23391,8DE15D34A0DAE0CE5FABCABC75057336,10491,5,22,17,33,48,1698
23392,23392,C13EDA65C3B019881628338CF4BA6FEF,42491,0,6,6,32,46,1646
23393,23393,C13EDA65C3B019881628338CF4BA6FEF,42523,7,13,6,31,47,1597
23394,23394,C13EDA65C3B019881628338CF4BA6FEF,42491,15,19,4,32,46,1646
23395,23395,C13EDA65C3B019881628338CF4BA6FEF,10292,21,23,2,30,47,1547
23399,23399,85A9063F7506C2E51076A4190DDE5AA8,11261,0,2,2,36,46,1846
23400,23400,85A9063F7506C2E51076A4190DDE5AA8,13231,5,7,2,39,46,1996
23401,23401,85A9063F7506C2E51076A4190DDE5AA8,11261,10,22,12,36,46,1846
23402,23402,A0E829F4319BFCF37BA7414AFCB09FF1,42221,0,7,7,38,48,1948
23403,23403,A0E829F4319BFCF37BA7414AFCB09FF1,12514,8,10,2,38,47,1947
23404,23404,A0E829F4319BFCF37BA7414AFCB09FF1,11074,10,11,1,37,47,1897
23405,23405,A0E829F4319BFCF37BA7414AFCB09FF1,42221,13,23,10,38,48,1948
23423,23423,2F3FBE39EE4E3AB748593134D6A2A772,42231,2,14,12,37,46,1896
23424,23424,2F3FBE39EE4E3AB748593134D6A2A772,42351,14,18,4,38,45,1945
23425,23425,2F3FBE39EE4E3AB748593134D6A2A772,42231,19,22,3,37,46,1896
23426,23426,E1B8B389FB89A6FD4C4FFE9BDF0E0F7E,11381,1,18,17,30,47,1547
23427,23427,E1B8B389FB89A6FD4C4FFE9BDF0E0F7E,10951,18,19,1,29,48,1498
23428,23428,E1B8B389FB89A6FD4C4FFE9BDF0E0F7E,11381,19,23,4,30,47,1547
23445,23445,E835E54D31E2053FF59F5E3D61ABCD72,11151,6,15,9,30,48,1548
23446,23446,E835E54D31E2053FF59F5E3D61ABCD72,11061,15,16,1,29,48,1498
23447,23447,E835E54D31E2053FF59F5E3D61ABCD72,11151,17,23,6,30,48,1548
23478,23478,1DA79481C6B6D1D9223A378A0D81757A,10111,0,8,8,37,47,1897
23479,23479,1DA79481C6B6D1D9223A378A0D81757A,11331,9,10,1,37,48,1898
23480,23480,1DA79481C6B6D1D9223A378A0D81757A,10111,11,23,12,37,47,1897
23484,23484,32809330ABBE3BDC7EDF41259F0307C9,11231,0,14,14,37,49,1899
23485,23485,32809330ABBE3BDC7EDF41259F0307C9,11021,14,17,3,36,49,1849
23486,23486,32809330ABBE3BDC7EDF41259F0307C9,10371,18,23,5,37,49,1899
23496,23496,5767E0EE50B7CB3B0CFBFCA7463471BC,11806,0,7,7,41,48,2098
23497,23497,5767E0EE50B7CB3B0CFBFCA7463471BC,13791,8,19,11,42,47,2147
23498,23498,5767E0EE50B7CB3B0CFBFCA7463471BC,11806,20,23,3,41,48,2098
23499,23499,5B51BC643A26489396AC90A6305DBADE,11231,0,8,8,37,49,1899
23500,23500,5B51BC643A26489396AC90A6305DBADE,13731,10,17,7,33,49,1699
23501,23501,5B51BC643A26489396AC90A6305DBADE,11231,18,22,4,37,49,1899
23502,23502,A2939A88D49E89644FEBA8B1C0E8B435,10111,0,7,7,37,47,1897
23503,23503,A2939A88D49E89644FEBA8B1C0E8B435,11331,9,10,1,37,48,1898
23504,23504,A2939A88D49E89644FEBA8B1C0E8B435,10251,13,18,5,35,47,1797
23505,23505,A2939A88D49E89644FEBA8B1C0E8B435,41612,18,21,3,36,47,1847
23509,23509,CD55B44A3FD4B718A673CC03711FD344,12921,3,5,2,9,41,491
23510,23510,CD55B44A3FD4B718A673CC03711FD344,12641,9,17,8,10,43,543
23511,23511,CD55B44A3FD4B718A673CC03711FD344,12921,18,22,4,9,41,491
23512,23512,E259E36EE859D4C4C9374127A836D38A,10171,0,8,8,26,47,1347
23513,23513,E259E36EE859D4C4C9374127A836D38A,12601,9,13,4,25,47,1297
23514,23514,E259E36EE859D4C4C9374127A836D38A,10171,14,16,2,26,47,1347
23515,23515,E259E36EE859D4C4C9374127A836D38A,12601,17,21,4,25,47,1297
23516,23516,D3E46B15B35DC3C198E6EE945D227259,11806,0,5,5,41,48,2098
23517,23517,D3E46B15B35DC3C198E6EE945D227259,42271,5,17,12,40,47,2047
23518,23518,D3E46B15B35DC3C198E6EE945D227259,13381,19,23,4,39,47,1997
23519,23519,FEE5ACDB24DFF6E9A25C550C618C43AE,10251,0,2,2,35,47,1797
23520,23520,FEE5ACDB24DFF6E9A25C550C618C43AE,40673,6,9,3,36,48,1848
23521,23521,FEE5ACDB24DFF6E9A25C550C618C43AE,10251,13,23,10,35,47,1797
23522,23522,185D56D388FE8A96E07F52D610C68C9B,12514,0,7,7,38,47,1947
23523,23523,185D56D388FE8A96E07F52D610C68C9B,11074,8,18,10,37,47,1897
23524,23524,185D56D388FE8A96E07F52D610C68C9B,12514,20,22,2,38,47,1947
23532,23532,06DA10A5127707E5C949D4A6A9073869,42531,1,3,2,31,45,1595
23533,23533,06DA10A5127707E5C949D4A6A9073869,12311,3,9,6,30,44,1544
23534,23534,06DA10A5127707E5C949D4A6A9073869,42531,12,23,11,31,45,1595
23539,23539,1DF0FA0C5B05EE4CBE545C4D1FA04C67,42691,0,9,9,24,48,1248
23540,23540,1DF0FA0C5B05EE4CBE545C4D1FA04C67,10451,10,11,1,25,48,1298
23541,23541,1DF0FA0C5B05EE4CBE545C4D1FA04C67,12581,18,22,4,24,48,1248
23547,23547,354BD264A9E3427AF445BDA947BFDA83,11771,6,12,6,39,49,1999
23548,23548,354BD264A9E3427AF445BDA947BFDA83,11801,13,14,1,42,48,2148
23549,23549,354BD264A9E3427AF445BDA947BFDA83,11771,15,19,4,39,49,1999
23550,23550,BA285F01E6926591864F1F3184565800,42581,5,6,1,38,48,1948
23551,23551,BA285F01E6926591864F1F3184565800,11914,9,11,2,37,48,1898
23552,23552,BA285F01E6926591864F1F3184565800,42581,12,16,4,38,48,1948
23553,23553,BA285F01E6926591864F1F3184565800,10107,17,19,2,38,49,1949
23560,23560,0A026519DFB36EBDF50838029C8182A2,11461,2,10,8,37,49,1899
23561,23561,0A026519DFB36EBDF50838029C8182A2,40171,11,14,3,38,48,1948
23562,23562,0A026519DFB36EBDF50838029C8182A2,13741,18,21,3,37,49,1899
23579,23579,FD52F504D9ED6534F4EFC660DD8D51D0,11011,0,7,7,39,49,1999
23580,23580,FD52F504D9ED6534F4EFC660DD8D51D0,12391,8,9,1,36,49,1849
23581,23581,FD52F504D9ED6534F4EFC660DD8D51D0,11351,10,11,1,36,48,1848
23582,23582,FD52F504D9ED6534F4EFC660DD8D51D0,11011,17,18,1,39,49,1999
23605,23605,75B73E3953DB5FE1D47D41CFE2BB4DC6,11491,8,9,1,36,47,1847
23606,23606,75B73E3953DB5FE1D47D41CFE2BB4DC6,13121,10,16,6,38,46,1946
23607,23607,75B73E3953DB5FE1D47D41CFE2BB4DC6,10271,21,22,1,37,46,1896
23615,23615,14E7B816E908FAE62B5E87D240A77327,43761,6,8,2,32,47,1647
23616,23616,14E7B816E908FAE62B5E87D240A77327,42523,8,11,3,31,47,1597
23617,23617,14E7B816E908FAE62B5E87D240A77327,43761,14,18,4,32,47,1647
23628,23628,D8063B7C8CAA23F18B002D2A443A5135,43101,0,11,11,46,40,2340
23629,23629,D8063B7C8CAA23F18B002D2A443A5135,43951,11,17,6,49,41,2491
23630,23630,D8063B7C8CAA23F18B002D2A443A5135,43101,17,19,2,46,40,2340
23637,23637,56C4E47448F48431A95DFD66A119F059,42871,0,6,6,30,45,1545
23638,23638,56C4E47448F48431A95DFD66A119F059,11875,7,8,1,30,46,1546
23639,23639,56C4E47448F48431A95DFD66A119F059,12661,12,13,1,32,45,1645
23640,23640,56C4E47448F48431A95DFD66A119F059,12311,16,20,4,30,44,1544
23644,23644,E3139DB091B4CD3C84624B2D1FAA8A70,43161,0,7,7,35,47,1797
23645,23645,E3139DB091B4CD3C84624B2D1FAA8A70,10841,8,10,2,37,47,1897
23646,23646,E3139DB091B4CD3C84624B2D1FAA8A70,42161,10,16,6,36,47,1847
23647,23647,E3139DB091B4CD3C84624B2D1FAA8A70,11211,17,18,1,34,49,1749
23651,23651,1F586282DD0AC03725A5E548411F5D82,10841,0,3,3,37,47,1897
23652,23652,1F586282DD0AC03725A5E548411F5D82,12514,5,13,8,38,47,1947
23653,23653,1F586282DD0AC03725A5E548411F5D82,10841,16,18,2,37,47,1897
23654,23654,DE6709015B79F307E57CED7DDDF807DA,12491,8,9,1,36,43,1843
23655,23655,DE6709015B79F307E57CED7DDDF807DA,42151,11,12,1,35,45,1795
23656,23656,DE6709015B79F307E57CED7DDDF807DA,42861,14,18,4,37,44,1894
23657,23657,DE6709015B79F307E57CED7DDDF807DA,42151,21,22,1,35,45,1795
23666,23666,5CD05C4F3FA986DCFEC1824F9E061C0E,11331,0,8,8,37,48,1898
23667,23667,5CD05C4F3FA986DCFEC1824F9E061C0E,40505,11,12,1,36,48,1848
23668,23668,5CD05C4F3FA986DCFEC1824F9E061C0E,43731,17,18,1,34,47,1747
23669,23669,5CD05C4F3FA986DCFEC1824F9E061C0E,10971,19,22,3,35,47,1797
23679,23679,662B4DE10B5E46302328673CD9C61795,10111,0,7,7,37,47,1897
23680,23680,662B4DE10B5E46302328673CD9C61795,11491,8,17,9,36,47,1847
23681,23681,662B4DE10B5E46302328673CD9C61795,10111,18,23,5,37,47,1897
23682,23682,0B302A96FA0DFDEB2B3F6999345F0CFE,10301,0,3,3,31,45,1595
23683,23683,0B302A96FA0DFDEB2B3F6999345F0CFE,12661,4,9,5,32,45,1645
23684,23684,0B302A96FA0DFDEB2B3F6999345F0CFE,12311,12,15,3,30,44,1544
23685,23685,0B302A96FA0DFDEB2B3F6999345F0CFE,11834,19,23,4,32,45,1645
23686,23686,C247820FF94535A6E7B0AE8ABDC5672D,12221,1,10,9,43,44,2194
23687,23687,C247820FF94535A6E7B0AE8ABDC5672D,42201,14,17,3,43,46,2196
23688,23688,C247820FF94535A6E7B0AE8ABDC5672D,42111,20,22,2,44,46,2246
23708,23708,8E0D20320C5276BDD797BA6D65B9C51D,11074,0,7,7,37,47,1897
23709,23709,8E0D20320C5276BDD797BA6D65B9C51D,11231,8,15,7,37,49,1899
23710,23710,8E0D20320C5276BDD797BA6D65B9C51D,12083,16,18,2,36,49,1849
23711,23711,8E0D20320C5276BDD797BA6D65B9C51D,11074,19,23,4,37,47,1897
23716,23716,F7C245A127AE4F6E751BB51167E8E0AD,13271,3,5,2,41,47,2097
23717,23717,F7C245A127AE4F6E751BB51167E8E0AD,11481,5,8,3,41,48,2098
23718,23718,F7C245A127AE4F6E751BB51167E8E0AD,13271,12,23,11,41,47,2097
23719,23719,31CBC77871B7612C90BD0F8F8FF24A20,42321,0,11,11,43,47,2197
23720,23720,31CBC77871B7612C90BD0F8F8FF24A20,10801,15,17,2,42,47,2147
23721,23721,31CBC77871B7612C90BD0F8F8FF24A20,42321,17,18,1,43,47,2197
23722,23722,400659CE2E6F8BFF6D95D6F52F73DF5B,42921,0,5,5,33,47,1697
23723,23723,400659CE2E6F8BFF6D95D6F52F73DF5B,11861,5,11,6,32,47,1647
23724,23724,400659CE2E6F8BFF6D95D6F52F73DF5B,42921,11,22,11,33,47,1697
23728,23728,5D3AB87CDE152EA5E956E4DDC06AC59B,43361,0,12,12,38,48,1948
23729,23729,5D3AB87CDE152EA5E956E4DDC06AC59B,10471,12,13,1,37,48,1898
23730,23730,5D3AB87CDE152EA5E956E4DDC06AC59B,42581,14,23,9,38,48,1948
23731,23731,A9CB10B468D8E4AF35699B759EB26E7B,10251,1,11,10,35,47,1797
23732,23732,A9CB10B468D8E4AF35699B759EB26E7B,10411,14,16,2,36,48,1848
23733,23733,A9CB10B468D8E4AF35699B759EB26E7B,10251,21,23,2,35,47,1797
23734,23734,DF6451E86EE4B7B98BCA60FC558F51EE,11151,0,6,6,30,48,1548
23735,23735,DF6451E86EE4B7B98BCA60FC558F51EE,12121,9,18,9,29,47,1497
23736,23736,DF6451E86EE4B7B98BCA60FC558F51EE,11061,19,21,2,29,48,1498
23744,23744,CA4EF480CEFA96C9CD9B67B387B35170,43951,0,6,6,49,41,2491
23745,23745,CA4EF480CEFA96C9CD9B67B387B35170,43101,8,12,4,46,40,2340
23746,23746,CA4EF480CEFA96C9CD9B67B387B35170,43951,12,23,11,49,41,2491
23747,23747,2E18E8DF093288689E2805A1F3FB2A40,12641,0,4,4,10,43,543
23748,23748,2E18E8DF093288689E2805A1F3FB2A40,12921,6,8,2,9,41,491
23749,23749,2E18E8DF093288689E2805A1F3FB2A40,12641,8,18,10,10,43,543
23758,23758,9C211F2E07C17475B7D2343E9DD9ED0D,10721,0,9,9,31,48,1598
23759,23759,9C211F2E07C17475B7D2343E9DD9ED0D,10301,11,17,6,31,45,1595
23760,23760,9C211F2E07C17475B7D2343E9DD9ED0D,11061,18,20,2,29,48,1498
23766,23766,49913D060F497A2E80EBAA132C3ADF88,10544,0,10,10,28,48,1448
23767,23767,49913D060F497A2E80EBAA132C3ADF88,12381,14,15,1,32,48,1648
23768,23768,49913D060F497A2E80EBAA132C3ADF88,10544,17,23,6,28,48,1448
23795,23795,4A7E0C26D094908459DFDB4A502F3938,42161,0,9,9,36,47,1847
23796,23796,4A7E0C26D094908459DFDB4A502F3938,11331,10,11,1,37,48,1898
23797,23797,4A7E0C26D094908459DFDB4A502F3938,42161,11,22,11,36,47,1847
23801,23801,89084C54499EDD168F6753B4E522A173,11914,9,10,1,37,48,1898
23802,23802,89084C54499EDD168F6753B4E522A173,42581,14,18,4,38,48,1948
23803,23803,89084C54499EDD168F6753B4E522A173,11914,19,20,1,37,48,1898
23809,23809,9E981569C6718F42D2105C2620CE51EF,42461,0,6,6,45,47,2297
23810,23810,9E981569C6718F42D2105C2620CE51EF,42321,6,15,9,43,47,2197
23811,23811,9E981569C6718F42D2105C2620CE51EF,40691,19,23,4,42,48,2148
23831,23831,EF7A20DA8B1B5B9AEB04342FCDE03590,42271,0,7,7,40,47,2047
23832,23832,EF7A20DA8B1B5B9AEB04342FCDE03590,11794,9,12,3,38,49,1949
23833,23833,EF7A20DA8B1B5B9AEB04342FCDE03590,42271,12,23,11,40,47,2047
23842,23842,E46021F2EBB1FF86CE07D74A4E5B9C9F,12921,0,5,5,9,41,491
23843,23843,E46021F2EBB1FF86CE07D74A4E5B9C9F,49201,7,8,1,7,41,391
23844,23844,E46021F2EBB1FF86CE07D74A4E5B9C9F,12921,8,10,2,9,41,491
23845,23845,E46021F2EBB1FF86CE07D74A4E5B9C9F,49201,11,23,12,7,41,391
23863,23863,5C81004482023832AD545CD8F1DA1576,42351,3,9,6,38,45,1945
23864,23864,5C81004482023832AD545CD8F1DA1576,42231,11,19,8,37,46,1896
23865,23865,5C81004482023832AD545CD8F1DA1576,13911,22,23,1,39,46,1996
23870,23870,4515D69DA9DF7C67BD58AB71BAA57E58,11914,0,11,11,37,48,1898
23871,23871,4515D69DA9DF7C67BD58AB71BAA57E58,40171,13,17,4,38,48,1948
23872,23872,4515D69DA9DF7C67BD58AB71BAA57E58,11231,18,20,2,37,49,1899
23873,23873,4515D69DA9DF7C67BD58AB71BAA57E58,11914,20,23,3,37,48,1898
23874,23874,2FA830A3F4936C72A1774CB1227927A5,42161,0,7,7,36,47,1847
23875,23875,2FA830A3F4936C72A1774CB1227927A5,42271,10,15,5,40,47,2047
23876,23876,2FA830A3F4936C72A1774CB1227927A5,42161,18,23,5,36,47,1847
23877,23877,ECC711E8651604C7C144D4EB41E79316,13601,0,13,13,34,47,1747
23878,23878,ECC711E8651604C7C144D4EB41E79316,42921,17,18,1,33,47,1697
23879,23879,ECC711E8651604C7C144D4EB41E79316,13601,20,23,3,34,47,1747
23880,23880,0FCC9992AE8D71AAE404BB0E597A281E,11861,0,5,5,32,47,1647
23881,23881,0FCC9992AE8D71AAE404BB0E597A281E,43671,6,18,12,35,48,1798
23882,23882,0FCC9992AE8D71AAE404BB0E597A281E,11861,19,23,4,32,47,1647
23888,23888,3AAD0CC5613FE2A6FDEF58DFE6BF20B8,11061,3,6,3,29,48,1498
23889,23889,3AAD0CC5613FE2A6FDEF58DFE6BF20B8,11151,7,9,2,30,48,1548
23890,23890,3AAD0CC5613FE2A6FDEF58DFE6BF20B8,11061,13,23,10,29,48,1498
23896,23896,520F9ABAA156FE9FB29070D4A540240C,40673,0,10,10,36,48,1848
23897,23897,520F9ABAA156FE9FB29070D4A540240C,10111,10,21,11,37,47,1897
23898,23898,520F9ABAA156FE9FB29070D4A540240C,42161,21,23,2,36,47,1847
23904,23904,FF5DD8EE67E9FCEBC31AC48BEA2F1522,13371,0,14,14,41,47,2097
23905,23905,FF5DD8EE67E9FCEBC31AC48BEA2F1522,13101,14,18,4,40,47,2047
23906,23906,FF5DD8EE67E9FCEBC31AC48BEA2F1522,13371,18,23,5,41,47,2097
23907,23907,4DFCA00DE8A1EE33D561C65FAD863DDF,11381,0,6,6,30,47,1547
23908,23908,4DFCA00DE8A1EE33D561C65FAD863DDF,10681,9,12,3,30,48,1548
23909,23909,4DFCA00DE8A1EE33D561C65FAD863DDF,11061,12,15,3,29,48,1498
23910,23910,4DFCA00DE8A1EE33D561C65FAD863DDF,12381,19,20,1,32,48,1648
23916,23916,11FECEE7865049CDA55CAB34FACD3089,42871,0,6,6,30,45,1545
23917,23917,11FECEE7865049CDA55CAB34FACD3089,11871,7,14,7,29,46,1496
23918,23918,11FECEE7865049CDA55CAB34FACD3089,11151,15,16,1,30,48,1548
23919,23919,11FECEE7865049CDA55CAB34FACD3089,11061,20,22,2,29,48,1498
23925,23925,6AE2FA19F90C6BBDAB69E2E1C7BD408D,11921,1,13,12,38,48,1948
23926,23926,6AE2FA19F90C6BBDAB69E2E1C7BD408D,11914,14,15,1,37,48,1898
23927,23927,6AE2FA19F90C6BBDAB69E2E1C7BD408D,11921,18,23,5,38,48,1948
23941,23941,E36FD26FF0781015793D06014074DA42,12211,0,1,1,41,44,2094
23942,23942,E36FD26FF0781015793D06014074DA42,12221,3,5,2,43,44,2194
23943,23943,E36FD26FF0781015793D06014074DA42,12211,6,21,15,41,44,2094
23955,23955,85B29A2F7FF35790227E6EB92B7FBDCF,42351,9,13,4,38,45,1945
23956,23956,85B29A2F7FF35790227E6EB92B7FBDCF,11261,15,16,1,36,46,1846
23957,23957,85B29A2F7FF35790227E6EB92B7FBDCF,42351,19,22,3,38,45,1945
23958,23958,535378523E09141D94880FBA59BB7297,42301,1,15,14,36,47,1847
23959,23959,535378523E09141D94880FBA59BB7297,10111,19,20,1,37,47,1897
23960,23960,535378523E09141D94880FBA59BB7297,42301,21,23,2,36,47,1847
23979,23979,D9FB9F3F4820A4EF951566780A770C45,11261,1,8,7,36,46,1846
23980,23980,D9FB9F3F4820A4EF951566780A770C45,11941,9,10,1,37,46,1896
23981,23981,D9FB9F3F4820A4EF951566780A770C45,42351,10,13,3,38,45,1945
23982,23982,D9FB9F3F4820A4EF951566780A770C45,11261,14,22,8,36,46,1846
23993,23993,3C632F755669D5C30D783CB5D0C7EF1F,42281,0,2,2,40,48,2048
23994,23994,3C632F755669D5C30D783CB5D0C7EF1F,11806,2,6,4,41,48,2098
23995,23995,3C632F755669D5C30D783CB5D0C7EF1F,42281,6,23,17,40,48,2048
24000,24000,9582B0C41CE65E76B09E8491AC26676B,11875,0,6,6,30,46,1546
24001,24001,9582B0C41CE65E76B09E8491AC26676B,12311,7,18,11,30,44,1544
24002,24002,9582B0C41CE65E76B09E8491AC26676B,11875,19,23,4,30,46,1546
24011,24011,7681E0D68D024C184A5D43D46389C591,11861,0,4,4,32,47,1647
24012,24012,7681E0D68D024C184A5D43D46389C591,42921,5,12,7,33,47,1697
24013,24013,7681E0D68D024C184A5D43D46389C591,11861,12,19,7,32,47,1647
24014,24014,829F3CF969A99106A0CF5C6D0ED0FE14,42401,0,8,8,36,47,1847
24015,24015,829F3CF969A99106A0CF5C6D0ED0FE14,11751,9,15,6,35,48,1798
24016,24016,829F3CF969A99106A0CF5C6D0ED0FE14,42301,17,23,6,36,47,1847
24017,24017,7C98BDF484E2B085C51A4945E804FC0C,42151,1,16,15,35,45,1795
24018,24018,7C98BDF484E2B085C51A4945E804FC0C,12491,16,19,3,36,43,1843
24019,24019,7C98BDF484E2B085C51A4945E804FC0C,42151,19,21,2,35,45,1795
24039,24039,442785976ECE3A21AB2E12E8FCC04E3B,42523,3,15,12,31,47,1597
24040,24040,442785976ECE3A21AB2E12E8FCC04E3B,42491,15,16,1,32,46,1646
24041,24041,442785976ECE3A21AB2E12E8FCC04E3B,42523,17,18,1,31,47,1597
24042,24042,442785976ECE3A21AB2E12E8FCC04E3B,42491,22,23,1,32,46,1646
24043,24043,E43A1713BA9589398F5DEA7CD1BD08F1,43061,0,9,9,43,46,2196
24044,24044,E43A1713BA9589398F5DEA7CD1BD08F1,40365,12,14,2,42,48,2148
24045,24045,E43A1713BA9589398F5DEA7CD1BD08F1,13791,16,23,7,42,47,2147
24046,24046,F9B50F8C0BC548F341BD45D3142A9731,10161,0,11,11,35,49,1799
24047,24047,F9B50F8C0BC548F341BD45D3142A9731,43281,12,13,1,37,48,1898
24048,24048,F9B50F8C0BC548F341BD45D3142A9731,40925,17,20,3,35,49,1799
24049,24049,CD5264FA94F0D7079560625C6CCF7D91,13711,7,14,7,38,46,1946
24050,24050,CD5264FA94F0D7079560625C6CCF7D91,10271,14,17,3,37,46,1896
24051,24051,CD5264FA94F0D7079560625C6CCF7D91,13711,17,23,6,38,46,1946
24052,24052,5E269639C787C5D2BDF7F359B5257597,13381,0,8,8,39,47,1997
24053,24053,5E269639C787C5D2BDF7F359B5257597,11481,8,18,10,41,48,2098
24054,24054,5E269639C787C5D2BDF7F359B5257597,13381,19,23,4,39,47,1997
24084,24084,2CB6953F391C73F166D02AC31E930A06,40171,0,5,5,38,48,1948
24085,24085,2CB6953F391C73F166D02AC31E930A06,11914,6,16,10,37,48,1898
24086,24086,2CB6953F391C73F166D02AC31E930A06,42581,18,23,5,38,48,1948
24099,24099,ECE0FA03A797FCAE4E058BD1C3356073,42161,0,14,14,36,47,1847
24100,24100,ECE0FA03A797FCAE4E058BD1C3356073,10111,15,17,2,37,47,1897
24101,24101,ECE0FA03A797FCAE4E058BD1C3356073,42161,18,23,5,36,47,1847
24102,24102,6424EDB36AA4CB82C0E7E1EC5FB37688,12561,0,4,4,45,43,2293
24103,24103,6424EDB36AA4CB82C0E7E1EC5FB37688,12221,5,18,13,43,44,2194
24104,24104,6424EDB36AA4CB82C0E7E1EC5FB37688,12561,20,21,1,45,43,2293
24105,24105,9D7E28E179E5F5D009F8D277D0F434A8,10281,0,9,9,33,48,1698
24106,24106,9D7E28E179E5F5D009F8D277D0F434A8,11861,10,20,10,32,47,1647
24107,24107,9D7E28E179E5F5D009F8D277D0F434A8,10281,20,23,3,33,48,1698
24111,24111,2173A04AABD1130AA4443C921013A632,10351,0,2,2,28,45,1445
24112,24112,2173A04AABD1130AA4443C921013A632,10634,2,4,2,27,45,1395
24113,24113,2173A04AABD1130AA4443C921013A632,10351,4,12,8,28,45,1445
24114,24114,2173A04AABD1130AA4443C921013A632,10634,16,23,7,27,45,1395
24120,24120,31C99BE35DAA7CC1D9A6D662CA3683F3,41021,9,14,5,38,47,1947
24121,24121,31C99BE35DAA7CC1D9A6D662CA3683F3,10841,18,19,1,37,47,1897
24122,24122,31C99BE35DAA7CC1D9A6D662CA3683F3,42331,20,22,2,39,46,1996
24123,24123,31C99BE35DAA7CC1D9A6D662CA3683F3,10841,22,23,1,37,47,1897
24128,24128,4B5C492CF16B079882322240829D6566,11231,0,8,8,37,49,1899
24129,24129,4B5C492CF16B079882322240829D6566,40502,8,9,1,36,48,1848
24130,24130,4B5C492CF16B079882322240829D6566,11231,9,18,9,37,49,1899
24131,24131,4B5C492CF16B079882322240829D6566,43281,21,23,2,37,48,1898
24145,24145,2D36A352B4AA68B8B80A97FB73A5417A,10731,0,6,6,33,47,1697
24146,24146,2D36A352B4AA68B8B80A97FB73A5417A,13601,6,9,3,34,47,1747
24147,24147,2D36A352B4AA68B8B80A97FB73A5417A,10731,9,23,14,33,47,1697
24148,24148,D7B4DEFCB86C55D027A1210EEC02063B,11231,0,1,1,37,49,1899
24149,24149,D7B4DEFCB86C55D027A1210EEC02063B,11021,2,20,18,36,49,1849
24150,24150,D7B4DEFCB86C55D027A1210EEC02063B,11231,20,22,2,37,49,1899
24155,24155,F87C006906FC5F5270405EDAA1B0E6A3,12514,0,7,7,38,47,1947
24156,24156,F87C006906FC5F5270405EDAA1B0E6A3,10841,13,14,1,37,47,1897
24157,24157,F87C006906FC5F5270405EDAA1B0E6A3,10107,18,20,2,38,49,1949
24176,24176,537B866E49840CD2552EC8B3E30E45EA,42523,5,8,3,31,47,1597
24177,24177,537B866E49840CD2552EC8B3E30E45EA,42021,11,19,8,33,47,1697
24178,24178,537B866E49840CD2552EC8B3E30E45EA,11861,20,23,3,32,47,1647
24179,24179,3F29D0D409D1B6D4E7D2087740FD0BBC,42401,0,4,4,36,47,1847
24180,24180,3F29D0D409D1B6D4E7D2087740FD0BBC,10251,5,12,7,35,47,1797
24181,24181,3F29D0D409D1B6D4E7D2087740FD0BBC,42401,19,23,4,36,47,1847
24198,24198,0C2B805EE888E91F034AB21F925F07C4,19901,0,6,6,7,44,394
24199,24199,0C2B805EE888E91F034AB21F925F07C4,19114,9,10,1,7,43,393
24200,24200,0C2B805EE888E91F034AB21F925F07C4,19901,13,19,6,7,44,394
24209,24209,2F5563C242808A6A598EAFEA56F85890,10121,0,11,11,36,49,1849
24210,24210,2F5563C242808A6A598EAFEA56F85890,43671,11,13,2,35,48,1798
24211,24211,2F5563C242808A6A598EAFEA56F85890,10121,13,23,10,36,49,1849
24216,24216,F41482495C7C1BFF3B02971058475A44,42021,0,11,11,33,47,1697
24217,24217,F41482495C7C1BFF3B02971058475A44,10251,11,14,3,35,47,1797
24218,24218,F41482495C7C1BFF3B02971058475A44,11861,15,18,3,32,47,1647
24219,24219,F41482495C7C1BFF3B02971058475A44,42021,19,23,4,33,47,1697
24220,24220,BD8CAD24421DB26887D85E96D51CCDAC,42511,0,7,7,37,47,1897
24221,24221,BD8CAD24421DB26887D85E96D51CCDAC,12514,14,15,1,38,47,1947
24222,24222,BD8CAD24421DB26887D85E96D51CCDAC,42511,18,19,1,37,47,1897
24223,24223,BD8CAD24421DB26887D85E96D51CCDAC,40124,20,21,1,38,47,1947
24232,24232,47E88EEB0ACD8A050A018340BD482B6B,13331,0,1,1,38,47,1947
24233,24233,47E88EEB0ACD8A050A018340BD482B6B,11074,1,20,19,37,47,1897
24234,24234,47E88EEB0ACD8A050A018340BD482B6B,42583,21,22,1,40,48,2048
24244,24244,4C479F308A99C28A9312A97B8F351EC7,10161,0,18,18,35,49,1799
24245,24245,4C479F308A99C28A9312A97B8F351EC7,13561,18,20,2,37,49,1899
24246,24246,4C479F308A99C28A9312A97B8F351EC7,11201,20,23,3,35,49,1799
24273,24273,90AEF58BB4CABDF543DA1FFF777671DC,10292,0,6,6,30,47,1547
24274,24274,90AEF58BB4CABDF543DA1FFF777671DC,42523,9,11,2,31,47,1597
24275,24275,90AEF58BB4CABDF543DA1FFF777671DC,11381,12,23,11,30,47,1547
24276,24276,FAA3F795EAFB9E0592080667B1BA282F,13941,9,10,1,41,47,2097
24277,24277,FAA3F795EAFB9E0592080667B1BA282F,11001,11,12,1,42,47,2147
24278,24278,FAA3F795EAFB9E0592080667B1BA282F,13941,15,16,1,41,47,2097
24279,24279,FAA3F795EAFB9E0592080667B1BA282F,11001,16,19,3,42,47,2147
24280,24280,6D5AD065D152866F8B3D587D0B5B6031,11806,0,6,6,41,48,2098
24281,24281,6D5AD065D152866F8B3D587D0B5B6031,42271,6,18,12,40,47,2047
24282,24282,6D5AD065D152866F8B3D587D0B5B6031,11806,18,19,1,41,48,2098
24289,24289,18D411488A51B9B5C9FDB16761B10892,43761,0,6,6,32,47,1647
24290,24290,18D411488A51B9B5C9FDB16761B10892,43471,7,10,3,31,49,1599
24291,24291,18D411488A51B9B5C9FDB16761B10892,11861,15,22,7,32,47,1647
24300,24300,A534FD7E51A551BE3196665029DD0400,19931,0,12,12,7,43,393
24301,24301,A534FD7E51A551BE3196665029DD0400,12641,14,20,6,10,43,543
24302,24302,A534FD7E51A551BE3196665029DD0400,19931,22,23,1,7,43,393
24308,24308,7AF62B0D4CF514494A82D32705DCE2E9,40361,0,15,15,42,48,2148
24309,24309,7AF62B0D4CF514494A82D32705DCE2E9,12511,18,19,1,39,47,1997
24310,24310,7AF62B0D4CF514494A82D32705DCE2E9,40361,21,23,2,42,48,2148
24316,24316,9641FF809BC99375A7EB0913A38DD4C9,11061,0,8,8,29,48,1498
24317,24317,9641FF809BC99375A7EB0913A38DD4C9,42071,8,10,2,31,49,1599
24318,24318,9641FF809BC99375A7EB0913A38DD4C9,43391,10,22,12,29,48,1498
24324,24324,60DB2F1E5C63BE640D47B87EE3CFB05B,42461,0,7,7,45,47,2297
24325,24325,60DB2F1E5C63BE640D47B87EE3CFB05B,42321,7,10,3,43,47,2197
24326,24326,60DB2F1E5C63BE640D47B87EE3CFB05B,42461,11,23,12,45,47,2297
24330,24330,88BD866547E35D038437E393C4A29F25,42151,0,5,5,35,45,1795
24331,24331,88BD866547E35D038437E393C4A29F25,11261,6,8,2,36,46,1846
24332,24332,88BD866547E35D038437E393C4A29F25,42941,10,13,3,37,47,1897
24333,24333,88BD866547E35D038437E393C4A29F25,11261,15,23,8,36,46,1846
24339,24339,A9FDB442F75FC7FF8CE9BE4C7BB0C6E7,13711,4,9,5,38,46,1946
24340,24340,A9FDB442F75FC7FF8CE9BE4C7BB0C6E7,11491,11,12,1,36,47,1847
24341,24341,A9FDB442F75FC7FF8CE9BE4C7BB0C6E7,41401,12,18,6,37,46,1896
24342,24342,9BBBC00C93BA6A3176E2B008E6F8A88E,13911,1,4,3,39,46,1996
24343,24343,9BBBC00C93BA6A3176E2B008E6F8A88E,42351,6,7,1,38,45,1945
24344,24344,9BBBC00C93BA6A3176E2B008E6F8A88E,11261,9,19,10,36,46,1846
24345,24345,9BBBC00C93BA6A3176E2B008E6F8A88E,13911,20,22,2,39,46,1996
24355,24355,5DC656AE1F755A21D4CE0049D29039D4,11261,2,8,6,36,46,1846
24356,24356,5DC656AE1F755A21D4CE0049D29039D4,12491,9,17,8,36,43,1843
24357,24357,5DC656AE1F755A21D4CE0049D29039D4,11261,18,19,1,36,46,1846
24358,24358,5DC656AE1F755A21D4CE0049D29039D4,12491,21,23,2,36,43,1843
24359,24359,F9FE340AD192EDE0E7CC914D9F98789E,12491,0,3,3,36,43,1843
24360,24360,F9FE340AD192EDE0E7CC914D9F98789E,43451,6,16,10,37,40,1890
24361,24361,F9FE340AD192EDE0E7CC914D9F98789E,12491,19,23,4,36,43,1843
24362,24362,393401B408F6FAB061069A53043F6814,10191,10,12,2,40,48,2048
24363,24363,393401B408F6FAB061069A53043F6814,11291,12,14,2,40,49,2049
24364,24364,393401B408F6FAB061069A53043F6814,13121,16,21,5,38,46,1946
24365,24365,393401B408F6FAB061069A53043F6814,11291,22,23,1,40,49,2049
24389,24389,68D66AC2F31097852E1113FCAC38B096,42531,0,4,4,31,45,1595
24390,24390,68D66AC2F31097852E1113FCAC38B096,12121,6,7,1,29,47,1497
24391,24391,68D66AC2F31097852E1113FCAC38B096,42531,9,19,10,31,45,1595
24392,24392,68D66AC2F31097852E1113FCAC38B096,12311,19,21,2,30,44,1544
24401,24401,C404F60AD0A2D6862A45A9C320EEAB5F,11261,0,4,4,36,46,1846
24402,24402,C404F60AD0A2D6862A45A9C320EEAB5F,42861,7,18,11,37,44,1894
24403,24403,C404F60AD0A2D6862A45A9C320EEAB5F,11261,21,22,1,36,46,1846
24404,24404,DEAED68AE3C073AACA878B29D6C9BBC2,42231,2,13,11,37,46,1896
24405,24405,DEAED68AE3C073AACA878B29D6C9BBC2,42351,15,16,1,38,45,1945
24406,24406,DEAED68AE3C073AACA878B29D6C9BBC2,42231,19,23,4,37,46,1896
24426,24426,3167279CE8CFD8F4AA7B1E5335A41089,11361,0,7,7,22,48,1148
24427,24427,3167279CE8CFD8F4AA7B1E5335A41089,12601,11,13,2,25,47,1297
24428,24428,3167279CE8CFD8F4AA7B1E5335A41089,42711,14,19,5,26,48,1348
24429,24429,3167279CE8CFD8F4AA7B1E5335A41089,12601,21,22,1,25,47,1297
24433,24433,21214DF25ABBFE57C13DD19922691751,13911,0,10,10,39,46,1996
24434,24434,21214DF25ABBFE57C13DD19922691751,11261,13,19,6,36,46,1846
24435,24435,21214DF25ABBFE57C13DD19922691751,13231,20,21,1,39,46,1996
24436,24436,C83A24549690919D158BD0CE80AE31F4,11261,0,2,2,36,46,1846
24437,24437,C83A24549690919D158BD0CE80AE31F4,42864,6,7,1,38,44,1944
24438,24438,C83A24549690919D158BD0CE80AE31F4,11261,7,21,14,36,46,1846
24459,24459,0014D81C3ECBA44F259506A9B468FB1E,11431,2,7,5,29,47,1497
24460,24460,0014D81C3ECBA44F259506A9B468FB1E,11061,10,12,2,29,48,1498
24461,24461,0014D81C3ECBA44F259506A9B468FB1E,11431,14,23,9,29,47,1497
24485,24485,9C95D6292421E6B801C911060D75482F,12921,0,10,10,9,41,491
24486,24486,9C95D6292421E6B801C911060D75482F,12641,10,12,2,10,43,543
24487,24487,9C95D6292421E6B801C911060D75482F,12921,12,14,2,9,41,491
24488,24488,9C95D6292421E6B801C911060D75482F,12641,17,23,6,10,43,543
24492,24492,6D0799AB0F55190F6E5F774F154A9036,13271,0,6,6,41,47,2097
24493,24493,6D0799AB0F55190F6E5F774F154A9036,11481,6,13,7,41,48,2098
24494,24494,6D0799AB0F55190F6E5F774F154A9036,11801,14,22,8,42,48,2148
24495,24495,49AB4D2DD3BD71A7C7CC9A15B8B93EEA,42221,0,7,7,38,48,1948
24496,24496,49AB4D2DD3BD71A7C7CC9A15B8B93EEA,11551,9,10,1,39,49,1999
24497,24497,49AB4D2DD3BD71A7C7CC9A15B8B93EEA,13221,12,14,2,40,47,2047
24498,24498,49AB4D2DD3BD71A7C7CC9A15B8B93EEA,13371,14,19,5,41,47,2097
24499,24499,CEAC6C818D7651ADBA37DD2B6097C732,42351,0,11,11,38,45,1945
24500,24500,CEAC6C818D7651ADBA37DD2B6097C732,42301,12,14,2,36,47,1847
24501,24501,CEAC6C818D7651ADBA37DD2B6097C732,42351,14,18,4,38,45,1945
24502,24502,1F54E6BF7B3A6641B77A0D2E783C656A,11151,3,5,2,30,48,1548
24503,24503,1F54E6BF7B3A6641B77A0D2E783C656A,11061,7,21,14,29,48,1498
24504,24504,1F54E6BF7B3A6641B77A0D2E783C656A,11151,22,23,1,30,48,1548
24523,24523,775CA947FF37432092AA3395F5AA137B,43731,0,14,14,34,47,1747
24524,24524,775CA947FF37432092AA3395F5AA137B,10971,14,15,1,35,47,1797
24525,24525,775CA947FF37432092AA3395F5AA137B,10111,18,21,3,37,47,1897
24526,24526,FCA3C665B5BF337F331669EDB597A6AC,42151,0,8,8,35,45,1795
24527,24527,FCA3C665B5BF337F331669EDB597A6AC,10271,8,9,1,37,46,1896
24528,24528,FCA3C665B5BF337F331669EDB597A6AC,13121,9,18,9,38,46,1946
24529,24529,FCA3C665B5BF337F331669EDB597A6AC,42791,20,22,2,35,45,1795
24544,24544,360BDCD136FC688F810014C7E068DDA6,43761,4,10,6,32,47,1647
24545,24545,360BDCD136FC688F810014C7E068DDA6,42523,11,12,1,31,47,1597
24546,24546,360BDCD136FC688F810014C7E068DDA6,43761,12,23,11,32,47,1647
24547,24547,EC7B1406490C086F53DA3C0A24A69538,40637,0,9,9,36,47,1847
24548,24548,EC7B1406490C086F53DA3C0A24A69538,10251,12,15,3,35,47,1797
24549,24549,EC7B1406490C086F53DA3C0A24A69538,40502,18,19,1,36,48,1848
24550,24550,EC7B1406490C086F53DA3C0A24A69538,10251,20,23,3,35,47,1797
24555,24555,10B7F6DA30FEF909842005D2A7191DF7,42491,0,7,7,32,46,1646
24556,24556,10B7F6DA30FEF909842005D2A7191DF7,42523,9,10,1,31,47,1597
24557,24557,10B7F6DA30FEF909842005D2A7191DF7,42491,10,23,13,32,46,1646
24558,24558,170A0AC014DC9BA930EAA0E56A2C9D03,42321,0,6,6,43,47,2197
24559,24559,170A0AC014DC9BA930EAA0E56A2C9D03,11701,10,19,9,43,48,2198
24560,24560,170A0AC014DC9BA930EAA0E56A2C9D03,42321,21,23,2,43,47,2197
24564,24564,667DA38911C3C96DC83EC0865AF97CD1,11731,0,8,8,36,48,1848
24565,24565,667DA38911C3C96DC83EC0865AF97CD1,42581,9,10,1,38,48,1948
24566,24566,667DA38911C3C96DC83EC0865AF97CD1,11914,11,20,9,37,48,1898
24567,24567,667DA38911C3C96DC83EC0865AF97CD1,11731,21,23,2,36,48,1848
24568,24568,E68D0CB0F880ABD846C1FA07F5533B50,42021,2,8,6,33,47,1697
24569,24569,E68D0CB0F880ABD846C1FA07F5533B50,43761,9,10,1,32,47,1647
24570,24570,E68D0CB0F880ABD846C1FA07F5533B50,42021,13,23,10,33,47,1697
24592,24592,BBEB20E4CE09F78FD771E8818046FF01,42583,0,5,5,40,48,2048
24593,24593,BBEB20E4CE09F78FD771E8818046FF01,42221,6,8,2,38,48,1948
24594,24594,BBEB20E4CE09F78FD771E8818046FF01,42271,8,19,11,40,47,2047
24595,24595,BBEB20E4CE09F78FD771E8818046FF01,42583,19,23,4,40,48,2048
24608,24608,2DF13F3C6B51FEAFB9527CE1523C2712,11381,10,12,2,30,47,1547
24609,24609,2DF13F3C6B51FEAFB9527CE1523C2712,10951,13,14,1,29,48,1498
24610,24610,2DF13F3C6B51FEAFB9527CE1523C2712,11381,16,18,2,30,47,1547
24615,24615,360CAB205F052520FED1AC4C9779857A,42221,4,6,2,38,48,1948
24616,24616,360CAB205F052520FED1AC4C9779857A,11331,8,9,1,37,48,1898
24617,24617,360CAB205F052520FED1AC4C9779857A,42221,9,10,1,38,48,1948
24618,24618,360CAB205F052520FED1AC4C9779857A,11941,12,22,10,37,46,1896
24623,24623,053AF9D02F27761F1671A0A9A244D378,40441,0,6,6,30,48,1548
24624,24624,053AF9D02F27761F1671A0A9A244D378,42291,11,14,3,29,48,1498
24625,24625,053AF9D02F27761F1671A0A9A244D378,11381,15,22,7,30,47,1547
24634,24634,13E192A41573EE21B0A86028C0154874,11531,0,1,1,34,49,1749
24635,24635,13E192A41573EE21B0A86028C0154874,42471,2,3,1,35,49,1799
24636,24636,13E192A41573EE21B0A86028C0154874,11531,7,13,6,34,49,1749
24637,24637,13E192A41573EE21B0A86028C0154874,42471,18,23,5,35,49,1799
24638,24638,221907A0B5FBDE67A1B2826B991290F1,11061,0,7,7,29,48,1498
24639,24639,221907A0B5FBDE67A1B2826B991290F1,11381,12,13,1,30,47,1547
24640,24640,221907A0B5FBDE67A1B2826B991290F1,12121,16,18,2,29,47,1497
24641,24641,221907A0B5FBDE67A1B2826B991290F1,11061,21,23,2,29,48,1498
24645,24645,831CEF471029417D091D2BE9F78234DD,10801,2,4,2,42,47,2147
24646,24646,831CEF471029417D091D2BE9F78234DD,42321,5,8,3,43,47,2197
24647,24647,831CEF471029417D091D2BE9F78234DD,13941,15,18,3,41,47,2097
24651,24651,36A90A80131B8512F2CF65258F5BBD79,13101,3,9,6,40,47,2047
24652,24652,36A90A80131B8512F2CF65258F5BBD79,13271,10,11,1,41,47,2097
24653,24653,36A90A80131B8512F2CF65258F5BBD79,10107,12,21,9,38,49,1949
24659,24659,89C5F5C036761FD2C32F64BC4CDE2E5B,42041,0,1,1,10,47,547
24660,24660,89C5F5C036761FD2C32F64BC4CDE2E5B,19024,1,9,8,9,45,495
24661,24661,89C5F5C036761FD2C32F64BC4CDE2E5B,19441,12,23,11,8,46,446
24662,24662,B2012EE6BD195EC80673B0F2B5EC1C5E,12921,1,5,4,9,41,491
24663,24663,B2012EE6BD195EC80673B0F2B5EC1C5E,12641,6,21,15,10,43,543
24664,24664,B2012EE6BD195EC80673B0F2B5EC1C5E,12921,22,23,1,9,41,491
24665,24665,DB5C0024A3C9A77900C99EA6DCF506D1,11941,0,6,6,37,46,1896
24666,24666,DB5C0024A3C9A77900C99EA6DCF506D1,11261,18,19,1,36,46,1846
24667,24667,DB5C0024A3C9A77900C99EA6DCF506D1,11941,20,21,1,37,46,1896
24676,24676,A0E96E8A9AD818FBF087A431E03695B8,10471,0,8,8,37,48,1898
24677,24677,A0E96E8A9AD818FBF087A431E03695B8,11021,8,17,9,36,49,1849
24678,24678,A0E96E8A9AD818FBF087A431E03695B8,10471,20,23,3,37,48,1898
24690,24690,0CE1530259EA66797A9FEEF237D2664E,42861,0,5,5,37,44,1894
24691,24691,0CE1530259EA66797A9FEEF237D2664E,13231,6,9,3,39,46,1996
24692,24692,0CE1530259EA66797A9FEEF237D2664E,42861,12,23,11,37,44,1894
24697,24697,612F18F83615AD18C521C0260D4FB623,11914,0,7,7,37,48,1898
24698,24698,612F18F83615AD18C521C0260D4FB623,42581,8,9,1,38,48,1948
24699,24699,612F18F83615AD18C521C0260D4FB623,11914,10,23,13,37,48,1898
24715,24715,8A35309960304DAF98A2649637AD86E1,10634,0,10,10,27,45,1395
24716,24716,8A35309960304DAF98A2649637AD86E1,10351,11,18,7,28,45,1445
24717,24717,8A35309960304DAF98A2649637AD86E1,10634,18,19,1,27,45,1395
24718,24718,8A35309960304DAF98A2649637AD86E1,10351,22,23,1,28,45,1445
24727,24727,EB7EB6074C1F2A07A41462E31EDA6629,42401,0,9,9,36,47,1847
24728,24728,EB7EB6074C1F2A07A41462E31EDA6629,10111,12,16,4,37,47,1897
24729,24729,EB7EB6074C1F2A07A41462E31EDA6629,42301,18,23,5,36,47,1847
24730,24730,10D6E07CB2A92B35A37820638A6643C4,11771,0,2,2,39,49,1999
24731,24731,10D6E07CB2A92B35A37820638A6643C4,12514,4,6,2,38,47,1947
24732,24732,10D6E07CB2A92B35A37820638A6643C4,10841,9,12,3,37,47,1897
24733,24733,10D6E07CB2A92B35A37820638A6643C4,11771,14,23,9,39,49,1999
24745,24745,94150C503E4F188DBA61689C298AFE78,11231,0,18,18,37,49,1899
24746,24746,94150C503E4F188DBA61689C298AFE78,41591,19,20,1,34,49,1749
24747,24747,94150C503E4F188DBA61689C298AFE78,11231,21,23,2,37,49,1899
24751,24751,A2C5AB7B1D9B4051DCCFBB940FDF47B0,13711,0,7,7,38,46,1946
24752,24752,A2C5AB7B1D9B4051DCCFBB940FDF47B0,42231,9,10,1,37,46,1896
24753,24753,A2C5AB7B1D9B4051DCCFBB940FDF47B0,13711,14,23,9,38,46,1946
24757,24757,7C305C42CF65A3D7BEC72C7CD6F5E03B,11061,0,13,13,29,48,1498
24758,24758,7C305C42CF65A3D7BEC72C7CD6F5E03B,11151,14,18,4,30,48,1548
24759,24759,7C305C42CF65A3D7BEC72C7CD6F5E03B,11061,18,19,1,29,48,1498
24768,24768,CC3FA096FA296BC301B8FB82BD507846,42471,2,6,4,35,49,1799
24769,24769,CC3FA096FA296BC301B8FB82BD507846,11531,7,9,2,34,49,1749
24770,24770,CC3FA096FA296BC301B8FB82BD507846,42471,10,23,13,35,49,1799
24771,24771,28C2D2FE4D28624F13409918B749F4EA,42231,0,5,5,37,46,1896
24772,24772,28C2D2FE4D28624F13409918B749F4EA,13711,7,17,10,38,46,1946
24773,24773,28C2D2FE4D28624F13409918B749F4EA,42231,19,20,1,37,46,1896
24774,24774,28C2D2FE4D28624F13409918B749F4EA,13711,22,23,1,38,46,1946
24775,24775,FE84C5B6FD29AD1D9C75D32BF19FA780,11261,0,6,6,36,46,1846
24776,24776,FE84C5B6FD29AD1D9C75D32BF19FA780,42861,7,9,2,37,44,1894
24777,24777,FE84C5B6FD29AD1D9C75D32BF19FA780,11261,9,19,10,36,46,1846
24785,24785,BD517E29BD7069EA61B2CA0844AA760E,10731,0,6,6,33,47,1697
24786,24786,BD517E29BD7069EA61B2CA0844AA760E,42141,8,18,10,32,47,1647
24787,24787,BD517E29BD7069EA61B2CA0844AA760E,10731,21,22,1,33,47,1697
24788,24788,851B0DC09818756606A4B6B5AFE731B9,42221,2,13,11,38,48,1948
24789,24789,851B0DC09818756606A4B6B5AFE731B9,40234,14,16,2,35,49,1799
24790,24790,851B0DC09818756606A4B6B5AFE731B9,42864,17,18,1,38,44,1944
24791,24791,EDBE9058BB0B28E0915A84395E9226D9,11261,0,4,4,36,46,1846
24792,24792,EDBE9058BB0B28E0915A84395E9226D9,42861,6,15,9,37,44,1894
24793,24793,EDBE9058BB0B28E0915A84395E9226D9,11261,17,22,5,36,46,1846
24803,24803,A9855A0CED48CC18B59E12E4C1F5151B,11914,0,16,16,37,48,1898
24804,24804,A9855A0CED48CC18B59E12E4C1F5151B,13121,17,19,2,38,46,1946
24805,24805,A9855A0CED48CC18B59E12E4C1F5151B,10271,20,21,1,37,46,1896
24806,24806,DE3E54BB176520C8599DB39C6B8B34A3,43951,0,5,5,49,41,2491
24807,24807,DE3E54BB176520C8599DB39C6B8B34A3,13411,6,9,3,49,42,2492
24808,24808,DE3E54BB176520C8599DB39C6B8B34A3,43951,12,23,11,49,41,2491
24813,24813,0E54FDDDFEF0BF7075D3505985BA7000,42381,0,5,5,39,41,1991
24814,24814,0E54FDDDFEF0BF7075D3505985BA7000,43451,6,11,5,37,40,1890
24815,24815,0E54FDDDFEF0BF7075D3505985BA7000,13071,12,14,2,41,41,2091
24816,24816,0E54FDDDFEF0BF7075D3505985BA7000,43451,14,18,4,37,40,1890
24821,24821,0E40901167898EDFDA9B65FF7D65C295,42041,9,10,1,10,47,547
24822,24822,0E40901167898EDFDA9B65FF7D65C295,11471,12,13,1,12,48,648
24823,24823,0E40901167898EDFDA9B65FF7D65C295,19021,17,18,1,10,45,545
24827,24827,8F0F9FD615E5CF54612AE31BD94EEC63,11381,8,14,6,30,47,1547
24828,24828,8F0F9FD615E5CF54612AE31BD94EEC63,11431,15,16,1,29,47,1497
24829,24829,8F0F9FD615E5CF54612AE31BD94EEC63,11381,17,21,4,30,47,1547
24833,24833,BAA43C143E20DD56728B5265BDF01E01,11811,6,9,3,38,49,1949
24834,24834,BAA43C143E20DD56728B5265BDF01E01,13711,10,15,5,38,46,1946
24835,24835,BAA43C143E20DD56728B5265BDF01E01,10107,16,23,7,38,49,1949
24855,24855,B5CCEF3E5B535EF97877E582DB4AA1BB,11381,0,2,2,30,47,1547
24856,24856,B5CCEF3E5B535EF97877E582DB4AA1BB,11061,5,6,1,29,48,1498
24857,24857,B5CCEF3E5B535EF97877E582DB4AA1BB,11381,7,23,16,30,47,1547
24865,24865,8C6728922EF1CCC03B1E56C8334750DD,11641,0,8,8,22,49,1149
24866,24866,8C6728922EF1CCC03B1E56C8334750DD,42681,11,12,1,24,48,1248
24867,24867,8C6728922EF1CCC03B1E56C8334750DD,11641,13,21,8,22,49,1149
24868,24868,FD60C133B106731C26412AD92D44C95F,42301,0,1,1,36,47,1847
24869,24869,FD60C133B106731C26412AD92D44C95F,10111,2,19,17,37,47,1897
24870,24870,FD60C133B106731C26412AD92D44C95F,42301,20,21,1,36,47,1847
24871,24871,FD60C133B106731C26412AD92D44C95F,10111,21,23,2,37,47,1897
24876,24876,635DC88C9F9AF491963B1ADEFDFD70EA,11161,0,14,14,32,48,1648
24877,24877,635DC88C9F9AF491963B1ADEFDFD70EA,11151,17,18,1,30,48,1548
24878,24878,635DC88C9F9AF491963B1ADEFDFD70EA,11161,20,23,3,32,48,1648
24879,24879,569FE1B0CCF701005479FDA64CAA96A2,11074,0,6,6,37,47,1897
24880,24880,569FE1B0CCF701005479FDA64CAA96A2,11231,8,18,10,37,49,1899
24881,24881,569FE1B0CCF701005479FDA64CAA96A2,11074,18,20,2,37,47,1897
24894,24894,2FCEA8AFEE1EB24BBCF386268B1232AC,43311,0,1,1,31,48,1598
24895,24895,2FCEA8AFEE1EB24BBCF386268B1232AC,11161,1,3,2,32,48,1648
24896,24896,2FCEA8AFEE1EB24BBCF386268B1232AC,11061,6,8,2,29,48,1498
24897,24897,2FCEA8AFEE1EB24BBCF386268B1232AC,11161,9,18,9,32,48,1648
24898,24898,D429753EEB35077FBB0F7FD7B24671DA,42381,3,5,2,39,41,1991
24899,24899,D429753EEB35077FBB0F7FD7B24671DA,43451,7,17,10,37,40,1890
24900,24900,D429753EEB35077FBB0F7FD7B24671DA,13071,17,23,6,41,41,2091
24920,24920,B70267EAE88B62F9B87C2FB6E0BEE8BF,43621,6,7,1,46,48,2348
24921,24921,B70267EAE88B62F9B87C2FB6E0BEE8BF,42321,9,16,7,43,47,2197
24922,24922,B70267EAE88B62F9B87C2FB6E0BEE8BF,43621,16,21,5,46,48,2348
24927,24927,7427B3324440A1EFA3CDACBD7F38F5A4,13911,0,3,3,39,46,1996
24928,24928,7427B3324440A1EFA3CDACBD7F38F5A4,11261,8,14,6,36,46,1846
24929,24929,7427B3324440A1EFA3CDACBD7F38F5A4,13911,15,17,2,39,46,1996
24930,24930,7427B3324440A1EFA3CDACBD7F38F5A4,10601,21,22,1,39,47,1997
24976,24976,2EEA4ED7A1CF18C4C1F40671BCC8C125,13671,1,10,9,27,43,1393
24977,24977,2EEA4ED7A1CF18C4C1F40671BCC8C125,10351,11,12,1,28,45,1445
24978,24978,2EEA4ED7A1CF18C4C1F40671BCC8C125,13671,15,17,2,27,43,1393
24979,24979,2EEA4ED7A1CF18C4C1F40671BCC8C125,10351,22,23,1,28,45,1445
24980,24980,57E38E75C3154FA28FE7B22CE29AF775,11151,1,13,12,30,48,1548
24981,24981,57E38E75C3154FA28FE7B22CE29AF775,11061,14,16,2,29,48,1498
24982,24982,57E38E75C3154FA28FE7B22CE29AF775,10381,16,18,2,31,49,1599
24983,24983,57E38E75C3154FA28FE7B22CE29AF775,11151,20,21,1,30,48,1548
24984,24984,B6B9FD86337BD93E048A74A5E56BF693,10111,0,8,8,37,47,1897
24985,24985,B6B9FD86337BD93E048A74A5E56BF693,11751,13,14,1,35,48,1798
24986,24986,B6B9FD86337BD93E048A74A5E56BF693,12083,15,22,7,36,49,1849
24987,24987,D2007E56CDD263F500CAE75A804D6B50,42871,0,13,13,30,45,1545
24988,24988,D2007E56CDD263F500CAE75A804D6B50,12311,16,17,1,30,44,1544
24989,24989,D2007E56CDD263F500CAE75A804D6B50,42871,21,23,2,30,45,1545
24990,24990,41CA667DED9699C7B767163541666854,43761,6,14,8,32,47,1647
24991,24991,41CA667DED9699C7B767163541666854,10341,18,19,1,31,47,1597
24992,24992,41CA667DED9699C7B767163541666854,43761,21,22,1,32,47,1647
24993,24993,DC5D5D8C8D4DEF01D59496E4F2B56767,11231,0,19,19,37,49,1899
24994,24994,DC5D5D8C8D4DEF01D59496E4F2B56767,11531,20,22,2,34,49,1749
24995,24995,DC5D5D8C8D4DEF01D59496E4F2B56767,11231,22,23,1,37,49,1899
25006,25006,B951230F2D8FB21FF5FBA5B70040A128,10681,0,14,14,30,48,1548
25007,25007,B951230F2D8FB21FF5FBA5B70040A128,11061,20,21,1,29,48,1498
25008,25008,B951230F2D8FB21FF5FBA5B70040A128,10681,21,22,1,30,48,1548
25009,25009,F10F5F870D2BAF9C3378171A398BFD7F,42151,2,3,1,35,45,1795
25010,25010,F10F5F870D2BAF9C3378171A398BFD7F,42861,3,9,6,37,44,1894
25011,25011,F10F5F870D2BAF9C3378171A398BFD7F,42151,12,20,8,35,45,1795
25012,25012,918AD7E0042462198E5F018A267D9BF2,12641,0,10,10,10,43,543
25013,25013,918AD7E0042462198E5F018A267D9BF2,12921,13,14,1,9,41,491
25014,25014,918AD7E0042462198E5F018A267D9BF2,12641,17,23,6,10,43,543
25015,25015,02C59B5D03B5AFABF41FCA4036F1E267,11781,0,13,13,38,49,1949
25016,25016,02C59B5D03B5AFABF41FCA4036F1E267,40951,14,17,3,36,49,1849
25017,25017,02C59B5D03B5AFABF41FCA4036F1E267,10901,18,19,1,35,48,1798
25018,25018,09C311D86737E534420F351D48938D74,12381,0,12,12,32,48,1648
25019,25019,09C311D86737E534420F351D48938D74,43161,13,16,3,35,47,1797
25020,25020,09C311D86737E534420F351D48938D74,13511,16,17,1,34,48,1748
25021,25021,09C311D86737E534420F351D48938D74,12381,20,23,3,32,48,1648
25025,25025,17BFCEDD973B29E8302E2E7670AFE303,10471,0,14,14,37,48,1898
25026,25026,17BFCEDD973B29E8302E2E7670AFE303,40171,14,16,2,38,48,1948
25027,25027,17BFCEDD973B29E8302E2E7670AFE303,11781,18,19,1,38,49,1949
25028,25028,28AE6FF44E8686DC354D2E3DF7700FCC,42461,0,6,6,45,47,2297
25029,25029,28AE6FF44E8686DC354D2E3DF7700FCC,42321,10,11,1,43,47,2197
25030,25030,28AE6FF44E8686DC354D2E3DF7700FCC,42461,11,23,12,45,47,2297
25031,25031,F9DC2F592D6193343BD07B6C3149B9BD,11651,0,7,7,33,47,1697
25032,25032,F9DC2F592D6193343BD07B6C3149B9BD,42161,8,9,1,36,47,1847
25033,25033,F9DC2F592D6193343BD07B6C3149B9BD,43731,9,19,10,34,47,1747
25034,25034,F9DC2F592D6193343BD07B6C3149B9BD,10731,22,23,1,33,47,1697
25038,25038,4F3F717E93BC5AFE00C4421DCBF0AA01,40322,0,8,8,38,46,1946
25039,25039,4F3F717E93BC5AFE00C4421DCBF0AA01,11261,9,20,11,36,46,1846
25040,25040,4F3F717E93BC5AFE00C4421DCBF0AA01,10811,22,23,1,38,46,1946
25045,25045,F808ABC7A00624398DD0E1E1BEE09822,11021,0,8,8,36,49,1849
25046,25046,F808ABC7A00624398DD0E1E1BEE09822,11201,8,10,2,35,49,1799
25047,25047,F808ABC7A00624398DD0E1E1BEE09822,11021,12,19,7,36,49,1849
25048,25048,F808ABC7A00624398DD0E1E1BEE09822,11201,20,22,2,35,49,1799
25054,25054,8EB0EA8A0FB0C9F044024C5DB3D8B52C,19021,0,13,13,10,45,545
25055,25055,8EB0EA8A0FB0C9F044024C5DB3D8B52C,19024,14,16,2,9,45,495
25056,25056,8EB0EA8A0FB0C9F044024C5DB3D8B52C,19021,18,19,1,10,45,545
25060,25060,649D537EAF2002D83012C69B3CA759A0,11161,5,13,8,32,48,1648
25061,25061,649D537EAF2002D83012C69B3CA759A0,43311,15,17,2,31,48,1598
25062,25062,649D537EAF2002D83012C69B3CA759A0,11061,17,18,1,29,48,1498
25066,25066,8F7952C6A7A4230F6F6D59DE64E25351,13911,0,5,5,39,46,1996
25067,25067,8F7952C6A7A4230F6F6D59DE64E25351,11481,12,20,8,41,48,2098
25068,25068,8F7952C6A7A4230F6F6D59DE64E25351,13911,20,23,3,39,46,1996
25069,25069,4FA7E2AF35091649A8D61648BF92F5C0,42581,0,6,6,38,48,1948
25070,25070,4FA7E2AF35091649A8D61648BF92F5C0,10471,10,11,1,37,48,1898
25071,25071,4FA7E2AF35091649A8D61648BF92F5C0,42581,12,14,2,38,48,1948
25072,25072,4FA7E2AF35091649A8D61648BF92F5C0,10471,14,18,4,37,48,1898
25093,25093,94A66B099C3B286235DEE73BAE7FEB6C,11861,0,11,11,32,47,1647
25094,25094,94A66B099C3B286235DEE73BAE7FEB6C,10281,15,16,1,33,48,1698
25095,25095,94A66B099C3B286235DEE73BAE7FEB6C,11861,16,21,5,32,47,1647
25123,25123,2FC158799FF19F821FBD3DC4EFE863DB,43101,0,13,13,46,40,2340
25124,25124,2FC158799FF19F821FBD3DC4EFE863DB,13551,13,17,4,45,38,2288
25125,25125,2FC158799FF19F821FBD3DC4EFE863DB,43101,19,20,1,46,40,2340
25126,25126,2FC158799FF19F821FBD3DC4EFE863DB,13551,22,23,1,45,38,2288
25142,25142,1A405C5DE99A88589837D5F72AD75DAF,11331,0,6,6,37,48,1898
25143,25143,1A405C5DE99A88589837D5F72AD75DAF,11531,12,13,1,34,49,1749
25144,25144,1A405C5DE99A88589837D5F72AD75DAF,43731,14,17,3,34,47,1747
25145,25145,1A405C5DE99A88589837D5F72AD75DAF,11911,19,22,3,37,48,1898
25146,25146,A4CBFA774BBCB1E081978588796288CA,10901,0,7,7,35,48,1798
25147,25147,A4CBFA774BBCB1E081978588796288CA,11231,8,18,10,37,49,1899
25148,25148,A4CBFA774BBCB1E081978588796288CA,10901,19,23,4,35,48,1798
25149,25149,6C085935D99355C13FA9E34597239F44,13911,0,3,3,39,46,1996
25150,25150,6C085935D99355C13FA9E34597239F44,43341,3,4,1,41,46,2096
25151,25151,6C085935D99355C13FA9E34597239F44,42031,14,18,4,40,46,2046
25152,25152,6C085935D99355C13FA9E34597239F44,13911,19,23,4,39,46,1996
25153,25153,7A4DBB44BE9FCEDC5184703F54CA8A35,11381,1,7,6,30,47,1547
25154,25154,7A4DBB44BE9FCEDC5184703F54CA8A35,10951,8,10,2,29,48,1498
25155,25155,7A4DBB44BE9FCEDC5184703F54CA8A35,11381,12,18,6,30,47,1547
25156,25156,3ACB60E55F95448DF312A377377AF46F,10721,2,4,2,31,48,1598
25157,25157,3ACB60E55F95448DF312A377377AF46F,11061,4,10,6,29,48,1498
25158,25158,3ACB60E55F95448DF312A377377AF46F,10721,13,15,2,31,48,1598
25159,25159,3ACB60E55F95448DF312A377377AF46F,11061,16,23,7,29,48,1498
25160,25160,C44A844815EDFF1B8B49CFB3C71F380E,42161,0,17,17,36,47,1847
25161,25161,C44A844815EDFF1B8B49CFB3C71F380E,11074,17,19,2,37,47,1897
25162,25162,C44A844815EDFF1B8B49CFB3C71F380E,42161,19,21,2,36,47,1847
25174,25174,A02E7FCD783D3B9FF6BA938561F51C11,42161,0,7,7,36,47,1847
25175,25175,A02E7FCD783D3B9FF6BA938561F51C11,10251,8,17,9,35,47,1797
25176,25176,A02E7FCD783D3B9FF6BA938561F51C11,42161,18,22,4,36,47,1847
25181,25181,1C28F39B6E92104A5F767DF1DD64A4C7,11753,0,8,8,35,48,1798
25182,25182,1C28F39B6E92104A5F767DF1DD64A4C7,11074,13,17,4,37,47,1897
25183,25183,1C28F39B6E92104A5F767DF1DD64A4C7,11753,17,23,6,35,48,1798
25199,25199,3544B9900CDDC16C4606729762F4FE67,11151,0,13,13,30,48,1548
25200,25200,3544B9900CDDC16C4606729762F4FE67,43391,14,15,1,29,48,1498
25201,25201,3544B9900CDDC16C4606729762F4FE67,11151,15,23,8,30,48,1548
25211,25211,D64DF2C2FAB80CB42859AD7194DBB705,11921,0,6,6,38,48,1948
25212,25212,D64DF2C2FAB80CB42859AD7194DBB705,11074,7,13,6,37,47,1897
25213,25213,D64DF2C2FAB80CB42859AD7194DBB705,11921,14,22,8,38,48,1948
25214,25214,466786D54A3236A0CA1395E1CA33DFC4,11381,3,17,14,30,47,1547
25215,25215,466786D54A3236A0CA1395E1CA33DFC4,42921,18,19,1,33,47,1697
25216,25216,466786D54A3236A0CA1395E1CA33DFC4,13651,20,21,1,30,47,1547
25217,25217,BA68D19087DD7682E8C396165511A278,11381,4,8,4,30,47,1547
25218,25218,BA68D19087DD7682E8C396165511A278,11061,9,10,1,29,48,1498
25219,25219,BA68D19087DD7682E8C396165511A278,11381,11,12,1,30,47,1547
25220,25220,BA68D19087DD7682E8C396165511A278,42521,12,23,11,31,47,1597
25244,25244,CA79E4C4EEA4EDDBEC743AB0C71E74A4,11231,0,11,11,37,49,1899
25245,25245,CA79E4C4EEA4EDDBEC743AB0C71E74A4,11271,12,13,1,37,48,1898
25246,25246,CA79E4C4EEA4EDDBEC743AB0C71E74A4,11231,14,23,9,37,49,1899
25247,25247,B45CB2E1B244B3B7583778DACAAA9799,11074,0,10,10,37,47,1897
25248,25248,B45CB2E1B244B3B7583778DACAAA9799,12514,11,14,3,38,47,1947
25249,25249,B45CB2E1B244B3B7583778DACAAA9799,10841,17,23,6,37,47,1897
25259,25259,2D8E9CCEB5B1B76AE08CCCDEE4B92809,19114,0,14,14,7,43,393
25260,25260,2D8E9CCEB5B1B76AE08CCCDEE4B92809,12641,15,16,1,10,43,543
25261,25261,2D8E9CCEB5B1B76AE08CCCDEE4B92809,19114,20,23,3,7,43,393
25262,25262,63A1194DA67A916294F825B4249AD293,10251,0,5,5,35,47,1797
25263,25263,63A1194DA67A916294F825B4249AD293,42161,6,7,1,36,47,1847
25264,25264,63A1194DA67A916294F825B4249AD293,11261,9,17,8,36,46,1846
25265,25265,63A1194DA67A916294F825B4249AD293,40637,18,21,3,36,47,1847
25287,25287,091B59EF8B9A131B61177C57E0259755,42161,0,7,7,36,47,1847
25288,25288,091B59EF8B9A131B61177C57E0259755,10251,10,14,4,35,47,1797
25289,25289,091B59EF8B9A131B61177C57E0259755,42161,14,23,9,36,47,1847
25290,25290,CD62F89A81CF58E2979469073621225B,12031,0,6,6,33,48,1698
25291,25291,CD62F89A81CF58E2979469073621225B,43731,8,10,2,34,47,1747
25292,25292,CD62F89A81CF58E2979469073621225B,10401,14,15,1,33,49,1699
25293,25293,CD62F89A81CF58E2979469073621225B,10491,19,23,4,33,48,1698
25294,25294,AF19336752E8D443DA84EEDE248347A2,42141,4,8,4,32,47,1647
25295,25295,AF19336752E8D443DA84EEDE248347A2,42491,8,13,5,32,46,1646
25296,25296,AF19336752E8D443DA84EEDE248347A2,43761,14,23,9,32,47,1647
25302,25302,FACA7C472055342CB52356ECCA18D789,10811,0,9,9,38,46,1946
25303,25303,FACA7C472055342CB52356ECCA18D789,11261,9,11,2,36,46,1846
25304,25304,FACA7C472055342CB52356ECCA18D789,10771,12,18,6,41,46,2096
25305,25305,FACA7C472055342CB52356ECCA18D789,11261,18,23,5,36,46,1846
25311,25311,0806ED2055F7FB652E67D56C776ED8F7,10107,0,8,8,38,49,1949
25312,25312,0806ED2055F7FB652E67D56C776ED8F7,13121,11,13,2,38,46,1946
25313,25313,0806ED2055F7FB652E67D56C776ED8F7,10107,14,17,3,38,49,1949
25314,25314,0806ED2055F7FB652E67D56C776ED8F7,40636,21,23,2,35,48,1798
25318,25318,5ED8949BAC5CDF05EDA1019FB7CA4B17,42301,0,13,13,36,47,1847
25319,25319,5ED8949BAC5CDF05EDA1019FB7CA4B17,40171,15,16,1,38,48,1948
25320,25320,5ED8949BAC5CDF05EDA1019FB7CA4B17,42191,19,20,1,38,49,1949
25321,25321,5ED8949BAC5CDF05EDA1019FB7CA4B17,10471,21,22,1,37,48,1898
25326,25326,A6FB8806348882E3287150AAB70E5425,42141,0,1,1,32,47,1647
25327,25327,A6FB8806348882E3287150AAB70E5425,11161,2,3,1,32,48,1648
25328,25328,A6FB8806348882E3287150AAB70E5425,43761,6,21,15,32,47,1647
25329,25329,619B4993323BBB76F010058331D5BCE1,12491,7,9,2,36,43,1843
25330,25330,619B4993323BBB76F010058331D5BCE1,11261,9,20,11,36,46,1846
25331,25331,619B4993323BBB76F010058331D5BCE1,12491,22,23,1,36,43,1843
25332,25332,2629052B8A83A39F4867436330DEE3B9,11161,0,10,10,32,48,1648
25333,25333,2629052B8A83A39F4867436330DEE3B9,43761,13,16,3,32,47,1647
25334,25334,2629052B8A83A39F4867436330DEE3B9,11161,17,23,6,32,48,1648
25335,25335,5B7E7E4FB63F70E50B23EF4DECA2F359,12641,10,14,4,10,43,543
25336,25336,5B7E7E4FB63F70E50B23EF4DECA2F359,12921,14,15,1,9,41,491
25337,25337,5B7E7E4FB63F70E50B23EF4DECA2F359,19931,15,21,6,7,43,393
25361,25361,99EF4A4C6EEE35257A93BB52B8A18E43,11481,2,15,13,41,48,2098
25362,25362,99EF4A4C6EEE35257A93BB52B8A18E43,10821,16,17,1,40,47,2047
25363,25363,99EF4A4C6EEE35257A93BB52B8A18E43,11481,17,23,6,41,48,2098
25375,25375,91EB59FA0D03DF92CD974EF6C6B73426,11061,3,9,6,29,48,1498
25376,25376,91EB59FA0D03DF92CD974EF6C6B73426,11381,12,17,5,30,47,1547
25377,25377,91EB59FA0D03DF92CD974EF6C6B73426,11061,18,19,1,29,48,1498
25378,25378,91EB59FA0D03DF92CD974EF6C6B73426,11381,22,23,1,30,47,1547
25389,25389,B304D2AD98C7DE24CAE6DD0DA65095F0,10431,0,7,7,33,49,1699
25390,25390,B304D2AD98C7DE24CAE6DD0DA65095F0,43581,7,18,11,33,48,1698
25391,25391,B304D2AD98C7DE24CAE6DD0DA65095F0,10431,18,23,5,33,49,1699
25398,25398,0CEC3D7EB4E938500D3BE15F068C3654,42511,4,5,1,37,47,1897
25399,25399,0CEC3D7EB4E938500D3BE15F068C3654,13121,8,10,2,38,46,1946
25400,25400,0CEC3D7EB4E938500D3BE15F068C3654,42511,11,22,11,37,47,1897
25405,25405,CC115E075627F49AC17F5D9D869D1EC5,19441,3,4,1,8,46,446
25406,25406,CC115E075627F49AC17F5D9D869D1EC5,19621,8,14,6,5,46,296
25407,25407,CC115E075627F49AC17F5D9D869D1EC5,19441,18,23,5,8,46,446
25418,25418,BAF87A0BC01C594FFAC1B35DD77FCF62,10471,0,17,17,37,48,1898
25419,25419,BAF87A0BC01C594FFAC1B35DD77FCF62,11461,19,20,1,37,49,1899
25420,25420,BAF87A0BC01C594FFAC1B35DD77FCF62,10471,20,23,3,37,48,1898
25431,25431,1E78C6812CC13AC596F7D7BD80A5DD70,11921,0,13,13,38,48,1948
25432,25432,1E78C6812CC13AC596F7D7BD80A5DD70,11074,16,17,1,37,47,1897
25433,25433,1E78C6812CC13AC596F7D7BD80A5DD70,10471,19,23,4,37,48,1898
25434,25434,73AC3CBDB2A277CF5F45112FEF564EF8,13121,0,19,19,38,46,1946
25435,25435,73AC3CBDB2A277CF5F45112FEF564EF8,42271,20,21,1,40,47,2047
25436,25436,73AC3CBDB2A277CF5F45112FEF564EF8,13121,21,23,2,38,46,1946
25440,25440,39E8FB5C4AE9A0E0783441178F244CD5,10341,0,17,17,31,47,1597
25441,25441,39E8FB5C4AE9A0E0783441178F244CD5,10154,17,19,2,33,47,1697
25442,25442,39E8FB5C4AE9A0E0783441178F244CD5,10341,20,23,3,31,47,1597
25443,25443,70DFAD9CC535457B59206F2CD88E5D55,13711,1,6,5,38,46,1946
25444,25444,70DFAD9CC535457B59206F2CD88E5D55,11941,8,9,1,37,46,1896
25445,25445,70DFAD9CC535457B59206F2CD88E5D55,13711,12,22,10,38,46,1946
25446,25446,2337FC404415B660A54C760E95DFCC85,10811,0,5,5,38,46,1946
25447,25447,2337FC404415B660A54C760E95DFCC85,11261,6,8,2,36,46,1846
25448,25448,2337FC404415B660A54C760E95DFCC85,42351,8,11,3,38,45,1945
25449,25449,2337FC404415B660A54C760E95DFCC85,13911,12,19,7,39,46,1996
25459,25459,86877F32D6D32D1728C272FD8E7855F4,11861,0,10,10,32,47,1647
25460,25460,86877F32D6D32D1728C272FD8E7855F4,42021,11,12,1,33,47,1697
25461,25461,86877F32D6D32D1728C272FD8E7855F4,11861,13,23,10,32,47,1647
25475,25475,8D623891FD363ED9542404996A5AA525,13511,0,1,1,34,48,1748
25476,25476,8D623891FD363ED9542404996A5AA525,10251,1,16,15,35,47,1797
25477,25477,8D623891FD363ED9542404996A5AA525,13511,16,23,7,34,48,1748
25482,25482,1788FF83230593384DFEF88881720D90,43101,6,9,3,46,40,2340
25483,25483,1788FF83230593384DFEF88881720D90,13551,13,15,2,45,38,2288
25484,25484,1788FF83230593384DFEF88881720D90,43101,17,20,3,46,40,2340
25524,25524,88D3AECB79C42D19C5311DB0C1B36772,10271,0,6,6,37,46,1896
25525,25525,88D3AECB79C42D19C5311DB0C1B36772,13711,8,18,10,38,46,1946
25526,25526,88D3AECB79C42D19C5311DB0C1B36772,10271,22,23,1,37,46,1896
25543,25543,02EE2A9621F66BD6F8785DE528B34698,11061,4,7,3,29,48,1498
25544,25544,02EE2A9621F66BD6F8785DE528B34698,10681,9,10,1,30,48,1548
25545,25545,02EE2A9621F66BD6F8785DE528B34698,11061,12,21,9,29,48,1498
25549,25549,522EF83A0BB6C187BC51EA021D98EB82,40611,0,16,16,35,47,1797
25550,25550,522EF83A0BB6C187BC51EA021D98EB82,11541,17,20,3,35,49,1799
25551,25551,522EF83A0BB6C187BC51EA021D98EB82,40611,20,23,3,35,47,1797
25560,25560,B113707EAA93879EBE330B26F03C03B2,13271,0,8,8,41,47,2097
25561,25561,B113707EAA93879EBE330B26F03C03B2,11481,13,18,5,41,48,2098
25562,25562,B113707EAA93879EBE330B26F03C03B2,11771,19,20,1,39,49,1999
25563,25563,B113707EAA93879EBE330B26F03C03B2,13371,21,22,1,41,47,2097
25569,25569,55512A674181595FCB06113D10743A88,10281,0,9,9,33,48,1698
25570,25570,55512A674181595FCB06113D10743A88,42921,17,21,4,33,47,1697
25571,25571,55512A674181595FCB06113D10743A88,13601,21,23,2,34,47,1747
25587,25587,D39C316EF1291ADA4CA0A7B8B6DA0A9D,11231,0,9,9,37,49,1899
25588,25588,D39C316EF1291ADA4CA0A7B8B6DA0A9D,11731,12,13,1,36,48,1848
25589,25589,D39C316EF1291ADA4CA0A7B8B6DA0A9D,11231,14,17,3,37,49,1899
25590,25590,D39C316EF1291ADA4CA0A7B8B6DA0A9D,13121,18,21,3,38,46,1946
25591,25591,E6AC57452A564977FA8F4CD52CD9B295,10281,0,8,8,33,48,1698
25592,25592,E6AC57452A564977FA8F4CD52CD9B295,11861,12,14,2,32,47,1647
25593,25593,E6AC57452A564977FA8F4CD52CD9B295,11201,16,22,6,35,49,1799
25594,25594,E6AC57452A564977FA8F4CD52CD9B295,11861,22,23,1,32,47,1647
25605,25605,C7DABDD3B30538BA528E17648006549E,42401,0,10,10,36,47,1847
25606,25606,C7DABDD3B30538BA528E17648006549E,10111,11,14,3,37,47,1897
25607,25607,C7DABDD3B30538BA528E17648006549E,42401,14,23,9,36,47,1847
25628,25628,D75839547F19BC6AA2555211CD306BBE,12514,0,12,12,38,47,1947
25629,25629,D75839547F19BC6AA2555211CD306BBE,11074,14,18,4,37,47,1897
25630,25630,D75839547F19BC6AA2555211CD306BBE,12514,19,23,4,38,47,1947
25635,25635,406EDA02B30F2BAE6E77943EDDABB841,42461,0,7,7,45,47,2297
25636,25636,406EDA02B30F2BAE6E77943EDDABB841,42091,14,21,7,43,46,2196
25637,25637,406EDA02B30F2BAE6E77943EDDABB841,42461,21,23,2,45,47,2297
25638,25638,23EA4F8B5D0ABEDDC9284DC80F701F9F,42091,0,9,9,43,46,2196
25639,25639,23EA4F8B5D0ABEDDC9284DC80F701F9F,42461,12,13,1,45,47,2297
25640,25640,23EA4F8B5D0ABEDDC9284DC80F701F9F,42091,15,17,2,43,46,2196
25641,25641,23EA4F8B5D0ABEDDC9284DC80F701F9F,42461,19,21,2,45,47,2297
25664,25664,2F1F7798F5E8889B4080CA59D71F0274,10271,4,14,10,37,46,1896
25665,25665,2F1F7798F5E8889B4080CA59D71F0274,13711,16,19,3,38,46,1946
25666,25666,2F1F7798F5E8889B4080CA59D71F0274,10271,21,23,2,37,46,1896
25678,25678,600D7AE0D829582E691D7BDBD387E918,19441,1,9,8,8,46,446
25679,25679,600D7AE0D829582E691D7BDBD387E918,42041,10,15,5,10,47,547
25680,25680,600D7AE0D829582E691D7BDBD387E918,19441,17,19,2,8,46,446
25684,25684,8B2CDE26493ABAF74D34F1EF2C2810F4,13341,8,10,2,44,45,2245
25685,25685,8B2CDE26493ABAF74D34F1EF2C2810F4,42201,11,12,1,43,46,2196
25686,25686,8B2CDE26493ABAF74D34F1EF2C2810F4,13341,14,18,4,44,45,2245
25700,25700,18961728F310462F7858ADF1FBEB29F6,40833,0,5,5,41,47,2097
25701,25701,18961728F310462F7858ADF1FBEB29F6,11001,8,10,2,42,47,2147
25702,25702,18961728F310462F7858ADF1FBEB29F6,40833,13,23,10,41,47,2097
25703,25703,3E98933C589157FCDDD2AEF7643E6F5D,12083,2,4,2,36,49,1849
25704,25704,3E98933C589157FCDDD2AEF7643E6F5D,11231,4,6,2,37,49,1899
25705,25705,3E98933C589157FCDDD2AEF7643E6F5D,42961,9,16,7,35,49,1799
25706,25706,3E98933C589157FCDDD2AEF7643E6F5D,12391,18,20,2,36,49,1849
25715,25715,51E47FDE51716EB36BE96125516194AB,10651,0,18,18,36,49,1849
25716,25716,51E47FDE51716EB36BE96125516194AB,12401,18,21,3,39,49,1999
25717,25717,51E47FDE51716EB36BE96125516194AB,11021,22,23,1,36,49,1849
25726,25726,D26F0C7647C35B2B285D2B37FBBE17EB,43761,3,9,6,32,47,1647
25727,25727,D26F0C7647C35B2B285D2B37FBBE17EB,42521,12,14,2,31,47,1597
25728,25728,D26F0C7647C35B2B285D2B37FBBE17EB,11861,15,17,2,32,47,1647
25729,25729,D26F0C7647C35B2B285D2B37FBBE17EB,42521,17,22,5,31,47,1597
25733,25733,6D033C8B1FDFACFDEA2FDDDDB2035602,42231,5,13,8,37,46,1896
25734,25734,6D033C8B1FDFACFDEA2FDDDDB2035602,42351,14,17,3,38,45,1945
25735,25735,6D033C8B1FDFACFDEA2FDDDDB2035602,42231,17,21,4,37,46,1896
25745,25745,D9026A3CE10A3841EFEE0C49DAE389C6,12641,0,3,3,10,43,543
25746,25746,D9026A3CE10A3841EFEE0C49DAE389C6,19114,6,10,4,7,43,393
25747,25747,D9026A3CE10A3841EFEE0C49DAE389C6,12641,11,12,1,10,43,543
25748,25748,D9026A3CE10A3841EFEE0C49DAE389C6,19114,14,21,7,7,43,393
25749,25749,D814AC010A265CB560CDCBE882AB02E6,43951,0,9,9,49,41,2491
25750,25750,D814AC010A265CB560CDCBE882AB02E6,13411,10,11,1,49,42,2492
25751,25751,D814AC010A265CB560CDCBE882AB02E6,43951,15,18,3,49,41,2491
25787,25787,7BBD15EB45C3F1BA6E572F56B02ABEDA,10841,0,11,11,37,47,1897
25788,25788,7BBD15EB45C3F1BA6E572F56B02ABEDA,13331,13,17,4,38,47,1947
25789,25789,7BBD15EB45C3F1BA6E572F56B02ABEDA,11074,19,23,4,37,47,1897
25790,25790,6FAC7BB08E665D69B9DFE624BBEE190F,11021,0,2,2,36,49,1849
25791,25791,6FAC7BB08E665D69B9DFE624BBEE190F,10107,3,12,9,38,49,1949
25792,25792,6FAC7BB08E665D69B9DFE624BBEE190F,11021,12,23,11,36,49,1849
25793,25793,C7DA09D84BB6D5A3ABEAD976C8C0731E,42861,0,13,13,37,44,1894
25794,25794,C7DA09D84BB6D5A3ABEAD976C8C0731E,11261,14,17,3,36,46,1846
25795,25795,C7DA09D84BB6D5A3ABEAD976C8C0731E,42861,19,23,4,37,44,1894
25799,25799,2911E7269AAFABD6050C0D1971E47D07,10681,0,1,1,30,48,1548
25800,25800,2911E7269AAFABD6050C0D1971E47D07,10721,3,10,7,31,48,1598
25801,25801,2911E7269AAFABD6050C0D1971E47D07,43471,14,23,9,31,49,1599
25819,25819,44EC2B0D5EE5BD6B35ABC292F1B0BE4A,12921,0,7,7,9,41,491
25820,25820,44EC2B0D5EE5BD6B35ABC292F1B0BE4A,12641,10,11,1,10,43,543
25821,25821,44EC2B0D5EE5BD6B35ABC292F1B0BE4A,12921,12,22,10,9,41,491
25859,25859,5282F43DA1098E1CCE157C02623C4D9B,10121,0,8,8,36,49,1849
25860,25860,5282F43DA1098E1CCE157C02623C4D9B,13561,8,9,1,37,49,1899
25861,25861,5282F43DA1098E1CCE157C02623C4D9B,10121,10,23,13,36,49,1849
25862,25862,3A9091630EF76EB9B9172BBA7FB5D957,10221,0,3,3,34,49,1749
25863,25863,3A9091630EF76EB9B9172BBA7FB5D957,11231,3,16,13,37,49,1899
25864,25864,3A9091630EF76EB9B9172BBA7FB5D957,43281,17,19,2,37,48,1898
25865,25865,3A9091630EF76EB9B9172BBA7FB5D957,11201,20,23,3,35,49,1799
25866,25866,181B5103F0FBF120AFF5BEC3A26A3DB7,43761,1,3,2,32,47,1647
25867,25867,181B5103F0FBF120AFF5BEC3A26A3DB7,11161,3,5,2,32,48,1648
25868,25868,181B5103F0FBF120AFF5BEC3A26A3DB7,43761,6,23,17,32,47,1647
25869,25869,EDA329415D84856534462D1DBAE0A105,42231,0,1,1,37,46,1896
25870,25870,EDA329415D84856534462D1DBAE0A105,42351,4,6,2,38,45,1945
25871,25871,EDA329415D84856534462D1DBAE0A105,42231,6,20,14,37,46,1896
25872,25872,EDA329415D84856534462D1DBAE0A105,13911,21,22,1,39,46,1996
25884,25884,7561007C44C9B9B43A5E78AE0FF299F7,43051,6,16,10,46,45,2345
25885,25885,7561007C44C9B9B43A5E78AE0FF299F7,42631,17,19,2,43,45,2195
25886,25886,7561007C44C9B9B43A5E78AE0FF299F7,43051,19,23,4,46,45,2345
25905,25905,55533B9612A041F560AB09E0A0C2A735,10251,0,8,8,35,47,1797
25906,25906,55533B9612A041F560AB09E0A0C2A735,43731,12,17,5,34,47,1747
25907,25907,55533B9612A041F560AB09E0A0C2A735,10251,21,23,2,35,47,1797
25908,25908,8A063C000C18EFD5117E8B73289494F1,40343,0,8,8,24,49,1249
25909,25909,8A063C000C18EFD5117E8B73289494F1,10451,10,15,5,25,48,1298
25910,25910,8A063C000C18EFD5117E8B73289494F1,40343,15,23,8,24,49,1249
25925,25925,01AD8678560B948D0F150F181F8839DC,42401,0,11,11,36,47,1847
25926,25926,01AD8678560B948D0F150F181F8839DC,11074,11,12,1,37,47,1897
25927,25927,01AD8678560B948D0F150F181F8839DC,42401,12,23,11,36,47,1847
25928,25928,CD43D1F11B0EDA08EE573941DA879084,10681,1,8,7,30,48,1548
25929,25929,CD43D1F11B0EDA08EE573941DA879084,11061,10,12,2,29,48,1498
25930,25930,CD43D1F11B0EDA08EE573941DA879084,10681,12,14,2,30,48,1548
25931,25931,CD43D1F11B0EDA08EE573941DA879084,11061,17,20,3,29,48,1498
25938,25938,13FE336F780D5F9F83776798BCE67144,11261,4,15,11,36,46,1846
25939,25939,13FE336F780D5F9F83776798BCE67144,42351,15,17,2,38,45,1945
25940,25940,13FE336F780D5F9F83776798BCE67144,11261,18,21,3,36,46,1846
25945,25945,ED14F75680A1780D0C6AF7290516296F,10281,0,7,7,33,48,1698
25946,25946,ED14F75680A1780D0C6AF7290516296F,43731,9,11,2,34,47,1747
25947,25947,ED14F75680A1780D0C6AF7290516296F,10971,15,16,1,35,47,1797
25948,25948,ED14F75680A1780D0C6AF7290516296F,10281,19,23,4,33,48,1698
25949,25949,F74A692B863D412E165DF48C1089389E,10634,9,15,6,27,45,1395
25950,25950,F74A692B863D412E165DF48C1089389E,42531,17,18,1,31,45,1595
25951,25951,F74A692B863D412E165DF48C1089389E,12311,20,22,2,30,44,1544
25952,25952,98FCD0E7592CE3BE44D1E20097E37B5B,42401,8,10,2,36,47,1847
25953,25953,98FCD0E7592CE3BE44D1E20097E37B5B,11331,11,12,1,37,48,1898
25954,25954,98FCD0E7592CE3BE44D1E20097E37B5B,10111,14,16,2,37,47,1897
25955,25955,98FCD0E7592CE3BE44D1E20097E37B5B,40637,18,21,3,36,47,1847
25956,25956,6C7DE4B4696563CBDA9D3C6E4FCAB652,10341,0,7,7,31,47,1597
25957,25957,6C7DE4B4696563CBDA9D3C6E4FCAB652,10292,9,12,3,30,47,1547
25958,25958,6C7DE4B4696563CBDA9D3C6E4FCAB652,10341,14,22,8,31,47,1597
25965,25965,8B162D826614AE6B0D3DB5A304485836,11771,0,7,7,39,49,1999
25966,25966,8B162D826614AE6B0D3DB5A304485836,11914,10,17,7,37,48,1898
25967,25967,8B162D826614AE6B0D3DB5A304485836,11771,19,23,4,39,49,1999
25968,25968,D8834D4F22FF034FF914EE328071C45B,40636,0,11,11,35,48,1798
25969,25969,D8834D4F22FF034FF914EE328071C45B,11021,11,12,1,36,49,1849
25970,25970,D8834D4F22FF034FF914EE328071C45B,40636,18,23,5,35,48,1798
25979,25979,E6A8B36EA819F0A64C66840FF99B9AB3,42581,1,6,5,38,48,1948
25980,25980,E6A8B36EA819F0A64C66840FF99B9AB3,11914,8,10,2,37,48,1898
25981,25981,E6A8B36EA819F0A64C66840FF99B9AB3,40171,13,14,1,38,48,1948
25982,25982,E6A8B36EA819F0A64C66840FF99B9AB3,11914,17,20,3,37,48,1898
25983,25983,4FA50ACEDD30F1F921CEE6F85693AFFB,42161,0,8,8,36,47,1847
25984,25984,4FA50ACEDD30F1F921CEE6F85693AFFB,10111,9,14,5,37,47,1897
25985,25985,4FA50ACEDD30F1F921CEE6F85693AFFB,10471,16,20,4,37,48,1898
25986,25986,4FA50ACEDD30F1F921CEE6F85693AFFB,10111,21,22,1,37,47,1897
26002,26002,2E41D12914D018ABBECDD31B0655F2CF,10841,1,2,1,37,47,1897
26003,26003,2E41D12914D018ABBECDD31B0655F2CF,42301,2,9,7,36,47,1847
26004,26004,2E41D12914D018ABBECDD31B0655F2CF,10271,10,20,10,37,46,1896
26005,26005,2E41D12914D018ABBECDD31B0655F2CF,13121,21,22,1,38,46,1946
26006,26006,1F37C13C52F34E6056520CCE105A28F8,13121,0,1,1,38,46,1946
26007,26007,1F37C13C52F34E6056520CCE105A28F8,10271,3,15,12,37,46,1896
26008,26008,1F37C13C52F34E6056520CCE105A28F8,13121,18,19,1,38,46,1946
26009,26009,1F37C13C52F34E6056520CCE105A28F8,11551,20,23,3,39,49,1999
26015,26015,A6D339F182477E1C5060BEA422C0ED75,10251,0,8,8,35,47,1797
26016,26016,A6D339F182477E1C5060BEA422C0ED75,11331,11,18,7,37,48,1898
26017,26017,A6D339F182477E1C5060BEA422C0ED75,42161,19,23,4,36,47,1847
26026,26026,20538B8C1777892DA77867D1D04B5D49,43761,0,2,2,32,47,1647
26027,26027,20538B8C1777892DA77867D1D04B5D49,11161,3,18,15,32,48,1648
26028,26028,20538B8C1777892DA77867D1D04B5D49,43761,21,23,2,32,47,1647
26029,26029,14DC78B96F17324DFD0B44C76818BC45,11381,0,10,10,30,47,1547
26030,26030,14DC78B96F17324DFD0B44C76818BC45,10951,14,17,3,29,48,1498
26031,26031,14DC78B96F17324DFD0B44C76818BC45,13651,18,19,1,30,47,1547
26037,26037,FC84A2378B686F26A27F74304ABEC5B0,43061,0,17,17,43,46,2196
26038,26038,FC84A2378B686F26A27F74304ABEC5B0,43051,17,19,2,46,45,2345
26039,26039,FC84A2378B686F26A27F74304ABEC5B0,43061,19,23,4,43,46,2196
26040,26040,2220ACECA44CDD6B643C1166EB143787,12641,0,8,8,10,43,543
26041,26041,2220ACECA44CDD6B643C1166EB143787,19114,9,11,2,7,43,393
26042,26042,2220ACECA44CDD6B643C1166EB143787,12641,12,23,11,10,43,543
26043,26043,2B742D33ECA5D739DE9809C030EAA6E5,42351,5,13,8,38,45,1945
26044,26044,2B742D33ECA5D739DE9809C030EAA6E5,11261,15,16,1,36,46,1846
26045,26045,2B742D33ECA5D739DE9809C030EAA6E5,13911,17,19,2,39,46,1996
26053,26053,A60E51B2BB36D63F6E34260285BCBDB6,12661,0,13,13,32,45,1645
26054,26054,A60E51B2BB36D63F6E34260285BCBDB6,12311,14,19,5,30,44,1544
26055,26055,A60E51B2BB36D63F6E34260285BCBDB6,42531,20,23,3,31,45,1595
26056,26056,B7783E40C231BF2A915C5200F2E2562A,12031,0,13,13,33,48,1698
26057,26057,B7783E40C231BF2A915C5200F2E2562A,40951,18,19,1,36,49,1849
26058,26058,B7783E40C231BF2A915C5200F2E2562A,10901,19,20,1,35,48,1798
26059,26059,B7783E40C231BF2A915C5200F2E2562A,40951,20,22,2,36,49,1849
26063,26063,CFF4943452741BA085C68AD1AAC66347,10331,0,15,15,39,46,1996
26064,26064,CFF4943452741BA085C68AD1AAC66347,10191,15,17,2,40,48,2048
26065,26065,CFF4943452741BA085C68AD1AAC66347,10331,18,23,5,39,46,1996
26066,26066,30923AEEC372BFA482FE4F2D1B8414D6,42091,0,7,7,43,46,2196
26067,26067,30923AEEC372BFA482FE4F2D1B8414D6,12141,7,11,4,42,45,2145
26068,26068,30923AEEC372BFA482FE4F2D1B8414D6,42461,12,16,4,45,47,2297
26069,26069,30923AEEC372BFA482FE4F2D1B8414D6,43061,17,23,6,43,46,2196
26074,26074,D051A53A52187B78CF6DA99F6B3FF9C4,40637,0,8,8,36,47,1847
26075,26075,D051A53A52187B78CF6DA99F6B3FF9C4,10251,10,11,1,35,47,1797
26076,26076,D051A53A52187B78CF6DA99F6B3FF9C4,42401,15,22,7,36,47,1847
26085,26085,88182B8F0A08A7B6CD3790FE87C79F47,42231,0,4,4,37,46,1896
26086,26086,88182B8F0A08A7B6CD3790FE87C79F47,42351,4,14,10,38,45,1945
26087,26087,88182B8F0A08A7B6CD3790FE87C79F47,42231,15,19,4,37,46,1896
26088,26088,88182B8F0A08A7B6CD3790FE87C79F47,42351,20,22,2,38,45,1945
26089,26089,3CDE88E41494ADADB515291429110B2E,43481,2,11,9,39,48,1998
26090,26090,3CDE88E41494ADADB515291429110B2E,11231,12,16,4,37,49,1899
26091,26091,3CDE88E41494ADADB515291429110B2E,10901,18,20,2,35,48,1798
26092,26092,3CDE88E41494ADADB515291429110B2E,12514,22,23,1,38,47,1947
26093,26093,3E17C9F881E8F571652BFE5E841845EF,11861,0,3,3,32,47,1647
26094,26094,3E17C9F881E8F571652BFE5E841845EF,10281,4,9,5,33,48,1698
26095,26095,3E17C9F881E8F571652BFE5E841845EF,11861,9,22,13,32,47,1647
26096,26096,A81638617545A61CA275F98CB5E7FC67,12601,8,12,4,25,47,1297
26097,26097,A81638617545A61CA275F98CB5E7FC67,42711,14,20,6,26,48,1348
26098,26098,A81638617545A61CA275F98CB5E7FC67,12601,22,23,1,25,47,1297
26124,26124,3725094C67BAB476261802F12382A183,42161,6,8,2,36,47,1847
26125,26125,3725094C67BAB476261802F12382A183,10251,11,17,6,35,47,1797
26126,26126,3725094C67BAB476261802F12382A183,42161,18,23,5,36,47,1847
26130,26130,734BE21864A3611A04F28278A72C8D0B,42151,0,5,5,35,45,1795
26131,26131,734BE21864A3611A04F28278A72C8D0B,42021,8,10,2,33,47,1697
26132,26132,734BE21864A3611A04F28278A72C8D0B,42151,12,21,9,35,45,1795
26133,26133,0722208BA05F2FA64560C4BADA491D8E,43761,0,8,8,32,47,1647
26134,26134,0722208BA05F2FA64560C4BADA491D8E,10151,9,18,9,34,47,1747
26135,26135,0722208BA05F2FA64560C4BADA491D8E,11381,20,21,1,30,47,1547
26168,26168,5E3A7142BBDC1E249B155588A0E138DD,12641,0,9,9,10,43,543
26169,26169,5E3A7142BBDC1E249B155588A0E138DD,19114,11,12,1,7,43,393
26170,26170,5E3A7142BBDC1E249B155588A0E138DD,12641,12,19,7,10,43,543
26171,26171,DD2776738383CBF6281F190C1D1B13EA,11231,0,13,13,37,49,1899
26172,26172,DD2776738383CBF6281F190C1D1B13EA,11074,16,20,4,37,47,1897
26173,26173,DD2776738383CBF6281F190C1D1B13EA,12083,21,23,2,36,49,1849
26215,26215,936F3EAEFFE6D40274671E4FB3E6BD97,11941,0,5,5,37,46,1896
26216,26216,936F3EAEFFE6D40274671E4FB3E6BD97,42161,8,17,9,36,47,1847
26217,26217,936F3EAEFFE6D40274671E4FB3E6BD97,42231,18,19,1,37,46,1896
26218,26218,936F3EAEFFE6D40274671E4FB3E6BD97,13911,20,22,2,39,46,1996
26249,26249,1228A94EA6C2D4622CFEAC816DA2851D,10901,8,13,5,35,48,1798
26250,26250,1228A94EA6C2D4622CFEAC816DA2851D,10121,13,15,2,36,49,1849
26251,26251,1228A94EA6C2D4622CFEAC816DA2851D,10901,17,22,5,35,48,1798
26255,26255,C63EDF2506E8586FA7C0E39ACBECA0E4,12311,7,9,2,30,44,1544
26256,26256,C63EDF2506E8586FA7C0E39ACBECA0E4,11871,10,12,2,29,46,1496
26257,26257,C63EDF2506E8586FA7C0E39ACBECA0E4,11875,12,18,6,30,46,1546
26258,26258,C63EDF2506E8586FA7C0E39ACBECA0E4,12161,20,22,2,32,46,1646
26266,26266,6B2E238C2A4978AFB452986609DB74C2,10295,0,2,2,30,47,1547
26267,26267,6B2E238C2A4978AFB452986609DB74C2,42523,2,8,6,31,47,1597
26268,26268,6B2E238C2A4978AFB452986609DB74C2,43761,11,15,4,32,47,1647
26269,26269,6B2E238C2A4978AFB452986609DB74C2,13601,16,23,7,34,47,1747
26270,26270,8DF8B02E7C787F47D1A97C30E8472BF0,11061,0,10,10,29,48,1498
26271,26271,8DF8B02E7C787F47D1A97C30E8472BF0,13651,12,13,1,30,47,1547
26272,26272,8DF8B02E7C787F47D1A97C30E8472BF0,11061,18,21,3,29,48,1498
26285,26285,ACD7D06D699A88B2E7BB7970CE635C80,11381,0,9,9,30,47,1547
26286,26286,ACD7D06D699A88B2E7BB7970CE635C80,10951,11,13,2,29,48,1498
26287,26287,ACD7D06D699A88B2E7BB7970CE635C80,11381,14,23,9,30,47,1547
26292,26292,44BA65919A80728667B0D62571A4968D,13121,0,14,14,38,46,1946
26293,26293,44BA65919A80728667B0D62571A4968D,10271,14,17,3,37,46,1896
26294,26294,44BA65919A80728667B0D62571A4968D,13121,18,19,1,38,46,1946
26295,26295,44BA65919A80728667B0D62571A4968D,43281,22,23,1,37,48,1898
26296,26296,CAB9FC0248C2EC2B48D48F68319D9ACA,10292,0,1,1,30,47,1547
26297,26297,CAB9FC0248C2EC2B48D48F68319D9ACA,42523,4,5,1,31,47,1597
26298,26298,CAB9FC0248C2EC2B48D48F68319D9ACA,10292,6,7,1,30,47,1547
26299,26299,CAB9FC0248C2EC2B48D48F68319D9ACA,42523,17,20,3,31,47,1597
26303,26303,456B92CD20400F1E2BB076575324C8C5,42141,0,19,19,32,47,1647
26304,26304,456B92CD20400F1E2BB076575324C8C5,10281,20,22,2,33,48,1698
26305,26305,456B92CD20400F1E2BB076575324C8C5,42141,22,23,1,32,47,1647
26306,26306,775D2A8F104041B3D53BA2721A326EFF,42861,0,5,5,37,44,1894
26307,26307,775D2A8F104041B3D53BA2721A326EFF,42151,6,7,1,35,45,1795
26308,26308,775D2A8F104041B3D53BA2721A326EFF,42861,9,11,2,37,44,1894
26309,26309,775D2A8F104041B3D53BA2721A326EFF,42151,11,23,12,35,45,1795
26330,26330,9027D7BCCA8B9488D727103093A0EE77,12561,0,1,1,45,43,2293
26331,26331,9027D7BCCA8B9488D727103093A0EE77,13341,3,9,6,44,45,2245
26332,26332,9027D7BCCA8B9488D727103093A0EE77,42631,10,11,1,43,45,2195
26333,26333,9027D7BCCA8B9488D727103093A0EE77,13341,12,21,9,44,45,2245
26334,26334,1A0A69C0F167E832FF52DB7A74DB1CC6,42801,0,9,9,40,49,2049
26335,26335,1A0A69C0F167E832FF52DB7A74DB1CC6,43361,12,13,1,38,48,1948
26336,26336,1A0A69C0F167E832FF52DB7A74DB1CC6,10471,16,20,4,37,48,1898
26337,26337,1A0A69C0F167E832FF52DB7A74DB1CC6,11661,22,23,1,40,49,2049
26338,26338,4FEDDE4724DDA61E19979F6B8E0B84B5,42301,0,2,2,36,47,1847
26339,26339,4FEDDE4724DDA61E19979F6B8E0B84B5,42511,2,6,4,37,47,1897
26340,26340,4FEDDE4724DDA61E19979F6B8E0B84B5,10271,8,19,11,37,46,1896
26341,26341,4FEDDE4724DDA61E19979F6B8E0B84B5,42301,20,22,2,36,47,1847
26346,26346,BBF0A6FDFFEE7C70DA97434056C4483C,42511,0,9,9,37,47,1897
26347,26347,BBF0A6FDFFEE7C70DA97434056C4483C,11201,10,13,3,35,49,1799
26348,26348,BBF0A6FDFFEE7C70DA97434056C4483C,42031,15,22,7,40,46,2046
26369,26369,5E1BBAE6A1AB78C09E8201C8FF351A4E,12514,1,7,6,38,47,1947
26370,26370,5E1BBAE6A1AB78C09E8201C8FF351A4E,11074,11,14,3,37,47,1897
26371,26371,5E1BBAE6A1AB78C09E8201C8FF351A4E,12514,16,18,2,38,47,1947
26376,26376,09C2A5500F5ABAEEAC932C07F5628EC4,11021,0,18,18,36,49,1849
26377,26377,09C2A5500F5ABAEEAC932C07F5628EC4,42161,19,22,3,36,47,1847
26378,26378,09C2A5500F5ABAEEAC932C07F5628EC4,11021,22,23,1,36,49,1849
26382,26382,4F985171E935EB3DC7536EAA1C4743E5,42623,0,8,8,22,49,1149
26383,26383,4F985171E935EB3DC7536EAA1C4743E5,42081,9,11,2,24,49,1249
26384,26384,4F985171E935EB3DC7536EAA1C4743E5,42623,11,23,12,22,49,1149
26403,26403,A348A51091703B88535273AA38F84E2F,11061,0,11,11,29,48,1498
26404,26404,A348A51091703B88535273AA38F84E2F,10681,12,14,2,30,48,1548
26405,26405,A348A51091703B88535273AA38F84E2F,11061,15,23,8,29,48,1498
26409,26409,A9082CDCF30DF30191443EA24A58E76C,43501,0,8,8,27,48,1398
26410,26410,A9082CDCF30DF30191443EA24A58E76C,10951,9,10,1,29,48,1498
26411,26411,A9082CDCF30DF30191443EA24A58E76C,42501,13,18,5,28,47,1447
26429,26429,AD235EE6A83CA7956AB86E8BC887D3C7,11541,1,6,5,35,49,1799
26430,26430,AD235EE6A83CA7956AB86E8BC887D3C7,13561,6,9,3,37,49,1899
26431,26431,AD235EE6A83CA7956AB86E8BC887D3C7,11021,10,18,8,36,49,1849
26432,26432,AD235EE6A83CA7956AB86E8BC887D3C7,11541,19,23,4,35,49,1799
26441,26441,EE6B8585E25BB845D2DA0A95F88FAB79,42351,5,15,10,38,45,1945
26442,26442,EE6B8585E25BB845D2DA0A95F88FAB79,13911,16,18,2,39,46,1996
26443,26443,EE6B8585E25BB845D2DA0A95F88FAB79,42231,18,19,1,37,46,1896
26444,26444,EE6B8585E25BB845D2DA0A95F88FAB79,11261,20,21,1,36,46,1846
26445,26445,D1161F75E2083066372593043FD61104,13331,0,6,6,38,47,1947
26446,26446,D1161F75E2083066372593043FD61104,42511,6,8,2,37,47,1897
26447,26447,D1161F75E2083066372593043FD61104,12514,10,23,13,38,47,1947
26457,26457,A097CA7B6EFBB8E9E33D4E1BFAB62372,10951,1,3,2,29,48,1498
26458,26458,A097CA7B6EFBB8E9E33D4E1BFAB62372,11381,5,10,5,30,47,1547
26459,26459,A097CA7B6EFBB8E9E33D4E1BFAB62372,10951,14,15,1,29,48,1498
26460,26460,A097CA7B6EFBB8E9E33D4E1BFAB62372,11381,19,23,4,30,47,1547
26461,26461,5C8F2529D7987CD38C69D86858134456,11231,1,9,8,37,49,1899
26462,26462,5C8F2529D7987CD38C69D86858134456,11751,10,19,9,35,48,1798
26463,26463,5C8F2529D7987CD38C69D86858134456,40951,19,22,3,36,49,1849
26476,26476,132BAF41704DD845C2F70543C3732C4E,42231,1,5,4,37,46,1896
26477,26477,132BAF41704DD845C2F70543C3732C4E,13711,9,10,1,38,46,1946
26478,26478,132BAF41704DD845C2F70543C3732C4E,42231,15,18,3,37,46,1896
26479,26479,B1886EF8F5487F8E8F1A6E89D17F4DF6,12311,2,5,3,30,44,1544
26480,26480,B1886EF8F5487F8E8F1A6E89D17F4DF6,42531,9,19,10,31,45,1595
26481,26481,B1886EF8F5487F8E8F1A6E89D17F4DF6,12311,22,23,1,30,44,1544
26482,26482,DF50F92C5DF380B053E9E96E672CF10A,11021,0,13,13,36,49,1849
26483,26483,DF50F92C5DF380B053E9E96E672CF10A,11794,14,18,4,38,49,1949
26484,26484,DF50F92C5DF380B053E9E96E672CF10A,11021,20,21,1,36,49,1849
26498,26498,A280969FD90AA928F73AE4BBEE919365,13101,0,12,12,40,47,2047
26499,26499,A280969FD90AA928F73AE4BBEE919365,40833,14,16,2,41,47,2097
26500,26500,A280969FD90AA928F73AE4BBEE919365,13101,18,23,5,40,47,2047
26504,26504,4C6EBE1C4B2FAAFACD17B57BF7692986,42161,2,7,5,36,47,1847
26505,26505,4C6EBE1C4B2FAAFACD17B57BF7692986,10531,11,14,3,34,46,1746
26506,26506,4C6EBE1C4B2FAAFACD17B57BF7692986,42161,19,20,1,36,47,1847
26507,26507,4C6EBE1C4B2FAAFACD17B57BF7692986,43731,21,23,2,34,47,1747
26508,26508,045E1A9A29D2B78C68A438803CABBFA2,42301,0,14,14,36,47,1847
26509,26509,045E1A9A29D2B78C68A438803CABBFA2,10111,15,16,1,37,47,1897
26510,26510,045E1A9A29D2B78C68A438803CABBFA2,42301,21,23,2,36,47,1847
26522,26522,10C025DE83AEC63388DB13DE6128ADC8,12121,0,7,7,29,47,1497
26523,26523,10C025DE83AEC63388DB13DE6128ADC8,10951,8,9,1,29,48,1498
26524,26524,10C025DE83AEC63388DB13DE6128ADC8,11381,10,13,3,30,47,1547
26525,26525,10C025DE83AEC63388DB13DE6128ADC8,10951,13,21,8,29,48,1498
26526,26526,E1BB7B2CDA075A402737990C0757A672,43361,0,1,1,38,48,1948
26527,26527,E1BB7B2CDA075A402737990C0757A672,40632,2,9,7,35,48,1798
26528,26528,E1BB7B2CDA075A402737990C0757A672,12481,11,12,1,37,49,1899
26529,26529,E1BB7B2CDA075A402737990C0757A672,42981,17,21,4,36,49,1849
26567,26567,528421A4A4CF40E840301284E0AFB525,42301,1,7,6,36,47,1847
26568,26568,528421A4A4CF40E840301284E0AFB525,11201,9,17,8,35,49,1799
26569,26569,528421A4A4CF40E840301284E0AFB525,42161,21,22,1,36,47,1847
26573,26573,6D226E0DDF624F7E36125C1EE8DFD7DD,12641,7,9,2,10,43,543
26574,26574,6D226E0DDF624F7E36125C1EE8DFD7DD,19904,10,12,2,9,44,494
26575,26575,6D226E0DDF624F7E36125C1EE8DFD7DD,12641,13,14,1,10,43,543
26576,26576,6D226E0DDF624F7E36125C1EE8DFD7DD,19904,16,20,4,9,44,494
26577,26577,7B1BF8E757A1490F181B2D552B77BEE6,11804,0,17,17,41,48,2098
26578,26578,7B1BF8E757A1490F181B2D552B77BEE6,13271,18,21,3,41,47,2097
26579,26579,7B1BF8E757A1490F181B2D552B77BEE6,11481,21,23,2,41,48,2098
26580,26580,534F3B1CD78FDD46A8ACE2B5E3E0C898,13911,0,6,6,39,46,1996
26581,26581,534F3B1CD78FDD46A8ACE2B5E3E0C898,11261,8,14,6,36,46,1846
26582,26582,534F3B1CD78FDD46A8ACE2B5E3E0C898,13911,15,19,4,39,46,1996
26586,26586,F36A9C530F88290C9D611D428C0B8F3A,11021,0,8,8,36,49,1849
26587,26587,F36A9C530F88290C9D611D428C0B8F3A,42471,10,11,1,35,49,1799
26588,26588,F36A9C530F88290C9D611D428C0B8F3A,11021,11,22,11,36,49,1849
26589,26589,8C7DCF60D5A91C4294A8C14ABFA5CFBF,42581,1,5,4,38,48,1948
26590,26590,8C7DCF60D5A91C4294A8C14ABFA5CFBF,11271,6,8,2,37,48,1898
26591,26591,8C7DCF60D5A91C4294A8C14ABFA5CFBF,42581,11,22,11,38,48,1948
26592,26592,5F72E18AC22CC05F11A96BFBD57885CE,10411,0,8,8,36,48,1848
26593,26593,5F72E18AC22CC05F11A96BFBD57885CE,10221,8,14,6,34,49,1749
26594,26594,5F72E18AC22CC05F11A96BFBD57885CE,42161,15,16,1,36,47,1847
26595,26595,5F72E18AC22CC05F11A96BFBD57885CE,10221,17,22,5,34,49,1749
26611,26611,8A1C9B5C15692D40B303FA14476C8B37,43061,0,16,16,43,46,2196
26612,26612,8A1C9B5C15692D40B303FA14476C8B37,42461,16,17,1,45,47,2297
26613,26613,8A1C9B5C15692D40B303FA14476C8B37,43061,18,23,5,43,46,2196
26622,26622,9581E2738397A78656E486E508776CFB,10121,0,8,8,36,49,1849
26623,26623,9581E2738397A78656E486E508776CFB,10161,9,21,12,35,49,1799
26624,26624,9581E2738397A78656E486E508776CFB,10121,22,23,1,36,49,1849
26631,26631,63E113647B076FC93CF9833FECFEFE8C,11381,0,14,14,30,47,1547
26632,26632,63E113647B076FC93CF9833FECFEFE8C,11061,14,16,2,29,48,1498
26633,26633,63E113647B076FC93CF9833FECFEFE8C,42071,18,19,1,31,49,1599
26634,26634,BAE761F181336B6EFEB3593DBB531554,11911,0,13,13,37,48,1898
26635,26635,BAE761F181336B6EFEB3593DBB531554,12514,14,16,2,38,47,1947
26636,26636,BAE761F181336B6EFEB3593DBB531554,11911,18,20,2,37,48,1898
26637,26637,D366589B3E90DFE9BB97263FFFDAB40D,13911,1,3,2,39,46,1996
26638,26638,D366589B3E90DFE9BB97263FFFDAB40D,10811,3,5,2,38,46,1946
26639,26639,D366589B3E90DFE9BB97263FFFDAB40D,42231,6,15,9,37,46,1896
26640,26640,D366589B3E90DFE9BB97263FFFDAB40D,13911,15,21,6,39,46,1996
26649,26649,23F96418DBDA7106BDBB6C7E2C3432BD,42351,0,8,8,38,45,1945
26650,26650,23F96418DBDA7106BDBB6C7E2C3432BD,42231,8,10,2,37,46,1896
26651,26651,23F96418DBDA7106BDBB6C7E2C3432BD,42351,11,13,2,38,45,1945
26652,26652,23F96418DBDA7106BDBB6C7E2C3432BD,13911,18,20,2,39,46,1996
26665,26665,E051F3A68F183E58DAB85439F9F9C3B1,11954,0,5,5,32,49,1649
26666,26666,E051F3A68F183E58DAB85439F9F9C3B1,13731,8,18,10,33,49,1699
26667,26667,E051F3A68F183E58DAB85439F9F9C3B1,11954,20,23,3,32,49,1649
26675,26675,6D5AF993DE67C77E881A67987581C78A,42581,2,9,7,38,48,1948
26676,26676,6D5AF993DE67C77E881A67987581C78A,11914,11,17,6,37,48,1898
26677,26677,6D5AF993DE67C77E881A67987581C78A,42581,19,21,2,38,48,1948
26681,26681,E99176074424BF1CA2C083C0DBF3C62C,42221,3,6,3,38,48,1948
26682,26682,E99176074424BF1CA2C083C0DBF3C62C,12514,8,9,1,38,47,1947
26683,26683,E99176074424BF1CA2C083C0DBF3C62C,12841,12,22,10,37,47,1897
26699,26699,4C13C3D7416FEE47C7E01DACD89CC954,10301,1,8,7,31,45,1595
26700,26700,4C13C3D7416FEE47C7E01DACD89CC954,12311,9,11,2,30,44,1544
26701,26701,4C13C3D7416FEE47C7E01DACD89CC954,10301,11,16,5,31,45,1595
26702,26702,4C13C3D7416FEE47C7E01DACD89CC954,42871,17,18,1,30,45,1545
26706,26706,A4BC16FDE84BA1A928A7C6E482678E7C,10634,0,12,12,27,45,1395
26707,26707,A4BC16FDE84BA1A928A7C6E482678E7C,12601,16,17,1,25,47,1297
26708,26708,A4BC16FDE84BA1A928A7C6E482678E7C,10634,17,23,6,27,45,1395
26709,26709,9F344971AFB0848D22FABB2D34666ADF,10801,4,11,7,42,47,2147
26710,26710,9F344971AFB0848D22FABB2D34666ADF,42321,11,12,1,43,47,2197
26711,26711,9F344971AFB0848D22FABB2D34666ADF,10801,14,15,1,42,47,2147
26712,26712,9F344971AFB0848D22FABB2D34666ADF,11301,18,21,3,41,49,2099
26716,26716,7200E84AEDCA7E085FE069DDCE5F2702,42401,0,7,7,36,47,1847
26717,26717,7200E84AEDCA7E085FE069DDCE5F2702,41081,8,19,11,36,49,1849
26718,26718,7200E84AEDCA7E085FE069DDCE5F2702,42401,19,23,4,36,47,1847
26738,26738,E528C1BCF7730647027A4A7EFB058975,42631,0,6,6,43,45,2195
26739,26739,E528C1BCF7730647027A4A7EFB058975,13341,6,8,2,44,45,2245
26740,26740,E528C1BCF7730647027A4A7EFB058975,43061,8,9,1,43,46,2196
26741,26741,E528C1BCF7730647027A4A7EFB058975,13341,12,21,9,44,45,2245
26746,26746,5ABFABF55A302AC65CDD1BFE0186727A,42221,0,8,8,38,48,1948
26747,26747,5ABFABF55A302AC65CDD1BFE0186727A,10841,11,12,1,37,47,1897
26748,26748,5ABFABF55A302AC65CDD1BFE0186727A,11921,16,18,2,38,48,1948
26749,26749,5ABFABF55A302AC65CDD1BFE0186727A,11301,19,20,1,41,49,2099
26750,26750,6F3F4688F888FF4011915135083334C6,12641,0,6,6,10,43,543
26751,26751,6F3F4688F888FF4011915135083334C6,19114,8,11,3,7,43,393
26752,26752,6F3F4688F888FF4011915135083334C6,12641,14,23,9,10,43,543
26753,26753,2446E8F15BFC2A49F5E456D12DC187B8,42071,4,8,4,31,49,1599
26754,26754,2446E8F15BFC2A49F5E456D12DC187B8,43391,8,13,5,29,48,1498
26755,26755,2446E8F15BFC2A49F5E456D12DC187B8,10381,14,23,9,31,49,1599
26759,26759,2E5B93B6FE04610C56A0B33EE6E9E88D,11361,0,7,7,22,48,1148
26760,26760,2E5B93B6FE04610C56A0B33EE6E9E88D,42691,8,17,9,24,48,1248
26761,26761,2E5B93B6FE04610C56A0B33EE6E9E88D,42481,17,22,5,22,49,1149
26765,26765,46ECC1FB4BFD7A9CE6754D1733E3770C,43661,0,6,6,33,47,1697
26766,26766,46ECC1FB4BFD7A9CE6754D1733E3770C,11861,9,14,5,32,47,1647
26767,26767,46ECC1FB4BFD7A9CE6754D1733E3770C,42371,15,17,2,34,46,1746
26768,26768,46ECC1FB4BFD7A9CE6754D1733E3770C,42021,19,21,2,33,47,1697
26769,26769,BFC66AC44DE3D0C3983BFF60677905F1,13121,0,5,5,38,46,1946
26770,26770,BFC66AC44DE3D0C3983BFF60677905F1,10271,6,7,1,37,46,1896
26771,26771,BFC66AC44DE3D0C3983BFF60677905F1,13121,8,9,1,38,46,1946
26772,26772,BFC66AC44DE3D0C3983BFF60677905F1,10841,10,23,13,37,47,1897
26793,26793,5084492A6A758A3CF1EF2B8D58F59187,11875,0,6,6,30,46,1546
26794,26794,5084492A6A758A3CF1EF2B8D58F59187,12311,6,16,10,30,44,1544
26795,26795,5084492A6A758A3CF1EF2B8D58F59187,11875,18,23,5,30,46,1546
26807,26807,2B796358390FD846EE57DE8924EDBF14,42581,0,10,10,38,48,1948
26808,26808,2B796358390FD846EE57DE8924EDBF14,11331,10,11,1,37,48,1898
26809,26809,2B796358390FD846EE57DE8924EDBF14,40171,12,23,11,38,48,1948
26814,26814,E4A99F1C3E7ED34FBD67066F6ADB6F92,12311,0,5,5,30,44,1544
26815,26815,E4A99F1C3E7ED34FBD67066F6ADB6F92,10301,7,11,4,31,45,1595
26816,26816,E4A99F1C3E7ED34FBD67066F6ADB6F92,12311,12,21,9,30,44,1544
26817,26817,E4A99F1C3E7ED34FBD67066F6ADB6F92,10301,21,23,2,31,45,1595
26822,26822,0ABF15EDFCAA333ABA775777DB9BDACA,43981,0,1,1,36,49,1849
26823,26823,0ABF15EDFCAA333ABA775777DB9BDACA,11954,1,18,17,32,49,1649
26824,26824,0ABF15EDFCAA333ABA775777DB9BDACA,43981,21,22,1,36,49,1849
26840,26840,624C4BFCBA6BE4C3D9056CCC16907DD9,11381,8,14,6,30,47,1547
26841,26841,624C4BFCBA6BE4C3D9056CCC16907DD9,12121,15,16,1,29,47,1497
26842,26842,624C4BFCBA6BE4C3D9056CCC16907DD9,11381,16,23,7,30,47,1547
26843,26843,B885E78265DACA8F21D2357388930CCE,11461,0,1,1,37,49,1899
26844,26844,B885E78265DACA8F21D2357388930CCE,12514,1,9,8,38,47,1947
26845,26845,B885E78265DACA8F21D2357388930CCE,42511,9,11,2,37,47,1897
26846,26846,B885E78265DACA8F21D2357388930CCE,12514,13,22,9,38,47,1947
26859,26859,A26526FCE25758DA240C3B314B205E8A,19024,0,6,6,9,45,495
26860,26860,A26526FCE25758DA240C3B314B205E8A,12641,7,19,12,10,43,543
26861,26861,A26526FCE25758DA240C3B314B205E8A,19441,21,23,2,8,46,446
26862,26862,E8A3A2F2678AE58B36D710FCF037760E,11231,0,1,1,37,49,1899
26863,26863,E8A3A2F2678AE58B36D710FCF037760E,10411,2,17,15,36,48,1848
26864,26864,E8A3A2F2678AE58B36D710FCF037760E,11231,20,23,3,37,49,1899
26873,26873,3D14ED52517EC87D2CFF7A1C6FD766A1,11481,0,9,9,41,48,2098
26874,26874,3D14ED52517EC87D2CFF7A1C6FD766A1,13101,12,13,1,40,47,2047
26875,26875,3D14ED52517EC87D2CFF7A1C6FD766A1,11481,15,23,8,41,48,2098
26894,26894,7294ADAAB7F86703E931102CF604C5F5,42981,3,6,3,36,49,1849
26895,26895,7294ADAAB7F86703E931102CF604C5F5,13511,9,10,1,34,48,1748
26896,26896,7294ADAAB7F86703E931102CF604C5F5,42191,15,16,1,38,49,1949
26897,26897,7294ADAAB7F86703E931102CF604C5F5,40951,20,21,1,36,49,1849
26898,26898,BA91B9470249EAFC3720D0B9152253D7,42501,0,19,19,28,47,1447
26899,26899,BA91B9470249EAFC3720D0B9152253D7,11381,19,21,2,30,47,1547
26900,26900,BA91B9470249EAFC3720D0B9152253D7,42501,22,23,1,28,47,1447
26901,26901,C21989F99D3B120EE23386DE2361CA67,42231,0,8,8,37,46,1896
26902,26902,C21989F99D3B120EE23386DE2361CA67,10841,13,21,8,37,47,1897
26903,26903,C21989F99D3B120EE23386DE2361CA67,42231,21,23,2,37,46,1896
26909,26909,052ADC4E7A6EAE0ABB07A23D2A7C8445,11061,0,16,16,29,48,1498
26910,26910,052ADC4E7A6EAE0ABB07A23D2A7C8445,11381,16,17,1,30,47,1547
26911,26911,052ADC4E7A6EAE0ABB07A23D2A7C8445,10681,17,23,6,30,48,1548
26919,26919,2FC852B4FFDF067DECF04814ED84AACA,42511,0,11,11,37,47,1897
26920,26920,2FC852B4FFDF067DECF04814ED84AACA,10271,13,15,2,37,46,1896
26921,26921,2FC852B4FFDF067DECF04814ED84AACA,42511,16,18,2,37,47,1897
26922,26922,2FC852B4FFDF067DECF04814ED84AACA,10661,19,20,1,37,49,1899
26926,26926,14C205DF57BD0AA586E26BE4ED695846,42581,0,14,14,38,48,1948
26927,26927,14C205DF57BD0AA586E26BE4ED695846,11914,17,22,5,37,48,1898
26928,26928,14C205DF57BD0AA586E26BE4ED695846,42581,22,23,1,38,48,1948
26941,26941,BF866CAC6181D104CF2321FFD1D54D90,42491,1,2,1,32,46,1646
26942,26942,BF866CAC6181D104CF2321FFD1D54D90,42521,3,8,5,31,47,1597
26943,26943,BF866CAC6181D104CF2321FFD1D54D90,10292,9,18,9,30,47,1547
26944,26944,BF866CAC6181D104CF2321FFD1D54D90,42521,21,22,1,31,47,1597
26953,26953,D0D1074F45176FC191CDAB90155D8511,40833,0,6,6,41,47,2097
26954,26954,D0D1074F45176FC191CDAB90155D8511,11481,7,9,2,41,48,2098
26955,26955,D0D1074F45176FC191CDAB90155D8511,11301,12,15,3,41,49,2099
26956,26956,D0D1074F45176FC191CDAB90155D8511,11806,20,21,1,41,48,2098
26957,26957,91E718E92A6BC4FFDB2BED65F1A821B0,10661,0,8,8,37,49,1899
26958,26958,91E718E92A6BC4FFDB2BED65F1A821B0,10401,8,10,2,33,49,1699
26959,26959,91E718E92A6BC4FFDB2BED65F1A821B0,10661,11,23,12,37,49,1899
26960,26960,2096D605E761270CADC602C6FACD079B,10681,0,11,11,30,48,1548
26961,26961,2096D605E761270CADC602C6FACD079B,11061,15,17,2,29,48,1498
26962,26962,2096D605E761270CADC602C6FACD079B,10681,18,23,5,30,48,1548
26963,26963,8A816EA4A13C7A05F2858059CFD14D89,49201,1,6,5,7,41,391
26964,26964,8A816EA4A13C7A05F2858059CFD14D89,12921,9,17,8,9,41,491
26965,26965,8A816EA4A13C7A05F2858059CFD14D89,49201,18,23,5,7,41,391
26966,26966,A302484374CC515845C9B08843D53144,11381,1,6,5,30,47,1547
26967,26967,A302484374CC515845C9B08843D53144,11061,6,14,8,29,48,1498
26968,26968,A302484374CC515845C9B08843D53144,11381,15,17,2,30,47,1547
26969,26969,A302484374CC515845C9B08843D53144,11061,18,20,2,29,48,1498
26970,26970,7811A36A3B8B1362E3D1919C305829D8,13651,0,10,10,30,47,1547
26971,26971,7811A36A3B8B1362E3D1919C305829D8,12661,12,20,8,32,45,1645
26972,26972,7811A36A3B8B1362E3D1919C305829D8,11381,21,23,2,30,47,1547
26979,26979,44AA91905A7E8DBC24B0A51CC88C9204,42151,0,6,6,35,45,1795
26980,26980,44AA91905A7E8DBC24B0A51CC88C9204,42531,6,10,4,31,45,1595
26981,26981,44AA91905A7E8DBC24B0A51CC88C9204,42151,12,23,11,35,45,1795
26982,26982,128DCFD6B56FBE9785EE90D272DAB731,13731,2,11,9,33,49,1699
26983,26983,128DCFD6B56FBE9785EE90D272DAB731,11954,13,16,3,32,49,1649
26984,26984,128DCFD6B56FBE9785EE90D272DAB731,13731,18,19,1,33,49,1699
26985,26985,1C1F6C68185E32864EF19C73864604BB,42581,0,2,2,38,48,1948
26986,26986,1C1F6C68185E32864EF19C73864604BB,11914,4,10,6,37,48,1898
26987,26987,1C1F6C68185E32864EF19C73864604BB,42581,10,13,3,38,48,1948
26988,26988,1C1F6C68185E32864EF19C73864604BB,11911,13,21,8,37,48,1898
26996,26996,AA0DD1907C53C79CDF2CC2239F9884F9,11731,0,9,9,36,48,1848
26997,26997,AA0DD1907C53C79CDF2CC2239F9884F9,12083,15,17,2,36,49,1849
26998,26998,AA0DD1907C53C79CDF2CC2239F9884F9,11731,18,22,4,36,48,1848
26999,26999,AA0DD1907C53C79CDF2CC2239F9884F9,11231,22,23,1,37,49,1899
27008,27008,FAA9869DB3076F7A839BA1E47E6D87C5,11324,0,5,5,31,46,1596
27009,27009,FAA9869DB3076F7A839BA1E47E6D87C5,10951,9,10,1,29,48,1498
27010,27010,FAA9869DB3076F7A839BA1E47E6D87C5,11381,10,19,9,30,47,1547
27011,27011,FAA9869DB3076F7A839BA1E47E6D87C5,11324,20,23,3,31,46,1596
27018,27018,AA2539D9B54CFE4AD7D4B893AF5D182C,42301,0,9,9,36,47,1847
27019,27019,AA2539D9B54CFE4AD7D4B893AF5D182C,42511,11,12,1,37,47,1897
27020,27020,AA2539D9B54CFE4AD7D4B893AF5D182C,42301,12,23,11,36,47,1847
27057,27057,2C7D95B7F8A71C5FC3EC45077A737BE3,13371,0,16,16,41,47,2097
27058,27058,2C7D95B7F8A71C5FC3EC45077A737BE3,13221,17,18,1,40,47,2047
27059,27059,2C7D95B7F8A71C5FC3EC45077A737BE3,13371,20,21,1,41,47,2097
27060,27060,20EBDF07FAB10C468662B7339874EF65,11806,0,14,14,41,48,2098
27061,27061,20EBDF07FAB10C468662B7339874EF65,42271,15,20,5,40,47,2047
27062,27062,20EBDF07FAB10C468662B7339874EF65,11806,21,23,2,41,48,2098
27063,27063,139E705FEB960DA0C2327BA21AC8A84C,10911,0,10,10,39,46,1996
27064,27064,139E705FEB960DA0C2327BA21AC8A84C,11806,10,15,5,41,48,2098
27065,27065,139E705FEB960DA0C2327BA21AC8A84C,13101,16,19,3,40,47,2047
27071,27071,74520F546F2539E2BFCCF2955A1768C0,40673,0,4,4,36,48,1848
27072,27072,74520F546F2539E2BFCCF2955A1768C0,11231,6,17,11,37,49,1899
27073,27073,74520F546F2539E2BFCCF2955A1768C0,11271,17,18,1,37,48,1898
27074,27074,74520F546F2539E2BFCCF2955A1768C0,11231,22,23,1,37,49,1899
27109,27109,309C2EBD6881FB9505C9BCE9119A811B,13731,7,9,2,33,49,1699
27110,27110,309C2EBD6881FB9505C9BCE9119A811B,42071,12,13,1,31,49,1599
27111,27111,309C2EBD6881FB9505C9BCE9119A811B,13731,22,23,1,33,49,1699
27112,27112,CC826983AF147567E5D69C94E7380E48,11321,0,6,6,31,46,1596
27113,27113,CC826983AF147567E5D69C94E7380E48,11875,10,12,2,30,46,1546
27114,27114,CC826983AF147567E5D69C94E7380E48,12311,14,16,2,30,44,1544
27115,27115,CC826983AF147567E5D69C94E7380E48,11321,17,23,6,31,46,1596
27116,27116,76F0E4E7FC3D96822BB075AE4DF4D46C,42141,0,5,5,32,47,1647
27117,27117,76F0E4E7FC3D96822BB075AE4DF4D46C,42021,5,18,13,33,47,1697
27118,27118,76F0E4E7FC3D96822BB075AE4DF4D46C,11861,20,23,3,32,47,1647
27138,27138,FE004681BB28BF06C917204F0243DDB4,10531,1,7,6,34,46,1746
27139,27139,FE004681BB28BF06C917204F0243DDB4,43161,11,12,1,35,47,1797
27140,27140,FE004681BB28BF06C917204F0243DDB4,11651,16,17,1,33,47,1697
27141,27141,FE004681BB28BF06C917204F0243DDB4,42161,21,22,1,36,47,1847
27142,27142,4CA28E087D95A72AF97BE17DAF5BCBF2,12731,0,16,16,22,40,1140
27143,27143,4CA28E087D95A72AF97BE17DAF5BCBF2,13094,17,18,1,21,42,1092
27144,27144,4CA28E087D95A72AF97BE17DAF5BCBF2,13091,21,23,2,20,42,1042
27145,27145,F14B27CFA07BFF1C03E8748CE04AA105,10341,0,8,8,31,47,1597
27146,27146,F14B27CFA07BFF1C03E8748CE04AA105,10544,8,10,2,28,48,1448
27147,27147,F14B27CFA07BFF1C03E8748CE04AA105,11061,11,13,2,29,48,1498
27148,27148,F14B27CFA07BFF1C03E8748CE04AA105,10341,16,22,6,31,47,1597
27155,27155,A0D0A92258D9DAF7EDCF60BEFD3CB622,19441,0,10,10,8,46,446
27156,27156,A0D0A92258D9DAF7EDCF60BEFD3CB622,42041,10,14,4,10,47,547
27157,27157,A0D0A92258D9DAF7EDCF60BEFD3CB622,19441,14,19,5,8,46,446
27158,27158,3B9989389C2FB72384F3330F9A990AB0,42231,0,4,4,37,46,1896
27159,27159,3B9989389C2FB72384F3330F9A990AB0,42351,4,5,1,38,45,1945
27160,27160,3B9989389C2FB72384F3330F9A990AB0,42231,10,23,13,37,46,1896
27161,27161,48E848BEC812456E7DD8396BAFEE6761,11074,0,16,16,37,47,1897
27162,27162,48E848BEC812456E7DD8396BAFEE6761,40271,17,18,1,35,49,1799
27163,27163,48E848BEC812456E7DD8396BAFEE6761,11074,21,23,2,37,47,1897
27164,27164,48BFDAC45FFDDC1EE0721263D1AD77D7,10841,0,14,14,37,47,1897
27165,27165,48BFDAC45FFDDC1EE0721263D1AD77D7,10251,14,17,3,35,47,1797
27166,27166,48BFDAC45FFDDC1EE0721263D1AD77D7,10841,18,23,5,37,47,1897
27167,27167,7158BB5FE54F024DF86B9682428D7D80,43181,1,2,1,39,48,1998
27168,27168,7158BB5FE54F024DF86B9682428D7D80,10471,5,6,1,37,48,1898
27169,27169,7158BB5FE54F024DF86B9682428D7D80,42581,10,17,7,38,48,1948
27170,27170,7158BB5FE54F024DF86B9682428D7D80,10471,17,22,5,37,48,1898
27188,27188,990F89A555478F97C2E0E123BB133187,49201,5,6,1,7,41,391
27189,27189,990F89A555478F97C2E0E123BB133187,19181,9,11,2,8,40,440
27190,27190,990F89A555478F97C2E0E123BB133187,49201,12,13,1,7,41,391
27191,27191,990F89A555478F97C2E0E123BB133187,19181,16,19,3,8,40,440
27192,27192,44A1B2095028F2B1D6198AB3D390B206,11061,0,9,9,29,48,1498
27193,27193,44A1B2095028F2B1D6198AB3D390B206,10681,10,12,2,30,48,1548
27194,27194,44A1B2095028F2B1D6198AB3D390B206,11061,15,16,1,29,48,1498
27195,27195,44A1B2095028F2B1D6198AB3D390B206,10681,17,21,4,30,48,1548
27196,27196,D54477AB0049D6C15615D96E9339F35F,10411,1,9,8,36,48,1848
27197,27197,D54477AB0049D6C15615D96E9339F35F,40637,10,19,9,36,47,1847
27198,27198,D54477AB0049D6C15615D96E9339F35F,10411,20,21,1,36,48,1848
27199,27199,5A0EE807C504E748ADB72D7AA2D1BCFD,43971,0,4,4,30,48,1548
27200,27200,5A0EE807C504E748ADB72D7AA2D1BCFD,11061,5,7,2,29,48,1498
27201,27201,5A0EE807C504E748ADB72D7AA2D1BCFD,42521,7,9,2,31,47,1597
27202,27202,5A0EE807C504E748ADB72D7AA2D1BCFD,43971,9,23,14,30,48,1548
27212,27212,644074FAED2D07B771DBBC3C2ED7ABF4,13411,0,6,6,49,42,2492
27213,27213,644074FAED2D07B771DBBC3C2ED7ABF4,43951,6,20,14,49,41,2491
27214,27214,644074FAED2D07B771DBBC3C2ED7ABF4,13411,20,23,3,49,42,2492
27228,27228,E4E11D5BABE3812603202CD337AEBF21,42141,0,5,5,32,47,1647
27229,27229,E4E11D5BABE3812603202CD337AEBF21,13651,7,17,10,30,47,1547
27230,27230,E4E11D5BABE3812603202CD337AEBF21,43761,18,23,5,32,47,1647
27235,27235,660D2150C1391153938CD9B90E2CE919,12641,0,4,4,10,43,543
27236,27236,660D2150C1391153938CD9B90E2CE919,19021,6,14,8,10,45,545
27237,27237,660D2150C1391153938CD9B90E2CE919,19024,14,16,2,9,45,495
27238,27238,660D2150C1391153938CD9B90E2CE919,12641,20,23,3,10,43,543
27239,27239,389DA3D4B9F28E4FB981C4DEAEAE78AC,10271,0,9,9,37,46,1896
27240,27240,389DA3D4B9F28E4FB981C4DEAEAE78AC,10251,13,14,1,35,47,1797
27241,27241,389DA3D4B9F28E4FB981C4DEAEAE78AC,11751,15,18,3,35,48,1798
27242,27242,47F2C03C91E1D89BDD89B2581C85F965,11701,1,13,12,43,48,2198
27243,27243,47F2C03C91E1D89BDD89B2581C85F965,42321,13,15,2,43,47,2197
27244,27244,47F2C03C91E1D89BDD89B2581C85F965,40697,18,22,4,43,48,2198
27248,27248,D15100E610F8F0B5F3A2A9C57F7C2125,42511,0,14,14,37,47,1897
27249,27249,D15100E610F8F0B5F3A2A9C57F7C2125,12514,14,15,1,38,47,1947
27250,27250,D15100E610F8F0B5F3A2A9C57F7C2125,42511,19,20,1,37,47,1897
27251,27251,D15100E610F8F0B5F3A2A9C57F7C2125,12514,21,22,1,38,47,1947
27257,27257,DC5BA3A853ED31EE975EA6932EBA9DBD,13121,0,13,13,38,46,1946
27258,27258,DC5BA3A853ED31EE975EA6932EBA9DBD,43241,18,21,3,36,46,1846
27259,27259,DC5BA3A853ED31EE975EA6932EBA9DBD,11231,22,23,1,37,49,1899
27273,27273,AE931B79E80BF3CFA2F48EF7F9685CA5,11261,0,1,1,36,46,1846
27274,27274,AE931B79E80BF3CFA2F48EF7F9685CA5,12491,3,4,1,36,43,1843
27275,27275,AE931B79E80BF3CFA2F48EF7F9685CA5,13911,9,10,1,39,46,1996
27276,27276,AE931B79E80BF3CFA2F48EF7F9685CA5,11261,13,21,8,36,46,1846
27280,27280,9FC853D14B199D9AE09B3905110E90BD,12514,0,5,5,38,47,1947
27281,27281,9FC853D14B199D9AE09B3905110E90BD,42221,5,8,3,38,48,1948
27282,27282,9FC853D14B199D9AE09B3905110E90BD,12514,8,23,15,38,47,1947
27288,27288,669C34237215178780FBCDB7F5444D7E,43971,0,2,2,30,48,1548
27289,27289,669C34237215178780FBCDB7F5444D7E,42521,2,12,10,31,47,1597
27290,27290,669C34237215178780FBCDB7F5444D7E,43971,14,18,4,30,48,1548
27291,27291,669C34237215178780FBCDB7F5444D7E,11381,20,23,3,30,47,1547
27301,27301,4ECF535B69201A355EA7749BD213A59C,11231,0,3,3,37,49,1899
27302,27302,4ECF535B69201A355EA7749BD213A59C,11351,4,11,7,36,48,1848
27303,27303,4ECF535B69201A355EA7749BD213A59C,11231,11,23,12,37,49,1899
27315,27315,0A61C8BC2E2F3B8A439DFBB7542FD5B0,13371,7,9,2,41,47,2097
27316,27316,0A61C8BC2E2F3B8A439DFBB7542FD5B0,13121,10,11,1,38,46,1946
27317,27317,0A61C8BC2E2F3B8A439DFBB7542FD5B0,13371,11,23,12,41,47,2097
27354,27354,3457AFD1000C37A689F1A73ADB9321A9,12521,0,16,16,35,41,1791
27355,27355,3457AFD1000C37A689F1A73ADB9321A9,43451,17,18,1,37,40,1890
27356,27356,3457AFD1000C37A689F1A73ADB9321A9,12521,20,23,3,35,41,1791
27357,27357,E835E54D31E2053FF59F5E3D61ABCD72,42071,0,4,4,31,49,1599
27358,27358,E835E54D31E2053FF59F5E3D61ABCD72,11151,4,15,11,30,48,1548
27359,27359,E835E54D31E2053FF59F5E3D61ABCD72,11061,17,18,1,29,48,1498
27360,27360,E835E54D31E2053FF59F5E3D61ABCD72,11151,19,22,3,30,48,1548
27372,27372,350909571DAF40BC1326F0871B6F4AC2,42371,0,6,6,34,46,1746
27373,27373,350909571DAF40BC1326F0871B6F4AC2,40637,15,16,1,36,47,1847
27374,27374,350909571DAF40BC1326F0871B6F4AC2,42371,19,23,4,34,46,1746
27380,27380,97B6D6D29EC4E9F125FDF48E88E16061,11381,0,8,8,30,47,1547
27381,27381,97B6D6D29EC4E9F125FDF48E88E16061,43971,9,14,5,30,48,1548
27382,27382,97B6D6D29EC4E9F125FDF48E88E16061,11061,19,20,1,29,48,1498
27388,27388,7598D32DC332293D35F2F6ACB7EBDD15,10251,0,18,18,35,47,1797
27389,27389,7598D32DC332293D35F2F6ACB7EBDD15,11751,19,20,1,35,48,1798
27390,27390,7598D32DC332293D35F2F6ACB7EBDD15,11941,20,22,2,37,46,1896
27391,27391,1DA79481C6B6D1D9223A378A0D81757A,10111,0,15,15,37,47,1897
27392,27392,1DA79481C6B6D1D9223A378A0D81757A,11331,16,17,1,37,48,1898
27393,27393,1DA79481C6B6D1D9223A378A0D81757A,10111,18,23,5,37,47,1897
27408,27408,7F8FEC3F30CB3DD9FA8B49EBAA16E6AE,10111,0,9,9,37,47,1897
27409,27409,7F8FEC3F30CB3DD9FA8B49EBAA16E6AE,13121,9,10,1,38,46,1946
27410,27410,7F8FEC3F30CB3DD9FA8B49EBAA16E6AE,10111,17,23,6,37,47,1897
27411,27411,1CE5F4D10EE2FB173CB9F2BC0746661A,12311,0,9,9,30,44,1544
27412,27412,1CE5F4D10EE2FB173CB9F2BC0746661A,42531,10,14,4,31,45,1595
27413,27413,1CE5F4D10EE2FB173CB9F2BC0746661A,12311,18,22,4,30,44,1544
27428,27428,FEE5ACDB24DFF6E9A25C550C618C43AE,42161,2,11,9,36,47,1847
27429,27429,FEE5ACDB24DFF6E9A25C550C618C43AE,40673,12,14,2,36,48,1848
27430,27430,FEE5ACDB24DFF6E9A25C550C618C43AE,10251,14,18,4,35,47,1797
27431,27431,FEE5ACDB24DFF6E9A25C550C618C43AE,11941,20,23,3,37,46,1896
27440,27440,394B81CC36B31D897120A6153D7C1457,11061,0,4,4,29,48,1498
27441,27441,394B81CC36B31D897120A6153D7C1457,12121,7,14,7,29,47,1497
27442,27442,394B81CC36B31D897120A6153D7C1457,11061,17,21,4,29,48,1498
27447,27447,185D56D388FE8A96E07F52D610C68C9B,12514,0,16,16,38,47,1947
27448,27448,185D56D388FE8A96E07F52D610C68C9B,11074,18,19,1,37,47,1897
27449,27449,185D56D388FE8A96E07F52D610C68C9B,12514,19,23,4,38,47,1947
27457,27457,B54975B2A820370FFF355FA7E33D956D,42401,0,12,12,36,47,1847
27458,27458,B54975B2A820370FFF355FA7E33D956D,10111,12,13,1,37,47,1897
27459,27459,B54975B2A820370FFF355FA7E33D956D,42301,17,23,6,36,47,1847
27460,27460,405F80E4DB047BF65667610085A0E1FB,19441,0,9,9,8,46,446
27461,27461,405F80E4DB047BF65667610085A0E1FB,42041,10,11,1,10,47,547
27462,27462,405F80E4DB047BF65667610085A0E1FB,19441,11,19,8,8,46,446
27463,27463,EF24F74DDF741D0DEC0CB3B2510AE4FC,10351,0,6,6,28,45,1445
27464,27464,EF24F74DDF741D0DEC0CB3B2510AE4FC,10301,7,20,13,31,45,1595
27465,27465,EF24F74DDF741D0DEC0CB3B2510AE4FC,10351,22,23,1,28,45,1445
27473,27473,BA285F01E6926591864F1F3184565800,42581,0,9,9,38,48,1948
27474,27474,BA285F01E6926591864F1F3184565800,11914,11,12,1,37,48,1898
27475,27475,BA285F01E6926591864F1F3184565800,40171,14,15,1,38,48,1948
27476,27476,BA285F01E6926591864F1F3184565800,10107,16,21,5,38,49,1949
27484,27484,5AC2D6E8C66247063F49530DBE7AF221,10251,0,4,4,35,47,1797
27485,27485,5AC2D6E8C66247063F49530DBE7AF221,43731,4,8,4,34,47,1747
27486,27486,5AC2D6E8C66247063F49530DBE7AF221,10251,9,19,10,35,47,1797
27487,27487,5AC2D6E8C66247063F49530DBE7AF221,42161,20,22,2,36,47,1847
27491,27491,70E50AA138C0538910E5623295B506D8,42351,4,6,2,38,45,1945
27492,27492,70E50AA138C0538910E5623295B506D8,11261,10,12,2,36,46,1846
27493,27493,70E50AA138C0538910E5623295B506D8,13911,12,14,2,39,46,1996
27494,27494,70E50AA138C0538910E5623295B506D8,42351,17,18,1,38,45,1945
27495,27495,C835EEEDE005D3B4BA8B4E767519847C,43731,0,1,1,34,47,1747
27496,27496,C835EEEDE005D3B4BA8B4E767519847C,10971,1,10,9,35,47,1797
27497,27497,C835EEEDE005D3B4BA8B4E767519847C,43731,10,12,2,34,47,1747
27498,27498,C835EEEDE005D3B4BA8B4E767519847C,42921,17,23,6,33,47,1697
27507,27507,43AA632E12ABCA3F01D2033AFFAEDEF3,10151,0,8,8,34,47,1747
27508,27508,43AA632E12ABCA3F01D2033AFFAEDEF3,10531,12,13,1,34,46,1746
27509,27509,43AA632E12ABCA3F01D2033AFFAEDEF3,10151,16,23,7,34,47,1747
27526,27526,0CF512FC69F088D8EDFBB0E5C1B7EBC8,13651,8,9,1,30,47,1547
27527,27527,0CF512FC69F088D8EDFBB0E5C1B7EBC8,12121,10,12,2,29,47,1497
27528,27528,0CF512FC69F088D8EDFBB0E5C1B7EBC8,13651,15,17,2,30,47,1547
27529,27529,0CF512FC69F088D8EDFBB0E5C1B7EBC8,12121,21,23,2,29,47,1497
27530,27530,9F541427977446D96030A544BAE61896,10221,0,14,14,34,49,1749
27531,27531,9F541427977446D96030A544BAE61896,13561,14,15,1,37,49,1899
27532,27532,9F541427977446D96030A544BAE61896,10221,18,20,2,34,49,1749
27533,27533,33AE0DE753B40346F5819E39A735C5C1,10491,0,8,8,33,48,1698
27534,27534,33AE0DE753B40346F5819E39A735C5C1,11381,14,16,2,30,47,1547
27535,27535,33AE0DE753B40346F5819E39A735C5C1,42471,17,18,1,35,49,1799
27541,27541,75B73E3953DB5FE1D47D41CFE2BB4DC6,13121,0,8,8,38,46,1946
27542,27542,75B73E3953DB5FE1D47D41CFE2BB4DC6,13331,8,12,4,38,47,1947
27543,27543,75B73E3953DB5FE1D47D41CFE2BB4DC6,10271,12,16,4,37,46,1896
27544,27544,75B73E3953DB5FE1D47D41CFE2BB4DC6,11491,20,21,1,36,47,1847
27548,27548,59BAD7D0307255207187442691451EAD,13094,0,6,6,21,42,1092
27549,27549,59BAD7D0307255207187442691451EAD,12671,8,9,1,21,43,1093
27550,27550,59BAD7D0307255207187442691451EAD,13094,12,16,4,21,42,1092
27551,27551,59BAD7D0307255207187442691451EAD,13091,19,21,2,20,42,1042
27559,27559,D8063B7C8CAA23F18B002D2A443A5135,43101,0,7,7,46,40,2340
27560,27560,D8063B7C8CAA23F18B002D2A443A5135,43951,7,8,1,49,41,2491
27561,27561,D8063B7C8CAA23F18B002D2A443A5135,43101,8,22,14,46,40,2340
27565,27565,EDD75337CB590392F5B95F6FB9BFB234,10471,6,11,5,37,48,1898
27566,27566,EDD75337CB590392F5B95F6FB9BFB234,10107,12,17,5,38,49,1949
27567,27567,EDD75337CB590392F5B95F6FB9BFB234,10471,18,23,5,37,48,1898
27571,27571,474A8DACA51CB40E50178AB2BE706270,11806,0,4,4,41,48,2098
27572,27572,474A8DACA51CB40E50178AB2BE706270,42271,6,7,1,40,47,2047
27573,27573,474A8DACA51CB40E50178AB2BE706270,11806,8,23,15,41,48,2098
27574,27574,6EA4CCEDBFDE801AE8D11614A06A0C5C,11281,0,4,4,27,40,1390
27575,27575,6EA4CCEDBFDE801AE8D11614A06A0C5C,13671,6,7,1,27,43,1393
27576,27576,6EA4CCEDBFDE801AE8D11614A06A0C5C,11281,10,23,13,27,40,1390
27582,27582,F3A2A95C1CAE090A29A04F767E407686,42161,2,5,3,36,47,1847
27583,27583,F3A2A95C1CAE090A29A04F767E407686,42941,7,19,12,37,47,1897
27584,27584,F3A2A95C1CAE090A29A04F767E407686,11781,22,23,1,38,49,1949
27585,27585,7FD9072832AAE29AE2915CDEF233B942,42321,0,7,7,43,47,2197
27586,27586,7FD9072832AAE29AE2915CDEF233B942,10801,10,17,7,42,47,2147
27587,27587,7FD9072832AAE29AE2915CDEF233B942,42321,22,23,1,43,47,2197
27591,27591,C58858487A094FE533AB3B2C1388EAF8,42161,0,2,2,36,47,1847
27592,27592,C58858487A094FE533AB3B2C1388EAF8,42141,3,15,12,32,47,1647
27593,27593,C58858487A094FE533AB3B2C1388EAF8,10251,18,23,5,35,47,1797
27594,27594,5934F23DBC87E0A312C26B502942AF2F,11261,6,7,1,36,46,1846
27595,27595,5934F23DBC87E0A312C26B502942AF2F,42231,8,15,7,37,46,1896
27596,27596,5934F23DBC87E0A312C26B502942AF2F,13911,16,17,1,39,46,1996
27597,27597,5934F23DBC87E0A312C26B502942AF2F,11491,20,21,1,36,47,1847
27598,27598,A3D2BAA56CF79B0ACEF2BC2F2CE5A460,11431,0,10,10,29,47,1497
27599,27599,A3D2BAA56CF79B0ACEF2BC2F2CE5A460,10711,12,14,2,29,46,1496
27600,27600,A3D2BAA56CF79B0ACEF2BC2F2CE5A460,11091,22,23,1,29,47,1497
27613,27613,A03C1D63BAC5E41AE1A4B426E037BC8D,40431,0,6,6,36,47,1847
27614,27614,A03C1D63BAC5E41AE1A4B426E037BC8D,10271,9,17,8,37,46,1896
27615,27615,A03C1D63BAC5E41AE1A4B426E037BC8D,13121,17,18,1,38,46,1946
27616,27616,A03C1D63BAC5E41AE1A4B426E037BC8D,40431,20,23,3,36,47,1847
27626,27626,9B8E3A84EF821A3E9564A6D6EAEA0FE5,11914,0,1,1,37,48,1898
27627,27627,9B8E3A84EF821A3E9564A6D6EAEA0FE5,42581,3,4,1,38,48,1948
27628,27628,9B8E3A84EF821A3E9564A6D6EAEA0FE5,11914,5,19,14,37,48,1898
27629,27629,9B8E3A84EF821A3E9564A6D6EAEA0FE5,42581,20,21,1,38,48,1948
27630,27630,2A0992E271C7BA45FB386AAF3150EA6F,11861,2,4,2,32,47,1647
27631,27631,2A0992E271C7BA45FB386AAF3150EA6F,10611,6,13,7,32,48,1648
27632,27632,2A0992E271C7BA45FB386AAF3150EA6F,11861,16,17,1,32,47,1647
27633,27633,2A0992E271C7BA45FB386AAF3150EA6F,10611,21,23,2,32,48,1648
27637,27637,D1B681929BD44A1A7918A0268A3E43F0,12641,0,5,5,10,43,543
27638,27638,D1B681929BD44A1A7918A0268A3E43F0,12921,6,14,8,9,41,491
27639,27639,D1B681929BD44A1A7918A0268A3E43F0,12641,14,23,9,10,43,543
27640,27640,5D3AB87CDE152EA5E956E4DDC06AC59B,40171,0,11,11,38,48,1948
27641,27641,5D3AB87CDE152EA5E956E4DDC06AC59B,10471,12,13,1,37,48,1898
27642,27642,5D3AB87CDE152EA5E956E4DDC06AC59B,42581,13,17,4,38,48,1948
27643,27643,5D3AB87CDE152EA5E956E4DDC06AC59B,10471,20,22,2,37,48,1898
27644,27644,A25BD81EC9134E523B096ACC3062CFB1,40833,0,8,8,41,47,2097
27645,27645,A25BD81EC9134E523B096ACC3062CFB1,40171,8,10,2,38,48,1948
27646,27646,A25BD81EC9134E523B096ACC3062CFB1,40833,14,19,5,41,47,2097
27647,27647,A9CB10B468D8E4AF35699B759EB26E7B,10251,0,12,12,35,47,1797
27648,27648,A9CB10B468D8E4AF35699B759EB26E7B,10411,13,18,5,36,48,1848
27649,27649,A9CB10B468D8E4AF35699B759EB26E7B,10251,18,22,4,35,47,1797
27650,27650,511248B31413344B77C12D74A5EE7CDF,40872,0,7,7,30,49,1549
27651,27651,511248B31413344B77C12D74A5EE7CDF,11151,10,17,7,30,48,1548
27652,27652,511248B31413344B77C12D74A5EE7CDF,11381,21,22,1,30,47,1547
27653,27653,7A8F9786100F8F4E166FF0614007C794,11161,1,5,4,32,48,1648
27654,27654,7A8F9786100F8F4E166FF0614007C794,43761,9,17,8,32,47,1647
27655,27655,7A8F9786100F8F4E166FF0614007C794,11161,18,19,1,32,48,1648
27656,27656,7A8F9786100F8F4E166FF0614007C794,43761,20,22,2,32,47,1647
27657,27657,3D514E4E67A21E1A34FB75EA946F21E7,11875,0,6,6,30,46,1546
27658,27658,3D514E4E67A21E1A34FB75EA946F21E7,12311,7,10,3,30,44,1544
27659,27659,3D514E4E67A21E1A34FB75EA946F21E7,11875,10,15,5,30,46,1546
27660,27660,3D514E4E67A21E1A34FB75EA946F21E7,11871,15,19,4,29,46,1496
27681,27681,25DF23F398DD0B4C6CED78808A57A933,11091,0,8,8,29,47,1497
27682,27682,25DF23F398DD0B4C6CED78808A57A933,10292,9,17,8,30,47,1547
27683,27683,25DF23F398DD0B4C6CED78808A57A933,11091,21,23,2,29,47,1497
27698,27698,4A7DB4C98C495CBE39929E4AF5856114,11531,0,4,4,34,49,1749
27699,27699,4A7DB4C98C495CBE39929E4AF5856114,11201,17,18,1,35,49,1799
27700,27700,4A7DB4C98C495CBE39929E4AF5856114,11531,18,21,3,34,49,1749
27706,27706,857A8E0D6DC1B408B8273E584D9A8FC4,13371,0,15,15,41,47,2097
27707,27707,857A8E0D6DC1B408B8273E584D9A8FC4,11806,17,18,1,41,48,2098
27708,27708,857A8E0D6DC1B408B8273E584D9A8FC4,13371,18,22,4,41,47,2097
27729,27729,2353E24278CC2C352AD768571A17B8C0,19181,6,7,1,8,40,440
27730,27730,2353E24278CC2C352AD768571A17B8C0,49201,11,12,1,7,41,391
27731,27731,2353E24278CC2C352AD768571A17B8C0,12921,14,16,2,9,41,491
27732,27732,2353E24278CC2C352AD768571A17B8C0,49201,18,19,1,7,41,391
27744,27744,F7F5786640F27ED295C03A9D39E50230,42341,0,10,10,43,49,2199
27745,27745,F7F5786640F27ED295C03A9D39E50230,10191,10,11,1,40,48,2048
27746,27746,F7F5786640F27ED295C03A9D39E50230,42341,13,17,4,43,49,2199
27747,27747,F7F5786640F27ED295C03A9D39E50230,10191,22,23,1,40,48,2048
27748,27748,4515D69DA9DF7C67BD58AB71BAA57E58,11914,0,9,9,37,48,1898
27749,27749,4515D69DA9DF7C67BD58AB71BAA57E58,40171,9,16,7,38,48,1948
27750,27750,4515D69DA9DF7C67BD58AB71BAA57E58,11914,17,23,6,37,48,1898
27761,27761,F1D52E271AD2CA60B9DB39C5E4BE77A4,12641,0,4,4,10,43,543
27762,27762,F1D52E271AD2CA60B9DB39C5E4BE77A4,19021,8,15,7,10,45,545
27763,27763,F1D52E271AD2CA60B9DB39C5E4BE77A4,12641,19,21,2,10,43,543
27764,27764,F1D52E271AD2CA60B9DB39C5E4BE77A4,19931,22,23,1,7,43,393
27780,27780,ED70E4FFEFCCC0655C158EA3C526D0EE,11271,1,11,10,37,48,1898
27781,27781,ED70E4FFEFCCC0655C158EA3C526D0EE,42581,15,16,1,38,48,1948
27782,27782,ED70E4FFEFCCC0655C158EA3C526D0EE,11914,17,18,1,37,48,1898
27783,27783,ED70E4FFEFCCC0655C158EA3C526D0EE,42581,20,21,1,38,48,1948
27784,27784,6AE92A17C626057150B2CCF755D6FCFC,11901,0,9,9,42,49,2149
27785,27785,6AE92A17C626057150B2CCF755D6FCFC,40302,12,13,1,40,49,2049
27786,27786,6AE92A17C626057150B2CCF755D6FCFC,11901,13,23,10,42,49,2149
27790,27790,7300FFB733BFFEA187DB110E4D4DC3D2,19181,0,6,6,8,40,440
27791,27791,7300FFB733BFFEA187DB110E4D4DC3D2,12921,8,9,1,9,41,491
27792,27792,7300FFB733BFFEA187DB110E4D4DC3D2,49201,13,15,2,7,41,391
27793,27793,7300FFB733BFFEA187DB110E4D4DC3D2,19114,19,20,1,7,43,393
27798,27798,155EAD487ABEF6E5584C76B8730CF96B,11074,0,8,8,37,47,1897
27799,27799,155EAD487ABEF6E5584C76B8730CF96B,10191,8,10,2,40,48,2048
27800,27800,155EAD487ABEF6E5584C76B8730CF96B,11074,11,13,2,37,47,1897
27801,27801,155EAD487ABEF6E5584C76B8730CF96B,42021,16,23,7,33,47,1697
27802,27802,24CACD73BA8D75767DDD668E5EA165E2,40171,0,5,5,38,48,1948
27803,27803,24CACD73BA8D75767DDD668E5EA165E2,11914,7,9,2,37,48,1898
27804,27804,24CACD73BA8D75767DDD668E5EA165E2,40171,11,13,2,38,48,1948
27805,27805,24CACD73BA8D75767DDD668E5EA165E2,11914,13,18,5,37,48,1898
27809,27809,6AE2FA19F90C6BBDAB69E2E1C7BD408D,11921,0,15,15,38,48,1948
27810,27810,6AE2FA19F90C6BBDAB69E2E1C7BD408D,11914,16,17,1,37,48,1898
27811,27811,6AE2FA19F90C6BBDAB69E2E1C7BD408D,11921,19,21,2,38,48,1948
27812,27812,6AE2FA19F90C6BBDAB69E2E1C7BD408D,11914,22,23,1,37,48,1898
27813,27813,04218139C4137A884FE7935678F7D5B1,11231,0,7,7,37,49,1899
27814,27814,04218139C4137A884FE7935678F7D5B1,11531,9,11,2,34,49,1749
27815,27815,04218139C4137A884FE7935678F7D5B1,11201,15,17,2,35,49,1799
27816,27816,04218139C4137A884FE7935678F7D5B1,11271,19,20,1,37,48,1898
27817,27817,73701CC9434D9172C828A8DD1EB9C8FD,19114,0,5,5,7,43,393
27818,27818,73701CC9434D9172C828A8DD1EB9C8FD,49201,8,17,9,7,41,391
27819,27819,73701CC9434D9172C828A8DD1EB9C8FD,19114,19,23,4,7,43,393
27823,27823,6AC475AC79C633534E038993D43D2BFF,40891,0,12,12,37,47,1897
27824,27824,6AC475AC79C633534E038993D43D2BFF,10785,12,14,2,35,47,1797
27825,27825,6AC475AC79C633534E038993D43D2BFF,13121,14,16,2,38,46,1946
27826,27826,6AC475AC79C633534E038993D43D2BFF,40891,17,23,6,37,47,1897
27827,27827,82D1CEDE24E0792F5B9EEC9BCF1BF69B,43101,0,1,1,46,40,2340
27828,27828,82D1CEDE24E0792F5B9EEC9BCF1BF69B,43951,6,15,9,49,41,2491
27829,27829,82D1CEDE24E0792F5B9EEC9BCF1BF69B,43101,20,21,1,46,40,2340
27830,27830,65C1604BB67F0F47E8EDA9EA4716D601,42864,0,6,6,38,44,1944
27831,27831,65C1604BB67F0F47E8EDA9EA4716D601,11261,10,11,1,36,46,1846
27832,27832,65C1604BB67F0F47E8EDA9EA4716D601,42864,12,23,11,38,44,1944
27833,27833,A5985BC498E0A51C59FCA0D4DD429277,11701,0,11,11,43,48,2198
27834,27834,A5985BC498E0A51C59FCA0D4DD429277,40302,14,21,7,40,49,2049
27835,27835,A5985BC498E0A51C59FCA0D4DD429277,41393,21,23,2,43,49,2199
27840,27840,5AA983F1C8CEDAA46FA754897B4EC93C,11261,0,7,7,36,46,1846
27841,27841,5AA983F1C8CEDAA46FA754897B4EC93C,42864,12,14,2,38,44,1944
27842,27842,5AA983F1C8CEDAA46FA754897B4EC93C,11261,17,22,5,36,46,1846
27853,27853,A06465C33822DBAACCFCA67CF792360D,10295,0,9,9,30,47,1547
27854,27854,A06465C33822DBAACCFCA67CF792360D,42523,10,12,2,31,47,1597
27855,27855,A06465C33822DBAACCFCA67CF792360D,10295,12,22,10,30,47,1547
27856,27856,8B7D7C1DA2F14FAC0EB28238A1F33D6C,13271,1,3,2,41,47,2097
27857,27857,8B7D7C1DA2F14FAC0EB28238A1F33D6C,13101,5,15,10,40,47,2047
27858,27858,8B7D7C1DA2F14FAC0EB28238A1F33D6C,40833,16,17,1,41,47,2097
27859,27859,8B7D7C1DA2F14FAC0EB28238A1F33D6C,13101,17,18,1,40,47,2047
27869,27869,D9FB9F3F4820A4EF951566780A770C45,42351,0,1,1,38,45,1945
27870,27870,D9FB9F3F4820A4EF951566780A770C45,11261,5,15,10,36,46,1846
27871,27871,D9FB9F3F4820A4EF951566780A770C45,42351,15,16,1,38,45,1945
27872,27872,D9FB9F3F4820A4EF951566780A770C45,11261,17,19,2,36,46,1846
27873,27873,9582B0C41CE65E76B09E8491AC26676B,11875,0,5,5,30,46,1546
27874,27874,9582B0C41CE65E76B09E8491AC26676B,12311,6,16,10,30,44,1544
27875,27875,9582B0C41CE65E76B09E8491AC26676B,11875,20,23,3,30,46,1546
27876,27876,64EA873D359181A561255128009EB239,12514,0,1,1,38,47,1947
27877,27877,64EA873D359181A561255128009EB239,42581,1,5,4,38,48,1948
27878,27878,64EA873D359181A561255128009EB239,11914,6,19,13,37,48,1898
27879,27879,64EA873D359181A561255128009EB239,42581,22,23,1,38,48,1948
27883,27883,FCC81FB1D89F2E284C3312E5101F2149,42151,3,6,3,35,45,1795
27884,27884,FCC81FB1D89F2E284C3312E5101F2149,42861,7,8,1,37,44,1894
27885,27885,FCC81FB1D89F2E284C3312E5101F2149,42151,9,23,14,35,45,1795
27886,27886,EFBA89D1B9F8A3238B6B7005DFF11556,10801,8,9,1,42,47,2147
27887,27887,EFBA89D1B9F8A3238B6B7005DFF11556,42321,10,13,3,43,47,2197
27888,27888,EFBA89D1B9F8A3238B6B7005DFF11556,13341,17,19,2,44,45,2245
27889,27889,6B4D51A4231E697456281435F5175150,13841,0,12,12,40,46,2046
27890,27890,6B4D51A4231E697456281435F5175150,43341,16,20,4,41,46,2096
27891,27891,6B4D51A4231E697456281435F5175150,10821,21,23,2,40,47,2047
27892,27892,3EE21C82096056103395982F3BA140C7,13511,4,6,2,34,48,1748
27893,27893,3EE21C82096056103395982F3BA140C7,10251,7,8,1,35,47,1797
27894,27894,3EE21C82096056103395982F3BA140C7,42161,8,19,11,36,47,1847
27895,27895,3EE21C82096056103395982F3BA140C7,13511,20,22,2,34,48,1748
27901,27901,BA378CA14AC7E7392C5911748E498DCC,10171,4,13,9,26,47,1347
27902,27902,BA378CA14AC7E7392C5911748E498DCC,12601,14,20,6,25,47,1297
27903,27903,BA378CA14AC7E7392C5911748E498DCC,10171,21,22,1,26,47,1347
27919,27919,C332ACE59D95C5B7ACA16A093B91D4F8,13111,0,12,12,42,46,2146
27920,27920,C332ACE59D95C5B7ACA16A093B91D4F8,11481,13,15,2,41,48,2098
27921,27921,C332ACE59D95C5B7ACA16A093B91D4F8,13111,18,23,5,42,46,2146
27937,27937,C854A42BD96B9AAAFCA68A46B1033403,10221,0,2,2,34,49,1749
27938,27938,C854A42BD96B9AAAFCA68A46B1033403,10251,6,18,12,35,47,1797
27939,27939,C854A42BD96B9AAAFCA68A46B1033403,11201,20,23,3,35,49,1799
27945,27945,7DF20745CA3702FAFFAC0138B1B2E95E,12391,4,8,4,36,49,1849
27946,27946,7DF20745CA3702FAFFAC0138B1B2E95E,13561,10,11,1,37,49,1899
27947,27947,7DF20745CA3702FAFFAC0138B1B2E95E,12083,13,23,10,36,49,1849
27948,27948,5E269639C787C5D2BDF7F359B5257597,13381,0,8,8,39,47,1997
27949,27949,5E269639C787C5D2BDF7F359B5257597,11481,9,18,9,41,48,2098
27950,27950,5E269639C787C5D2BDF7F359B5257597,13381,20,23,3,39,47,1997
27951,27951,CD5264FA94F0D7079560625C6CCF7D91,13711,2,5,3,38,46,1946
27952,27952,CD5264FA94F0D7079560625C6CCF7D91,10271,7,8,1,37,46,1896
27953,27953,CD5264FA94F0D7079560625C6CCF7D91,13711,9,23,14,38,46,1946
27972,27972,8819837FD8CEEBF0A1A8389A5700C1ED,42601,0,8,8,44,48,2248
27973,27973,8819837FD8CEEBF0A1A8389A5700C1ED,42091,9,18,9,43,46,2196
27974,27974,8819837FD8CEEBF0A1A8389A5700C1ED,42461,18,21,3,45,47,2297
27978,27978,8CD5156CF883DA15618BAFE58DDCF2A7,42581,0,6,6,38,48,1948
27979,27979,8CD5156CF883DA15618BAFE58DDCF2A7,11914,7,19,12,37,48,1898
27980,27980,8CD5156CF883DA15618BAFE58DDCF2A7,42581,21,23,2,38,48,1948
27988,27988,DC444CC4C9F386FD35E14E55AD0AC285,13011,1,2,1,39,47,1997
27989,27989,DC444CC4C9F386FD35E14E55AD0AC285,42321,2,6,4,43,47,2197
27990,27990,DC444CC4C9F386FD35E14E55AD0AC285,13941,7,8,1,41,47,2097
27991,27991,DC444CC4C9F386FD35E14E55AD0AC285,42321,12,21,9,43,47,2197
28021,28021,C13E66C78C66072C9185A5D9323CAB19,42021,0,16,16,33,47,1697
28022,28022,C13E66C78C66072C9185A5D9323CAB19,43761,17,19,2,32,47,1647
28023,28023,C13E66C78C66072C9185A5D9323CAB19,42021,19,21,2,33,47,1697
28028,28028,7F8504A93A07B16991910D6FBDF251C3,42523,0,8,8,31,47,1597
28029,28029,7F8504A93A07B16991910D6FBDF251C3,10295,9,14,5,30,47,1547
28030,28030,7F8504A93A07B16991910D6FBDF251C3,42523,16,18,2,31,47,1597
28031,28031,7F8504A93A07B16991910D6FBDF251C3,10295,18,23,5,30,47,1547
28059,28059,7F78752A70A41E260D80D552F245436B,42501,0,13,13,28,47,1447
28060,28060,7F78752A70A41E260D80D552F245436B,11381,14,16,2,30,47,1547
28061,28061,7F78752A70A41E260D80D552F245436B,42501,18,23,5,28,47,1447
28070,28070,10998AC050402D0103054DA8672DA230,19441,0,7,7,8,46,446
28071,28071,10998AC050402D0103054DA8672DA230,42041,8,10,2,10,47,547
28072,28072,10998AC050402D0103054DA8672DA230,19441,12,20,8,8,46,446
28082,28082,2FC977AAECB05F28AE0C53353C4DD1FC,13121,0,9,9,38,46,1946
28083,28083,2FC977AAECB05F28AE0C53353C4DD1FC,10271,13,16,3,37,46,1896
28084,28084,2FC977AAECB05F28AE0C53353C4DD1FC,13121,19,22,3,38,46,1946
28085,28085,F004825C5EEC7F8B7A184D4985895C55,13341,0,7,7,44,45,2245
28086,28086,F004825C5EEC7F8B7A184D4985895C55,42631,8,13,5,43,45,2195
28087,28087,F004825C5EEC7F8B7A184D4985895C55,13341,14,16,2,44,45,2245
28088,28088,F004825C5EEC7F8B7A184D4985895C55,42631,18,20,2,43,45,2195
28103,28103,2F8A771E760E88DECBB6AC957DA76EF5,42031,0,9,9,40,46,2046
28104,28104,2F8A771E760E88DECBB6AC957DA76EF5,43341,10,11,1,41,46,2096
28105,28105,2F8A771E760E88DECBB6AC957DA76EF5,42031,12,23,11,40,46,2046
28126,28126,3F29D0D409D1B6D4E7D2087740FD0BBC,10251,0,11,11,35,47,1797
28127,28127,3F29D0D409D1B6D4E7D2087740FD0BBC,42161,11,12,1,36,47,1847
28128,28128,3F29D0D409D1B6D4E7D2087740FD0BBC,10251,17,18,1,35,47,1797
28129,28129,3F29D0D409D1B6D4E7D2087740FD0BBC,40673,18,23,5,36,48,1848
28134,28134,5A45F00505D10CE6F80144DAC647FEEE,19024,0,6,6,9,45,495
28135,28135,5A45F00505D10CE6F80144DAC647FEEE,12641,10,16,6,10,43,543
28136,28136,5A45F00505D10CE6F80144DAC647FEEE,19024,17,23,6,9,45,495
28149,28149,BF11F158BB981034C1A44258D3F4A9AC,42523,0,8,8,31,47,1597
28150,28150,BF11F158BB981034C1A44258D3F4A9AC,11061,9,11,2,29,48,1498
28151,28151,BF11F158BB981034C1A44258D3F4A9AC,42523,14,18,4,31,47,1597
28152,28152,BF11F158BB981034C1A44258D3F4A9AC,11061,21,22,1,29,48,1498
28170,28170,5DCDEE86AFA2D68FD07F31A3CA76F70F,42801,0,8,8,40,49,2049
28171,28171,5DCDEE86AFA2D68FD07F31A3CA76F70F,11551,10,11,1,39,49,1999
28172,28172,5DCDEE86AFA2D68FD07F31A3CA76F70F,11661,13,21,8,40,49,2049
28176,28176,9B96DAA509FD397123C045520455AB11,13941,9,10,1,41,47,2097
28177,28177,9B96DAA509FD397123C045520455AB11,13111,13,18,5,42,46,2146
28178,28178,9B96DAA509FD397123C045520455AB11,13371,18,19,1,41,47,2097
28190,28190,DD11EC5E596BBBC5A00C9F6952DD9EC0,10281,0,12,12,33,48,1698
28191,28191,DD11EC5E596BBBC5A00C9F6952DD9EC0,42301,14,16,2,36,47,1847
28192,28192,DD11EC5E596BBBC5A00C9F6952DD9EC0,10281,16,21,5,33,48,1698
28199,28199,8964BE3BDB8A882E0820AE09A961E1E9,13101,7,9,2,40,47,2047
28200,28200,8964BE3BDB8A882E0820AE09A961E1E9,40833,11,14,3,41,47,2097
28201,28201,8964BE3BDB8A882E0820AE09A961E1E9,13101,14,22,8,40,47,2047
28206,28206,0F3B9D51ABEBD568D2353EE492F4DCAE,40171,0,16,16,38,48,1948
28207,28207,0F3B9D51ABEBD568D2353EE492F4DCAE,10471,19,22,3,37,48,1898
28208,28208,0F3B9D51ABEBD568D2353EE492F4DCAE,40171,22,23,1,38,48,1948
28228,28228,ED417F95DAB52C7D5E659E5FB8F28A50,12051,0,3,3,20,47,1047
28229,28229,ED417F95DAB52C7D5E659E5FB8F28A50,43751,4,19,15,19,48,998
28230,28230,ED417F95DAB52C7D5E659E5FB8F28A50,12051,20,21,1,20,47,1047
28231,28231,ED417F95DAB52C7D5E659E5FB8F28A50,43751,21,23,2,19,48,998
28232,28232,BDA67F5B71597181E331845AE88C939C,42161,0,7,7,36,47,1847
28233,28233,BDA67F5B71597181E331845AE88C939C,10111,8,10,2,37,47,1897
28234,28234,BDA67F5B71597181E331845AE88C939C,42161,10,15,5,36,47,1847
28235,28235,BDA67F5B71597181E331845AE88C939C,42941,15,21,6,37,47,1897
28250,28250,9C853A4D5C7B5210EB733E5032A36376,11021,0,11,11,36,49,1849
28251,28251,9C853A4D5C7B5210EB733E5032A36376,10281,12,13,1,33,48,1698
28252,28252,9C853A4D5C7B5210EB733E5032A36376,11021,13,19,6,36,49,1849
28265,28265,A1B1493AD1E4959D25E397CB780FB65E,42531,0,6,6,31,45,1595
28266,28266,A1B1493AD1E4959D25E397CB780FB65E,12311,7,8,1,30,44,1544
28267,28267,A1B1493AD1E4959D25E397CB780FB65E,42531,12,19,7,31,45,1595
28268,28268,A1B1493AD1E4959D25E397CB780FB65E,10634,19,20,1,27,45,1395
28281,28281,6D66725D0B9803C07583F5B30C783245,12661,6,7,1,32,45,1645
28282,28282,6D66725D0B9803C07583F5B30C783245,42531,9,11,2,31,45,1595
28283,28283,6D66725D0B9803C07583F5B30C783245,42151,15,19,4,35,45,1795
28284,28284,184C01DF5AF7FEEE2B90AA7395647187,42151,1,10,9,35,45,1795
28285,28285,184C01DF5AF7FEEE2B90AA7395647187,42861,10,11,1,37,44,1894
28286,28286,184C01DF5AF7FEEE2B90AA7395647187,42151,14,16,2,35,45,1795
28287,28287,184C01DF5AF7FEEE2B90AA7395647187,42861,16,18,2,37,44,1894
28293,28293,7D5000772E957DD3A483CE8963A15A13,12121,0,1,1,29,47,1497
28294,28294,7D5000772E957DD3A483CE8963A15A13,42501,4,10,6,28,47,1447
28295,28295,7D5000772E957DD3A483CE8963A15A13,11381,10,12,2,30,47,1547
28296,28296,7D5000772E957DD3A483CE8963A15A13,12121,13,21,8,29,47,1497
28302,28302,C1E8F3774284D6AC368E0B84B6CE4425,13651,0,10,10,30,47,1547
28303,28303,C1E8F3774284D6AC368E0B84B6CE4425,42501,10,15,5,28,47,1447
28304,28304,C1E8F3774284D6AC368E0B84B6CE4425,11381,17,21,4,30,47,1547
28312,28312,9508FAE0B774FCD97D7CFB3C4BD72215,42401,8,13,5,36,47,1847
28313,28313,9508FAE0B774FCD97D7CFB3C4BD72215,10111,15,19,4,37,47,1897
28314,28314,9508FAE0B774FCD97D7CFB3C4BD72215,42301,19,23,4,36,47,1847
28334,28334,68D66AC2F31097852E1113FCAC38B096,12311,0,9,9,30,44,1544
28335,28335,68D66AC2F31097852E1113FCAC38B096,42531,9,11,2,31,45,1595
28336,28336,68D66AC2F31097852E1113FCAC38B096,12311,12,23,11,30,44,1544
28337,28337,C3E732D15F022D9CEC194DCDE873E649,10471,0,12,12,37,48,1898
28338,28338,C3E732D15F022D9CEC194DCDE873E649,11461,13,18,5,37,49,1899
28339,28339,C3E732D15F022D9CEC194DCDE873E649,40171,22,23,1,38,48,1948
28344,28344,A5BD6455D4E4978EA029AC2DE0CED6BF,42011,0,14,14,36,46,1846
28345,28345,A5BD6455D4E4978EA029AC2DE0CED6BF,10901,18,20,2,35,48,1798
28346,28346,A5BD6455D4E4978EA029AC2DE0CED6BF,42011,21,23,2,36,46,1846
28347,28347,780CF605B987CE4335E0B64DFA86ACBF,12514,1,8,7,38,47,1947
28348,28348,780CF605B987CE4335E0B64DFA86ACBF,42511,10,18,8,37,47,1897
28349,28349,780CF605B987CE4335E0B64DFA86ACBF,11461,22,23,1,37,49,1899
28350,28350,21214DF25ABBFE57C13DD19922691751,42351,0,6,6,38,45,1945
28351,28351,21214DF25ABBFE57C13DD19922691751,13911,6,7,1,39,46,1996
28352,28352,21214DF25ABBFE57C13DD19922691751,11261,11,18,7,36,46,1846
28367,28367,0C2847EFE5F93E92ACEB4EA16E4104D9,13411,0,1,1,49,42,2492
28368,28368,0C2847EFE5F93E92ACEB4EA16E4104D9,43951,13,15,2,49,41,2491
28369,28369,0C2847EFE5F93E92ACEB4EA16E4104D9,13411,19,22,3,49,42,2492
28370,28370,11C1E1E71B6DE725F234833E4DE3B8BD,42581,4,14,10,38,48,1948
28371,28371,11C1E1E71B6DE725F234833E4DE3B8BD,11481,14,15,1,41,48,2098
28372,28372,11C1E1E71B6DE725F234833E4DE3B8BD,11801,19,22,3,42,48,2148
28373,28373,BDFA867B40521AA4CCFB04E71D5FA018,10121,0,8,8,36,49,1849
28374,28374,BDFA867B40521AA4CCFB04E71D5FA018,13561,9,10,1,37,49,1899
28375,28375,BDFA867B40521AA4CCFB04E71D5FA018,10121,12,23,11,36,49,1849
28376,28376,CDBCD8EDBA0D5B4AF24E0D1D0E2B188E,12514,0,10,10,38,47,1947
28377,28377,CDBCD8EDBA0D5B4AF24E0D1D0E2B188E,40951,12,14,2,36,49,1849
28378,28378,CDBCD8EDBA0D5B4AF24E0D1D0E2B188E,12514,17,23,6,38,47,1947
28401,28401,84C94B2F533ED609B0C2666E73EA3142,40833,1,11,10,41,47,2097
28402,28402,84C94B2F533ED609B0C2666E73EA3142,11806,13,14,1,41,48,2098
28403,28403,84C94B2F533ED609B0C2666E73EA3142,13271,19,23,4,41,47,2097
28411,28411,6D0799AB0F55190F6E5F774F154A9036,11481,0,6,6,41,48,2098
28412,28412,6D0799AB0F55190F6E5F774F154A9036,13101,6,8,2,40,47,2047
28413,28413,6D0799AB0F55190F6E5F774F154A9036,11801,8,20,12,42,48,2148
28431,28431,39E9477CFB7A739ED25E5621F7D2A965,10821,0,9,9,40,47,2047
28432,28432,39E9477CFB7A739ED25E5621F7D2A965,42301,10,11,1,36,47,1847
28433,28433,39E9477CFB7A739ED25E5621F7D2A965,40697,12,13,1,43,48,2198
28434,28434,39E9477CFB7A739ED25E5621F7D2A965,42301,17,23,6,36,47,1847
28435,28435,85061C43999146706723F4E0700EE955,13911,0,19,19,39,46,1996
28436,28436,85061C43999146706723F4E0700EE955,11261,21,22,1,36,46,1846
28437,28437,85061C43999146706723F4E0700EE955,13911,22,23,1,39,46,1996
28438,28438,7746FF196D36AB589AE8E420B23CDD5F,10841,0,9,9,37,47,1897
28439,28439,7746FF196D36AB589AE8E420B23CDD5F,40211,14,17,3,36,49,1849
28440,28440,7746FF196D36AB589AE8E420B23CDD5F,10841,20,21,1,37,47,1897
28441,28441,E6F8B18996A93B41942201687916F106,11231,0,9,9,37,49,1899
28442,28442,E6F8B18996A93B41942201687916F106,10471,14,15,1,37,48,1898
28443,28443,E6F8B18996A93B41942201687916F106,11231,16,23,7,37,49,1899
28494,28494,19B7F0CF3E3FD886B38254D17C1F93A2,12311,0,7,7,30,44,1544
28495,28495,19B7F0CF3E3FD886B38254D17C1F93A2,10301,7,18,11,31,45,1595
28496,28496,19B7F0CF3E3FD886B38254D17C1F93A2,10351,21,22,1,28,45,1445
28511,28511,E78E0ABBE194ABEE97C2D7DD94378A1C,10121,0,5,5,36,49,1849
28512,28512,E78E0ABBE194ABEE97C2D7DD94378A1C,10281,11,20,9,33,48,1698
28513,28513,E78E0ABBE194ABEE97C2D7DD94378A1C,42801,21,23,2,40,49,2049
28521,28521,BBEB20E4CE09F78FD771E8818046FF01,42583,0,6,6,40,48,2048
28522,28522,BBEB20E4CE09F78FD771E8818046FF01,42271,6,15,9,40,47,2047
28523,28523,BBEB20E4CE09F78FD771E8818046FF01,42221,16,17,1,38,48,1948
28524,28524,BBEB20E4CE09F78FD771E8818046FF01,42583,20,23,3,40,48,2048
28541,28541,2DF13F3C6B51FEAFB9527CE1523C2712,12121,0,10,10,29,47,1497
28542,28542,2DF13F3C6B51FEAFB9527CE1523C2712,11381,10,17,7,30,47,1547
28543,28543,2DF13F3C6B51FEAFB9527CE1523C2712,12121,20,21,1,29,47,1497
28544,28544,2DF13F3C6B51FEAFB9527CE1523C2712,11381,22,23,1,30,47,1547
28554,28554,83605D331BD58EAF678A915FCE0FA0A7,11641,0,11,11,22,49,1149
28555,28555,83605D331BD58EAF678A915FCE0FA0A7,42081,12,13,1,24,49,1249
28556,28556,83605D331BD58EAF678A915FCE0FA0A7,11641,13,23,10,22,49,1149
28557,28557,053AF9D02F27761F1671A0A9A244D378,42291,0,9,9,29,48,1498
28558,28558,053AF9D02F27761F1671A0A9A244D378,11381,13,15,2,30,47,1547
28559,28559,053AF9D02F27761F1671A0A9A244D378,42291,16,22,6,29,48,1498
28560,28560,06724C888D13FBA3C30984CA3D9C3C3A,43391,0,8,8,29,48,1498
28561,28561,06724C888D13FBA3C30984CA3D9C3C3A,10381,8,10,2,31,49,1599
28562,28562,06724C888D13FBA3C30984CA3D9C3C3A,43391,11,22,11,29,48,1498
28568,28568,BDFD62682367460EB805AE59E8FC8892,10691,6,13,7,33,48,1698
28569,28569,BDFD62682367460EB805AE59E8FC8892,13601,15,17,2,34,47,1747
28570,28570,BDFD62682367460EB805AE59E8FC8892,11651,17,19,2,33,47,1697
28571,28571,BDFD62682367460EB805AE59E8FC8892,11131,21,23,2,33,48,1698
28575,28575,9D2F8B673CF5A851F245B3DD21FD08F4,10111,0,7,7,37,47,1897
28576,28576,9D2F8B673CF5A851F245B3DD21FD08F4,42161,10,12,2,36,47,1847
28577,28577,9D2F8B673CF5A851F245B3DD21FD08F4,10111,12,23,11,37,47,1897
28601,28601,0CE1530259EA66797A9FEEF237D2664E,42861,0,13,13,37,44,1894
28602,28602,0CE1530259EA66797A9FEEF237D2664E,11261,15,20,5,36,46,1846
28603,28603,0CE1530259EA66797A9FEEF237D2664E,42861,21,23,2,37,44,1894
28609,28609,BD70351A89F443C3905BBEB2477E8C12,42961,0,7,7,35,49,1799
28610,28610,BD70351A89F443C3905BBEB2477E8C12,42511,8,9,1,37,47,1897
28611,28611,BD70351A89F443C3905BBEB2477E8C12,12083,11,23,12,36,49,1849
28612,28612,0A753885BE5CDC6D1CF1B7B35F1C199C,42523,0,19,19,31,47,1597
28613,28613,0A753885BE5CDC6D1CF1B7B35F1C199C,10295,21,22,1,30,47,1547
28614,28614,0A753885BE5CDC6D1CF1B7B35F1C199C,42523,22,23,1,31,47,1597
28620,28620,923AB5DC5205430EA74CC2C460DE6E71,11021,0,4,4,36,49,1849
28621,28621,923AB5DC5205430EA74CC2C460DE6E71,42961,5,15,10,35,49,1799
28622,28622,923AB5DC5205430EA74CC2C460DE6E71,10107,19,21,2,38,49,1949
28623,28623,C8EB41C6B7152CD714709DA811B3B245,10681,0,8,8,30,48,1548
28624,28624,C8EB41C6B7152CD714709DA811B3B245,40094,8,22,14,29,48,1498
28625,28625,C8EB41C6B7152CD714709DA811B3B245,10681,22,23,1,30,48,1548
28636,28636,583602182C31C8E2D985404EA5592339,12641,4,5,1,10,43,543
28637,28637,583602182C31C8E2D985404EA5592339,12921,6,11,5,9,41,491
28638,28638,583602182C31C8E2D985404EA5592339,12641,12,13,1,10,43,543
28639,28639,583602182C31C8E2D985404EA5592339,12921,16,20,4,9,41,491
28645,28645,10D6E07CB2A92B35A37820638A6643C4,11771,0,3,3,39,49,1999
28646,28646,10D6E07CB2A92B35A37820638A6643C4,12514,6,18,12,38,47,1947
28647,28647,10D6E07CB2A92B35A37820638A6643C4,11791,20,22,2,38,49,1949
28648,28648,96056246DD9856C2DDE7E703B0D16D68,11381,0,13,13,30,47,1547
28649,28649,96056246DD9856C2DDE7E703B0D16D68,10341,13,15,2,31,47,1597
28650,28650,96056246DD9856C2DDE7E703B0D16D68,11381,16,18,2,30,47,1547
28651,28651,96056246DD9856C2DDE7E703B0D16D68,42523,20,22,2,31,47,1597
28656,28656,76F6239B0D42D641886D22006F826F8A,42221,2,10,8,38,48,1948
28657,28657,76F6239B0D42D641886D22006F826F8A,11074,11,12,1,37,47,1897
28658,28658,76F6239B0D42D641886D22006F826F8A,42221,16,17,1,38,48,1948
28659,28659,76F6239B0D42D641886D22006F826F8A,12514,20,23,3,38,47,1947
28660,28660,B9E127195A4DFA1F988A0F90827556AB,13951,0,9,9,47,45,2395
28661,28661,B9E127195A4DFA1F988A0F90827556AB,42461,10,12,2,45,47,2297
28662,28662,B9E127195A4DFA1F988A0F90827556AB,13951,12,23,11,47,45,2395
28666,28666,94A3712E9C7F704FC691727747B03786,12391,0,11,11,36,49,1849
28667,28667,94A3712E9C7F704FC691727747B03786,10221,14,17,3,34,49,1749
28668,28668,94A3712E9C7F704FC691727747B03786,42981,17,18,1,36,49,1849
28669,28669,94A3712E9C7F704FC691727747B03786,10221,19,23,4,34,49,1749
28670,28670,43DBEEA61839592A95FC32BC8064AB85,12921,0,5,5,9,41,491
28671,28671,43DBEEA61839592A95FC32BC8064AB85,12641,9,12,3,10,43,543
28672,28672,43DBEEA61839592A95FC32BC8064AB85,12921,12,23,11,9,41,491
28679,28679,4EABE655BE26B3EDCCD7B6B2C89F187F,10161,0,10,10,35,49,1799
28680,28680,4EABE655BE26B3EDCCD7B6B2C89F187F,11231,13,14,1,37,49,1899
28681,28681,4EABE655BE26B3EDCCD7B6B2C89F187F,42981,15,18,3,36,49,1849
28696,28696,AFC682DA7B2C15A5BBB72506964CC56C,13941,0,16,16,41,47,2097
28697,28697,AFC682DA7B2C15A5BBB72506964CC56C,11001,19,20,1,42,47,2147
28698,28698,AFC682DA7B2C15A5BBB72506964CC56C,13941,20,21,1,41,47,2097
28699,28699,DE3E54BB176520C8599DB39C6B8B34A3,43951,0,4,4,49,41,2491
28700,28700,DE3E54BB176520C8599DB39C6B8B34A3,13411,4,7,3,49,42,2492
28701,28701,DE3E54BB176520C8599DB39C6B8B34A3,43951,9,10,1,49,41,2491
28702,28702,DE3E54BB176520C8599DB39C6B8B34A3,13491,11,23,12,48,39,2439
28708,28708,8868A050B2675F1D16135ACF47FD7E3C,12641,0,5,5,10,43,543
28709,28709,8868A050B2675F1D16135ACF47FD7E3C,19111,7,17,10,9,45,495
28710,28710,8868A050B2675F1D16135ACF47FD7E3C,19114,19,20,1,7,43,393
28711,28711,D454F61AD8B5A1CBE1E15CE597E2F528,12083,0,1,1,36,49,1849
28712,28712,D454F61AD8B5A1CBE1E15CE597E2F528,11491,2,7,5,36,47,1847
28713,28713,D454F61AD8B5A1CBE1E15CE597E2F528,11231,8,20,12,37,49,1899
28714,28714,EAC1D4A2CA6BC033BCE82C152098CC16,11914,0,1,1,37,48,1898
28715,28715,EAC1D4A2CA6BC033BCE82C152098CC16,42581,3,4,1,38,48,1948
28716,28716,EAC1D4A2CA6BC033BCE82C152098CC16,11914,7,23,16,37,48,1898
28730,28730,51CA45CA2AACCC83748D6918E9F511C1,42371,3,7,4,34,46,1746
28731,28731,51CA45CA2AACCC83748D6918E9F511C1,42151,8,11,3,35,45,1795
28732,28732,51CA45CA2AACCC83748D6918E9F511C1,12661,12,14,2,32,45,1645
28733,28733,51CA45CA2AACCC83748D6918E9F511C1,42151,16,18,2,35,45,1795
28759,28759,A769D23649FC88977888E37E432489C6,11261,0,1,1,36,46,1846
28760,28760,A769D23649FC88977888E37E432489C6,13911,2,3,1,39,46,1996
28761,28761,A769D23649FC88977888E37E432489C6,11261,4,20,16,36,46,1846
28766,28766,670481A6A6FDB5646DF53C0039FD1C41,12121,0,9,9,29,47,1497
28767,28767,670481A6A6FDB5646DF53C0039FD1C41,11061,11,12,1,29,48,1498
28768,28768,670481A6A6FDB5646DF53C0039FD1C41,42021,13,18,5,33,47,1697
28769,28769,670481A6A6FDB5646DF53C0039FD1C41,12121,19,20,1,29,47,1497
28776,28776,C42FD7C548D357EF753CE9F17CAC9C4B,43061,3,4,1,43,46,2196
28777,28777,C42FD7C548D357EF753CE9F17CAC9C4B,13341,8,10,2,44,45,2245
28778,28778,C42FD7C548D357EF753CE9F17CAC9C4B,43061,12,16,4,43,46,2196
28779,28779,C42FD7C548D357EF753CE9F17CAC9C4B,13341,18,19,1,44,45,2245
28796,28796,F40CCBE0F53CE8C39AAE5C5C821E8F3D,40691,0,7,7,42,48,2148
28797,28797,F40CCBE0F53CE8C39AAE5C5C821E8F3D,11701,8,17,9,43,48,2198
28798,28798,F40CCBE0F53CE8C39AAE5C5C821E8F3D,10421,18,20,2,41,48,2098
28799,28799,F40CCBE0F53CE8C39AAE5C5C821E8F3D,42461,21,22,1,45,47,2297
28800,28800,D429753EEB35077FBB0F7FD7B24671DA,42381,1,4,3,39,41,1991
28801,28801,D429753EEB35077FBB0F7FD7B24671DA,43451,6,11,5,37,40,1890
28802,28802,D429753EEB35077FBB0F7FD7B24671DA,13071,12,17,5,41,41,2091
28803,28803,D429753EEB35077FBB0F7FD7B24671DA,43451,17,18,1,37,40,1890
28816,28816,4EC8D8BFDD4FC00C53BDA72AE182E742,42511,0,8,8,37,47,1897
28817,28817,4EC8D8BFDD4FC00C53BDA72AE182E742,11351,12,13,1,36,48,1848
28818,28818,4EC8D8BFDD4FC00C53BDA72AE182E742,42511,16,18,2,37,47,1897
28839,28839,3624837A8CEE8FA380EBBA166C2E7021,42091,0,11,11,43,46,2196
28840,28840,3624837A8CEE8FA380EBBA166C2E7021,13341,14,17,3,44,45,2245
28841,28841,3624837A8CEE8FA380EBBA166C2E7021,42091,18,23,5,43,46,2196
28848,28848,039720C5318D39E34BBB18DF8027F133,42581,1,2,1,38,48,1948
28849,28849,039720C5318D39E34BBB18DF8027F133,11271,6,18,12,37,48,1898
28850,28850,039720C5318D39E34BBB18DF8027F133,42581,18,23,5,38,48,1948
28851,28851,05286C4B5017A260B39768783F7D4555,42581,0,10,10,38,48,1948
28852,28852,05286C4B5017A260B39768783F7D4555,11914,12,13,1,37,48,1898
28853,28853,05286C4B5017A260B39768783F7D4555,40171,16,22,6,38,48,1948
28854,28854,E3950B228FF57BC4F70CD2EC3D90B5FF,11941,0,8,8,37,46,1896
28855,28855,E3950B228FF57BC4F70CD2EC3D90B5FF,42151,11,15,4,35,45,1795
28856,28856,E3950B228FF57BC4F70CD2EC3D90B5FF,13711,18,23,5,38,46,1946
28857,28857,B6B9FD86337BD93E048A74A5E56BF693,10111,0,8,8,37,47,1897
28858,28858,B6B9FD86337BD93E048A74A5E56BF693,40951,9,17,8,36,49,1849
28859,28859,B6B9FD86337BD93E048A74A5E56BF693,11751,17,20,3,35,48,1798
28860,28860,EC5826DDC7A3A0934F77BEC54C5B1C99,42531,0,6,6,31,45,1595
28861,28861,EC5826DDC7A3A0934F77BEC54C5B1C99,12311,10,11,1,30,44,1544
28862,28862,EC5826DDC7A3A0934F77BEC54C5B1C99,42531,12,23,11,31,45,1595
28863,28863,7A7AEC35AE07D4110F6099DB218EF80C,19441,0,2,2,8,46,446
28864,28864,7A7AEC35AE07D4110F6099DB218EF80C,19021,3,17,14,10,45,545
28865,28865,7A7AEC35AE07D4110F6099DB218EF80C,19114,18,20,2,7,43,393
28866,28866,4BCECD3225E1896D75A2EFDCE2845317,11061,5,6,1,29,48,1498
28867,28867,4BCECD3225E1896D75A2EFDCE2845317,42071,8,16,8,31,49,1599
28868,28868,4BCECD3225E1896D75A2EFDCE2845317,11151,18,20,2,30,48,1548
28869,28869,D3F6CC79419CB8E677F2F17C3DF072CD,13121,0,7,7,38,46,1946
28870,28870,D3F6CC79419CB8E677F2F17C3DF072CD,13331,8,17,9,38,47,1947
28871,28871,D3F6CC79419CB8E677F2F17C3DF072CD,13121,19,22,3,38,46,1946
28876,28876,58FF60972C1637520443DC5766A2AB67,13411,0,6,6,49,42,2492
28877,28877,58FF60972C1637520443DC5766A2AB67,43951,6,17,11,49,41,2491
28878,28878,58FF60972C1637520443DC5766A2AB67,13411,20,23,3,49,42,2492
28885,28885,17BFCEDD973B29E8302E2E7670AFE303,10471,1,16,15,37,48,1898
28886,28886,17BFCEDD973B29E8302E2E7670AFE303,40171,18,19,1,38,48,1948
28887,28887,17BFCEDD973B29E8302E2E7670AFE303,10471,22,23,1,37,48,1898
28888,28888,B377B1A009BB64894719A8DF0AC3F76E,10901,1,2,1,35,48,1798
28889,28889,B377B1A009BB64894719A8DF0AC3F76E,12083,2,4,2,36,49,1849
28890,28890,B377B1A009BB64894719A8DF0AC3F76E,10471,5,12,7,37,48,1898
28891,28891,B377B1A009BB64894719A8DF0AC3F76E,11231,16,22,6,37,49,1899
28892,28892,28AE6FF44E8686DC354D2E3DF7700FCC,42461,0,14,14,45,47,2297
28893,28893,28AE6FF44E8686DC354D2E3DF7700FCC,42321,14,17,3,43,47,2197
28894,28894,28AE6FF44E8686DC354D2E3DF7700FCC,11701,21,22,1,43,48,2198
28902,28902,D3440D1508561AD99BDA68DC5ADE94F2,42471,0,7,7,35,49,1799
28903,28903,D3440D1508561AD99BDA68DC5ADE94F2,13731,7,8,1,33,49,1699
28904,28904,D3440D1508561AD99BDA68DC5ADE94F2,11541,9,22,13,35,49,1799
28911,28911,9C35C609BEEB7023F559DA7824DEFA84,11061,1,16,15,29,48,1498
28912,28912,9C35C609BEEB7023F559DA7824DEFA84,40445,18,20,2,30,48,1548
28913,28913,9C35C609BEEB7023F559DA7824DEFA84,11061,20,21,1,29,48,1498
28923,28923,AF5140B00273B874DD47CFF400890B83,43951,3,10,7,49,41,2491
28924,28924,AF5140B00273B874DD47CFF400890B83,13411,10,11,1,49,42,2492
28925,28925,AF5140B00273B874DD47CFF400890B83,43951,12,18,6,49,41,2491
28926,28926,25D7A02E36F2606193AA6545F1D088D2,19441,0,7,7,8,46,446
28927,28927,25D7A02E36F2606193AA6545F1D088D2,19901,8,10,2,7,44,394
28928,28928,25D7A02E36F2606193AA6545F1D088D2,19441,13,23,10,8,46,446
28929,28929,FD5EF28EAD4BB7B6215FEE28B08DAD3E,12311,7,11,4,30,44,1544
28930,28930,FD5EF28EAD4BB7B6215FEE28B08DAD3E,12661,12,13,1,32,45,1645
28931,28931,FD5EF28EAD4BB7B6215FEE28B08DAD3E,12311,14,15,1,30,44,1544
28932,28932,FD5EF28EAD4BB7B6215FEE28B08DAD3E,12661,18,23,5,32,45,1645
28933,28933,835FBF8C6527564BD266FF99E849E600,11914,2,3,1,37,48,1898
28934,28934,835FBF8C6527564BD266FF99E849E600,40171,6,12,6,38,48,1948
28935,28935,835FBF8C6527564BD266FF99E849E600,10471,13,23,10,37,48,1898
28941,28941,CA846E977C574581372BF484E6107101,11074,0,7,7,37,47,1897
28942,28942,CA846E977C574581372BF484E6107101,13331,7,8,1,38,47,1947
28943,28943,CA846E977C574581372BF484E6107101,10841,9,18,9,37,47,1897
28947,28947,EC1141E725A7198CD46488DFBB2FD884,12311,5,7,2,30,44,1544
28948,28948,EC1141E725A7198CD46488DFBB2FD884,42531,7,9,2,31,45,1595
28949,28949,EC1141E725A7198CD46488DFBB2FD884,12311,13,21,8,30,44,1544
28956,28956,2FC158799FF19F821FBD3DC4EFE863DB,43101,5,8,3,46,40,2340
28957,28957,2FC158799FF19F821FBD3DC4EFE863DB,13551,8,13,5,45,38,2288
28958,28958,2FC158799FF19F821FBD3DC4EFE863DB,43101,17,23,6,46,40,2340
28959,28959,A91B4F81A1EC50DE337F87C118C00C5D,11461,0,7,7,37,49,1899
28960,28960,A91B4F81A1EC50DE337F87C118C00C5D,43281,10,11,1,37,48,1898
28961,28961,A91B4F81A1EC50DE337F87C118C00C5D,11231,11,23,12,37,49,1899
28975,28975,1A405C5DE99A88589837D5F72AD75DAF,11331,0,6,6,37,48,1898
28976,28976,1A405C5DE99A88589837D5F72AD75DAF,43731,14,17,3,34,47,1747
28977,28977,1A405C5DE99A88589837D5F72AD75DAF,11331,18,23,5,37,48,1898
28978,28978,872EA7042E221A40D168D3255557BABA,43761,2,6,4,32,47,1647
28979,28979,872EA7042E221A40D168D3255557BABA,42521,9,10,1,31,47,1597
28980,28980,872EA7042E221A40D168D3255557BABA,43761,13,18,5,32,47,1647
28981,28981,872EA7042E221A40D168D3255557BABA,42521,19,21,2,31,47,1597
28989,28989,8D46B95B525743F44D3D955B4D34230E,13791,0,8,8,42,47,2147
28990,28990,8D46B95B525743F44D3D955B4D34230E,13941,10,11,1,41,47,2097
28991,28991,8D46B95B525743F44D3D955B4D34230E,43061,15,18,3,43,46,2196
29013,29013,B1BD4731B0ECBC442D0F3066A3342E92,42071,1,5,4,31,49,1599
29014,29014,B1BD4731B0ECBC442D0F3066A3342E92,10951,6,8,2,29,48,1498
29015,29015,B1BD4731B0ECBC442D0F3066A3342E92,10381,8,19,11,31,49,1599
29016,29016,0447A6B040BE8662ECE5520F8BE6530D,13101,0,16,16,40,47,2047
29017,29017,0447A6B040BE8662ECE5520F8BE6530D,11801,16,18,2,42,48,2148
29018,29018,0447A6B040BE8662ECE5520F8BE6530D,10421,19,23,4,41,48,2098
29019,29019,B0CA59461CE535DA6C80DC6682EBEAFB,11806,0,6,6,41,48,2098
29020,29020,B0CA59461CE535DA6C80DC6682EBEAFB,42271,10,12,2,40,47,2047
29021,29021,B0CA59461CE535DA6C80DC6682EBEAFB,11806,13,14,1,41,48,2098
29022,29022,B0CA59461CE535DA6C80DC6682EBEAFB,42271,14,19,5,40,47,2047
29023,29023,285C0FF579A1296077AA1E724FE2D65D,10121,0,13,13,36,49,1849
29024,29024,285C0FF579A1296077AA1E724FE2D65D,11231,13,15,2,37,49,1899
29025,29025,285C0FF579A1296077AA1E724FE2D65D,10121,17,19,2,36,49,1849
29030,29030,FE289D23B7E617AD349A76499E85C77F,43761,3,4,1,32,47,1647
29031,29031,FE289D23B7E617AD349A76499E85C77F,13601,4,11,7,34,47,1747
29032,29032,FE289D23B7E617AD349A76499E85C77F,42021,11,23,12,33,47,1697
29033,29033,590DAC63AAEA804ADBFB882BD29A8CA5,13651,1,16,15,30,47,1547
29034,29034,590DAC63AAEA804ADBFB882BD29A8CA5,42021,18,19,1,33,47,1697
29035,29035,590DAC63AAEA804ADBFB882BD29A8CA5,13651,21,22,1,30,47,1547
29036,29036,E6B1F111F7A3D9AB5FA537FE2A3A8B77,42371,0,14,14,34,46,1746
29037,29037,E6B1F111F7A3D9AB5FA537FE2A3A8B77,42791,14,15,1,35,45,1795
29038,29038,E6B1F111F7A3D9AB5FA537FE2A3A8B77,42371,17,19,2,34,46,1746
29050,29050,63A1194DA67A916294F825B4249AD293,42301,0,6,6,36,47,1847
29051,29051,63A1194DA67A916294F825B4249AD293,11261,9,17,8,36,46,1846
29052,29052,63A1194DA67A916294F825B4249AD293,40891,21,22,1,37,47,1897
29053,29053,4B18376F646A8C5898CD3325A7616D50,10681,0,4,4,30,48,1548
29054,29054,4B18376F646A8C5898CD3325A7616D50,11061,8,10,2,29,48,1498
29055,29055,4B18376F646A8C5898CD3325A7616D50,43971,11,14,3,30,48,1548
29056,29056,4B18376F646A8C5898CD3325A7616D50,11381,17,20,3,30,47,1547
29066,29066,315AEAD65875C50C1315909C70451FCD,13371,3,5,2,41,47,2097
29067,29067,315AEAD65875C50C1315909C70451FCD,13011,9,11,2,39,47,1997
29068,29068,315AEAD65875C50C1315909C70451FCD,13371,12,15,3,41,47,2097
29069,29069,315AEAD65875C50C1315909C70451FCD,42031,21,22,1,40,46,2046
29078,29078,14909CB01CC7902DACA46E64F89B4A03,42864,4,8,4,38,44,1944
29079,29079,14909CB01CC7902DACA46E64F89B4A03,42231,9,14,5,37,46,1896
29080,29080,14909CB01CC7902DACA46E64F89B4A03,13461,14,16,2,39,44,1994
29081,29081,14909CB01CC7902DACA46E64F89B4A03,42864,18,22,4,38,44,1944
29082,29082,7F73A642AA11134206C46BA15C785E40,42521,7,10,3,31,47,1597
29083,29083,7F73A642AA11134206C46BA15C785E40,13651,10,12,2,30,47,1547
29084,29084,7F73A642AA11134206C46BA15C785E40,42521,13,15,2,31,47,1597
29085,29085,7F73A642AA11134206C46BA15C785E40,13651,18,19,1,30,47,1547
29086,29086,CD62F89A81CF58E2979469073621225B,10491,0,6,6,33,48,1698
29087,29087,CD62F89A81CF58E2979469073621225B,11561,7,15,8,32,49,1649
29088,29088,CD62F89A81CF58E2979469073621225B,43731,16,17,1,34,47,1747
29089,29089,CD62F89A81CF58E2979469073621225B,10881,19,23,4,34,48,1748
29090,29090,56380B9BCFA6857A7D3E4BBFC0E5BBBD,12514,0,14,14,38,47,1947
29091,29091,56380B9BCFA6857A7D3E4BBFC0E5BBBD,12841,14,15,1,37,47,1897
29092,29092,56380B9BCFA6857A7D3E4BBFC0E5BBBD,11911,19,20,1,37,48,1898
29093,29093,C6B20AF59FCE7811AD359D515A06A5AA,42161,0,16,16,36,47,1847
29094,29094,C6B20AF59FCE7811AD359D515A06A5AA,10251,16,17,1,35,47,1797
29095,29095,C6B20AF59FCE7811AD359D515A06A5AA,42161,22,23,1,36,47,1847
29096,29096,A1F76E9AE160B1A2577BA1E3948B2B29,42864,0,6,6,38,44,1944
29097,29097,A1F76E9AE160B1A2577BA1E3948B2B29,11261,6,10,4,36,46,1846
29098,29098,A1F76E9AE160B1A2577BA1E3948B2B29,42864,11,23,12,38,44,1944
29102,29102,FC707C73D6614611D82A13C2F325D332,42511,5,7,2,37,47,1897
29103,29103,FC707C73D6614611D82A13C2F325D332,11021,9,10,1,36,49,1849
29104,29104,FC707C73D6614611D82A13C2F325D332,42471,11,15,4,35,49,1799
29105,29105,FC707C73D6614611D82A13C2F325D332,11021,18,23,5,36,49,1849
29106,29106,3FDEC67AEAECF97FFF0C863D42676BE7,11271,0,2,2,37,48,1898
29107,29107,3FDEC67AEAECF97FFF0C863D42676BE7,11551,2,12,10,39,49,1999
29108,29108,3FDEC67AEAECF97FFF0C863D42676BE7,11231,20,23,3,37,49,1899
29109,29109,4590234855D494BC2B4471EDE9565EEB,11551,2,13,11,39,49,1999
29110,29110,4590234855D494BC2B4471EDE9565EEB,11074,15,19,4,37,47,1897
29111,29111,4590234855D494BC2B4471EDE9565EEB,42031,19,22,3,40,46,2046
29112,29112,4DAFB85C918047225CA596E4134A09D3,42141,0,5,5,32,47,1647
29113,29113,4DAFB85C918047225CA596E4134A09D3,13651,7,18,11,30,47,1547
29114,29114,4DAFB85C918047225CA596E4134A09D3,42141,20,23,3,32,47,1647
29118,29118,0CB59E8D868A989F35AA087C24245C30,13231,0,9,9,39,46,1996
29119,29119,0CB59E8D868A989F35AA087C24245C30,11781,14,15,1,38,49,1949
29120,29120,0CB59E8D868A989F35AA087C24245C30,10331,18,22,4,39,46,1996
29121,29121,54E9147B0F88496112EA8083546467E6,12661,0,16,16,32,45,1645
29122,29122,54E9147B0F88496112EA8083546467E6,12311,16,18,2,30,44,1544
29123,29123,54E9147B0F88496112EA8083546467E6,40381,20,21,1,32,46,1646
29128,29128,C26F0AB1B8AD896B177DE30E7C0A729F,11381,0,5,5,30,47,1547
29129,29129,C26F0AB1B8AD896B177DE30E7C0A729F,11061,5,18,13,29,48,1498
29130,29130,C26F0AB1B8AD896B177DE30E7C0A729F,11381,18,21,3,30,47,1547
29131,29131,C26F0AB1B8AD896B177DE30E7C0A729F,11061,21,23,2,29,48,1498
29132,29132,A6FB8806348882E3287150AAB70E5425,11161,0,4,4,32,48,1648
29133,29133,A6FB8806348882E3287150AAB70E5425,43761,5,7,2,32,47,1647
29134,29134,A6FB8806348882E3287150AAB70E5425,11161,12,13,1,32,48,1648
29135,29135,A6FB8806348882E3287150AAB70E5425,43761,18,23,5,32,47,1647
29136,29136,2DA3C1BC11D2C4E558F39E9372514315,42581,1,4,3,38,48,1948
29137,29137,2DA3C1BC11D2C4E558F39E9372514315,42271,4,17,13,40,47,2047
29138,29138,2DA3C1BC11D2C4E558F39E9372514315,43481,19,23,4,39,48,1998
29155,29155,2CAEA5E29EC045ABED8FBD60EF3344BD,13961,1,15,14,42,48,2148
29156,29156,2CAEA5E29EC045ABED8FBD60EF3344BD,11901,18,20,2,42,49,2149
29157,29157,2CAEA5E29EC045ABED8FBD60EF3344BD,42051,20,23,3,42,48,2148
29158,29158,1BCA8F195CED1A69C9ABE190E0303E0A,19114,0,17,17,7,43,393
29159,29159,1BCA8F195CED1A69C9ABE190E0303E0A,19111,17,20,3,9,45,495
29160,29160,1BCA8F195CED1A69C9ABE190E0303E0A,12641,21,22,1,10,43,543
29164,29164,12CF5F0E019282F2BF2076B3C77B6607,42041,1,3,2,10,47,547
29165,29165,12CF5F0E019282F2BF2076B3C77B6607,19441,4,7,3,8,46,446
29166,29166,12CF5F0E019282F2BF2076B3C77B6607,42041,12,13,1,10,47,547
29167,29167,12CF5F0E019282F2BF2076B3C77B6607,19441,14,23,9,8,46,446
29175,29175,0AD8838435D12A1009D3BADE4EAE690D,10951,0,5,5,29,48,1498
29176,29176,0AD8838435D12A1009D3BADE4EAE690D,11381,7,16,9,30,47,1547
29177,29177,0AD8838435D12A1009D3BADE4EAE690D,10951,16,21,5,29,48,1498
29178,29178,0AD8838435D12A1009D3BADE4EAE690D,11381,21,23,2,30,47,1547
29188,29188,A71AF189763CBF3E45D468B893870CE7,10901,0,9,9,35,48,1798
29189,29189,A71AF189763CBF3E45D468B893870CE7,40951,13,14,1,36,49,1849
29190,29190,A71AF189763CBF3E45D468B893870CE7,10901,18,23,5,35,48,1798
29197,29197,55536669E97AF41ACDE427113BB85731,10691,0,5,5,33,48,1698
29198,29198,55536669E97AF41ACDE427113BB85731,11861,7,18,11,32,47,1647
29199,29199,55536669E97AF41ACDE427113BB85731,10691,19,23,4,33,48,1698
29220,29220,0CEC3D7EB4E938500D3BE15F068C3654,13121,2,9,7,38,46,1946
29221,29221,0CEC3D7EB4E938500D3BE15F068C3654,42511,11,13,2,37,47,1897
29222,29222,0CEC3D7EB4E938500D3BE15F068C3654,13121,13,15,2,38,46,1946
29223,29223,0CEC3D7EB4E938500D3BE15F068C3654,42511,15,18,3,37,47,1897
29232,29232,CED2E140B216F950F7D7F7935269042E,11541,0,18,18,35,49,1799
29233,29233,CED2E140B216F950F7D7F7935269042E,10107,18,21,3,38,49,1949
29234,29234,CED2E140B216F950F7D7F7935269042E,40241,22,23,1,35,49,1799
29254,29254,C27CAD921E0A90627C5337FD9A33D6C8,10721,0,6,6,31,48,1598
29255,29255,C27CAD921E0A90627C5337FD9A33D6C8,11151,7,8,1,30,48,1548
29256,29256,C27CAD921E0A90627C5337FD9A33D6C8,11875,11,13,2,30,46,1546
29257,29257,C27CAD921E0A90627C5337FD9A33D6C8,11861,15,19,4,32,47,1647
29261,29261,3D0F2BCCE75D465843155D0427A87610,42271,0,1,1,40,47,2047
29262,29262,3D0F2BCCE75D465843155D0427A87610,11806,1,14,13,41,48,2098
29263,29263,3D0F2BCCE75D465843155D0427A87610,42271,17,19,2,40,47,2047
29264,29264,3D0F2BCCE75D465843155D0427A87610,11806,22,23,1,41,48,2098
29265,29265,C56E447B643642E5A3B3F78B996BE366,11351,7,9,2,36,48,1848
29266,29266,C56E447B643642E5A3B3F78B996BE366,42921,9,17,8,33,47,1697
29267,29267,C56E447B643642E5A3B3F78B996BE366,10281,19,20,1,33,48,1698
29268,29268,2337FC404415B660A54C760E95DFCC85,10811,0,5,5,38,46,1946
29269,29269,2337FC404415B660A54C760E95DFCC85,13911,5,18,13,39,46,1996
29270,29270,2337FC404415B660A54C760E95DFCC85,10811,20,22,2,38,46,1946
29271,29271,59A6045EA5A9833FEEF7C5ADED10F457,13561,0,8,8,37,49,1899
29272,29272,59A6045EA5A9833FEEF7C5ADED10F457,11074,9,12,3,37,47,1897
29273,29273,59A6045EA5A9833FEEF7C5ADED10F457,12021,16,23,7,37,49,1899
29293,29293,86877F32D6D32D1728C272FD8E7855F4,10281,0,7,7,33,48,1698
29294,29294,86877F32D6D32D1728C272FD8E7855F4,11861,7,14,7,32,47,1647
29295,29295,86877F32D6D32D1728C272FD8E7855F4,42021,15,16,1,33,47,1697
29296,29296,86877F32D6D32D1728C272FD8E7855F4,11861,17,23,6,32,47,1647
29317,29317,1788FF83230593384DFEF88881720D90,13551,0,6,6,45,38,2288
29318,29318,1788FF83230593384DFEF88881720D90,43101,6,15,9,46,40,2340
29319,29319,1788FF83230593384DFEF88881720D90,13551,15,17,2,45,38,2288
29320,29320,1788FF83230593384DFEF88881720D90,43101,17,19,2,46,40,2340
29337,29337,F0BC1521C378208DCF32C7BF71132055,11011,0,8,8,39,49,1999
29338,29338,F0BC1521C378208DCF32C7BF71132055,11291,12,14,2,40,49,2049
29339,29339,F0BC1521C378208DCF32C7BF71132055,11011,18,23,5,39,49,1999
29343,29343,ED8D8F005EB8203284148B54A4E62E74,42141,3,10,7,32,47,1647
29344,29344,ED8D8F005EB8203284148B54A4E62E74,12161,13,14,1,32,46,1646
29345,29345,ED8D8F005EB8203284148B54A4E62E74,40611,19,20,1,35,47,1797
29346,29346,C328A2915A4792A71AC58E7C60675781,42581,8,9,1,38,48,1948
29347,29347,C328A2915A4792A71AC58E7C60675781,11914,10,12,2,37,48,1898
29348,29348,C328A2915A4792A71AC58E7C60675781,42581,15,16,1,38,48,1948
29349,29349,C328A2915A4792A71AC58E7C60675781,11914,19,20,1,37,48,1898
29350,29350,1EB6584C52EFA6B9ABE490B65662DE3E,10251,9,10,1,35,47,1797
29351,29351,1EB6584C52EFA6B9ABE490B65662DE3E,11074,10,12,2,37,47,1897
29352,29352,1EB6584C52EFA6B9ABE490B65662DE3E,42401,13,18,5,36,47,1847
29358,29358,227CF90E190A804F43263E2E6F09CFEC,10681,0,9,9,30,48,1548
29359,29359,227CF90E190A804F43263E2E6F09CFEC,11061,10,18,8,29,48,1498
29360,29360,227CF90E190A804F43263E2E6F09CFEC,10681,18,21,3,30,48,1548
29375,29375,30C49EE7A31FEEE7EEC894E81C72E143,43181,3,5,2,39,48,1998
29376,29376,30C49EE7A31FEEE7EEC894E81C72E143,42581,7,8,1,38,48,1948
29377,29377,30C49EE7A31FEEE7EEC894E81C72E143,11914,9,15,6,37,48,1898
29378,29378,30C49EE7A31FEEE7EEC894E81C72E143,40171,20,21,1,38,48,1948
29382,29382,02EE2A9621F66BD6F8785DE528B34698,11151,0,6,6,30,48,1548
29383,29383,02EE2A9621F66BD6F8785DE528B34698,11061,8,13,5,29,48,1498
29384,29384,02EE2A9621F66BD6F8785DE528B34698,11151,15,16,1,30,48,1548
29385,29385,02EE2A9621F66BD6F8785DE528B34698,11061,16,20,4,29,48,1498
29391,29391,7B232F64965638DDE8171577AC9EEAD7,42871,0,10,10,30,45,1545
29392,29392,7B232F64965638DDE8171577AC9EEAD7,11871,14,15,1,29,46,1496
29393,29393,7B232F64965638DDE8171577AC9EEAD7,42871,16,19,3,30,45,1545
29404,29404,47C1473BA4462B22BD05E79B53CFA190,42041,0,1,1,10,47,547
29405,29405,47C1473BA4462B22BD05E79B53CFA190,19441,2,4,2,8,46,446
29406,29406,47C1473BA4462B22BD05E79B53CFA190,42041,19,23,4,10,47,547
29413,29413,918239D4EE1CD24F89734D8227B4B571,42161,0,12,12,36,47,1847
29414,29414,918239D4EE1CD24F89734D8227B4B571,12021,13,19,6,37,49,1899
29415,29415,918239D4EE1CD24F89734D8227B4B571,42161,21,23,2,36,47,1847
29426,29426,A5918B01A4D813C237D11A681347796F,12611,1,7,6,41,29,2079
29427,29427,A5918B01A4D813C237D11A681347796F,13361,8,13,5,42,31,2131
29428,29428,A5918B01A4D813C237D11A681347796F,12611,17,19,2,41,29,2079
29429,29429,AF04DCE8D90457C614594537B338C609,10292,0,18,18,30,47,1547
29430,29430,AF04DCE8D90457C614594537B338C609,42491,18,21,3,32,46,1646
29431,29431,AF04DCE8D90457C614594537B338C609,13651,22,23,1,30,47,1547
29435,29435,7B27DF400F344F6F46338A9F907AAD49,19021,1,6,5,10,45,545
29436,29436,7B27DF400F344F6F46338A9F907AAD49,12641,9,18,9,10,43,543
29437,29437,7B27DF400F344F6F46338A9F907AAD49,19021,20,23,3,10,45,545
29452,29452,6E3A482A59CE9925DB19971C6ACB206A,10471,0,10,10,37,48,1898
29453,29453,6E3A482A59CE9925DB19971C6ACB206A,40171,13,16,3,38,48,1948
29454,29454,6E3A482A59CE9925DB19971C6ACB206A,10471,17,23,6,37,48,1898
29455,29455,094A666A5E9A24F7CF6E287CC48F4053,42633,9,13,4,42,46,2146
29456,29456,094A666A5E9A24F7CF6E287CC48F4053,43061,14,18,4,43,46,2196
29457,29457,094A666A5E9A24F7CF6E287CC48F4053,43341,21,22,1,41,46,2096
29458,29458,C4610AFE955041639E8EF06B652762AD,11021,2,14,12,36,49,1849
29459,29459,C4610AFE955041639E8EF06B652762AD,11541,16,17,1,35,49,1799
29460,29460,C4610AFE955041639E8EF06B652762AD,11021,18,23,5,36,49,1849
29464,29464,4E1126CD1AF86FC47E3B081AF053FA88,43761,0,7,7,32,47,1647
29465,29465,4E1126CD1AF86FC47E3B081AF053FA88,42491,7,14,7,32,46,1646
29466,29466,4E1126CD1AF86FC47E3B081AF053FA88,42141,16,22,6,32,47,1647
29467,29467,96FE08600264D55F9260850729AEC7B8,42301,0,11,11,36,47,1847
29468,29468,96FE08600264D55F9260850729AEC7B8,10251,14,20,6,35,47,1797
29469,29469,96FE08600264D55F9260850729AEC7B8,42301,21,23,2,36,47,1847
29484,29484,74A03A755ED21436427E35EA7BBE6627,42481,0,10,10,22,49,1149
29485,29485,74A03A755ED21436427E35EA7BBE6627,42621,10,11,1,24,49,1249
29486,29486,74A03A755ED21436427E35EA7BBE6627,42481,12,23,11,22,49,1149
29487,29487,D75839547F19BC6AA2555211CD306BBE,12514,0,5,5,38,47,1947
29488,29488,D75839547F19BC6AA2555211CD306BBE,11914,8,18,10,37,48,1898
29489,29489,D75839547F19BC6AA2555211CD306BBE,12514,20,23,3,38,47,1947
29515,29515,FBAEDDC35131773D9B34EA9CA44E2AF3,10971,0,1,1,35,47,1797
29516,29516,FBAEDDC35131773D9B34EA9CA44E2AF3,43731,2,9,7,34,47,1747
29517,29517,FBAEDDC35131773D9B34EA9CA44E2AF3,10971,11,21,10,35,47,1797
29518,29518,FBAEDDC35131773D9B34EA9CA44E2AF3,43731,22,23,1,34,47,1747
29534,29534,B6F80668987D76AE8AEC48092E44D3BD,42301,0,2,2,36,47,1847
29535,29535,B6F80668987D76AE8AEC48092E44D3BD,10271,2,9,7,37,46,1896
29536,29536,B6F80668987D76AE8AEC48092E44D3BD,42301,9,11,2,36,47,1847
29537,29537,B6F80668987D76AE8AEC48092E44D3BD,42511,17,23,6,37,47,1897
29538,29538,487315C9A10EA017D67B443311820F7A,11771,0,8,8,39,49,1999
29539,29539,487315C9A10EA017D67B443311820F7A,11914,9,14,5,37,48,1898
29540,29540,487315C9A10EA017D67B443311820F7A,12401,19,23,4,39,49,1999
29546,29546,D7DE5735B7F76B89CCFEC789CF375D07,11074,0,7,7,37,47,1897
29547,29547,D7DE5735B7F76B89CCFEC789CF375D07,11261,10,16,6,36,46,1846
29548,29548,D7DE5735B7F76B89CCFEC789CF375D07,11074,19,23,4,37,47,1897
29559,29559,A6E7C9F768A521D8C9E298A4B1559383,42581,0,6,6,38,48,1948
29560,29560,A6E7C9F768A521D8C9E298A4B1559383,43181,10,12,2,39,48,1998
29561,29561,A6E7C9F768A521D8C9E298A4B1559383,11921,17,18,1,38,48,1948
29574,29574,96B398BCE821D0E1508347A9D7207669,12641,0,15,15,10,43,543
29575,29575,96B398BCE821D0E1508347A9D7207669,19931,18,19,1,7,43,393
29576,29576,96B398BCE821D0E1508347A9D7207669,12641,21,23,2,10,43,543
29593,29593,BF48EEACA0D9E0A901DD439DC66936C5,13791,0,10,10,42,47,2147
29594,29594,BF48EEACA0D9E0A901DD439DC66936C5,13941,13,18,5,41,47,2097
29595,29595,BF48EEACA0D9E0A901DD439DC66936C5,11001,20,23,3,42,47,2147
29596,29596,405425CB3107629C743592DE469E38AA,42581,0,5,5,38,48,1948
29597,29597,405425CB3107629C743592DE469E38AA,11914,5,13,8,37,48,1898
29598,29598,405425CB3107629C743592DE469E38AA,42581,14,17,3,38,48,1948
29599,29599,405425CB3107629C743592DE469E38AA,11914,17,22,5,37,48,1898
29612,29612,BAB92154BCA6CFC7EA4D414D7D54ED3F,12311,0,1,1,30,44,1544
29613,29613,BAB92154BCA6CFC7EA4D414D7D54ED3F,42531,2,5,3,31,45,1595
29614,29614,BAB92154BCA6CFC7EA4D414D7D54ED3F,12311,7,23,16,30,44,1544
29620,29620,70E36A4B82878626B569C66E46C7827C,11271,1,2,1,37,48,1898
29621,29621,70E36A4B82878626B569C66E46C7827C,13511,3,7,4,34,48,1748
29622,29622,70E36A4B82878626B569C66E46C7827C,11271,19,23,4,37,48,1898
29628,29628,5F5C2388C16FBBCF889B7BB88B6087BC,13341,0,6,6,44,45,2245
29629,29629,5F5C2388C16FBBCF889B7BB88B6087BC,42201,7,9,2,43,46,2196
29630,29630,5F5C2388C16FBBCF889B7BB88B6087BC,13341,12,20,8,44,45,2245
29631,29631,DAB1E551BD64F41E0CFBA6BC2210C0F6,40637,0,14,14,36,47,1847
29632,29632,DAB1E551BD64F41E0CFBA6BC2210C0F6,10251,15,21,6,35,47,1797
29633,29633,DAB1E551BD64F41E0CFBA6BC2210C0F6,40637,22,23,1,36,47,1847
29639,29639,53B9F7992DB29A9E3000FDBC39A3F0DF,11074,1,2,1,37,47,1897
29640,29640,53B9F7992DB29A9E3000FDBC39A3F0DF,42221,7,8,1,38,48,1948
29641,29641,53B9F7992DB29A9E3000FDBC39A3F0DF,42271,9,10,1,40,47,2047
29642,29642,53B9F7992DB29A9E3000FDBC39A3F0DF,11074,11,20,9,37,47,1897
29653,29653,193603340935DA55C70322807542A372,19111,0,18,18,9,45,495
29654,29654,193603340935DA55C70322807542A372,19114,18,19,1,7,43,393
29655,29655,193603340935DA55C70322807542A372,19111,20,21,1,9,45,495
29659,29659,826B40817E61853148AFBFECB1C48C70,11261,0,5,5,36,46,1846
29660,29660,826B40817E61853148AFBFECB1C48C70,42861,5,21,16,37,44,1894
29661,29661,826B40817E61853148AFBFECB1C48C70,11261,21,23,2,36,46,1846
29677,29677,92E340B82C56A45F91D53CD2B709557E,11914,8,10,2,37,48,1898
29678,29678,92E340B82C56A45F91D53CD2B709557E,42581,12,14,2,38,48,1948
29679,29679,92E340B82C56A45F91D53CD2B709557E,11914,14,18,4,37,48,1898
29680,29680,86ED269C4CA1391D71DB9BF7C4485A4D,13411,1,10,9,49,42,2492
29681,29681,86ED269C4CA1391D71DB9BF7C4485A4D,43951,15,16,1,49,41,2491
29682,29682,86ED269C4CA1391D71DB9BF7C4485A4D,13411,19,22,3,49,42,2492
29690,29690,81E9C3858C44D7DA57E9FCCB87C1B34F,11861,1,5,4,32,47,1647
29691,29691,81E9C3858C44D7DA57E9FCCB87C1B34F,10691,10,14,4,33,48,1698
29692,29692,81E9C3858C44D7DA57E9FCCB87C1B34F,42021,16,18,2,33,47,1697
29693,29693,81E9C3858C44D7DA57E9FCCB87C1B34F,10491,19,20,1,33,48,1698
29697,29697,44EC2B0D5EE5BD6B35ABC292F1B0BE4A,12641,2,3,1,10,43,543
29698,29698,44EC2B0D5EE5BD6B35ABC292F1B0BE4A,12921,4,5,1,9,41,491
29699,29699,44EC2B0D5EE5BD6B35ABC292F1B0BE4A,12641,9,10,1,10,43,543
29700,29700,44EC2B0D5EE5BD6B35ABC292F1B0BE4A,12921,11,23,12,9,41,491
29704,29704,2C19FDC386B0B2E924F75B25676D719F,40322,1,7,6,38,46,1946
29705,29705,2C19FDC386B0B2E924F75B25676D719F,42351,9,10,1,38,45,1945
29706,29706,2C19FDC386B0B2E924F75B25676D719F,42231,10,18,8,37,46,1896
29707,29707,2C19FDC386B0B2E924F75B25676D719F,13711,20,22,2,38,46,1946
29716,29716,0AE01B9B54FEFE84315FE108EDDE3B30,11161,0,7,7,32,48,1648
29717,29717,0AE01B9B54FEFE84315FE108EDDE3B30,43761,10,18,8,32,47,1647
29718,29718,0AE01B9B54FEFE84315FE108EDDE3B30,11161,20,23,3,32,48,1648
29719,29719,537281FCC0481DD8A50DAF763CC077B5,10681,0,7,7,30,48,1548
29720,29720,537281FCC0481DD8A50DAF763CC077B5,43761,9,11,2,32,47,1647
29721,29721,537281FCC0481DD8A50DAF763CC077B5,10681,15,22,7,30,48,1548
29722,29722,91C845F33B01C4DA71C1A0D3DEBCFC93,42221,1,10,9,38,48,1948
29723,29723,91C845F33B01C4DA71C1A0D3DEBCFC93,10591,14,16,2,39,48,1998
29724,29724,91C845F33B01C4DA71C1A0D3DEBCFC93,42471,19,20,1,35,49,1799
29728,29728,B1D714EAA88F4188BDEB8AEAFDE91C5B,42461,0,6,6,45,47,2297
29729,29729,B1D714EAA88F4188BDEB8AEAFDE91C5B,42111,7,8,1,44,46,2246
29730,29730,B1D714EAA88F4188BDEB8AEAFDE91C5B,42461,12,22,10,45,47,2297
29736,29736,FE93A16C7230CF15DDD8021B0FE821B3,12311,9,10,1,30,44,1544
29737,29737,FE93A16C7230CF15DDD8021B0FE821B3,12661,12,18,6,32,45,1645
29738,29738,FE93A16C7230CF15DDD8021B0FE821B3,12311,20,21,1,30,44,1544
29739,29739,C6869A64CA9EF97A25D7192A00726FC2,42401,0,13,13,36,47,1847
29740,29740,C6869A64CA9EF97A25D7192A00726FC2,10251,13,19,6,35,47,1797
29741,29741,C6869A64CA9EF97A25D7192A00726FC2,42401,20,23,3,36,47,1847
29745,29745,0EEE8C3F6BBA84AF90D6E1908AB19ECA,10381,0,15,15,31,49,1599
29746,29746,0EEE8C3F6BBA84AF90D6E1908AB19ECA,43391,15,16,1,29,48,1498
29747,29747,0EEE8C3F6BBA84AF90D6E1908AB19ECA,11151,18,23,5,30,48,1548
29748,29748,078D744FD5840DE4508E7DD5C66617FF,11261,1,5,4,36,46,1846
29749,29749,078D744FD5840DE4508E7DD5C66617FF,42351,9,17,8,38,45,1945
29750,29750,078D744FD5840DE4508E7DD5C66617FF,11261,18,23,5,36,46,1846
29780,29780,2B05CC2BC211341FBD9F6EA8966B4690,11914,0,12,12,37,48,1898
29781,29781,2B05CC2BC211341FBD9F6EA8966B4690,42581,16,17,1,38,48,1948
29782,29782,2B05CC2BC211341FBD9F6EA8966B4690,11914,17,23,6,37,48,1898
29793,29793,678046569E2EA8E0029CA68E4A494B0D,19114,0,7,7,7,43,393
29794,29794,678046569E2EA8E0029CA68E4A494B0D,12641,8,10,2,10,43,543
29795,29795,678046569E2EA8E0029CA68E4A494B0D,19114,12,23,11,7,43,393
29796,29796,90568B514F9B63E4374F225CB87C45A4,11021,0,16,16,36,49,1849
29797,29797,90568B514F9B63E4374F225CB87C45A4,42471,18,19,1,35,49,1799
29798,29798,90568B514F9B63E4374F225CB87C45A4,11021,19,22,3,36,49,1849
29799,29799,1DABB12859D13B3092B5C002A09FA674,10811,1,10,9,38,46,1946
29800,29800,1DABB12859D13B3092B5C002A09FA674,10601,10,15,5,39,47,1997
29801,29801,1DABB12859D13B3092B5C002A09FA674,10331,21,23,2,39,46,1996
29802,29802,727E11E725674B466632480A8E7EBB32,11481,0,8,8,41,48,2098
29803,29803,727E11E725674B466632480A8E7EBB32,13101,9,10,1,40,47,2047
29804,29804,727E11E725674B466632480A8E7EBB32,11481,11,17,6,41,48,2098
29805,29805,727E11E725674B466632480A8E7EBB32,13271,17,23,6,41,47,2097
29806,29806,716FBFB227B51AA05D4F812E328391F3,19441,0,3,3,8,46,446
29807,29807,716FBFB227B51AA05D4F812E328391F3,19621,3,6,3,5,46,296
29808,29808,716FBFB227B51AA05D4F812E328391F3,19441,8,20,12,8,46,446
29809,29809,AE4A6270CFE8D53376809A1F5BCB61EF,11074,0,1,1,37,47,1897
29810,29810,AE4A6270CFE8D53376809A1F5BCB61EF,40421,3,15,12,37,48,1898
29811,29811,AE4A6270CFE8D53376809A1F5BCB61EF,10841,15,16,1,37,47,1897
29812,29812,AE4A6270CFE8D53376809A1F5BCB61EF,40421,19,22,3,37,48,1898
29816,29816,5BD38FAF30C47E51437EACD34683C50B,11651,0,6,6,33,47,1697
29817,29817,5BD38FAF30C47E51437EACD34683C50B,10281,7,8,1,33,48,1698
29818,29818,5BD38FAF30C47E51437EACD34683C50B,11861,8,17,9,32,47,1647
29819,29819,5BD38FAF30C47E51437EACD34683C50B,10281,19,23,4,33,48,1698
29825,29825,116588AF5AC58392ED419AB241CF9AB4,10971,0,11,11,35,47,1797
29826,29826,116588AF5AC58392ED419AB241CF9AB4,42231,16,18,2,37,46,1896
29827,29827,116588AF5AC58392ED419AB241CF9AB4,10781,20,23,3,35,47,1797
29828,29828,75219378BBB10FFE07C7301517B53FE1,43281,8,12,4,37,48,1898
29829,29829,75219378BBB10FFE07C7301517B53FE1,11806,12,13,1,41,48,2098
29830,29830,75219378BBB10FFE07C7301517B53FE1,11231,14,22,8,37,49,1899
29831,29831,F74A692B863D412E165DF48C1089389E,12311,1,3,2,30,44,1544
29832,29832,F74A692B863D412E165DF48C1089389E,10634,7,17,10,27,45,1395
29833,29833,F74A692B863D412E165DF48C1089389E,42531,18,19,1,31,45,1595
29834,29834,0AA9A21AE5592E43C5386C31A83CC971,11021,0,7,7,36,49,1849
29835,29835,0AA9A21AE5592E43C5386C31A83CC971,11751,10,13,3,35,48,1798
29836,29836,0AA9A21AE5592E43C5386C31A83CC971,40951,16,23,7,36,49,1849
29837,29837,EFD67C44A54A4D4B59860E50D1F4BFA0,42161,0,17,17,36,47,1847
29838,29838,EFD67C44A54A4D4B59860E50D1F4BFA0,43161,18,19,1,35,47,1797
29839,29839,EFD67C44A54A4D4B59860E50D1F4BFA0,42161,20,23,3,36,47,1847
29849,29849,5529DD2214C36634346603006F6A0F3F,12521,0,6,6,35,41,1791
29850,29850,5529DD2214C36634346603006F6A0F3F,42381,7,11,4,39,41,1991
29851,29851,5529DD2214C36634346603006F6A0F3F,12521,12,23,11,35,41,1791
29855,29855,617CDCBB763C8E42460705E2218A65BF,42141,2,4,2,32,47,1647
29856,29856,617CDCBB763C8E42460705E2218A65BF,42523,7,9,2,31,47,1597
29857,29857,617CDCBB763C8E42460705E2218A65BF,43761,11,21,10,32,47,1647
29858,29858,20538B8C1777892DA77867D1D04B5D49,43761,0,2,2,32,47,1647
29859,29859,20538B8C1777892DA77867D1D04B5D49,11161,3,9,6,32,48,1648
29860,29860,20538B8C1777892DA77867D1D04B5D49,43761,10,23,13,32,47,1647
29861,29861,EC971BEA56DBA93E199ED44EE6EDF346,11861,0,8,8,32,47,1647
29862,29862,EC971BEA56DBA93E199ED44EE6EDF346,10281,12,17,5,33,48,1698
29863,29863,EC971BEA56DBA93E199ED44EE6EDF346,11861,18,19,1,32,47,1647
29872,29872,06D551A8B84FE30AD5961028E6C3C756,19441,0,5,5,8,46,446
29873,29873,06D551A8B84FE30AD5961028E6C3C756,42041,6,7,1,10,47,547
29874,29874,06D551A8B84FE30AD5961028E6C3C756,19441,10,23,13,8,46,446
29880,29880,79180DDD86B22B2BAEB51E3552560D4E,11381,1,14,13,30,47,1547
29881,29881,79180DDD86B22B2BAEB51E3552560D4E,42523,14,15,1,31,47,1597
29882,29882,79180DDD86B22B2BAEB51E3552560D4E,11381,16,21,5,30,47,1547
29883,29883,2D31A857958A9483557700A965EAE41B,10401,0,7,7,33,49,1699
29884,29884,2D31A857958A9483557700A965EAE41B,11211,8,9,1,34,49,1749
29885,29885,2D31A857958A9483557700A965EAE41B,11201,13,14,1,35,49,1799
29886,29886,2D31A857958A9483557700A965EAE41B,11211,18,22,4,34,49,1749
29887,29887,A60E51B2BB36D63F6E34260285BCBDB6,12661,0,6,6,32,45,1645
29888,29888,A60E51B2BB36D63F6E34260285BCBDB6,12311,6,19,13,30,44,1544
29889,29889,A60E51B2BB36D63F6E34260285BCBDB6,42531,22,23,1,31,45,1595
29893,29893,B7783E40C231BF2A915C5200F2E2562A,12031,0,9,9,33,48,1698
29894,29894,B7783E40C231BF2A915C5200F2E2562A,40951,11,16,5,36,49,1849
29895,29895,B7783E40C231BF2A915C5200F2E2562A,10491,19,23,4,33,48,1698
29903,29903,3F2B2DC2E885E396AE6A5E681FE358A4,42801,0,7,7,40,49,2049
29904,29904,3F2B2DC2E885E396AE6A5E681FE358A4,11301,19,21,2,41,49,2099
29905,29905,3F2B2DC2E885E396AE6A5E681FE358A4,42801,22,23,1,40,49,2049
29906,29906,6F6F174BF3BBBF4A283E7794B5A58265,11914,8,9,1,37,48,1898
29907,29907,6F6F174BF3BBBF4A283E7794B5A58265,42581,10,16,6,38,48,1948
29908,29908,6F6F174BF3BBBF4A283E7794B5A58265,11914,16,18,2,37,48,1898
29909,29909,6F6F174BF3BBBF4A283E7794B5A58265,11811,19,21,2,38,49,1949
29916,29916,EFA28DCFBC4E23F114FD86750477011F,42151,2,7,5,35,45,1795
29917,29917,EFA28DCFBC4E23F114FD86750477011F,42851,11,14,3,35,41,1791
29918,29918,EFA28DCFBC4E23F114FD86750477011F,42151,17,18,1,35,45,1795
29919,29919,EFA28DCFBC4E23F114FD86750477011F,12491,20,21,1,36,43,1843
29920,29920,BC5A81C0B2239125AA93000674BACB94,10281,2,11,9,33,48,1698
29921,29921,BC5A81C0B2239125AA93000674BACB94,40951,16,17,1,36,49,1849
29922,29922,BC5A81C0B2239125AA93000674BACB94,10281,18,20,2,33,48,1698
29935,29935,88B9ED484BFC88A3E18D812526B753D0,42351,0,4,4,38,45,1945
29936,29936,88B9ED484BFC88A3E18D812526B753D0,42864,7,10,3,38,44,1944
29937,29937,88B9ED484BFC88A3E18D812526B753D0,42861,14,18,4,37,44,1894
29938,29938,88B9ED484BFC88A3E18D812526B753D0,10811,21,23,2,38,46,1946
29939,29939,D1FBBC137A3A036EF8A0FD81ABD2B8C1,11201,0,7,7,35,49,1799
29940,29940,D1FBBC137A3A036EF8A0FD81ABD2B8C1,43731,11,13,2,34,47,1747
29941,29941,D1FBBC137A3A036EF8A0FD81ABD2B8C1,11201,13,23,10,35,49,1799
29946,29946,878DD44EE8FA6A43A619DDA4A892D760,11806,0,1,1,41,48,2098
29947,29947,878DD44EE8FA6A43A619DDA4A892D760,42271,3,19,16,40,47,2047
29948,29948,878DD44EE8FA6A43A619DDA4A892D760,11806,19,23,4,41,48,2098
29972,29972,DCE9BDF4C30776F61FC7C0FB237D8FCF,40941,0,7,7,32,48,1648
29973,29973,DCE9BDF4C30776F61FC7C0FB237D8FCF,11171,10,15,5,33,48,1698
29974,29974,DCE9BDF4C30776F61FC7C0FB237D8FCF,40941,21,23,2,32,48,1648
29986,29986,9F07E2341EC43516CD02BDC269F3E6AA,11381,7,15,8,30,47,1547
29987,29987,9F07E2341EC43516CD02BDC269F3E6AA,11061,17,18,1,29,48,1498
29988,29988,9F07E2341EC43516CD02BDC269F3E6AA,11381,20,21,1,30,47,1547
30024,30024,1F3C23281F41B8FE0994675CCF600603,11381,1,8,7,30,47,1547
30025,30025,1F3C23281F41B8FE0994675CCF600603,10951,8,11,3,29,48,1498
30026,30026,1F3C23281F41B8FE0994675CCF600603,13651,11,17,6,30,47,1547
30027,30027,1F3C23281F41B8FE0994675CCF600603,42523,21,23,2,31,47,1597
30042,30042,BB6408B6449FE57F7E33631A828BC98E,10421,1,7,6,41,48,2098
30043,30043,BB6408B6449FE57F7E33631A828BC98E,13961,8,13,5,42,48,2148
30044,30044,BB6408B6449FE57F7E33631A828BC98E,11701,17,21,4,43,48,2198
30049,30049,4B50E3EFF8633FBE01E31B5F6F8477A0,42091,2,10,8,43,46,2196
30050,30050,4B50E3EFF8633FBE01E31B5F6F8477A0,11701,13,16,3,43,48,2198
30051,30051,4B50E3EFF8633FBE01E31B5F6F8477A0,42091,18,22,4,43,46,2196
30071,30071,C28E26CBDD605F3A0694ECCAB6E5AC28,11431,0,9,9,29,47,1497
30072,30072,C28E26CBDD605F3A0694ECCAB6E5AC28,10634,14,20,6,27,45,1395
30073,30073,C28E26CBDD605F3A0694ECCAB6E5AC28,42501,21,22,1,28,47,1447
30079,30079,BA865EE03D54F441A6E18D3EAF3533FA,42291,0,4,4,29,48,1498
30080,30080,BA865EE03D54F441A6E18D3EAF3533FA,11381,14,19,5,30,47,1547
30081,30081,BA865EE03D54F441A6E18D3EAF3533FA,11061,21,23,2,29,48,1498
30082,30082,EAAE5582D770542811ACCE7282DFD32E,43751,6,12,6,19,48,998
30083,30083,EAAE5582D770542811ACCE7282DFD32E,42481,15,16,1,22,49,1149
30084,30084,EAAE5582D770542811ACCE7282DFD32E,43751,17,19,2,19,48,998
30109,30109,19FF976328DAF40B2191A4FAD8E693E1,42381,0,6,6,39,41,1991
30110,30110,19FF976328DAF40B2191A4FAD8E693E1,43451,6,15,9,37,40,1890
30111,30111,19FF976328DAF40B2191A4FAD8E693E1,43011,16,17,1,40,42,2042
30112,30112,19FF976328DAF40B2191A4FAD8E693E1,13071,21,22,1,41,41,2091
30117,30117,069E04DF3B296509CEAF40ED78771346,19181,8,13,5,8,40,440
30118,30118,069E04DF3B296509CEAF40ED78771346,12921,15,17,2,9,41,491
30119,30119,069E04DF3B296509CEAF40ED78771346,49201,17,22,5,7,41,391
30120,30120,424EA41F1DC8F019DCB89E6CE3B31FE9,10121,0,12,12,36,49,1849
30121,30121,424EA41F1DC8F019DCB89E6CE3B31FE9,40925,15,18,3,35,49,1799
30122,30122,424EA41F1DC8F019DCB89E6CE3B31FE9,10107,21,22,1,38,49,1949
30123,30123,9CA777C26F090A99FBBCE57B69E10F32,11161,0,6,6,32,48,1648
30124,30124,9CA777C26F090A99FBBCE57B69E10F32,43761,6,17,11,32,47,1647
30125,30125,9CA777C26F090A99FBBCE57B69E10F32,11161,21,23,2,32,48,1648
30130,30130,BEF31F045A546CF30A63CFBCD60FD3FA,13911,4,16,12,39,46,1996
30131,30131,BEF31F045A546CF30A63CFBCD60FD3FA,42231,20,22,2,37,46,1896
30132,30132,BEF31F045A546CF30A63CFBCD60FD3FA,13911,22,23,1,39,46,1996
30148,30148,44BA65919A80728667B0D62571A4968D,13121,4,16,12,38,46,1946
30149,30149,44BA65919A80728667B0D62571A4968D,10271,16,20,4,37,46,1896
30150,30150,44BA65919A80728667B0D62571A4968D,13121,20,23,3,38,46,1946
30155,30155,EA76F6018E37635F2D98F3C61FC7376D,13331,2,15,13,38,47,1947
30156,30156,EA76F6018E37635F2D98F3C61FC7376D,10841,16,18,2,37,47,1897
30157,30157,EA76F6018E37635F2D98F3C61FC7376D,13331,18,19,1,38,47,1947
30158,30158,EA76F6018E37635F2D98F3C61FC7376D,10841,22,23,1,37,47,1897
30164,30164,A4548EA77EB2B3C8A80CBA5339B6031A,13651,4,7,3,30,47,1547
30165,30165,A4548EA77EB2B3C8A80CBA5339B6031A,42523,8,9,1,31,47,1597
30166,30166,A4548EA77EB2B3C8A80CBA5339B6031A,13651,11,16,5,30,47,1547
30167,30167,A4548EA77EB2B3C8A80CBA5339B6031A,10491,18,21,3,33,48,1698
30172,30172,DB3E630F0B8B4654A4F1A27A65033CF0,10681,0,15,15,30,48,1548
30173,30173,DB3E630F0B8B4654A4F1A27A65033CF0,43311,15,16,1,31,48,1598
30174,30174,DB3E630F0B8B4654A4F1A27A65033CF0,10681,18,23,5,30,48,1548
30175,30175,1F63B4EA7EA3EF1957ABD7DC1B0012CC,42301,1,15,14,36,47,1847
30176,30176,1F63B4EA7EA3EF1957ABD7DC1B0012CC,10107,17,18,1,38,49,1949
30177,30177,1F63B4EA7EA3EF1957ABD7DC1B0012CC,42401,18,20,2,36,47,1847
30190,30190,4F6A74BBD714EF065A4DB365EFF3390D,11271,0,8,8,37,48,1898
30191,30191,4F6A74BBD714EF065A4DB365EFF3390D,10221,12,15,3,34,49,1749
30192,30192,4F6A74BBD714EF065A4DB365EFF3390D,11271,18,22,4,37,48,1898
30213,30213,5E1BBAE6A1AB78C09E8201C8FF351A4E,13011,2,8,6,39,47,1997
30214,30214,5E1BBAE6A1AB78C09E8201C8FF351A4E,12514,10,11,1,38,47,1947
30215,30215,5E1BBAE6A1AB78C09E8201C8FF351A4E,11074,16,19,3,37,47,1897
30216,30216,FEBD122FF83E402204912098A86567F3,42921,0,8,8,33,47,1697
30217,30217,FEBD122FF83E402204912098A86567F3,11861,10,13,3,32,47,1647
30218,30218,FEBD122FF83E402204912098A86567F3,13601,14,23,9,34,47,1747
30235,30235,46248CD3AE5F02514CBE5AD511617E45,13671,0,6,6,27,43,1393
30236,30236,46248CD3AE5F02514CBE5AD511617E45,13311,10,12,2,27,39,1389
30237,30237,46248CD3AE5F02514CBE5AD511617E45,11281,16,18,2,27,40,1390
30238,30238,46248CD3AE5F02514CBE5AD511617E45,13671,18,20,2,27,43,1393
30239,30239,60B3904EE9AFD7C630994F95D4C927AC,11231,0,1,1,37,49,1899
30240,30240,60B3904EE9AFD7C630994F95D4C927AC,11591,4,5,1,36,49,1849
30241,30241,60B3904EE9AFD7C630994F95D4C927AC,13561,7,23,16,37,49,1899
30242,30242,686D4F0D299962ED76BF11C36F11CE9B,40124,0,10,10,38,47,1947
30243,30243,686D4F0D299962ED76BF11C36F11CE9B,42511,15,19,4,37,47,1897
30244,30244,686D4F0D299962ED76BF11C36F11CE9B,13331,20,23,3,38,47,1947
30253,30253,C98E7EDEB63C71E36BA524A0EC0FBED4,42231,2,6,4,37,46,1896
30254,30254,C98E7EDEB63C71E36BA524A0EC0FBED4,13121,8,15,7,38,46,1946
30255,30255,C98E7EDEB63C71E36BA524A0EC0FBED4,11074,18,20,2,37,47,1897
30256,30256,C98E7EDEB63C71E36BA524A0EC0FBED4,13121,21,23,2,38,46,1946
30265,30265,EE6B8585E25BB845D2DA0A95F88FAB79,42231,6,10,4,37,46,1896
30266,30266,EE6B8585E25BB845D2DA0A95F88FAB79,13911,14,16,2,39,46,1996
30267,30267,EE6B8585E25BB845D2DA0A95F88FAB79,11261,16,18,2,36,46,1846
30268,30268,EE6B8585E25BB845D2DA0A95F88FAB79,42231,22,23,1,37,46,1896
30280,30280,FC32FCDE5EA162E6A3931CE10EF22190,11231,8,10,2,37,49,1899
30281,30281,FC32FCDE5EA162E6A3931CE10EF22190,11021,13,14,1,36,49,1849
30282,30282,FC32FCDE5EA162E6A3931CE10EF22190,11231,16,18,2,37,49,1899
30283,30283,52DE1B5B29EB088C4F7CC0D4865B38F5,42151,10,14,4,35,45,1795
30284,30284,52DE1B5B29EB088C4F7CC0D4865B38F5,42861,14,15,1,37,44,1894
30285,30285,52DE1B5B29EB088C4F7CC0D4865B38F5,42151,15,22,7,35,45,1795
30292,30292,D1DADBAFF8F1838CF54C306F30C9CCE9,10691,0,11,11,33,48,1698
30293,30293,D1DADBAFF8F1838CF54C306F30C9CCE9,42021,16,17,1,33,47,1697
30294,30294,D1DADBAFF8F1838CF54C306F30C9CCE9,10691,18,23,5,33,48,1698
30295,30295,A280969FD90AA928F73AE4BBEE919365,13101,0,19,19,40,47,2047
30296,30296,A280969FD90AA928F73AE4BBEE919365,13371,20,22,2,41,47,2097
30297,30297,A280969FD90AA928F73AE4BBEE919365,13101,22,23,1,40,47,2047
30298,30298,4C6EBE1C4B2FAAFACD17B57BF7692986,10531,0,6,6,34,46,1746
30299,30299,4C6EBE1C4B2FAAFACD17B57BF7692986,43731,8,14,6,34,47,1747
30300,30300,4C6EBE1C4B2FAAFACD17B57BF7692986,42161,15,16,1,36,47,1847
30301,30301,4C6EBE1C4B2FAAFACD17B57BF7692986,43731,17,23,6,34,47,1747
30307,30307,10C025DE83AEC63388DB13DE6128ADC8,11381,0,7,7,30,47,1547
30308,30308,10C025DE83AEC63388DB13DE6128ADC8,12121,10,12,2,29,47,1497
30309,30309,10C025DE83AEC63388DB13DE6128ADC8,10951,14,20,6,29,48,1498
30316,30316,0353F059AABCEF9821E6663B38E76F76,11701,5,8,3,43,48,2198
30317,30317,0353F059AABCEF9821E6663B38E76F76,43621,9,14,5,46,48,2348
30318,30318,0353F059AABCEF9821E6663B38E76F76,11701,15,23,8,43,48,2198
30319,30319,130A3F07110C04FAA25AF414856A2109,13601,10,15,5,34,47,1747
30320,30320,130A3F07110C04FAA25AF414856A2109,42921,16,17,1,33,47,1697
30321,30321,130A3F07110C04FAA25AF414856A2109,13601,18,21,3,34,47,1747
30322,30322,130A3F07110C04FAA25AF414856A2109,42921,22,23,1,33,47,1697
30323,30323,4E7614A4B91A30F096E19E723EE62442,10634,1,12,11,27,45,1395
30324,30324,4E7614A4B91A30F096E19E723EE62442,10351,12,14,2,28,45,1445
30325,30325,4E7614A4B91A30F096E19E723EE62442,10634,14,22,8,27,45,1395
30332,30332,182A42BB7961D14AD940FD065D4EDF33,13121,5,7,2,38,46,1946
30333,30333,182A42BB7961D14AD940FD065D4EDF33,11941,9,16,7,37,46,1896
30334,30334,182A42BB7961D14AD940FD065D4EDF33,13121,20,22,2,38,46,1946
30335,30335,5F72E18AC22CC05F11A96BFBD57885CE,11201,1,16,15,35,49,1799
30336,30336,5F72E18AC22CC05F11A96BFBD57885CE,10411,16,17,1,36,48,1848
30337,30337,5F72E18AC22CC05F11A96BFBD57885CE,10221,21,23,2,34,49,1749
30343,30343,012D304B65BB1C01DC9FFE26FE6AEE56,42161,0,11,11,36,47,1847
30344,30344,012D304B65BB1C01DC9FFE26FE6AEE56,10161,13,15,2,35,49,1799
30345,30345,012D304B65BB1C01DC9FFE26FE6AEE56,11271,16,18,2,37,48,1898
30346,30346,012D304B65BB1C01DC9FFE26FE6AEE56,10161,21,23,2,35,49,1799
30356,30356,D97F93CB7946C1399F01BAA588B11A0C,42351,0,13,13,38,45,1945
30357,30357,D97F93CB7946C1399F01BAA588B11A0C,11261,15,17,2,36,46,1846
30358,30358,D97F93CB7946C1399F01BAA588B11A0C,42351,18,23,5,38,45,1945
30359,30359,9159AFAA11D55EDF8EDEF2351CBE2983,11331,1,15,14,37,48,1898
30360,30360,9159AFAA11D55EDF8EDEF2351CBE2983,11074,17,18,1,37,47,1897
30361,30361,9159AFAA11D55EDF8EDEF2351CBE2983,11331,21,22,1,37,48,1898
30370,30370,24E0526322E0EAC047203D45AB3ADD60,11011,0,10,10,39,49,1999
30371,30371,24E0526322E0EAC047203D45AB3ADD60,40951,11,14,3,36,49,1849
30372,30372,24E0526322E0EAC047203D45AB3ADD60,11481,14,18,4,41,48,2098
30380,30380,FF6FF9B0197A91C0352AF48B73895F85,42201,0,6,6,43,46,2196
30381,30381,FF6FF9B0197A91C0352AF48B73895F85,13341,6,11,5,44,45,2245
30382,30382,FF6FF9B0197A91C0352AF48B73895F85,42201,13,18,5,43,46,2196
30387,30387,3BD6568A851F0862F8846C1E3EDE82AC,42021,0,18,18,33,47,1697
30388,30388,3BD6568A851F0862F8846C1E3EDE82AC,11861,19,20,1,32,47,1647
30389,30389,3BD6568A851F0862F8846C1E3EDE82AC,42021,21,22,1,33,47,1697
30404,30404,F2B91319B08EF74FD61D182A88F13907,43761,0,10,10,32,47,1647
30405,30405,F2B91319B08EF74FD61D182A88F13907,42021,11,14,3,33,47,1697
30406,30406,F2B91319B08EF74FD61D182A88F13907,43761,17,18,1,32,47,1647
30407,30407,08B6161A63F0BFCCF67BFC0EA5B81E44,42621,0,14,14,24,49,1249
30408,30408,08B6161A63F0BFCCF67BFC0EA5B81E44,40341,14,18,4,23,49,1199
30409,30409,08B6161A63F0BFCCF67BFC0EA5B81E44,42621,18,23,5,24,49,1249
30410,30410,59F99AD9A04D6F91F4E80FA7D2485889,42351,0,7,7,38,45,1945
30411,30411,59F99AD9A04D6F91F4E80FA7D2485889,11261,11,20,9,36,46,1846
30412,30412,59F99AD9A04D6F91F4E80FA7D2485889,42231,21,23,2,37,46,1896
30413,30413,1C6C9F4ABC734E6DFFC05F95E3F46D4D,42301,0,13,13,36,47,1847
30414,30414,1C6C9F4ABC734E6DFFC05F95E3F46D4D,10251,13,18,5,35,47,1797
30415,30415,1C6C9F4ABC734E6DFFC05F95E3F46D4D,42161,20,21,1,36,47,1847
30419,30419,1AF3413905A2A8813EEB1CD65CEC34FB,10531,1,8,7,34,46,1746
30420,30420,1AF3413905A2A8813EEB1CD65CEC34FB,11841,11,14,3,33,46,1696
30421,30421,1AF3413905A2A8813EEB1CD65CEC34FB,10531,18,20,2,34,46,1746
30422,30422,1AF3413905A2A8813EEB1CD65CEC34FB,11841,21,22,1,33,46,1696
30429,30429,8911BF0097E87038417D233158DB1D64,10601,0,9,9,39,47,1997
30430,30430,8911BF0097E87038417D233158DB1D64,13101,11,13,2,40,47,2047
30431,30431,8911BF0097E87038417D233158DB1D64,10601,14,21,7,39,47,1997
30432,30432,3BC1FEC85921C44B1F7DC483EC4194E1,43061,0,6,6,43,46,2196
30433,30433,3BC1FEC85921C44B1F7DC483EC4194E1,42461,7,8,1,45,47,2297
30434,30434,3BC1FEC85921C44B1F7DC483EC4194E1,43061,19,22,3,43,46,2196
30442,30442,7200E84AEDCA7E085FE069DDCE5F2702,42401,0,7,7,36,47,1847
30443,30443,7200E84AEDCA7E085FE069DDCE5F2702,41081,8,17,9,36,49,1849
30444,30444,7200E84AEDCA7E085FE069DDCE5F2702,42401,18,23,5,36,47,1847
30452,30452,EC8D784C19C185B8F2C30A9ECA831652,13911,2,3,1,39,46,1996
30453,30453,EC8D784C19C185B8F2C30A9ECA831652,11261,5,15,10,36,46,1846
30454,30454,EC8D784C19C185B8F2C30A9ECA831652,42231,15,18,3,37,46,1896
30455,30455,EC8D784C19C185B8F2C30A9ECA831652,13911,21,23,2,39,46,1996
30456,30456,271B4D4F9BFB265367C27D7A696FE372,43761,0,19,19,32,47,1647
30457,30457,271B4D4F9BFB265367C27D7A696FE372,11381,19,21,2,30,47,1547
30458,30458,271B4D4F9BFB265367C27D7A696FE372,43761,21,22,1,32,47,1647
30465,30465,41BEA9D7D7C433E67F41ED8F3F4B85D2,11074,0,6,6,37,47,1897
30466,30466,41BEA9D7D7C433E67F41ED8F3F4B85D2,13371,10,14,4,41,47,2097
30467,30467,41BEA9D7D7C433E67F41ED8F3F4B85D2,11074,14,20,6,37,47,1897
30468,30468,6D3D88C57BAED90EED5783D123F38AA1,11731,0,3,3,36,48,1848
30469,30469,6D3D88C57BAED90EED5783D123F38AA1,10251,3,15,12,35,47,1797
30470,30470,6D3D88C57BAED90EED5783D123F38AA1,10161,15,21,6,35,49,1799
30484,30484,B532F93B6517A3D30211D466DC2FD209,42281,0,7,7,40,48,2048
30485,30485,B532F93B6517A3D30211D466DC2FD209,13381,12,14,2,39,47,1997
30486,30486,B532F93B6517A3D30211D466DC2FD209,42281,15,16,1,40,48,2048
30487,30487,B532F93B6517A3D30211D466DC2FD209,11806,20,21,1,41,48,2098
30488,30488,1277ACA424D6A91D4C363B632562549C,12601,1,8,7,25,47,1297
30489,30489,1277ACA424D6A91D4C363B632562549C,10501,11,12,1,22,46,1146
30490,30490,1277ACA424D6A91D4C363B632562549C,12601,12,22,10,25,47,1297
30495,30495,AC5FFFC9828085332F197D373119C99F,42531,0,12,12,31,45,1595
30496,30496,AC5FFFC9828085332F197D373119C99F,42151,16,17,1,35,45,1795
30497,30497,AC5FFFC9828085332F197D373119C99F,42531,20,21,1,31,45,1595
30517,30517,5084492A6A758A3CF1EF2B8D58F59187,11875,0,5,5,30,46,1546
30518,30518,5084492A6A758A3CF1EF2B8D58F59187,12311,9,17,8,30,44,1544
30519,30519,5084492A6A758A3CF1EF2B8D58F59187,11875,19,22,3,30,46,1546
30525,30525,2B796358390FD846EE57DE8924EDBF14,42581,0,5,5,38,48,1948
30526,30526,2B796358390FD846EE57DE8924EDBF14,11271,7,15,8,37,48,1898
30527,30527,2B796358390FD846EE57DE8924EDBF14,42581,19,23,4,38,48,1948
30528,30528,905AFBF8C9D2DC6B48AC77C3F506268E,13561,0,5,5,37,49,1899
30529,30529,905AFBF8C9D2DC6B48AC77C3F506268E,11021,7,17,10,36,49,1849
30530,30530,905AFBF8C9D2DC6B48AC77C3F506268E,13561,20,23,3,37,49,1899
30549,30549,A26526FCE25758DA240C3B314B205E8A,19441,0,6,6,8,46,446
30550,30550,A26526FCE25758DA240C3B314B205E8A,19114,8,15,7,7,43,393
30551,30551,A26526FCE25758DA240C3B314B205E8A,19024,20,23,3,9,45,495
30552,30552,E8A3A2F2678AE58B36D710FCF037760E,11231,0,1,1,37,49,1899
30553,30553,E8A3A2F2678AE58B36D710FCF037760E,10411,2,20,18,36,48,1848
30554,30554,E8A3A2F2678AE58B36D710FCF037760E,11231,21,23,2,37,49,1899
30555,30555,C56F88E442CA52D12F7DED656C94C0A5,42231,0,6,6,37,46,1896
30556,30556,C56F88E442CA52D12F7DED656C94C0A5,13911,9,10,1,39,46,1996
30557,30557,C56F88E442CA52D12F7DED656C94C0A5,42231,11,23,12,37,46,1896
30567,30567,273E194878CE130DC9C04220F5068056,10841,0,7,7,37,47,1897
30568,30568,273E194878CE130DC9C04220F5068056,42161,11,12,1,36,47,1847
30569,30569,273E194878CE130DC9C04220F5068056,10841,14,22,8,37,47,1897
30570,30570,5102B42C348B7F58F60DC6DAF5653AF2,11914,0,15,15,37,48,1898
30571,30571,5102B42C348B7F58F60DC6DAF5653AF2,42581,15,19,4,38,48,1948
30572,30572,5102B42C348B7F58F60DC6DAF5653AF2,10371,20,23,3,37,49,1899
30576,30576,6448AD2FDBA33B773228F13A91A3786C,43761,2,16,14,32,47,1647
30577,30577,6448AD2FDBA33B773228F13A91A3786C,10281,19,20,1,33,48,1698
30578,30578,6448AD2FDBA33B773228F13A91A3786C,43761,20,22,2,32,47,1647
30579,30579,FE157E2906F39F22EFF42EFD9B7DC358,42291,0,6,6,29,48,1498
30580,30580,FE157E2906F39F22EFF42EFD9B7DC358,11381,7,10,3,30,47,1547
30581,30581,FE157E2906F39F22EFF42EFD9B7DC358,11061,11,14,3,29,48,1498
30582,30582,FE157E2906F39F22EFF42EFD9B7DC358,11381,16,20,4,30,47,1547
30583,30583,3D14ED52517EC87D2CFF7A1C6FD766A1,11481,0,13,13,41,48,2098
30584,30584,3D14ED52517EC87D2CFF7A1C6FD766A1,13101,13,15,2,40,47,2047
30585,30585,3D14ED52517EC87D2CFF7A1C6FD766A1,11481,17,22,5,41,48,2098
30592,30592,292C54710FB21A50B273EFB2F0804791,42081,2,4,2,24,49,1249
30593,30593,292C54710FB21A50B273EFB2F0804791,42623,10,12,2,22,49,1149
30594,30594,292C54710FB21A50B273EFB2F0804791,42081,15,20,5,24,49,1249
30595,30595,4003E07D2A4AF66E84145561FFA003F3,10341,0,4,4,31,47,1597
30596,30596,4003E07D2A4AF66E84145561FFA003F3,42491,5,6,1,32,46,1646
30597,30597,4003E07D2A4AF66E84145561FFA003F3,10341,7,19,12,31,47,1597
30598,30598,4003E07D2A4AF66E84145561FFA003F3,42141,20,21,1,32,47,1647
30606,30606,5CBB3BFC4ED61841A41A893768B01036,13911,0,14,14,39,46,1996
30607,30607,5CBB3BFC4ED61841A41A893768B01036,11261,16,17,1,36,46,1846
30608,30608,5CBB3BFC4ED61841A41A893768B01036,13911,21,23,2,39,46,1996
30609,30609,1650B3F85521CDDD645493B1689A16D8,10681,0,6,6,30,48,1548
30610,30610,1650B3F85521CDDD645493B1689A16D8,11061,6,15,9,29,48,1498
30611,30611,1650B3F85521CDDD645493B1689A16D8,10681,15,22,7,30,48,1548
30612,30612,0D9AA89290D1F445356B85B4B256A343,11001,0,3,3,42,47,2147
30613,30613,0D9AA89290D1F445356B85B4B256A343,13941,4,5,1,41,47,2097
30614,30614,0D9AA89290D1F445356B85B4B256A343,42201,6,17,11,43,46,2196
30615,30615,0D9AA89290D1F445356B85B4B256A343,11001,22,23,1,42,47,2147
30621,30621,D746519213A28242D49759FCE6B0BCB4,19441,0,5,5,8,46,446
30622,30622,D746519213A28242D49759FCE6B0BCB4,19621,9,10,1,5,46,296
30623,30623,D746519213A28242D49759FCE6B0BCB4,19441,11,21,10,8,46,446
30624,30624,D746519213A28242D49759FCE6B0BCB4,42041,21,23,2,10,47,547
30633,30633,6F6BFA140B8F0D41AE13D3CFA2E32A87,19114,0,5,5,7,43,393
30634,30634,6F6BFA140B8F0D41AE13D3CFA2E32A87,12921,6,7,1,9,41,491
30635,30635,6F6BFA140B8F0D41AE13D3CFA2E32A87,19181,7,8,1,8,40,440
30636,30636,6F6BFA140B8F0D41AE13D3CFA2E32A87,19114,13,23,10,7,43,393
30637,30637,A584DB5FF6EE02AE16BAE873BBEDDAA1,12921,0,9,9,9,41,491
30638,30638,A584DB5FF6EE02AE16BAE873BBEDDAA1,12641,13,14,1,10,43,543
30639,30639,A584DB5FF6EE02AE16BAE873BBEDDAA1,12921,15,19,4,9,41,491
30640,30640,A584DB5FF6EE02AE16BAE873BBEDDAA1,49201,19,21,2,7,41,391
30641,30641,0277E6ABE6E23FB8B51E9078601CBBC1,42491,0,7,7,32,46,1646
30642,30642,0277E6ABE6E23FB8B51E9078601CBBC1,42523,11,16,5,31,47,1597
30643,30643,0277E6ABE6E23FB8B51E9078601CBBC1,42491,18,23,5,32,46,1646
30644,30644,9A1CB6044954B6099E36F60F8EE95A99,11381,1,12,11,30,47,1547
30645,30645,9A1CB6044954B6099E36F60F8EE95A99,10951,16,17,1,29,48,1498
30646,30646,9A1CB6044954B6099E36F60F8EE95A99,11381,18,22,4,30,47,1547
30647,30647,F8EA0C68F3C8266C3E7BA4F2FCE6F8BC,19441,0,14,14,8,46,446
30648,30648,F8EA0C68F3C8266C3E7BA4F2FCE6F8BC,42041,15,17,2,10,47,547
30649,30649,F8EA0C68F3C8266C3E7BA4F2FCE6F8BC,19441,18,23,5,8,46,446
30650,30650,3DA0BCC83518894F0CE5D638362ECC1B,43731,0,6,6,34,47,1747
30651,30651,3DA0BCC83518894F0CE5D638362ECC1B,10971,9,10,1,35,47,1797
30652,30652,3DA0BCC83518894F0CE5D638362ECC1B,43731,10,19,9,34,47,1747
30656,30656,995514E74525DCE707CCE63893D938C0,10841,2,3,1,37,47,1897
30657,30657,995514E74525DCE707CCE63893D938C0,13331,4,9,5,38,47,1947
30658,30658,995514E74525DCE707CCE63893D938C0,10841,11,16,5,37,47,1897
30659,30659,995514E74525DCE707CCE63893D938C0,13331,16,23,7,38,47,1947
30672,30672,CD1558A461467623497C8E8A3785B0D9,42111,2,4,2,44,46,2246
30673,30673,CD1558A461467623497C8E8A3785B0D9,42091,6,14,8,43,46,2196
30674,30674,CD1558A461467623497C8E8A3785B0D9,42111,14,15,1,44,46,2246
30675,30675,CD1558A461467623497C8E8A3785B0D9,42091,16,19,3,43,46,2196
30676,30676,FC3B8910035FE6AFFCEFAAF1A5BD46D7,10471,0,12,12,37,48,1898
30677,30677,FC3B8910035FE6AFFCEFAAF1A5BD46D7,42191,13,15,2,38,49,1949
30678,30678,FC3B8910035FE6AFFCEFAAF1A5BD46D7,10471,16,22,6,37,48,1898
30679,30679,3C5BF8354C7B22C00BFA5438C070BC0F,13711,1,14,13,38,46,1946
30680,30680,3C5BF8354C7B22C00BFA5438C070BC0F,43241,14,16,2,36,46,1846
30681,30681,3C5BF8354C7B22C00BFA5438C070BC0F,13711,16,21,5,38,46,1946
30682,30682,FF54487E0B5C80FA4088AB1638FB8194,42581,0,12,12,38,48,1948
30683,30683,FF54487E0B5C80FA4088AB1638FB8194,11914,14,17,3,37,48,1898
30684,30684,FF54487E0B5C80FA4088AB1638FB8194,42581,21,22,1,38,48,1948
30685,30685,8E45D965AF47E02C830A23504714573B,42981,0,6,6,36,49,1849
30686,30686,8E45D965AF47E02C830A23504714573B,10841,9,12,3,37,47,1897
30687,30687,8E45D965AF47E02C830A23504714573B,11331,13,14,1,37,48,1898
30688,30688,8E45D965AF47E02C830A23504714573B,10841,15,21,6,37,47,1897
30703,30703,D96C351A2D3BF2CB9C84E8F01C9997B6,19904,0,2,2,9,44,494
30704,30704,D96C351A2D3BF2CB9C84E8F01C9997B6,12641,2,19,17,10,43,543
30705,30705,D96C351A2D3BF2CB9C84E8F01C9997B6,19904,21,23,2,9,44,494
30714,30714,44AA91905A7E8DBC24B0A51CC88C9204,42151,0,12,12,35,45,1795
30715,30715,44AA91905A7E8DBC24B0A51CC88C9204,42231,15,16,1,37,46,1896
30716,30716,44AA91905A7E8DBC24B0A51CC88C9204,42151,20,23,3,35,45,1795
30720,30720,D4DE28276D2C825AA4FE715AD291B466,13121,0,6,6,38,46,1946
30721,30721,D4DE28276D2C825AA4FE715AD291B466,11941,10,11,1,37,46,1896
30722,30722,D4DE28276D2C825AA4FE715AD291B466,13711,13,19,6,38,46,1946
30723,30723,F23A2BC65E541459E62AB893332F31AE,42231,9,10,1,37,46,1896
30724,30724,F23A2BC65E541459E62AB893332F31AE,42351,10,11,1,38,45,1945
30725,30725,F23A2BC65E541459E62AB893332F31AE,13911,14,19,5,39,46,1996
30726,30726,F23A2BC65E541459E62AB893332F31AE,42231,19,22,3,37,46,1896
30727,30727,ACFB892F60074737B9E0F9A496FA6823,42861,0,4,4,37,44,1894
30728,30728,ACFB892F60074737B9E0F9A496FA6823,42151,4,12,8,35,45,1795
30729,30729,ACFB892F60074737B9E0F9A496FA6823,42861,12,13,1,37,44,1894
30730,30730,ACFB892F60074737B9E0F9A496FA6823,42151,17,19,2,35,45,1795
30731,30731,33E38F12F8713108E12BCC9991D28568,43621,5,17,12,46,48,2348
30732,30732,33E38F12F8713108E12BCC9991D28568,41393,19,20,1,43,49,2199
30733,30733,33E38F12F8713108E12BCC9991D28568,42461,22,23,1,45,47,2297
30750,30750,EA7259828C59286A0C8476F89AAE54B8,42351,0,5,5,38,45,1945
30751,30751,EA7259828C59286A0C8476F89AAE54B8,11261,6,9,3,36,46,1846
30752,30752,EA7259828C59286A0C8476F89AAE54B8,42351,9,11,2,38,45,1945
30753,30753,EA7259828C59286A0C8476F89AAE54B8,11261,11,21,10,36,46,1846
30760,30760,946768BFA72752D5660750415178C67F,13601,1,7,6,34,47,1747
30761,30761,946768BFA72752D5660750415178C67F,11081,8,15,7,35,46,1796
30762,30762,946768BFA72752D5660750415178C67F,11021,17,18,1,36,49,1849
30763,30763,946768BFA72752D5660750415178C67F,40925,22,23,1,35,49,1799
30770,30770,C10A062A2E87C521BC7FE101323C323B,11381,1,3,2,30,47,1547
30771,30771,C10A062A2E87C521BC7FE101323C323B,10731,3,14,11,33,47,1697
30772,30772,C10A062A2E87C521BC7FE101323C323B,13601,14,23,9,34,47,1747
30777,30777,1E7B4221778C83E8FB5E586229CF5577,19901,0,13,13,7,44,394
30778,30778,1E7B4221778C83E8FB5E586229CF5577,12641,14,15,1,10,43,543
30779,30779,1E7B4221778C83E8FB5E586229CF5577,19901,20,23,3,7,44,394
30794,30794,BD4F1B02E335A606DD6849B8E89B0BA2,42531,0,18,18,31,45,1595
30795,30795,BD4F1B02E335A606DD6849B8E89B0BA2,12311,19,20,1,30,44,1544
30796,30796,BD4F1B02E335A606DD6849B8E89B0BA2,42531,20,23,3,31,45,1595
30801,30801,2BDE8FA893331A6AAEB29301A411BFB4,42141,3,13,10,32,47,1647
30802,30802,2BDE8FA893331A6AAEB29301A411BFB4,10281,17,18,1,33,48,1698
30803,30803,2BDE8FA893331A6AAEB29301A411BFB4,11861,19,20,1,32,47,1647
30804,30804,BD8F20B7B297286F95E7BD281FB1B8D2,10771,0,6,6,41,46,2096
30805,30805,BD8F20B7B297286F95E7BD281FB1B8D2,13841,7,8,1,40,46,2046
30806,30806,BD8F20B7B297286F95E7BD281FB1B8D2,10771,16,20,4,41,46,2096
30821,30821,FB5A872D0FAE7AA0035523EB5DBD36C2,11324,0,7,7,31,46,1596
30822,30822,FB5A872D0FAE7AA0035523EB5DBD36C2,43761,7,8,1,32,47,1647
30823,30823,FB5A872D0FAE7AA0035523EB5DBD36C2,43581,12,17,5,33,48,1698
30824,30824,FB5A872D0FAE7AA0035523EB5DBD36C2,11324,19,22,3,31,46,1596
30830,30830,E859A0BF6FB37F9B42DF06EC7EE8FF9D,42461,0,6,6,45,47,2297
30831,30831,E859A0BF6FB37F9B42DF06EC7EE8FF9D,42321,10,18,8,43,47,2197
30832,30832,E859A0BF6FB37F9B42DF06EC7EE8FF9D,42461,18,23,5,45,47,2297
30840,30840,56577D7E072F237C8DE51C5D025371C7,10121,0,4,4,36,49,1849
30841,30841,56577D7E072F237C8DE51C5D025371C7,13561,4,5,1,37,49,1899
30842,30842,56577D7E072F237C8DE51C5D025371C7,10121,5,20,15,36,49,1849
30847,30847,EAD22166B32AC453F1024BFF97D86E27,43161,3,5,2,35,47,1797
30848,30848,EAD22166B32AC453F1024BFF97D86E27,42944,6,8,2,37,47,1897
30849,30849,EAD22166B32AC453F1024BFF97D86E27,42301,8,18,10,36,47,1847
30850,30850,F14B27CFA07BFF1C03E8748CE04AA105,10341,0,8,8,31,47,1597
30851,30851,F14B27CFA07BFF1C03E8748CE04AA105,11061,12,13,1,29,48,1498
30852,30852,F14B27CFA07BFF1C03E8748CE04AA105,10341,17,23,6,31,47,1597
30853,30853,E16566CAC1D2263C830A92E3D7A4B3A9,42351,0,3,3,38,45,1945
30854,30854,E16566CAC1D2263C830A92E3D7A4B3A9,13911,4,6,2,39,46,1996
30855,30855,E16566CAC1D2263C830A92E3D7A4B3A9,42231,6,19,13,37,46,1896
30877,30877,19A29A27E6506D34C07A04E6E9F52A03,42151,0,10,10,35,45,1795
30878,30878,19A29A27E6506D34C07A04E6E9F52A03,12491,13,14,1,36,43,1843
30879,30879,19A29A27E6506D34C07A04E6E9F52A03,42151,18,22,4,35,45,1795
30880,30880,59FC4B0A6BC49CDF01B844E5DEB53370,11231,0,13,13,37,49,1899
30881,30881,59FC4B0A6BC49CDF01B844E5DEB53370,43281,14,16,2,37,48,1898
30882,30882,59FC4B0A6BC49CDF01B844E5DEB53370,11231,16,23,7,37,49,1899
30891,30891,644074FAED2D07B771DBBC3C2ED7ABF4,13411,0,6,6,49,42,2492
30892,30892,644074FAED2D07B771DBBC3C2ED7ABF4,43951,6,20,14,49,41,2491
30893,30893,644074FAED2D07B771DBBC3C2ED7ABF4,13411,21,23,2,49,42,2492
30903,30903,660D2150C1391153938CD9B90E2CE919,12641,0,4,4,10,43,543
30904,30904,660D2150C1391153938CD9B90E2CE919,19021,6,17,11,10,45,545
30905,30905,660D2150C1391153938CD9B90E2CE919,12641,20,23,3,10,43,543
30911,30911,394D700E14C58A7853C10805B183B24E,11061,5,7,2,29,48,1498
30912,30912,394D700E14C58A7853C10805B183B24E,11875,10,18,8,30,46,1546
30913,30913,394D700E14C58A7853C10805B183B24E,10381,21,22,1,31,49,1599
30914,30914,2D7ACF8AD7E4B49F2A7FD23DB75DC6F1,42971,0,6,6,43,49,2199
30915,30915,2D7ACF8AD7E4B49F2A7FD23DB75DC6F1,11741,6,10,4,42,49,2149
30916,30916,2D7ACF8AD7E4B49F2A7FD23DB75DC6F1,42971,12,23,11,43,49,2199
30922,30922,A655C67D52402CE056E16AFA14815F89,13101,1,2,1,40,47,2047
30923,30923,A655C67D52402CE056E16AFA14815F89,11481,3,5,2,41,48,2098
30924,30924,A655C67D52402CE056E16AFA14815F89,13271,6,21,15,41,47,2097
30943,30943,AE931B79E80BF3CFA2F48EF7F9685CA5,11261,3,8,5,36,46,1846
30944,30944,AE931B79E80BF3CFA2F48EF7F9685CA5,12491,9,11,2,36,43,1843
30945,30945,AE931B79E80BF3CFA2F48EF7F9685CA5,11261,13,23,10,36,46,1846
30946,30946,52A3E1CE4491060F392925C38B78647A,10841,8,12,4,37,47,1897
30947,30947,52A3E1CE4491060F392925C38B78647A,11591,13,14,1,36,49,1849
30948,30948,52A3E1CE4491060F392925C38B78647A,10841,19,20,1,37,47,1897
30949,30949,83BB102D42B106B02532A9E858086CAC,11061,0,12,12,29,48,1498
30950,30950,83BB102D42B106B02532A9E858086CAC,10681,18,19,1,30,48,1548
30951,30951,83BB102D42B106B02532A9E858086CAC,11061,20,22,2,29,48,1498
30959,30959,6EF69708DD923556D4EF232AA0406F1C,42231,0,13,13,37,46,1896
30960,30960,6EF69708DD923556D4EF232AA0406F1C,42351,15,17,2,38,45,1945
30961,30961,6EF69708DD923556D4EF232AA0406F1C,13711,18,19,1,38,46,1946
30962,30962,6EF69708DD923556D4EF232AA0406F1C,11941,21,23,2,37,46,1896
30976,30976,177168A1104485CCD77EDFA93575365C,12381,0,16,16,32,48,1648
30977,30977,177168A1104485CCD77EDFA93575365C,11731,17,19,2,36,48,1848
30978,30978,177168A1104485CCD77EDFA93575365C,11751,20,22,2,35,48,1798
31002,31002,52ACC485A3B15823424685D0F282776F,10841,0,11,11,37,47,1897
31003,31003,52ACC485A3B15823424685D0F282776F,11921,15,16,1,38,48,1948
31004,31004,52ACC485A3B15823424685D0F282776F,42231,18,19,1,37,46,1896
31008,31008,13BC89BF4CB2126BDBED6033269CBB6A,12641,0,7,7,10,43,543
31009,31009,13BC89BF4CB2126BDBED6033269CBB6A,19021,7,11,4,10,45,545
31010,31010,13BC89BF4CB2126BDBED6033269CBB6A,12641,12,21,9,10,43,543
31011,31011,A923C41770F47C64367C4A31C06C83C7,10292,2,13,11,30,47,1547
31012,31012,A923C41770F47C64367C4A31C06C83C7,42523,15,19,4,31,47,1597
31013,31013,A923C41770F47C64367C4A31C06C83C7,10292,19,20,1,30,47,1547
31026,31026,1DA79481C6B6D1D9223A378A0D81757A,10111,0,13,13,37,47,1897
31027,31027,1DA79481C6B6D1D9223A378A0D81757A,11331,14,16,2,37,48,1898
31028,31028,1DA79481C6B6D1D9223A378A0D81757A,10111,16,23,7,37,47,1897
31042,31042,BBA22655B692982B5517C3B173267A4A,19051,0,6,6,16,23,823
31043,31043,BBA22655B692982B5517C3B173267A4A,15371,7,16,9,15,22,772
31044,31044,BBA22655B692982B5517C3B173267A4A,19051,19,21,2,16,23,823
31050,31050,E9E990F48245ACFDBDC8F1C95015FE95,42511,0,8,8,37,47,1897
31051,31051,E9E990F48245ACFDBDC8F1C95015FE95,13121,8,12,4,38,46,1946
31052,31052,E9E990F48245ACFDBDC8F1C95015FE95,40124,14,20,6,38,47,1947
31053,31053,F0D6A0DD95FECBA9B8057DD90C2A5CED,11381,1,2,1,30,47,1547
31054,31054,F0D6A0DD95FECBA9B8057DD90C2A5CED,11061,5,7,2,29,48,1498
31055,31055,F0D6A0DD95FECBA9B8057DD90C2A5CED,10681,8,15,7,30,48,1548
31056,31056,F0D6A0DD95FECBA9B8057DD90C2A5CED,11381,16,23,7,30,47,1547
31061,31061,1CE5F4D10EE2FB173CB9F2BC0746661A,42531,0,1,1,31,45,1595
31062,31062,1CE5F4D10EE2FB173CB9F2BC0746661A,12311,1,11,10,30,44,1544
31063,31063,1CE5F4D10EE2FB173CB9F2BC0746661A,42531,12,22,10,31,45,1595
31078,31078,50AD8ACDABF8BBC007C0D64420D91B51,12381,10,12,2,32,48,1648
31079,31079,50AD8ACDABF8BBC007C0D64420D91B51,11861,12,14,2,32,47,1647
31080,31080,50AD8ACDABF8BBC007C0D64420D91B51,12381,15,18,3,32,48,1648
31081,31081,50AD8ACDABF8BBC007C0D64420D91B51,11861,20,23,3,32,47,1647
31082,31082,013FCD4AD29F7B39A4D2C5FDC4F1DF38,42401,0,8,8,36,47,1847
31083,31083,013FCD4AD29F7B39A4D2C5FDC4F1DF38,10111,9,19,10,37,47,1897
31084,31084,013FCD4AD29F7B39A4D2C5FDC4F1DF38,42401,20,23,3,36,47,1847
31088,31088,394B81CC36B31D897120A6153D7C1457,11061,0,2,2,29,48,1498
31089,31089,394B81CC36B31D897120A6153D7C1457,42501,7,16,9,28,47,1447
31090,31090,394B81CC36B31D897120A6153D7C1457,11061,18,23,5,29,48,1498
31096,31096,4560AA6E9FF5488D13E472C26129D09F,42301,0,6,6,36,47,1847
31097,31097,4560AA6E9FF5488D13E472C26129D09F,12514,7,12,5,38,47,1947
31098,31098,4560AA6E9FF5488D13E472C26129D09F,42511,16,17,1,37,47,1897
31099,31099,4560AA6E9FF5488D13E472C26129D09F,12514,21,23,2,38,47,1947
31100,31100,B54975B2A820370FFF355FA7E33D956D,42401,0,3,3,36,47,1847
31101,31101,B54975B2A820370FFF355FA7E33D956D,10251,5,9,4,35,47,1797
31102,31102,B54975B2A820370FFF355FA7E33D956D,42301,13,23,10,36,47,1847
31108,31108,5AC2D6E8C66247063F49530DBE7AF221,10251,1,3,2,35,47,1797
31109,31109,5AC2D6E8C66247063F49530DBE7AF221,43731,4,9,5,34,47,1747
31110,31110,5AC2D6E8C66247063F49530DBE7AF221,10251,11,13,2,35,47,1797
31111,31111,5AC2D6E8C66247063F49530DBE7AF221,11081,16,21,5,35,46,1796
31112,31112,A43D5D4A5B684572DED832EF1C15CC22,11261,2,5,3,36,46,1846
31113,31113,A43D5D4A5B684572DED832EF1C15CC22,13231,7,9,2,39,46,1996
31114,31114,A43D5D4A5B684572DED832EF1C15CC22,11261,9,23,14,36,46,1846
31119,31119,3F271425F5D5BA7FEC9D1C93CCBA4B72,13941,0,11,11,41,47,2097
31120,31120,3F271425F5D5BA7FEC9D1C93CCBA4B72,11001,12,16,4,42,47,2147
31121,31121,3F271425F5D5BA7FEC9D1C93CCBA4B72,13941,16,19,3,41,47,2097
31147,31147,00B181DD66423FB09C5417E3C6EB3025,13941,0,6,6,41,47,2097
31148,31148,00B181DD66423FB09C5417E3C6EB3025,11001,9,15,6,42,47,2147
31149,31149,00B181DD66423FB09C5417E3C6EB3025,13371,18,23,5,41,47,2097
31150,31150,9C007195A690CE7A18A8403A683FC752,43391,0,8,8,29,48,1498
31151,31151,9C007195A690CE7A18A8403A683FC752,11151,11,14,3,30,48,1548
31152,31152,9C007195A690CE7A18A8403A683FC752,43391,14,23,9,29,48,1498
31164,31164,9F7BD4B191C6CDB262073FE9BC5F12C5,11381,0,7,7,30,47,1547
31165,31165,9F7BD4B191C6CDB262073FE9BC5F12C5,11061,7,8,1,29,48,1498
31166,31166,9F7BD4B191C6CDB262073FE9BC5F12C5,11381,13,19,6,30,47,1547
31171,31171,8E0D20320C5276BDD797BA6D65B9C51D,11074,0,7,7,37,47,1897
31172,31172,8E0D20320C5276BDD797BA6D65B9C51D,11231,8,18,10,37,49,1899
31173,31173,8E0D20320C5276BDD797BA6D65B9C51D,11074,19,23,4,37,47,1897
31188,31188,A25BD81EC9134E523B096ACC3062CFB1,40833,0,7,7,41,47,2097
31189,31189,A25BD81EC9134E523B096ACC3062CFB1,40171,16,18,2,38,48,1948
31190,31190,A25BD81EC9134E523B096ACC3062CFB1,40833,21,23,2,41,47,2097
31191,31191,511248B31413344B77C12D74A5EE7CDF,43471,0,6,6,31,49,1599
31192,31192,511248B31413344B77C12D74A5EE7CDF,11151,7,12,5,30,48,1548
31193,31193,511248B31413344B77C12D74A5EE7CDF,43391,14,21,7,29,48,1498
31194,31194,511248B31413344B77C12D74A5EE7CDF,43471,22,23,1,31,49,1599
31195,31195,325B301C16FB3DB9C4CED544F7B2E787,10471,0,4,4,37,48,1898
31196,31196,325B301C16FB3DB9C4CED544F7B2E787,42191,4,7,3,38,49,1949
31197,31197,325B301C16FB3DB9C4CED544F7B2E787,11271,8,21,13,37,48,1898
31202,31202,71CDB42BF8ABF4C8B89BDC81F92C39B7,10634,0,14,14,27,45,1395
31203,31203,71CDB42BF8ABF4C8B89BDC81F92C39B7,12601,15,16,1,25,47,1297
31204,31204,71CDB42BF8ABF4C8B89BDC81F92C39B7,10634,19,23,4,27,45,1395
31213,31213,A09953F67FED80A8C2308F84F83FE6DA,42011,2,6,4,36,46,1846
31214,31214,A09953F67FED80A8C2308F84F83FE6DA,13711,7,11,4,38,46,1946
31215,31215,A09953F67FED80A8C2308F84F83FE6DA,43241,16,22,6,36,46,1846
31216,31216,FAA5294A962477DF58D88724F4B906AF,12651,3,15,12,43,47,2197
31217,31217,FAA5294A962477DF58D88724F4B906AF,43621,17,18,1,46,48,2348
31218,31218,FAA5294A962477DF58D88724F4B906AF,12651,18,20,2,43,47,2197
31219,31219,9E981569C6718F42D2105C2620CE51EF,42461,0,6,6,45,47,2297
31220,31220,9E981569C6718F42D2105C2620CE51EF,42321,7,18,11,43,47,2197
31221,31221,9E981569C6718F42D2105C2620CE51EF,40691,20,21,1,42,48,2148
31222,31222,288D369FF27C2F58011E60F4D93BD67B,11061,0,15,15,29,48,1498
31223,31223,288D369FF27C2F58011E60F4D93BD67B,11381,15,17,2,30,47,1547
31224,31224,288D369FF27C2F58011E60F4D93BD67B,43761,19,20,1,32,47,1647
31225,31225,288D369FF27C2F58011E60F4D93BD67B,11061,21,23,2,29,48,1498
31226,31226,5C81004482023832AD545CD8F1DA1576,13911,0,6,6,39,46,1996
31227,31227,5C81004482023832AD545CD8F1DA1576,42231,6,18,12,37,46,1896
31228,31228,5C81004482023832AD545CD8F1DA1576,13911,21,23,2,39,46,1996
31229,31229,641C859EE2F1D414BC3BD88280CA45F9,11861,0,13,13,32,47,1647
31230,31230,641C859EE2F1D414BC3BD88280CA45F9,11211,16,17,1,34,49,1749
31231,31231,641C859EE2F1D414BC3BD88280CA45F9,11861,18,23,5,32,47,1647
31232,31232,445A90121514A82FCCD431DD3088A581,11381,7,10,3,30,47,1547
31233,31233,445A90121514A82FCCD431DD3088A581,11861,11,13,2,32,47,1647
31234,31234,445A90121514A82FCCD431DD3088A581,11381,14,17,3,30,47,1547
31235,31235,445A90121514A82FCCD431DD3088A581,10281,18,20,2,33,48,1698
31241,31241,69E543DFF7ABD4903EB302CAAC6962DA,42581,1,7,6,38,48,1948
31242,31242,69E543DFF7ABD4903EB302CAAC6962DA,11021,8,11,3,36,49,1849
31243,31243,69E543DFF7ABD4903EB302CAAC6962DA,42471,12,17,5,35,49,1799
31244,31244,69E543DFF7ABD4903EB302CAAC6962DA,11074,20,22,2,37,47,1897
31252,31252,0FCC9992AE8D71AAE404BB0E597A281E,11861,0,5,5,32,47,1647
31253,31253,0FCC9992AE8D71AAE404BB0E597A281E,10221,5,18,13,34,49,1749
31254,31254,0FCC9992AE8D71AAE404BB0E597A281E,11861,19,23,4,32,47,1647
31255,31255,DF460CBD4C09A51D06C2038FDA368680,42041,0,7,7,10,47,547
31256,31256,DF460CBD4C09A51D06C2038FDA368680,19441,11,21,10,8,46,446
31257,31257,DF460CBD4C09A51D06C2038FDA368680,42041,22,23,1,10,47,547
31258,31258,24CACD73BA8D75767DDD668E5EA165E2,40171,0,10,10,38,48,1948
31259,31259,24CACD73BA8D75767DDD668E5EA165E2,11914,13,18,5,37,48,1898
31260,31260,24CACD73BA8D75767DDD668E5EA165E2,42191,21,23,2,38,49,1949
31261,31261,9793A85FD5F8245DB87C881D3A802622,12661,0,13,13,32,45,1645
31262,31262,9793A85FD5F8245DB87C881D3A802622,10351,16,18,2,28,45,1445
31263,31263,9793A85FD5F8245DB87C881D3A802622,12661,20,23,3,32,45,1645
31264,31264,520F9ABAA156FE9FB29070D4A540240C,10111,0,13,13,37,47,1897
31265,31265,520F9ABAA156FE9FB29070D4A540240C,10411,14,19,5,36,48,1848
31266,31266,520F9ABAA156FE9FB29070D4A540240C,10971,21,23,2,35,47,1797
31267,31267,582FCEF67ED9C80E5B2E8667690F61FB,42221,0,6,6,38,48,1948
31268,31268,582FCEF67ED9C80E5B2E8667690F61FB,42401,8,12,4,36,47,1847
31269,31269,582FCEF67ED9C80E5B2E8667690F61FB,42221,12,16,4,38,48,1948
31270,31270,582FCEF67ED9C80E5B2E8667690F61FB,42401,17,22,5,36,47,1847
31271,31271,504467700DDD1C036193CD82D6D3619F,42521,2,6,4,31,47,1597
31272,31272,504467700DDD1C036193CD82D6D3619F,43761,8,14,6,32,47,1647
31273,31273,504467700DDD1C036193CD82D6D3619F,42521,17,18,1,31,47,1597
31274,31274,504467700DDD1C036193CD82D6D3619F,42501,19,21,2,28,47,1447
31275,31275,11FECEE7865049CDA55CAB34FACD3089,42871,0,6,6,30,45,1545
31276,31276,11FECEE7865049CDA55CAB34FACD3089,11875,10,11,1,30,46,1546
31277,31277,11FECEE7865049CDA55CAB34FACD3089,11871,12,15,3,29,46,1496
31278,31278,11FECEE7865049CDA55CAB34FACD3089,11875,17,19,2,30,46,1546
31282,31282,5AB9A6057AD5B34AE6E536DE14E09EFB,43951,0,6,6,49,41,2491
31283,31283,5AB9A6057AD5B34AE6E536DE14E09EFB,43101,8,21,13,46,40,2340
31284,31284,5AB9A6057AD5B34AE6E536DE14E09EFB,43951,21,23,2,49,41,2491
31294,31294,6BE007D5C8B4993AD32E52C9999BE064,42961,0,9,9,35,49,1799
31295,31295,6BE007D5C8B4993AD32E52C9999BE064,11531,17,19,2,34,49,1749
31296,31296,6BE007D5C8B4993AD32E52C9999BE064,40271,19,23,4,35,49,1799
31297,31297,A86A2549CD02B65958808F3EC9B7BFBD,13911,1,2,1,39,46,1996
31298,31298,A86A2549CD02B65958808F3EC9B7BFBD,11261,6,8,2,36,46,1846
31299,31299,A86A2549CD02B65958808F3EC9B7BFBD,13911,8,13,5,39,46,1996
31300,31300,A86A2549CD02B65958808F3EC9B7BFBD,11261,14,18,4,36,46,1846
31315,31315,DC9866094212A637CCAC17CF01FE4B5F,42861,0,5,5,37,44,1894
31316,31316,DC9866094212A637CCAC17CF01FE4B5F,11261,6,16,10,36,46,1846
31317,31317,DC9866094212A637CCAC17CF01FE4B5F,42861,20,23,3,37,44,1894
31318,31318,A06465C33822DBAACCFCA67CF792360D,10295,0,14,14,30,47,1547
31319,31319,A06465C33822DBAACCFCA67CF792360D,42523,14,16,2,31,47,1597
31320,31320,A06465C33822DBAACCFCA67CF792360D,10295,18,23,5,30,47,1547
31321,31321,2BC714C204CBBFEE616B46CC493E087B,12641,0,5,5,10,43,543
31322,31322,2BC714C204CBBFEE616B46CC493E087B,12921,6,8,2,9,41,491
31323,31323,2BC714C204CBBFEE616B46CC493E087B,12641,12,20,8,10,43,543
31327,31327,0BC1BC9FA127A76D4558FF0A0EC8FEFB,42921,0,7,7,33,47,1697
31328,31328,0BC1BC9FA127A76D4558FF0A0EC8FEFB,10281,7,8,1,33,48,1698
31329,31329,0BC1BC9FA127A76D4558FF0A0EC8FEFB,10731,10,21,11,33,47,1697
31335,31335,D9FB9F3F4820A4EF951566780A770C45,11261,0,17,17,36,46,1846
31336,31336,D9FB9F3F4820A4EF951566780A770C45,13711,19,20,1,38,46,1946
31337,31337,D9FB9F3F4820A4EF951566780A770C45,11261,21,22,1,36,46,1846
31342,31342,64EA873D359181A561255128009EB239,42581,0,5,5,38,48,1948
31343,31343,64EA873D359181A561255128009EB239,11914,8,10,2,37,48,1898
31344,31344,64EA873D359181A561255128009EB239,42581,12,13,1,38,48,1948
31345,31345,64EA873D359181A561255128009EB239,11914,13,18,5,37,48,1898
31346,31346,FCC81FB1D89F2E284C3312E5101F2149,42151,0,6,6,35,45,1795
31347,31347,FCC81FB1D89F2E284C3312E5101F2149,42861,10,13,3,37,44,1894
31348,31348,FCC81FB1D89F2E284C3312E5101F2149,42151,15,23,8,35,45,1795
31349,31349,92BAAFB07F1C4AA0FACBFB608DF088FA,42921,0,10,10,33,47,1697
31350,31350,92BAAFB07F1C4AA0FACBFB608DF088FA,42523,12,14,2,31,47,1597
31351,31351,92BAAFB07F1C4AA0FACBFB608DF088FA,42921,18,21,3,33,47,1697
31357,31357,829F3CF969A99106A0CF5C6D0ED0FE14,42401,0,8,8,36,47,1847
31358,31358,829F3CF969A99106A0CF5C6D0ED0FE14,11751,9,16,7,35,48,1798
31359,31359,829F3CF969A99106A0CF5C6D0ED0FE14,10251,16,23,7,35,47,1797
31365,31365,B7832DB383CB1E7DD6C87A81AAE89D66,11231,2,6,4,37,49,1899
31366,31366,B7832DB383CB1E7DD6C87A81AAE89D66,10901,6,20,14,35,48,1798
31367,31367,B7832DB383CB1E7DD6C87A81AAE89D66,11231,20,23,3,37,49,1899
31368,31368,442785976ECE3A21AB2E12E8FCC04E3B,42523,0,3,3,31,47,1597
31369,31369,442785976ECE3A21AB2E12E8FCC04E3B,42491,4,17,13,32,46,1646
31370,31370,442785976ECE3A21AB2E12E8FCC04E3B,42523,18,19,1,31,47,1597
31375,31375,0C3EDD26A7ED891A1146E2AB7A623C19,10151,0,9,9,34,47,1747
31376,31376,0C3EDD26A7ED891A1146E2AB7A623C19,10971,9,18,9,35,47,1797
31377,31377,0C3EDD26A7ED891A1146E2AB7A623C19,10151,19,23,4,34,47,1747
31378,31378,A233EC2C10A5C170549589E5B7B99B60,42221,0,13,13,38,48,1948
31379,31379,A233EC2C10A5C170549589E5B7B99B60,11074,14,20,6,37,47,1897
31380,31380,A233EC2C10A5C170549589E5B7B99B60,42221,20,23,3,38,48,1948
31381,31381,A1C6C79563B181B2396F4DF08F5629AA,42151,0,7,7,35,45,1795
31382,31382,A1C6C79563B181B2396F4DF08F5629AA,12661,10,11,1,32,45,1645
31383,31383,A1C6C79563B181B2396F4DF08F5629AA,42151,11,22,11,35,45,1795
31384,31384,215C2968B2146DB0591170CF91F3A17C,11461,0,1,1,37,49,1899
31385,31385,215C2968B2146DB0591170CF91F3A17C,10471,2,7,5,37,48,1898
31386,31386,215C2968B2146DB0591170CF91F3A17C,11201,8,20,12,35,49,1799
31387,31387,215C2968B2146DB0591170CF91F3A17C,10471,22,23,1,37,48,1898
31393,31393,31CDF80C6F6D99CDF02165EC65D6A959,42041,2,4,2,10,47,547
31394,31394,31CDF80C6F6D99CDF02165EC65D6A959,19441,5,22,17,8,46,446
31395,31395,31CDF80C6F6D99CDF02165EC65D6A959,42041,22,23,1,10,47,547
31396,31396,F6D5F0720A4C82E72FD0C591B5570DDC,11951,0,8,8,31,49,1599
31397,31397,F6D5F0720A4C82E72FD0C591B5570DDC,10431,12,16,4,33,49,1699
31398,31398,F6D5F0720A4C82E72FD0C591B5570DDC,11951,20,22,2,31,49,1599
31404,31404,863093DB11F1063670E11FFAF49890AF,43061,0,15,15,43,46,2196
31405,31405,863093DB11F1063670E11FFAF49890AF,13341,16,17,1,44,45,2245
31406,31406,863093DB11F1063670E11FFAF49890AF,43061,18,22,4,43,46,2196
31407,31407,8CD5156CF883DA15618BAFE58DDCF2A7,42581,0,7,7,38,48,1948
31408,31408,8CD5156CF883DA15618BAFE58DDCF2A7,11914,10,18,8,37,48,1898
31409,31409,8CD5156CF883DA15618BAFE58DDCF2A7,42581,21,23,2,38,48,1948
31410,31410,0E15468F284D0B2CB2F3413AC7772E23,43581,0,5,5,33,48,1698
31411,31411,0E15468F284D0B2CB2F3413AC7772E23,43731,7,15,8,34,47,1747
31412,31412,0E15468F284D0B2CB2F3413AC7772E23,12031,19,23,4,33,48,1698
31417,31417,D7349708A10855AEF98FEB8D22C33E59,10601,0,7,7,39,47,1997
31418,31418,D7349708A10855AEF98FEB8D22C33E59,11231,8,15,7,37,49,1899
31419,31419,D7349708A10855AEF98FEB8D22C33E59,13271,20,23,3,41,47,2097
31420,31420,5AF85D9ED958D0E5348613692DAC5B4D,11201,0,3,3,35,49,1799
31421,31421,5AF85D9ED958D0E5348613692DAC5B4D,12083,5,16,11,36,49,1849
31422,31422,5AF85D9ED958D0E5348613692DAC5B4D,43581,20,23,3,33,48,1698
31440,31440,9D7E28E179E5F5D009F8D277D0F434A8,42021,1,5,4,33,47,1697
31441,31441,9D7E28E179E5F5D009F8D277D0F434A8,11861,7,8,1,32,47,1647
31442,31442,9D7E28E179E5F5D009F8D277D0F434A8,10281,9,12,3,33,48,1698
31443,31443,9D7E28E179E5F5D009F8D277D0F434A8,11861,12,23,11,32,47,1647
31444,31444,DFA092DF7A7BEEE404201371239AEE7A,11231,0,13,13,37,49,1899
31445,31445,DFA092DF7A7BEEE404201371239AEE7A,10841,14,15,1,37,47,1897
31446,31446,DFA092DF7A7BEEE404201371239AEE7A,10371,15,21,6,37,49,1899
31451,31451,D9B0439F3B0C81F4C0A4571FAB2A3A71,42021,6,7,1,33,47,1697
31452,31452,D9B0439F3B0C81F4C0A4571FAB2A3A71,11861,8,14,6,32,47,1647
31453,31453,D9B0439F3B0C81F4C0A4571FAB2A3A71,42021,17,19,2,33,47,1697
31454,31454,C7859131FC5613A278444EF81B856AED,42511,2,9,7,37,47,1897
31455,31455,C7859131FC5613A278444EF81B856AED,13711,14,15,1,38,46,1946
31456,31456,C7859131FC5613A278444EF81B856AED,42511,15,19,4,37,47,1897
31460,31460,4B5C492CF16B079882322240829D6566,43281,0,6,6,37,48,1898
31461,31461,4B5C492CF16B079882322240829D6566,40502,7,8,1,36,48,1848
31462,31462,4B5C492CF16B079882322240829D6566,11231,9,20,11,37,49,1899
31463,31463,4B5C492CF16B079882322240829D6566,43281,22,23,1,37,48,1898
31489,31489,55DF1B2532956BA775A076A4B2BFF792,12121,1,7,6,29,47,1497
31490,31490,55DF1B2532956BA775A076A4B2BFF792,11381,10,11,1,30,47,1547
31491,31491,55DF1B2532956BA775A076A4B2BFF792,12121,13,21,8,29,47,1497
31492,31492,55DF1B2532956BA775A076A4B2BFF792,11381,21,22,1,30,47,1547
31498,31498,F65E3BB6EC86C48CCE482A30FA9EC6F6,43361,10,12,2,38,48,1948
31499,31499,F65E3BB6EC86C48CCE482A30FA9EC6F6,10841,13,15,2,37,47,1897
31500,31500,F65E3BB6EC86C48CCE482A30FA9EC6F6,43361,16,22,6,38,48,1948
31507,31507,0E4B3B25FE0CAB1DCA768980553C13E7,42791,0,8,8,35,45,1795
31508,31508,0E4B3B25FE0CAB1DCA768980553C13E7,12661,10,14,4,32,45,1645
31509,31509,0E4B3B25FE0CAB1DCA768980553C13E7,42151,17,18,1,35,45,1795
31510,31510,0E4B3B25FE0CAB1DCA768980553C13E7,12661,19,21,2,32,45,1645
31516,31516,3EA1DA94379F7679CA011B08D7D44EE7,13911,0,11,11,39,46,1996
31517,31517,3EA1DA94379F7679CA011B08D7D44EE7,42231,15,16,1,37,46,1896
31518,31518,3EA1DA94379F7679CA011B08D7D44EE7,13911,19,23,4,39,46,1996
31519,31519,3F29D0D409D1B6D4E7D2087740FD0BBC,40673,0,7,7,36,48,1848
31520,31520,3F29D0D409D1B6D4E7D2087740FD0BBC,42401,8,16,8,36,47,1847
31521,31521,3F29D0D409D1B6D4E7D2087740FD0BBC,10251,18,23,5,35,47,1797
31522,31522,0C2B805EE888E91F034AB21F925F07C4,19901,4,6,2,7,44,394
31523,31523,0C2B805EE888E91F034AB21F925F07C4,19114,7,8,1,7,43,393
31524,31524,0C2B805EE888E91F034AB21F925F07C4,12641,13,16,3,10,43,543
31525,31525,0C2B805EE888E91F034AB21F925F07C4,19901,17,20,3,7,44,394
31541,31541,878056C296B20CAD11EA9623EF308C26,11074,0,6,6,37,47,1897
31542,31542,878056C296B20CAD11EA9623EF308C26,13561,9,11,2,37,49,1899
31543,31543,878056C296B20CAD11EA9623EF308C26,13911,15,17,2,39,46,1996
31544,31544,878056C296B20CAD11EA9623EF308C26,11074,22,23,1,37,47,1897
31545,31545,DFD67893B33D33FDAA92DC71D5732DAF,10111,0,6,6,37,47,1897
31546,31546,DFD67893B33D33FDAA92DC71D5732DAF,42161,7,13,6,36,47,1847
31547,31547,DFD67893B33D33FDAA92DC71D5732DAF,10111,17,22,5,37,47,1897
31552,31552,74D96C0DB6CB17E6F272D22FC43A3C8B,13341,0,8,8,44,45,2245
31553,31553,74D96C0DB6CB17E6F272D22FC43A3C8B,42631,8,9,1,43,45,2195
31554,31554,74D96C0DB6CB17E6F272D22FC43A3C8B,12561,12,21,9,45,43,2293
31555,31555,0C993A1B5BD23944DD153F92F92FAA1E,10634,2,5,3,27,45,1395
31556,31556,0C993A1B5BD23944DD153F92F92FAA1E,10351,6,8,2,28,45,1445
31557,31557,0C993A1B5BD23944DD153F92F92FAA1E,10634,10,15,5,27,45,1395
31558,31558,0C993A1B5BD23944DD153F92F92FAA1E,10351,15,20,5,28,45,1445
31571,31571,4D0ED6C01EC55D2BA8CCC5E44CD25B70,13121,0,6,6,38,46,1946
31572,31572,4D0ED6C01EC55D2BA8CCC5E44CD25B70,11941,8,16,8,37,46,1896
31573,31573,4D0ED6C01EC55D2BA8CCC5E44CD25B70,13121,19,23,4,38,46,1946
31583,31583,28D864A9653A5DF59FCBAC3D2F34AE0A,10292,0,1,1,30,47,1547
31584,31584,28D864A9653A5DF59FCBAC3D2F34AE0A,42521,1,5,4,31,47,1597
31585,31585,28D864A9653A5DF59FCBAC3D2F34AE0A,10292,6,21,15,30,47,1547
31590,31590,0F3B9D51ABEBD568D2353EE492F4DCAE,42581,8,12,4,38,48,1948
31591,31591,0F3B9D51ABEBD568D2353EE492F4DCAE,10471,13,14,1,37,48,1898
31592,31592,0F3B9D51ABEBD568D2353EE492F4DCAE,42581,14,17,3,38,48,1948
31593,31593,0F3B9D51ABEBD568D2353EE492F4DCAE,10471,19,22,3,37,48,1898
31597,31597,2950F1088A03A09C07AF5353742B9FD8,11161,0,9,9,32,48,1648
31598,31598,2950F1088A03A09C07AF5353742B9FD8,11861,11,12,1,32,47,1647
31599,31599,2950F1088A03A09C07AF5353742B9FD8,11161,12,19,7,32,48,1648
31607,31607,ED417F95DAB52C7D5E659E5FB8F28A50,43751,0,13,13,19,48,998
31608,31608,ED417F95DAB52C7D5E659E5FB8F28A50,11361,14,15,1,22,48,1148
31609,31609,ED417F95DAB52C7D5E659E5FB8F28A50,43751,18,23,5,19,48,998
31615,31615,0ACD42FBA28A767F44D73783967C8C23,10731,0,9,9,33,47,1697
31616,31616,0ACD42FBA28A767F44D73783967C8C23,12381,9,13,4,32,48,1648
31617,31617,0ACD42FBA28A767F44D73783967C8C23,11651,14,21,7,33,47,1697
31624,31624,34742BC5A2A667B03D313FF35D998A11,11074,1,8,7,37,47,1897
31625,31625,34742BC5A2A667B03D313FF35D998A11,42161,9,12,3,36,47,1847
31626,31626,34742BC5A2A667B03D313FF35D998A11,12841,14,16,2,37,47,1897
31627,31627,34742BC5A2A667B03D313FF35D998A11,42161,20,22,2,36,47,1847
31636,31636,266D491E71A562F023DA0DFC337C4A29,10381,3,7,4,31,49,1599
31637,31637,266D491E71A562F023DA0DFC337C4A29,11061,7,17,10,29,48,1498
31638,31638,266D491E71A562F023DA0DFC337C4A29,10381,18,20,2,31,49,1599
31639,31639,266D491E71A562F023DA0DFC337C4A29,11061,21,23,2,29,48,1498
31640,31640,5DC656AE1F755A21D4CE0049D29039D4,12491,0,15,15,36,43,1843
31641,31641,5DC656AE1F755A21D4CE0049D29039D4,11261,15,17,2,36,46,1846
31642,31642,5DC656AE1F755A21D4CE0049D29039D4,12491,20,22,2,36,43,1843
31643,31643,6D66725D0B9803C07583F5B30C783245,42531,2,8,6,31,45,1595
31644,31644,6D66725D0B9803C07583F5B30C783245,12311,12,13,1,30,44,1544
31645,31645,6D66725D0B9803C07583F5B30C783245,42531,14,23,9,31,45,1595
31654,31654,7FC156843B3D799267901A1806D63598,42071,1,11,10,31,49,1599
31655,31655,7FC156843B3D799267901A1806D63598,11061,11,13,2,29,48,1498
31656,31656,7FC156843B3D799267901A1806D63598,10381,13,22,9,31,49,1599
31660,31660,D1A31315BF92416813F499B6BE6EBD54,13651,0,8,8,30,47,1547
31661,31661,D1A31315BF92416813F499B6BE6EBD54,11061,10,12,2,29,48,1498
31662,31662,D1A31315BF92416813F499B6BE6EBD54,10292,13,21,8,30,47,1547
31663,31663,9508FAE0B774FCD97D7CFB3C4BD72215,42401,7,10,3,36,47,1847
31664,31664,9508FAE0B774FCD97D7CFB3C4BD72215,10111,10,16,6,37,47,1897
31665,31665,9508FAE0B774FCD97D7CFB3C4BD72215,42401,17,20,3,36,47,1847
31666,31666,9508FAE0B774FCD97D7CFB3C4BD72215,10111,20,23,3,37,47,1897
31673,31673,806A9140D4F11D37CD665345EE97E730,12921,3,11,8,9,41,491
31674,31674,806A9140D4F11D37CD665345EE97E730,12641,12,18,6,10,43,543
31675,31675,806A9140D4F11D37CD665345EE97E730,12921,19,20,1,9,41,491
31676,31676,806A9140D4F11D37CD665345EE97E730,12641,20,22,2,10,43,543
31684,31684,A34EF6EE90ED5E41350A7E9FC6D1C785,41271,10,18,8,38,48,1948
31685,31685,A34EF6EE90ED5E41350A7E9FC6D1C785,10471,18,19,1,37,48,1898
31686,31686,A34EF6EE90ED5E41350A7E9FC6D1C785,41724,22,23,1,38,48,1948
31697,31697,FF16D1104349162E539969031BE39A02,12511,0,5,5,39,47,1997
31698,31698,FF16D1104349162E539969031BE39A02,43481,7,8,1,39,48,1998
31699,31699,FF16D1104349162E539969031BE39A02,12511,8,18,10,39,47,1997
31700,31700,FF16D1104349162E539969031BE39A02,43481,21,23,2,39,48,1998
31705,31705,5A2804F11BFBB5218C088FCAF5CDBBF4,10151,0,7,7,34,47,1747
31706,31706,5A2804F11BFBB5218C088FCAF5CDBBF4,42021,9,11,2,33,47,1697
31707,31707,5A2804F11BFBB5218C088FCAF5CDBBF4,10151,12,23,11,34,47,1747
31716,31716,21A8FB8FD140A46FF635EB531284A32F,42291,0,1,1,29,48,1498
31717,31717,21A8FB8FD140A46FF635EB531284A32F,11381,5,10,5,30,47,1547
31718,31718,21A8FB8FD140A46FF635EB531284A32F,11951,14,23,9,31,49,1599
31719,31719,8D86E284D185DE22084CD86C6BFE1A08,11875,0,13,13,30,46,1546
31720,31720,8D86E284D185DE22084CD86C6BFE1A08,12311,15,16,1,30,44,1544
31721,31721,8D86E284D185DE22084CD86C6BFE1A08,11875,18,23,5,30,46,1546
31722,31722,F2ED260BEE0CFBD7C0D8D1BC36233DE2,12121,0,15,15,29,47,1497
31723,31723,F2ED260BEE0CFBD7C0D8D1BC36233DE2,11381,15,17,2,30,47,1547
31724,31724,F2ED260BEE0CFBD7C0D8D1BC36233DE2,12121,20,21,1,29,47,1497
31725,31725,F2ED260BEE0CFBD7C0D8D1BC36233DE2,11381,21,23,2,30,47,1547
31741,31741,90B13C1A71DF735753681820FCEBD200,11261,0,6,6,36,46,1846
31742,31742,90B13C1A71DF735753681820FCEBD200,12491,6,8,2,36,43,1843
31743,31743,90B13C1A71DF735753681820FCEBD200,11261,8,9,1,36,46,1846
31744,31744,90B13C1A71DF735753681820FCEBD200,12491,12,19,7,36,43,1843
31745,31745,F2971C3C111263F217176C0D8DBD4C49,40981,0,7,7,34,47,1747
31746,31746,F2971C3C111263F217176C0D8DBD4C49,11914,11,14,3,37,48,1898
31747,31747,F2971C3C111263F217176C0D8DBD4C49,40981,17,23,6,34,47,1747
31766,31766,968EA5A531F57AB4335F924E18D6CC7A,10351,0,12,12,28,45,1445
31767,31767,968EA5A531F57AB4335F924E18D6CC7A,11875,13,16,3,30,46,1546
31768,31768,968EA5A531F57AB4335F924E18D6CC7A,10634,17,19,2,27,45,1395
31769,31769,968EA5A531F57AB4335F924E18D6CC7A,10351,22,23,1,28,45,1445
31773,31773,35DAC6756C7F4B57C2B1C6F65896CD31,10351,0,4,4,28,45,1445
31774,31774,35DAC6756C7F4B57C2B1C6F65896CD31,10634,6,13,7,27,45,1395
31775,31775,35DAC6756C7F4B57C2B1C6F65896CD31,10351,13,23,10,28,45,1445
31776,31776,AC9A35D001464E087369411DD671E08D,42301,0,7,7,36,47,1847
31777,31777,AC9A35D001464E087369411DD671E08D,42941,11,12,1,37,47,1897
31778,31778,AC9A35D001464E087369411DD671E08D,40637,15,16,1,36,47,1847
31779,31779,AC9A35D001464E087369411DD671E08D,42941,18,23,5,37,47,1897
31780,31780,8988A7990AAD8F2B86CA6DEB15ED06F4,43311,0,8,8,31,48,1598
31781,31781,8988A7990AAD8F2B86CA6DEB15ED06F4,12131,12,14,2,32,47,1647
31782,31782,8988A7990AAD8F2B86CA6DEB15ED06F4,43311,19,23,4,31,48,1598
31783,31783,9ECA5557B94DDF8D494B58216329A377,42864,2,6,4,38,44,1944
31784,31784,9ECA5557B94DDF8D494B58216329A377,42861,7,9,2,37,44,1894
31785,31785,9ECA5557B94DDF8D494B58216329A377,42864,11,13,2,38,44,1944
31786,31786,9ECA5557B94DDF8D494B58216329A377,11261,14,19,5,36,46,1846
31798,31798,806223F4E6A75E30DD9FB8BC0E922847,11151,0,8,8,30,48,1548
31799,31799,806223F4E6A75E30DD9FB8BC0E922847,11061,9,18,9,29,48,1498
31800,31800,806223F4E6A75E30DD9FB8BC0E922847,11151,19,20,1,30,48,1548
31801,31801,806223F4E6A75E30DD9FB8BC0E922847,11061,22,23,1,29,48,1498
31829,31829,1C29D823B21418CE7B076871E0859D6A,11001,0,6,6,42,47,2147
31830,31830,1C29D823B21418CE7B076871E0859D6A,13941,6,8,2,41,47,2097
31831,31831,1C29D823B21418CE7B076871E0859D6A,11001,11,23,12,42,47,2147
31835,31835,19783D60B70DD47851602F72E0868D88,12381,0,8,8,32,48,1648
31836,31836,19783D60B70DD47851602F72E0868D88,11211,8,18,10,34,49,1749
31837,31837,19783D60B70DD47851602F72E0868D88,13731,19,20,1,33,49,1699
31863,31863,656752102BA99654C7060CE5B2133D72,19114,0,6,6,7,43,393
31864,31864,656752102BA99654C7060CE5B2133D72,49201,7,11,4,7,41,391
31865,31865,656752102BA99654C7060CE5B2133D72,19114,12,13,1,7,43,393
31866,31866,656752102BA99654C7060CE5B2133D72,12921,14,18,4,9,41,491
31867,31867,0CE1530259EA66797A9FEEF237D2664E,42861,0,13,13,37,44,1894
31868,31868,0CE1530259EA66797A9FEEF237D2664E,11261,14,20,6,36,46,1846
31869,31869,0CE1530259EA66797A9FEEF237D2664E,42861,21,23,2,37,44,1894
31870,31870,C2938F6FA2A943D6DFC754D5D6C219D6,42221,0,4,4,38,48,1948
31871,31871,C2938F6FA2A943D6DFC754D5D6C219D6,10591,4,6,2,39,48,1998
31872,31872,C2938F6FA2A943D6DFC754D5D6C219D6,42221,6,13,7,38,48,1948
31873,31873,C2938F6FA2A943D6DFC754D5D6C219D6,11074,14,23,9,37,47,1897
31874,31874,99165E654E4A5840EA37FC83361CE61B,42581,0,5,5,38,48,1948
31875,31875,99165E654E4A5840EA37FC83361CE61B,11914,6,10,4,37,48,1898
31876,31876,99165E654E4A5840EA37FC83361CE61B,42581,12,14,2,38,48,1948
31877,31877,99165E654E4A5840EA37FC83361CE61B,11914,17,23,6,37,48,1898
31878,31878,0A753885BE5CDC6D1CF1B7B35F1C199C,43761,1,6,5,32,47,1647
31879,31879,0A753885BE5CDC6D1CF1B7B35F1C199C,42523,7,8,1,31,47,1597
31880,31880,0A753885BE5CDC6D1CF1B7B35F1C199C,10221,12,13,1,34,49,1749
31881,31881,0A753885BE5CDC6D1CF1B7B35F1C199C,42523,21,23,2,31,47,1597
31882,31882,612F18F83615AD18C521C0260D4FB623,11914,0,8,8,37,48,1898
31883,31883,612F18F83615AD18C521C0260D4FB623,40673,8,10,2,36,48,1848
31884,31884,612F18F83615AD18C521C0260D4FB623,11914,10,23,13,37,48,1898
31885,31885,6B8040EDBA3C7A3B7087183B1A963D8F,41392,0,7,7,43,48,2198
31886,31886,6B8040EDBA3C7A3B7087183B1A963D8F,41393,12,20,8,43,49,2199
31887,31887,6B8040EDBA3C7A3B7087183B1A963D8F,11291,20,21,1,40,49,2049
31888,31888,D44EDEFE20C6E53FAD2290D9CECCD593,19441,7,12,5,8,46,446
31889,31889,D44EDEFE20C6E53FAD2290D9CECCD593,19021,13,14,1,10,45,545
31890,31890,D44EDEFE20C6E53FAD2290D9CECCD593,19441,19,23,4,8,46,446
31895,31895,583602182C31C8E2D985404EA5592339,12641,0,6,6,10,43,543
31896,31896,583602182C31C8E2D985404EA5592339,12921,10,16,6,9,41,491
31897,31897,583602182C31C8E2D985404EA5592339,12641,21,23,2,10,43,543
31898,31898,ED0EE3E9960BCEF6967F4298DBD60F07,12641,9,12,3,10,43,543
31899,31899,ED0EE3E9960BCEF6967F4298DBD60F07,19114,16,21,5,7,43,393
31900,31900,ED0EE3E9960BCEF6967F4298DBD60F07,12641,22,23,1,10,43,543
31914,31914,B3E3F7F4BB39DF4D783E592F9F0BB965,10281,0,7,7,33,48,1698
31915,31915,B3E3F7F4BB39DF4D783E592F9F0BB965,43161,8,17,9,35,47,1797
31916,31916,B3E3F7F4BB39DF4D783E592F9F0BB965,10281,20,23,3,33,48,1698
31917,31917,43DBEEA61839592A95FC32BC8064AB85,12921,0,5,5,9,41,491
31918,31918,43DBEEA61839592A95FC32BC8064AB85,12641,10,11,1,10,43,543
31919,31919,43DBEEA61839592A95FC32BC8064AB85,12921,12,20,8,9,41,491
31920,31920,70F4E7C7C32C909D21E260DE46FC3C7A,13411,0,1,1,49,42,2492
31921,31921,70F4E7C7C32C909D21E260DE46FC3C7A,43951,11,20,9,49,41,2491
31922,31922,70F4E7C7C32C909D21E260DE46FC3C7A,13411,20,22,2,49,42,2492
31932,31932,FE84C5B6FD29AD1D9C75D32BF19FA780,42861,0,4,4,37,44,1894
31933,31933,FE84C5B6FD29AD1D9C75D32BF19FA780,11261,6,7,1,36,46,1846
31934,31934,FE84C5B6FD29AD1D9C75D32BF19FA780,42861,10,14,4,37,44,1894
31935,31935,FE84C5B6FD29AD1D9C75D32BF19FA780,11261,18,20,2,36,46,1846
31936,31936,994BA369046D8B99F80604E02227FCEB,42581,2,5,3,38,48,1948
31937,31937,994BA369046D8B99F80604E02227FCEB,11914,8,9,1,37,48,1898
31938,31938,994BA369046D8B99F80604E02227FCEB,42581,13,22,9,38,48,1948
31943,31943,7B4E6126570CADEFC5C95EC455FF20E3,11914,0,5,5,37,48,1898
31944,31944,7B4E6126570CADEFC5C95EC455FF20E3,43361,7,8,1,38,48,1948
31945,31945,7B4E6126570CADEFC5C95EC455FF20E3,11914,11,23,12,37,48,1898
31955,31955,D454F61AD8B5A1CBE1E15CE597E2F528,42301,5,7,2,36,47,1847
31956,31956,D454F61AD8B5A1CBE1E15CE597E2F528,42471,8,11,3,35,49,1799
31957,31957,D454F61AD8B5A1CBE1E15CE597E2F528,10661,11,21,10,37,49,1899
31958,31958,D511994F01F94DCFC72D9B68CBD83EAB,13511,0,1,1,34,48,1748
31959,31959,D511994F01F94DCFC72D9B68CBD83EAB,13601,2,11,9,34,47,1747
31960,31960,D511994F01F94DCFC72D9B68CBD83EAB,10251,14,21,7,35,47,1797
31961,31961,D511994F01F94DCFC72D9B68CBD83EAB,13601,21,23,2,34,47,1747
31965,31965,B20D4CCCBBF9B534BB9F26A35B371E4C,42351,0,4,4,38,45,1945
31966,31966,B20D4CCCBBF9B534BB9F26A35B371E4C,42231,8,13,5,37,46,1896
31967,31967,B20D4CCCBBF9B534BB9F26A35B371E4C,42351,14,15,1,38,45,1945
31968,31968,B20D4CCCBBF9B534BB9F26A35B371E4C,42231,15,21,6,37,46,1896
31969,31969,714D2F9E9FED92A3078B45E04B3A334E,42231,0,16,16,37,46,1896
31970,31970,714D2F9E9FED92A3078B45E04B3A334E,12841,20,21,1,37,47,1897
31971,31971,714D2F9E9FED92A3078B45E04B3A334E,42231,21,23,2,37,46,1896
31975,31975,4C8E92DBB85921608C1C92929A7A8C92,42521,0,14,14,31,47,1597
31976,31976,4C8E92DBB85921608C1C92929A7A8C92,13651,14,16,2,30,47,1547
31977,31977,4C8E92DBB85921608C1C92929A7A8C92,42521,17,23,6,31,47,1597
31978,31978,97A3B9094890860B92A31E0AAB4F3E63,10451,0,8,8,25,48,1298
31979,31979,97A3B9094890860B92A31E0AAB4F3E63,42623,18,19,1,22,49,1149
31980,31980,97A3B9094890860B92A31E0AAB4F3E63,10451,20,23,3,25,48,1298
31981,31981,1C7DBF9E53F65ED639E90C6178E9F4A9,42231,0,8,8,37,46,1896
31982,31982,1C7DBF9E53F65ED639E90C6178E9F4A9,42351,13,14,1,38,45,1945
31983,31983,1C7DBF9E53F65ED639E90C6178E9F4A9,11261,16,20,4,36,46,1846
31984,31984,1C7DBF9E53F65ED639E90C6178E9F4A9,42351,21,23,2,38,45,1945
31985,31985,2A58E967B5D668689EB5BA1D77297BD1,10511,0,7,7,35,46,1796
31986,31986,2A58E967B5D668689EB5BA1D77297BD1,10781,9,12,3,35,47,1797
31987,31987,2A58E967B5D668689EB5BA1D77297BD1,42511,16,19,3,37,47,1897
31988,31988,2A58E967B5D668689EB5BA1D77297BD1,40431,20,21,1,36,47,1847
31989,31989,1F49E26C341B3738FA1E54F232E557D3,12514,0,13,13,38,47,1947
31990,31990,1F49E26C341B3738FA1E54F232E557D3,11751,14,16,2,35,48,1798
31991,31991,1F49E26C341B3738FA1E54F232E557D3,12514,20,23,3,38,47,1947
31992,31992,DF7E4D4B4D8F7FF887F0F74560FD3F47,11021,0,11,11,36,49,1849
31993,31993,DF7E4D4B4D8F7FF887F0F74560FD3F47,10161,12,14,2,35,49,1799
31994,31994,DF7E4D4B4D8F7FF887F0F74560FD3F47,11021,18,23,5,36,49,1849
32013,32013,F2C0EE842BDF17F50106FE208FFEF411,10511,0,11,11,35,46,1796
32014,32014,F2C0EE842BDF17F50106FE208FFEF411,11841,13,14,1,33,46,1696
32015,32015,F2C0EE842BDF17F50106FE208FFEF411,42511,16,19,3,37,47,1897
32016,32016,F2C0EE842BDF17F50106FE208FFEF411,10781,19,21,2,35,47,1797
32022,32022,A9A3A3D193DC50B4BBAF47FFC9E9C2E1,42771,0,14,14,36,47,1847
32023,32023,A9A3A3D193DC50B4BBAF47FFC9E9C2E1,42511,19,21,2,37,47,1897
32024,32024,A9A3A3D193DC50B4BBAF47FFC9E9C2E1,42771,21,22,1,36,47,1847
32025,32025,2FCEA8AFEE1EB24BBCF386268B1232AC,11061,0,3,3,29,48,1498
32026,32026,2FCEA8AFEE1EB24BBCF386268B1232AC,11161,3,18,15,32,48,1648
32027,32027,2FCEA8AFEE1EB24BBCF386268B1232AC,11061,22,23,1,29,48,1498
32038,32038,B70267EAE88B62F9B87C2FB6E0BEE8BF,43621,0,7,7,46,48,2348
32039,32039,B70267EAE88B62F9B87C2FB6E0BEE8BF,11701,9,12,3,43,48,2198
32040,32040,B70267EAE88B62F9B87C2FB6E0BEE8BF,43621,13,22,9,46,48,2348
32041,32041,503C825874017B94AAE9067BE859DEB7,49201,0,5,5,7,41,391
32042,32042,503C825874017B94AAE9067BE859DEB7,19901,9,10,1,7,44,394
32043,32043,503C825874017B94AAE9067BE859DEB7,49201,13,23,10,7,41,391
32049,32049,DA3AEAD1CF8DB9120CF7E023CE86C4E3,10471,0,9,9,37,48,1898
32050,32050,DA3AEAD1CF8DB9120CF7E023CE86C4E3,10901,11,13,2,35,48,1798
32051,32051,DA3AEAD1CF8DB9120CF7E023CE86C4E3,11201,14,18,4,35,49,1799
32052,32052,DA3AEAD1CF8DB9120CF7E023CE86C4E3,10471,21,23,2,37,48,1898
32053,32053,3624837A8CEE8FA380EBBA166C2E7021,42091,0,13,13,43,46,2196
32054,32054,3624837A8CEE8FA380EBBA166C2E7021,13341,16,17,1,44,45,2245
32055,32055,3624837A8CEE8FA380EBBA166C2E7021,42091,18,23,5,43,46,2196
32056,32056,179C9FE89AB1A0E7249FE171F554F068,10341,0,12,12,31,47,1597
32057,32057,179C9FE89AB1A0E7249FE171F554F068,11151,13,14,1,30,48,1548
32058,32058,179C9FE89AB1A0E7249FE171F554F068,42523,16,20,4,31,47,1597
32059,32059,179C9FE89AB1A0E7249FE171F554F068,43761,20,21,1,32,47,1647
32069,32069,E3950B228FF57BC4F70CD2EC3D90B5FF,13711,5,7,2,38,46,1946
32070,32070,E3950B228FF57BC4F70CD2EC3D90B5FF,42151,11,17,6,35,45,1795
32071,32071,E3950B228FF57BC4F70CD2EC3D90B5FF,11941,19,20,1,37,46,1896
32072,32072,E3950B228FF57BC4F70CD2EC3D90B5FF,13711,22,23,1,38,46,1946
32076,32076,22BB480F010854FD7DE372B6CB620323,13101,0,8,8,40,47,2047
32077,32077,22BB480F010854FD7DE372B6CB620323,13271,9,10,1,41,47,2097
32078,32078,22BB480F010854FD7DE372B6CB620323,13101,11,23,12,40,47,2047
32079,32079,F80217E3B51992ECD97DB6E1ACCD96C3,12571,0,12,12,48,39,2439
32080,32080,F80217E3B51992ECD97DB6E1ACCD96C3,43101,16,17,1,46,40,2340
32081,32081,F80217E3B51992ECD97DB6E1ACCD96C3,12571,20,21,1,48,39,2439
32082,32082,4A7EF801268FA87DD49AA705DCA560E1,42581,1,14,13,38,48,1948
32083,32083,4A7EF801268FA87DD49AA705DCA560E1,11914,16,19,3,37,48,1898
32084,32084,4A7EF801268FA87DD49AA705DCA560E1,42581,21,22,1,38,48,1948
32088,32088,58FF60972C1637520443DC5766A2AB67,13411,1,6,5,49,42,2492
32089,32089,58FF60972C1637520443DC5766A2AB67,43951,6,17,11,49,41,2491
32090,32090,58FF60972C1637520443DC5766A2AB67,13411,20,22,2,49,42,2492
32091,32091,D3F6CC79419CB8E677F2F17C3DF072CD,13121,0,5,5,38,46,1946
32092,32092,D3F6CC79419CB8E677F2F17C3DF072CD,13331,6,18,12,38,47,1947
32093,32093,D3F6CC79419CB8E677F2F17C3DF072CD,13121,19,23,4,38,46,1946
32097,32097,9951832C875ED15346443116F8C6A7D1,42331,6,7,1,39,46,1996
32098,32098,9951832C875ED15346443116F8C6A7D1,11921,9,11,2,38,48,1948
32099,32099,9951832C875ED15346443116F8C6A7D1,10191,12,14,2,40,48,2048
32100,32100,9951832C875ED15346443116F8C6A7D1,42331,18,23,5,39,46,1996
32101,32101,83B65A620AA8887006B94BCE755E769B,10351,0,2,2,28,45,1445
32102,32102,83B65A620AA8887006B94BCE755E769B,10634,3,14,11,27,45,1395
32103,32103,83B65A620AA8887006B94BCE755E769B,10351,14,23,9,28,45,1445
32104,32104,AA2AAE26F1B48002865B69CE7B480FED,42523,3,4,1,31,47,1597
32105,32105,AA2AAE26F1B48002865B69CE7B480FED,13511,9,11,2,34,48,1748
32106,32106,AA2AAE26F1B48002865B69CE7B480FED,12161,11,12,1,32,46,1646
32107,32107,AA2AAE26F1B48002865B69CE7B480FED,42523,13,23,10,31,47,1597
32108,32108,28AE6FF44E8686DC354D2E3DF7700FCC,42461,0,14,14,45,47,2297
32109,32109,28AE6FF44E8686DC354D2E3DF7700FCC,11701,14,15,1,43,48,2198
32110,32110,28AE6FF44E8686DC354D2E3DF7700FCC,42461,18,23,5,45,47,2297
32115,32115,EBE45C3DBBC67B87F4B89C2B32FB91AA,42111,0,7,7,44,46,2246
32116,32116,EBE45C3DBBC67B87F4B89C2B32FB91AA,42461,7,8,1,45,47,2297
32117,32117,EBE45C3DBBC67B87F4B89C2B32FB91AA,42111,19,23,4,44,46,2246
32118,32118,B12CEF0016D6710869B6D602734EBC64,11324,0,7,7,31,46,1596
32119,32119,B12CEF0016D6710869B6D602734EBC64,10295,9,11,2,30,47,1547
32120,32120,B12CEF0016D6710869B6D602734EBC64,11324,16,23,7,31,46,1596
32125,32125,4FA7E2AF35091649A8D61648BF92F5C0,42581,0,8,8,38,48,1948
32126,32126,4FA7E2AF35091649A8D61648BF92F5C0,10471,9,11,2,37,48,1898
32127,32127,4FA7E2AF35091649A8D61648BF92F5C0,42581,12,13,1,38,48,1948
32128,32128,4FA7E2AF35091649A8D61648BF92F5C0,10471,14,21,7,37,48,1898
32129,32129,AF5140B00273B874DD47CFF400890B83,13821,1,3,2,49,45,2495
32130,32130,AF5140B00273B874DD47CFF400890B83,43951,4,8,4,49,41,2491
32131,32131,AF5140B00273B874DD47CFF400890B83,13411,8,9,1,49,42,2492
32132,32132,AF5140B00273B874DD47CFF400890B83,43951,13,23,10,49,41,2491
32140,32140,F6734E8BFE2D439520889EE4B91CD7DB,11061,0,2,2,29,48,1498
32141,32141,F6734E8BFE2D439520889EE4B91CD7DB,42071,2,19,17,31,49,1599
32142,32142,F6734E8BFE2D439520889EE4B91CD7DB,11061,20,22,2,29,48,1498
32143,32143,F6734E8BFE2D439520889EE4B91CD7DB,42071,22,23,1,31,49,1599
32147,32147,110EB8ED5B33FF374638B480C238C00D,10271,0,6,6,37,46,1896
32148,32148,110EB8ED5B33FF374638B480C238C00D,13121,8,10,2,38,46,1946
32149,32149,110EB8ED5B33FF374638B480C238C00D,10271,11,13,2,37,46,1896
32150,32150,110EB8ED5B33FF374638B480C238C00D,13121,16,20,4,38,46,1946
32161,32161,A6F4E0A14DDF72AB1602B3834CD2AC43,11914,0,4,4,37,48,1898
32162,32162,A6F4E0A14DDF72AB1602B3834CD2AC43,43361,7,8,1,38,48,1948
32163,32163,A6F4E0A14DDF72AB1602B3834CD2AC43,11914,11,23,12,37,48,1898
32164,32164,2FC158799FF19F821FBD3DC4EFE863DB,43101,3,9,6,46,40,2340
32165,32165,2FC158799FF19F821FBD3DC4EFE863DB,13551,9,11,2,45,38,2288
32166,32166,2FC158799FF19F821FBD3DC4EFE863DB,43101,13,23,10,46,40,2340
32167,32167,A4CBFA774BBCB1E081978588796288CA,10901,0,8,8,35,48,1798
32168,32168,A4CBFA774BBCB1E081978588796288CA,11231,10,17,7,37,49,1899
32169,32169,A4CBFA774BBCB1E081978588796288CA,10901,17,23,6,35,48,1798
32188,32188,9BFAC605539D316372225D788773DC0B,43481,1,4,3,39,48,1998
32189,32189,9BFAC605539D316372225D788773DC0B,12514,7,19,12,38,47,1947
32190,32190,9BFAC605539D316372225D788773DC0B,43481,22,23,1,39,48,1998
32196,32196,D64DF2C2FAB80CB42859AD7194DBB705,11921,0,7,7,38,48,1948
32197,32197,D64DF2C2FAB80CB42859AD7194DBB705,11074,8,20,12,37,47,1897
32198,32198,D64DF2C2FAB80CB42859AD7194DBB705,11921,20,22,2,38,48,1948
32199,32199,B0CA59461CE535DA6C80DC6682EBEAFB,42271,0,12,12,40,47,2047
32200,32200,B0CA59461CE535DA6C80DC6682EBEAFB,11806,13,14,1,41,48,2098
32201,32201,B0CA59461CE535DA6C80DC6682EBEAFB,42271,14,23,9,40,47,2047
32202,32202,FE289D23B7E617AD349A76499E85C77F,42021,0,1,1,33,47,1697
32203,32203,FE289D23B7E617AD349A76499E85C77F,13601,5,9,4,34,47,1747
32204,32204,FE289D23B7E617AD349A76499E85C77F,42021,9,21,12,33,47,1697
32209,32209,1129CFAE9FE6FF8D7F89EAB9AE20D07F,42041,4,9,5,10,47,547
32210,32210,1129CFAE9FE6FF8D7F89EAB9AE20D07F,19441,13,15,2,8,46,446
32211,32211,1129CFAE9FE6FF8D7F89EAB9AE20D07F,42041,16,19,3,10,47,547
32212,32212,1129CFAE9FE6FF8D7F89EAB9AE20D07F,19441,21,22,1,8,46,446
32220,32220,63A1194DA67A916294F825B4249AD293,42511,2,4,2,37,47,1897
32221,32221,63A1194DA67A916294F825B4249AD293,42161,5,7,2,36,47,1847
32222,32222,63A1194DA67A916294F825B4249AD293,11261,9,18,9,36,46,1846
32230,32230,2163009C55B05ECD83E44729736749E5,10951,0,7,7,29,48,1498
32231,32231,2163009C55B05ECD83E44729736749E5,11381,9,11,2,30,47,1547
32232,32232,2163009C55B05ECD83E44729736749E5,10951,11,13,2,29,48,1498
32233,32233,2163009C55B05ECD83E44729736749E5,11381,13,23,10,30,47,1547
32245,32245,C3F19D44E7AB1CD7653F15D0D1FC1177,10591,0,3,3,39,48,1998
32246,32246,C3F19D44E7AB1CD7653F15D0D1FC1177,11291,8,16,8,40,49,2049
32247,32247,C3F19D44E7AB1CD7653F15D0D1FC1177,11481,18,20,2,41,48,2098
32255,32255,F3D69D17D900427D0A05FF399134E46B,42071,0,13,13,31,49,1599
32256,32256,F3D69D17D900427D0A05FF399134E46B,11151,16,20,4,30,48,1548
32257,32257,F3D69D17D900427D0A05FF399134E46B,10381,21,23,2,31,49,1599
32258,32258,4A69CEF881C930B26BF97D2854913ACB,43951,0,5,5,49,41,2491
32259,32259,4A69CEF881C930B26BF97D2854913ACB,43101,10,11,1,46,40,2340
32260,32260,4A69CEF881C930B26BF97D2854913ACB,43951,12,23,11,49,41,2491
32266,32266,56380B9BCFA6857A7D3E4BBFC0E5BBBD,12514,1,7,6,38,47,1947
32267,32267,56380B9BCFA6857A7D3E4BBFC0E5BBBD,12841,9,13,4,37,47,1897
32268,32268,56380B9BCFA6857A7D3E4BBFC0E5BBBD,41005,15,23,8,38,47,1947
32275,32275,5ED8949BAC5CDF05EDA1019FB7CA4B17,42301,0,7,7,36,47,1847
32276,32276,5ED8949BAC5CDF05EDA1019FB7CA4B17,10471,8,18,10,37,48,1898
32277,32277,5ED8949BAC5CDF05EDA1019FB7CA4B17,40171,21,23,2,38,48,1948
32278,32278,54E9147B0F88496112EA8083546467E6,12661,0,13,13,32,45,1645
32279,32279,54E9147B0F88496112EA8083546467E6,12311,13,19,6,30,44,1544
32280,32280,54E9147B0F88496112EA8083546467E6,40381,20,22,2,32,46,1646
32284,32284,A6FB8806348882E3287150AAB70E5425,42141,1,3,2,32,47,1647
32285,32285,A6FB8806348882E3287150AAB70E5425,11161,4,5,1,32,48,1648
32286,32286,A6FB8806348882E3287150AAB70E5425,43761,8,23,15,32,47,1647
32287,32287,619B4993323BBB76F010058331D5BCE1,13911,0,3,3,39,46,1996
32288,32288,619B4993323BBB76F010058331D5BCE1,11261,5,10,5,36,46,1846
32289,32289,619B4993323BBB76F010058331D5BCE1,13221,12,13,1,40,47,2047
32290,32290,619B4993323BBB76F010058331D5BCE1,11261,16,18,2,36,46,1846
32313,32313,0AD8838435D12A1009D3BADE4EAE690D,11381,0,9,9,30,47,1547
32314,32314,0AD8838435D12A1009D3BADE4EAE690D,11061,9,10,1,29,48,1498
32315,32315,0AD8838435D12A1009D3BADE4EAE690D,11381,11,23,12,30,47,1547
32316,32316,5EC66C5A4B87D37344B296F73CB04D80,11231,0,11,11,37,49,1899
32317,32317,5EC66C5A4B87D37344B296F73CB04D80,10471,11,12,1,37,48,1898
32318,32318,5EC66C5A4B87D37344B296F73CB04D80,11231,12,17,5,37,49,1899
32319,32319,5EC66C5A4B87D37344B296F73CB04D80,10471,17,23,6,37,48,1898
32326,32326,55536669E97AF41ACDE427113BB85731,10691,0,6,6,33,48,1698
32327,32327,55536669E97AF41ACDE427113BB85731,11861,7,17,10,32,47,1647
32328,32328,55536669E97AF41ACDE427113BB85731,10491,18,22,4,33,48,1698
32329,32329,B304D2AD98C7DE24CAE6DD0DA65095F0,10431,0,13,13,33,49,1699
32330,32330,B304D2AD98C7DE24CAE6DD0DA65095F0,43581,14,18,4,33,48,1698
32331,32331,B304D2AD98C7DE24CAE6DD0DA65095F0,10431,18,23,5,33,49,1699
32332,32332,0CEC3D7EB4E938500D3BE15F068C3654,13121,1,9,8,38,46,1946
32333,32333,0CEC3D7EB4E938500D3BE15F068C3654,42511,12,16,4,37,47,1897
32334,32334,0CEC3D7EB4E938500D3BE15F068C3654,13121,17,20,3,38,46,1946
32340,32340,34FB5BF239A7B5016E3CA81F47968839,40961,6,13,7,35,47,1797
32341,32341,34FB5BF239A7B5016E3CA81F47968839,42161,13,15,2,36,47,1847
32342,32342,34FB5BF239A7B5016E3CA81F47968839,43161,17,19,2,35,47,1797
32352,32352,4ADBE8CCE4B3759BF992C8D6CFC80C27,42961,0,9,9,35,49,1799
32353,32353,4ADBE8CCE4B3759BF992C8D6CFC80C27,12083,11,12,1,36,49,1849
32354,32354,4ADBE8CCE4B3759BF992C8D6CFC80C27,42961,13,14,1,35,49,1799
32355,32355,4ADBE8CCE4B3759BF992C8D6CFC80C27,11231,20,23,3,37,49,1899
32386,32386,C934D1AD73BDF932D5199708F24A6232,10491,0,17,17,33,48,1698
32387,32387,C934D1AD73BDF932D5199708F24A6232,11861,18,20,2,32,47,1647
32388,32388,C934D1AD73BDF932D5199708F24A6232,42523,20,22,2,31,47,1597
32402,32402,1D604F5710A9E4979C670CB3E8F5518A,11381,0,17,17,30,47,1547
32403,32403,1D604F5710A9E4979C670CB3E8F5518A,10951,17,20,3,29,48,1498
32404,32404,1D604F5710A9E4979C670CB3E8F5518A,11381,20,23,3,30,47,1547
32413,32413,70BC072844C7CA9E90555B310CFF3C22,13601,2,8,6,34,47,1747
32414,32414,70BC072844C7CA9E90555B310CFF3C22,12381,8,17,9,32,48,1648
32415,32415,70BC072844C7CA9E90555B310CFF3C22,11081,22,23,1,35,46,1796
32420,32420,E75E9A8559DDAA5F20100934DD35A3D8,42401,1,2,1,36,47,1847
32421,32421,E75E9A8559DDAA5F20100934DD35A3D8,12841,3,4,1,37,47,1897
32422,32422,E75E9A8559DDAA5F20100934DD35A3D8,40673,6,19,13,36,48,1848
32423,32423,E75E9A8559DDAA5F20100934DD35A3D8,11331,20,22,2,37,48,1898
32424,32424,0DFD98C5BF618352145AEF64606DF221,10251,0,8,8,35,47,1797
32425,32425,0DFD98C5BF618352145AEF64606DF221,42161,9,21,12,36,47,1847
32426,32426,0DFD98C5BF618352145AEF64606DF221,10251,22,23,1,35,47,1797
32432,32432,EA2FF49AFA8BAE81E231360D1149B249,42351,1,11,10,38,45,1945
32433,32433,EA2FF49AFA8BAE81E231360D1149B249,42864,14,15,1,38,44,1944
32434,32434,EA2FF49AFA8BAE81E231360D1149B249,13231,20,22,2,39,46,1996
32442,32442,FC69FF2B8F3FFBA821A97ACC70374733,11161,0,10,10,32,48,1648
32443,32443,FC69FF2B8F3FFBA821A97ACC70374733,43761,11,13,2,32,47,1647
32444,32444,FC69FF2B8F3FFBA821A97ACC70374733,11161,14,20,6,32,48,1648
32445,32445,FC69FF2B8F3FFBA821A97ACC70374733,43761,21,23,2,32,47,1647
32454,32454,AA17A21C3D4D6A5EB5FDFC5D9A442A0B,42161,0,7,7,36,47,1847
32455,32455,AA17A21C3D4D6A5EB5FDFC5D9A442A0B,42231,11,16,5,37,46,1896
32456,32456,AA17A21C3D4D6A5EB5FDFC5D9A442A0B,42161,18,23,5,36,47,1847
32457,32457,9AF6F4C6C4937C91C918EC9853CABA28,11261,0,1,1,36,46,1846
32458,32458,9AF6F4C6C4937C91C918EC9853CABA28,42861,1,13,12,37,44,1894
32459,32459,9AF6F4C6C4937C91C918EC9853CABA28,11261,14,16,2,36,46,1846
32460,32460,9AF6F4C6C4937C91C918EC9853CABA28,42861,18,23,5,37,44,1894
32471,32471,7C9F24DFE966C2C315850837E609AD7B,10681,0,14,14,30,48,1548
32472,32472,7C9F24DFE966C2C315850837E609AD7B,11061,18,20,2,29,48,1498
32473,32473,7C9F24DFE966C2C315850837E609AD7B,10681,20,23,3,30,48,1548
32487,32487,E67DA67FCD45B9364F372EDFEC0B97BD,11211,0,9,9,34,49,1749
32488,32488,E67DA67FCD45B9364F372EDFEC0B97BD,11541,12,13,1,35,49,1799
32489,32489,E67DA67FCD45B9364F372EDFEC0B97BD,11531,16,19,3,34,49,1749
32490,32490,E67DA67FCD45B9364F372EDFEC0B97BD,11541,21,22,1,35,49,1799
32491,32491,970C5B25507CD6DAD2276870EE5AE8B6,11875,1,2,1,30,46,1546
32492,32492,970C5B25507CD6DAD2276870EE5AE8B6,11871,5,7,2,29,46,1496
32493,32493,970C5B25507CD6DAD2276870EE5AE8B6,11875,10,14,4,30,46,1546
32494,32494,970C5B25507CD6DAD2276870EE5AE8B6,42531,18,19,1,31,45,1595
32495,32495,6E3A482A59CE9925DB19971C6ACB206A,11914,1,7,6,37,48,1898
32496,32496,6E3A482A59CE9925DB19971C6ACB206A,40171,9,13,4,38,48,1948
32497,32497,6E3A482A59CE9925DB19971C6ACB206A,10471,17,22,5,37,48,1898
32498,32498,4E1126CD1AF86FC47E3B081AF053FA88,43761,2,10,8,32,47,1647
32499,32499,4E1126CD1AF86FC47E3B081AF053FA88,10341,12,18,6,31,47,1597
32500,32500,4E1126CD1AF86FC47E3B081AF053FA88,42141,18,23,5,32,47,1647
32519,32519,A61D0F5D6E4730E77483BB5A83F54B2C,42771,1,8,7,36,47,1847
32520,32520,A61D0F5D6E4730E77483BB5A83F54B2C,10841,9,17,8,37,47,1897
32521,32521,A61D0F5D6E4730E77483BB5A83F54B2C,12083,17,19,2,36,49,1849
32522,32522,A61D0F5D6E4730E77483BB5A83F54B2C,10811,21,23,2,38,46,1946
32523,32523,A53DAA006542212C0F792E33874BF547,11661,1,13,12,40,49,2049
32524,32524,A53DAA006542212C0F792E33874BF547,10231,16,20,4,39,49,1999
32525,32525,A53DAA006542212C0F792E33874BF547,12083,21,22,1,36,49,1849
32526,32526,3EF73C757C94E8AD07B112481B940D3A,11161,3,4,1,32,48,1648
32527,32527,3EF73C757C94E8AD07B112481B940D3A,43761,6,9,3,32,47,1647
32528,32528,3EF73C757C94E8AD07B112481B940D3A,11381,11,12,1,30,47,1547
32529,32529,3EF73C757C94E8AD07B112481B940D3A,43761,14,19,5,32,47,1647
32548,32548,AA6D4A35F81446E34CB45D0775B9D6B5,11231,1,9,8,37,49,1899
32549,32549,AA6D4A35F81446E34CB45D0775B9D6B5,10471,9,13,4,37,48,1898
32550,32550,AA6D4A35F81446E34CB45D0775B9D6B5,11231,18,23,5,37,49,1899
32554,32554,FE72309A49FBEB6B76C0E42028E74707,42041,1,16,15,10,47,547
32555,32555,FE72309A49FBEB6B76C0E42028E74707,19441,19,21,2,8,46,446
32556,32556,FE72309A49FBEB6B76C0E42028E74707,42041,21,22,1,10,47,547
32557,32557,4A1082E29116D07A4EA830C32D0BE5ED,12221,0,18,18,43,44,2194
32558,32558,4A1082E29116D07A4EA830C32D0BE5ED,42631,20,21,1,43,45,2195
32559,32559,4A1082E29116D07A4EA830C32D0BE5ED,12221,21,22,1,43,44,2194
32560,32560,B4CF5575585A81D8047EC86B2FC8CF53,42861,0,12,12,37,44,1894
32561,32561,B4CF5575585A81D8047EC86B2FC8CF53,11261,15,16,1,36,46,1846
32562,32562,B4CF5575585A81D8047EC86B2FC8CF53,13461,20,21,1,39,44,1994
32563,32563,70884D19952CA4B432FAA84B8636A296,43621,0,7,7,46,48,2348
32564,32564,70884D19952CA4B432FAA84B8636A296,13351,7,19,12,48,48,2448
32565,32565,70884D19952CA4B432FAA84B8636A296,42461,20,21,1,45,47,2297
32571,32571,487315C9A10EA017D67B443311820F7A,12401,0,6,6,39,49,1999
32572,32572,487315C9A10EA017D67B443311820F7A,11914,9,18,9,37,48,1898
32573,32573,487315C9A10EA017D67B443311820F7A,42801,19,20,1,40,49,2049
32574,32574,180C57D9A40178E5B15186C701804F1B,10421,0,2,2,41,48,2098
32575,32575,180C57D9A40178E5B15186C701804F1B,42931,2,5,3,41,49,2099
32576,32576,180C57D9A40178E5B15186C701804F1B,10421,6,9,3,41,48,2098
32577,32577,180C57D9A40178E5B15186C701804F1B,42801,20,22,2,40,49,2049
32578,32578,5ABC7476B829907717164C7F4D7F76B4,10681,1,14,13,30,48,1548
32579,32579,5ABC7476B829907717164C7F4D7F76B4,11061,16,17,1,29,48,1498
32580,32580,5ABC7476B829907717164C7F4D7F76B4,11381,18,19,1,30,47,1547
32605,32605,405425CB3107629C743592DE469E38AA,42581,0,8,8,38,48,1948
32606,32606,405425CB3107629C743592DE469E38AA,11914,8,11,3,37,48,1898
32607,32607,405425CB3107629C743592DE469E38AA,10841,16,18,2,37,47,1897
32608,32608,405425CB3107629C743592DE469E38AA,42581,19,22,3,38,48,1948
32609,32609,181802B57A29F4FAE1E7EF60B334A9D5,11261,5,6,1,36,46,1846
32610,32610,181802B57A29F4FAE1E7EF60B334A9D5,42861,9,15,6,37,44,1894
32611,32611,181802B57A29F4FAE1E7EF60B334A9D5,11261,18,19,1,36,46,1846
32612,32612,181802B57A29F4FAE1E7EF60B334A9D5,42864,22,23,1,38,44,1944
32623,32623,3BE46C14B2CA2CE1D859CAF16A631486,13341,0,6,6,44,45,2245
32624,32624,3BE46C14B2CA2CE1D859CAF16A631486,12211,7,8,1,41,44,2094
32625,32625,3BE46C14B2CA2CE1D859CAF16A631486,12561,13,14,1,45,43,2293
32626,32626,3BE46C14B2CA2CE1D859CAF16A631486,13341,18,21,3,44,45,2245
32632,32632,A6B20A71D8FE4CB54D204D2A323CF5A8,11914,0,13,13,37,48,1898
32633,32633,A6B20A71D8FE4CB54D204D2A323CF5A8,43361,15,16,1,38,48,1948
32634,32634,A6B20A71D8FE4CB54D204D2A323CF5A8,11914,17,23,6,37,48,1898
32639,32639,F93D646A1BCE1AFF390EB78A01863C9E,40171,0,3,3,38,48,1948
32640,32640,F93D646A1BCE1AFF390EB78A01863C9E,10471,3,15,12,37,48,1898
32641,32641,F93D646A1BCE1AFF390EB78A01863C9E,42581,15,19,4,38,48,1948
32652,32652,7BBD15EB45C3F1BA6E572F56B02ABEDA,10841,0,6,6,37,47,1897
32653,32653,7BBD15EB45C3F1BA6E572F56B02ABEDA,12514,8,12,4,38,47,1947
32654,32654,7BBD15EB45C3F1BA6E572F56B02ABEDA,10841,13,18,5,37,47,1897
32655,32655,C7DA09D84BB6D5A3ABEAD976C8C0731E,42861,0,13,13,37,44,1894
32656,32656,C7DA09D84BB6D5A3ABEAD976C8C0731E,11261,15,17,2,36,46,1846
32657,32657,C7DA09D84BB6D5A3ABEAD976C8C0731E,42861,19,22,3,37,44,1894
32664,32664,C2DF457F1D0C11A80CBA147D424E3E70,11871,0,7,7,29,46,1496
32665,32665,C2DF457F1D0C11A80CBA147D424E3E70,12311,8,9,1,30,44,1544
32666,32666,C2DF457F1D0C11A80CBA147D424E3E70,11871,12,23,11,29,46,1496
32675,32675,167F0AD4C372262B104F1E644C482559,43281,1,8,7,37,48,1898
32676,32676,167F0AD4C372262B104F1E644C482559,13121,12,15,3,38,46,1946
32677,32677,167F0AD4C372262B104F1E644C482559,10491,17,19,2,33,48,1698
32678,32678,167F0AD4C372262B104F1E644C482559,43731,19,23,4,34,47,1747
32691,32691,CB569F11653BED8355DBB1B17AC5F222,42191,0,3,3,38,49,1949
32692,32692,CB569F11653BED8355DBB1B17AC5F222,11914,3,13,10,37,48,1898
32693,32693,CB569F11653BED8355DBB1B17AC5F222,40171,13,20,7,38,48,1948
32694,32694,CB569F11653BED8355DBB1B17AC5F222,42191,21,22,1,38,49,1949
32695,32695,0F11B5CA889ADAC68664648A25492433,42523,0,6,6,31,47,1597
32696,32696,0F11B5CA889ADAC68664648A25492433,43311,7,9,2,31,48,1598
32697,32697,0F11B5CA889ADAC68664648A25492433,42523,14,20,6,31,47,1597
32701,32701,6C96EE989846ABECA961FEB7DAD4E3B3,43361,0,6,6,38,48,1948
32702,32702,6C96EE989846ABECA961FEB7DAD4E3B3,10471,7,11,4,37,48,1898
32703,32703,6C96EE989846ABECA961FEB7DAD4E3B3,43361,13,14,1,38,48,1948
32704,32704,6C96EE989846ABECA961FEB7DAD4E3B3,10471,15,22,7,37,48,1898
32705,32705,C6869A64CA9EF97A25D7192A00726FC2,42401,0,9,9,36,47,1847
32706,32706,C6869A64CA9EF97A25D7192A00726FC2,10781,9,18,9,35,47,1797
32707,32707,C6869A64CA9EF97A25D7192A00726FC2,10111,18,23,5,37,47,1897
32708,32708,078D744FD5840DE4508E7DD5C66617FF,11261,0,6,6,36,46,1846
32709,32709,078D744FD5840DE4508E7DD5C66617FF,42351,7,15,8,38,45,1945
32710,32710,078D744FD5840DE4508E7DD5C66617FF,11261,16,23,7,36,46,1846
32711,32711,21FCC6B6C6A0998CC9336AAD4AF0C4E3,42941,0,3,3,37,47,1897
32712,32712,21FCC6B6C6A0998CC9336AAD4AF0C4E3,10271,6,18,12,37,46,1896
32713,32713,21FCC6B6C6A0998CC9336AAD4AF0C4E3,42941,20,23,3,37,47,1897
32719,32719,181B5103F0FBF120AFF5BEC3A26A3DB7,43761,1,7,6,32,47,1647
32720,32720,181B5103F0FBF120AFF5BEC3A26A3DB7,40112,8,16,8,32,48,1648
32721,32721,181B5103F0FBF120AFF5BEC3A26A3DB7,43761,18,22,4,32,47,1647
32732,32732,EC57E33248ACEF6B14CA4470A7B4BE9F,42921,0,8,8,33,47,1697
32733,32733,EC57E33248ACEF6B14CA4470A7B4BE9F,11861,9,11,2,32,47,1647
32734,32734,EC57E33248ACEF6B14CA4470A7B4BE9F,42921,13,18,5,33,47,1697
32738,32738,2B05CC2BC211341FBD9F6EA8966B4690,11914,5,19,14,37,48,1898
32739,32739,2B05CC2BC211341FBD9F6EA8966B4690,40171,19,21,2,38,48,1948
32740,32740,2B05CC2BC211341FBD9F6EA8966B4690,11914,22,23,1,37,48,1898
32741,32741,318608EA3FE88544F5C52BCECF823725,11751,0,11,11,35,48,1798
32742,32742,318608EA3FE88544F5C52BCECF823725,12971,15,16,1,32,48,1648
32743,32743,318608EA3FE88544F5C52BCECF823725,43671,16,23,7,35,48,1798
32750,32750,812932466C0F18458E2AE0D62145AC1E,11481,0,8,8,41,48,2098
32751,32751,812932466C0F18458E2AE0D62145AC1E,13101,8,9,1,40,47,2047
32752,32752,812932466C0F18458E2AE0D62145AC1E,11481,10,17,7,41,48,2098
32753,32753,812932466C0F18458E2AE0D62145AC1E,13101,20,23,3,40,47,2047
32767,32767,FCC89D0F72B0B6BEC68E599778108B84,10111,0,11,11,37,47,1897
32768,32768,FCC89D0F72B0B6BEC68E599778108B84,40421,13,15,2,37,48,1898
32769,32769,FCC89D0F72B0B6BEC68E599778108B84,10111,16,23,7,37,47,1897
32775,32775,C172ECEA2F7AF9729D921F01FE2F1A6B,42581,1,10,9,38,48,1948
32776,32776,C172ECEA2F7AF9729D921F01FE2F1A6B,10661,18,19,1,37,49,1899
32777,32777,C172ECEA2F7AF9729D921F01FE2F1A6B,11921,20,21,1,38,48,1948
32778,32778,1F9F1C83F1B526750C2575DE062BE373,43761,0,7,7,32,47,1647
32779,32779,1F9F1C83F1B526750C2575DE062BE373,11211,8,12,4,34,49,1749
32780,32780,1F9F1C83F1B526750C2575DE062BE373,42523,16,22,6,31,47,1597
32781,32781,AD3E01B55BE3A10979B701E17C93952E,12581,2,5,3,24,48,1248
32782,32782,AD3E01B55BE3A10979B701E17C93952E,11361,7,20,13,22,48,1148
32783,32783,AD3E01B55BE3A10979B701E17C93952E,12581,20,21,1,24,48,1248
32784,32784,E6A8B36EA819F0A64C66840FF99B9AB3,42581,1,7,6,38,48,1948
32785,32785,E6A8B36EA819F0A64C66840FF99B9AB3,11914,9,15,6,37,48,1898
32786,32786,E6A8B36EA819F0A64C66840FF99B9AB3,42581,18,19,1,38,48,1948
32787,32787,EFD67C44A54A4D4B59860E50D1F4BFA0,42161,0,18,18,36,47,1847
32788,32788,EFD67C44A54A4D4B59860E50D1F4BFA0,11201,19,20,1,35,49,1799
32789,32789,EFD67C44A54A4D4B59860E50D1F4BFA0,42161,21,23,2,36,47,1847
32795,32795,03FE0D0BD52A528C1B4DF1F3C44F085B,43241,0,6,6,36,46,1846
32796,32796,03FE0D0BD52A528C1B4DF1F3C44F085B,42351,6,14,8,38,45,1945
32797,32797,03FE0D0BD52A528C1B4DF1F3C44F085B,11941,14,23,9,37,46,1896
32801,32801,5529DD2214C36634346603006F6A0F3F,12521,0,6,6,35,41,1791
32802,32802,5529DD2214C36634346603006F6A0F3F,42381,7,10,3,39,41,1991
32803,32803,5529DD2214C36634346603006F6A0F3F,12521,11,22,11,35,41,1791
32815,32815,20538B8C1777892DA77867D1D04B5D49,43761,0,3,3,32,47,1647
32816,32816,20538B8C1777892DA77867D1D04B5D49,11161,3,9,6,32,48,1648
32817,32817,20538B8C1777892DA77867D1D04B5D49,43761,10,23,13,32,47,1647
32818,32818,479BB88DD9C776BA69F274C628C53893,13121,0,5,5,38,46,1946
32819,32819,479BB88DD9C776BA69F274C628C53893,10271,9,10,1,37,46,1896
32820,32820,479BB88DD9C776BA69F274C628C53893,13121,11,23,12,38,46,1946
32821,32821,636D66B9C2DD39D28485A7810A6E1528,12381,0,10,10,32,48,1648
32822,32822,636D66B9C2DD39D28485A7810A6E1528,43311,12,14,2,31,48,1598
32823,32823,636D66B9C2DD39D28485A7810A6E1528,12381,22,23,1,32,48,1648
32824,32824,2220ACECA44CDD6B643C1166EB143787,12641,0,14,14,10,43,543
32825,32825,2220ACECA44CDD6B643C1166EB143787,19114,18,21,3,7,43,393
32826,32826,2220ACECA44CDD6B643C1166EB143787,12641,22,23,1,10,43,543
32841,32841,A60E51B2BB36D63F6E34260285BCBDB6,42531,0,1,1,31,45,1595
32842,32842,A60E51B2BB36D63F6E34260285BCBDB6,12661,2,13,11,32,45,1645
32843,32843,A60E51B2BB36D63F6E34260285BCBDB6,12311,17,19,2,30,44,1544
32858,32858,0BA677AEFA1FE879EC9FCA98466C3A1A,11641,0,13,13,22,49,1149
32859,32859,0BA677AEFA1FE879EC9FCA98466C3A1A,42681,13,14,1,24,48,1248
32860,32860,0BA677AEFA1FE879EC9FCA98466C3A1A,11641,14,23,9,22,49,1149
32861,32861,D051A53A52187B78CF6DA99F6B3FF9C4,40637,0,11,11,36,47,1847
32862,32862,D051A53A52187B78CF6DA99F6B3FF9C4,10251,16,18,2,35,47,1797
32863,32863,D051A53A52187B78CF6DA99F6B3FF9C4,40637,19,22,3,36,47,1847
32864,32864,3E17C9F881E8F571652BFE5E841845EF,11861,0,3,3,32,47,1647
32865,32865,3E17C9F881E8F571652BFE5E841845EF,10281,3,10,7,33,48,1698
32866,32866,3E17C9F881E8F571652BFE5E841845EF,11861,12,23,11,32,47,1647
32894,32894,0722208BA05F2FA64560C4BADA491D8E,11381,1,6,5,30,47,1547
32895,32895,0722208BA05F2FA64560C4BADA491D8E,10151,8,16,8,34,47,1747
32896,32896,0722208BA05F2FA64560C4BADA491D8E,13651,20,23,3,30,47,1547
32902,32902,DCE9BDF4C30776F61FC7C0FB237D8FCF,40941,0,7,7,32,48,1648
32903,32903,DCE9BDF4C30776F61FC7C0FB237D8FCF,11171,18,20,2,33,48,1698
32904,32904,DCE9BDF4C30776F61FC7C0FB237D8FCF,12381,21,23,2,32,48,1648
32905,32905,27B6DDFE3A356062F221ABD7AD70BB14,11061,0,6,6,29,48,1498
32906,32906,27B6DDFE3A356062F221ABD7AD70BB14,10681,8,9,1,30,48,1548
32907,32907,27B6DDFE3A356062F221ABD7AD70BB14,11061,9,23,14,29,48,1498
32908,32908,62E083FD6CCFD94FFA49C92986AAE56D,43761,1,14,13,32,47,1647
32909,32909,62E083FD6CCFD94FFA49C92986AAE56D,10281,18,19,1,33,48,1698
32910,32910,62E083FD6CCFD94FFA49C92986AAE56D,43761,20,22,2,32,47,1647
32914,32914,2B032F4759A63D3D3DE094528FC05913,42581,1,18,17,38,48,1948
32915,32915,2B032F4759A63D3D3DE094528FC05913,11811,19,21,2,38,49,1949
32916,32916,2B032F4759A63D3D3DE094528FC05913,11914,21,23,2,37,48,1898
32921,32921,E5C174D2FF195FD116006ADE577A953D,11381,0,6,6,30,47,1547
32922,32922,E5C174D2FF195FD116006ADE577A953D,11151,9,19,10,30,48,1548
32923,32923,E5C174D2FF195FD116006ADE577A953D,11061,22,23,1,29,48,1498
32928,32928,78A4AA9407E763ED8D1652A4AFF74DAE,19114,0,2,2,7,43,393
32929,32929,78A4AA9407E763ED8D1652A4AFF74DAE,12641,4,9,5,10,43,543
32930,32930,78A4AA9407E763ED8D1652A4AFF74DAE,19114,13,22,9,7,43,393
32944,32944,694AE58BB8FA7D73732050F947690888,13231,3,4,1,39,46,1996
32945,32945,694AE58BB8FA7D73732050F947690888,11261,5,21,16,36,46,1846
32946,32946,694AE58BB8FA7D73732050F947690888,13461,21,23,2,39,44,1994
32963,32963,9592706C1523EFA916EA05E92517C597,40833,0,6,6,41,47,2097
32964,32964,9592706C1523EFA916EA05E92517C597,43361,7,9,2,38,48,1948
32965,32965,9592706C1523EFA916EA05E92517C597,13271,12,22,10,41,47,2097
32971,32971,5443876423EFFC85FB222DD27BB73B26,11021,0,8,8,36,49,1849
32972,32972,5443876423EFFC85FB222DD27BB73B26,10281,10,12,2,33,48,1698
32973,32973,5443876423EFFC85FB222DD27BB73B26,11021,12,23,11,36,49,1849
32982,32982,BA865EE03D54F441A6E18D3EAF3533FA,11381,0,1,1,30,47,1547
32983,32983,BA865EE03D54F441A6E18D3EAF3533FA,11061,1,4,3,29,48,1498
32984,32984,BA865EE03D54F441A6E18D3EAF3533FA,11381,21,23,2,30,47,1547
32988,32988,48DCE60D429B0B1E7F2F1B7A462BF9BF,13651,0,2,2,30,47,1547
32989,32989,48DCE60D429B0B1E7F2F1B7A462BF9BF,42523,2,17,15,31,47,1597
32990,32990,48DCE60D429B0B1E7F2F1B7A462BF9BF,11861,20,23,3,32,47,1647
32991,32991,8939839233388352179B3292F509915F,12921,0,6,6,9,41,491
32992,32992,8939839233388352179B3292F509915F,12641,7,9,2,10,43,543
32993,32993,8939839233388352179B3292F509915F,12921,11,22,11,9,41,491
32994,32994,24C1593E231EB4ED8C43A959F640BD76,11231,0,18,18,37,49,1899
32995,32995,24C1593E231EB4ED8C43A959F640BD76,11351,19,20,1,36,48,1848
32996,32996,24C1593E231EB4ED8C43A959F640BD76,11231,21,22,1,37,49,1899
32997,32997,3C4F290E088B2251F5A11549B4DEDAFC,42511,0,5,5,37,47,1897
32998,32998,3C4F290E088B2251F5A11549B4DEDAFC,12514,7,19,12,38,47,1947
32999,32999,3C4F290E088B2251F5A11549B4DEDAFC,12511,19,20,1,39,47,1997
33000,33000,3C4F290E088B2251F5A11549B4DEDAFC,13331,21,22,1,38,47,1947
33015,33015,F18C7871BFB82CA1A349E44A5DE6D0B7,11021,7,18,11,36,49,1849
33016,33016,F18C7871BFB82CA1A349E44A5DE6D0B7,10221,19,21,2,34,49,1749
33017,33017,F18C7871BFB82CA1A349E44A5DE6D0B7,11021,22,23,1,36,49,1849
33021,33021,D049151AA3A3F2786A77273D813485C6,40833,1,10,9,41,47,2097
33022,33022,D049151AA3A3F2786A77273D813485C6,13101,10,13,3,40,47,2047
33023,33023,D049151AA3A3F2786A77273D813485C6,13271,15,18,3,41,47,2097
33029,33029,9CA777C26F090A99FBBCE57B69E10F32,11161,0,5,5,32,48,1648
33030,33030,9CA777C26F090A99FBBCE57B69E10F32,43761,6,11,5,32,47,1647
33031,33031,9CA777C26F090A99FBBCE57B69E10F32,11161,12,22,10,32,48,1648
33047,33047,A1C9B8A7CF7D449187392A8B69FA3CC6,13371,0,18,18,41,47,2097
33048,33048,A1C9B8A7CF7D449187392A8B69FA3CC6,11521,19,20,1,41,48,2098
33049,33049,A1C9B8A7CF7D449187392A8B69FA3CC6,13371,21,23,2,41,47,2097
33050,33050,DFA44588B9F7612E59AB24A1351E5F4F,12921,0,9,9,9,41,491
33051,33051,DFA44588B9F7612E59AB24A1351E5F4F,49201,11,13,2,7,41,391
33052,33052,DFA44588B9F7612E59AB24A1351E5F4F,12921,13,14,1,9,41,491
33053,33053,DFA44588B9F7612E59AB24A1351E5F4F,49201,17,22,5,7,41,391
33057,33057,DB3E630F0B8B4654A4F1A27A65033CF0,10681,0,6,6,30,48,1548
33058,33058,DB3E630F0B8B4654A4F1A27A65033CF0,11061,7,14,7,29,48,1498
33059,33059,DB3E630F0B8B4654A4F1A27A65033CF0,10681,14,15,1,30,48,1548
33060,33060,DB3E630F0B8B4654A4F1A27A65033CF0,11061,15,23,8,29,48,1498
33066,33066,4FEDDE4724DDA61E19979F6B8E0B84B5,42301,0,7,7,36,47,1847
33067,33067,4FEDDE4724DDA61E19979F6B8E0B84B5,10271,9,17,8,37,46,1896
33068,33068,4FEDDE4724DDA61E19979F6B8E0B84B5,42511,20,23,3,37,47,1897
33072,33072,C46CDF3840B783157CCBA7C0D999F0A9,10295,0,8,8,30,47,1547
33073,33073,C46CDF3840B783157CCBA7C0D999F0A9,42491,8,12,4,32,46,1646
33074,33074,C46CDF3840B783157CCBA7C0D999F0A9,10292,13,21,8,30,47,1547
33075,33075,C46CDF3840B783157CCBA7C0D999F0A9,42491,22,23,1,32,46,1646
33080,33080,CFDD81F3E0BD7D9739E43AB2B2B61D35,42301,0,7,7,36,47,1847
33081,33081,CFDD81F3E0BD7D9739E43AB2B2B61D35,10111,9,18,9,37,47,1897
33082,33082,CFDD81F3E0BD7D9739E43AB2B2B61D35,42301,19,23,4,36,47,1847
33086,33086,E090AE745FE0157CE235544725EE3E3A,12514,0,6,6,38,47,1947
33087,33087,E090AE745FE0157CE235544725EE3E3A,11021,9,17,8,36,49,1849
33088,33088,E090AE745FE0157CE235544725EE3E3A,12514,20,23,3,38,47,1947
33089,33089,D0819644627AC00B1760F57708B6F7FF,42461,0,6,6,45,47,2297
33090,33090,D0819644627AC00B1760F57708B6F7FF,41393,8,9,1,43,49,2199
33091,33091,D0819644627AC00B1760F57708B6F7FF,43621,14,23,9,46,48,2348
33092,33092,CC32F4A2BABE0D96EDADEEDB7E3A6A5F,42961,0,8,8,35,49,1799
33093,33093,CC32F4A2BABE0D96EDADEEDB7E3A6A5F,10901,8,16,8,35,48,1798
33094,33094,CC32F4A2BABE0D96EDADEEDB7E3A6A5F,42161,19,23,4,36,47,1847
33103,33103,3869E48F267B04208FDB1CED43168CE1,43761,0,7,7,32,47,1647
33104,33104,3869E48F267B04208FDB1CED43168CE1,42371,9,11,2,34,46,1746
33105,33105,3869E48F267B04208FDB1CED43168CE1,12161,13,18,5,32,46,1646
33106,33106,3869E48F267B04208FDB1CED43168CE1,43761,21,23,2,32,47,1647
33115,33115,1D5FEB85097765A4DAC299D8A4D17B3D,42501,0,14,14,28,47,1447
33116,33116,1D5FEB85097765A4DAC299D8A4D17B3D,43311,18,21,3,31,48,1598
33117,33117,1D5FEB85097765A4DAC299D8A4D17B3D,12121,21,22,1,29,47,1497
33118,33118,7593D7AED856FF2FC2E20D8E8570438A,40171,4,8,4,38,48,1948
33119,33119,7593D7AED856FF2FC2E20D8E8570438A,11914,8,10,2,37,48,1898
33120,33120,7593D7AED856FF2FC2E20D8E8570438A,42581,13,15,2,38,48,1948
33121,33121,7593D7AED856FF2FC2E20D8E8570438A,11914,15,18,3,37,48,1898
33122,33122,BE782842408BDDB8513DF8B66BC1C78B,43761,6,8,2,32,47,1647
33123,33123,BE782842408BDDB8513DF8B66BC1C78B,42523,8,14,6,31,47,1597
33124,33124,BE782842408BDDB8513DF8B66BC1C78B,43761,14,16,2,32,47,1647
33125,33125,BE782842408BDDB8513DF8B66BC1C78B,42523,16,18,2,31,47,1597
33126,33126,39EB4D3A98BB31BC89AD2CF96D05916B,11021,0,10,10,36,49,1849
33127,33127,39EB4D3A98BB31BC89AD2CF96D05916B,10107,13,15,2,38,49,1949
33128,33128,39EB4D3A98BB31BC89AD2CF96D05916B,13741,15,17,2,37,49,1899
33129,33129,39EB4D3A98BB31BC89AD2CF96D05916B,11021,18,22,4,36,49,1849
33133,33133,B0FF888F2A2CE698F2B8641BCE4B074A,11875,1,11,10,30,46,1546
33134,33134,B0FF888F2A2CE698F2B8641BCE4B074A,10634,13,15,2,27,45,1395
33135,33135,B0FF888F2A2CE698F2B8641BCE4B074A,11875,18,20,2,30,46,1546
33136,33136,AD235EE6A83CA7956AB86E8BC887D3C7,11541,0,6,6,35,49,1799
33137,33137,AD235EE6A83CA7956AB86E8BC887D3C7,13561,9,11,2,37,49,1899
33138,33138,AD235EE6A83CA7956AB86E8BC887D3C7,11021,13,16,3,36,49,1849
33139,33139,AD235EE6A83CA7956AB86E8BC887D3C7,11541,19,23,4,35,49,1799
33144,33144,EE6B8585E25BB845D2DA0A95F88FAB79,42231,1,11,10,37,46,1896
33145,33145,EE6B8585E25BB845D2DA0A95F88FAB79,42351,13,15,2,38,45,1945
33146,33146,EE6B8585E25BB845D2DA0A95F88FAB79,13911,19,20,1,39,46,1996
33147,33147,EE6B8585E25BB845D2DA0A95F88FAB79,42231,22,23,1,37,46,1896
33148,33148,52DE1B5B29EB088C4F7CC0D4865B38F5,42861,0,9,9,37,44,1894
33149,33149,52DE1B5B29EB088C4F7CC0D4865B38F5,42151,9,11,2,35,45,1795
33150,33150,52DE1B5B29EB088C4F7CC0D4865B38F5,42861,13,14,1,37,44,1894
33151,33151,52DE1B5B29EB088C4F7CC0D4865B38F5,42151,18,19,1,35,45,1795
33152,33152,132BAF41704DD845C2F70543C3732C4E,13711,0,4,4,38,46,1946
33153,33153,132BAF41704DD845C2F70543C3732C4E,42231,7,11,4,37,46,1896
33154,33154,132BAF41704DD845C2F70543C3732C4E,13711,11,14,3,38,46,1946
33155,33155,132BAF41704DD845C2F70543C3732C4E,42231,16,20,4,37,46,1896
33156,33156,B1886EF8F5487F8E8F1A6E89D17F4DF6,12311,0,13,13,30,44,1544
33157,33157,B1886EF8F5487F8E8F1A6E89D17F4DF6,42531,15,18,3,31,45,1595
33158,33158,B1886EF8F5487F8E8F1A6E89D17F4DF6,12311,21,23,2,30,44,1544
33159,33159,15D46EC570105A948AAA5BD130B0DCB7,10111,0,7,7,37,47,1897
33160,33160,15D46EC570105A948AAA5BD130B0DCB7,11491,7,12,5,36,47,1847
33161,33161,15D46EC570105A948AAA5BD130B0DCB7,10111,12,22,10,37,47,1897
33167,33167,626F67A59D85B6C170D57EA81DBC293E,11381,0,2,2,30,47,1547
33168,33168,626F67A59D85B6C170D57EA81DBC293E,42291,4,5,1,29,48,1498
33169,33169,626F67A59D85B6C170D57EA81DBC293E,11381,6,7,1,30,47,1547
33170,33170,626F67A59D85B6C170D57EA81DBC293E,11951,14,23,9,31,49,1599
33171,33171,2AC8E4C41FCDCF53C09A83820985C782,11381,0,1,1,30,47,1547
33172,33172,2AC8E4C41FCDCF53C09A83820985C782,10171,2,14,12,26,47,1347
33173,33173,2AC8E4C41FCDCF53C09A83820985C782,11381,15,18,3,30,47,1547
33174,33174,B7D6EFF1A712C97E66620534B8D3DEAE,10471,1,16,15,37,48,1898
33175,33175,B7D6EFF1A712C97E66620534B8D3DEAE,41271,17,20,3,38,48,1948
33176,33176,B7D6EFF1A712C97E66620534B8D3DEAE,10471,21,23,2,37,48,1898
33185,33185,082808D93E8688E9598DE50927F17FC1,10111,0,8,8,37,47,1897
33186,33186,082808D93E8688E9598DE50927F17FC1,43234,10,16,6,37,49,1899
33187,33187,082808D93E8688E9598DE50927F17FC1,42301,17,23,6,36,47,1847
33188,33188,60E47AB33736AC41E2674A67294A03D4,11261,0,3,3,36,46,1846
33189,33189,60E47AB33736AC41E2674A67294A03D4,12491,6,8,2,36,43,1843
33190,33190,60E47AB33736AC41E2674A67294A03D4,11261,11,19,8,36,46,1846
33191,33191,5E8A3BDEF627558EB3C1F73A3263F788,13711,3,4,1,38,46,1946
33192,33192,5E8A3BDEF627558EB3C1F73A3263F788,42231,8,10,2,37,46,1896
33193,33193,5E8A3BDEF627558EB3C1F73A3263F788,13711,13,18,5,38,46,1946
33194,33194,5E8A3BDEF627558EB3C1F73A3263F788,42231,20,21,1,37,46,1896
33195,33195,E7A499EFF2705CCA8F4C4AD8B684EDF4,10221,0,8,8,34,49,1749
33196,33196,E7A499EFF2705CCA8F4C4AD8B684EDF4,43761,12,18,6,32,47,1647
33197,33197,E7A499EFF2705CCA8F4C4AD8B684EDF4,11951,19,21,2,31,49,1599
33202,33202,F587555054424F7ED0D63829AAEB0C06,42271,0,8,8,40,47,2047
33203,33203,F587555054424F7ED0D63829AAEB0C06,11806,11,15,4,41,48,2098
33204,33204,F587555054424F7ED0D63829AAEB0C06,42271,15,23,8,40,47,2047
33212,33212,3D2ECC6A4BAE851C87C67624F1270EC4,13911,0,1,1,39,46,1996
33213,33213,3D2ECC6A4BAE851C87C67624F1270EC4,42351,2,4,2,38,45,1945
33214,33214,3D2ECC6A4BAE851C87C67624F1270EC4,13911,7,9,2,39,46,1996
33215,33215,3D2ECC6A4BAE851C87C67624F1270EC4,42351,11,23,12,38,45,1945
33216,33216,534F3B1CD78FDD46A8ACE2B5E3E0C898,11261,3,11,8,36,46,1846
33217,33217,534F3B1CD78FDD46A8ACE2B5E3E0C898,13231,12,13,1,39,46,1996
33218,33218,534F3B1CD78FDD46A8ACE2B5E3E0C898,11261,17,21,4,36,46,1846
33219,33219,34B0487DA91675A6216B605C367EE35D,43761,1,7,6,32,47,1647
33220,33220,34B0487DA91675A6216B605C367EE35D,43581,9,17,8,33,48,1698
33221,33221,34B0487DA91675A6216B605C367EE35D,11061,19,21,2,29,48,1498
33222,33222,34B0487DA91675A6216B605C367EE35D,43311,21,22,1,31,48,1598
33228,33228,2A299573B8ADE5EDDBBA5F82D87A0B34,43731,0,12,12,34,47,1747
33229,33229,2A299573B8ADE5EDDBBA5F82D87A0B34,42921,13,16,3,33,47,1697
33230,33230,2A299573B8ADE5EDDBBA5F82D87A0B34,43731,17,23,6,34,47,1747
33245,33245,E051F3A68F183E58DAB85439F9F9C3B1,11954,0,6,6,32,49,1649
33246,33246,E051F3A68F183E58DAB85439F9F9C3B1,13731,8,17,9,33,49,1699
33247,33247,E051F3A68F183E58DAB85439F9F9C3B1,11954,20,21,1,32,49,1649
33248,33248,CC3234747D56D0944870AC7B3BB5CF99,12521,3,6,3,35,41,1791
33249,33249,CC3234747D56D0944870AC7B3BB5CF99,43451,8,10,2,37,40,1890
33250,33250,CC3234747D56D0944870AC7B3BB5CF99,12521,14,19,5,35,41,1791
33265,33265,F4D2972F8183CFAB035866813CF4C6D8,42511,8,10,2,37,47,1897
33266,33266,F4D2972F8183CFAB035866813CF4C6D8,13331,13,15,2,38,47,1947
33267,33267,F4D2972F8183CFAB035866813CF4C6D8,11231,16,18,2,37,49,1899
33283,33283,6D3D88C57BAED90EED5783D123F38AA1,11731,0,2,2,36,48,1848
33284,33284,6D3D88C57BAED90EED5783D123F38AA1,10251,2,12,10,35,47,1797
33285,33285,6D3D88C57BAED90EED5783D123F38AA1,10161,13,20,7,35,49,1799
33286,33286,6D3D88C57BAED90EED5783D123F38AA1,10251,21,22,1,35,47,1797
33291,33291,7FC5EC6D5DFA02928A2B6D37E8B80603,13551,3,5,2,45,38,2288
33292,33292,7FC5EC6D5DFA02928A2B6D37E8B80603,43101,5,15,10,46,40,2340
33293,33293,7FC5EC6D5DFA02928A2B6D37E8B80603,13551,16,18,2,45,38,2288
33294,33294,7FC5EC6D5DFA02928A2B6D37E8B80603,43101,19,21,2,46,40,2340
33309,33309,38BAD20AF3F1C2D76FC5AB52738907B1,10341,10,13,3,31,47,1597
33310,33310,38BAD20AF3F1C2D76FC5AB52738907B1,42141,17,19,2,32,47,1647
33311,33311,38BAD20AF3F1C2D76FC5AB52738907B1,10341,19,23,4,31,47,1597
33320,33320,EAEFCB977DEDF23C1346736B36A6F67B,42351,4,8,4,38,45,1945
33321,33321,EAEFCB977DEDF23C1346736B36A6F67B,42231,8,9,1,37,46,1896
33322,33322,EAEFCB977DEDF23C1346736B36A6F67B,42351,10,11,1,38,45,1945
33323,33323,EAEFCB977DEDF23C1346736B36A6F67B,13911,13,20,7,39,46,1996
33347,33347,A26526FCE25758DA240C3B314B205E8A,19024,0,6,6,9,45,495
33348,33348,A26526FCE25758DA240C3B314B205E8A,12641,7,16,9,10,43,543
33349,33349,A26526FCE25758DA240C3B314B205E8A,19114,16,19,3,7,43,393
33350,33350,A26526FCE25758DA240C3B314B205E8A,19024,20,21,1,9,45,495
33351,33351,E8A3A2F2678AE58B36D710FCF037760E,11231,0,1,1,37,49,1899
33352,33352,E8A3A2F2678AE58B36D710FCF037760E,10411,2,22,20,36,48,1848
33353,33353,E8A3A2F2678AE58B36D710FCF037760E,11231,22,23,1,37,49,1899
33354,33354,2F9BEC5949A1F687FDFE12287F0E1F52,42471,0,2,2,35,49,1799
33355,33355,2F9BEC5949A1F687FDFE12287F0E1F52,40463,3,6,3,38,49,1949
33356,33356,2F9BEC5949A1F687FDFE12287F0E1F52,11021,8,23,15,36,49,1849
33357,33357,0B1AFB24DF884F60B6F408AA4B8B069D,11151,1,13,12,30,48,1548
33358,33358,0B1AFB24DF884F60B6F408AA4B8B069D,11061,16,18,2,29,48,1498
33359,33359,0B1AFB24DF884F60B6F408AA4B8B069D,11151,22,23,1,30,48,1548
33363,33363,A0A00D4FFCF39B121347488247DF3626,12311,3,8,5,30,44,1544
33364,33364,A0A00D4FFCF39B121347488247DF3626,10301,10,16,6,31,45,1595
33365,33365,A0A00D4FFCF39B121347488247DF3626,11875,16,20,4,30,46,1546
33380,33380,4003E07D2A4AF66E84145561FFA003F3,10341,0,14,14,31,47,1597
33381,33381,4003E07D2A4AF66E84145561FFA003F3,10151,15,18,3,34,47,1747
33382,33382,4003E07D2A4AF66E84145561FFA003F3,10341,18,20,2,31,47,1597
33386,33386,AA911EDB017489DAB51923BC75BA2F37,42523,0,6,6,31,47,1597
33387,33387,AA911EDB017489DAB51923BC75BA2F37,11061,7,9,2,29,48,1498
33388,33388,AA911EDB017489DAB51923BC75BA2F37,42523,13,14,1,31,47,1597
33389,33389,AA911EDB017489DAB51923BC75BA2F37,43761,18,21,3,32,47,1647
33390,33390,FCCC7A372AE6BB99A42B9ABB469468AB,10661,1,4,3,37,49,1899
33391,33391,FCCC7A372AE6BB99A42B9ABB469468AB,11271,4,11,7,37,48,1898
33392,33392,FCCC7A372AE6BB99A42B9ABB469468AB,11461,15,17,2,37,49,1899
33393,33393,FCCC7A372AE6BB99A42B9ABB469468AB,11271,21,23,2,37,48,1898
33404,33404,0A24AC6A2DB2B396939A10A8EFCB227D,43951,6,14,8,49,41,2491
33405,33405,0A24AC6A2DB2B396939A10A8EFCB227D,13411,19,20,1,49,42,2492
33406,33406,0A24AC6A2DB2B396939A10A8EFCB227D,43951,20,22,2,49,41,2491
33410,33410,A584DB5FF6EE02AE16BAE873BBEDDAA1,12921,2,12,10,9,41,491
33411,33411,A584DB5FF6EE02AE16BAE873BBEDDAA1,19181,13,14,1,8,40,440
33412,33412,A584DB5FF6EE02AE16BAE873BBEDDAA1,12921,17,23,6,9,41,491
33413,33413,0277E6ABE6E23FB8B51E9078601CBBC1,42491,0,8,8,32,46,1646
33414,33414,0277E6ABE6E23FB8B51E9078601CBBC1,42523,13,18,5,31,47,1597
33415,33415,0277E6ABE6E23FB8B51E9078601CBBC1,42491,22,23,1,32,46,1646
33431,33431,08B76115004F6EB3AEFC7DEF1A1E7865,42401,0,5,5,36,47,1847
33432,33432,08B76115004F6EB3AEFC7DEF1A1E7865,10841,7,9,2,37,47,1897
33433,33433,08B76115004F6EB3AEFC7DEF1A1E7865,42301,9,23,14,36,47,1847
33434,33434,B46F7CFBF42B8DF5990A028C3A15EF50,42531,2,11,9,31,45,1595
33435,33435,B46F7CFBF42B8DF5990A028C3A15EF50,12311,15,17,2,30,44,1544
33436,33436,B46F7CFBF42B8DF5990A028C3A15EF50,42531,18,20,2,31,45,1595
33437,33437,B46F7CFBF42B8DF5990A028C3A15EF50,12311,21,23,2,30,44,1544
33441,33441,C8AB1EA977FB9DDF0741997FF81BCEEE,12311,0,14,14,30,44,1544
33442,33442,C8AB1EA977FB9DDF0741997FF81BCEEE,10351,18,19,1,28,45,1445
33443,33443,C8AB1EA977FB9DDF0741997FF81BCEEE,12311,20,21,1,30,44,1544
33444,33444,E063ED0B410DBCBEA7B106C50A20F760,11491,1,3,2,36,47,1847
33445,33445,E063ED0B410DBCBEA7B106C50A20F760,42941,5,14,9,37,47,1897
33446,33446,E063ED0B410DBCBEA7B106C50A20F760,10251,15,16,1,35,47,1797
33447,33447,E063ED0B410DBCBEA7B106C50A20F760,42301,17,20,3,36,47,1847
33465,33465,6E1487869B5E12737EA94495C079C41B,42231,0,16,16,37,46,1896
33466,33466,6E1487869B5E12737EA94495C079C41B,42351,16,17,1,38,45,1945
33467,33467,6E1487869B5E12737EA94495C079C41B,42231,17,23,6,37,46,1896
33468,33468,0EB744D8CF782A2BC3FD88288C6BBBDF,42371,0,7,7,34,46,1746
33469,33469,0EB744D8CF782A2BC3FD88288C6BBBDF,10841,8,16,8,37,47,1897
33470,33470,0EB744D8CF782A2BC3FD88288C6BBBDF,10531,17,22,5,34,46,1746
33471,33471,D4DE28276D2C825AA4FE715AD291B466,42511,2,5,3,37,47,1897
33472,33472,D4DE28276D2C825AA4FE715AD291B466,13711,7,16,9,38,46,1946
33473,33473,D4DE28276D2C825AA4FE715AD291B466,11941,17,18,1,37,46,1896
33474,33474,D4DE28276D2C825AA4FE715AD291B466,13711,20,21,1,38,46,1946
33479,33479,8F3404E2284E6D378432BD986156ED27,11381,0,15,15,30,47,1547
33480,33480,8F3404E2284E6D378432BD986156ED27,11061,16,18,2,29,48,1498
33481,33481,8F3404E2284E6D378432BD986156ED27,11381,22,23,1,30,47,1547
33482,33482,76780BDA1CE8853E5C6D6B4A56C0AC5B,11381,10,12,2,30,47,1547
33483,33483,76780BDA1CE8853E5C6D6B4A56C0AC5B,12121,12,14,2,29,47,1497
33484,33484,76780BDA1CE8853E5C6D6B4A56C0AC5B,11381,14,21,7,30,47,1547
33485,33485,C20496C873E4D6CBDAA003A1B830833C,11074,10,19,9,37,47,1897
33486,33486,C20496C873E4D6CBDAA003A1B830833C,10107,19,21,2,38,49,1949
33487,33487,C20496C873E4D6CBDAA003A1B830833C,11011,21,22,1,39,49,1999
33506,33506,CFA8075C39ACC82E93A37CA6A9DAA1E6,11231,0,16,16,37,49,1899
33507,33507,CFA8075C39ACC82E93A37CA6A9DAA1E6,10471,16,18,2,37,48,1898
33508,33508,CFA8075C39ACC82E93A37CA6A9DAA1E6,11231,19,23,4,37,49,1899
33509,33509,20EBDF07FAB10C468662B7339874EF65,11806,0,8,8,41,48,2098
33510,33510,20EBDF07FAB10C468662B7339874EF65,42271,8,10,2,40,47,2047
33511,33511,20EBDF07FAB10C468662B7339874EF65,11806,10,22,12,41,48,2098
33516,33516,39179060954ADF536A44D5CDC3D7ADA4,11261,4,7,3,36,46,1846
33517,33517,39179060954ADF536A44D5CDC3D7ADA4,13911,7,8,1,39,46,1996
33518,33518,39179060954ADF536A44D5CDC3D7ADA4,11261,8,23,15,36,46,1846
33519,33519,BE6556F4F32DDBE17FA5A6143CEC24DA,42921,6,7,1,33,47,1697
33520,33520,BE6556F4F32DDBE17FA5A6143CEC24DA,11201,8,17,9,35,49,1799
33521,33521,BE6556F4F32DDBE17FA5A6143CEC24DA,42921,20,23,3,33,47,1697
33522,33522,46D492BAB010922B2E00FA587B30756A,43951,1,19,18,49,41,2491
33523,33523,46D492BAB010922B2E00FA587B30756A,13411,19,21,2,49,42,2492
33524,33524,46D492BAB010922B2E00FA587B30756A,43951,22,23,1,49,41,2491
33525,33525,9A302C9B117B652868AD0F5FDA2B331B,42371,0,7,7,34,46,1746
33526,33526,9A302C9B117B652868AD0F5FDA2B331B,10841,8,16,8,37,47,1897
33527,33527,9A302C9B117B652868AD0F5FDA2B331B,42371,19,23,4,34,46,1746
33528,33528,77806B76C9464C3352C73240356F598A,10771,0,14,14,41,46,2096
33529,33529,77806B76C9464C3352C73240356F598A,13791,17,20,3,42,47,2147
33530,33530,77806B76C9464C3352C73240356F598A,10771,21,23,2,41,46,2096
33539,33539,DEE5888BD7E461DD868275DE6FB19D26,10921,0,13,13,43,48,2198
33540,33540,DEE5888BD7E461DD868275DE6FB19D26,42201,13,15,2,43,46,2196
33541,33541,DEE5888BD7E461DD868275DE6FB19D26,10921,19,23,4,43,48,2198
33545,33545,87E83B17518064E417741F00BFE7BE50,12641,0,9,9,10,43,543
33546,33546,87E83B17518064E417741F00BFE7BE50,19114,10,11,1,7,43,393
33547,33547,87E83B17518064E417741F00BFE7BE50,12641,14,23,9,10,43,543
33548,33548,DCCCB5A87EDB009422985F714C0FA27B,11231,0,14,14,37,49,1899
33549,33549,DCCCB5A87EDB009422985F714C0FA27B,10107,16,17,1,38,49,1949
33550,33550,DCCCB5A87EDB009422985F714C0FA27B,11461,18,23,5,37,49,1899
33556,33556,56577D7E072F237C8DE51C5D025371C7,11021,0,1,1,36,49,1849
33557,33557,56577D7E072F237C8DE51C5D025371C7,13561,5,6,1,37,49,1899
33558,33558,56577D7E072F237C8DE51C5D025371C7,11021,11,18,7,36,49,1849
33559,33559,7ECA73FB8DEF7DF78220D3155339952E,13961,0,6,6,42,48,2148
33560,33560,7ECA73FB8DEF7DF78220D3155339952E,11921,12,18,6,38,48,1948
33561,33561,7ECA73FB8DEF7DF78220D3155339952E,13961,20,23,3,42,48,2148
33562,33562,F14B27CFA07BFF1C03E8748CE04AA105,10341,0,7,7,31,47,1597
33563,33563,F14B27CFA07BFF1C03E8748CE04AA105,11061,12,14,2,29,48,1498
33564,33564,F14B27CFA07BFF1C03E8748CE04AA105,10341,18,23,5,31,47,1597
33568,33568,0AA5586D6B12F9AD29AA699D8536DBEA,11231,0,7,7,37,49,1899
33569,33569,0AA5586D6B12F9AD29AA699D8536DBEA,41271,8,10,2,38,48,1948
33570,33570,0AA5586D6B12F9AD29AA699D8536DBEA,11231,13,23,10,37,49,1899
33571,33571,9D0C016FAC9B03B23F695C0F283D602D,42581,5,18,13,38,48,1948
33572,33572,9D0C016FAC9B03B23F695C0F283D602D,11914,18,19,1,37,48,1898
33573,33573,9D0C016FAC9B03B23F695C0F283D602D,42581,19,21,2,38,48,1948
33574,33574,9D0C016FAC9B03B23F695C0F283D602D,11914,21,22,1,37,48,1898
33575,33575,27E85AEC10BD13BABE08660D8F483253,11491,0,2,2,36,47,1847
33576,33576,27E85AEC10BD13BABE08660D8F483253,42371,3,8,5,34,46,1746
33577,33577,27E85AEC10BD13BABE08660D8F483253,43241,11,21,10,36,46,1846
33578,33578,27E85AEC10BD13BABE08660D8F483253,10271,21,22,1,37,46,1896
33579,33579,D1D5B16F27340AAF330DB0252EB38467,19101,7,11,4,17,29,879
33580,33580,D1D5B16F27340AAF330DB0252EB38467,19531,12,20,8,17,30,880
33581,33581,D1D5B16F27340AAF330DB0252EB38467,19101,21,23,2,17,29,879
33595,33595,A4B13605C78797589D9B98BC8787EDD0,19931,0,9,9,7,43,393
33596,33596,A4B13605C78797589D9B98BC8787EDD0,12921,14,16,2,9,41,491
33597,33597,A4B13605C78797589D9B98BC8787EDD0,19114,19,22,3,7,43,393
33598,33598,93F2A6A1CC13873D05580CA5FB37A1C7,11074,0,17,17,37,47,1897
33599,33599,93F2A6A1CC13873D05580CA5FB37A1C7,11751,20,21,1,35,48,1798
33600,33600,93F2A6A1CC13873D05580CA5FB37A1C7,10841,21,23,2,37,47,1897
33611,33611,10CE970ADBFDF0EB0AA90452C27FCACE,42921,10,11,1,33,47,1697
33612,33612,10CE970ADBFDF0EB0AA90452C27FCACE,10971,15,17,2,35,47,1797
33613,33613,10CE970ADBFDF0EB0AA90452C27FCACE,42921,18,19,1,33,47,1697
33617,33617,E4E11D5BABE3812603202CD337AEBF21,42141,0,14,14,32,47,1647
33618,33618,E4E11D5BABE3812603202CD337AEBF21,42071,15,17,2,31,49,1599
33619,33619,E4E11D5BABE3812603202CD337AEBF21,43761,19,23,4,32,47,1647
33620,33620,AFF2B1944207762129EB0E25C3502ADB,13121,0,3,3,38,46,1946
33621,33621,AFF2B1944207762129EB0E25C3502ADB,11941,3,6,3,37,46,1896
33622,33622,AFF2B1944207762129EB0E25C3502ADB,13711,7,10,3,38,46,1946
33623,33623,AFF2B1944207762129EB0E25C3502ADB,11941,14,19,5,37,46,1896
33624,33624,895085FE0B62D7BCDF8725B5DB48E546,42521,0,6,6,31,47,1597
33625,33625,895085FE0B62D7BCDF8725B5DB48E546,11061,6,15,9,29,48,1498
33626,33626,895085FE0B62D7BCDF8725B5DB48E546,43971,16,23,7,30,48,1548
33627,33627,394D700E14C58A7853C10805B183B24E,11061,0,6,6,29,48,1498
33628,33628,394D700E14C58A7853C10805B183B24E,11381,6,7,1,30,47,1547
33629,33629,394D700E14C58A7853C10805B183B24E,11875,9,18,9,30,46,1546
33630,33630,394D700E14C58A7853C10805B183B24E,11381,19,21,2,30,47,1547
33631,33631,E41EFAEAC6CC7189E20FB98542ADB1CF,13101,0,14,14,40,47,2047
33632,33632,E41EFAEAC6CC7189E20FB98542ADB1CF,11804,19,20,1,41,48,2098
33633,33633,E41EFAEAC6CC7189E20FB98542ADB1CF,13101,22,23,1,40,47,2047
33639,33639,E779DF22EB61C0D4BA72F0FBA1762DF8,40171,6,9,3,38,48,1948
33640,33640,E779DF22EB61C0D4BA72F0FBA1762DF8,11914,11,20,9,37,48,1898
33641,33641,E779DF22EB61C0D4BA72F0FBA1762DF8,43181,20,21,1,39,48,1998
33642,33642,2D7ACF8AD7E4B49F2A7FD23DB75DC6F1,42971,0,6,6,43,49,2199
33643,33643,2D7ACF8AD7E4B49F2A7FD23DB75DC6F1,11741,6,10,4,42,49,2149
33644,33644,2D7ACF8AD7E4B49F2A7FD23DB75DC6F1,42971,12,23,11,43,49,2199
33645,33645,37D12B9A785069D9567B986D8917ECC5,10351,8,9,1,28,45,1445
33646,33646,37D12B9A785069D9567B986D8917ECC5,11381,9,11,2,30,47,1547
33647,33647,37D12B9A785069D9567B986D8917ECC5,10351,12,22,10,28,45,1445
33669,33669,A4CAD684439EE83A78C48121BECB1270,10111,0,8,8,37,47,1897
33670,33670,A4CAD684439EE83A78C48121BECB1270,10471,8,10,2,37,48,1898
33671,33671,A4CAD684439EE83A78C48121BECB1270,42161,14,21,7,36,47,1847
33672,33672,669C34237215178780FBCDB7F5444D7E,42521,1,10,9,31,47,1597
33673,33673,669C34237215178780FBCDB7F5444D7E,11061,14,17,3,29,48,1498
33674,33674,669C34237215178780FBCDB7F5444D7E,42521,17,19,2,31,47,1597
33675,33675,669C34237215178780FBCDB7F5444D7E,11381,22,23,1,30,47,1547
33676,33676,C13EDA65C3B019881628338CF4BA6FEF,42491,0,11,11,32,46,1646
33677,33677,C13EDA65C3B019881628338CF4BA6FEF,42523,11,13,2,31,47,1597
33678,33678,C13EDA65C3B019881628338CF4BA6FEF,42491,14,20,6,32,46,1646
33679,33679,C13EDA65C3B019881628338CF4BA6FEF,42523,20,21,1,31,47,1597
33680,33680,AEA8FBA757B3B3C24D247B550010D92E,10251,0,9,9,35,47,1797
33681,33681,AEA8FBA757B3B3C24D247B550010D92E,13601,9,13,4,34,47,1747
33682,33682,AEA8FBA757B3B3C24D247B550010D92E,42161,14,16,2,36,47,1847
33683,33683,AEA8FBA757B3B3C24D247B550010D92E,10971,16,21,5,35,47,1797
33688,33688,C0EC240E36490D1263D83D45770C29BF,42321,0,7,7,43,47,2197
33689,33689,C0EC240E36490D1263D83D45770C29BF,42091,7,16,9,43,46,2196
33690,33690,C0EC240E36490D1263D83D45770C29BF,42321,19,22,3,43,47,2197
33691,33691,7530DD650D6B9F35AF2A10C87B86C4D0,42081,0,3,3,24,49,1249
33692,33692,7530DD650D6B9F35AF2A10C87B86C4D0,42681,3,4,1,24,48,1248
33693,33693,7530DD650D6B9F35AF2A10C87B86C4D0,42081,7,18,11,24,49,1249
33697,33697,8097645712CA620CED99D44F8678451D,41271,9,12,3,38,48,1948
33698,33698,8097645712CA620CED99D44F8678451D,40951,14,15,1,36,49,1849
33699,33699,8097645712CA620CED99D44F8678451D,11751,15,19,4,35,48,1798
33700,33700,7EF8399B7744B26431FFE3070C9BD313,42041,0,5,5,10,47,547
33701,33701,7EF8399B7744B26431FFE3070C9BD313,19441,8,10,2,8,46,446
33702,33702,7EF8399B7744B26431FFE3070C9BD313,42041,12,13,1,10,47,547
33703,33703,7EF8399B7744B26431FFE3070C9BD313,19441,13,22,9,8,46,446
33704,33704,700A8469B8648E235281334EF5CC8DA1,11231,0,9,9,37,49,1899
33705,33705,700A8469B8648E235281334EF5CC8DA1,10471,9,11,2,37,48,1898
33706,33706,700A8469B8648E235281334EF5CC8DA1,10371,12,23,11,37,49,1899
33711,33711,2F3FBE39EE4E3AB748593134D6A2A772,42231,0,6,6,37,46,1896
33712,33712,2F3FBE39EE4E3AB748593134D6A2A772,42351,7,8,1,38,45,1945
33713,33713,2F3FBE39EE4E3AB748593134D6A2A772,42231,12,22,10,37,46,1896
33717,33717,B0E329B00E3FA297B870177AA9BA63AC,42141,0,13,13,32,47,1647
33718,33718,B0E329B00E3FA297B870177AA9BA63AC,42523,14,16,2,31,47,1597
33719,33719,B0E329B00E3FA297B870177AA9BA63AC,43761,17,23,6,32,47,1647
33720,33720,ABC9186267E71F28FA785B0F903DDD72,10471,1,8,7,37,48,1898
33721,33721,ABC9186267E71F28FA785B0F903DDD72,11811,9,10,1,38,49,1949
33722,33722,ABC9186267E71F28FA785B0F903DDD72,10471,10,11,1,37,48,1898
33723,33723,ABC9186267E71F28FA785B0F903DDD72,40171,11,22,11,38,48,1948
33724,33724,0AE1F060A9917578AF6CC39BEF4A5FD7,11074,2,7,5,37,47,1897
33725,33725,0AE1F060A9917578AF6CC39BEF4A5FD7,10371,8,18,10,37,49,1899
33726,33726,0AE1F060A9917578AF6CC39BEF4A5FD7,42271,19,23,4,40,47,2047
33727,33727,E835E54D31E2053FF59F5E3D61ABCD72,11151,0,7,7,30,48,1548
33728,33728,E835E54D31E2053FF59F5E3D61ABCD72,11061,9,10,1,29,48,1498
33729,33729,E835E54D31E2053FF59F5E3D61ABCD72,11151,11,21,10,30,48,1548
33744,33744,A923C41770F47C64367C4A31C06C83C7,42523,4,7,3,31,47,1597
33745,33745,A923C41770F47C64367C4A31C06C83C7,10292,8,18,10,30,47,1547
33746,33746,A923C41770F47C64367C4A31C06C83C7,42523,18,20,2,31,47,1597
33752,33752,1AEA44F051EC107D454C59951DC8E3E5,10771,0,7,7,41,46,2096
33753,33753,1AEA44F051EC107D454C59951DC8E3E5,13111,11,13,2,42,46,2146
33754,33754,1AEA44F051EC107D454C59951DC8E3E5,13791,13,19,6,42,47,2147
33755,33755,1AEA44F051EC107D454C59951DC8E3E5,13111,20,23,3,42,46,2146
33760,33760,147D4CA14E030CF5CD446F8C173CED55,11061,6,8,2,29,48,1498
33761,33761,147D4CA14E030CF5CD446F8C173CED55,10292,9,21,12,30,47,1547
33762,33762,147D4CA14E030CF5CD446F8C173CED55,11061,21,23,2,29,48,1498
33763,33763,DA1489BF10C5E54D6333A158A065E13C,43761,4,12,8,32,47,1647
33764,33764,DA1489BF10C5E54D6333A158A065E13C,10381,13,15,2,31,49,1599
33765,33765,DA1489BF10C5E54D6333A158A065E13C,42141,16,23,7,32,47,1647
33766,33766,E9E990F48245ACFDBDC8F1C95015FE95,42301,0,14,14,36,47,1847
33767,33767,E9E990F48245ACFDBDC8F1C95015FE95,13121,14,16,2,38,46,1946
33768,33768,E9E990F48245ACFDBDC8F1C95015FE95,42301,18,23,5,36,47,1847
33769,33769,7F8FEC3F30CB3DD9FA8B49EBAA16E6AE,10111,0,8,8,37,47,1897
33770,33770,7F8FEC3F30CB3DD9FA8B49EBAA16E6AE,10471,9,10,1,37,48,1898
33771,33771,7F8FEC3F30CB3DD9FA8B49EBAA16E6AE,10111,10,23,13,37,47,1897
33772,33772,5B51BC643A26489396AC90A6305DBADE,11231,0,7,7,37,49,1899
33773,33773,5B51BC643A26489396AC90A6305DBADE,13731,9,18,9,33,49,1699
33774,33774,5B51BC643A26489396AC90A6305DBADE,11231,18,23,5,37,49,1899
33787,33787,50BCF56CF143674E53B5B2FDFFF9711E,42141,8,11,3,32,47,1647
33788,33788,50BCF56CF143674E53B5B2FDFFF9711E,10281,14,15,1,33,48,1698
33789,33789,50BCF56CF143674E53B5B2FDFFF9711E,43761,18,19,1,32,47,1647
33801,33801,4560AA6E9FF5488D13E472C26129D09F,12514,0,15,15,38,47,1947
33802,33802,4560AA6E9FF5488D13E472C26129D09F,42511,15,16,1,37,47,1897
33803,33803,4560AA6E9FF5488D13E472C26129D09F,13681,20,23,3,38,47,1947
33810,33810,CF7D34E0CAAC53341408143F5EE5A475,10951,3,4,1,29,48,1498
33811,33811,CF7D34E0CAAC53341408143F5EE5A475,40331,6,19,13,30,47,1547
33812,33812,CF7D34E0CAAC53341408143F5EE5A475,10951,20,21,1,29,48,1498
33813,33813,CF7D34E0CAAC53341408143F5EE5A475,11381,21,23,2,30,47,1547
33819,33819,9D5FAD2D946916458AB09D98B7F6CB85,11641,1,8,7,22,49,1149
33820,33820,9D5FAD2D946916458AB09D98B7F6CB85,42081,8,10,2,24,49,1249
33821,33821,9D5FAD2D946916458AB09D98B7F6CB85,42623,13,23,10,22,49,1149
33822,33822,7A5DEDC7FE052035815232A8310135E2,11151,0,10,10,30,48,1548
33823,33823,7A5DEDC7FE052035815232A8310135E2,11061,11,13,2,29,48,1498
33824,33824,7A5DEDC7FE052035815232A8310135E2,11151,14,15,1,30,48,1548
33825,33825,7A5DEDC7FE052035815232A8310135E2,11061,19,23,4,29,48,1498
33837,33837,0513D4A0850C5AAFBF193D222DECEC20,12311,0,6,6,30,44,1544
33838,33838,0513D4A0850C5AAFBF193D222DECEC20,10301,8,10,2,31,45,1595
33839,33839,0513D4A0850C5AAFBF193D222DECEC20,13671,12,15,3,27,43,1393
33840,33840,0513D4A0850C5AAFBF193D222DECEC20,12311,20,23,3,30,44,1544
33852,33852,D8063B7C8CAA23F18B002D2A443A5135,43951,2,12,10,49,41,2491
33853,33853,D8063B7C8CAA23F18B002D2A443A5135,43101,14,15,1,46,40,2340
33854,33854,D8063B7C8CAA23F18B002D2A443A5135,43951,20,22,2,49,41,2491
33855,33855,804B7737707030C63DF2E4BD94DF220F,11806,0,7,7,41,48,2098
33856,33856,804B7737707030C63DF2E4BD94DF220F,42271,9,12,3,40,47,2047
33857,33857,804B7737707030C63DF2E4BD94DF220F,11806,13,23,10,41,48,2098
33858,33858,0AFAF8C12B0A136F334DBF2EEFFABEC7,42161,10,12,2,36,47,1847
33859,33859,0AFAF8C12B0A136F334DBF2EEFFABEC7,10411,12,18,6,36,48,1848
33860,33860,0AFAF8C12B0A136F334DBF2EEFFABEC7,42161,19,23,4,36,47,1847
33861,33861,7F683BD350227B09C7ECC1328A0C4739,42011,0,7,7,36,46,1846
33862,33862,7F683BD350227B09C7ECC1328A0C4739,10271,11,14,3,37,46,1896
33863,33863,7F683BD350227B09C7ECC1328A0C4739,42011,16,23,7,36,46,1846
33869,33869,7ABE41EB39A3EDCDD2AEC8825DC85CC5,11061,4,6,2,29,48,1498
33870,33870,7ABE41EB39A3EDCDD2AEC8825DC85CC5,10681,7,17,10,30,48,1548
33871,33871,7ABE41EB39A3EDCDD2AEC8825DC85CC5,11381,17,18,1,30,47,1547
33872,33872,7ABE41EB39A3EDCDD2AEC8825DC85CC5,10681,19,23,4,30,48,1548
33879,33879,8167EF05D15F996A6B93D96BD3E78468,10771,3,11,8,41,46,2096
33880,33880,8167EF05D15F996A6B93D96BD3E78468,12514,12,14,2,38,47,1947
33881,33881,8167EF05D15F996A6B93D96BD3E78468,43481,17,19,2,39,48,1998
33886,33886,DD7D3569C4BD229FB79C93D9EAD10504,12381,0,19,19,32,48,1648
33887,33887,DD7D3569C4BD229FB79C93D9EAD10504,12121,20,21,1,29,47,1497
33888,33888,DD7D3569C4BD229FB79C93D9EAD10504,12381,21,23,2,32,48,1648
33889,33889,C247820FF94535A6E7B0AE8ABDC5672D,42631,3,8,5,43,45,2195
33890,33890,C247820FF94535A6E7B0AE8ABDC5672D,12221,10,11,1,43,44,2194
33891,33891,C247820FF94535A6E7B0AE8ABDC5672D,13341,12,17,5,44,45,2245
33892,33892,C247820FF94535A6E7B0AE8ABDC5672D,11001,20,23,3,42,47,2147
33893,33893,DDF363C64B8F6ACF3450F0B1AA087EA1,19441,7,15,8,8,46,446
33894,33894,DDF363C64B8F6ACF3450F0B1AA087EA1,42041,15,17,2,10,47,547
33895,33895,DDF363C64B8F6ACF3450F0B1AA087EA1,19621,20,23,3,5,46,296
33901,33901,8E0D20320C5276BDD797BA6D65B9C51D,11074,0,7,7,37,47,1897
33902,33902,8E0D20320C5276BDD797BA6D65B9C51D,11231,9,16,7,37,49,1899
33903,33903,8E0D20320C5276BDD797BA6D65B9C51D,11074,20,23,3,37,47,1897
33907,33907,31CBC77871B7612C90BD0F8F8FF24A20,42321,0,6,6,43,47,2197
33908,33908,31CBC77871B7612C90BD0F8F8FF24A20,10801,7,19,12,42,47,2147
33909,33909,31CBC77871B7612C90BD0F8F8FF24A20,42321,20,22,2,43,47,2197
33916,33916,10B8A2D44211CACA01D59967B38E8576,42161,0,9,9,36,47,1847
33917,33917,10B8A2D44211CACA01D59967B38E8576,10251,11,19,8,35,47,1797
33918,33918,10B8A2D44211CACA01D59967B38E8576,42161,20,23,3,36,47,1847
33919,33919,D59A7D67E6A2D306517724C5A50D5385,10351,0,10,10,28,45,1445
33920,33920,D59A7D67E6A2D306517724C5A50D5385,42531,11,19,8,31,45,1595
33921,33921,D59A7D67E6A2D306517724C5A50D5385,10351,20,21,1,28,45,1445
33922,33922,6C6BC146AEBEF851AEEEDE2CDE87BAD0,12641,0,10,10,10,43,543
33923,33923,6C6BC146AEBEF851AEEEDE2CDE87BAD0,19114,12,13,1,7,43,393
33924,33924,6C6BC146AEBEF851AEEEDE2CDE87BAD0,12641,17,23,6,10,43,543
33939,33939,3AE63A5055E736CBCC5634D603296607,11461,0,15,15,37,49,1899
33940,33940,3AE63A5055E736CBCC5634D603296607,10431,15,17,2,33,49,1699
33941,33941,3AE63A5055E736CBCC5634D603296607,10107,21,23,2,38,49,1949
33946,33946,8D188B1328CA03E5FCB5F80DC745FFDD,42523,0,11,11,31,47,1597
33947,33947,8D188B1328CA03E5FCB5F80DC745FFDD,43471,18,20,2,31,49,1599
33948,33948,8D188B1328CA03E5FCB5F80DC745FFDD,42523,22,23,1,31,47,1597
33954,33954,2648C45FE5CC239A366DE45F7AAB1FCB,13911,0,9,9,39,46,1996
33955,33955,2648C45FE5CC239A366DE45F7AAB1FCB,42351,10,12,2,38,45,1945
33956,33956,2648C45FE5CC239A366DE45F7AAB1FCB,13911,13,21,8,39,46,1996
33963,33963,48A980CCF2A198BF882581E8F9F510C5,42771,2,6,4,36,47,1847
33964,33964,48A980CCF2A198BF882581E8F9F510C5,10111,7,21,14,37,47,1897
33965,33965,48A980CCF2A198BF882581E8F9F510C5,42301,22,23,1,36,47,1847
33969,33969,C1E5BCC1C7F8ECB908A80076B478386E,10691,0,6,6,33,48,1698
33970,33970,C1E5BCC1C7F8ECB908A80076B478386E,11561,9,10,1,32,49,1649
33971,33971,C1E5BCC1C7F8ECB908A80076B478386E,10431,14,20,6,33,49,1699
33972,33972,C1E5BCC1C7F8ECB908A80076B478386E,11171,21,22,1,33,48,1698
33973,33973,EF7A20DA8B1B5B9AEB04342FCDE03590,42271,1,14,13,40,47,2047
33974,33974,EF7A20DA8B1B5B9AEB04342FCDE03590,11794,15,17,2,38,49,1949
33975,33975,EF7A20DA8B1B5B9AEB04342FCDE03590,42271,18,20,2,40,47,2047
33989,33989,26A4E7AD001291610BB2E4F05F35E9EC,40421,0,1,1,37,48,1898
33990,33990,26A4E7AD001291610BB2E4F05F35E9EC,10111,3,11,8,37,47,1897
33991,33991,26A4E7AD001291610BB2E4F05F35E9EC,42281,17,18,1,40,48,2048
33992,33992,26A4E7AD001291610BB2E4F05F35E9EC,40421,22,23,1,37,48,1898
33993,33993,4515D69DA9DF7C67BD58AB71BAA57E58,11914,0,11,11,37,48,1898
33994,33994,4515D69DA9DF7C67BD58AB71BAA57E58,40171,12,14,2,38,48,1948
33995,33995,4515D69DA9DF7C67BD58AB71BAA57E58,10471,14,23,9,37,48,1898
33996,33996,4E7F2D3D18319A22EB657663CB37EE04,42864,0,7,7,38,44,1944
33997,33997,4E7F2D3D18319A22EB657663CB37EE04,42231,8,11,3,37,46,1896
33998,33998,4E7F2D3D18319A22EB657663CB37EE04,42864,12,23,11,38,44,1944
33999,33999,C1035E7091A0E4A79008248101DEF034,11381,0,8,8,30,47,1547
34000,34000,C1035E7091A0E4A79008248101DEF034,11061,9,11,2,29,48,1498
34001,34001,C1035E7091A0E4A79008248101DEF034,11381,13,16,3,30,47,1547
34002,34002,C1035E7091A0E4A79008248101DEF034,11061,16,22,6,29,48,1498
34006,34006,F1D52E271AD2CA60B9DB39C5E4BE77A4,12641,3,5,2,10,43,543
34007,34007,F1D52E271AD2CA60B9DB39C5E4BE77A4,19021,6,16,10,10,45,545
34008,34008,F1D52E271AD2CA60B9DB39C5E4BE77A4,12641,19,23,4,10,43,543
34009,34009,24CACD73BA8D75767DDD668E5EA165E2,11914,6,10,4,37,48,1898
34010,34010,24CACD73BA8D75767DDD668E5EA165E2,40171,11,13,2,38,48,1948
34011,34011,24CACD73BA8D75767DDD668E5EA165E2,11914,13,18,5,37,48,1898
34012,34012,24CACD73BA8D75767DDD668E5EA165E2,11921,19,21,2,38,48,1948
34019,34019,9793A85FD5F8245DB87C881D3A802622,12661,0,5,5,32,45,1645
34020,34020,9793A85FD5F8245DB87C881D3A802622,10351,6,7,1,28,45,1445
34021,34021,9793A85FD5F8245DB87C881D3A802622,12661,12,22,10,32,45,1645
34035,34035,6AE2FA19F90C6BBDAB69E2E1C7BD408D,11914,0,5,5,37,48,1898
34036,34036,6AE2FA19F90C6BBDAB69E2E1C7BD408D,11921,7,11,4,38,48,1948
34037,34037,6AE2FA19F90C6BBDAB69E2E1C7BD408D,11914,13,19,6,37,48,1898
34038,34038,C6CE1BC9B69267948B78869F2B1A69E1,10731,0,7,7,33,47,1697
34039,34039,C6CE1BC9B69267948B78869F2B1A69E1,11861,10,12,2,32,47,1647
34040,34040,C6CE1BC9B69267948B78869F2B1A69E1,10731,13,22,9,33,47,1697
34056,34056,DB5FC02E3FCB46BFAB970391F0DE49BF,11861,0,11,11,32,47,1647
34057,34057,DB5FC02E3FCB46BFAB970391F0DE49BF,10281,11,16,5,33,48,1698
34058,34058,DB5FC02E3FCB46BFAB970391F0DE49BF,11861,17,22,5,32,47,1647
34059,34059,C0EBF471F94BEEDB1281493ACFF571D1,42401,0,7,7,36,47,1847
34060,34060,C0EBF471F94BEEDB1281493ACFF571D1,11201,8,9,1,35,49,1799
34061,34061,C0EBF471F94BEEDB1281493ACFF571D1,42161,12,15,3,36,47,1847
34062,34062,C0EBF471F94BEEDB1281493ACFF571D1,10471,19,22,3,37,48,1898
34063,34063,A5985BC498E0A51C59FCA0D4DD429277,41392,0,9,9,43,48,2198
34064,34064,A5985BC498E0A51C59FCA0D4DD429277,11291,13,15,2,40,49,2049
34065,34065,A5985BC498E0A51C59FCA0D4DD429277,40691,15,17,2,42,48,2148
34066,34066,A5985BC498E0A51C59FCA0D4DD429277,41393,21,23,2,43,49,2199
34079,34079,85B29A2F7FF35790227E6EB92B7FBDCF,42351,2,8,6,38,45,1945
34080,34080,85B29A2F7FF35790227E6EB92B7FBDCF,11261,10,11,1,36,46,1846
34081,34081,85B29A2F7FF35790227E6EB92B7FBDCF,42351,12,13,1,38,45,1945
34082,34082,85B29A2F7FF35790227E6EB92B7FBDCF,11261,13,23,10,36,46,1846
34090,34090,A86A2549CD02B65958808F3EC9B7BFBD,13911,0,2,2,39,46,1996
34091,34091,A86A2549CD02B65958808F3EC9B7BFBD,11261,6,8,2,36,46,1846
34092,34092,A86A2549CD02B65958808F3EC9B7BFBD,13911,8,10,2,39,46,1996
34093,34093,A86A2549CD02B65958808F3EC9B7BFBD,11261,12,22,10,36,46,1846
34094,34094,4DF3C091EB814BBFB3CE5DF6F2B4BD49,12641,0,15,15,10,43,543
34095,34095,4DF3C091EB814BBFB3CE5DF6F2B4BD49,19114,16,20,4,7,43,393
34096,34096,4DF3C091EB814BBFB3CE5DF6F2B4BD49,12641,20,22,2,10,43,543
34102,34102,0BC1BC9FA127A76D4558FF0A0EC8FEFB,42921,0,7,7,33,47,1697
34103,34103,0BC1BC9FA127A76D4558FF0A0EC8FEFB,10281,8,9,1,33,48,1698
34104,34104,0BC1BC9FA127A76D4558FF0A0EC8FEFB,13601,11,14,3,34,47,1747
34105,34105,0BC1BC9FA127A76D4558FF0A0EC8FEFB,42921,15,21,6,33,47,1697
34109,34109,17A4E00C733F721F255B23A4DF169A99,10491,2,12,10,33,48,1698
34110,34110,17A4E00C733F721F255B23A4DF169A99,11381,12,15,3,30,47,1547
34111,34111,17A4E00C733F721F255B23A4DF169A99,12381,16,18,2,32,48,1648
34112,34112,17A4E00C733F721F255B23A4DF169A99,11381,22,23,1,30,47,1547
34140,34140,ED36A592544F9D3B4DC283835B5C723A,13101,9,10,1,40,47,2047
34141,34141,ED36A592544F9D3B4DC283835B5C723A,11481,12,19,7,41,48,2098
34142,34142,ED36A592544F9D3B4DC283835B5C723A,42271,20,21,1,40,47,2047
34146,34146,B7832DB383CB1E7DD6C87A81AAE89D66,11231,0,1,1,37,49,1899
34147,34147,B7832DB383CB1E7DD6C87A81AAE89D66,10901,2,7,5,35,48,1798
34148,34148,B7832DB383CB1E7DD6C87A81AAE89D66,11231,11,23,12,37,49,1899
34149,34149,F43476BBF49FF8A7E4D0E7D4165D7B1D,42231,0,7,7,37,46,1896
34150,34150,F43476BBF49FF8A7E4D0E7D4165D7B1D,11261,11,14,3,36,46,1846
34151,34151,F43476BBF49FF8A7E4D0E7D4165D7B1D,42861,16,17,1,37,44,1894
34152,34152,F43476BBF49FF8A7E4D0E7D4165D7B1D,42231,19,23,4,37,46,1896
34153,34153,442785976ECE3A21AB2E12E8FCC04E3B,42523,0,6,6,31,47,1597
34154,34154,442785976ECE3A21AB2E12E8FCC04E3B,42491,7,17,10,32,46,1646
34155,34155,442785976ECE3A21AB2E12E8FCC04E3B,42523,19,21,2,31,47,1597
34159,34159,0C3EDD26A7ED891A1146E2AB7A623C19,10151,0,9,9,34,47,1747
34160,34160,0C3EDD26A7ED891A1146E2AB7A623C19,10971,10,17,7,35,47,1797
34161,34161,0C3EDD26A7ED891A1146E2AB7A623C19,10151,18,22,4,34,47,1747
34162,34162,C70FF977FA3BD2286D57535D98EFE336,10111,1,10,9,37,47,1897
34163,34163,C70FF977FA3BD2286D57535D98EFE336,11551,14,16,2,39,49,1999
34164,34164,C70FF977FA3BD2286D57535D98EFE336,10111,20,21,1,37,47,1897
34165,34165,5E269639C787C5D2BDF7F359B5257597,13381,0,7,7,39,47,1997
34166,34166,5E269639C787C5D2BDF7F359B5257597,11481,8,18,10,41,48,2098
34167,34167,5E269639C787C5D2BDF7F359B5257597,13381,19,23,4,39,47,1997
34178,34178,CC1D3C2DA42F1EBED6688749C3DA1D87,11381,0,10,10,30,47,1547
34179,34179,CC1D3C2DA42F1EBED6688749C3DA1D87,11061,14,15,1,29,48,1498
34180,34180,CC1D3C2DA42F1EBED6688749C3DA1D87,11381,15,18,3,30,47,1547
34205,34205,87DA57462D476367AB276D1A619F26E5,11151,0,8,8,30,48,1548
34206,34206,87DA57462D476367AB276D1A619F26E5,43391,9,12,3,29,48,1498
34207,34207,87DA57462D476367AB276D1A619F26E5,11151,12,19,7,30,48,1548
34208,34208,58098C95EBB5313B1B7006269C40D97A,10121,0,14,14,36,49,1849
34209,34209,58098C95EBB5313B1B7006269C40D97A,11231,15,16,1,37,49,1899
34210,34210,58098C95EBB5313B1B7006269C40D97A,10121,18,23,5,36,49,1849
34211,34211,51B36D67A1ACB097C61E398C8B8124AC,43761,1,7,6,32,47,1647
34212,34212,51B36D67A1ACB097C61E398C8B8124AC,42523,9,11,2,31,47,1597
34213,34213,51B36D67A1ACB097C61E398C8B8124AC,11861,12,21,9,32,47,1647
34214,34214,3D4D278B3D58167073B4ACCB11432DB2,13094,0,5,5,21,42,1092
34215,34215,3D4D278B3D58167073B4ACCB11432DB2,12671,5,8,3,21,43,1093
34216,34216,3D4D278B3D58167073B4ACCB11432DB2,13091,8,9,1,20,42,1042
34217,34217,3D4D278B3D58167073B4ACCB11432DB2,12671,10,20,10,21,43,1093
34218,34218,3F610288646E91F0293396CEFA65A672,13511,1,7,6,34,48,1748
34219,34219,3F610288646E91F0293396CEFA65A672,11911,8,14,6,37,48,1898
34220,34220,3F610288646E91F0293396CEFA65A672,10281,17,21,4,33,48,1698
34221,34221,3F610288646E91F0293396CEFA65A672,11753,21,23,2,35,48,1798
34232,34232,4B5C492CF16B079882322240829D6566,11231,0,9,9,37,49,1899
34233,34233,4B5C492CF16B079882322240829D6566,10471,10,12,2,37,48,1898
34234,34234,4B5C492CF16B079882322240829D6566,11231,15,21,6,37,49,1899
34240,34240,11D0C3BFA1EEA48E71CAB72BD84A5D2F,13671,2,6,4,27,43,1393
34241,34241,11D0C3BFA1EEA48E71CAB72BD84A5D2F,10634,6,8,2,27,45,1395
34242,34242,11D0C3BFA1EEA48E71CAB72BD84A5D2F,10351,11,14,3,28,45,1445
34243,34243,11D0C3BFA1EEA48E71CAB72BD84A5D2F,10634,17,18,1,27,45,1395
34257,34257,2FC977AAECB05F28AE0C53353C4DD1FC,13121,0,15,15,38,46,1946
34258,34258,2FC977AAECB05F28AE0C53353C4DD1FC,10271,17,18,1,37,46,1896
34259,34259,2FC977AAECB05F28AE0C53353C4DD1FC,13121,20,23,3,38,46,1946
34265,34265,C7CE7192CEA544B45335555D251F889F,13681,3,9,6,38,47,1947
34266,34266,C7CE7192CEA544B45335555D251F889F,42511,9,12,3,37,47,1897
34267,34267,C7CE7192CEA544B45335555D251F889F,13121,13,19,6,38,46,1946
34268,34268,E8F5F4A78C0DE5C1EE8D56EB7226C7B2,11131,0,9,9,33,48,1698
34269,34269,E8F5F4A78C0DE5C1EE8D56EB7226C7B2,42471,11,21,10,35,49,1799
34270,34270,E8F5F4A78C0DE5C1EE8D56EB7226C7B2,11131,21,23,2,33,48,1698
34274,34274,878056C296B20CAD11EA9623EF308C26,11074,0,4,4,37,47,1897
34275,34275,878056C296B20CAD11EA9623EF308C26,13561,8,10,2,37,49,1899
34276,34276,878056C296B20CAD11EA9623EF308C26,11074,11,22,11,37,47,1897
34283,34283,F41482495C7C1BFF3B02971058475A44,42021,0,12,12,33,47,1697
34284,34284,F41482495C7C1BFF3B02971058475A44,42161,13,15,2,36,47,1847
34285,34285,F41482495C7C1BFF3B02971058475A44,42021,16,23,7,33,47,1697
34289,34289,26B9AAC369331C3B7CCBFCA623526739,13461,2,13,11,39,44,1994
34290,34290,26B9AAC369331C3B7CCBFCA623526739,10811,15,16,1,38,46,1946
34291,34291,26B9AAC369331C3B7CCBFCA623526739,13461,18,20,2,39,44,1994
34292,34292,4C479F308A99C28A9312A97B8F351EC7,10431,0,8,8,33,49,1699
34293,34293,4C479F308A99C28A9312A97B8F351EC7,12971,11,14,3,32,48,1648
34294,34294,4C479F308A99C28A9312A97B8F351EC7,11021,18,23,5,36,49,1849
34298,34298,38FB09D98F279F59CE399773ACB503E3,13651,0,16,16,30,47,1547
34299,34299,38FB09D98F279F59CE399773ACB503E3,42523,17,18,1,31,47,1597
34300,34300,38FB09D98F279F59CE399773ACB503E3,13651,20,22,2,30,47,1547
34309,34309,6B8EFEBEF5489C021016731A730F97CB,42371,0,1,1,34,46,1746
34310,34310,6B8EFEBEF5489C021016731A730F97CB,42151,2,5,3,35,45,1795
34311,34311,6B8EFEBEF5489C021016731A730F97CB,42371,5,23,18,34,46,1746
34332,34332,0F3B9D51ABEBD568D2353EE492F4DCAE,10471,1,3,2,37,48,1898
34333,34333,0F3B9D51ABEBD568D2353EE492F4DCAE,42581,8,17,9,38,48,1948
34334,34334,0F3B9D51ABEBD568D2353EE492F4DCAE,10471,19,23,4,37,48,1898
34355,34355,34742BC5A2A667B03D313FF35D998A11,11074,0,4,4,37,47,1897
34356,34356,34742BC5A2A667B03D313FF35D998A11,42161,6,14,8,36,47,1847
34357,34357,34742BC5A2A667B03D313FF35D998A11,12841,14,15,1,37,47,1897
34358,34358,34742BC5A2A667B03D313FF35D998A11,42161,16,22,6,36,47,1847
34376,34376,3F0EDFFC6E18B4A03094543F5DAD11AE,43761,0,4,4,32,47,1647
34377,34377,3F0EDFFC6E18B4A03094543F5DAD11AE,42521,5,10,5,31,47,1597
34378,34378,3F0EDFFC6E18B4A03094543F5DAD11AE,43761,13,18,5,32,47,1647
34379,34379,3F0EDFFC6E18B4A03094543F5DAD11AE,42521,19,21,2,31,47,1597
34386,34386,296E7B917A1C9BBE703645D1D7E31230,11231,0,5,5,37,49,1899
34387,34387,296E7B917A1C9BBE703645D1D7E31230,10901,10,13,3,35,48,1798
34388,34388,296E7B917A1C9BBE703645D1D7E31230,11231,15,17,2,37,49,1899
34389,34389,296E7B917A1C9BBE703645D1D7E31230,11731,17,20,3,36,48,1848
34390,34390,DEAED68AE3C073AACA878B29D6C9BBC2,42231,2,11,9,37,46,1896
34391,34391,DEAED68AE3C073AACA878B29D6C9BBC2,42351,12,13,1,38,45,1945
34392,34392,DEAED68AE3C073AACA878B29D6C9BBC2,42231,15,23,8,37,46,1896
34402,34402,C404F60AD0A2D6862A45A9C320EEAB5F,11261,0,5,5,36,46,1846
34403,34403,C404F60AD0A2D6862A45A9C320EEAB5F,42861,7,17,10,37,44,1894
34404,34404,C404F60AD0A2D6862A45A9C320EEAB5F,11261,18,22,4,36,46,1846
34405,34405,780CF605B987CE4335E0B64DFA86ACBF,12514,3,12,9,38,47,1947
34406,34406,780CF605B987CE4335E0B64DFA86ACBF,11921,14,19,5,38,48,1948
34407,34407,780CF605B987CE4335E0B64DFA86ACBF,11461,21,22,1,37,49,1899
34408,34408,C83A24549690919D158BD0CE80AE31F4,11261,1,9,8,36,46,1846
34409,34409,C83A24549690919D158BD0CE80AE31F4,13231,12,16,4,39,46,1996
34410,34410,C83A24549690919D158BD0CE80AE31F4,11261,18,22,4,36,46,1846
34414,34414,2E9ACB5217DEAC635E911A6AAEF6DCF5,10107,0,7,7,38,49,1949
34415,34415,2E9ACB5217DEAC635E911A6AAEF6DCF5,12021,8,11,3,37,49,1899
34416,34416,2E9ACB5217DEAC635E911A6AAEF6DCF5,42161,18,21,3,36,47,1847
34421,34421,6A1D10B491D138F434BFB67E66419B4E,19441,0,9,9,8,46,446
34422,34422,6A1D10B491D138F434BFB67E66419B4E,42041,9,10,1,10,47,547
34423,34423,6A1D10B491D138F434BFB67E66419B4E,19441,11,22,11,8,46,446
34436,34436,E6F8B18996A93B41942201687916F106,11231,0,11,11,37,49,1899
34437,34437,E6F8B18996A93B41942201687916F106,10471,12,13,1,37,48,1898
34438,34438,E6F8B18996A93B41942201687916F106,11231,13,18,5,37,49,1899
34439,34439,E6F8B18996A93B41942201687916F106,10471,21,23,2,37,48,1898
34456,34456,71FDEFC3187A3CF24BA939D7B11B9629,42961,0,7,7,35,49,1799
34457,34457,71FDEFC3187A3CF24BA939D7B11B9629,11021,8,17,9,36,49,1849
34458,34458,71FDEFC3187A3CF24BA939D7B11B9629,10471,20,23,3,37,48,1898
34475,34475,EC909F98ED0E6EF5A40A37FA5726A995,10251,1,15,14,35,47,1797
34476,34476,EC909F98ED0E6EF5A40A37FA5726A995,42161,16,18,2,36,47,1847
34477,34477,EC909F98ED0E6EF5A40A37FA5726A995,10251,21,22,1,35,47,1797
34498,34498,8DE4D252DA36E1365B15A8E9C0F92CC0,11151,6,18,12,30,48,1548
34499,34499,8DE4D252DA36E1365B15A8E9C0F92CC0,10544,19,20,1,28,48,1448
34500,34500,8DE4D252DA36E1365B15A8E9C0F92CC0,11151,20,22,2,30,48,1548
34504,34504,7D8BB90B66B5BB302B836A7DB354A71B,11701,0,7,7,43,48,2198
34505,34505,7D8BB90B66B5BB302B836A7DB354A71B,42321,7,8,1,43,47,2197
34506,34506,7D8BB90B66B5BB302B836A7DB354A71B,42601,12,14,2,44,48,2248
34507,34507,7D8BB90B66B5BB302B836A7DB354A71B,11701,15,23,8,43,48,2198
34508,34508,DB2A7AF4E3CE5306702B394040D91F34,42231,1,5,4,37,46,1896
34509,34509,DB2A7AF4E3CE5306702B394040D91F34,42351,7,17,10,38,45,1945
34510,34510,DB2A7AF4E3CE5306702B394040D91F34,42231,18,19,1,37,46,1896
34511,34511,36E343A96D81AB746DE47507E4AE3DEE,12491,0,6,6,36,43,1843
34512,34512,36E343A96D81AB746DE47507E4AE3DEE,43451,6,9,3,37,40,1890
34513,34513,36E343A96D81AB746DE47507E4AE3DEE,12491,11,23,12,36,43,1843
34514,34514,E9F5D0C2382D0D17DF61B7A5284E6ABD,12641,1,2,1,10,43,543
34515,34515,E9F5D0C2382D0D17DF61B7A5284E6ABD,19904,2,3,1,9,44,494
34516,34516,E9F5D0C2382D0D17DF61B7A5284E6ABD,12641,3,23,20,10,43,543
34517,34517,1F7B3179DF46FBD4BF02920F94E8EEB6,11461,0,1,1,37,49,1899
34518,34518,1F7B3179DF46FBD4BF02920F94E8EEB6,10471,2,15,13,37,48,1898
34519,34519,1F7B3179DF46FBD4BF02920F94E8EEB6,11461,17,18,1,37,49,1899
34520,34520,1F7B3179DF46FBD4BF02920F94E8EEB6,10471,18,23,5,37,48,1898
34525,34525,831CEF471029417D091D2BE9F78234DD,42321,3,14,11,43,47,2197
34526,34526,831CEF471029417D091D2BE9F78234DD,11001,15,17,2,42,47,2147
34527,34527,831CEF471029417D091D2BE9F78234DD,13941,21,22,1,41,47,2097
34533,34533,88755E17FFF69DE5064C9C86A18E3FD7,10691,0,6,6,33,48,1698
34534,34534,88755E17FFF69DE5064C9C86A18E3FD7,43731,7,17,10,34,47,1747
34535,34535,88755E17FFF69DE5064C9C86A18E3FD7,10691,20,23,3,33,48,1698
34536,34536,785F4EBA3F4642EC7BD5BE5F80643D2E,43731,0,3,3,34,47,1747
34537,34537,785F4EBA3F4642EC7BD5BE5F80643D2E,42371,4,6,2,34,46,1746
34538,34538,785F4EBA3F4642EC7BD5BE5F80643D2E,13601,11,19,8,34,47,1747
34548,34548,2295C74F0BD2BB081A3FCDFFDED68B9C,12641,4,6,2,10,43,543
34549,34549,2295C74F0BD2BB081A3FCDFFDED68B9C,12921,8,9,1,9,41,491
34550,34550,2295C74F0BD2BB081A3FCDFFDED68B9C,12641,13,14,1,10,43,543
34551,34551,2295C74F0BD2BB081A3FCDFFDED68B9C,12921,15,19,4,9,41,491
34558,34558,F006E600171E6D181F07E02A37ECC960,42161,0,13,13,36,47,1847
34559,34559,F006E600171E6D181F07E02A37ECC960,10781,15,16,1,35,47,1797
34560,34560,F006E600171E6D181F07E02A37ECC960,42941,19,20,1,37,47,1897
34561,34561,F006E600171E6D181F07E02A37ECC960,11491,21,22,1,36,47,1847
34568,34568,84D6F944A9720742D92DF6BE4B5D36E6,12221,0,4,4,43,44,2194
34569,34569,84D6F944A9720742D92DF6BE4B5D36E6,12141,4,6,2,42,45,2145
34570,34570,84D6F944A9720742D92DF6BE4B5D36E6,12221,6,12,6,43,44,2194
34571,34571,84D6F944A9720742D92DF6BE4B5D36E6,12141,14,21,7,42,45,2145
34576,34576,95A50FC77E468146BAD45CC8BD317370,42921,0,7,7,33,47,1697
34577,34577,95A50FC77E468146BAD45CC8BD317370,42521,9,18,9,31,47,1597
34578,34578,95A50FC77E468146BAD45CC8BD317370,43731,20,22,2,34,47,1747
34597,34597,C132E4C242B7EC12A7123616F55E9237,42321,0,5,5,43,47,2197
34598,34598,C132E4C242B7EC12A7123616F55E9237,42461,7,9,2,45,47,2297
34599,34599,C132E4C242B7EC12A7123616F55E9237,43621,12,20,8,46,48,2348
34600,34600,8A35309960304DAF98A2649637AD86E1,10351,0,8,8,28,45,1445
34601,34601,8A35309960304DAF98A2649637AD86E1,10634,11,12,1,27,45,1395
34602,34602,8A35309960304DAF98A2649637AD86E1,10351,14,21,7,28,45,1445
34609,34609,670568C520C89BECF36566995096FF80,10411,2,3,1,36,48,1848
34610,34610,670568C520C89BECF36566995096FF80,41612,9,13,4,36,47,1847
34611,34611,670568C520C89BECF36566995096FF80,11331,13,15,2,37,48,1898
34612,34612,670568C520C89BECF36566995096FF80,10111,17,23,6,37,47,1897
34613,34613,1F37F1A26F28B353C3F7467B414D9C73,11061,2,3,1,29,48,1498
34614,34614,1F37F1A26F28B353C3F7467B414D9C73,43971,6,17,11,30,48,1548
34615,34615,1F37F1A26F28B353C3F7467B414D9C73,11061,19,20,1,29,48,1498
34616,34616,1F37F1A26F28B353C3F7467B414D9C73,43971,21,22,1,30,48,1548
34617,34617,94F493B11613D5DBEE60C88F6FBC1F5E,42091,9,11,2,43,46,2196
34618,34618,94F493B11613D5DBEE60C88F6FBC1F5E,42461,12,13,1,45,47,2297
34619,34619,94F493B11613D5DBEE60C88F6FBC1F5E,40801,16,20,4,43,46,2196
34620,34620,F1AA6F3E940CBB9FB719C98F8431D25C,19901,0,6,6,7,44,394
34621,34621,F1AA6F3E940CBB9FB719C98F8431D25C,12641,6,9,3,10,43,543
34622,34622,F1AA6F3E940CBB9FB719C98F8431D25C,19901,10,19,9,7,44,394
34629,34629,D07D1F07E63AF50292E2B99934F4BC91,12311,0,10,10,30,44,1544
34630,34630,D07D1F07E63AF50292E2B99934F4BC91,12661,14,15,1,32,45,1645
34631,34631,D07D1F07E63AF50292E2B99934F4BC91,12311,16,18,2,30,44,1544
34635,34635,B36C8579A2DBF718933C4838B2421A42,42511,4,11,7,37,47,1897
34636,34636,B36C8579A2DBF718933C4838B2421A42,13121,14,15,1,38,46,1946
34637,34637,B36C8579A2DBF718933C4838B2421A42,10841,16,18,2,37,47,1897
34638,34638,B36C8579A2DBF718933C4838B2421A42,13121,19,20,1,38,46,1946
34643,34643,CC3FA096FA296BC301B8FB82BD507846,42471,1,6,5,35,49,1799
34644,34644,CC3FA096FA296BC301B8FB82BD507846,11531,6,9,3,34,49,1749
34645,34645,CC3FA096FA296BC301B8FB82BD507846,11021,10,17,7,36,49,1849
34646,34646,CC3FA096FA296BC301B8FB82BD507846,42071,19,21,2,31,49,1599
34647,34647,2C8716D214A8F24FFDE64347FFFC6CDE,11381,1,3,2,30,47,1547
34648,34648,2C8716D214A8F24FFDE64347FFFC6CDE,11061,8,17,9,29,48,1498
34649,34649,2C8716D214A8F24FFDE64347FFFC6CDE,11381,21,22,1,30,47,1547
34654,34654,5E3DAD543888AED453CFEE13BBCB613D,13911,0,4,4,39,46,1996
34655,34655,5E3DAD543888AED453CFEE13BBCB613D,42351,4,5,1,38,45,1945
34656,34656,5E3DAD543888AED453CFEE13BBCB613D,13911,7,15,8,39,46,1996
34657,34657,5E3DAD543888AED453CFEE13BBCB613D,42231,19,21,2,37,46,1896
34658,34658,27E5652E2BA40D37FBD9A0AA720456AC,13121,8,9,1,38,46,1946
34659,34659,27E5652E2BA40D37FBD9A0AA720456AC,43241,11,12,1,36,46,1846
34660,34660,27E5652E2BA40D37FBD9A0AA720456AC,13121,12,15,3,38,46,1946
34661,34661,27E5652E2BA40D37FBD9A0AA720456AC,11941,18,20,2,37,46,1896
34666,34666,7B4E6126570CADEFC5C95EC455FF20E3,11914,0,13,13,37,48,1898
34667,34667,7B4E6126570CADEFC5C95EC455FF20E3,43361,17,18,1,38,48,1948
34668,34668,7B4E6126570CADEFC5C95EC455FF20E3,11914,19,20,1,37,48,1898
34677,34677,B400ACFA7232ADC3897E9004784F9482,12491,1,5,4,36,43,1843
34678,34678,B400ACFA7232ADC3897E9004784F9482,11261,6,22,16,36,46,1846
34679,34679,B400ACFA7232ADC3897E9004784F9482,12491,22,23,1,36,43,1843
34680,34680,8F0F9FD615E5CF54612AE31BD94EEC63,10951,1,7,6,29,48,1498
34681,34681,8F0F9FD615E5CF54612AE31BD94EEC63,11381,7,14,7,30,47,1547
34682,34682,8F0F9FD615E5CF54612AE31BD94EEC63,11431,16,19,3,29,47,1497
34683,34683,8F0F9FD615E5CF54612AE31BD94EEC63,13651,20,22,2,30,47,1547
34689,34689,B5CCEF3E5B535EF97877E582DB4AA1BB,11381,2,12,10,30,47,1547
34690,34690,B5CCEF3E5B535EF97877E582DB4AA1BB,42521,15,17,2,31,47,1597
34691,34691,B5CCEF3E5B535EF97877E582DB4AA1BB,11381,18,23,5,30,47,1547
34706,34706,BB39D64AF4BA5797CA6434108C1B1053,10681,2,14,12,30,48,1548
34707,34707,BB39D64AF4BA5797CA6434108C1B1053,11061,14,17,3,29,48,1498
34708,34708,BB39D64AF4BA5797CA6434108C1B1053,10681,17,23,6,30,48,1548
34709,34709,82205CE7AD5103C39D0A2C152E69D7E7,42511,0,5,5,37,47,1897
34710,34710,82205CE7AD5103C39D0A2C152E69D7E7,13331,6,8,2,38,47,1947
34711,34711,82205CE7AD5103C39D0A2C152E69D7E7,42511,14,15,1,37,47,1897
34712,34712,82205CE7AD5103C39D0A2C152E69D7E7,12021,19,20,1,37,49,1899
34713,34713,898EBF47A6F3F37D09C3EE2E41079760,40637,0,9,9,36,47,1847
34714,34714,898EBF47A6F3F37D09C3EE2E41079760,12021,11,13,2,37,49,1899
34715,34715,898EBF47A6F3F37D09C3EE2E41079760,40637,14,16,2,36,47,1847
34716,34716,898EBF47A6F3F37D09C3EE2E41079760,10251,16,22,6,35,47,1797
34717,34717,347A31E9527C6F1D2B24E19393D7EBED,43971,0,5,5,30,48,1548
34718,34718,347A31E9527C6F1D2B24E19393D7EBED,11061,9,11,2,29,48,1498
34719,34719,347A31E9527C6F1D2B24E19393D7EBED,43971,12,18,6,30,48,1548
34720,34720,347A31E9527C6F1D2B24E19393D7EBED,43311,21,23,2,31,48,1598
34734,34734,04E25EABAF57B3731144C024B2F68618,13341,1,2,1,44,45,2245
34735,34735,04E25EABAF57B3731144C024B2F68618,42631,3,17,14,43,45,2195
34736,34736,04E25EABAF57B3731144C024B2F68618,13341,17,18,1,44,45,2245
34737,34737,04E25EABAF57B3731144C024B2F68618,42631,19,22,3,43,45,2195
34738,34738,4A8B6D4A591CC4F1D4132A3A7DF0E4D7,42141,1,8,7,32,47,1647
34739,34739,4A8B6D4A591CC4F1D4132A3A7DF0E4D7,10341,9,11,2,31,47,1597
34740,34740,4A8B6D4A591CC4F1D4132A3A7DF0E4D7,43761,13,20,7,32,47,1647
34747,34747,05286C4B5017A260B39768783F7D4555,42581,0,12,12,38,48,1948
34748,34748,05286C4B5017A260B39768783F7D4555,10471,13,17,4,37,48,1898
34749,34749,05286C4B5017A260B39768783F7D4555,42581,20,23,3,38,48,1948
34750,34750,E3950B228FF57BC4F70CD2EC3D90B5FF,13711,1,7,6,38,46,1946
34751,34751,E3950B228FF57BC4F70CD2EC3D90B5FF,42151,11,17,6,35,45,1795
34752,34752,E3950B228FF57BC4F70CD2EC3D90B5FF,13711,21,22,1,38,46,1946
34765,34765,B6B9FD86337BD93E048A74A5E56BF693,10111,0,9,9,37,47,1897
34766,34766,B6B9FD86337BD93E048A74A5E56BF693,12391,14,15,1,36,49,1849
34767,34767,B6B9FD86337BD93E048A74A5E56BF693,42161,16,19,3,36,47,1847
34768,34768,B6B9FD86337BD93E048A74A5E56BF693,10111,21,23,2,37,47,1897
34773,34773,2A94734468D10DBD0CE914B947435C9C,42271,0,10,10,40,47,2047
34774,34774,2A94734468D10DBD0CE914B947435C9C,10601,10,13,3,39,47,1997
34775,34775,2A94734468D10DBD0CE914B947435C9C,11914,18,23,5,37,48,1898
34776,34776,D2007E56CDD263F500CAE75A804D6B50,42871,0,6,6,30,45,1545
34777,34777,D2007E56CDD263F500CAE75A804D6B50,11324,8,18,10,31,46,1596
34778,34778,D2007E56CDD263F500CAE75A804D6B50,12311,21,23,2,30,44,1544
34784,34784,58FF60972C1637520443DC5766A2AB67,13411,0,5,5,49,42,2492
34785,34785,58FF60972C1637520443DC5766A2AB67,43951,6,17,11,49,41,2491
34786,34786,58FF60972C1637520443DC5766A2AB67,13411,17,23,6,49,42,2492
34787,34787,D3F6CC79419CB8E677F2F17C3DF072CD,13121,0,5,5,38,46,1946
34788,34788,D3F6CC79419CB8E677F2F17C3DF072CD,10271,6,8,2,37,46,1896
34789,34789,D3F6CC79419CB8E677F2F17C3DF072CD,13331,8,10,2,38,47,1947
34790,34790,D3F6CC79419CB8E677F2F17C3DF072CD,13121,12,22,10,38,46,1946
34810,34810,9A519709635398D7673DD5F4D42C6C46,42151,0,12,12,35,45,1795
34811,34811,9A519709635398D7673DD5F4D42C6C46,12491,15,16,1,36,43,1843
34812,34812,9A519709635398D7673DD5F4D42C6C46,42151,16,21,5,35,45,1795
34818,34818,6343124213E972A8E4D577814E40CD01,11861,0,12,12,32,47,1647
34819,34819,6343124213E972A8E4D577814E40CD01,42491,15,17,2,32,46,1646
34820,34820,6343124213E972A8E4D577814E40CD01,12131,18,23,5,32,47,1647
34835,34835,F808ABC7A00624398DD0E1E1BEE09822,11021,0,18,18,36,49,1849
34836,34836,F808ABC7A00624398DD0E1E1BEE09822,11201,19,22,3,35,49,1799
34837,34837,F808ABC7A00624398DD0E1E1BEE09822,11021,22,23,1,36,49,1849
34838,34838,EBE45C3DBBC67B87F4B89C2B32FB91AA,42111,1,4,3,44,46,2246
34839,34839,EBE45C3DBBC67B87F4B89C2B32FB91AA,42461,4,7,3,45,47,2297
34840,34840,EBE45C3DBBC67B87F4B89C2B32FB91AA,10771,22,23,1,41,46,2096
34846,34846,73C431267E9D15126DD630F092950C8C,42111,1,13,12,44,46,2246
34847,34847,73C431267E9D15126DD630F092950C8C,42461,16,17,1,45,47,2297
34848,34848,73C431267E9D15126DD630F092950C8C,42111,22,23,1,44,46,2246
34849,34849,9C35C609BEEB7023F559DA7824DEFA84,11061,1,14,13,29,48,1498
34850,34850,9C35C609BEEB7023F559DA7824DEFA84,43971,15,16,1,30,48,1548
34851,34851,9C35C609BEEB7023F559DA7824DEFA84,11061,21,23,2,29,48,1498
34852,34852,4FA7E2AF35091649A8D61648BF92F5C0,42581,0,6,6,38,48,1948
34853,34853,4FA7E2AF35091649A8D61648BF92F5C0,10471,8,17,9,37,48,1898
34854,34854,4FA7E2AF35091649A8D61648BF92F5C0,11921,19,21,2,38,48,1948
34855,34855,94A66B099C3B286235DEE73BAE7FEB6C,11861,0,7,7,32,47,1647
34856,34856,94A66B099C3B286235DEE73BAE7FEB6C,10281,8,14,6,33,48,1698
34857,34857,94A66B099C3B286235DEE73BAE7FEB6C,11861,14,23,9,32,47,1647
34864,34864,716C7ACEE11502C3A86D5EF613660813,19181,0,6,6,8,40,440
34865,34865,716C7ACEE11502C3A86D5EF613660813,49201,8,12,4,7,41,391
34866,34866,716C7ACEE11502C3A86D5EF613660813,19114,16,19,3,7,43,393
34872,34872,A8DFAF39A5A26AE1BCD9E9DE060BB315,11091,0,5,5,29,47,1497
34873,34873,A8DFAF39A5A26AE1BCD9E9DE060BB315,10292,5,10,5,30,47,1547
34874,34874,A8DFAF39A5A26AE1BCD9E9DE060BB315,11091,12,23,11,29,47,1497
34878,34878,2FC158799FF19F821FBD3DC4EFE863DB,13551,0,10,10,45,38,2288
34879,34879,2FC158799FF19F821FBD3DC4EFE863DB,43101,15,17,2,46,40,2340
34880,34880,2FC158799FF19F821FBD3DC4EFE863DB,13551,22,23,1,45,38,2288
34885,34885,209CBAFCECFCFAF5ADEC7A13A8F80FC5,19114,4,10,6,7,43,393
34886,34886,209CBAFCECFCFAF5ADEC7A13A8F80FC5,19901,12,14,2,7,44,394
34887,34887,209CBAFCECFCFAF5ADEC7A13A8F80FC5,19114,14,19,5,7,43,393
34891,34891,BB89489061864EDEBB4F501372B151B1,49201,8,10,2,7,41,391
34892,34892,BB89489061864EDEBB4F501372B151B1,12921,11,15,4,9,41,491
34893,34893,BB89489061864EDEBB4F501372B151B1,49201,15,18,3,7,41,391
34902,34902,FCF6425DA3F542476DF1F93935C075D8,42581,0,6,6,38,48,1948
34903,34903,FCF6425DA3F542476DF1F93935C075D8,11914,10,11,1,37,48,1898
34904,34904,FCF6425DA3F542476DF1F93935C075D8,42581,12,23,11,38,48,1948
34908,34908,1C28F39B6E92104A5F767DF1DD64A4C7,13511,0,7,7,34,48,1748
34909,34909,1C28F39B6E92104A5F767DF1DD64A4C7,12381,8,10,2,32,48,1648
34910,34910,1C28F39B6E92104A5F767DF1DD64A4C7,10491,14,15,1,33,48,1698
34911,34911,1C28F39B6E92104A5F767DF1DD64A4C7,13511,19,23,4,34,48,1748
34915,34915,D64DF2C2FAB80CB42859AD7194DBB705,42271,0,6,6,40,47,2047
34916,34916,D64DF2C2FAB80CB42859AD7194DBB705,11074,8,13,5,37,47,1897
34917,34917,D64DF2C2FAB80CB42859AD7194DBB705,11921,14,15,1,38,48,1948
34918,34918,D64DF2C2FAB80CB42859AD7194DBB705,11074,17,19,2,37,47,1897
34922,34922,FE289D23B7E617AD349A76499E85C77F,42021,1,3,2,33,47,1697
34923,34923,FE289D23B7E617AD349A76499E85C77F,13601,3,8,5,34,47,1747
34924,34924,FE289D23B7E617AD349A76499E85C77F,42021,9,21,12,33,47,1697
34925,34925,FE289D23B7E617AD349A76499E85C77F,13601,22,23,1,34,47,1747
34926,34926,E610935782979ECFD62FB0099155ECBC,11061,3,9,6,29,48,1498
34927,34927,E610935782979ECFD62FB0099155ECBC,10681,14,17,3,30,48,1548
34928,34928,E610935782979ECFD62FB0099155ECBC,11061,22,23,1,29,48,1498
34929,34929,51AE587203D7D2FFABB67795EE897242,42021,0,7,7,33,47,1697
34930,34930,51AE587203D7D2FFABB67795EE897242,13601,10,11,1,34,47,1747
34931,34931,51AE587203D7D2FFABB67795EE897242,42021,11,20,9,33,47,1697
34932,34932,51AE587203D7D2FFABB67795EE897242,10281,22,23,1,33,48,1698
34933,34933,63A1194DA67A916294F825B4249AD293,42161,0,7,7,36,47,1847
34934,34934,63A1194DA67A916294F825B4249AD293,11261,9,14,5,36,46,1846
34935,34935,63A1194DA67A916294F825B4249AD293,10841,19,21,2,37,47,1897
34944,34944,2BE09BA33D3A262DFB2C55A4D625C735,42121,0,1,1,26,49,1349
34945,34945,2BE09BA33D3A262DFB2C55A4D625C735,42081,2,9,7,24,49,1249
34946,34946,2BE09BA33D3A262DFB2C55A4D625C735,42623,13,21,8,22,49,1149
34950,34950,2764B8ABB23930F22F4F0762C2A18E7E,13711,1,7,6,38,46,1946
34951,34951,2764B8ABB23930F22F4F0762C2A18E7E,42351,10,17,7,38,45,1945
34952,34952,2764B8ABB23930F22F4F0762C2A18E7E,13711,19,20,1,38,46,1946
34975,34975,BE784774CC06FCA1412486B5B9B18C26,13711,8,9,1,38,46,1946
34976,34976,BE784774CC06FCA1412486B5B9B18C26,11941,9,11,2,37,46,1896
34977,34977,BE784774CC06FCA1412486B5B9B18C26,13711,14,19,5,38,46,1946
34978,34978,C97051E6FB48C1025E34799B4F49424B,13911,3,5,2,39,46,1996
34979,34979,C97051E6FB48C1025E34799B4F49424B,42231,6,11,5,37,46,1896
34980,34980,C97051E6FB48C1025E34799B4F49424B,42351,12,13,1,38,45,1945
34981,34981,C97051E6FB48C1025E34799B4F49424B,42231,15,19,4,37,46,1896
34999,34999,71C58BC8D60C1B4D2F61D55848B6A510,10351,2,3,1,28,45,1445
35000,35000,71C58BC8D60C1B4D2F61D55848B6A510,10634,3,7,4,27,45,1395
35001,35001,71C58BC8D60C1B4D2F61D55848B6A510,10351,7,15,8,28,45,1445
35002,35002,71C58BC8D60C1B4D2F61D55848B6A510,10634,19,21,2,27,45,1395
35026,35026,5EC66C5A4B87D37344B296F73CB04D80,11231,0,8,8,37,49,1899
35027,35027,5EC66C5A4B87D37344B296F73CB04D80,10471,11,17,6,37,48,1898
35028,35028,5EC66C5A4B87D37344B296F73CB04D80,11231,20,23,3,37,49,1899
35039,35039,53493041487B5321836147FAAD536213,11074,1,13,12,37,47,1897
35040,35040,53493041487B5321836147FAAD536213,42021,14,15,1,33,47,1697
35041,35041,53493041487B5321836147FAAD536213,13101,18,23,5,40,47,2047
35042,35042,55536669E97AF41ACDE427113BB85731,10691,0,6,6,33,48,1698
35043,35043,55536669E97AF41ACDE427113BB85731,11861,6,11,5,32,47,1647
35044,35044,55536669E97AF41ACDE427113BB85731,10691,12,23,11,33,48,1698
35057,35057,B304D2AD98C7DE24CAE6DD0DA65095F0,10431,0,7,7,33,49,1699
35058,35058,B304D2AD98C7DE24CAE6DD0DA65095F0,43581,10,18,8,33,48,1698
35059,35059,B304D2AD98C7DE24CAE6DD0DA65095F0,10431,19,23,4,33,49,1699
35060,35060,D65506EDDA59637632B53755416666C4,11914,1,6,5,37,48,1898
35061,35061,D65506EDDA59637632B53755416666C4,42221,8,15,7,38,48,1948
35062,35062,D65506EDDA59637632B53755416666C4,43181,15,18,3,39,48,1998
35068,35068,6F1358C6526C9CA4FB50AA20B6B16B03,11001,0,6,6,42,47,2147
35069,35069,6F1358C6526C9CA4FB50AA20B6B16B03,13941,6,21,15,41,47,2097
35070,35070,6F1358C6526C9CA4FB50AA20B6B16B03,11001,22,23,1,42,47,2147
35074,35074,1E78C6812CC13AC596F7D7BD80A5DD70,11921,0,14,14,38,48,1948
35075,35075,1E78C6812CC13AC596F7D7BD80A5DD70,11074,18,19,1,37,47,1897
35076,35076,1E78C6812CC13AC596F7D7BD80A5DD70,11914,22,23,1,37,48,1898
35077,35077,E880DD3703242558096D10770FE10A54,42861,3,4,1,37,44,1894
35078,35078,E880DD3703242558096D10770FE10A54,11261,7,10,3,36,46,1846
35079,35079,E880DD3703242558096D10770FE10A54,42861,12,21,9,37,44,1894
35097,35097,F4C8F856DD638BBA75F52C720E10C05D,12921,0,1,1,9,41,491
35098,35098,F4C8F856DD638BBA75F52C720E10C05D,12641,1,7,6,10,43,543
35099,35099,F4C8F856DD638BBA75F52C720E10C05D,12921,11,23,12,9,41,491
35100,35100,1788FF83230593384DFEF88881720D90,13551,0,11,11,45,38,2288
35101,35101,1788FF83230593384DFEF88881720D90,43101,11,19,8,46,40,2340
35102,35102,1788FF83230593384DFEF88881720D90,13551,22,23,1,45,38,2288
35117,35117,11C5ACA60B0246DE7069023057E8285F,11381,1,2,1,30,47,1547
35118,35118,11C5ACA60B0246DE7069023057E8285F,11061,5,13,8,29,48,1498
35119,35119,11C5ACA60B0246DE7069023057E8285F,11381,13,23,10,30,47,1547
35134,35134,089202C74F7A5B708A3906BDD594D636,12601,0,11,11,25,47,1297
35135,35135,089202C74F7A5B708A3906BDD594D636,10501,13,15,2,22,46,1146
35136,35136,089202C74F7A5B708A3906BDD594D636,12601,15,23,8,25,47,1297
35137,35137,0DFD98C5BF618352145AEF64606DF221,10251,0,1,1,35,47,1797
35138,35138,0DFD98C5BF618352145AEF64606DF221,42161,2,18,16,36,47,1847
35139,35139,0DFD98C5BF618352145AEF64606DF221,10251,21,23,2,35,47,1797
35156,35156,31100BE8BDE5B74B2D64B60F8888BAE5,10111,1,8,7,37,47,1897
35157,35157,31100BE8BDE5B74B2D64B60F8888BAE5,42161,11,14,3,36,47,1847
35158,35158,31100BE8BDE5B74B2D64B60F8888BAE5,10111,15,23,8,37,47,1897
35174,35174,99C7ECB8A04AED18341CF71575998F26,13231,0,7,7,39,46,1996
35175,35175,99C7ECB8A04AED18341CF71575998F26,42091,8,10,2,43,46,2196
35176,35176,99C7ECB8A04AED18341CF71575998F26,13231,12,17,5,39,46,1996
35177,35177,99C7ECB8A04AED18341CF71575998F26,10811,18,23,5,38,46,1946
35178,35178,F776CF5BFCBAFE40EFE079BFD8CF34A4,19901,0,6,6,7,44,394
35179,35179,F776CF5BFCBAFE40EFE079BFD8CF34A4,19021,8,17,9,10,45,545
35180,35180,F776CF5BFCBAFE40EFE079BFD8CF34A4,12641,19,21,2,10,43,543
35189,35189,C7DABDD3B30538BA528E17648006549E,42401,0,12,12,36,47,1847
35190,35190,C7DABDD3B30538BA528E17648006549E,10111,14,17,3,37,47,1897
35191,35191,C7DABDD3B30538BA528E17648006549E,10251,17,18,1,35,47,1797
35192,35192,C7DABDD3B30538BA528E17648006549E,42301,21,22,1,36,47,1847
35193,35193,6CC24D921FE70D79D98FA5B7890BCB55,19441,0,8,8,8,46,446
35194,35194,6CC24D921FE70D79D98FA5B7890BCB55,42041,10,16,6,10,47,547
35195,35195,6CC24D921FE70D79D98FA5B7890BCB55,19901,20,22,2,7,44,394
35200,35200,508C4B8E02EFEECAF31B09D5217E4106,42271,1,9,8,40,47,2047
35201,35201,508C4B8E02EFEECAF31B09D5217E4106,11481,12,15,3,41,48,2098
35202,35202,508C4B8E02EFEECAF31B09D5217E4106,13101,15,17,2,40,47,2047
35203,35203,508C4B8E02EFEECAF31B09D5217E4106,40697,19,21,2,43,48,2198
35204,35204,29C5C7944A565741A7D5BD5CE10D2802,11261,1,7,6,36,46,1846
35205,35205,29C5C7944A565741A7D5BD5CE10D2802,13911,8,10,2,39,46,1996
35206,35206,29C5C7944A565741A7D5BD5CE10D2802,11261,14,17,3,36,46,1846
35207,35207,29C5C7944A565741A7D5BD5CE10D2802,13911,20,21,1,39,46,1996
35208,35208,1C461F1E440C54F9A8141510311D9FF7,10531,0,8,8,34,46,1746
35209,35209,1C461F1E440C54F9A8141510311D9FF7,13601,8,10,2,34,47,1747
35210,35210,1C461F1E440C54F9A8141510311D9FF7,42921,12,13,1,33,47,1697
35211,35211,1C461F1E440C54F9A8141510311D9FF7,10151,18,22,4,34,47,1747
35212,35212,A61D0F5D6E4730E77483BB5A83F54B2C,42771,0,8,8,36,47,1847
35213,35213,A61D0F5D6E4730E77483BB5A83F54B2C,10841,9,17,8,37,47,1897
35214,35214,A61D0F5D6E4730E77483BB5A83F54B2C,42401,18,20,2,36,47,1847
35215,35215,A61D0F5D6E4730E77483BB5A83F54B2C,12021,21,22,1,37,49,1899
35219,35219,089AAF334E5A34D1BBCB15FBAD54C901,42523,0,1,1,31,47,1597
35220,35220,089AAF334E5A34D1BBCB15FBAD54C901,13651,1,2,1,30,47,1547
35221,35221,089AAF334E5A34D1BBCB15FBAD54C901,11324,3,7,4,31,46,1596
35222,35222,089AAF334E5A34D1BBCB15FBAD54C901,42523,14,23,9,31,47,1597
35223,35223,2F1F7798F5E8889B4080CA59D71F0274,10271,0,15,15,37,46,1896
35224,35224,2F1F7798F5E8889B4080CA59D71F0274,13711,16,18,2,38,46,1946
35225,35225,2F1F7798F5E8889B4080CA59D71F0274,10271,20,23,3,37,46,1896
35233,35233,B4CF5575585A81D8047EC86B2FC8CF53,42861,3,13,10,37,44,1894
35234,35234,B4CF5575585A81D8047EC86B2FC8CF53,11261,14,15,1,36,46,1846
35235,35235,B4CF5575585A81D8047EC86B2FC8CF53,42861,17,23,6,37,44,1894
35240,35240,726D8BF6FE9D2B730CE8E7DD26F779CD,11131,0,8,8,33,48,1698
35241,35241,726D8BF6FE9D2B730CE8E7DD26F779CD,11381,9,19,10,30,47,1547
35242,35242,726D8BF6FE9D2B730CE8E7DD26F779CD,10341,20,23,3,31,47,1597
35243,35243,DBB647C4A4603B7F4340A7E09EDD7C70,43051,0,5,5,46,45,2345
35244,35244,DBB647C4A4603B7F4340A7E09EDD7C70,43621,7,16,9,46,48,2348
35245,35245,DBB647C4A4603B7F4340A7E09EDD7C70,43051,18,23,5,46,45,2345
35250,35250,5ABC7476B829907717164C7F4D7F76B4,43971,1,18,17,30,48,1548
35251,35251,5ABC7476B829907717164C7F4D7F76B4,11381,18,20,2,30,47,1547
35252,35252,5ABC7476B829907717164C7F4D7F76B4,11061,20,22,2,29,48,1498
35258,35258,06E3599A2E0EFD77989421A9D6100A1A,42301,0,1,1,36,47,1847
35259,35259,06E3599A2E0EFD77989421A9D6100A1A,10111,5,9,4,37,47,1897
35260,35260,06E3599A2E0EFD77989421A9D6100A1A,42301,9,12,3,36,47,1847
35261,35261,06E3599A2E0EFD77989421A9D6100A1A,10111,14,21,7,37,47,1897
35262,35262,1522BDE7E05C3ADAA9D8391F632D7715,11361,0,5,5,22,48,1148
35263,35263,1522BDE7E05C3ADAA9D8391F632D7715,12051,9,14,5,20,47,1047
35264,35264,1522BDE7E05C3ADAA9D8391F632D7715,12581,16,17,1,24,48,1248
35265,35265,1522BDE7E05C3ADAA9D8391F632D7715,11361,22,23,1,22,48,1148
35266,35266,B313DC957E2F1850A88A4D61011A548A,10151,0,1,1,34,47,1747
35267,35267,B313DC957E2F1850A88A4D61011A548A,10251,1,18,17,35,47,1797
35268,35268,B313DC957E2F1850A88A4D61011A548A,42021,18,20,2,33,47,1697
35269,35269,878C5910D8B33E157EC121F0E7A41043,42021,1,8,7,33,47,1697
35270,35270,878C5910D8B33E157EC121F0E7A41043,11861,8,20,12,32,47,1647
35271,35271,878C5910D8B33E157EC121F0E7A41043,42021,20,23,3,33,47,1697
35285,35285,18CC713B80CCF9AB1A7B146FB6B3AAAC,10271,0,13,13,37,46,1896
35286,35286,18CC713B80CCF9AB1A7B146FB6B3AAAC,13711,15,16,1,38,46,1946
35287,35287,18CC713B80CCF9AB1A7B146FB6B3AAAC,10271,17,20,3,37,46,1896
35288,35288,18CC713B80CCF9AB1A7B146FB6B3AAAC,13711,22,23,1,38,46,1946
35297,35297,B8DB030E6F574F75DC469AA0B11A44D5,10531,0,6,6,34,46,1746
35298,35298,B8DB030E6F574F75DC469AA0B11A44D5,42921,7,17,10,33,47,1697
35299,35299,B8DB030E6F574F75DC469AA0B11A44D5,10531,19,23,4,34,46,1746
35300,35300,92E340B82C56A45F91D53CD2B709557E,42581,1,13,12,38,48,1948
35301,35301,92E340B82C56A45F91D53CD2B709557E,11914,14,18,4,37,48,1898
35302,35302,92E340B82C56A45F91D53CD2B709557E,42581,21,23,2,38,48,1948
35303,35303,F54C9D4E2001ACEF8FFE7EEF806B67B0,10121,0,9,9,36,49,1849
35304,35304,F54C9D4E2001ACEF8FFE7EEF806B67B0,10841,9,13,4,37,47,1897
35305,35305,F54C9D4E2001ACEF8FFE7EEF806B67B0,10121,13,23,10,36,49,1849
35306,35306,0635F9DF2EA1E946C4F55221676132EF,10281,0,9,9,33,48,1698
35307,35307,0635F9DF2EA1E946C4F55221676132EF,43761,10,12,2,32,47,1647
35308,35308,0635F9DF2EA1E946C4F55221676132EF,42523,12,13,1,31,47,1597
35309,35309,0635F9DF2EA1E946C4F55221676132EF,43761,18,21,3,32,47,1647
35310,35310,44EC2B0D5EE5BD6B35ABC292F1B0BE4A,12641,0,6,6,10,43,543
35311,35311,44EC2B0D5EE5BD6B35ABC292F1B0BE4A,12921,8,18,10,9,41,491
35312,35312,44EC2B0D5EE5BD6B35ABC292F1B0BE4A,12641,21,22,1,10,43,543
35313,35313,F2229754FABF7F398D6839D6208AC86F,10544,0,14,14,28,48,1448
35314,35314,F2229754FABF7F398D6839D6208AC86F,10951,15,16,1,29,48,1498
35315,35315,F2229754FABF7F398D6839D6208AC86F,10544,19,23,4,28,48,1448
35316,35316,CB569F11653BED8355DBB1B17AC5F222,11914,0,7,7,37,48,1898
35317,35317,CB569F11653BED8355DBB1B17AC5F222,40171,7,19,12,38,48,1948
35318,35318,CB569F11653BED8355DBB1B17AC5F222,11914,22,23,1,37,48,1898
35319,35319,62AA062F87FE364B2D35EA2526834225,11806,0,6,6,41,48,2098
35320,35320,62AA062F87FE364B2D35EA2526834225,42271,9,12,3,40,47,2047
35321,35321,62AA062F87FE364B2D35EA2526834225,10331,14,15,1,39,46,1996
35322,35322,62AA062F87FE364B2D35EA2526834225,11914,17,23,6,37,48,1898
35329,35329,C6869A64CA9EF97A25D7192A00726FC2,42401,0,9,9,36,47,1847
35330,35330,C6869A64CA9EF97A25D7192A00726FC2,10781,9,18,9,35,47,1797
35331,35331,C6869A64CA9EF97A25D7192A00726FC2,42401,18,23,5,36,47,1847
35341,35341,078D744FD5840DE4508E7DD5C66617FF,11261,2,6,4,36,46,1846
35342,35342,078D744FD5840DE4508E7DD5C66617FF,42351,8,18,10,38,45,1945
35343,35343,078D744FD5840DE4508E7DD5C66617FF,11261,19,23,4,36,46,1846
35350,35350,7D0C3A14F471312EA3AC4A0006D340F8,11381,6,15,9,30,47,1547
35351,35351,7D0C3A14F471312EA3AC4A0006D340F8,10951,15,17,2,29,48,1498
35352,35352,7D0C3A14F471312EA3AC4A0006D340F8,11381,19,23,4,30,47,1547
35353,35353,181B5103F0FBF120AFF5BEC3A26A3DB7,43761,0,7,7,32,47,1647
35354,35354,181B5103F0FBF120AFF5BEC3A26A3DB7,10431,8,16,8,33,49,1699
35355,35355,181B5103F0FBF120AFF5BEC3A26A3DB7,43761,18,20,2,32,47,1647
35363,35363,0DD480B5A13E261C7A404CA1C7C938C6,42511,0,7,7,37,47,1897
35364,35364,0DD480B5A13E261C7A404CA1C7C938C6,13121,12,14,2,38,46,1946
35365,35365,0DD480B5A13E261C7A404CA1C7C938C6,42511,14,16,2,37,47,1897
35366,35366,0DD480B5A13E261C7A404CA1C7C938C6,13121,18,21,3,38,46,1946
35371,35371,D8963F7C81A647B0DB7A8BBF70036A0B,42221,1,2,1,38,48,1948
35372,35372,D8963F7C81A647B0DB7A8BBF70036A0B,12514,2,7,5,38,47,1947
35373,35373,D8963F7C81A647B0DB7A8BBF70036A0B,10471,8,17,9,37,48,1898
35374,35374,D8963F7C81A647B0DB7A8BBF70036A0B,12514,19,21,2,38,47,1947
35379,35379,EC57E33248ACEF6B14CA4470A7B4BE9F,42921,4,9,5,33,47,1697
35380,35380,EC57E33248ACEF6B14CA4470A7B4BE9F,10281,9,14,5,33,48,1698
35381,35381,EC57E33248ACEF6B14CA4470A7B4BE9F,42921,15,18,3,33,47,1697
35382,35382,EC57E33248ACEF6B14CA4470A7B4BE9F,11531,20,22,2,34,49,1749
35391,35391,9936C0BC7C8E5C695B3A454E94E542C6,11021,0,15,15,36,49,1849
35392,35392,9936C0BC7C8E5C695B3A454E94E542C6,10271,19,21,2,37,46,1896
35393,35393,9936C0BC7C8E5C695B3A454E94E542C6,11021,21,23,2,36,49,1849
35394,35394,AE4A6270CFE8D53376809A1F5BCB61EF,11074,0,4,4,37,47,1897
35395,35395,AE4A6270CFE8D53376809A1F5BCB61EF,40421,5,6,1,37,48,1898
35396,35396,AE4A6270CFE8D53376809A1F5BCB61EF,11074,7,9,2,37,47,1897
35397,35397,AE4A6270CFE8D53376809A1F5BCB61EF,40421,12,19,7,37,48,1898
35403,35403,13FE336F780D5F9F83776798BCE67144,42151,2,5,3,35,45,1795
35404,35404,13FE336F780D5F9F83776798BCE67144,11261,7,14,7,36,46,1846
35405,35405,13FE336F780D5F9F83776798BCE67144,42351,15,16,1,38,45,1945
35406,35406,13FE336F780D5F9F83776798BCE67144,11261,16,21,5,36,46,1846
35407,35407,D246B107853B0F4D941EBF1F8081E653,42523,0,2,2,31,47,1597
35408,35408,D246B107853B0F4D941EBF1F8081E653,43761,4,11,7,32,47,1647
35409,35409,D246B107853B0F4D941EBF1F8081E653,10295,12,19,7,30,47,1547
35414,35414,C5E6CD443585007EEBF145B2163DFA1C,42981,0,5,5,36,49,1849
35415,35415,C5E6CD443585007EEBF145B2163DFA1C,10901,7,12,5,35,48,1798
35416,35416,C5E6CD443585007EEBF145B2163DFA1C,10471,14,18,4,37,48,1898
35417,35417,C5E6CD443585007EEBF145B2163DFA1C,42981,21,23,2,36,49,1849
35418,35418,56C847E93955474C4B50268BCBE9390B,11551,0,11,11,39,49,1999
35419,35419,56C847E93955474C4B50268BCBE9390B,40951,12,14,2,36,49,1849
35420,35420,56C847E93955474C4B50268BCBE9390B,11551,17,23,6,39,49,1999
35421,35421,98FCD0E7592CE3BE44D1E20097E37B5B,42401,8,11,3,36,47,1847
35422,35422,98FCD0E7592CE3BE44D1E20097E37B5B,13121,14,16,2,38,46,1946
35423,35423,98FCD0E7592CE3BE44D1E20097E37B5B,11331,19,23,4,37,48,1898
35429,35429,E6A8B36EA819F0A64C66840FF99B9AB3,11914,7,8,1,37,48,1898
35430,35430,E6A8B36EA819F0A64C66840FF99B9AB3,42581,8,10,2,38,48,1948
35431,35431,E6A8B36EA819F0A64C66840FF99B9AB3,11914,10,18,8,37,48,1898
35439,35439,950A0454C1D55A1D196C6BF9FD6D1997,10691,0,8,8,33,48,1698
35440,35440,950A0454C1D55A1D196C6BF9FD6D1997,42401,9,10,1,36,47,1847
35441,35441,950A0454C1D55A1D196C6BF9FD6D1997,10251,10,12,2,35,47,1797
35442,35442,950A0454C1D55A1D196C6BF9FD6D1997,10691,13,23,10,33,48,1698
35461,35461,2220ACECA44CDD6B643C1166EB143787,12641,0,5,5,10,43,543
35462,35462,2220ACECA44CDD6B643C1166EB143787,19114,10,11,1,7,43,393
35463,35463,2220ACECA44CDD6B643C1166EB143787,12641,12,22,10,10,43,543
35464,35464,2B742D33ECA5D739DE9809C030EAA6E5,42351,9,10,1,38,45,1945
35465,35465,2B742D33ECA5D739DE9809C030EAA6E5,12491,12,13,1,36,43,1843
35466,35466,2B742D33ECA5D739DE9809C030EAA6E5,11261,15,19,4,36,46,1846
35467,35467,2B742D33ECA5D739DE9809C030EAA6E5,42231,20,23,3,37,46,1896
35468,35468,03CC5102FB306C3254027D35E65D966E,42581,0,4,4,38,48,1948
35469,35469,03CC5102FB306C3254027D35E65D966E,11914,6,12,6,37,48,1898
35470,35470,03CC5102FB306C3254027D35E65D966E,42581,14,16,2,38,48,1948
35471,35471,03CC5102FB306C3254027D35E65D966E,11914,19,20,1,37,48,1898
35472,35472,7416ABA9B70926119329485C1E15D038,13731,6,14,8,33,49,1699
35473,35473,7416ABA9B70926119329485C1E15D038,11954,14,15,1,32,49,1649
35474,35474,7416ABA9B70926119329485C1E15D038,13731,19,21,2,33,49,1699
35475,35475,B7783E40C231BF2A915C5200F2E2562A,10491,0,13,13,33,48,1698
35476,35476,B7783E40C231BF2A915C5200F2E2562A,10901,16,17,1,35,48,1798
35477,35477,B7783E40C231BF2A915C5200F2E2562A,40951,20,21,1,36,49,1849
35478,35478,0BA677AEFA1FE879EC9FCA98466C3A1A,11641,0,4,4,22,49,1149
35479,35479,0BA677AEFA1FE879EC9FCA98466C3A1A,42681,5,6,1,24,48,1248
35480,35480,0BA677AEFA1FE879EC9FCA98466C3A1A,11641,6,23,17,22,49,1149
35481,35481,8F8152ABCDBBD4CE857B1EFCB582F5D2,11074,10,12,2,37,47,1897
35482,35482,8F8152ABCDBBD4CE857B1EFCB582F5D2,10251,15,16,1,35,47,1797
35483,35483,8F8152ABCDBBD4CE857B1EFCB582F5D2,11074,18,22,4,37,47,1897
35484,35484,3E17C9F881E8F571652BFE5E841845EF,11861,0,10,10,32,47,1647
35485,35485,3E17C9F881E8F571652BFE5E841845EF,10281,11,18,7,33,48,1698
35486,35486,3E17C9F881E8F571652BFE5E841845EF,11861,18,23,5,32,47,1647
35495,35495,1CD741282378ACECE229BFA3E57C9431,19441,0,3,3,8,46,446
35496,35496,1CD741282378ACECE229BFA3E57C9431,42041,8,17,9,10,47,547
35497,35497,1CD741282378ACECE229BFA3E57C9431,19441,19,23,4,8,46,446
35498,35498,11E1F1DC5DF0F9BFBEA93370DDE86DBE,13911,0,8,8,39,46,1996
35499,35499,11E1F1DC5DF0F9BFBEA93370DDE86DBE,11481,9,12,3,41,48,2098
35500,35500,11E1F1DC5DF0F9BFBEA93370DDE86DBE,10911,21,22,1,39,46,1996
35501,35501,AE5EC73B53E9C3CD1EC48FB8238BD121,10221,0,1,1,34,49,1749
35502,35502,AE5EC73B53E9C3CD1EC48FB8238BD121,10161,2,17,15,35,49,1799
35503,35503,AE5EC73B53E9C3CD1EC48FB8238BD121,10221,19,21,2,34,49,1749
35504,35504,AE5EC73B53E9C3CD1EC48FB8238BD121,40271,21,23,2,35,49,1799
35509,35509,DAEEB33C776B03012D94B6F1E26F3BEC,12511,0,8,8,39,47,1997
35510,35510,DAEEB33C776B03012D94B6F1E26F3BEC,43481,10,12,2,39,48,1998
35511,35511,DAEEB33C776B03012D94B6F1E26F3BEC,12511,14,19,5,39,47,1997
35522,35522,9F07E2341EC43516CD02BDC269F3E6AA,11381,0,11,11,30,47,1547
35523,35523,9F07E2341EC43516CD02BDC269F3E6AA,11061,13,16,3,29,48,1498
35524,35524,9F07E2341EC43516CD02BDC269F3E6AA,11381,19,21,2,30,47,1547
35525,35525,27B6DDFE3A356062F221ABD7AD70BB14,11061,0,6,6,29,48,1498
35526,35526,27B6DDFE3A356062F221ABD7AD70BB14,10681,7,15,8,30,48,1548
35527,35527,27B6DDFE3A356062F221ABD7AD70BB14,11061,19,23,4,29,48,1498
35528,35528,200194CA33DD57C0E0CC791C5F2E51EB,12514,0,6,6,38,47,1947
35529,35529,200194CA33DD57C0E0CC791C5F2E51EB,11081,8,9,1,35,46,1796
35530,35530,200194CA33DD57C0E0CC791C5F2E51EB,12514,13,16,3,38,47,1947
35531,35531,200194CA33DD57C0E0CC791C5F2E51EB,11081,16,18,2,35,46,1796
35541,35541,5DF8F7E1653AFE78BE17522058E83109,10651,0,8,8,36,49,1849
35542,35542,5DF8F7E1653AFE78BE17522058E83109,13561,12,14,2,37,49,1899
35543,35543,5DF8F7E1653AFE78BE17522058E83109,10651,18,19,1,36,49,1849
35544,35544,2B032F4759A63D3D3DE094528FC05913,42581,0,15,15,38,48,1948
35545,35545,2B032F4759A63D3D3DE094528FC05913,11914,16,18,2,37,48,1898
35546,35546,2B032F4759A63D3D3DE094528FC05913,42581,18,23,5,38,48,1948
35555,35555,F20C6F9EEDC5052A0219DBE6439067E2,11091,1,2,1,29,47,1497
35556,35556,F20C6F9EEDC5052A0219DBE6439067E2,11871,19,21,2,29,46,1496
35557,35557,F20C6F9EEDC5052A0219DBE6439067E2,11091,22,23,1,29,47,1497
35561,35561,E5C174D2FF195FD116006ADE577A953D,11381,3,4,1,30,47,1547
35562,35562,E5C174D2FF195FD116006ADE577A953D,11151,7,8,1,30,48,1548
35563,35563,E5C174D2FF195FD116006ADE577A953D,11061,10,11,1,29,48,1498
35564,35564,E5C174D2FF195FD116006ADE577A953D,11151,14,20,6,30,48,1548
35565,35565,0D7C9DCB96BA3618B4BB7FC3680144CA,13371,0,15,15,41,47,2097
35566,35566,0D7C9DCB96BA3618B4BB7FC3680144CA,13331,16,17,1,38,47,1947
35567,35567,0D7C9DCB96BA3618B4BB7FC3680144CA,13371,17,23,6,41,47,2097
35573,35573,0A5C5176B278974D4B66307D8BE6DDEB,19114,1,12,11,7,43,393
35574,35574,0A5C5176B278974D4B66307D8BE6DDEB,12641,14,16,2,10,43,543
35575,35575,0A5C5176B278974D4B66307D8BE6DDEB,19114,17,18,1,7,43,393
35576,35576,0A5C5176B278974D4B66307D8BE6DDEB,12641,20,21,1,10,43,543
35606,35606,48DCE60D429B0B1E7F2F1B7A462BF9BF,42523,2,6,4,31,47,1597
35607,35607,48DCE60D429B0B1E7F2F1B7A462BF9BF,13651,7,8,1,30,47,1547
35608,35608,48DCE60D429B0B1E7F2F1B7A462BF9BF,11861,12,22,10,32,47,1647
35609,35609,035266CFE514B2CE8084B5CCD3E8A0F1,11074,10,11,1,37,47,1897
35610,35610,035266CFE514B2CE8084B5CCD3E8A0F1,11331,14,17,3,37,48,1898
35611,35611,035266CFE514B2CE8084B5CCD3E8A0F1,11074,19,20,1,37,47,1897
35612,35612,035266CFE514B2CE8084B5CCD3E8A0F1,11331,21,23,2,37,48,1898
35622,35622,685D4E55E3EA75E4EB890DFD0B50D317,11321,3,10,7,31,46,1596
35623,35623,685D4E55E3EA75E4EB890DFD0B50D317,42523,14,16,2,31,47,1597
35624,35624,685D4E55E3EA75E4EB890DFD0B50D317,11321,18,19,1,31,46,1596
35625,35625,685D4E55E3EA75E4EB890DFD0B50D317,42523,22,23,1,31,47,1597
35626,35626,4F717808305424D6529B2687FA7E5A49,11951,1,2,1,31,49,1599
35627,35627,4F717808305424D6529B2687FA7E5A49,10401,2,14,12,33,49,1699
35628,35628,4F717808305424D6529B2687FA7E5A49,11951,20,21,1,31,49,1599
35629,35629,4F717808305424D6529B2687FA7E5A49,10401,21,23,2,33,49,1699
35634,35634,BDA0B26F64A43C09D33A6313175B9FA1,12584,0,16,16,24,48,1248
35635,35635,BDA0B26F64A43C09D33A6313175B9FA1,10451,17,19,2,25,48,1298
35636,35636,BDA0B26F64A43C09D33A6313175B9FA1,40343,20,22,2,24,49,1249
35657,35657,19FF976328DAF40B2191A4FAD8E693E1,42381,5,6,1,39,41,1991
35658,35658,19FF976328DAF40B2191A4FAD8E693E1,43451,6,15,9,37,40,1890
35659,35659,19FF976328DAF40B2191A4FAD8E693E1,13071,20,21,1,41,41,2091
35660,35660,ACD7D06D699A88B2E7BB7970CE635C80,11381,7,14,7,30,47,1547
35661,35661,ACD7D06D699A88B2E7BB7970CE635C80,42291,17,19,2,29,48,1498
35662,35662,ACD7D06D699A88B2E7BB7970CE635C80,11381,21,23,2,30,47,1547
35663,35663,B7FB64E6C8C6E314875448108E0FD031,13561,0,8,8,37,49,1899
35664,35664,B7FB64E6C8C6E314875448108E0FD031,42471,13,14,1,35,49,1799
35665,35665,B7FB64E6C8C6E314875448108E0FD031,13561,18,22,4,37,49,1899
35673,35673,3202A7F9C47E4AF3E4587FA7438FD62F,10811,1,7,6,38,46,1946
35674,35674,3202A7F9C47E4AF3E4587FA7438FD62F,10111,9,12,3,37,47,1897
35675,35675,3202A7F9C47E4AF3E4587FA7438FD62F,42161,16,18,2,36,47,1847
35676,35676,3202A7F9C47E4AF3E4587FA7438FD62F,10811,19,23,4,38,46,1946
35677,35677,A80358E64F8337F82B0DC9D276184F9D,12601,0,12,12,25,47,1297
35678,35678,A80358E64F8337F82B0DC9D276184F9D,10501,12,14,2,22,46,1146
35679,35679,A80358E64F8337F82B0DC9D276184F9D,12601,18,23,5,25,47,1297
35688,35688,D2729AB4C70132F423F41A3669BBCC53,43761,1,8,7,32,47,1647
35689,35689,D2729AB4C70132F423F41A3669BBCC53,42521,8,9,1,31,47,1597
35690,35690,D2729AB4C70132F423F41A3669BBCC53,43761,9,19,10,32,47,1647
35691,35691,D2729AB4C70132F423F41A3669BBCC53,42521,19,20,1,31,47,1597
35698,35698,FB74EBCE9ED6B4055ED5E2F33038467F,11001,0,15,15,42,47,2147
35699,35699,FB74EBCE9ED6B4055ED5E2F33038467F,43481,20,21,1,39,48,1998
35700,35700,FB74EBCE9ED6B4055ED5E2F33038467F,11001,21,23,2,42,47,2147
35701,35701,C46CDF3840B783157CCBA7C0D999F0A9,10295,0,7,7,30,47,1547
35702,35702,C46CDF3840B783157CCBA7C0D999F0A9,42491,7,11,4,32,46,1646
35703,35703,C46CDF3840B783157CCBA7C0D999F0A9,10292,13,21,8,30,47,1547
35709,35709,E090AE745FE0157CE235544725EE3E3A,12514,0,6,6,38,47,1947
35710,35710,E090AE745FE0157CE235544725EE3E3A,11021,11,13,2,36,49,1849
35711,35711,E090AE745FE0157CE235544725EE3E3A,13561,14,18,4,37,49,1899
35712,35712,E090AE745FE0157CE235544725EE3E3A,12514,21,23,2,38,47,1947
35720,35720,7609CCFD6F7B0D818CF8B9F446BDEA7E,40242,0,8,8,36,49,1849
35721,35721,7609CCFD6F7B0D818CF8B9F446BDEA7E,10221,11,12,1,34,49,1749
35722,35722,7609CCFD6F7B0D818CF8B9F446BDEA7E,42961,12,19,7,35,49,1799
35723,35723,7609CCFD6F7B0D818CF8B9F446BDEA7E,40242,20,23,3,36,49,1849
35729,35729,6570D32D680E059EAEF7C538F249C69D,11091,0,8,8,29,47,1497
35730,35730,6570D32D680E059EAEF7C538F249C69D,13651,12,15,3,30,47,1547
35731,35731,6570D32D680E059EAEF7C538F249C69D,10716,19,23,4,30,46,1546
35739,35739,12F8DFA204056C9C0447EA60BB73026A,10841,0,8,8,37,47,1897
35740,35740,12F8DFA204056C9C0447EA60BB73026A,12021,18,19,1,37,49,1899
35741,35741,12F8DFA204056C9C0447EA60BB73026A,10841,20,23,3,37,47,1897
35747,35747,60B3904EE9AFD7C630994F95D4C927AC,11231,0,1,1,37,49,1899
35748,35748,60B3904EE9AFD7C630994F95D4C927AC,11201,3,5,2,35,49,1799
35749,35749,60B3904EE9AFD7C630994F95D4C927AC,13561,5,23,18,37,49,1899
35750,35750,35CAA8E33B432720CDD3C14AE49DEBFD,43751,9,10,1,19,48,998
35751,35751,35CAA8E33B432720CDD3C14AE49DEBFD,11641,14,17,3,22,49,1149
35752,35752,35CAA8E33B432720CDD3C14AE49DEBFD,43751,20,22,2,19,48,998
35753,35753,2A64F7240C0C21774B5140F4F665BEBC,40242,0,11,11,36,49,1849
35754,35754,2A64F7240C0C21774B5140F4F665BEBC,10901,13,18,5,35,48,1798
35755,35755,2A64F7240C0C21774B5140F4F665BEBC,11021,19,21,2,36,49,1849
35756,35756,584EF9EE2A3ED68DA8B082E28E1F22DB,40951,0,7,7,36,49,1849
35757,35757,584EF9EE2A3ED68DA8B082E28E1F22DB,11491,8,12,4,36,47,1847
35758,35758,584EF9EE2A3ED68DA8B082E28E1F22DB,43361,19,21,2,38,48,1948
35759,35759,584EF9EE2A3ED68DA8B082E28E1F22DB,42401,22,23,1,36,47,1847
35760,35760,4302C043DEE894456C30DA30A12F3152,10221,8,18,10,34,49,1749
35761,35761,4302C043DEE894456C30DA30A12F3152,11201,19,20,1,35,49,1799
35762,35762,4302C043DEE894456C30DA30A12F3152,10731,20,22,2,33,47,1697
35763,35763,AD235EE6A83CA7956AB86E8BC887D3C7,11541,0,6,6,35,49,1799
35764,35764,AD235EE6A83CA7956AB86E8BC887D3C7,11021,6,16,10,36,49,1849
35765,35765,AD235EE6A83CA7956AB86E8BC887D3C7,11541,20,23,3,35,49,1799
35766,35766,A5267560F8241F40BFCB325C4ADBB18D,10351,5,7,2,28,45,1445
35767,35767,A5267560F8241F40BFCB325C4ADBB18D,10634,9,11,2,27,45,1395
35768,35768,A5267560F8241F40BFCB325C4ADBB18D,10351,14,22,8,28,45,1445
35781,35781,5B005239AD91B224060A740123F8C94E,13231,0,6,6,39,46,1996
35782,35782,5B005239AD91B224060A740123F8C94E,42231,10,16,6,37,46,1896
35783,35783,5B005239AD91B224060A740123F8C94E,13231,21,23,2,39,46,1996
35784,35784,FC32FCDE5EA162E6A3931CE10EF22190,11021,0,6,6,36,49,1849
35785,35785,FC32FCDE5EA162E6A3931CE10EF22190,11231,8,18,10,37,49,1899
35786,35786,FC32FCDE5EA162E6A3931CE10EF22190,11074,19,20,1,37,47,1897
35794,35794,52DE1B5B29EB088C4F7CC0D4865B38F5,42151,1,2,1,35,45,1795
35795,35795,52DE1B5B29EB088C4F7CC0D4865B38F5,42861,3,5,2,37,44,1894
35796,35796,52DE1B5B29EB088C4F7CC0D4865B38F5,42151,10,13,3,35,45,1795
35797,35797,52DE1B5B29EB088C4F7CC0D4865B38F5,42861,15,22,7,37,44,1894
35809,35809,D1DADBAFF8F1838CF54C306F30C9CCE9,10691,0,8,8,33,48,1698
35810,35810,D1DADBAFF8F1838CF54C306F30C9CCE9,42021,10,19,9,33,47,1697
35811,35811,D1DADBAFF8F1838CF54C306F30C9CCE9,10691,21,23,2,33,48,1698
35817,35817,15D46EC570105A948AAA5BD130B0DCB7,10111,1,5,4,37,47,1897
35818,35818,15D46EC570105A948AAA5BD130B0DCB7,42161,6,7,1,36,47,1847
35819,35819,15D46EC570105A948AAA5BD130B0DCB7,10111,9,23,14,37,47,1897
35820,35820,51BC336998B7C1707612FC61253356A7,11261,1,9,8,36,46,1846
35821,35821,51BC336998B7C1707612FC61253356A7,42861,12,13,1,37,44,1894
35822,35822,51BC336998B7C1707612FC61253356A7,11261,16,20,4,36,46,1846
35823,35823,51BC336998B7C1707612FC61253356A7,42861,21,23,2,37,44,1894
35861,35861,D97F93CB7946C1399F01BAA588B11A0C,42351,0,7,7,38,45,1945
35862,35862,D97F93CB7946C1399F01BAA588B11A0C,11261,10,11,1,36,46,1846
35863,35863,D97F93CB7946C1399F01BAA588B11A0C,42351,11,23,12,38,45,1945
35864,35864,F587555054424F7ED0D63829AAEB0C06,42271,0,8,8,40,47,2047
35865,35865,F587555054424F7ED0D63829AAEB0C06,11806,10,11,1,41,48,2098
35866,35866,F587555054424F7ED0D63829AAEB0C06,42271,14,23,9,40,47,2047
35867,35867,6461AAFB513BF8ECA7540E13A2A6898B,11701,0,1,1,43,48,2198
35868,35868,6461AAFB513BF8ECA7540E13A2A6898B,43621,4,6,2,46,48,2348
35869,35869,6461AAFB513BF8ECA7540E13A2A6898B,42601,6,23,17,44,48,2248
35877,35877,B6D6806939507B6504BD50B0F874F6C4,15021,0,14,14,46,18,2318
35878,35878,B6D6806939507B6504BD50B0F874F6C4,15441,16,19,3,44,20,2220
35879,35879,B6D6806939507B6504BD50B0F874F6C4,15021,21,22,1,46,18,2318
35896,35896,81677BBF6981E3D6E202B916ACF354DA,42301,0,10,10,36,47,1847
35897,35897,81677BBF6981E3D6E202B916ACF354DA,10111,12,17,5,37,47,1897
35898,35898,81677BBF6981E3D6E202B916ACF354DA,42301,20,21,1,36,47,1847
35919,35919,64CD015D410FD64E05B4431B458C1C51,43951,0,1,1,49,41,2491
35920,35920,64CD015D410FD64E05B4431B458C1C51,13411,2,4,2,49,42,2492
35921,35921,64CD015D410FD64E05B4431B458C1C51,43951,5,22,17,49,41,2491
35922,35922,7BF71B893274BD2453B5FAE00144C714,40673,0,11,11,36,48,1848
35923,35923,7BF71B893274BD2453B5FAE00144C714,10251,12,13,1,35,47,1797
35924,35924,7BF71B893274BD2453B5FAE00144C714,40673,18,23,5,36,48,1848
35943,35943,4C13C3D7416FEE47C7E01DACD89CC954,10301,0,13,13,31,45,1595
35944,35944,4C13C3D7416FEE47C7E01DACD89CC954,12311,14,16,2,30,44,1544
35945,35945,4C13C3D7416FEE47C7E01DACD89CC954,42531,16,20,4,31,45,1595
35961,35961,46B3DE812748722328FAB277775E5F5A,42221,3,9,6,38,48,1948
35962,35962,46B3DE812748722328FAB277775E5F5A,10841,10,11,1,37,47,1897
35963,35963,46B3DE812748722328FAB277775E5F5A,12514,11,20,9,38,47,1947
35964,35964,6D3D88C57BAED90EED5783D123F38AA1,10251,0,15,15,35,47,1797
35965,35965,6D3D88C57BAED90EED5783D123F38AA1,11731,15,16,1,36,48,1848
35966,35966,6D3D88C57BAED90EED5783D123F38AA1,10251,17,23,6,35,47,1797
35967,35967,5A8308F9DAAF40265186D4E63F2640C9,12381,0,7,7,32,48,1648
35968,35968,5A8308F9DAAF40265186D4E63F2640C9,13731,12,17,5,33,49,1699
35969,35969,5A8308F9DAAF40265186D4E63F2640C9,12381,20,23,3,32,48,1648
35978,35978,1277ACA424D6A91D4C363B632562549C,12601,0,5,5,25,47,1297
35979,35979,1277ACA424D6A91D4C363B632562549C,10501,6,7,1,22,46,1146
35980,35980,1277ACA424D6A91D4C363B632562549C,12601,10,23,13,25,47,1297
35981,35981,166BAAB821AA202CFD3471F7D2BCE45E,42331,0,5,5,39,46,1996
35982,35982,166BAAB821AA202CFD3471F7D2BCE45E,42351,10,11,1,38,45,1945
35983,35983,166BAAB821AA202CFD3471F7D2BCE45E,11261,14,16,2,36,46,1846
35984,35984,166BAAB821AA202CFD3471F7D2BCE45E,10911,20,23,3,39,46,1996
36004,36004,38BAD20AF3F1C2D76FC5AB52738907B1,10341,0,14,14,31,47,1597
36005,36005,38BAD20AF3F1C2D76FC5AB52738907B1,42141,16,17,1,32,47,1647
36006,36006,38BAD20AF3F1C2D76FC5AB52738907B1,10341,18,20,2,31,47,1597
36007,36007,2B796358390FD846EE57DE8924EDBF14,42581,0,4,4,38,48,1948
36008,36008,2B796358390FD846EE57DE8924EDBF14,11914,5,7,2,37,48,1898
36009,36009,2B796358390FD846EE57DE8924EDBF14,42581,7,22,15,38,48,1948
36010,36010,0F18A9274445631256C7B0403CD7E0F0,10111,0,8,8,37,47,1897
36011,36011,0F18A9274445631256C7B0403CD7E0F0,12021,11,12,1,37,49,1899
36012,36012,0F18A9274445631256C7B0403CD7E0F0,10111,14,20,6,37,47,1897
36013,36013,0F18A9274445631256C7B0403CD7E0F0,42161,22,23,1,36,47,1847
36014,36014,C898CBC2B35F503BC424C75E27A5EB91,10111,0,12,12,37,47,1897
36015,36015,C898CBC2B35F503BC424C75E27A5EB91,10251,14,15,1,35,47,1797
36016,36016,C898CBC2B35F503BC424C75E27A5EB91,10111,17,19,2,37,47,1897
36017,36017,EAEFCB977DEDF23C1346736B36A6F67B,13911,0,7,7,39,46,1996
36018,36018,EAEFCB977DEDF23C1346736B36A6F67B,11261,7,8,1,36,46,1846
36019,36019,EAEFCB977DEDF23C1346736B36A6F67B,42231,12,23,11,37,46,1896
36020,36020,909FE24282032BE2FFBF86A121DA90F1,10471,0,13,13,37,48,1898
36021,36021,909FE24282032BE2FFBF86A121DA90F1,42961,15,16,1,35,49,1799
36022,36022,909FE24282032BE2FFBF86A121DA90F1,10471,17,23,6,37,48,1898
36023,36023,A26526FCE25758DA240C3B314B205E8A,19024,0,6,6,9,45,495
36024,36024,A26526FCE25758DA240C3B314B205E8A,12641,7,19,12,10,43,543
36025,36025,A26526FCE25758DA240C3B314B205E8A,19024,21,23,2,9,45,495
36036,36036,E8A3A2F2678AE58B36D710FCF037760E,11231,0,2,2,37,49,1899
36037,36037,E8A3A2F2678AE58B36D710FCF037760E,10411,2,21,19,36,48,1848
36038,36038,E8A3A2F2678AE58B36D710FCF037760E,11231,21,23,2,37,49,1899
36039,36039,0B1AFB24DF884F60B6F408AA4B8B069D,11151,0,8,8,30,48,1548
36040,36040,0B1AFB24DF884F60B6F408AA4B8B069D,11061,9,12,3,29,48,1498
36041,36041,0B1AFB24DF884F60B6F408AA4B8B069D,11151,14,23,9,30,48,1548
36062,36062,3C89D3E050BD396C6E176628C3E38174,10471,0,7,7,37,48,1898
36063,36063,3C89D3E050BD396C6E176628C3E38174,10111,10,12,2,37,47,1897
36064,36064,3C89D3E050BD396C6E176628C3E38174,42771,14,20,6,36,47,1847
36075,36075,0277E6ABE6E23FB8B51E9078601CBBC1,42491,0,7,7,32,46,1646
36076,36076,0277E6ABE6E23FB8B51E9078601CBBC1,42523,11,15,4,31,47,1597
36077,36077,0277E6ABE6E23FB8B51E9078601CBBC1,42491,19,23,4,32,46,1646
36078,36078,35B7E72942C4FC8B9E6675E01B3D7631,42871,0,6,6,30,45,1545
36079,36079,35B7E72942C4FC8B9E6675E01B3D7631,10301,7,15,8,31,45,1595
36080,36080,35B7E72942C4FC8B9E6675E01B3D7631,10351,19,20,1,28,45,1445
36084,36084,E1ADA5D6F54060F04D34C1A2CB8FE108,42221,0,7,7,38,48,1948
36085,36085,E1ADA5D6F54060F04D34C1A2CB8FE108,11074,10,12,2,37,47,1897
36086,36086,E1ADA5D6F54060F04D34C1A2CB8FE108,13381,12,18,6,39,47,1997
36087,36087,C75781F60799DE2652DF86EC8BB9A296,11731,1,3,2,36,48,1848
36088,36088,C75781F60799DE2652DF86EC8BB9A296,10251,6,14,8,35,47,1797
36089,36089,C75781F60799DE2652DF86EC8BB9A296,10411,16,23,7,36,48,1848
36090,36090,DAFE070AC8164EB683B9455E05DD84E1,13101,0,7,7,40,47,2047
36091,36091,DAFE070AC8164EB683B9455E05DD84E1,11481,8,19,11,41,48,2098
36092,36092,DAFE070AC8164EB683B9455E05DD84E1,13101,21,23,2,40,47,2047
36097,36097,FC3B8910035FE6AFFCEFAAF1A5BD46D7,10471,0,11,11,37,48,1898
36098,36098,FC3B8910035FE6AFFCEFAAF1A5BD46D7,42191,12,16,4,38,49,1949
36099,36099,FC3B8910035FE6AFFCEFAAF1A5BD46D7,10471,19,23,4,37,48,1898
36100,36100,3C5BF8354C7B22C00BFA5438C070BC0F,13711,0,7,7,38,46,1946
36101,36101,3C5BF8354C7B22C00BFA5438C070BC0F,43241,9,11,2,36,46,1846
36102,36102,3C5BF8354C7B22C00BFA5438C070BC0F,13711,11,20,9,38,46,1946
36103,36103,805EE774A2BBF9DBFC5B48F9642AD1F7,10251,0,1,1,35,47,1797
36104,36104,805EE774A2BBF9DBFC5B48F9642AD1F7,10111,1,8,7,37,47,1897
36105,36105,805EE774A2BBF9DBFC5B48F9642AD1F7,42301,11,23,12,36,47,1847
36122,36122,2510A335FA627692203CB5C3136C3C6E,43081,0,9,9,27,28,1378
36123,36123,2510A335FA627692203CB5C3136C3C6E,15321,14,15,1,29,26,1476
36124,36124,2510A335FA627692203CB5C3136C3C6E,43081,16,17,1,27,28,1378
36125,36125,2510A335FA627692203CB5C3136C3C6E,15321,21,22,1,29,26,1476
36131,36131,D75859C5199E26E4E069299921FEC112,42921,0,9,9,33,47,1697
36132,36132,D75859C5199E26E4E069299921FEC112,43761,9,19,10,32,47,1647
36133,36133,D75859C5199E26E4E069299921FEC112,42021,19,20,1,33,47,1697
36134,36134,D75859C5199E26E4E069299921FEC112,43761,20,22,2,32,47,1647
36139,36139,227550B71384889A67AC4E901F7C17A1,10151,8,11,3,34,47,1747
36140,36140,227550B71384889A67AC4E901F7C17A1,11861,12,19,7,32,47,1647
36141,36141,227550B71384889A67AC4E901F7C17A1,10151,20,23,3,34,47,1747
36152,36152,B8DCAC0FC6FA981D871032E55C240C8E,11914,0,14,14,37,48,1898
36153,36153,B8DCAC0FC6FA981D871032E55C240C8E,42583,15,16,1,40,48,2048
36154,36154,B8DCAC0FC6FA981D871032E55C240C8E,11914,18,20,2,37,48,1898
36155,36155,B8DCAC0FC6FA981D871032E55C240C8E,42581,20,21,1,38,48,1948
36156,36156,EA7259828C59286A0C8476F89AAE54B8,42351,0,4,4,38,45,1945
36157,36157,EA7259828C59286A0C8476F89AAE54B8,11261,4,9,5,36,46,1846
36158,36158,EA7259828C59286A0C8476F89AAE54B8,42351,10,12,2,38,45,1945
36159,36159,EA7259828C59286A0C8476F89AAE54B8,11261,13,20,7,36,46,1846
36160,36160,793DC4BC4E2928DCDBFB7B36F78CD36B,10111,0,9,9,37,47,1897
36161,36161,793DC4BC4E2928DCDBFB7B36F78CD36B,11551,11,18,7,39,49,1999
36162,36162,793DC4BC4E2928DCDBFB7B36F78CD36B,40637,20,22,2,36,47,1847
36180,36180,C1436EDF959E671E7FA82361C08DB659,42581,2,4,2,38,48,1948
36181,36181,C1436EDF959E671E7FA82361C08DB659,10191,6,18,12,40,48,2048
36182,36182,C1436EDF959E671E7FA82361C08DB659,11914,20,21,1,37,48,1898
36183,36183,42A16EFB84F2A02AEC5229D088C54FF3,13911,2,7,5,39,46,1996
36184,36184,42A16EFB84F2A02AEC5229D088C54FF3,42231,10,11,1,37,46,1896
36185,36185,42A16EFB84F2A02AEC5229D088C54FF3,13911,13,18,5,39,46,1996
36199,36199,46D492BAB010922B2E00FA587B30756A,43951,0,10,10,49,41,2491
36200,36200,46D492BAB010922B2E00FA587B30756A,13411,10,11,1,49,42,2492
36201,36201,46D492BAB010922B2E00FA587B30756A,43951,11,16,5,49,41,2491
36202,36202,46D492BAB010922B2E00FA587B30756A,13411,19,23,4,49,42,2492
36208,36208,58DF107986367FA88C1D627635A20D98,42011,3,9,6,36,46,1846
36209,36209,58DF107986367FA88C1D627635A20D98,42231,9,11,2,37,46,1896
36210,36210,58DF107986367FA88C1D627635A20D98,42011,12,22,10,36,46,1846
36225,36225,8A42F196E2C98613B7912F262231FCD6,11151,0,8,8,30,48,1548
36226,36226,8A42F196E2C98613B7912F262231FCD6,12311,12,16,4,30,44,1544
36227,36227,8A42F196E2C98613B7912F262231FCD6,42521,17,18,1,31,47,1597
36228,36228,9C819019C9FBB04766CC6EE29C66CE0E,11331,0,8,8,37,48,1898
36229,36229,9C819019C9FBB04766CC6EE29C66CE0E,40673,12,15,3,36,48,1848
36230,36230,9C819019C9FBB04766CC6EE29C66CE0E,10111,17,20,3,37,47,1897
36231,36231,9C819019C9FBB04766CC6EE29C66CE0E,40421,21,23,2,37,48,1898
36232,36232,E859A0BF6FB37F9B42DF06EC7EE8FF9D,42461,0,6,6,45,47,2297
36233,36233,E859A0BF6FB37F9B42DF06EC7EE8FF9D,43621,8,10,2,46,48,2348
36234,36234,E859A0BF6FB37F9B42DF06EC7EE8FF9D,11701,15,17,2,43,48,2198
36235,36235,E859A0BF6FB37F9B42DF06EC7EE8FF9D,42461,18,22,4,45,47,2297
36240,36240,964156E683797EC321E31C806CD19178,11914,0,2,2,37,48,1898
36241,36241,964156E683797EC321E31C806CD19178,42581,5,11,6,38,48,1948
36242,36242,964156E683797EC321E31C806CD19178,11331,15,23,8,37,48,1898
36243,36243,C1896697E8F9082F3C179E6CB902F84B,12871,1,6,5,22,33,1133
36244,36244,C1896697E8F9082F3C179E6CB902F84B,49181,9,10,1,21,31,1081
36245,36245,C1896697E8F9082F3C179E6CB902F84B,12871,10,12,2,22,33,1133
36246,36246,C1896697E8F9082F3C179E6CB902F84B,49181,12,21,9,21,31,1081
36247,36247,622CAD2A1CBEEB3E7C37B415C8550447,13561,0,8,8,37,49,1899
36248,36248,622CAD2A1CBEEB3E7C37B415C8550447,11261,10,12,2,36,46,1846
36249,36249,622CAD2A1CBEEB3E7C37B415C8550447,43981,12,19,7,36,49,1849
36250,36250,622CAD2A1CBEEB3E7C37B415C8550447,13741,19,21,2,37,49,1899
36255,36255,FC0936587C74EF8144A5D7B54D78302D,19441,3,5,2,8,46,446
36256,36256,FC0936587C74EF8144A5D7B54D78302D,19021,5,19,14,10,45,545
36257,36257,FC0936587C74EF8144A5D7B54D78302D,19441,19,21,2,8,46,446
36262,36262,E16566CAC1D2263C830A92E3D7A4B3A9,42231,0,14,14,37,46,1896
36263,36263,E16566CAC1D2263C830A92E3D7A4B3A9,13911,17,19,2,39,46,1996
36264,36264,E16566CAC1D2263C830A92E3D7A4B3A9,42351,20,21,1,38,45,1945
36265,36265,7158BB5FE54F024DF86B9682428D7D80,42581,0,5,5,38,48,1948
36266,36266,7158BB5FE54F024DF86B9682428D7D80,11914,7,8,1,37,48,1898
36267,36267,7158BB5FE54F024DF86B9682428D7D80,42581,12,14,2,38,48,1948
36268,36268,7158BB5FE54F024DF86B9682428D7D80,10471,19,23,4,37,48,1898
36269,36269,19A29A27E6506D34C07A04E6E9F52A03,12491,0,1,1,36,43,1843
36270,36270,19A29A27E6506D34C07A04E6E9F52A03,42151,2,11,9,35,45,1795
36271,36271,19A29A27E6506D34C07A04E6E9F52A03,12491,16,17,1,36,43,1843
36272,36272,19A29A27E6506D34C07A04E6E9F52A03,42151,20,21,1,35,45,1795
36276,36276,9393B0A1C7F58A6E01E93A0B90D8C1D0,10292,0,7,7,30,47,1547
36277,36277,9393B0A1C7F58A6E01E93A0B90D8C1D0,12131,8,11,3,32,47,1647
36278,36278,9393B0A1C7F58A6E01E93A0B90D8C1D0,42523,16,18,2,31,47,1597
36279,36279,9393B0A1C7F58A6E01E93A0B90D8C1D0,10292,20,23,3,30,47,1547
36284,36284,DECD997D8180830B0BE35E7B3104F23D,11751,0,13,13,35,48,1798
36285,36285,DECD997D8180830B0BE35E7B3104F23D,40673,14,15,1,36,48,1848
36286,36286,DECD997D8180830B0BE35E7B3104F23D,10401,19,21,2,33,49,1699
36287,36287,DECD997D8180830B0BE35E7B3104F23D,43321,21,23,2,36,49,1849
36291,36291,10D4ECB5748779C9E514DAF1CC0CDD65,11861,2,9,7,32,47,1647
36292,36292,10D4ECB5748779C9E514DAF1CC0CDD65,11161,14,16,2,32,48,1648
36293,36293,10D4ECB5748779C9E514DAF1CC0CDD65,42021,16,22,6,33,47,1697
36304,36304,394D700E14C58A7853C10805B183B24E,43761,0,1,1,32,47,1647
36305,36305,394D700E14C58A7853C10805B183B24E,11061,2,6,4,29,48,1498
36306,36306,394D700E14C58A7853C10805B183B24E,11875,8,18,10,30,46,1546
36307,36307,B3D9D8E72FD92A77A76B6490766A3C36,19901,0,4,4,7,44,394
36308,36308,B3D9D8E72FD92A77A76B6490766A3C36,12641,6,8,2,10,43,543
36309,36309,B3D9D8E72FD92A77A76B6490766A3C36,19114,10,22,12,7,43,393
36315,36315,AA8CC60B06B8E7A334E7FA04353D8EED,42864,0,5,5,38,44,1944
36316,36316,AA8CC60B06B8E7A334E7FA04353D8EED,11261,6,8,2,36,46,1846
36317,36317,AA8CC60B06B8E7A334E7FA04353D8EED,13231,18,19,1,39,46,1996
36318,36318,AA8CC60B06B8E7A334E7FA04353D8EED,11261,19,21,2,36,46,1846
36324,36324,34DB9905DC650E195FEB755F1CE4E898,43481,2,5,3,39,48,1998
36325,36325,34DB9905DC650E195FEB755F1CE4E898,42271,6,13,7,40,47,2047
36326,36326,34DB9905DC650E195FEB755F1CE4E898,13381,13,17,4,39,47,1997
36327,36327,34DB9905DC650E195FEB755F1CE4E898,42271,20,23,3,40,47,2047
36328,36328,E779DF22EB61C0D4BA72F0FBA1762DF8,11914,0,14,14,37,48,1898
36329,36329,E779DF22EB61C0D4BA72F0FBA1762DF8,43181,17,19,2,39,48,1998
36330,36330,E779DF22EB61C0D4BA72F0FBA1762DF8,11914,22,23,1,37,48,1898
36331,36331,A655C67D52402CE056E16AFA14815F89,11481,2,4,2,41,48,2098
36332,36332,A655C67D52402CE056E16AFA14815F89,13271,6,12,6,41,47,2097
36333,36333,A655C67D52402CE056E16AFA14815F89,11481,14,17,3,41,48,2098
36334,36334,A655C67D52402CE056E16AFA14815F89,13271,22,23,1,41,47,2097
36335,36335,AE931B79E80BF3CFA2F48EF7F9685CA5,12491,2,4,2,36,43,1843
36336,36336,AE931B79E80BF3CFA2F48EF7F9685CA5,11261,5,6,1,36,46,1846
36337,36337,AE931B79E80BF3CFA2F48EF7F9685CA5,12491,6,8,2,36,43,1843
36338,36338,AE931B79E80BF3CFA2F48EF7F9685CA5,11261,10,20,10,36,46,1846
36339,36339,ADD558F3FC3AD50A8C0F6E8918A2B55F,10251,10,13,3,35,47,1797
36340,36340,ADD558F3FC3AD50A8C0F6E8918A2B55F,40637,13,17,4,36,47,1847
36341,36341,ADD558F3FC3AD50A8C0F6E8918A2B55F,10251,19,21,2,35,47,1797
36342,36342,4294B5A32655CC23063B4ED966A8BED3,10611,1,14,13,32,48,1648
36343,36343,4294B5A32655CC23063B4ED966A8BED3,11131,18,20,2,33,48,1698
36344,36344,4294B5A32655CC23063B4ED966A8BED3,10611,22,23,1,32,48,1648
36369,36369,48FFE05CCBE41B8475B3588494BC5562,42583,0,13,13,40,48,2048
36370,36370,48FFE05CCBE41B8475B3588494BC5562,13101,14,17,3,40,47,2047
36371,36371,48FFE05CCBE41B8475B3588494BC5562,11806,20,23,3,41,48,2098
36379,36379,7CC7901DF094F799764E6157DE62B394,42961,0,4,4,35,49,1799
36380,36380,7CC7901DF094F799764E6157DE62B394,11231,5,7,2,37,49,1899
36381,36381,7CC7901DF094F799764E6157DE62B394,12083,8,18,10,36,49,1849
36382,36382,7CC7901DF094F799764E6157DE62B394,11231,18,23,5,37,49,1899
36383,36383,6DFA48F81EF42083077B44FC80706865,10971,0,19,19,35,47,1797
36384,36384,6DFA48F81EF42083077B44FC80706865,43731,19,21,2,34,47,1747
36385,36385,6DFA48F81EF42083077B44FC80706865,10971,21,22,1,35,47,1797
36394,36394,7EF8399B7744B26431FFE3070C9BD313,19441,0,9,9,8,46,446
36395,36395,7EF8399B7744B26431FFE3070C9BD313,42041,10,20,10,10,47,547
36396,36396,7EF8399B7744B26431FFE3070C9BD313,19441,22,23,1,8,46,446
36397,36397,700A8469B8648E235281334EF5CC8DA1,10371,0,17,17,37,49,1899
36398,36398,700A8469B8648E235281334EF5CC8DA1,10471,17,18,1,37,48,1898
36399,36399,700A8469B8648E235281334EF5CC8DA1,11231,18,23,5,37,49,1899
36411,36411,5B9E09F094541824399F39AB61F4C681,13651,10,11,1,30,47,1547
36412,36412,5B9E09F094541824399F39AB61F4C681,10951,15,16,1,29,48,1498
36413,36413,5B9E09F094541824399F39AB61F4C681,11381,19,21,2,30,47,1547
36414,36414,0AE1F060A9917578AF6CC39BEF4A5FD7,11914,1,6,5,37,48,1898
36415,36415,0AE1F060A9917578AF6CC39BEF4A5FD7,10371,9,18,9,37,49,1899
36416,36416,0AE1F060A9917578AF6CC39BEF4A5FD7,11914,22,23,1,37,48,1898
36417,36417,23F8F9B0AC0C62AC07DD5CA5BCEDE820,43101,1,7,6,46,40,2340
36418,36418,23F8F9B0AC0C62AC07DD5CA5BCEDE820,13551,7,13,6,45,38,2288
36419,36419,23F8F9B0AC0C62AC07DD5CA5BCEDE820,43101,13,16,3,46,40,2340
36420,36420,23F8F9B0AC0C62AC07DD5CA5BCEDE820,13551,17,22,5,45,38,2288
36421,36421,E835E54D31E2053FF59F5E3D61ABCD72,11151,8,11,3,30,48,1548
36422,36422,E835E54D31E2053FF59F5E3D61ABCD72,42831,12,13,1,27,48,1398
36423,36423,E835E54D31E2053FF59F5E3D61ABCD72,11151,14,21,7,30,48,1548
36424,36424,508DF001F529FBF83DF8D4A342350BFA,42861,3,19,16,37,44,1894
36425,36425,508DF001F529FBF83DF8D4A342350BFA,11261,19,20,1,36,46,1846
36426,36426,508DF001F529FBF83DF8D4A342350BFA,13231,20,23,3,39,46,1996
36464,36464,5767E0EE50B7CB3B0CFBFCA7463471BC,11806,0,6,6,41,48,2098
36465,36465,5767E0EE50B7CB3B0CFBFCA7463471BC,13111,7,18,11,42,46,2146
36466,36466,5767E0EE50B7CB3B0CFBFCA7463471BC,11806,20,22,2,41,48,2098
36470,36470,1CE5F4D10EE2FB173CB9F2BC0746661A,12311,1,3,2,30,44,1544
36471,36471,1CE5F4D10EE2FB173CB9F2BC0746661A,42531,3,10,7,31,45,1595
36472,36472,1CE5F4D10EE2FB173CB9F2BC0746661A,12311,14,23,9,30,44,1544
36478,36478,394B81CC36B31D897120A6153D7C1457,11061,1,4,3,29,48,1498
36479,36479,394B81CC36B31D897120A6153D7C1457,42501,8,12,4,28,47,1447
36480,36480,394B81CC36B31D897120A6153D7C1457,12121,12,17,5,29,47,1497
36481,36481,394B81CC36B31D897120A6153D7C1457,11061,18,23,5,29,48,1498
36489,36489,354BD264A9E3427AF445BDA947BFDA83,11791,7,8,1,38,49,1949
36490,36490,354BD264A9E3427AF445BDA947BFDA83,40171,10,11,1,38,48,1948
36491,36491,354BD264A9E3427AF445BDA947BFDA83,11771,12,18,6,39,49,1999
36492,36492,354BD264A9E3427AF445BDA947BFDA83,10221,21,22,1,34,49,1749
36493,36493,CF7D34E0CAAC53341408143F5EE5A475,10951,0,3,3,29,48,1498
36494,36494,CF7D34E0CAAC53341408143F5EE5A475,40331,7,10,3,30,47,1547
36495,36495,CF7D34E0CAAC53341408143F5EE5A475,10951,12,13,1,29,48,1498
36496,36496,CF7D34E0CAAC53341408143F5EE5A475,40331,14,20,6,30,47,1547
36497,36497,1E73C162A836B499430B39DAD69D8DD3,40891,0,3,3,37,47,1897
36498,36498,1E73C162A836B499430B39DAD69D8DD3,11331,4,5,1,37,48,1898
36499,36499,1E73C162A836B499430B39DAD69D8DD3,10841,5,23,18,37,47,1897
36509,36509,A43D5D4A5B684572DED832EF1C15CC22,11261,1,12,11,36,46,1846
36510,36510,A43D5D4A5B684572DED832EF1C15CC22,13231,16,17,1,39,46,1996
36511,36511,A43D5D4A5B684572DED832EF1C15CC22,11261,21,23,2,36,46,1846
36522,36522,28EBDF129D422CC62555B67FAF051D3A,43761,0,8,8,32,47,1647
36523,36523,28EBDF129D422CC62555B67FAF051D3A,10901,12,18,6,35,48,1798
36524,36524,28EBDF129D422CC62555B67FAF051D3A,43761,19,23,4,32,47,1647
36547,36547,8E8831CA308168F585F32EA6A4F05D47,13651,0,1,1,30,47,1547
36548,36548,8E8831CA308168F585F32EA6A4F05D47,12121,4,13,9,29,47,1497
36549,36549,8E8831CA308168F585F32EA6A4F05D47,10951,17,19,2,29,48,1498
36550,36550,8E8831CA308168F585F32EA6A4F05D47,12121,20,22,2,29,47,1497
36551,36551,C3F5D89F883E89DCE972179BE4776686,42941,0,10,10,37,47,1897
36552,36552,C3F5D89F883E89DCE972179BE4776686,10251,10,19,9,35,47,1797
36553,36553,C3F5D89F883E89DCE972179BE4776686,42941,20,22,2,37,47,1897
36554,36554,36D57AC4B96C7DFE87ABBE02CDA239B2,10251,0,7,7,35,47,1797
36555,36555,36D57AC4B96C7DFE87ABBE02CDA239B2,11861,19,21,2,32,47,1647
36556,36556,36D57AC4B96C7DFE87ABBE02CDA239B2,10471,22,23,1,37,48,1898
36560,36560,91284BBE72A4661BF1E53E3FAFD2E3D8,13651,0,13,13,30,47,1547
36561,36561,91284BBE72A4661BF1E53E3FAFD2E3D8,42523,18,19,1,31,47,1597
36562,36562,91284BBE72A4661BF1E53E3FAFD2E3D8,10295,20,23,3,30,47,1547
36566,36566,A03C1D63BAC5E41AE1A4B426E037BC8D,11491,0,7,7,36,47,1847
36567,36567,A03C1D63BAC5E41AE1A4B426E037BC8D,13121,8,9,1,38,46,1946
36568,36568,A03C1D63BAC5E41AE1A4B426E037BC8D,10271,12,17,5,37,46,1896
36569,36569,A03C1D63BAC5E41AE1A4B426E037BC8D,40431,21,23,2,36,47,1847
36570,36570,924C94FEA337955066B022FCC7607D38,11361,0,5,5,22,48,1148
36571,36571,924C94FEA337955066B022FCC7607D38,12581,5,21,16,24,48,1248
36572,36572,924C94FEA337955066B022FCC7607D38,11361,21,23,2,22,48,1148
36573,36573,8671664FCEA72D44791A077CF27C82B3,12921,0,6,6,9,41,491
36574,36574,8671664FCEA72D44791A077CF27C82B3,12641,6,7,1,10,43,543
36575,36575,8671664FCEA72D44791A077CF27C82B3,12921,8,11,3,9,41,491
36576,36576,8671664FCEA72D44791A077CF27C82B3,12641,14,20,6,10,43,543
36577,36577,8E0D20320C5276BDD797BA6D65B9C51D,11074,0,7,7,37,47,1897
36578,36578,8E0D20320C5276BDD797BA6D65B9C51D,11231,8,15,7,37,49,1899
36579,36579,8E0D20320C5276BDD797BA6D65B9C51D,12083,17,18,1,36,49,1849
36580,36580,8E0D20320C5276BDD797BA6D65B9C51D,11074,18,23,5,37,47,1897
36592,36592,5D3AB87CDE152EA5E956E4DDC06AC59B,10471,0,1,1,37,48,1898
36593,36593,5D3AB87CDE152EA5E956E4DDC06AC59B,40171,2,16,14,38,48,1948
36594,36594,5D3AB87CDE152EA5E956E4DDC06AC59B,10471,16,18,2,37,48,1898
36595,36595,5D3AB87CDE152EA5E956E4DDC06AC59B,40171,20,22,2,38,48,1948
36596,36596,10B8A2D44211CACA01D59967B38E8576,42161,0,8,8,36,47,1847
36597,36597,10B8A2D44211CACA01D59967B38E8576,10251,11,16,5,35,47,1797
36598,36598,10B8A2D44211CACA01D59967B38E8576,42161,16,18,2,36,47,1847
36599,36599,10B8A2D44211CACA01D59967B38E8576,10251,21,23,2,35,47,1797
36600,36600,559777BBBCD664850DC1E8E7503633C6,10351,1,11,10,28,45,1445
36601,36601,559777BBBCD664850DC1E8E7503633C6,42531,14,15,1,31,45,1595
36602,36602,559777BBBCD664850DC1E8E7503633C6,12661,20,23,3,32,45,1645
36606,36606,E1EFCCC2B784376CB5869240B9B59E0D,19931,0,3,3,7,43,393
36607,36607,E1EFCCC2B784376CB5869240B9B59E0D,12641,5,14,9,10,43,543
36608,36608,E1EFCCC2B784376CB5869240B9B59E0D,19931,19,22,3,7,43,393
36609,36609,9D1D6C8F3B399A8A61F31E1610AD3A2B,10971,3,4,1,35,47,1797
36610,36610,9D1D6C8F3B399A8A61F31E1610AD3A2B,42161,5,7,2,36,47,1847
36611,36611,9D1D6C8F3B399A8A61F31E1610AD3A2B,10971,10,19,9,35,47,1797
36612,36612,2E18E8DF093288689E2805A1F3FB2A40,12921,0,6,6,9,41,491
36613,36613,2E18E8DF093288689E2805A1F3FB2A40,12641,6,10,4,10,43,543
36614,36614,2E18E8DF093288689E2805A1F3FB2A40,12921,10,21,11,9,41,491
36624,36624,F66EBAC9EE1CB5E174070796CFB61D9B,12491,3,14,11,36,43,1843
36625,36625,F66EBAC9EE1CB5E174070796CFB61D9B,42151,17,18,1,35,45,1795
36626,36626,F66EBAC9EE1CB5E174070796CFB61D9B,12491,19,20,1,36,43,1843
36627,36627,F66EBAC9EE1CB5E174070796CFB61D9B,10511,21,22,1,35,46,1796
36652,36652,ED63CD6A523ED82BABC0C283513656AA,19441,10,11,1,8,46,446
36653,36653,ED63CD6A523ED82BABC0C283513656AA,19114,12,16,4,7,43,393
36654,36654,ED63CD6A523ED82BABC0C283513656AA,19901,17,19,2,7,44,394
36655,36655,ED63CD6A523ED82BABC0C283513656AA,42041,22,23,1,10,47,547
36662,36662,445A90121514A82FCCD431DD3088A581,40637,0,7,7,36,47,1847
36663,36663,445A90121514A82FCCD431DD3088A581,42921,11,13,2,33,47,1697
36664,36664,445A90121514A82FCCD431DD3088A581,11861,17,21,4,32,47,1647
36665,36665,1258C393C9337F1E0666CA607B4668D4,12221,1,2,1,43,44,2194
36666,36666,1258C393C9337F1E0666CA607B4668D4,12141,3,7,4,42,45,2145
36667,36667,1258C393C9337F1E0666CA607B4668D4,13111,8,9,1,42,46,2146
36668,36668,1258C393C9337F1E0666CA607B4668D4,10771,11,19,8,41,46,2096
36673,36673,69E543DFF7ABD4903EB302CAAC6962DA,11921,0,6,6,38,48,1948
36674,36674,69E543DFF7ABD4903EB302CAAC6962DA,11021,9,18,9,36,49,1849
36675,36675,69E543DFF7ABD4903EB302CAAC6962DA,11921,20,22,2,38,48,1948
36676,36676,73F5D46A0AB49D3D1FF3EBE9DD0774B5,11261,0,12,12,36,46,1846
36677,36677,73F5D46A0AB49D3D1FF3EBE9DD0774B5,42861,15,17,2,37,44,1894
36678,36678,73F5D46A0AB49D3D1FF3EBE9DD0774B5,11261,18,21,3,36,46,1846
36679,36679,DF460CBD4C09A51D06C2038FDA368680,19441,1,7,6,8,46,446
36680,36680,DF460CBD4C09A51D06C2038FDA368680,42041,9,10,1,10,47,547
36681,36681,DF460CBD4C09A51D06C2038FDA368680,19441,14,21,7,8,46,446
36682,36682,ED70E4FFEFCCC0655C158EA3C526D0EE,11914,9,11,2,37,48,1898
36683,36683,ED70E4FFEFCCC0655C158EA3C526D0EE,42581,13,16,3,38,48,1948
36684,36684,ED70E4FFEFCCC0655C158EA3C526D0EE,11914,18,22,4,37,48,1898
36685,36685,520F9ABAA156FE9FB29070D4A540240C,43161,0,1,1,35,47,1797
36686,36686,520F9ABAA156FE9FB29070D4A540240C,10111,1,11,10,37,47,1897
36687,36687,520F9ABAA156FE9FB29070D4A540240C,40673,12,17,5,36,48,1848
36688,36688,520F9ABAA156FE9FB29070D4A540240C,10111,18,23,5,37,47,1897
36689,36689,7300FFB733BFFEA187DB110E4D4DC3D2,19181,0,6,6,8,40,440
36690,36690,7300FFB733BFFEA187DB110E4D4DC3D2,12921,7,9,2,9,41,491
36691,36691,7300FFB733BFFEA187DB110E4D4DC3D2,49201,12,13,1,7,41,391
36692,36692,7300FFB733BFFEA187DB110E4D4DC3D2,12921,15,22,7,9,41,491
36696,36696,582FCEF67ED9C80E5B2E8667690F61FB,42221,1,10,9,38,48,1948
36697,36697,582FCEF67ED9C80E5B2E8667690F61FB,42401,11,20,9,36,47,1847
36698,36698,582FCEF67ED9C80E5B2E8667690F61FB,42221,21,23,2,38,48,1948
36711,36711,823BB637426A4B64F4A56D087D45C241,49201,0,4,4,7,41,391
36712,36712,823BB637426A4B64F4A56D087D45C241,12921,9,19,10,9,41,491
36713,36713,823BB637426A4B64F4A56D087D45C241,49201,20,23,3,7,41,391
36714,36714,6EAAD36740FA9733F9B307AB6BB4291A,13341,0,13,13,44,45,2245
36715,36715,6EAAD36740FA9733F9B307AB6BB4291A,42631,16,17,1,43,45,2195
36716,36716,6EAAD36740FA9733F9B307AB6BB4291A,13341,21,23,2,44,45,2245
36717,36717,4ACECC2B9EC145419E108C6F4A54C789,10111,0,9,9,37,47,1897
36718,36718,4ACECC2B9EC145419E108C6F4A54C789,11331,10,11,1,37,48,1898
36719,36719,4ACECC2B9EC145419E108C6F4A54C789,10111,13,23,10,37,47,1897
36720,36720,B3D3247264CC59DE8B1DE47660D9C8A8,43761,3,10,7,32,47,1647
36721,36721,B3D3247264CC59DE8B1DE47660D9C8A8,11161,13,14,1,32,48,1648
36722,36722,B3D3247264CC59DE8B1DE47660D9C8A8,43761,15,17,2,32,47,1647
36723,36723,B3D3247264CC59DE8B1DE47660D9C8A8,11161,19,23,4,32,48,1648
36724,36724,F8320AC02FAC6F4A311CBF8892D02227,11381,0,11,11,30,47,1547
36725,36725,F8320AC02FAC6F4A311CBF8892D02227,10951,11,12,1,29,48,1498
36726,36726,F8320AC02FAC6F4A311CBF8892D02227,11381,14,23,9,30,47,1547
36727,36727,8D3081890D4E21B96EB36E3315800773,42523,0,5,5,31,47,1597
36728,36728,8D3081890D4E21B96EB36E3315800773,42491,8,16,8,32,46,1646
36729,36729,8D3081890D4E21B96EB36E3315800773,42523,21,23,2,31,47,1597
36741,36741,561D4D1AD62B823B1D086682C96A905B,42121,0,7,7,26,49,1349
36742,36742,561D4D1AD62B823B1D086682C96A905B,40343,10,12,2,24,49,1249
36743,36743,561D4D1AD62B823B1D086682C96A905B,40348,15,19,4,25,49,1299
36744,36744,561D4D1AD62B823B1D086682C96A905B,42121,21,23,2,26,49,1349
36745,36745,053138E4DD06C9756C34D015D055BBCE,10681,2,6,4,30,48,1548
36746,36746,053138E4DD06C9756C34D015D055BBCE,11061,10,11,1,29,48,1498
36747,36747,053138E4DD06C9756C34D015D055BBCE,10681,13,21,8,30,48,1548
36755,36755,81003AAF54FC7D8860E2DD4EB67FA5EE,11324,0,11,11,31,46,1596
36756,36756,81003AAF54FC7D8860E2DD4EB67FA5EE,11061,13,14,1,29,48,1498
36757,36757,81003AAF54FC7D8860E2DD4EB67FA5EE,11324,15,23,8,31,46,1596
36777,36777,FCC81FB1D89F2E284C3312E5101F2149,42151,0,5,5,35,45,1795
36778,36778,FCC81FB1D89F2E284C3312E5101F2149,42861,8,10,2,37,44,1894
36779,36779,FCC81FB1D89F2E284C3312E5101F2149,42151,10,14,4,35,45,1795
36780,36780,FCC81FB1D89F2E284C3312E5101F2149,42861,15,19,4,37,44,1894
36781,36781,F265D1D687E9BD738751812FB3D34D14,43761,0,14,14,32,47,1647
36782,36782,F265D1D687E9BD738751812FB3D34D14,11381,15,17,2,30,47,1547
36783,36783,F265D1D687E9BD738751812FB3D34D14,43761,20,21,1,32,47,1647
36787,36787,387C2BFABED9CD0C7C45EBAD5F5242F9,13511,0,14,14,34,48,1748
36788,36788,387C2BFABED9CD0C7C45EBAD5F5242F9,42161,14,15,1,36,47,1847
36789,36789,387C2BFABED9CD0C7C45EBAD5F5242F9,10251,16,18,2,35,47,1797
36790,36790,00ED2280FB2BEC22D8FB36F8A7AFB1A5,42791,0,7,7,35,45,1795
36791,36791,00ED2280FB2BEC22D8FB36F8A7AFB1A5,13121,8,15,7,38,46,1946
36792,36792,00ED2280FB2BEC22D8FB36F8A7AFB1A5,10271,17,22,5,37,46,1896
36798,36798,0C3EDD26A7ED891A1146E2AB7A623C19,10151,0,8,8,34,47,1747
36799,36799,0C3EDD26A7ED891A1146E2AB7A623C19,10971,9,17,8,35,47,1797
36800,36800,0C3EDD26A7ED891A1146E2AB7A623C19,10151,19,22,3,34,47,1747
36809,36809,C854A42BD96B9AAAFCA68A46B1033403,10221,2,9,7,34,49,1749
36810,36810,C854A42BD96B9AAAFCA68A46B1033403,10251,13,15,2,35,47,1797
36811,36811,C854A42BD96B9AAAFCA68A46B1033403,10221,17,18,1,34,49,1749
36812,36812,C854A42BD96B9AAAFCA68A46B1033403,10251,19,21,2,35,47,1797
36813,36813,C70FF977FA3BD2286D57535D98EFE336,10111,1,10,9,37,47,1897
36814,36814,C70FF977FA3BD2286D57535D98EFE336,42161,10,18,8,36,47,1847
36815,36815,C70FF977FA3BD2286D57535D98EFE336,10111,18,19,1,37,47,1897
36816,36816,C70FF977FA3BD2286D57535D98EFE336,42921,21,23,2,33,47,1697
36830,36830,5E269639C787C5D2BDF7F359B5257597,13381,0,7,7,39,47,1997
36831,36831,5E269639C787C5D2BDF7F359B5257597,11481,8,15,7,41,48,2098
36832,36832,5E269639C787C5D2BDF7F359B5257597,42271,16,17,1,40,47,2047
36833,36833,5E269639C787C5D2BDF7F359B5257597,11481,18,23,5,41,48,2098
36846,36846,CC1D3C2DA42F1EBED6688749C3DA1D87,11381,0,7,7,30,47,1547
36847,36847,CC1D3C2DA42F1EBED6688749C3DA1D87,11061,9,10,1,29,48,1498
36848,36848,CC1D3C2DA42F1EBED6688749C3DA1D87,11381,13,22,9,30,47,1547
36849,36849,18496E2FF2891EA7D83B956436E60EA5,11381,0,8,8,30,47,1547
36850,36850,18496E2FF2891EA7D83B956436E60EA5,11861,11,19,8,32,47,1647
36851,36851,18496E2FF2891EA7D83B956436E60EA5,11381,21,23,2,30,47,1547
36852,36852,64C3417B19E018B97BBD82B17F26BC9C,10681,0,10,10,30,48,1548
36853,36853,64C3417B19E018B97BBD82B17F26BC9C,43391,14,15,1,29,48,1498
36854,36854,64C3417B19E018B97BBD82B17F26BC9C,10681,17,20,3,30,48,1548
36855,36855,64C3417B19E018B97BBD82B17F26BC9C,43391,21,23,2,29,48,1498
36856,36856,8CD5156CF883DA15618BAFE58DDCF2A7,42581,0,3,3,38,48,1948
36857,36857,8CD5156CF883DA15618BAFE58DDCF2A7,11914,8,12,4,37,48,1898
36858,36858,8CD5156CF883DA15618BAFE58DDCF2A7,42581,15,18,3,38,48,1948
36859,36859,70001957DCF2B9125DCB996733DDF49B,11381,0,10,10,30,47,1547
36860,36860,70001957DCF2B9125DCB996733DDF49B,11061,11,12,1,29,48,1498
36861,36861,70001957DCF2B9125DCB996733DDF49B,11381,13,23,10,30,47,1547
36862,36862,91C67E318C33CA16848BDF0388915AA7,11231,0,13,13,37,49,1899
36863,36863,91C67E318C33CA16848BDF0388915AA7,11914,15,16,1,37,48,1898
36864,36864,91C67E318C33CA16848BDF0388915AA7,40951,18,22,4,36,49,1849
36879,36879,855AF0077FBE2FE365D2D9E5D044E5A4,43761,2,6,4,32,47,1647
36880,36880,855AF0077FBE2FE365D2D9E5D044E5A4,42523,8,9,1,31,47,1597
36881,36881,855AF0077FBE2FE365D2D9E5D044E5A4,43761,10,23,13,32,47,1647
36882,36882,6E393276634E5B0B2A68B7AC0F0F48CF,10491,0,14,14,33,48,1698
36883,36883,6E393276634E5B0B2A68B7AC0F0F48CF,11861,17,18,1,32,47,1647
36884,36884,6E393276634E5B0B2A68B7AC0F0F48CF,10491,20,23,3,33,48,1698
36885,36885,9D7E28E179E5F5D009F8D277D0F434A8,11861,1,10,9,32,47,1647
36886,36886,9D7E28E179E5F5D009F8D277D0F434A8,10281,11,18,7,33,48,1698
36887,36887,9D7E28E179E5F5D009F8D277D0F434A8,11861,18,23,5,32,47,1647
36894,36894,9561ABDECCD36C7236B43D7186F9954F,11151,1,6,5,30,48,1548
36895,36895,9561ABDECCD36C7236B43D7186F9954F,11061,9,11,2,29,48,1498
36896,36896,9561ABDECCD36C7236B43D7186F9954F,10681,11,13,2,30,48,1548
36897,36897,9561ABDECCD36C7236B43D7186F9954F,11061,17,23,6,29,48,1498
36911,36911,4B5C492CF16B079882322240829D6566,11461,2,13,11,37,49,1899
36912,36912,4B5C492CF16B079882322240829D6566,42161,15,16,1,36,47,1847
36913,36913,4B5C492CF16B079882322240829D6566,11231,17,21,4,37,49,1899
36914,36914,4B5C492CF16B079882322240829D6566,43281,22,23,1,37,48,1898
36918,36918,481ACCA439BA3A892F35B61310E30397,11914,0,14,14,37,48,1898
36919,36919,481ACCA439BA3A892F35B61310E30397,10191,19,20,1,40,48,2048
36920,36920,481ACCA439BA3A892F35B61310E30397,11914,22,23,1,37,48,1898
36921,36921,85FD0824809DD36E6F4EE776DF75318A,12391,0,7,7,36,49,1849
36922,36922,85FD0824809DD36E6F4EE776DF75318A,11231,18,21,3,37,49,1899
36923,36923,85FD0824809DD36E6F4EE776DF75318A,12391,22,23,1,36,49,1849
36928,36928,3B13223DDDE569265499AF6495E8952A,11381,0,11,11,30,47,1547
36929,36929,3B13223DDDE569265499AF6495E8952A,43971,12,13,1,30,48,1548
36930,36930,3B13223DDDE569265499AF6495E8952A,11381,13,23,10,30,47,1547
36952,36952,7E0551263B729B84FDA4D97FDAFF30C7,13711,0,8,8,38,46,1946
36953,36953,7E0551263B729B84FDA4D97FDAFF30C7,42011,10,11,1,36,46,1846
36954,36954,7E0551263B729B84FDA4D97FDAFF30C7,13711,11,21,10,38,46,1946
36955,36955,DE3ACBBFFF90250B316F62451B8DF01D,10901,0,7,7,35,48,1798
36956,36956,DE3ACBBFFF90250B316F62451B8DF01D,10731,12,14,2,33,47,1697
36957,36957,DE3ACBBFFF90250B316F62451B8DF01D,10901,14,18,4,35,48,1798
36958,36958,DE3ACBBFFF90250B316F62451B8DF01D,43731,19,20,1,34,47,1747
36959,36959,0C2B805EE888E91F034AB21F925F07C4,12641,0,2,2,10,43,543
36960,36960,0C2B805EE888E91F034AB21F925F07C4,19114,6,17,11,7,43,393
36961,36961,0C2B805EE888E91F034AB21F925F07C4,19901,19,20,1,7,44,394
36962,36962,0C2B805EE888E91F034AB21F925F07C4,12641,22,23,1,10,43,543
36968,36968,74D96C0DB6CB17E6F272D22FC43A3C8B,13341,0,9,9,44,45,2245
36969,36969,74D96C0DB6CB17E6F272D22FC43A3C8B,12561,12,13,1,45,43,2293
36970,36970,74D96C0DB6CB17E6F272D22FC43A3C8B,13341,18,21,3,44,45,2245
36974,36974,4C479F308A99C28A9312A97B8F351EC7,10161,0,8,8,35,49,1799
36975,36975,4C479F308A99C28A9312A97B8F351EC7,12083,13,14,1,36,49,1849
36976,36976,4C479F308A99C28A9312A97B8F351EC7,42471,17,22,5,35,49,1799
36977,36977,B93C16A242FE2C6BDA83A87AD4FAA434,12601,0,7,7,25,47,1297
36978,36978,B93C16A242FE2C6BDA83A87AD4FAA434,10501,8,9,1,22,46,1146
36979,36979,B93C16A242FE2C6BDA83A87AD4FAA434,12601,9,19,10,25,47,1297
36987,36987,37DB10810F74CA9F9B64CFB416E0C013,19844,3,6,3,8,20,420
36988,36988,37DB10810F74CA9F9B64CFB416E0C013,15641,7,8,1,9,21,471
36989,36989,37DB10810F74CA9F9B64CFB416E0C013,19844,20,21,1,8,20,420
36995,36995,DD11EC5E596BBBC5A00C9F6952DD9EC0,10281,0,11,11,33,48,1698
36996,36996,DD11EC5E596BBBC5A00C9F6952DD9EC0,42301,13,14,1,36,47,1847
36997,36997,DD11EC5E596BBBC5A00C9F6952DD9EC0,10281,19,22,3,33,48,1698
36998,36998,0EE0313B12B9F1B71F01783385794A53,10421,10,12,2,41,48,2098
36999,36999,0EE0313B12B9F1B71F01783385794A53,40691,14,18,4,42,48,2148
37000,37000,0EE0313B12B9F1B71F01783385794A53,42341,20,21,1,43,49,2199
37001,37001,0F3B9D51ABEBD568D2353EE492F4DCAE,11914,2,6,4,37,48,1898
37002,37002,0F3B9D51ABEBD568D2353EE492F4DCAE,42581,8,18,10,38,48,1948
37003,37003,0F3B9D51ABEBD568D2353EE492F4DCAE,10471,19,23,4,37,48,1898
37004,37004,EEAD4C1A5C3C3CA3E08C3BA4BC80CCB9,12921,0,14,14,9,41,491
37005,37005,EEAD4C1A5C3C3CA3E08C3BA4BC80CCB9,12641,15,16,1,10,43,543
37006,37006,EEAD4C1A5C3C3CA3E08C3BA4BC80CCB9,49201,21,22,1,7,41,391
37013,37013,F58A6BA375AD1293B95B27D538977CC9,11161,0,15,15,32,48,1648
37014,37014,F58A6BA375AD1293B95B27D538977CC9,43761,19,20,1,32,47,1647
37015,37015,F58A6BA375AD1293B95B27D538977CC9,11161,22,23,1,32,48,1648
37016,37016,403D057EE29EE54E4ABECB6FAE56C588,10221,9,10,1,34,49,1749
37017,37017,403D057EE29EE54E4ABECB6FAE56C588,11541,20,21,1,35,49,1799
37018,37018,403D057EE29EE54E4ABECB6FAE56C588,11211,22,23,1,34,49,1749
37019,37019,9BBBC00C93BA6A3176E2B008E6F8A88E,42351,4,5,1,38,45,1945
37020,37020,9BBBC00C93BA6A3176E2B008E6F8A88E,11261,5,21,16,36,46,1846
37021,37021,9BBBC00C93BA6A3176E2B008E6F8A88E,12211,22,23,1,41,44,2094
37032,37032,B4FCDB5AEF312903DA35370D241616C0,10111,0,7,7,37,47,1897
37033,37033,B4FCDB5AEF312903DA35370D241616C0,12511,8,11,3,39,47,1997
37034,37034,B4FCDB5AEF312903DA35370D241616C0,10111,11,23,12,37,47,1897
37043,37043,3F0EDFFC6E18B4A03094543F5DAD11AE,42141,0,17,17,32,47,1647
37044,37044,3F0EDFFC6E18B4A03094543F5DAD11AE,42521,17,21,4,31,47,1597
37045,37045,3F0EDFFC6E18B4A03094543F5DAD11AE,43761,21,23,2,32,47,1647
37051,37051,7D5000772E957DD3A483CE8963A15A13,12121,0,1,1,29,47,1497
37052,37052,7D5000772E957DD3A483CE8963A15A13,42501,2,6,4,28,47,1447
37053,37053,7D5000772E957DD3A483CE8963A15A13,11381,8,11,3,30,47,1547
37054,37054,7D5000772E957DD3A483CE8963A15A13,12121,14,20,6,29,47,1497
37055,37055,449E7811DCD6E8CD500501049B5A906E,13231,3,12,9,39,46,1996
37056,37056,449E7811DCD6E8CD500501049B5A906E,11261,14,17,3,36,46,1846
37057,37057,449E7811DCD6E8CD500501049B5A906E,13231,18,21,3,39,46,1996
37058,37058,9508FAE0B774FCD97D7CFB3C4BD72215,10111,3,5,2,37,47,1897
37059,37059,9508FAE0B774FCD97D7CFB3C4BD72215,42401,6,9,3,36,47,1847
37060,37060,9508FAE0B774FCD97D7CFB3C4BD72215,10111,10,19,9,37,47,1897
37061,37061,7540A13FF92DC68E510704847404855F,10281,0,2,2,33,48,1698
37062,37062,7540A13FF92DC68E510704847404855F,42021,6,8,2,33,47,1697
37063,37063,7540A13FF92DC68E510704847404855F,11914,12,19,7,37,48,1898
37064,37064,7540A13FF92DC68E510704847404855F,40211,20,23,3,36,49,1849
37065,37065,9C017418D67328D93FD696E6655B46ED,11211,1,7,6,34,49,1749
37066,37066,9C017418D67328D93FD696E6655B46ED,12971,8,10,2,32,48,1648
37067,37067,9C017418D67328D93FD696E6655B46ED,11211,11,13,2,34,49,1749
37068,37068,9C017418D67328D93FD696E6655B46ED,11541,19,23,4,35,49,1799
37078,37078,68D66AC2F31097852E1113FCAC38B096,42531,1,4,3,31,45,1595
37079,37079,68D66AC2F31097852E1113FCAC38B096,12311,8,12,4,30,44,1544
37080,37080,68D66AC2F31097852E1113FCAC38B096,42531,13,18,5,31,45,1595
37081,37081,68D66AC2F31097852E1113FCAC38B096,12311,21,23,2,30,44,1544
37082,37082,2ED4560667A26EE0B30F7B955F8F467C,13011,0,7,7,39,47,1997
37083,37083,2ED4560667A26EE0B30F7B955F8F467C,42231,12,14,2,37,46,1896
37084,37084,2ED4560667A26EE0B30F7B955F8F467C,13011,19,23,4,39,47,1997
37085,37085,D5AEB0275C07F9A43E4282B7A52A66F5,11061,0,7,7,29,48,1498
37086,37086,D5AEB0275C07F9A43E4282B7A52A66F5,10681,17,18,1,30,48,1548
37087,37087,D5AEB0275C07F9A43E4282B7A52A66F5,11061,19,23,4,29,48,1498
37093,37093,92A823D7887A55DA669369A749783D4F,11021,6,8,2,36,49,1849
37094,37094,92A823D7887A55DA669369A749783D4F,11211,15,16,1,34,49,1749
37095,37095,92A823D7887A55DA669369A749783D4F,11021,19,23,4,36,49,1849
37099,37099,98B7965FA5B1BE6BB02AE9700D9209F3,11954,0,8,8,32,49,1649
37100,37100,98B7965FA5B1BE6BB02AE9700D9209F3,12083,8,14,6,36,49,1849
37101,37101,98B7965FA5B1BE6BB02AE9700D9209F3,11954,17,23,6,32,49,1649
37102,37102,780CF605B987CE4335E0B64DFA86ACBF,11921,0,5,5,38,48,1948
37103,37103,780CF605B987CE4335E0B64DFA86ACBF,12514,7,9,2,38,47,1947
37104,37104,780CF605B987CE4335E0B64DFA86ACBF,11921,11,12,1,38,48,1948
37105,37105,780CF605B987CE4335E0B64DFA86ACBF,11461,13,23,10,37,49,1899
37106,37106,21214DF25ABBFE57C13DD19922691751,13911,0,4,4,39,46,1996
37107,37107,21214DF25ABBFE57C13DD19922691751,42351,4,8,4,38,45,1945
37108,37108,21214DF25ABBFE57C13DD19922691751,11261,9,21,12,36,46,1846
37109,37109,21214DF25ABBFE57C13DD19922691751,13911,22,23,1,39,46,1996
37120,37120,BE9D468D7F12D5E16507D9D3A7CF66B2,43041,0,8,8,41,46,2096
37121,37121,BE9D468D7F12D5E16507D9D3A7CF66B2,13121,11,15,4,38,46,1946
37122,37122,BE9D468D7F12D5E16507D9D3A7CF66B2,43041,17,23,6,41,46,2096
37136,37136,AFAE133FA88B98A999C46702AA923186,10811,0,7,7,38,46,1946
37137,37137,AFAE133FA88B98A999C46702AA923186,10821,10,11,1,40,47,2047
37138,37138,AFAE133FA88B98A999C46702AA923186,10601,12,23,11,39,47,1997
37149,37149,FD8C757A10FC8342CB9359B3B019D044,10901,0,7,7,35,48,1798
37150,37150,FD8C757A10FC8342CB9359B3B019D044,42961,12,13,1,35,49,1799
37151,37151,FD8C757A10FC8342CB9359B3B019D044,11231,13,16,3,37,49,1899
37152,37152,FD8C757A10FC8342CB9359B3B019D044,10901,18,23,5,35,48,1798
37162,37162,6D0799AB0F55190F6E5F774F154A9036,13271,4,6,2,41,47,2097
37163,37163,6D0799AB0F55190F6E5F774F154A9036,11481,6,14,8,41,48,2098
37164,37164,6D0799AB0F55190F6E5F774F154A9036,11801,14,21,7,42,48,2148
37172,37172,CEAC6C818D7651ADBA37DD2B6097C732,42351,1,8,7,38,45,1945
37173,37173,CEAC6C818D7651ADBA37DD2B6097C732,42231,13,17,4,37,46,1896
37174,37174,CEAC6C818D7651ADBA37DD2B6097C732,13711,21,23,2,38,46,1946
37175,37175,85061C43999146706723F4E0700EE955,13911,0,4,4,39,46,1996
37176,37176,85061C43999146706723F4E0700EE955,42351,6,9,3,38,45,1945
37177,37177,85061C43999146706723F4E0700EE955,42231,13,20,7,37,46,1896
37181,37181,775CA947FF37432092AA3395F5AA137B,43161,0,10,10,35,47,1797
37182,37182,775CA947FF37432092AA3395F5AA137B,43731,11,17,6,34,47,1747
37183,37183,775CA947FF37432092AA3395F5AA137B,10971,19,22,3,35,47,1797
37189,37189,D13C02BEEACD390F018A47A644BA238F,10111,0,8,8,37,47,1897
37190,37190,D13C02BEEACD390F018A47A644BA238F,13911,11,14,3,39,46,1996
37191,37191,D13C02BEEACD390F018A47A644BA238F,42471,18,19,1,35,49,1799
37199,37199,D5C29F54FD64D9CE1AEFE2D9CA4F33A5,11806,6,8,2,41,48,2098
37200,37200,D5C29F54FD64D9CE1AEFE2D9CA4F33A5,13101,10,20,10,40,47,2047
37201,37201,D5C29F54FD64D9CE1AEFE2D9CA4F33A5,43361,22,23,1,38,48,1948
37202,37202,3D8552BEA095D06AE6FC415BCE1E5CBC,10501,0,2,2,22,46,1146
37203,37203,3D8552BEA095D06AE6FC415BCE1E5CBC,12601,5,10,5,25,47,1297
37204,37204,3D8552BEA095D06AE6FC415BCE1E5CBC,10501,10,12,2,22,46,1146
37205,37205,3D8552BEA095D06AE6FC415BCE1E5CBC,12601,13,23,10,25,47,1297
37214,37214,E68D0CB0F880ABD846C1FA07F5533B50,42141,2,8,6,32,47,1647
37215,37215,E68D0CB0F880ABD846C1FA07F5533B50,42021,9,12,3,33,47,1697
37216,37216,E68D0CB0F880ABD846C1FA07F5533B50,42141,13,23,10,32,47,1647
37224,37224,806223F4E6A75E30DD9FB8BC0E922847,11061,0,16,16,29,48,1498
37225,37225,806223F4E6A75E30DD9FB8BC0E922847,11151,17,18,1,30,48,1548
37226,37226,806223F4E6A75E30DD9FB8BC0E922847,11061,20,23,3,29,48,1498
37227,37227,BBEB20E4CE09F78FD771E8818046FF01,42583,0,5,5,40,48,2048
37228,37228,BBEB20E4CE09F78FD771E8818046FF01,42271,8,9,1,40,47,2047
37229,37229,BBEB20E4CE09F78FD771E8818046FF01,42221,9,14,5,38,48,1948
37230,37230,BBEB20E4CE09F78FD771E8818046FF01,42583,18,23,5,40,48,2048
37231,37231,CBA3EEB115425BF46575E225F464D168,13941,0,12,12,41,47,2097
37232,37232,CBA3EEB115425BF46575E225F464D168,10921,15,17,2,43,48,2198
37233,37233,CBA3EEB115425BF46575E225F464D168,13941,20,23,3,41,47,2097
37238,37238,2AB3497A87FC792BC786E44179711EBA,10841,9,11,2,37,47,1897
37239,37239,2AB3497A87FC792BC786E44179711EBA,12391,11,14,3,36,49,1849
37240,37240,2AB3497A87FC792BC786E44179711EBA,12511,18,19,1,39,47,1997
37241,37241,2AB3497A87FC792BC786E44179711EBA,11074,19,22,3,37,47,1897
37265,37265,A8CFBCA9A33C65DE4AB357D9A64460F4,12514,3,14,11,38,47,1947
37266,37266,A8CFBCA9A33C65DE4AB357D9A64460F4,10841,15,17,2,37,47,1897
37267,37267,A8CFBCA9A33C65DE4AB357D9A64460F4,12514,19,22,3,38,47,1947
37268,37268,785F4EBA3F4642EC7BD5BE5F80643D2E,43731,0,14,14,34,47,1747
37269,37269,785F4EBA3F4642EC7BD5BE5F80643D2E,42921,15,17,2,33,47,1697
37270,37270,785F4EBA3F4642EC7BD5BE5F80643D2E,13601,22,23,1,34,47,1747
37275,37275,8561EFE8142104963485E2F214FD8DF8,10271,8,10,2,37,46,1896
37276,37276,8561EFE8142104963485E2F214FD8DF8,13711,13,19,6,38,46,1946
37277,37277,8561EFE8142104963485E2F214FD8DF8,10271,22,23,1,37,46,1896
37278,37278,2295C74F0BD2BB081A3FCDFFDED68B9C,12641,0,14,14,10,43,543
37279,37279,2295C74F0BD2BB081A3FCDFFDED68B9C,12921,17,18,1,9,41,491
37280,37280,2295C74F0BD2BB081A3FCDFFDED68B9C,12641,18,19,1,10,43,543
37287,37287,F006E600171E6D181F07E02A37ECC960,11081,1,2,1,35,46,1796
37288,37288,F006E600171E6D181F07E02A37ECC960,11491,3,14,11,36,47,1847
37289,37289,F006E600171E6D181F07E02A37ECC960,10111,17,23,6,37,47,1897
37306,37306,478F01BCCD8ECC2639B5EA3CD060CD5E,11201,0,5,5,35,49,1799
37307,37307,478F01BCCD8ECC2639B5EA3CD060CD5E,10221,6,14,8,34,49,1749
37308,37308,478F01BCCD8ECC2639B5EA3CD060CD5E,10161,15,18,3,35,49,1799
37309,37309,478F01BCCD8ECC2639B5EA3CD060CD5E,13511,21,23,2,34,48,1748
37314,37314,055660D96102C90837257CF6FD6D548A,11261,4,6,2,36,46,1846
37315,37315,055660D96102C90837257CF6FD6D548A,11271,9,10,1,37,48,1898
37316,37316,055660D96102C90837257CF6FD6D548A,11261,11,18,7,36,46,1846
37336,37336,DC54D7B6B3A8755D5E8D41E92B448DB3,42981,0,2,2,36,49,1849
37337,37337,DC54D7B6B3A8755D5E8D41E92B448DB3,40637,3,7,4,36,47,1847
37338,37338,DC54D7B6B3A8755D5E8D41E92B448DB3,40421,8,13,5,37,48,1898
37339,37339,DC54D7B6B3A8755D5E8D41E92B448DB3,42981,14,23,9,36,49,1849
37347,37347,28C2D2FE4D28624F13409918B749F4EA,42231,1,9,8,37,46,1896
37348,37348,28C2D2FE4D28624F13409918B749F4EA,13711,12,16,4,38,46,1946
37349,37349,28C2D2FE4D28624F13409918B749F4EA,11941,17,18,1,37,46,1896
37355,37355,994BA369046D8B99F80604E02227FCEB,42581,0,6,6,38,48,1948
37356,37356,994BA369046D8B99F80604E02227FCEB,10471,7,11,4,37,48,1898
37357,37357,994BA369046D8B99F80604E02227FCEB,42581,12,22,10,38,48,1948
37358,37358,DE3E54BB176520C8599DB39C6B8B34A3,13411,0,6,6,49,42,2492
37359,37359,DE3E54BB176520C8599DB39C6B8B34A3,43951,7,9,2,49,41,2491
37360,37360,DE3E54BB176520C8599DB39C6B8B34A3,13411,9,19,10,49,42,2492
37361,37361,DE3E54BB176520C8599DB39C6B8B34A3,43951,19,22,3,49,41,2491
37367,37367,BD23B8F4441754E97EF9F4DBDD6CCEC2,13561,0,15,15,37,49,1899
37368,37368,BD23B8F4441754E97EF9F4DBDD6CCEC2,11201,16,17,1,35,49,1799
37369,37369,BD23B8F4441754E97EF9F4DBDD6CCEC2,13561,21,23,2,37,49,1899
37373,37373,5DAE8FB10D3FBEF5B02F98DB4BFD46E9,13711,0,8,8,38,46,1946
37374,37374,5DAE8FB10D3FBEF5B02F98DB4BFD46E9,42351,10,11,1,38,45,1945
37375,37375,5DAE8FB10D3FBEF5B02F98DB4BFD46E9,42231,13,18,5,37,46,1896
37376,37376,BC3507BB18C0A44FC993D8B041281F6D,43731,0,9,9,34,47,1747
37377,37377,BC3507BB18C0A44FC993D8B041281F6D,42161,14,15,1,36,47,1847
37378,37378,BC3507BB18C0A44FC993D8B041281F6D,10731,16,22,6,33,47,1697
37379,37379,2A91E3542FC9B1A56EDFF91DEB22828A,11161,0,14,14,32,48,1648
37380,37380,2A91E3542FC9B1A56EDFF91DEB22828A,10491,19,21,2,33,48,1698
37381,37381,2A91E3542FC9B1A56EDFF91DEB22828A,11161,21,23,2,32,48,1648
37386,37386,D454F61AD8B5A1CBE1E15CE597E2F528,13511,0,1,1,34,48,1748
37387,37387,D454F61AD8B5A1CBE1E15CE597E2F528,42301,2,6,4,36,47,1847
37388,37388,D454F61AD8B5A1CBE1E15CE597E2F528,11231,7,18,11,37,49,1899
37389,37389,D454F61AD8B5A1CBE1E15CE597E2F528,42301,21,23,2,36,47,1847
37390,37390,05B51695B375DD3A2259BF2668AD8716,42161,0,4,4,36,47,1847
37391,37391,05B51695B375DD3A2259BF2668AD8716,10111,4,6,2,37,47,1897
37392,37392,05B51695B375DD3A2259BF2668AD8716,42161,7,23,16,36,47,1847
37409,37409,2F01379144EDE9B5402C6D9A501D0E64,40833,1,3,2,41,47,2097
37410,37410,2F01379144EDE9B5402C6D9A501D0E64,42221,5,6,1,38,48,1948
37411,37411,2F01379144EDE9B5402C6D9A501D0E64,10591,21,22,1,39,48,1998
37412,37412,4E8CF0BE1A57E085938ED2B5916A9E34,11061,0,1,1,29,48,1498
37413,37413,4E8CF0BE1A57E085938ED2B5916A9E34,11381,5,10,5,30,47,1547
37414,37414,4E8CF0BE1A57E085938ED2B5916A9E34,11061,11,13,2,29,48,1498
37415,37415,4E8CF0BE1A57E085938ED2B5916A9E34,11381,15,18,3,30,47,1547
37429,37429,E428A2146487F7DA252A6BC2E421F512,11074,0,18,18,37,47,1897
37430,37430,E428A2146487F7DA252A6BC2E421F512,42221,18,19,1,38,48,1948
37431,37431,E428A2146487F7DA252A6BC2E421F512,42583,20,23,3,40,48,2048
37455,37455,56DFB01C55C65C951941BB028F5DE57E,13351,0,7,7,48,48,2448
37456,37456,56DFB01C55C65C951941BB028F5DE57E,42601,8,9,1,44,48,2248
37457,37457,56DFB01C55C65C951941BB028F5DE57E,13351,13,23,10,48,48,2448
37461,37461,B70267EAE88B62F9B87C2FB6E0BEE8BF,11701,0,7,7,43,48,2198
37462,37462,B70267EAE88B62F9B87C2FB6E0BEE8BF,43621,10,19,9,46,48,2348
37463,37463,B70267EAE88B62F9B87C2FB6E0BEE8BF,11701,21,22,1,43,48,2198
37474,37474,DBA3D71BD1FB8EBE62D011C8086410AE,12514,0,15,15,38,47,1947
37475,37475,DBA3D71BD1FB8EBE62D011C8086410AE,10591,16,18,2,39,48,1998
37476,37476,DBA3D71BD1FB8EBE62D011C8086410AE,12514,20,22,2,38,47,1947
37477,37477,039720C5318D39E34BBB18DF8027F133,11271,6,10,4,37,48,1898
37478,37478,039720C5318D39E34BBB18DF8027F133,42581,11,12,1,38,48,1948
37479,37479,039720C5318D39E34BBB18DF8027F133,11271,13,17,4,37,48,1898
37480,37480,039720C5318D39E34BBB18DF8027F133,42581,19,21,2,38,48,1948
37489,37489,E3950B228FF57BC4F70CD2EC3D90B5FF,11941,0,6,6,37,46,1896
37490,37490,E3950B228FF57BC4F70CD2EC3D90B5FF,42151,11,17,6,35,45,1795
37491,37491,E3950B228FF57BC4F70CD2EC3D90B5FF,13711,21,22,1,38,46,1946
37492,37492,F80217E3B51992ECD97DB6E1ACCD96C3,12571,0,1,1,48,39,2439
37493,37493,F80217E3B51992ECD97DB6E1ACCD96C3,43101,1,3,2,46,40,2340
37494,37494,F80217E3B51992ECD97DB6E1ACCD96C3,13491,3,5,2,48,39,2439
37495,37495,F80217E3B51992ECD97DB6E1ACCD96C3,43101,10,18,8,46,40,2340
37499,37499,B6B9FD86337BD93E048A74A5E56BF693,10111,7,14,7,37,47,1897
37500,37500,B6B9FD86337BD93E048A74A5E56BF693,11751,16,17,1,35,48,1798
37501,37501,B6B9FD86337BD93E048A74A5E56BF693,40951,17,21,4,36,49,1849
37502,37502,EE8535EFC0E3237FE1E9870ACB3D38E1,42461,0,4,4,45,47,2297
37503,37503,EE8535EFC0E3237FE1E9870ACB3D38E1,42321,7,8,1,43,47,2197
37504,37504,EE8535EFC0E3237FE1E9870ACB3D38E1,43621,8,11,3,46,48,2348
37505,37505,EE8535EFC0E3237FE1E9870ACB3D38E1,42321,16,18,2,43,47,2197
37506,37506,58FF60972C1637520443DC5766A2AB67,13411,0,5,5,49,42,2492
37507,37507,58FF60972C1637520443DC5766A2AB67,43951,6,18,12,49,41,2491
37508,37508,58FF60972C1637520443DC5766A2AB67,13411,19,23,4,49,42,2492
37509,37509,333863A2CE0A7D471D7CF76BFFDAB0D7,12641,1,12,11,10,43,543
37510,37510,333863A2CE0A7D471D7CF76BFFDAB0D7,19744,13,14,1,6,43,343
37511,37511,333863A2CE0A7D471D7CF76BFFDAB0D7,12641,14,23,9,10,43,543
37512,37512,9951832C875ED15346443116F8C6A7D1,10331,0,8,8,39,46,1996
37513,37513,9951832C875ED15346443116F8C6A7D1,41601,12,13,1,39,49,1999
37514,37514,9951832C875ED15346443116F8C6A7D1,42331,18,23,5,39,46,1996
37515,37515,A249659AA4285866F354A5650B26A07F,10111,0,6,6,37,47,1897
37516,37516,A249659AA4285866F354A5650B26A07F,42161,10,19,9,36,47,1847
37517,37517,A249659AA4285866F354A5650B26A07F,10111,20,21,1,37,47,1897
37523,37523,13A7164293FF85790DE95E7876757302,13121,0,7,7,38,46,1946
37524,37524,13A7164293FF85790DE95E7876757302,10251,9,10,1,35,47,1797
37525,37525,13A7164293FF85790DE95E7876757302,42401,15,16,1,36,47,1847
37526,37526,13A7164293FF85790DE95E7876757302,11791,17,18,1,38,49,1949
37533,37533,4F3F717E93BC5AFE00C4421DCBF0AA01,40322,0,9,9,38,46,1946
37534,37534,4F3F717E93BC5AFE00C4421DCBF0AA01,11261,9,10,1,36,46,1846
37535,37535,4F3F717E93BC5AFE00C4421DCBF0AA01,42864,14,23,9,38,44,1944
37536,37536,CDF3DC2AF9140EECB1AAD01517FCEF9A,10251,0,9,9,35,47,1797
37537,37537,CDF3DC2AF9140EECB1AAD01517FCEF9A,10161,10,13,3,35,49,1799
37538,37538,CDF3DC2AF9140EECB1AAD01517FCEF9A,40951,13,15,2,36,49,1849
37539,37539,CDF3DC2AF9140EECB1AAD01517FCEF9A,10251,17,23,6,35,47,1797
37545,37545,9C35C609BEEB7023F559DA7824DEFA84,11061,2,17,15,29,48,1498
37546,37546,9C35C609BEEB7023F559DA7824DEFA84,43971,18,21,3,30,48,1548
37547,37547,9C35C609BEEB7023F559DA7824DEFA84,11061,21,23,2,29,48,1498
37561,37561,D2D49AEA430F940B45CDC832BBBCB09C,43731,3,6,3,34,47,1747
37562,37562,D2D49AEA430F940B45CDC832BBBCB09C,13511,8,13,5,34,48,1748
37563,37563,D2D49AEA430F940B45CDC832BBBCB09C,10251,14,17,3,35,47,1797
37564,37564,D2D49AEA430F940B45CDC832BBBCB09C,43731,19,23,4,34,47,1747
37568,37568,7644AA9AA31C7A2D83A5FF57FB4FB460,10661,0,13,13,37,49,1899
37569,37569,7644AA9AA31C7A2D83A5FF57FB4FB460,11074,14,17,3,37,47,1897
37570,37570,7644AA9AA31C7A2D83A5FF57FB4FB460,10661,20,23,3,37,49,1899
37584,37584,0AAF0BF79959E9348273237BF21E836D,10331,0,6,6,39,46,1996
37585,37585,0AAF0BF79959E9348273237BF21E836D,13101,17,18,1,40,47,2047
37586,37586,0AAF0BF79959E9348273237BF21E836D,40833,18,19,1,41,47,2097
37587,37587,0AAF0BF79959E9348273237BF21E836D,13101,20,23,3,40,47,2047
37593,37593,2CB194F5C88F15739C3E83AF93DF02DF,10281,1,8,7,33,48,1698
37594,37594,2CB194F5C88F15739C3E83AF93DF02DF,41591,8,12,4,34,49,1749
37595,37595,2CB194F5C88F15739C3E83AF93DF02DF,43471,16,17,1,31,49,1599
37596,37596,2CB194F5C88F15739C3E83AF93DF02DF,10281,18,23,5,33,48,1698
37603,37603,3B0409DBAF33EAE6E983CBE096017943,11551,0,1,1,39,49,1999
37604,37604,3B0409DBAF33EAE6E983CBE096017943,11811,2,8,6,38,49,1949
37605,37605,3B0409DBAF33EAE6E983CBE096017943,11074,9,18,9,37,47,1897
37606,37606,3B0409DBAF33EAE6E983CBE096017943,11791,19,22,3,38,49,1949
37607,37607,87953BCA710762344CA74B66D40DAD39,43761,4,12,8,32,47,1647
37608,37608,87953BCA710762344CA74B66D40DAD39,42021,14,17,3,33,47,1697
37609,37609,87953BCA710762344CA74B66D40DAD39,40636,21,23,2,35,48,1798
37615,37615,A02E7FCD783D3B9FF6BA938561F51C11,42161,0,15,15,36,47,1847
37616,37616,A02E7FCD783D3B9FF6BA938561F51C11,40171,15,19,4,38,48,1948
37617,37617,A02E7FCD783D3B9FF6BA938561F51C11,10107,21,22,1,38,49,1949
37626,37626,BED343B3F226383209994F36981004E5,10661,6,13,7,37,49,1899
37627,37627,BED343B3F226383209994F36981004E5,40171,14,17,3,38,48,1948
37628,37628,BED343B3F226383209994F36981004E5,10221,18,20,2,34,49,1749
37629,37629,BED343B3F226383209994F36981004E5,40171,20,23,3,38,48,1948
37630,37630,1A64F5A3A265770889AAFFB5978121E9,11914,5,6,1,37,48,1898
37631,37631,1A64F5A3A265770889AAFFB5978121E9,40171,7,9,2,38,48,1948
37632,37632,1A64F5A3A265770889AAFFB5978121E9,11914,10,22,12,37,48,1898
37633,37633,64125BF70ADD2A9D2C91BE766AA2E78E,11261,6,7,1,36,46,1846
37634,37634,64125BF70ADD2A9D2C91BE766AA2E78E,13911,9,11,2,39,46,1996
37635,37635,64125BF70ADD2A9D2C91BE766AA2E78E,11261,14,23,9,36,46,1846
37636,37636,D64DF2C2FAB80CB42859AD7194DBB705,42221,0,6,6,38,48,1948
37637,37637,D64DF2C2FAB80CB42859AD7194DBB705,11074,9,14,5,37,47,1897
37638,37638,D64DF2C2FAB80CB42859AD7194DBB705,42221,18,23,5,38,48,1948
37644,37644,E610935782979ECFD62FB0099155ECBC,11381,0,10,10,30,47,1547
37645,37645,E610935782979ECFD62FB0099155ECBC,11061,12,16,4,29,48,1498
37646,37646,E610935782979ECFD62FB0099155ECBC,10681,16,18,2,30,48,1548
37647,37647,684CD853F55EF2E4DB41FBB3886F182A,43391,0,9,9,29,48,1498
37648,37648,684CD853F55EF2E4DB41FBB3886F182A,11151,9,11,2,30,48,1548
37649,37649,684CD853F55EF2E4DB41FBB3886F182A,40094,11,23,12,29,48,1498
37663,37663,03175FB6AFB4F200ADEA10CA8FF33747,10881,0,2,2,34,48,1748
37664,37664,03175FB6AFB4F200ADEA10CA8FF33747,10251,7,8,1,35,47,1797
37665,37665,03175FB6AFB4F200ADEA10CA8FF33747,40637,8,19,11,36,47,1847
37677,37677,7F73EEE1198B300F5190B9A740E251E3,13911,0,10,10,39,46,1996
37678,37678,7F73EEE1198B300F5190B9A740E251E3,11261,12,18,6,36,46,1846
37679,37679,7F73EEE1198B300F5190B9A740E251E3,13911,18,21,3,39,46,1996
37691,37691,AA541C733BB5F99408992FE5EC11F72D,42351,1,4,3,38,45,1945
37692,37692,AA541C733BB5F99408992FE5EC11F72D,42861,7,17,10,37,44,1894
37693,37693,AA541C733BB5F99408992FE5EC11F72D,42351,21,23,2,38,45,1945
37707,37707,BA22D206260DBB9ED185D0E77F37B601,11324,0,5,5,31,46,1596
37708,37708,BA22D206260DBB9ED185D0E77F37B601,12661,6,12,6,32,45,1645
37709,37709,BA22D206260DBB9ED185D0E77F37B601,10381,16,18,2,31,49,1599
37718,37718,C9C6BAB560EC6416E90DD7DBB63B8203,12131,0,8,8,32,47,1647
37719,37719,C9C6BAB560EC6416E90DD7DBB63B8203,13651,10,16,6,30,47,1547
37720,37720,C9C6BAB560EC6416E90DD7DBB63B8203,12131,21,23,2,32,47,1647
37721,37721,9E8454E3BE651FEBAAD2CFCFB76D7A82,42921,0,7,7,33,47,1697
37722,37722,9E8454E3BE651FEBAAD2CFCFB76D7A82,10221,8,10,2,34,49,1749
37723,37723,9E8454E3BE651FEBAAD2CFCFB76D7A82,42921,12,18,6,33,47,1697
37724,37724,9E8454E3BE651FEBAAD2CFCFB76D7A82,10381,18,21,3,31,49,1599
37725,37725,729DA0C079717E4E4A0173A20CB90D98,40171,0,9,9,38,48,1948
37726,37726,729DA0C079717E4E4A0173A20CB90D98,42801,11,13,2,40,49,2049
37727,37727,729DA0C079717E4E4A0173A20CB90D98,10471,14,23,9,37,48,1898
37728,37728,C6B20AF59FCE7811AD359D515A06A5AA,10251,0,7,7,35,47,1797
37729,37729,C6B20AF59FCE7811AD359D515A06A5AA,41271,12,15,3,38,48,1948
37730,37730,C6B20AF59FCE7811AD359D515A06A5AA,11074,19,20,1,37,47,1897
37731,37731,C6B20AF59FCE7811AD359D515A06A5AA,42161,21,23,2,36,47,1847
37737,37737,D950A9D3ACBEF7AFBBFB96859587E38D,42523,0,8,8,31,47,1597
37738,37738,D950A9D3ACBEF7AFBBFB96859587E38D,42491,8,13,5,32,46,1646
37739,37739,D950A9D3ACBEF7AFBBFB96859587E38D,10341,15,23,8,31,47,1597
37745,37745,51E8861068F901C8E015AE95E3FE760A,42231,2,6,4,37,46,1896
37746,37746,51E8861068F901C8E015AE95E3FE760A,13711,7,21,14,38,46,1946
37747,37747,51E8861068F901C8E015AE95E3FE760A,42231,22,23,1,37,46,1896
37752,37752,5ED8949BAC5CDF05EDA1019FB7CA4B17,11811,0,7,7,38,49,1949
37753,37753,5ED8949BAC5CDF05EDA1019FB7CA4B17,10471,9,16,7,37,48,1898
37754,37754,5ED8949BAC5CDF05EDA1019FB7CA4B17,42191,19,20,1,38,49,1949
37755,37755,5ED8949BAC5CDF05EDA1019FB7CA4B17,40171,21,23,2,38,48,1948
37762,37762,A5DEEBB2A80DA4A946704DB84A952200,43761,0,14,14,32,47,1647
37763,37763,A5DEEBB2A80DA4A946704DB84A952200,42523,15,16,1,31,47,1597
37764,37764,A5DEEBB2A80DA4A946704DB84A952200,43761,21,22,1,32,47,1647
37784,37784,5E27C3CEBAFB3612D0DDA8E462FC7F84,11021,7,9,2,36,49,1849
37785,37785,5E27C3CEBAFB3612D0DDA8E462FC7F84,11771,11,12,1,39,49,1999
37786,37786,5E27C3CEBAFB3612D0DDA8E462FC7F84,10107,12,14,2,38,49,1949
37787,37787,5E27C3CEBAFB3612D0DDA8E462FC7F84,11021,16,23,7,36,49,1849
37792,37792,08A52BC8363090C351FBB56D380273C7,42141,0,6,6,32,47,1647
37793,37793,08A52BC8363090C351FBB56D380273C7,10281,8,9,1,33,48,1698
37794,37794,08A52BC8363090C351FBB56D380273C7,42141,13,18,5,32,47,1647
37798,37798,E4DAC22C285EE7DCF2A6491936A72882,42204,1,8,7,43,46,2196
37799,37799,E4DAC22C285EE7DCF2A6491936A72882,42461,13,15,2,45,47,2297
37800,37800,E4DAC22C285EE7DCF2A6491936A72882,42091,19,20,1,43,46,2196
37801,37801,60F7A36E30F2A6AA75D382D47BF81CD3,42141,0,2,2,32,47,1647
37802,37802,60F7A36E30F2A6AA75D382D47BF81CD3,42161,2,12,10,36,47,1847
37803,37803,60F7A36E30F2A6AA75D382D47BF81CD3,11861,14,21,7,32,47,1647
37804,37804,60F7A36E30F2A6AA75D382D47BF81CD3,42161,22,23,1,36,47,1847
37822,37822,53493041487B5321836147FAAD536213,40833,2,9,7,41,47,2097
37823,37823,53493041487B5321836147FAAD536213,13101,13,17,4,40,47,2047
37824,37824,53493041487B5321836147FAAD536213,13941,20,21,1,41,47,2097
37849,37849,6F947024A8B73B97F8430A4C48FA1DF6,11231,0,13,13,37,49,1899
37850,37850,6F947024A8B73B97F8430A4C48FA1DF6,10107,15,18,3,38,49,1949
37851,37851,6F947024A8B73B97F8430A4C48FA1DF6,12083,21,23,2,36,49,1849
37855,37855,73AC3CBDB2A277CF5F45112FEF564EF8,13121,0,9,9,38,46,1946
37856,37856,73AC3CBDB2A277CF5F45112FEF564EF8,42511,9,11,2,37,47,1897
37857,37857,73AC3CBDB2A277CF5F45112FEF564EF8,13121,14,20,6,38,46,1946
37858,37858,A27203DC664657DF4BBDCCF4AC9D93B1,12921,0,15,15,9,41,491
37859,37859,A27203DC664657DF4BBDCCF4AC9D93B1,49201,15,16,1,7,41,391
37860,37860,A27203DC664657DF4BBDCCF4AC9D93B1,19111,19,23,4,9,45,495
37864,37864,C27CAD921E0A90627C5337FD9A33D6C8,10721,1,7,6,31,48,1598
37865,37865,C27CAD921E0A90627C5337FD9A33D6C8,11875,11,13,2,30,46,1546
37866,37866,C27CAD921E0A90627C5337FD9A33D6C8,11861,14,22,8,32,47,1647
37870,37870,3C5D029D57650D7A9CE83503042F1003,11261,1,15,14,36,46,1846
37871,37871,3C5D029D57650D7A9CE83503042F1003,42864,16,17,1,38,44,1944
37872,37872,3C5D029D57650D7A9CE83503042F1003,11261,17,18,1,36,46,1846
37876,37876,9697B9F61B38351656D148BBCAC6B04D,41392,0,8,8,43,48,2198
37877,37877,9697B9F61B38351656D148BBCAC6B04D,10924,10,14,4,43,49,2199
37878,37878,9697B9F61B38351656D148BBCAC6B04D,10421,21,22,1,41,48,2098
37896,37896,1788FF83230593384DFEF88881720D90,13551,0,6,6,45,38,2288
37897,37897,1788FF83230593384DFEF88881720D90,43101,7,8,1,46,40,2340
37898,37898,1788FF83230593384DFEF88881720D90,13551,8,23,15,45,38,2288
37902,37902,BCBB915A68F656D68AA2B85F9E93EB53,11381,0,8,8,30,47,1547
37903,37903,BCBB915A68F656D68AA2B85F9E93EB53,11831,11,22,11,32,45,1645
37904,37904,BCBB915A68F656D68AA2B85F9E93EB53,11381,22,23,1,30,47,1547
37905,37905,5674984FCE5B2DA13047CB9492AF31B3,43951,4,8,4,49,41,2491
37906,37906,5674984FCE5B2DA13047CB9492AF31B3,43101,9,11,2,46,40,2340
37907,37907,5674984FCE5B2DA13047CB9492AF31B3,43951,12,18,6,49,41,2491
37911,37911,D2A48FC60ADAD9E2BF11727867EF8CE8,11074,0,11,11,37,47,1897
37912,37912,D2A48FC60ADAD9E2BF11727867EF8CE8,12514,14,15,1,38,47,1947
37913,37913,D2A48FC60ADAD9E2BF11727867EF8CE8,11074,18,20,2,37,47,1897
37914,37914,D2A48FC60ADAD9E2BF11727867EF8CE8,10251,20,22,2,35,47,1797
37915,37915,172F302F5199600F927C0E74978E3B3A,42401,0,8,8,36,47,1847
37916,37916,172F302F5199600F927C0E74978E3B3A,10251,12,14,2,35,47,1797
37917,37917,172F302F5199600F927C0E74978E3B3A,10111,16,20,4,37,47,1897
37923,37923,9B6B73877F33AB3E9F8AF9AD1EB06F71,10111,0,3,3,37,47,1897
37924,37924,9B6B73877F33AB3E9F8AF9AD1EB06F71,42161,3,4,1,36,47,1847
37925,37925,9B6B73877F33AB3E9F8AF9AD1EB06F71,10111,6,22,16,37,47,1897
37929,37929,EBAFAC105CAD0D91101E1E07F19B8F7B,11541,0,20,20,35,49,1799
37930,37930,EBAFAC105CAD0D91101E1E07F19B8F7B,11074,20,21,1,37,47,1897
37931,37931,EBAFAC105CAD0D91101E1E07F19B8F7B,42471,21,23,2,35,49,1799
37940,37940,71B9D8B00C3B199DE9FF93BDB5C579DF,10292,7,9,2,30,47,1547
37941,37941,71B9D8B00C3B199DE9FF93BDB5C579DF,42523,11,13,2,31,47,1597
37942,37942,71B9D8B00C3B199DE9FF93BDB5C579DF,42491,13,14,1,32,46,1646
37943,37943,71B9D8B00C3B199DE9FF93BDB5C579DF,42523,17,21,4,31,47,1597
37948,37948,AAB17C6E62FC3D51BFEDF787F775594B,10295,0,14,14,30,47,1547
37949,37949,AAB17C6E62FC3D51BFEDF787F775594B,42523,14,16,2,31,47,1597
37950,37950,AAB17C6E62FC3D51BFEDF787F775594B,10295,19,20,1,30,47,1547
37951,37951,31100BE8BDE5B74B2D64B60F8888BAE5,10111,0,7,7,37,47,1897
37952,37952,31100BE8BDE5B74B2D64B60F8888BAE5,42161,10,18,8,36,47,1847
37953,37953,31100BE8BDE5B74B2D64B60F8888BAE5,10111,18,22,4,37,47,1897
37954,37954,93C87ADE4FBD02048670A9DCD4C6ECEA,11261,0,12,12,36,46,1846
37955,37955,93C87ADE4FBD02048670A9DCD4C6ECEA,42861,15,16,1,37,44,1894
37956,37956,93C87ADE4FBD02048670A9DCD4C6ECEA,11261,20,22,2,36,46,1846
37957,37957,3AEA3CF422288C2FFB9C65FD7BE694C9,19931,0,8,8,7,43,393
37958,37958,3AEA3CF422288C2FFB9C65FD7BE694C9,12921,8,11,3,9,41,491
37959,37959,3AEA3CF422288C2FFB9C65FD7BE694C9,19931,14,17,3,7,43,393
37960,37960,3AEA3CF422288C2FFB9C65FD7BE694C9,12921,20,22,2,9,41,491
37968,37968,D51C6C6BE8A8903D8184ED5A28006B69,11231,0,18,18,37,49,1899
37969,37969,D51C6C6BE8A8903D8184ED5A28006B69,11271,19,20,1,37,48,1898
37970,37970,D51C6C6BE8A8903D8184ED5A28006B69,11231,20,23,3,37,49,1899
37988,37988,6CC24D921FE70D79D98FA5B7890BCB55,19441,0,9,9,8,46,446
37989,37989,6CC24D921FE70D79D98FA5B7890BCB55,42041,9,11,2,10,47,547
37990,37990,6CC24D921FE70D79D98FA5B7890BCB55,19441,13,20,7,8,46,446
37991,37991,6E3A482A59CE9925DB19971C6ACB206A,11914,1,6,5,37,48,1898
37992,37992,6E3A482A59CE9925DB19971C6ACB206A,40171,6,9,3,38,48,1948
37993,37993,6E3A482A59CE9925DB19971C6ACB206A,10471,11,20,9,37,48,1898
38007,38007,8CAA944A76DA7309343EF407118B2A8F,10811,9,10,1,38,46,1946
38008,38008,8CAA944A76DA7309343EF407118B2A8F,11261,11,12,1,36,46,1846
38009,38009,8CAA944A76DA7309343EF407118B2A8F,13461,16,17,1,39,44,1994
38010,38010,8CAA944A76DA7309343EF407118B2A8F,11261,19,20,1,36,46,1846
38011,38011,5E2982CAA80E7C324CE0B25DE76E36B1,42511,0,10,10,37,47,1897
38012,38012,5E2982CAA80E7C324CE0B25DE76E36B1,42301,11,19,8,36,47,1847
38013,38013,5E2982CAA80E7C324CE0B25DE76E36B1,42941,21,23,2,37,47,1897
38014,38014,1C461F1E440C54F9A8141510311D9FF7,10531,0,6,6,34,46,1746
38015,38015,1C461F1E440C54F9A8141510311D9FF7,42921,7,15,8,33,47,1697
38016,38016,1C461F1E440C54F9A8141510311D9FF7,10531,18,23,5,34,46,1746
38020,38020,458D4C98BF56E065F2379A94D370F10D,10971,0,19,19,35,47,1797
38021,38021,458D4C98BF56E065F2379A94D370F10D,43581,20,21,1,33,48,1698
38022,38022,458D4C98BF56E065F2379A94D370F10D,42161,22,23,1,36,47,1847
38023,38023,3EF73C757C94E8AD07B112481B940D3A,43761,0,5,5,32,47,1647
38024,38024,3EF73C757C94E8AD07B112481B940D3A,11161,7,12,5,32,48,1648
38025,38025,3EF73C757C94E8AD07B112481B940D3A,42141,14,21,7,32,47,1647
38026,38026,74A03A755ED21436427E35EA7BBE6627,11641,0,6,6,22,49,1149
38027,38027,74A03A755ED21436427E35EA7BBE6627,42081,7,11,4,24,49,1249
38028,38028,74A03A755ED21436427E35EA7BBE6627,11641,15,23,8,22,49,1149
38029,38029,B5D372B83A800D0F8993F9701E49A955,13271,3,8,5,41,47,2097
38030,38030,B5D372B83A800D0F8993F9701E49A955,11801,11,13,2,42,48,2148
38031,38031,B5D372B83A800D0F8993F9701E49A955,13101,20,21,1,40,47,2047
38032,38032,B5D372B83A800D0F8993F9701E49A955,13271,22,23,1,41,47,2097
38036,38036,4568F4CB3839A063AA85BE5AD656F1DE,10221,2,3,1,34,49,1749
38037,38037,4568F4CB3839A063AA85BE5AD656F1DE,11351,10,11,1,36,48,1848
38038,38038,4568F4CB3839A063AA85BE5AD656F1DE,11201,13,22,9,35,49,1799
38055,38055,2F1F7798F5E8889B4080CA59D71F0274,10271,0,11,11,37,46,1896
38056,38056,2F1F7798F5E8889B4080CA59D71F0274,13711,12,15,3,38,46,1946
38057,38057,2F1F7798F5E8889B4080CA59D71F0274,10271,18,23,5,37,46,1896
38058,38058,018A1CC117B204501E34F73B68B137CB,42581,1,6,5,38,48,1948
38059,38059,018A1CC117B204501E34F73B68B137CB,11914,7,15,8,37,48,1898
38060,38060,018A1CC117B204501E34F73B68B137CB,42581,19,23,4,38,48,1948
38069,38069,205E68123C76ABCF2000DB175132D4CC,11951,0,5,5,31,49,1599
38070,38070,205E68123C76ABCF2000DB175132D4CC,11381,6,14,8,30,47,1547
38071,38071,205E68123C76ABCF2000DB175132D4CC,11951,17,23,6,31,49,1599
38072,38072,726D8BF6FE9D2B730CE8E7DD26F779CD,11381,0,16,16,30,47,1547
38073,38073,726D8BF6FE9D2B730CE8E7DD26F779CD,12121,16,17,1,29,47,1497
38074,38074,726D8BF6FE9D2B730CE8E7DD26F779CD,11131,21,23,2,33,48,1698
38075,38075,7BF529F423A6C51BF619B13381E16746,10281,0,12,12,33,48,1698
38076,38076,7BF529F423A6C51BF619B13381E16746,42141,16,18,2,32,47,1647
38077,38077,7BF529F423A6C51BF619B13381E16746,10281,20,22,2,33,48,1698
38087,38087,7E6F1057729DFB8EE8B59466F9245966,42231,0,6,6,37,46,1896
38088,38088,7E6F1057729DFB8EE8B59466F9245966,13221,9,10,1,40,47,2047
38089,38089,7E6F1057729DFB8EE8B59466F9245966,13911,13,23,10,39,46,1996
38090,38090,831704567A0B8CDF382FA5741F6A7093,11321,0,6,6,31,46,1596
38091,38091,831704567A0B8CDF382FA5741F6A7093,10301,7,8,1,31,45,1595
38092,38092,831704567A0B8CDF382FA5741F6A7093,11321,11,23,12,31,46,1596
38107,38107,BF48EEACA0D9E0A901DD439DC66936C5,13791,4,8,4,42,47,2147
38108,38108,BF48EEACA0D9E0A901DD439DC66936C5,13941,13,17,4,41,47,2097
38109,38109,BF48EEACA0D9E0A901DD439DC66936C5,11001,20,21,1,42,47,2147
38116,38116,D513C67DAA4B210E97B8B8DAD21FA84C,42271,0,10,10,40,47,2047
38117,38117,D513C67DAA4B210E97B8B8DAD21FA84C,12511,11,12,1,39,47,1997
38118,38118,D513C67DAA4B210E97B8B8DAD21FA84C,42271,12,14,2,40,47,2047
38119,38119,D513C67DAA4B210E97B8B8DAD21FA84C,13381,19,22,3,39,47,1997
38120,38120,B313DC957E2F1850A88A4D61011A548A,10251,0,17,17,35,47,1797
38121,38121,B313DC957E2F1850A88A4D61011A548A,43731,18,19,1,34,47,1747
38122,38122,B313DC957E2F1850A88A4D61011A548A,10251,20,22,2,35,47,1797
38123,38123,5E3291503FC27DAA0248AA453FC4D60A,19441,0,16,16,8,46,446
38124,38124,5E3291503FC27DAA0248AA453FC4D60A,42041,16,19,3,10,47,547
38125,38125,5E3291503FC27DAA0248AA453FC4D60A,19441,19,20,1,8,46,446
38126,38126,F292E588F5B97B789B94F3BB973BBEB5,42141,4,12,8,32,47,1647
38127,38127,F292E588F5B97B789B94F3BB973BBEB5,10731,14,15,1,33,47,1697
38128,38128,F292E588F5B97B789B94F3BB973BBEB5,10281,18,19,1,33,48,1698
38129,38129,F292E588F5B97B789B94F3BB973BBEB5,43761,20,21,1,32,47,1647
38130,38130,D9026A3CE10A3841EFEE0C49DAE389C6,19901,1,5,4,7,44,394
38131,38131,D9026A3CE10A3841EFEE0C49DAE389C6,19114,6,17,11,7,43,393
38132,38132,D9026A3CE10A3841EFEE0C49DAE389C6,19901,19,20,1,7,44,394
38133,38133,5F5C2388C16FBBCF889B7BB88B6087BC,13341,0,14,14,44,45,2245
38134,38134,5F5C2388C16FBBCF889B7BB88B6087BC,42201,14,16,2,43,46,2196
38135,38135,5F5C2388C16FBBCF889B7BB88B6087BC,13341,18,19,1,44,45,2245
38136,38136,5F5C2388C16FBBCF889B7BB88B6087BC,43051,20,23,3,46,45,2345
38142,38142,BD1CC7C7C25E3F0CEC8ED2F15DC862B7,42941,0,10,10,37,47,1897
38143,38143,BD1CC7C7C25E3F0CEC8ED2F15DC862B7,42301,12,20,8,36,47,1847
38144,38144,BD1CC7C7C25E3F0CEC8ED2F15DC862B7,10111,21,22,1,37,47,1897
38145,38145,BD1CC7C7C25E3F0CEC8ED2F15DC862B7,42301,22,23,1,36,47,1847
38151,38151,839E5B2416DDB60AF8D62A7EA6186138,42021,7,14,7,33,47,1697
38152,38152,839E5B2416DDB60AF8D62A7EA6186138,11201,17,18,1,35,49,1799
38153,38153,839E5B2416DDB60AF8D62A7EA6186138,42021,20,21,1,33,47,1697
38164,38164,7BBD15EB45C3F1BA6E572F56B02ABEDA,10841,0,8,8,37,47,1897
38165,38165,7BBD15EB45C3F1BA6E572F56B02ABEDA,12514,10,11,1,38,47,1947
38166,38166,7BBD15EB45C3F1BA6E572F56B02ABEDA,10841,11,20,9,37,47,1897
38167,38167,C7DA09D84BB6D5A3ABEAD976C8C0731E,42861,0,5,5,37,44,1894
38168,38168,C7DA09D84BB6D5A3ABEAD976C8C0731E,42351,6,8,2,38,45,1945
38169,38169,C7DA09D84BB6D5A3ABEAD976C8C0731E,42861,12,22,10,37,44,1894
38174,38174,B8DB030E6F574F75DC469AA0B11A44D5,10531,0,7,7,34,46,1746
38175,38175,B8DB030E6F574F75DC469AA0B11A44D5,10511,9,11,2,35,46,1796
38176,38176,B8DB030E6F574F75DC469AA0B11A44D5,42921,14,18,4,33,47,1697
38177,38177,B8DB030E6F574F75DC469AA0B11A44D5,10151,19,23,4,34,47,1747
38190,38190,07815E504E2AE025D7C40FE3C561B8BA,11074,0,13,13,37,47,1897
38191,38191,07815E504E2AE025D7C40FE3C561B8BA,13271,18,21,3,41,47,2097
38192,38192,07815E504E2AE025D7C40FE3C561B8BA,11074,21,23,2,37,47,1897
38198,38198,8FAD0C1D7595BBC5604BC21FB1B8075D,11001,0,5,5,42,47,2147
38199,38199,8FAD0C1D7595BBC5604BC21FB1B8075D,42204,8,9,1,43,46,2196
38200,38200,8FAD0C1D7595BBC5604BC21FB1B8075D,11001,13,15,2,42,47,2147
38201,38201,8FAD0C1D7595BBC5604BC21FB1B8075D,13941,17,18,1,41,47,2097
38202,38202,6C96EE989846ABECA961FEB7DAD4E3B3,40171,0,7,7,38,48,1948
38203,38203,6C96EE989846ABECA961FEB7DAD4E3B3,10471,8,16,8,37,48,1898
38204,38204,6C96EE989846ABECA961FEB7DAD4E3B3,43361,18,22,4,38,48,1948
38205,38205,C6869A64CA9EF97A25D7192A00726FC2,10111,0,2,2,37,47,1897
38206,38206,C6869A64CA9EF97A25D7192A00726FC2,42161,2,9,7,36,47,1847
38207,38207,C6869A64CA9EF97A25D7192A00726FC2,10781,10,18,8,35,47,1797
38208,38208,C6869A64CA9EF97A25D7192A00726FC2,42401,19,23,4,36,47,1847
38209,38209,8C29E031FB5956E038F5FE7083F4864A,42861,3,4,1,37,44,1894
38210,38210,8C29E031FB5956E038F5FE7083F4864A,11261,8,9,1,36,46,1846
38211,38211,8C29E031FB5956E038F5FE7083F4864A,42861,10,19,9,37,44,1894
38217,38217,C1677062502D8DBDAAAC7171DD4AB835,10471,0,17,17,37,48,1898
38218,38218,C1677062502D8DBDAAAC7171DD4AB835,40951,18,20,2,36,49,1849
38219,38219,C1677062502D8DBDAAAC7171DD4AB835,10471,22,23,1,37,48,1898
38230,38230,D8963F7C81A647B0DB7A8BBF70036A0B,42221,0,6,6,38,48,1948
38231,38231,D8963F7C81A647B0DB7A8BBF70036A0B,10471,8,17,9,37,48,1898
38232,38232,D8963F7C81A647B0DB7A8BBF70036A0B,12514,18,20,2,38,47,1947
38233,38233,D8963F7C81A647B0DB7A8BBF70036A0B,13221,22,23,1,40,47,2047
38252,38252,5AA79678815B989AD70B8E0F4F047CEC,11351,0,17,17,36,48,1848
38253,38253,5AA79678815B989AD70B8E0F4F047CEC,12514,18,20,2,38,47,1947
38254,38254,5AA79678815B989AD70B8E0F4F047CEC,10411,21,22,1,36,48,1848
38255,38255,2B05CC2BC211341FBD9F6EA8966B4690,11914,0,15,15,37,48,1898
38256,38256,2B05CC2BC211341FBD9F6EA8966B4690,42581,16,17,1,38,48,1948
38257,38257,2B05CC2BC211341FBD9F6EA8966B4690,11914,19,21,2,37,48,1898
38258,38258,55533B9612A041F560AB09E0A0C2A735,10251,0,7,7,35,47,1797
38259,38259,55533B9612A041F560AB09E0A0C2A735,43731,8,17,9,34,47,1747
38260,38260,55533B9612A041F560AB09E0A0C2A735,12021,20,21,1,37,49,1899
38261,38261,55533B9612A041F560AB09E0A0C2A735,10251,21,23,2,35,47,1797
38269,38269,6817DB094271302744F441100FAF5A74,10931,0,13,13,41,48,2098
38270,38270,6817DB094271302744F441100FAF5A74,42271,16,17,1,40,47,2047
38271,38271,6817DB094271302744F441100FAF5A74,10931,21,23,2,41,48,2098
38283,38283,98FCD0E7592CE3BE44D1E20097E37B5B,10111,7,9,2,37,47,1897
38284,38284,98FCD0E7592CE3BE44D1E20097E37B5B,11331,13,14,1,37,48,1898
38285,38285,98FCD0E7592CE3BE44D1E20097E37B5B,10111,17,19,2,37,47,1897
38289,38289,BF19E34EF22C25E20CB766DD1F94922D,43751,0,5,5,19,48,998
38290,38290,BF19E34EF22C25E20CB766DD1F94922D,11361,6,8,2,22,48,1148
38291,38291,BF19E34EF22C25E20CB766DD1F94922D,43751,12,23,11,19,48,998
38292,38292,FCC89D0F72B0B6BEC68E599778108B84,10111,0,10,10,37,47,1897
38293,38293,FCC89D0F72B0B6BEC68E599778108B84,41612,10,12,2,36,47,1847
38294,38294,FCC89D0F72B0B6BEC68E599778108B84,11331,13,15,2,37,48,1898
38295,38295,FCC89D0F72B0B6BEC68E599778108B84,10111,15,23,8,37,47,1897
38296,38296,F36A73BDDFA53560DF71BCDBD0DE662F,42861,0,1,1,37,44,1894
38297,38297,F36A73BDDFA53560DF71BCDBD0DE662F,42864,3,5,2,38,44,1944
38298,38298,F36A73BDDFA53560DF71BCDBD0DE662F,11261,9,18,9,36,46,1846
38299,38299,03FE0D0BD52A528C1B4DF1F3C44F085B,43241,1,5,4,36,46,1846
38300,38300,03FE0D0BD52A528C1B4DF1F3C44F085B,11941,7,16,9,37,46,1896
38301,38301,03FE0D0BD52A528C1B4DF1F3C44F085B,42351,17,19,2,38,45,1945
38320,38320,642E530AC0B9954883C291456EA07C44,10731,0,6,6,33,47,1697
38321,38321,642E530AC0B9954883C291456EA07C44,11074,7,15,8,37,47,1897
38322,38322,642E530AC0B9954883C291456EA07C44,42021,16,17,1,33,47,1697
38323,38323,642E530AC0B9954883C291456EA07C44,43761,18,20,2,32,47,1647
38328,38328,79180DDD86B22B2BAEB51E3552560D4E,10951,0,11,11,29,48,1498
38329,38329,79180DDD86B22B2BAEB51E3552560D4E,11381,11,19,8,30,47,1547
38330,38330,79180DDD86B22B2BAEB51E3552560D4E,10341,19,21,2,31,47,1597
38331,38331,74AB6CFD67956B56632339242F1AAEEC,10251,7,12,5,35,47,1797
38332,38332,74AB6CFD67956B56632339242F1AAEEC,42161,12,20,8,36,47,1847
38333,38333,74AB6CFD67956B56632339242F1AAEEC,11201,21,23,2,35,49,1799
38334,38334,746F9DB3F3845FA01FE3E393E29078E3,12841,0,11,11,37,47,1897
38335,38335,746F9DB3F3845FA01FE3E393E29078E3,43281,14,18,4,37,48,1898
38336,38336,746F9DB3F3845FA01FE3E393E29078E3,12841,20,22,2,37,47,1897
38346,38346,7F9E0E2D3C51C3F37CA292E0621BEE3D,13271,0,12,12,41,47,2097
38347,38347,7F9E0E2D3C51C3F37CA292E0621BEE3D,13101,15,17,2,40,47,2047
38348,38348,7F9E0E2D3C51C3F37CA292E0621BEE3D,40833,21,22,1,41,47,2097
38362,38362,B25C1AE1FA9C41BCED04F20481B5B4EC,43731,0,3,3,34,47,1747
38363,38363,B25C1AE1FA9C41BCED04F20481B5B4EC,40637,4,6,2,36,47,1847
38364,38364,B25C1AE1FA9C41BCED04F20481B5B4EC,43731,6,22,16,34,47,1747
38369,38369,9F07E2341EC43516CD02BDC269F3E6AA,11381,0,12,12,30,47,1547
38370,38370,9F07E2341EC43516CD02BDC269F3E6AA,11061,14,15,1,29,48,1498
38371,38371,9F07E2341EC43516CD02BDC269F3E6AA,11381,18,23,5,30,47,1547
38372,38372,27B6DDFE3A356062F221ABD7AD70BB14,11061,0,9,9,29,48,1498
38373,38373,27B6DDFE3A356062F221ABD7AD70BB14,10681,9,13,4,30,48,1548
38374,38374,27B6DDFE3A356062F221ABD7AD70BB14,11061,14,23,9,29,48,1498
38375,38375,795B19542A85BBCF6E0BEEABCE2E1262,11151,0,14,14,30,48,1548
38376,38376,795B19542A85BBCF6E0BEEABCE2E1262,10951,14,15,1,29,48,1498
38377,38377,795B19542A85BBCF6E0BEEABCE2E1262,11151,18,19,1,30,48,1548
38378,38378,D536873DC06AAF00AD4313A5D945DD7D,11231,0,18,18,37,49,1899
38379,38379,D536873DC06AAF00AD4313A5D945DD7D,10221,18,20,2,34,49,1749
38380,38380,D536873DC06AAF00AD4313A5D945DD7D,11231,20,23,3,37,49,1899
38381,38381,E83888D24F9B489390D1BDDD69FB71BE,42861,0,6,6,37,44,1894
38382,38382,E83888D24F9B489390D1BDDD69FB71BE,11261,8,9,1,36,46,1846
38383,38383,E83888D24F9B489390D1BDDD69FB71BE,42861,11,23,12,37,44,1894
38384,38384,8FABCF9CE3A0C1922B4386B62EDC8AD0,42871,0,6,6,30,45,1545
38385,38385,8FABCF9CE3A0C1922B4386B62EDC8AD0,10301,8,18,10,31,45,1595
38386,38386,8FABCF9CE3A0C1922B4386B62EDC8AD0,42871,21,23,2,30,45,1545
38387,38387,6BC25D943F92E8D81D0DD10A27C42A3A,11061,0,4,4,29,48,1498
38388,38388,6BC25D943F92E8D81D0DD10A27C42A3A,11381,7,15,8,30,47,1547
38389,38389,6BC25D943F92E8D81D0DD10A27C42A3A,11061,19,21,2,29,48,1498
38408,38408,54AF0735D887B9C0B8CEE7B0E8BAEF2D,19441,6,14,8,8,46,446
38409,38409,54AF0735D887B9C0B8CEE7B0E8BAEF2D,42041,14,15,1,10,47,547
38410,38410,54AF0735D887B9C0B8CEE7B0E8BAEF2D,19441,16,22,6,8,46,446
38411,38411,B2542631715105DE17F7E7EFAA92BF3C,10351,0,9,9,28,45,1445
38412,38412,B2542631715105DE17F7E7EFAA92BF3C,10634,9,10,1,27,45,1395
38413,38413,B2542631715105DE17F7E7EFAA92BF3C,10351,12,17,5,28,45,1445
38414,38414,B2542631715105DE17F7E7EFAA92BF3C,10634,20,23,3,27,45,1395
38415,38415,4F717808305424D6529B2687FA7E5A49,11951,0,9,9,31,49,1599
38416,38416,4F717808305424D6529B2687FA7E5A49,10401,12,14,2,33,49,1699
38417,38417,4F717808305424D6529B2687FA7E5A49,11951,18,21,3,31,49,1599
38418,38418,8B7D63C5EBF2F6E2C97BF1B06BF39487,10301,0,4,4,31,45,1595
38419,38419,8B7D63C5EBF2F6E2C97BF1B06BF39487,12311,4,9,5,30,44,1544
38420,38420,8B7D63C5EBF2F6E2C97BF1B06BF39487,10301,14,17,3,31,45,1595
38421,38421,8B7D63C5EBF2F6E2C97BF1B06BF39487,12311,20,22,2,30,44,1544
38422,38422,63407EB936631E067EBCB2C7C7D38F7B,13601,0,5,5,34,47,1747
38423,38423,63407EB936631E067EBCB2C7C7D38F7B,10731,9,10,1,33,47,1697
38424,38424,63407EB936631E067EBCB2C7C7D38F7B,13601,12,19,7,34,47,1747
38425,38425,63407EB936631E067EBCB2C7C7D38F7B,42921,21,23,2,33,47,1697
38426,38426,4AA12003EDB44E9D0A999ADC8DA5AE5C,42031,0,3,3,40,46,2046
38427,38427,4AA12003EDB44E9D0A999ADC8DA5AE5C,13111,3,5,2,42,46,2146
38428,38428,4AA12003EDB44E9D0A999ADC8DA5AE5C,13791,6,23,17,42,47,2147
38429,38429,3C4F290E088B2251F5A11549B4DEDAFC,12514,0,13,13,38,47,1947
38430,38430,3C4F290E088B2251F5A11549B4DEDAFC,42511,13,15,2,37,47,1897
38431,38431,3C4F290E088B2251F5A11549B4DEDAFC,40123,15,22,7,38,47,1947
38432,38432,36E4D456967ADF7C503C23EAE8460AAD,13651,2,7,5,30,47,1547
38433,38433,36E4D456967ADF7C503C23EAE8460AAD,42523,11,14,3,31,47,1597
38434,38434,36E4D456967ADF7C503C23EAE8460AAD,13651,15,18,3,30,47,1547
38435,38435,36E4D456967ADF7C503C23EAE8460AAD,42523,19,23,4,31,47,1597
38436,38436,9560F920B61391F4089AC027AFFE877B,40505,0,2,2,36,48,1848
38437,38437,9560F920B61391F4089AC027AFFE877B,40951,2,7,5,36,49,1849
38438,38438,9560F920B61391F4089AC027AFFE877B,10221,9,18,9,34,49,1749
38439,38439,B3E65E9B8C8CAC02E61922EDB0A62E7D,42511,1,2,1,37,47,1897
38440,38440,B3E65E9B8C8CAC02E61922EDB0A62E7D,41021,4,12,8,38,47,1947
38441,38441,B3E65E9B8C8CAC02E61922EDB0A62E7D,10841,16,20,4,37,47,1897
38456,38456,F18C7871BFB82CA1A349E44A5DE6D0B7,11021,0,19,19,36,49,1849
38457,38457,F18C7871BFB82CA1A349E44A5DE6D0B7,10221,19,21,2,34,49,1749
38458,38458,F18C7871BFB82CA1A349E44A5DE6D0B7,11021,21,23,2,36,49,1849
38478,38478,BEF31F045A546CF30A63CFBCD60FD3FA,42351,1,11,10,38,45,1945
38479,38479,BEF31F045A546CF30A63CFBCD60FD3FA,42231,13,20,7,37,46,1896
38480,38480,BEF31F045A546CF30A63CFBCD60FD3FA,13911,20,23,3,39,46,1996
38481,38481,B7FB64E6C8C6E314875448108E0FD031,13561,0,8,8,37,49,1899
38482,38482,B7FB64E6C8C6E314875448108E0FD031,11781,13,14,1,38,49,1949
38483,38483,B7FB64E6C8C6E314875448108E0FD031,13561,18,23,5,37,49,1899
38488,38488,E99517AC3D59974611C317AE256FC926,10471,0,18,18,37,48,1898
38489,38489,E99517AC3D59974611C317AE256FC926,11074,19,20,1,37,47,1897
38490,38490,E99517AC3D59974611C317AE256FC926,40171,20,23,3,38,48,1948
38514,38514,D2729AB4C70132F423F41A3669BBCC53,42521,0,3,3,31,47,1597
38515,38515,D2729AB4C70132F423F41A3669BBCC53,43761,3,7,4,32,47,1647
38516,38516,D2729AB4C70132F423F41A3669BBCC53,42521,7,8,1,31,47,1597
38517,38517,D2729AB4C70132F423F41A3669BBCC53,43761,8,23,15,32,47,1647
38518,38518,9027D7BCCA8B9488D727103093A0EE77,13341,0,1,1,44,45,2245
38519,38519,9027D7BCCA8B9488D727103093A0EE77,12561,5,20,15,45,43,2293
38520,38520,9027D7BCCA8B9488D727103093A0EE77,13341,21,23,2,44,45,2245
38539,38539,D0819644627AC00B1760F57708B6F7FF,41393,0,15,15,43,49,2199
38540,38540,D0819644627AC00B1760F57708B6F7FF,43621,15,16,1,46,48,2348
38541,38541,D0819644627AC00B1760F57708B6F7FF,41393,18,19,1,43,49,2199
38555,38555,94C244793C9D289B150510A6E7ED4D21,10901,2,11,9,35,48,1798
38556,38556,94C244793C9D289B150510A6E7ED4D21,10281,12,13,1,33,48,1698
38557,38557,94C244793C9D289B150510A6E7ED4D21,10901,14,18,4,35,48,1798
38558,38558,94C244793C9D289B150510A6E7ED4D21,43731,18,20,2,34,47,1747
38559,38559,4F985171E935EB3DC7536EAA1C4743E5,42623,3,16,13,22,49,1149
38560,38560,4F985171E935EB3DC7536EAA1C4743E5,42081,19,20,1,24,49,1249
38561,38561,4F985171E935EB3DC7536EAA1C4743E5,42623,22,23,1,22,49,1149
38573,38573,B3B147972ECD6C8A2C0FDDE3D7D5F774,13941,0,5,5,41,47,2097
38574,38574,B3B147972ECD6C8A2C0FDDE3D7D5F774,42311,6,7,1,41,46,2096
38575,38575,B3B147972ECD6C8A2C0FDDE3D7D5F774,13371,8,20,12,41,47,2097
38581,38581,686D4F0D299962ED76BF11C36F11CE9B,13681,0,9,9,38,47,1947
38582,38582,686D4F0D299962ED76BF11C36F11CE9B,42511,10,11,1,37,47,1897
38583,38583,686D4F0D299962ED76BF11C36F11CE9B,13331,11,17,6,38,47,1947
38584,38584,686D4F0D299962ED76BF11C36F11CE9B,42511,19,21,2,37,47,1897
38611,38611,EE6B8585E25BB845D2DA0A95F88FAB79,13911,6,8,2,39,46,1996
38612,38612,EE6B8585E25BB845D2DA0A95F88FAB79,42231,8,11,3,37,46,1896
38613,38613,EE6B8585E25BB845D2DA0A95F88FAB79,13911,14,16,2,39,46,1996
38614,38614,EE6B8585E25BB845D2DA0A95F88FAB79,11261,20,22,2,36,46,1846
38622,38622,5B005239AD91B224060A740123F8C94E,13231,1,9,8,39,46,1996
38623,38623,5B005239AD91B224060A740123F8C94E,42231,13,15,2,37,46,1896
38624,38624,5B005239AD91B224060A740123F8C94E,13911,15,23,8,39,46,1996
38625,38625,5C8F2529D7987CD38C69D86858134456,11231,1,7,6,37,49,1899
38626,38626,5C8F2529D7987CD38C69D86858134456,10121,8,12,4,36,49,1849
38627,38627,5C8F2529D7987CD38C69D86858134456,11751,15,18,3,35,48,1798
38628,38628,5C8F2529D7987CD38C69D86858134456,40951,19,22,3,36,49,1849
38629,38629,A6B86C51D1E851C8306B13F3333CE4AD,11081,0,7,7,35,46,1796
38630,38630,A6B86C51D1E851C8306B13F3333CE4AD,11491,12,13,1,36,47,1847
38631,38631,A6B86C51D1E851C8306B13F3333CE4AD,42511,14,16,2,37,47,1897
38632,38632,A6B86C51D1E851C8306B13F3333CE4AD,42301,16,22,6,36,47,1847
38633,38633,52DE1B5B29EB088C4F7CC0D4865B38F5,42151,0,2,2,35,45,1795
38634,38634,52DE1B5B29EB088C4F7CC0D4865B38F5,42861,4,8,4,37,44,1894
38635,38635,52DE1B5B29EB088C4F7CC0D4865B38F5,42151,9,10,1,35,45,1795
38636,38636,52DE1B5B29EB088C4F7CC0D4865B38F5,42861,13,19,6,37,44,1894
38642,38642,DA61182B1E585FBAFEE35AEAB2142F2D,11921,0,7,7,38,48,1948
38643,38643,DA61182B1E585FBAFEE35AEAB2142F2D,10901,9,11,2,35,48,1798
38644,38644,DA61182B1E585FBAFEE35AEAB2142F2D,40951,13,16,3,36,49,1849
38645,38645,DA61182B1E585FBAFEE35AEAB2142F2D,11331,18,23,5,37,48,1898
38654,38654,09D97CEA5CE47DD362C1A4DC7FD7A624,10251,0,17,17,35,47,1797
38655,38655,09D97CEA5CE47DD362C1A4DC7FD7A624,11201,18,19,1,35,49,1799
38656,38656,09D97CEA5CE47DD362C1A4DC7FD7A624,42401,20,23,3,36,47,1847
38661,38661,372DB2131E7B5E627299B2A0E089CE7F,11231,0,7,7,37,49,1899
38662,38662,372DB2131E7B5E627299B2A0E089CE7F,10191,8,9,1,40,48,2048
38663,38663,372DB2131E7B5E627299B2A0E089CE7F,12083,11,16,5,36,49,1849
38664,38664,372DB2131E7B5E627299B2A0E089CE7F,11231,17,19,2,37,49,1899
38665,38665,10C025DE83AEC63388DB13DE6128ADC8,11381,0,5,5,30,47,1547
38666,38666,10C025DE83AEC63388DB13DE6128ADC8,10951,5,7,2,29,48,1498
38667,38667,10C025DE83AEC63388DB13DE6128ADC8,11381,7,19,12,30,47,1547
38668,38668,10C025DE83AEC63388DB13DE6128ADC8,12121,19,20,1,29,47,1497
38672,38672,58F88D24C8D34253C1CFFF1E39E8BF81,10681,0,13,13,30,48,1548
38673,38673,58F88D24C8D34253C1CFFF1E39E8BF81,11061,16,18,2,29,48,1498
38674,38674,58F88D24C8D34253C1CFFF1E39E8BF81,10681,18,19,1,30,48,1548
38678,38678,66F421352C22D8571066F0AF8EA7BD0D,10491,2,6,4,33,48,1698
38679,38679,66F421352C22D8571066F0AF8EA7BD0D,10251,6,8,2,35,47,1797
38680,38680,66F421352C22D8571066F0AF8EA7BD0D,11861,12,17,5,32,47,1647
38681,38681,66F421352C22D8571066F0AF8EA7BD0D,10251,21,23,2,35,47,1797
38687,38687,182A42BB7961D14AD940FD065D4EDF33,13121,3,4,1,38,46,1946
38688,38688,182A42BB7961D14AD940FD065D4EDF33,42011,9,11,2,36,46,1846
38689,38689,182A42BB7961D14AD940FD065D4EDF33,11941,16,19,3,37,46,1896
38690,38690,60E47AB33736AC41E2674A67294A03D4,12491,6,17,11,36,43,1843
38691,38691,60E47AB33736AC41E2674A67294A03D4,11261,17,19,2,36,46,1846
38692,38692,60E47AB33736AC41E2674A67294A03D4,12491,20,21,1,36,43,1843
38696,38696,EAAB672210C677BA2879CCE67BDB7DF5,11151,0,5,5,30,48,1548
38697,38697,EAAB672210C677BA2879CCE67BDB7DF5,42831,6,8,2,27,48,1398
38698,38698,EAAB672210C677BA2879CCE67BDB7DF5,11151,11,19,8,30,48,1548
38699,38699,EAAB672210C677BA2879CCE67BDB7DF5,11061,20,22,2,29,48,1498
38700,38700,9159AFAA11D55EDF8EDEF2351CBE2983,11331,2,7,5,37,48,1898
38701,38701,9159AFAA11D55EDF8EDEF2351CBE2983,42221,8,15,7,38,48,1948
38702,38702,9159AFAA11D55EDF8EDEF2351CBE2983,11331,15,20,5,37,48,1898
38707,38707,F587555054424F7ED0D63829AAEB0C06,42271,0,2,2,40,47,2047
38708,38708,F587555054424F7ED0D63829AAEB0C06,11806,2,6,4,41,48,2098
38709,38709,F587555054424F7ED0D63829AAEB0C06,42271,9,23,14,40,47,2047
38722,38722,F36A9C530F88290C9D611D428C0B8F3A,11021,1,8,7,36,49,1849
38723,38723,F36A9C530F88290C9D611D428C0B8F3A,11531,10,11,1,34,49,1749
38724,38724,F36A9C530F88290C9D611D428C0B8F3A,11021,12,20,8,36,49,1849
38725,38725,F36A9C530F88290C9D611D428C0B8F3A,11531,20,23,3,34,49,1749
38730,38730,FF6FF9B0197A91C0352AF48B73895F85,42201,0,6,6,43,46,2196
38731,38731,FF6FF9B0197A91C0352AF48B73895F85,13341,6,9,3,44,45,2245
38732,38732,FF6FF9B0197A91C0352AF48B73895F85,42201,14,21,7,43,46,2196
38740,38740,DE7BE47E05724D2B7B84051451E0119E,42161,0,1,1,36,47,1847
38741,38741,DE7BE47E05724D2B7B84051451E0119E,12491,2,8,6,36,43,1843
38742,38742,DE7BE47E05724D2B7B84051451E0119E,10111,11,16,5,37,47,1897
38743,38743,DE7BE47E05724D2B7B84051451E0119E,42161,17,23,6,36,47,1847
38747,38747,2A299573B8ADE5EDDBBA5F82D87A0B34,13601,0,6,6,34,47,1747
38748,38748,2A299573B8ADE5EDDBBA5F82D87A0B34,10731,7,8,1,33,47,1697
38749,38749,2A299573B8ADE5EDDBBA5F82D87A0B34,13601,8,17,9,34,47,1747
38750,38750,2A299573B8ADE5EDDBBA5F82D87A0B34,42921,21,23,2,33,47,1697
38751,38751,0A06E26D4B63B311703019BBFB7FEF42,10471,0,10,10,37,48,1898
38752,38752,0A06E26D4B63B311703019BBFB7FEF42,11021,14,16,2,36,49,1849
38753,38753,0A06E26D4B63B311703019BBFB7FEF42,42471,17,19,2,35,49,1799
38754,38754,0A06E26D4B63B311703019BBFB7FEF42,10471,19,22,3,37,48,1898
38755,38755,08B6161A63F0BFCCF67BFC0EA5B81E44,42621,0,13,13,24,49,1249
38756,38756,08B6161A63F0BFCCF67BFC0EA5B81E44,40341,14,18,4,23,49,1199
38757,38757,08B6161A63F0BFCCF67BFC0EA5B81E44,42621,18,23,5,24,49,1249
38766,38766,C89DD497B3E25F408D5F4E0FF457EA4C,42581,0,5,5,38,48,1948
38767,38767,C89DD497B3E25F408D5F4E0FF457EA4C,11914,9,15,6,37,48,1898
38768,38768,C89DD497B3E25F408D5F4E0FF457EA4C,40171,19,23,4,38,48,1948
38769,38769,4C13C3D7416FEE47C7E01DACD89CC954,10301,0,13,13,31,45,1595
38770,38770,4C13C3D7416FEE47C7E01DACD89CC954,12311,15,16,1,30,44,1544
38771,38771,4C13C3D7416FEE47C7E01DACD89CC954,10301,17,23,6,31,45,1595
38772,38772,84C586CC13BD616C5E12E566947D52BB,11351,0,17,17,36,48,1848
38773,38773,84C586CC13BD616C5E12E566947D52BB,11461,17,18,1,37,49,1899
38774,38774,84C586CC13BD616C5E12E566947D52BB,11351,20,23,3,36,48,1848
38788,38788,7A880FE847C48EF3051E04A866E8ED9A,11031,5,9,4,42,49,2149
38789,38789,7A880FE847C48EF3051E04A866E8ED9A,11551,11,15,4,39,49,1999
38790,38790,7A880FE847C48EF3051E04A866E8ED9A,13221,16,19,3,40,47,2047
38791,38791,7A880FE847C48EF3051E04A866E8ED9A,11551,22,23,1,39,49,1999
38811,38811,5ABFABF55A302AC65CDD1BFE0186727A,11921,0,8,8,38,48,1948
38812,38812,5ABFABF55A302AC65CDD1BFE0186727A,10971,12,20,8,35,47,1797
38813,38813,5ABFABF55A302AC65CDD1BFE0186727A,11921,22,23,1,38,48,1948
38817,38817,C2DA48245CD941C09EA1CD154E210FD0,42301,0,3,3,36,47,1847
38818,38818,C2DA48245CD941C09EA1CD154E210FD0,42941,4,7,3,37,47,1897
38819,38819,C2DA48245CD941C09EA1CD154E210FD0,11021,8,10,2,36,49,1849
38820,38820,C2DA48245CD941C09EA1CD154E210FD0,42161,17,22,5,36,47,1847
38821,38821,1030D8F4FE8CF10A7F5B83AE8CE6624F,42401,3,5,2,36,47,1847
38822,38822,1030D8F4FE8CF10A7F5B83AE8CE6624F,10111,6,7,1,37,47,1897
38823,38823,1030D8F4FE8CF10A7F5B83AE8CE6624F,10251,8,13,5,35,47,1797
38824,38824,1030D8F4FE8CF10A7F5B83AE8CE6624F,42401,14,20,6,36,47,1847
38825,38825,1277ACA424D6A91D4C363B632562549C,12601,0,7,7,25,47,1297
38826,38826,1277ACA424D6A91D4C363B632562549C,10501,10,13,3,22,46,1146
38827,38827,1277ACA424D6A91D4C363B632562549C,12601,13,23,10,25,47,1297
38831,38831,1C60CB0F57E29CF26D99169B6CE00B11,13741,0,8,8,37,49,1899
38832,38832,1C60CB0F57E29CF26D99169B6CE00B11,42161,9,18,9,36,47,1847
38833,38833,1C60CB0F57E29CF26D99169B6CE00B11,40171,21,22,1,38,48,1948
38842,38842,64FF3E93355E6DCA29977E04D316EABA,10221,0,1,1,34,49,1749
38843,38843,64FF3E93355E6DCA29977E04D316EABA,11541,3,4,1,35,49,1799
38844,38844,64FF3E93355E6DCA29977E04D316EABA,12083,8,18,10,36,49,1849
38845,38845,64FF3E93355E6DCA29977E04D316EABA,11541,19,23,4,35,49,1799
38851,38851,DFB4B644CD023A40D3C6FA10558095F5,10924,0,2,2,43,49,2199
38852,38852,DFB4B644CD023A40D3C6FA10558095F5,11291,8,16,8,40,49,2049
38853,38853,DFB4B644CD023A40D3C6FA10558095F5,11741,20,23,3,42,49,2149
38860,38860,EAEFCB977DEDF23C1346736B36A6F67B,13911,5,8,3,39,46,1996
38861,38861,EAEFCB977DEDF23C1346736B36A6F67B,42231,10,13,3,37,46,1896
38862,38862,EAEFCB977DEDF23C1346736B36A6F67B,13911,14,19,5,39,46,1996
38867,38867,0A501EA010779C8F9EB8C2F8834C3F4F,10351,1,15,14,28,45,1445
38868,38868,0A501EA010779C8F9EB8C2F8834C3F4F,10301,16,19,3,31,45,1595
38869,38869,0A501EA010779C8F9EB8C2F8834C3F4F,10351,19,23,4,28,45,1445
38874,38874,5102B42C348B7F58F60DC6DAF5653AF2,11914,5,18,13,37,48,1898
38875,38875,5102B42C348B7F58F60DC6DAF5653AF2,42581,19,20,1,38,48,1948
38876,38876,5102B42C348B7F58F60DC6DAF5653AF2,11914,21,22,1,37,48,1898
38877,38877,4676B3185E4FA5F0DE76C1CDFE074B51,10471,0,11,11,37,48,1898
38878,38878,4676B3185E4FA5F0DE76C1CDFE074B51,11794,12,13,1,38,49,1949
38879,38879,4676B3185E4FA5F0DE76C1CDFE074B51,10471,14,23,9,37,48,1898
38883,38883,0F71932005DEDDB2CACBDF450463440D,42301,2,6,4,36,47,1847
38884,38884,0F71932005DEDDB2CACBDF450463440D,11861,7,12,5,32,47,1647
38885,38885,0F71932005DEDDB2CACBDF450463440D,42301,14,23,9,36,47,1847
38890,38890,DDE9AB91E1B48A77F6C40905465CC885,43321,0,1,1,36,49,1849
38891,38891,DDE9AB91E1B48A77F6C40905465CC885,11531,1,2,1,34,49,1749
38892,38892,DDE9AB91E1B48A77F6C40905465CC885,43321,2,8,6,36,49,1849
38893,38893,DDE9AB91E1B48A77F6C40905465CC885,11351,21,22,1,36,48,1848
38894,38894,AA911EDB017489DAB51923BC75BA2F37,43761,1,14,13,32,47,1647
38895,38895,AA911EDB017489DAB51923BC75BA2F37,11061,14,16,2,29,48,1498
38896,38896,AA911EDB017489DAB51923BC75BA2F37,42523,20,22,2,31,47,1597
38902,38902,4271CE1B3D306894C2ADBB07DA7FE0B3,19901,0,1,1,7,44,394
38903,38903,4271CE1B3D306894C2ADBB07DA7FE0B3,12641,3,7,4,10,43,543
38904,38904,4271CE1B3D306894C2ADBB07DA7FE0B3,19114,10,14,4,7,43,393
38905,38905,4271CE1B3D306894C2ADBB07DA7FE0B3,19111,16,19,3,9,45,495
38910,38910,C21989F99D3B120EE23386DE2361CA67,42231,0,8,8,37,46,1896
38911,38911,C21989F99D3B120EE23386DE2361CA67,10841,10,21,11,37,47,1897
38912,38912,C21989F99D3B120EE23386DE2361CA67,42231,21,22,1,37,46,1896
38913,38913,BAE9E6598B6B150C35C40B2B48021E32,10111,0,14,14,37,47,1897
38914,38914,BAE9E6598B6B150C35C40B2B48021E32,10121,15,16,1,36,49,1849
38915,38915,BAE9E6598B6B150C35C40B2B48021E32,10111,17,23,6,37,47,1897
38916,38916,27EAC3E469830DC4BD5F7D0BCC935E63,11074,0,3,3,37,47,1897
38917,38917,27EAC3E469830DC4BD5F7D0BCC935E63,42221,4,7,3,38,48,1948
38918,38918,27EAC3E469830DC4BD5F7D0BCC935E63,10841,8,21,13,37,47,1897
38919,38919,2089CCBC2F855C8416A68A67F03D7345,41031,1,8,7,32,49,1649
38920,38920,2089CCBC2F855C8416A68A67F03D7345,10161,12,16,4,35,49,1799
38921,38921,2089CCBC2F855C8416A68A67F03D7345,43981,17,19,2,36,49,1849
38922,38922,2089CCBC2F855C8416A68A67F03D7345,12971,19,23,4,32,48,1648
38923,38923,0277E6ABE6E23FB8B51E9078601CBBC1,42491,0,7,7,32,46,1646
38924,38924,0277E6ABE6E23FB8B51E9078601CBBC1,42523,9,16,7,31,47,1597
38925,38925,0277E6ABE6E23FB8B51E9078601CBBC1,42491,19,23,4,32,46,1646
38926,38926,2FC852B4FFDF067DECF04814ED84AACA,42511,0,11,11,37,47,1897
38927,38927,2FC852B4FFDF067DECF04814ED84AACA,10271,13,14,1,37,46,1896
38928,38928,2FC852B4FFDF067DECF04814ED84AACA,42511,15,18,3,37,47,1897
38929,38929,2FC852B4FFDF067DECF04814ED84AACA,40951,21,22,1,36,49,1849
38933,38933,14C205DF57BD0AA586E26BE4ED695846,42581,0,5,5,38,48,1948
38934,38934,14C205DF57BD0AA586E26BE4ED695846,11914,9,10,1,37,48,1898
38935,38935,14C205DF57BD0AA586E26BE4ED695846,42581,12,14,2,38,48,1948
38936,38936,14C205DF57BD0AA586E26BE4ED695846,11914,15,20,5,37,48,1898
38940,38940,E1ADA5D6F54060F04D34C1A2CB8FE108,13381,0,13,13,39,47,1997
38941,38941,E1ADA5D6F54060F04D34C1A2CB8FE108,42221,14,15,1,38,48,1948
38942,38942,E1ADA5D6F54060F04D34C1A2CB8FE108,11074,18,20,2,37,47,1897
38943,38943,FA05CF18A6BF06D3E5C89C49E2940179,11381,0,9,9,30,47,1547
38944,38944,FA05CF18A6BF06D3E5C89C49E2940179,11061,12,13,1,29,48,1498
38945,38945,FA05CF18A6BF06D3E5C89C49E2940179,11381,16,20,4,30,47,1547
38955,38955,3C5BF8354C7B22C00BFA5438C070BC0F,13711,0,14,14,38,46,1946
38956,38956,3C5BF8354C7B22C00BFA5438C070BC0F,43241,14,17,3,36,46,1846
38957,38957,3C5BF8354C7B22C00BFA5438C070BC0F,13711,17,19,2,38,46,1946
38964,38964,805EE774A2BBF9DBFC5B48F9642AD1F7,10111,0,7,7,37,47,1897
38965,38965,805EE774A2BBF9DBFC5B48F9642AD1F7,42301,7,21,14,36,47,1847
38966,38966,805EE774A2BBF9DBFC5B48F9642AD1F7,10111,22,23,1,37,47,1897
38974,38974,227550B71384889A67AC4E901F7C17A1,10151,0,10,10,34,47,1747
38975,38975,227550B71384889A67AC4E901F7C17A1,11861,11,17,6,32,47,1647
38976,38976,227550B71384889A67AC4E901F7C17A1,10151,19,23,4,34,47,1747
38977,38977,ACFB892F60074737B9E0F9A496FA6823,42151,0,4,4,35,45,1795
38978,38978,ACFB892F60074737B9E0F9A496FA6823,42861,4,6,2,37,44,1894
38979,38979,ACFB892F60074737B9E0F9A496FA6823,42151,10,22,12,35,45,1795
38980,38980,76780BDA1CE8853E5C6D6B4A56C0AC5B,11381,0,7,7,30,47,1547
38981,38981,76780BDA1CE8853E5C6D6B4A56C0AC5B,12121,7,9,2,29,47,1497
38982,38982,76780BDA1CE8853E5C6D6B4A56C0AC5B,11381,10,23,13,30,47,1547
38994,38994,EA7259828C59286A0C8476F89AAE54B8,11261,0,14,14,36,46,1846
38995,38995,EA7259828C59286A0C8476F89AAE54B8,42351,14,16,2,38,45,1945
38996,38996,EA7259828C59286A0C8476F89AAE54B8,11261,16,23,7,36,46,1846
39000,39000,946768BFA72752D5660750415178C67F,10511,8,14,6,35,46,1796
39001,39001,946768BFA72752D5660750415178C67F,42471,18,20,2,35,49,1799
39002,39002,946768BFA72752D5660750415178C67F,11131,22,23,1,33,48,1698
39003,39003,CB9FC3FE9195AF3F0A6A77B7B82B22F1,11591,6,8,2,36,49,1849
39004,39004,CB9FC3FE9195AF3F0A6A77B7B82B22F1,42471,9,10,1,35,49,1799
39005,39005,CB9FC3FE9195AF3F0A6A77B7B82B22F1,11591,13,22,9,36,49,1849
39006,39006,3821B66A00758CF4502F36B7CE2D17D9,43451,0,5,5,37,40,1890
39007,39007,3821B66A00758CF4502F36B7CE2D17D9,12491,7,10,3,36,43,1843
39008,39008,3821B66A00758CF4502F36B7CE2D17D9,43451,12,23,11,37,40,1890
39012,39012,216E6834F2F69B3B365AE443E0E50E24,11381,0,11,11,30,47,1547
39013,39013,216E6834F2F69B3B365AE443E0E50E24,43971,13,15,2,30,48,1548
39014,39014,216E6834F2F69B3B365AE443E0E50E24,11381,19,22,3,30,47,1547
39020,39020,20EBDF07FAB10C468662B7339874EF65,42271,1,11,10,40,47,2047
39021,39021,20EBDF07FAB10C468662B7339874EF65,11806,12,13,1,41,48,2098
39022,39022,20EBDF07FAB10C468662B7339874EF65,42271,16,18,2,40,47,2047
39023,39023,20EBDF07FAB10C468662B7339874EF65,11806,21,23,2,41,48,2098
39037,39037,46D492BAB010922B2E00FA587B30756A,43951,1,10,9,49,41,2491
39038,39038,46D492BAB010922B2E00FA587B30756A,13411,14,15,1,49,42,2492
39039,39039,46D492BAB010922B2E00FA587B30756A,43951,15,22,7,49,41,2491
39044,39044,C619BC39ADD64D285F289B032026DA59,11074,0,8,8,37,47,1897
39045,39045,C619BC39ADD64D285F289B032026DA59,11941,10,16,6,37,46,1896
39046,39046,C619BC39ADD64D285F289B032026DA59,11261,17,18,1,36,46,1846
39047,39047,C619BC39ADD64D285F289B032026DA59,10841,21,23,2,37,47,1897
39056,39056,DEE5888BD7E461DD868275DE6FB19D26,10921,0,13,13,43,48,2198
39057,39057,DEE5888BD7E461DD868275DE6FB19D26,42201,14,15,1,43,46,2196
39058,39058,DEE5888BD7E461DD868275DE6FB19D26,10921,18,23,5,43,48,2198
39059,39059,964156E683797EC321E31C806CD19178,11914,0,11,11,37,48,1898
39060,39060,964156E683797EC321E31C806CD19178,43181,15,17,2,39,48,1998
39061,39061,964156E683797EC321E31C806CD19178,11914,18,23,5,37,48,1898
39084,39084,F14B27CFA07BFF1C03E8748CE04AA105,10341,0,8,8,31,47,1597
39085,39085,F14B27CFA07BFF1C03E8748CE04AA105,11061,12,14,2,29,48,1498
39086,39086,F14B27CFA07BFF1C03E8748CE04AA105,10381,14,15,1,31,49,1599
39087,39087,F14B27CFA07BFF1C03E8748CE04AA105,10341,17,23,6,31,47,1597
39088,39088,9D0C016FAC9B03B23F695C0F283D602D,11914,3,7,4,37,48,1898
39089,39089,9D0C016FAC9B03B23F695C0F283D602D,11074,10,12,2,37,47,1897
39090,39090,9D0C016FAC9B03B23F695C0F283D602D,42581,14,16,2,38,48,1948
39091,39091,9D0C016FAC9B03B23F695C0F283D602D,11914,17,23,6,37,48,1898
39092,39092,751637010376FF10A15374FA98F99F38,11861,0,9,9,32,47,1647
39093,39093,751637010376FF10A15374FA98F99F38,13601,13,14,1,34,47,1747
39094,39094,751637010376FF10A15374FA98F99F38,11861,14,23,9,32,47,1647
39126,39126,06F407FD461A4B0FFE40FBF8673BD071,10351,0,8,8,28,45,1445
39127,39127,06F407FD461A4B0FFE40FBF8673BD071,10634,10,12,2,27,45,1395
39128,39128,06F407FD461A4B0FFE40FBF8673BD071,10351,12,23,11,28,45,1445
39132,39132,660D2150C1391153938CD9B90E2CE919,19021,5,16,11,10,45,545
39133,39133,660D2150C1391153938CD9B90E2CE919,19441,18,19,1,8,46,446
39134,39134,660D2150C1391153938CD9B90E2CE919,12641,21,22,1,10,43,543
39135,39135,5B38B567B1C7BA8CD66BEFDF9C575D7A,12083,0,1,1,36,49,1849
39136,39136,5B38B567B1C7BA8CD66BEFDF9C575D7A,11231,1,14,13,37,49,1899
39137,39137,5B38B567B1C7BA8CD66BEFDF9C575D7A,10901,21,23,2,35,48,1798
39142,39142,D5B8C5235ADB84B7998BAE6507D2CE64,11151,5,6,1,30,48,1548
39143,39143,D5B8C5235ADB84B7998BAE6507D2CE64,10544,8,9,1,28,48,1448
39144,39144,D5B8C5235ADB84B7998BAE6507D2CE64,11151,11,12,1,30,48,1548
39145,39145,D5B8C5235ADB84B7998BAE6507D2CE64,10544,12,23,11,28,48,1448
39149,39149,DF43765F97C5D2704B76662DF9F622F3,13121,0,4,4,38,46,1946
39150,39150,DF43765F97C5D2704B76662DF9F622F3,10911,5,6,1,39,46,1996
39151,39151,DF43765F97C5D2704B76662DF9F622F3,13121,6,23,17,38,46,1946
39158,39158,4CFE48022CAC445FF2DF9E1132BED841,13731,8,9,1,33,49,1699
39159,39159,4CFE48022CAC445FF2DF9E1132BED841,11954,12,13,1,32,49,1649
39160,39160,4CFE48022CAC445FF2DF9E1132BED841,13731,20,21,1,33,49,1699
39161,39161,D1348284A12247DBF7195CE953852CD8,11161,3,6,3,32,48,1648
39162,39162,D1348284A12247DBF7195CE953852CD8,43311,7,9,2,31,48,1598
39163,39163,D1348284A12247DBF7195CE953852CD8,11161,12,14,2,32,48,1648
39164,39164,D1348284A12247DBF7195CE953852CD8,42141,19,20,1,32,47,1647
39165,39165,ED1B197D1A6AAA8BFAE9A2A66FB2A911,19901,1,4,3,7,44,394
39166,39166,ED1B197D1A6AAA8BFAE9A2A66FB2A911,19111,4,5,1,9,45,495
39167,39167,ED1B197D1A6AAA8BFAE9A2A66FB2A911,49201,8,16,8,7,41,391
39168,39168,ED1B197D1A6AAA8BFAE9A2A66FB2A911,19111,19,22,3,9,45,495
39184,39184,D53608326657C140C9801171477BB48D,10491,0,8,8,33,48,1698
39185,39185,D53608326657C140C9801171477BB48D,12083,17,18,1,36,49,1849
39186,39186,D53608326657C140C9801171477BB48D,10881,19,23,4,34,48,1748
39187,39187,0A61C8BC2E2F3B8A439DFBB7542FD5B0,13371,0,13,13,41,47,2097
39188,39188,0A61C8BC2E2F3B8A439DFBB7542FD5B0,10601,14,16,2,39,47,1997
39189,39189,0A61C8BC2E2F3B8A439DFBB7542FD5B0,13331,16,17,1,38,47,1947
39190,39190,0A61C8BC2E2F3B8A439DFBB7542FD5B0,13371,19,23,4,41,47,2097
39202,39202,700A8469B8648E235281334EF5CC8DA1,10471,0,12,12,37,48,1898
39203,39203,700A8469B8648E235281334EF5CC8DA1,11231,12,17,5,37,49,1899
39204,39204,700A8469B8648E235281334EF5CC8DA1,10471,17,19,2,37,48,1898
39205,39205,700A8469B8648E235281334EF5CC8DA1,11231,19,22,3,37,49,1899
39212,39212,ABC9186267E71F28FA785B0F903DDD72,40171,1,2,1,38,48,1948
39213,39213,ABC9186267E71F28FA785B0F903DDD72,10471,5,22,17,37,48,1898
39214,39214,ABC9186267E71F28FA785B0F903DDD72,40171,22,23,1,38,48,1948
39215,39215,0AE1F060A9917578AF6CC39BEF4A5FD7,11914,0,7,7,37,48,1898
39216,39216,0AE1F060A9917578AF6CC39BEF4A5FD7,10371,8,17,9,37,49,1899
39217,39217,0AE1F060A9917578AF6CC39BEF4A5FD7,42221,22,23,1,38,48,1948
39226,39226,0CF6CC5FF24D6A6AB1B738BADBD1459E,10431,8,10,2,33,49,1699
39227,39227,0CF6CC5FF24D6A6AB1B738BADBD1459E,40925,10,12,2,35,49,1799
39228,39228,0CF6CC5FF24D6A6AB1B738BADBD1459E,12971,13,14,1,32,48,1648
39229,39229,0CF6CC5FF24D6A6AB1B738BADBD1459E,10431,18,21,3,33,49,1699
39230,39230,3A0E3E44786168E980AA0D5DA8A549F6,11951,2,7,5,31,49,1599
39231,39231,3A0E3E44786168E980AA0D5DA8A549F6,11954,8,16,8,32,49,1649
39232,39232,3A0E3E44786168E980AA0D5DA8A549F6,11861,19,21,2,32,47,1647
39237,39237,97B6D6D29EC4E9F125FDF48E88E16061,10681,2,6,4,30,48,1548
39238,39238,97B6D6D29EC4E9F125FDF48E88E16061,11061,7,15,8,29,48,1498
39239,39239,97B6D6D29EC4E9F125FDF48E88E16061,10491,19,20,1,33,48,1698
39240,39240,71E80706335E84CC6A7D19F4D3805DDF,19441,0,7,7,8,46,446
39241,39241,71E80706335E84CC6A7D19F4D3805DDF,42041,9,10,1,10,47,547
39242,39242,71E80706335E84CC6A7D19F4D3805DDF,19441,12,20,8,8,46,446
39243,39243,71E80706335E84CC6A7D19F4D3805DDF,42041,21,22,1,10,47,547
39255,39255,7F8FEC3F30CB3DD9FA8B49EBAA16E6AE,10111,0,13,13,37,47,1897
39256,39256,7F8FEC3F30CB3DD9FA8B49EBAA16E6AE,13941,14,18,4,41,47,2097
39257,39257,7F8FEC3F30CB3DD9FA8B49EBAA16E6AE,10111,19,23,4,37,47,1897
39258,39258,64BD805F6D9361B926D90DA2610BBB4F,49201,0,4,4,7,41,391
39259,39259,64BD805F6D9361B926D90DA2610BBB4F,12921,4,14,10,9,41,491
39260,39260,64BD805F6D9361B926D90DA2610BBB4F,49201,17,18,1,7,41,391
39261,39261,64BD805F6D9361B926D90DA2610BBB4F,12921,21,23,2,9,41,491
39268,39268,1CE5F4D10EE2FB173CB9F2BC0746661A,12311,0,3,3,30,44,1544
39269,39269,1CE5F4D10EE2FB173CB9F2BC0746661A,42531,3,11,8,31,45,1595
39270,39270,1CE5F4D10EE2FB173CB9F2BC0746661A,12311,12,19,7,30,44,1544
39271,39271,1CE5F4D10EE2FB173CB9F2BC0746661A,42531,22,23,1,31,45,1595
39272,39272,7A69176949A6F3CD56C41411DF7AEF2C,43161,0,3,3,35,47,1797
39273,39273,7A69176949A6F3CD56C41411DF7AEF2C,10411,8,12,4,36,48,1848
39274,39274,7A69176949A6F3CD56C41411DF7AEF2C,11074,20,22,2,37,47,1897
39275,39275,CD55B44A3FD4B718A673CC03711FD344,12921,0,5,5,9,41,491
39276,39276,CD55B44A3FD4B718A673CC03711FD344,12641,5,9,4,10,43,543
39277,39277,CD55B44A3FD4B718A673CC03711FD344,12921,12,15,3,9,41,491
39278,39278,CD55B44A3FD4B718A673CC03711FD344,12641,15,19,4,10,43,543
39287,39287,22E3BF2C7186DFE217FCAD3E03BD0D76,13271,3,7,4,41,47,2097
39288,39288,22E3BF2C7186DFE217FCAD3E03BD0D76,13101,12,14,2,40,47,2047
39289,39289,22E3BF2C7186DFE217FCAD3E03BD0D76,13271,14,16,2,41,47,2097
39290,39290,22E3BF2C7186DFE217FCAD3E03BD0D76,13101,19,20,1,40,47,2047
39291,39291,70E50AA138C0538910E5623295B506D8,42151,0,6,6,35,45,1795
39292,39292,70E50AA138C0538910E5623295B506D8,11261,9,10,1,36,46,1846
39293,39293,70E50AA138C0538910E5623295B506D8,42351,10,23,13,38,45,1945
39306,39306,43AA632E12ABCA3F01D2033AFFAEDEF3,10151,0,13,13,34,47,1747
39307,39307,43AA632E12ABCA3F01D2033AFFAEDEF3,10251,14,15,1,35,47,1797
39308,39308,43AA632E12ABCA3F01D2033AFFAEDEF3,10161,15,17,2,35,49,1799
39309,39309,43AA632E12ABCA3F01D2033AFFAEDEF3,11491,18,20,2,36,47,1847
39317,39317,F27087BB3ABABEBCE99979766B1DE30B,10341,0,14,14,31,47,1597
39318,39318,F27087BB3ABABEBCE99979766B1DE30B,42491,18,19,1,32,46,1646
39319,39319,F27087BB3ABABEBCE99979766B1DE30B,10341,19,23,4,31,47,1597
39324,39324,E232F612C0C45C5977524031A2E21A42,10381,0,6,6,31,49,1599
39325,39325,E232F612C0C45C5977524031A2E21A42,11061,7,16,9,29,48,1498
39326,39326,E232F612C0C45C5977524031A2E21A42,10381,17,21,4,31,49,1599
39327,39327,5CC5C35618AC0DF5927755EC84C58295,13711,0,15,15,38,46,1946
39328,39328,5CC5C35618AC0DF5927755EC84C58295,10191,19,20,1,40,48,2048
39329,39329,5CC5C35618AC0DF5927755EC84C58295,10841,21,23,2,37,47,1897
39333,39333,D8E810E9944384CCB75FBE32C487F667,11531,8,10,2,34,49,1749
39334,39334,D8E810E9944384CCB75FBE32C487F667,43321,12,17,5,36,49,1849
39335,39335,D8E810E9944384CCB75FBE32C487F667,11531,18,19,1,34,49,1749
39345,39345,B008950D13439AAF34B6D4BE3B059216,42523,2,3,1,31,47,1597
39346,39346,B008950D13439AAF34B6D4BE3B059216,13651,7,8,1,30,47,1547
39347,39347,B008950D13439AAF34B6D4BE3B059216,42523,9,17,8,31,47,1597
39348,39348,B008950D13439AAF34B6D4BE3B059216,13651,17,21,4,30,47,1547
39361,39361,822C0A93592A32AB705BCCE34C567AE4,13601,0,6,6,34,47,1747
39362,39362,822C0A93592A32AB705BCCE34C567AE4,13511,6,14,8,34,48,1748
39363,39363,822C0A93592A32AB705BCCE34C567AE4,13601,14,16,2,34,47,1747
39364,39364,822C0A93592A32AB705BCCE34C567AE4,13511,21,23,2,34,48,1748
39365,39365,7FD9072832AAE29AE2915CDEF233B942,42321,1,5,4,43,47,2197
39366,39366,7FD9072832AAE29AE2915CDEF233B942,10801,8,10,2,42,47,2147
39367,39367,7FD9072832AAE29AE2915CDEF233B942,13221,15,16,1,40,47,2047
39368,39368,7FD9072832AAE29AE2915CDEF233B942,10801,17,20,3,42,47,2147
39374,39374,1F586282DD0AC03725A5E548411F5D82,12514,2,12,10,38,47,1947
39375,39375,1F586282DD0AC03725A5E548411F5D82,10841,12,13,1,37,47,1897
39376,39376,1F586282DD0AC03725A5E548411F5D82,12514,15,23,8,38,47,1947
39377,39377,154B39807A422FDB28537C4227930019,11941,0,11,11,37,46,1896
39378,39378,154B39807A422FDB28537C4227930019,13711,13,15,2,38,46,1946
39379,39379,154B39807A422FDB28537C4227930019,11941,18,21,3,37,46,1896
39386,39386,8167EF05D15F996A6B93D96BD3E78468,41601,0,2,2,39,49,1999
39387,39387,8167EF05D15F996A6B93D96BD3E78468,13371,2,14,12,41,47,2097
39388,39388,8167EF05D15F996A6B93D96BD3E78468,12514,15,17,2,38,47,1947
39389,39389,8167EF05D15F996A6B93D96BD3E78468,43481,21,23,2,39,48,1998
39393,39393,06E5EEDC1E7CD6AB50F4421A81CA897C,11791,0,9,9,38,49,1949
39394,39394,06E5EEDC1E7CD6AB50F4421A81CA897C,11231,10,11,1,37,49,1899
39395,39395,06E5EEDC1E7CD6AB50F4421A81CA897C,11771,12,14,2,39,49,1999
39396,39396,06E5EEDC1E7CD6AB50F4421A81CA897C,40951,15,20,5,36,49,1849
39406,39406,8E0D20320C5276BDD797BA6D65B9C51D,11074,0,7,7,37,47,1897
39407,39407,8E0D20320C5276BDD797BA6D65B9C51D,11231,8,14,6,37,49,1899
39408,39408,8E0D20320C5276BDD797BA6D65B9C51D,12083,15,17,2,36,49,1849
39409,39409,8E0D20320C5276BDD797BA6D65B9C51D,11074,19,23,4,37,47,1897
39410,39410,E33544DEDE819852A7D0FA2347791128,42321,3,7,4,43,47,2197
39411,39411,E33544DEDE819852A7D0FA2347791128,13011,12,13,1,39,47,1997
39412,39412,E33544DEDE819852A7D0FA2347791128,13221,17,19,2,40,47,2047
39413,39413,1FE349017C0CCF9432DB68627FF8ADB4,11541,9,10,1,35,49,1799
39414,39414,1FE349017C0CCF9432DB68627FF8ADB4,11531,17,18,1,34,49,1749
39415,39415,1FE349017C0CCF9432DB68627FF8ADB4,40171,21,23,2,38,48,1948
39419,39419,5D3AB87CDE152EA5E956E4DDC06AC59B,40171,0,11,11,38,48,1948
39420,39420,5D3AB87CDE152EA5E956E4DDC06AC59B,10471,12,16,4,37,48,1898
39421,39421,5D3AB87CDE152EA5E956E4DDC06AC59B,40171,20,23,3,38,48,1948
39437,39437,511248B31413344B77C12D74A5EE7CDF,43471,0,7,7,31,49,1599
39438,39438,511248B31413344B77C12D74A5EE7CDF,11151,12,21,9,30,48,1548
39439,39439,511248B31413344B77C12D74A5EE7CDF,43471,21,23,2,31,49,1599
39440,39440,DA48F6EEC4784B4505CA1BBB58EA121A,10341,0,7,7,31,47,1597
39441,39441,DA48F6EEC4784B4505CA1BBB58EA121A,10292,7,12,5,30,47,1547
39442,39442,DA48F6EEC4784B4505CA1BBB58EA121A,10341,12,14,2,31,47,1597
39443,39443,DA48F6EEC4784B4505CA1BBB58EA121A,10292,18,22,4,30,47,1547
39444,39444,9D1D6C8F3B399A8A61F31E1610AD3A2B,10971,1,14,13,35,47,1797
39445,39445,9D1D6C8F3B399A8A61F31E1610AD3A2B,43731,16,18,2,34,47,1747
39446,39446,9D1D6C8F3B399A8A61F31E1610AD3A2B,10491,19,20,1,33,48,1698
39447,39447,9D1D6C8F3B399A8A61F31E1610AD3A2B,40277,21,23,2,35,49,1799
39453,39453,EF4309226B1A6FC23BE1987955F9DDE8,11491,0,6,6,36,47,1847
39454,39454,EF4309226B1A6FC23BE1987955F9DDE8,42941,7,15,8,37,47,1897
39455,39455,EF4309226B1A6FC23BE1987955F9DDE8,11491,17,22,5,36,47,1847
39466,39466,9E981569C6718F42D2105C2620CE51EF,42461,0,6,6,45,47,2297
39467,39467,9E981569C6718F42D2105C2620CE51EF,42321,6,18,12,43,47,2197
39468,39468,9E981569C6718F42D2105C2620CE51EF,40691,20,23,3,42,48,2148
39478,39478,070FBAC74203F15EE9C689471AF11573,40242,0,9,9,36,49,1849
39479,39479,070FBAC74203F15EE9C689471AF11573,11551,13,14,1,39,49,1999
39480,39480,070FBAC74203F15EE9C689471AF11573,10841,16,17,1,37,47,1897
39481,39481,070FBAC74203F15EE9C689471AF11573,11551,19,20,1,39,49,1999
39492,39492,26A4E7AD001291610BB2E4F05F35E9EC,11074,0,5,5,37,47,1897
39493,39493,26A4E7AD001291610BB2E4F05F35E9EC,42301,6,7,1,36,47,1847
39494,39494,26A4E7AD001291610BB2E4F05F35E9EC,10841,10,18,8,37,47,1897
39495,39495,C1035E7091A0E4A79008248101DEF034,11381,0,8,8,30,47,1547
39496,39496,C1035E7091A0E4A79008248101DEF034,11061,8,12,4,29,48,1498
39497,39497,C1035E7091A0E4A79008248101DEF034,43971,12,15,3,30,48,1548
39498,39498,C1035E7091A0E4A79008248101DEF034,11061,16,19,3,29,48,1498
39499,39499,73F5D46A0AB49D3D1FF3EBE9DD0774B5,11261,9,11,2,36,46,1846
39500,39500,73F5D46A0AB49D3D1FF3EBE9DD0774B5,42861,15,16,1,37,44,1894
39501,39501,73F5D46A0AB49D3D1FF3EBE9DD0774B5,11261,18,20,2,36,46,1846
39517,39517,DF460CBD4C09A51D06C2038FDA368680,19441,0,7,7,8,46,446
39518,39518,DF460CBD4C09A51D06C2038FDA368680,42041,10,11,1,10,47,547
39519,39519,DF460CBD4C09A51D06C2038FDA368680,19441,11,20,9,8,46,446
39525,39525,95179DBAB4AF2895C67C8CEEECB1B501,10691,0,6,6,33,48,1698
39526,39526,95179DBAB4AF2895C67C8CEEECB1B501,11561,10,17,7,32,49,1649
39527,39527,95179DBAB4AF2895C67C8CEEECB1B501,10691,19,23,4,33,48,1698
39553,39553,1FA24F76587DEEEE9ED93C46D3D68950,42151,5,6,1,35,45,1795
39554,39554,1FA24F76587DEEEE9ED93C46D3D68950,42371,8,17,9,34,46,1746
39555,39555,1FA24F76587DEEEE9ED93C46D3D68950,42151,19,20,1,35,45,1795
39560,39560,00D2FC0AEF9B9FF41E1F26A6EC4801FB,10151,1,8,7,34,47,1747
39561,39561,00D2FC0AEF9B9FF41E1F26A6EC4801FB,43981,11,12,1,36,49,1849
39562,39562,00D2FC0AEF9B9FF41E1F26A6EC4801FB,10151,14,23,9,34,47,1747
39563,39563,E7233A336FF6DC7015F36A96AF40FCB1,42301,0,1,1,36,47,1847
39564,39564,E7233A336FF6DC7015F36A96AF40FCB1,11941,5,6,1,37,46,1896
39565,39565,E7233A336FF6DC7015F36A96AF40FCB1,42161,10,12,2,36,47,1847
39566,39566,E7233A336FF6DC7015F36A96AF40FCB1,11941,16,22,6,37,46,1896
39574,39574,3F9A6924C359E667023E00EF6A58C7A3,13651,0,11,11,30,47,1547
39575,39575,3F9A6924C359E667023E00EF6A58C7A3,42521,12,14,2,31,47,1597
39576,39576,3F9A6924C359E667023E00EF6A58C7A3,10292,15,23,8,30,47,1547
39584,39584,EC4330687AFAD23F392FAEF4FB4107B7,10781,0,8,8,35,47,1797
39585,39585,EC4330687AFAD23F392FAEF4FB4107B7,11201,9,10,1,35,49,1799
39586,39586,EC4330687AFAD23F392FAEF4FB4107B7,10781,13,18,5,35,47,1797
39587,39587,EC4330687AFAD23F392FAEF4FB4107B7,42161,22,23,1,36,47,1847
39597,39597,0A1386913DE713CBA72662A5149627A3,13711,0,16,16,38,46,1946
39598,39598,0A1386913DE713CBA72662A5149627A3,11941,16,17,1,37,46,1896
39599,39599,0A1386913DE713CBA72662A5149627A3,13711,19,22,3,38,46,1946
39600,39600,7C98BDF484E2B085C51A4945E804FC0C,42151,0,2,2,35,45,1795
39601,39601,7C98BDF484E2B085C51A4945E804FC0C,12491,4,5,1,36,43,1843
39602,39602,7C98BDF484E2B085C51A4945E804FC0C,42151,8,21,13,35,45,1795
39603,39603,DC0BB9353438EF73E027E505129705B2,43761,0,13,13,32,47,1647
39604,39604,DC0BB9353438EF73E027E505129705B2,42523,16,17,1,31,47,1597
39605,39605,DC0BB9353438EF73E027E505129705B2,43761,18,19,1,32,47,1647
39606,39606,ED36A592544F9D3B4DC283835B5C723A,13381,1,7,6,39,47,1997
39607,39607,ED36A592544F9D3B4DC283835B5C723A,42271,7,12,5,40,47,2047
39608,39608,ED36A592544F9D3B4DC283835B5C723A,11481,13,23,10,41,48,2098
39626,39626,EBE74CAA370851CCC599E73574A1082B,11074,0,6,6,37,47,1897
39627,39627,EBE74CAA370851CCC599E73574A1082B,42221,10,13,3,38,48,1948
39628,39628,EBE74CAA370851CCC599E73574A1082B,11074,17,21,4,37,47,1897
39634,39634,C96AF7724AE07D1D1BE56C246C9FE7FC,13341,0,13,13,44,45,2245
39635,39635,C96AF7724AE07D1D1BE56C246C9FE7FC,42461,13,14,1,45,47,2297
39636,39636,C96AF7724AE07D1D1BE56C246C9FE7FC,42631,15,17,2,43,45,2195
39637,39637,C96AF7724AE07D1D1BE56C246C9FE7FC,13341,18,20,2,44,45,2245
39638,39638,A922D7161F816C1FD25F52BCCB616DFE,40673,0,2,2,36,48,1848
39639,39639,A922D7161F816C1FD25F52BCCB616DFE,43731,3,6,3,34,47,1747
39640,39640,A922D7161F816C1FD25F52BCCB616DFE,40673,6,9,3,36,48,1848
39641,39641,A922D7161F816C1FD25F52BCCB616DFE,10251,11,21,10,35,47,1797
39642,39642,5E269639C787C5D2BDF7F359B5257597,13381,0,8,8,39,47,1997
39643,39643,5E269639C787C5D2BDF7F359B5257597,11481,8,16,8,41,48,2098
39644,39644,5E269639C787C5D2BDF7F359B5257597,42271,18,23,5,40,47,2047
39645,39645,CD5264FA94F0D7079560625C6CCF7D91,13711,0,12,12,38,46,1946
39646,39646,CD5264FA94F0D7079560625C6CCF7D91,10271,12,14,2,37,46,1896
39647,39647,CD5264FA94F0D7079560625C6CCF7D91,13711,14,23,9,38,46,1946
39648,39648,47844E829FCB05D6E87386BF9A1380C3,11941,2,7,5,37,46,1896
39649,39649,47844E829FCB05D6E87386BF9A1380C3,11021,10,11,1,36,49,1849
39650,39650,47844E829FCB05D6E87386BF9A1380C3,11081,15,17,2,35,46,1796
39651,39651,47844E829FCB05D6E87386BF9A1380C3,13711,20,23,3,38,46,1946
39661,39661,8CD5156CF883DA15618BAFE58DDCF2A7,42581,0,5,5,38,48,1948
39662,39662,8CD5156CF883DA15618BAFE58DDCF2A7,11914,6,17,11,37,48,1898
39663,39663,8CD5156CF883DA15618BAFE58DDCF2A7,42581,19,23,4,38,48,1948
39671,39671,E24F34B965BE1054DCE4AF1C1CD48137,11861,0,8,8,32,47,1647
39672,39672,E24F34B965BE1054DCE4AF1C1CD48137,11875,9,20,11,30,46,1546
39673,39673,E24F34B965BE1054DCE4AF1C1CD48137,11861,21,23,2,32,47,1647
39681,39681,6E393276634E5B0B2A68B7AC0F0F48CF,10491,0,6,6,33,48,1698
39682,39682,6E393276634E5B0B2A68B7AC0F0F48CF,11861,6,8,2,32,47,1647
39683,39683,6E393276634E5B0B2A68B7AC0F0F48CF,10491,12,23,11,33,48,1698
39684,39684,9D7E28E179E5F5D009F8D277D0F434A8,11861,0,1,1,32,47,1647
39685,39685,9D7E28E179E5F5D009F8D277D0F434A8,10281,2,8,6,33,48,1698
39686,39686,9D7E28E179E5F5D009F8D277D0F434A8,11861,8,23,15,32,47,1647
39687,39687,9561ABDECCD36C7236B43D7186F9954F,10681,1,7,6,30,48,1548
39688,39688,9561ABDECCD36C7236B43D7186F9954F,11061,9,10,1,29,48,1498
39689,39689,9561ABDECCD36C7236B43D7186F9954F,10681,11,13,2,30,48,1548
39690,39690,9561ABDECCD36C7236B43D7186F9954F,11061,14,23,9,29,48,1498
39698,39698,D9B0439F3B0C81F4C0A4571FAB2A3A71,42021,0,14,14,33,47,1697
39699,39699,D9B0439F3B0C81F4C0A4571FAB2A3A71,13601,14,18,4,34,47,1747
39700,39700,D9B0439F3B0C81F4C0A4571FAB2A3A71,42021,20,23,3,33,47,1697
39701,39701,C7859131FC5613A278444EF81B856AED,42511,2,12,10,37,47,1897
39702,39702,C7859131FC5613A278444EF81B856AED,42301,14,16,2,36,47,1847
39703,39703,C7859131FC5613A278444EF81B856AED,42511,18,20,2,37,47,1897
39704,39704,C7859131FC5613A278444EF81B856AED,13711,21,22,1,38,46,1946
39712,39712,E45B0EC44E00842EDD865C65A561543D,11231,8,12,4,37,49,1899
39713,39713,E45B0EC44E00842EDD865C65A561543D,10471,12,13,1,37,48,1898
39714,39714,E45B0EC44E00842EDD865C65A561543D,11231,15,21,6,37,49,1899
39715,39715,B24DFEF6BEA91CB0AE942579D8124FCB,10971,0,7,7,35,47,1797
39716,39716,B24DFEF6BEA91CB0AE942579D8124FCB,40381,8,9,1,32,46,1646
39717,39717,B24DFEF6BEA91CB0AE942579D8124FCB,10971,13,23,10,35,47,1797
39718,39718,9FDE2E911BF49A6996BBEFBC05B62D08,42071,0,17,17,31,49,1599
39719,39719,9FDE2E911BF49A6996BBEFBC05B62D08,10681,19,20,1,30,48,1548
39720,39720,9FDE2E911BF49A6996BBEFBC05B62D08,10381,21,23,2,31,49,1599
39721,39721,1232165EC1AF2100253CAA0EBB1D130B,13601,8,9,1,34,47,1747
39722,39722,1232165EC1AF2100253CAA0EBB1D130B,10731,10,11,1,33,47,1697
39723,39723,1232165EC1AF2100253CAA0EBB1D130B,11491,14,15,1,36,47,1847
39724,39724,1232165EC1AF2100253CAA0EBB1D130B,42511,18,19,1,37,47,1897
39730,39730,D8B46FFCD15B641FB93B8219A29A7205,40673,3,7,4,36,48,1848
39731,39731,D8B46FFCD15B641FB93B8219A29A7205,10251,10,11,1,35,47,1797
39732,39732,D8B46FFCD15B641FB93B8219A29A7205,40673,13,15,2,36,48,1848
39733,39733,D8B46FFCD15B641FB93B8219A29A7205,42161,18,19,1,36,47,1847
39734,39734,8D75EC7608DEEC520A412E824B107B5A,43761,2,15,13,32,47,1647
39735,39735,8D75EC7608DEEC520A412E824B107B5A,42521,15,17,2,31,47,1597
39736,39736,8D75EC7608DEEC520A412E824B107B5A,43761,22,23,1,32,47,1647
39737,39737,F004825C5EEC7F8B7A184D4985895C55,13341,2,10,8,44,45,2245
39738,39738,F004825C5EEC7F8B7A184D4985895C55,42631,11,12,1,43,45,2195
39739,39739,F004825C5EEC7F8B7A184D4985895C55,13111,15,16,1,42,46,2146
39740,39740,F004825C5EEC7F8B7A184D4985895C55,13341,16,22,6,44,45,2245
39741,39741,2FC977AAECB05F28AE0C53353C4DD1FC,13121,0,10,10,38,46,1946
39742,39742,2FC977AAECB05F28AE0C53353C4DD1FC,10271,14,19,5,37,46,1896
39743,39743,2FC977AAECB05F28AE0C53353C4DD1FC,13121,20,23,3,38,46,1946
39744,39744,0E4B3B25FE0CAB1DCA768980553C13E7,42791,0,9,9,35,45,1795
39745,39745,0E4B3B25FE0CAB1DCA768980553C13E7,12661,11,20,9,32,45,1645
39746,39746,0E4B3B25FE0CAB1DCA768980553C13E7,42151,21,23,2,35,45,1795
39756,39756,026D9CD2D7AB3D5BF684F04063945AE0,13711,0,8,8,38,46,1946
39757,39757,026D9CD2D7AB3D5BF684F04063945AE0,42351,9,15,6,38,45,1945
39758,39758,026D9CD2D7AB3D5BF684F04063945AE0,13841,16,18,2,40,46,2046
39759,39759,026D9CD2D7AB3D5BF684F04063945AE0,42351,20,21,1,38,45,1945
39760,39760,537B866E49840CD2552EC8B3E30E45EA,42921,5,8,3,33,47,1697
39761,39761,537B866E49840CD2552EC8B3E30E45EA,10281,12,21,9,33,48,1698
39762,39762,537B866E49840CD2552EC8B3E30E45EA,42921,22,23,1,33,47,1697
39763,39763,9577C3E7EE21DEF21D939B8D53DB646D,42091,0,13,13,43,46,2196
39764,39764,9577C3E7EE21DEF21D939B8D53DB646D,42461,13,16,3,45,47,2297
39765,39765,9577C3E7EE21DEF21D939B8D53DB646D,42091,16,21,5,43,46,2196
39783,39783,0C2B805EE888E91F034AB21F925F07C4,19901,0,4,4,7,44,394
39784,39784,0C2B805EE888E91F034AB21F925F07C4,19114,6,14,8,7,43,393
39785,39785,0C2B805EE888E91F034AB21F925F07C4,12641,19,22,3,10,43,543
39786,39786,E8F5F4A78C0DE5C1EE8D56EB7226C7B2,10491,0,8,8,33,48,1698
39787,39787,E8F5F4A78C0DE5C1EE8D56EB7226C7B2,12131,9,10,1,32,47,1647
39788,39788,E8F5F4A78C0DE5C1EE8D56EB7226C7B2,10161,18,20,2,35,49,1799
39789,39789,E8F5F4A78C0DE5C1EE8D56EB7226C7B2,11131,21,23,2,33,48,1698
39793,39793,7D98A45A2A63975DDA0D630EA5B92C75,10801,0,5,5,42,47,2147
39794,39794,7D98A45A2A63975DDA0D630EA5B92C75,13941,8,9,1,41,47,2097
39795,39795,7D98A45A2A63975DDA0D630EA5B92C75,11001,10,21,11,42,47,2147
39804,39804,83DF2DC67F792D97F66715470F9922B2,43761,7,10,3,32,47,1647
39805,39805,83DF2DC67F792D97F66715470F9922B2,42521,11,17,6,31,47,1597
39806,39806,83DF2DC67F792D97F66715470F9922B2,43761,20,23,3,32,47,1647
39829,39829,EEAD4C1A5C3C3CA3E08C3BA4BC80CCB9,12641,0,7,7,10,43,543
39830,39830,EEAD4C1A5C3C3CA3E08C3BA4BC80CCB9,12921,8,18,10,9,41,491
39831,39831,EEAD4C1A5C3C3CA3E08C3BA4BC80CCB9,12641,20,21,1,10,43,543
39835,39835,62A4DF59E8BCEC0DCF6C971E2D9209AC,11491,1,5,4,36,47,1847
39836,39836,62A4DF59E8BCEC0DCF6C971E2D9209AC,11021,8,17,9,36,49,1849
39837,39837,62A4DF59E8BCEC0DCF6C971E2D9209AC,10271,18,20,2,37,46,1896
39844,39844,60DB2F1E5C63BE640D47B87EE3CFB05B,42461,0,6,6,45,47,2297
39845,39845,60DB2F1E5C63BE640D47B87EE3CFB05B,42091,7,9,2,43,46,2196
39846,39846,60DB2F1E5C63BE640D47B87EE3CFB05B,42321,12,18,6,43,47,2197
39847,39847,60DB2F1E5C63BE640D47B87EE3CFB05B,42461,19,23,4,45,47,2297
39855,39855,A9FDB442F75FC7FF8CE9BE4C7BB0C6E7,10271,0,1,1,37,46,1896
39856,39856,A9FDB442F75FC7FF8CE9BE4C7BB0C6E7,13711,1,6,5,38,46,1946
39857,39857,A9FDB442F75FC7FF8CE9BE4C7BB0C6E7,10271,10,14,4,37,46,1896
39858,39858,A9FDB442F75FC7FF8CE9BE4C7BB0C6E7,13711,14,22,8,38,46,1946
39863,39863,EE107F15123C6DB132974358298F51B4,11914,1,14,13,37,48,1898
39864,39864,EE107F15123C6DB132974358298F51B4,40171,15,16,1,38,48,1948
39865,39865,EE107F15123C6DB132974358298F51B4,11914,17,20,3,37,48,1898
39866,39866,05C3A7EB5EF4E026B421540B8AC90475,42531,1,4,3,31,45,1595
39867,39867,05C3A7EB5EF4E026B421540B8AC90475,42151,7,16,9,35,45,1795
39868,39868,05C3A7EB5EF4E026B421540B8AC90475,42531,17,19,2,31,45,1595
39869,39869,A1B1493AD1E4959D25E397CB780FB65E,42531,0,7,7,31,45,1595
39870,39870,A1B1493AD1E4959D25E397CB780FB65E,12311,7,8,1,30,44,1544
39871,39871,A1B1493AD1E4959D25E397CB780FB65E,42531,11,20,9,31,45,1595
39872,39872,A1B1493AD1E4959D25E397CB780FB65E,12311,21,23,2,30,44,1544
39873,39873,27BEAD14FBA5CCA8B617A95DF1B392F3,10544,1,4,3,28,48,1448
39874,39874,27BEAD14FBA5CCA8B617A95DF1B392F3,43501,6,9,3,27,48,1398
39875,39875,27BEAD14FBA5CCA8B617A95DF1B392F3,12601,11,19,8,25,47,1297
39876,39876,8A524E85431660319A09E8D071AC107B,42321,0,16,16,43,47,2197
39877,39877,8A524E85431660319A09E8D071AC107B,10801,17,19,2,42,47,2147
39878,39878,8A524E85431660319A09E8D071AC107B,42321,21,23,2,43,47,2197
39879,39879,7D5000772E957DD3A483CE8963A15A13,42501,2,5,3,28,47,1447
39880,39880,7D5000772E957DD3A483CE8963A15A13,42141,7,8,1,32,47,1647
39881,39881,7D5000772E957DD3A483CE8963A15A13,12121,10,23,13,29,47,1497
39882,39882,19520219413B0560C0BDE6534C7F0AD0,13561,0,15,15,37,49,1899
39883,39883,19520219413B0560C0BDE6534C7F0AD0,10121,16,18,2,36,49,1849
39884,39884,19520219413B0560C0BDE6534C7F0AD0,11231,20,23,3,37,49,1899
39885,39885,1A27B39488893CCC5AAB1E5C8534A13D,11021,0,7,7,36,49,1849
39886,39886,1A27B39488893CCC5AAB1E5C8534A13D,11941,8,10,2,37,46,1896
39887,39887,1A27B39488893CCC5AAB1E5C8534A13D,11021,12,20,8,36,49,1849
39918,39918,68D66AC2F31097852E1113FCAC38B096,12311,0,8,8,30,44,1544
39919,39919,68D66AC2F31097852E1113FCAC38B096,42531,8,18,10,31,45,1595
39920,39920,68D66AC2F31097852E1113FCAC38B096,12311,19,22,3,30,44,1544
39921,39921,FF16D1104349162E539969031BE39A02,12514,2,6,4,38,47,1947
39922,39922,FF16D1104349162E539969031BE39A02,12511,9,18,9,39,47,1997
39923,39923,FF16D1104349162E539969031BE39A02,43481,19,22,3,39,48,1998
39924,39924,EAAC45FB100EE8A458EC0FF985DACA2D,11751,0,7,7,35,48,1798
39925,39925,EAAC45FB100EE8A458EC0FF985DACA2D,12391,8,15,7,36,49,1849
39926,39926,EAAC45FB100EE8A458EC0FF985DACA2D,43281,16,17,1,37,48,1898
39927,39927,EAAC45FB100EE8A458EC0FF985DACA2D,11751,20,21,1,35,48,1798
39946,39946,14221EE63F6EE55805EE5B3069F379DA,11914,2,3,1,37,48,1898
39947,39947,14221EE63F6EE55805EE5B3069F379DA,42581,7,15,8,38,48,1948
39948,39948,14221EE63F6EE55805EE5B3069F379DA,11914,16,22,6,37,48,1898
39949,39949,8D86E284D185DE22084CD86C6BFE1A08,11381,0,6,6,30,47,1547
39950,39950,8D86E284D185DE22084CD86C6BFE1A08,12311,6,15,9,30,44,1544
39951,39951,8D86E284D185DE22084CD86C6BFE1A08,11875,18,23,5,30,46,1546
39956,39956,16A0589A145EA4C47047324378E38CE2,42633,0,7,7,42,46,2146
39957,39957,16A0589A145EA4C47047324378E38CE2,10811,8,12,4,38,46,1946
39958,39958,16A0589A145EA4C47047324378E38CE2,13231,15,17,2,39,46,1996
39959,39959,16A0589A145EA4C47047324378E38CE2,42633,21,23,2,42,46,2146
39971,39971,9C95D6292421E6B801C911060D75482F,12921,1,11,10,9,41,491
39972,39972,9C95D6292421E6B801C911060D75482F,12641,13,20,7,10,43,543
39973,39973,9C95D6292421E6B801C911060D75482F,12921,20,22,2,9,41,491
39974,39974,01308B72F71E3AACC045F922DA6CAE4D,42523,7,8,1,31,47,1597
39975,39975,01308B72F71E3AACC045F922DA6CAE4D,42491,8,10,2,32,46,1646
39976,39976,01308B72F71E3AACC045F922DA6CAE4D,43761,10,19,9,32,47,1647
39977,39977,01308B72F71E3AACC045F922DA6CAE4D,42523,21,23,2,31,47,1597
39978,39978,03C19F5F9D7D397AE6E9F2FD16BA994D,10251,0,15,15,35,47,1797
39979,39979,03C19F5F9D7D397AE6E9F2FD16BA994D,42401,15,19,4,36,47,1847
39980,39980,03C19F5F9D7D397AE6E9F2FD16BA994D,10251,19,23,4,35,47,1797
39984,39984,FCA3C665B5BF337F331669EDB597A6AC,42791,0,7,7,35,45,1795
39985,39985,FCA3C665B5BF337F331669EDB597A6AC,13121,10,12,2,38,46,1946
39986,39986,FCA3C665B5BF337F331669EDB597A6AC,10271,14,17,3,37,46,1896
39987,39987,FCA3C665B5BF337F331669EDB597A6AC,13711,18,22,4,38,46,1946
39988,39988,968EA5A531F57AB4335F924E18D6CC7A,10351,0,8,8,28,45,1445
39989,39989,968EA5A531F57AB4335F924E18D6CC7A,11381,8,9,1,30,47,1547
39990,39990,968EA5A531F57AB4335F924E18D6CC7A,10351,12,22,10,28,45,1445
39999,39999,C51E252CF4E3CCE91DAD548C30F00035,42021,0,7,7,33,47,1697
40000,40000,C51E252CF4E3CCE91DAD548C30F00035,42471,11,20,9,35,49,1799
40001,40001,C51E252CF4E3CCE91DAD548C30F00035,42021,21,23,2,33,47,1697
40002,40002,71FDEFC3187A3CF24BA939D7B11B9629,12481,0,1,1,37,49,1899
40003,40003,71FDEFC3187A3CF24BA939D7B11B9629,12391,1,16,15,36,49,1849
40004,40004,71FDEFC3187A3CF24BA939D7B11B9629,42961,19,21,2,35,49,1799
40005,40005,71FDEFC3187A3CF24BA939D7B11B9629,10471,22,23,1,37,48,1898
40006,40006,AC9A35D001464E087369411DD671E08D,40431,0,7,7,36,47,1847
40007,40007,AC9A35D001464E087369411DD671E08D,42941,10,15,5,37,47,1897
40008,40008,AC9A35D001464E087369411DD671E08D,42301,18,23,5,36,47,1847
40009,40009,7C4A9FEC22A5328D2AACA442D993867F,11384,0,9,9,30,47,1547
40010,40010,7C4A9FEC22A5328D2AACA442D993867F,42521,9,12,3,31,47,1597
40011,40011,7C4A9FEC22A5328D2AACA442D993867F,13651,12,23,11,30,47,1547
40015,40015,9365C0731F1C4631FF8F1D06F7923828,11361,0,5,5,22,48,1148
40016,40016,9365C0731F1C4631FF8F1D06F7923828,12581,8,9,1,24,48,1248
40017,40017,9365C0731F1C4631FF8F1D06F7923828,11361,13,14,1,22,48,1148
40018,40018,9365C0731F1C4631FF8F1D06F7923828,12581,16,18,2,24,48,1248
40026,40026,E3F199857752944062C87BF29578D10F,13711,5,15,10,38,46,1946
40027,40027,E3F199857752944062C87BF29578D10F,13461,15,16,1,39,44,1994
40028,40028,E3F199857752944062C87BF29578D10F,40891,20,22,2,37,47,1897
40029,40029,7D8BB90B66B5BB302B836A7DB354A71B,11701,0,7,7,43,48,2198
40030,40030,7D8BB90B66B5BB302B836A7DB354A71B,42601,8,14,6,44,48,2248
40031,40031,7D8BB90B66B5BB302B836A7DB354A71B,42321,14,15,1,43,47,2197
40032,40032,7D8BB90B66B5BB302B836A7DB354A71B,11701,20,21,1,43,48,2198
40040,40040,8285E7CFD2208E724767098E1AD19936,42041,4,12,8,10,47,547
40041,40041,8285E7CFD2208E724767098E1AD19936,19024,14,16,2,9,45,495
40042,40042,8285E7CFD2208E724767098E1AD19936,42041,18,20,2,10,47,547
40043,40043,26CDDE90E81CF115EC565EA62A47B92A,42491,6,7,1,32,46,1646
40044,40044,26CDDE90E81CF115EC565EA62A47B92A,42523,11,15,4,31,47,1597
40045,40045,26CDDE90E81CF115EC565EA62A47B92A,10401,18,19,1,33,49,1699
40053,40053,49F8AAD93F934300B33FEA8F6FB9926C,11541,0,6,6,35,49,1799
40054,40054,49F8AAD93F934300B33FEA8F6FB9926C,11021,6,13,7,36,49,1849
40055,40055,49F8AAD93F934300B33FEA8F6FB9926C,11211,15,20,5,34,49,1749
40056,40056,49F8AAD93F934300B33FEA8F6FB9926C,11541,21,23,2,35,49,1799
40062,40062,21D029E4FB71F3A5DA880019FDFB9BC1,12491,0,13,13,36,43,1843
40063,40063,21D029E4FB71F3A5DA880019FDFB9BC1,42151,17,18,1,35,45,1795
40064,40064,21D029E4FB71F3A5DA880019FDFB9BC1,12491,18,23,5,36,43,1843
40065,40065,87268C35D2C26CE8D0D34B26791C8611,41591,3,7,4,34,49,1749
40066,40066,87268C35D2C26CE8D0D34B26791C8611,11541,12,18,6,35,49,1799
40067,40067,87268C35D2C26CE8D0D34B26791C8611,41591,21,23,2,34,49,1749
40068,40068,04C634C0184FBA30D836B55608C77795,40861,0,8,8,34,48,1748
40069,40069,04C634C0184FBA30D836B55608C77795,42401,9,18,9,36,47,1847
40070,40070,04C634C0184FBA30D836B55608C77795,40861,21,22,1,34,48,1748
40083,40083,A0E96E8A9AD818FBF087A431E03695B8,40171,3,6,3,38,48,1948
40084,40084,A0E96E8A9AD818FBF087A431E03695B8,11021,8,17,9,36,49,1849
40085,40085,A0E96E8A9AD818FBF087A431E03695B8,10471,20,22,2,37,48,1898
40086,40086,B4B9EF8B2509C5B7E6B8F05B2AFC5406,10841,8,17,9,37,47,1897
40087,40087,B4B9EF8B2509C5B7E6B8F05B2AFC5406,42401,18,22,4,36,47,1847
40088,40088,B4B9EF8B2509C5B7E6B8F05B2AFC5406,11074,22,23,1,37,47,1897
40089,40089,58D76697ADA80EEB4FEB12BDE4B81C9D,10281,0,6,6,33,48,1698
40090,40090,58D76697ADA80EEB4FEB12BDE4B81C9D,13601,7,9,2,34,47,1747
40091,40091,58D76697ADA80EEB4FEB12BDE4B81C9D,10281,9,23,14,33,48,1698
40097,40097,F0A1BB763F378032A1CC33E7783B3D13,10661,1,3,2,37,49,1899
40098,40098,F0A1BB763F378032A1CC33E7783B3D13,11021,4,17,13,36,49,1849
40099,40099,F0A1BB763F378032A1CC33E7783B3D13,10661,18,19,1,37,49,1899
40100,40100,D236B4AEB858EC1AFE8DA3C2B8D19572,40348,0,12,12,25,49,1299
40101,40101,D236B4AEB858EC1AFE8DA3C2B8D19572,40343,14,21,7,24,49,1249
40102,40102,D236B4AEB858EC1AFE8DA3C2B8D19572,42121,21,23,2,26,49,1349
40114,40114,96056246DD9856C2DDE7E703B0D16D68,10951,2,14,12,29,48,1498
40115,40115,96056246DD9856C2DDE7E703B0D16D68,11381,15,19,4,30,47,1547
40116,40116,96056246DD9856C2DDE7E703B0D16D68,10341,19,23,4,31,47,1597
40123,40123,DC54D7B6B3A8755D5E8D41E92B448DB3,40421,0,2,2,37,48,1898
40124,40124,DC54D7B6B3A8755D5E8D41E92B448DB3,42401,3,4,1,36,47,1847
40125,40125,DC54D7B6B3A8755D5E8D41E92B448DB3,40421,4,7,3,37,48,1898
40126,40126,DC54D7B6B3A8755D5E8D41E92B448DB3,12391,10,21,11,36,49,1849
40130,40130,45E2591DDB181830E886EA4FBDDB1E4F,43761,0,8,8,32,47,1647
40131,40131,45E2591DDB181830E886EA4FBDDB1E4F,10151,9,17,8,34,47,1747
40132,40132,45E2591DDB181830E886EA4FBDDB1E4F,43761,18,20,2,32,47,1647
40139,40139,7ED7D66FEED190B1E9F750E601782159,12121,1,3,2,29,47,1497
40140,40140,7ED7D66FEED190B1E9F750E601782159,13651,5,10,5,30,47,1547
40141,40141,7ED7D66FEED190B1E9F750E601782159,12121,11,12,1,29,47,1497
40142,40142,7ED7D66FEED190B1E9F750E601782159,13651,15,18,3,30,47,1547
40143,40143,2C8716D214A8F24FFDE64347FFFC6CDE,11381,0,4,4,30,47,1547
40144,40144,2C8716D214A8F24FFDE64347FFFC6CDE,11061,4,17,13,29,48,1498
40145,40145,2C8716D214A8F24FFDE64347FFFC6CDE,11381,17,18,1,30,47,1547
40152,40152,27E5652E2BA40D37FBD9A0AA720456AC,42301,0,2,2,36,47,1847
40153,40153,27E5652E2BA40D37FBD9A0AA720456AC,13121,2,15,13,38,46,1946
40154,40154,27E5652E2BA40D37FBD9A0AA720456AC,43241,19,20,1,36,46,1846
40155,40155,64C3ED67BAF61F1BA70E97940F2449B3,11021,0,8,8,36,49,1849
40156,40156,64C3ED67BAF61F1BA70E97940F2449B3,10161,8,10,2,35,49,1799
40157,40157,64C3ED67BAF61F1BA70E97940F2449B3,11021,11,19,8,36,49,1849
40161,40161,7B4E6126570CADEFC5C95EC455FF20E3,11914,1,4,3,37,48,1898
40162,40162,7B4E6126570CADEFC5C95EC455FF20E3,43361,7,8,1,38,48,1948
40163,40163,7B4E6126570CADEFC5C95EC455FF20E3,11914,11,23,12,37,48,1898
40164,40164,5DAE8FB10D3FBEF5B02F98DB4BFD46E9,13711,0,7,7,38,46,1946
40165,40165,5DAE8FB10D3FBEF5B02F98DB4BFD46E9,13911,8,9,1,39,46,1996
40166,40166,5DAE8FB10D3FBEF5B02F98DB4BFD46E9,42231,10,11,1,37,46,1896
40167,40167,5DAE8FB10D3FBEF5B02F98DB4BFD46E9,42351,22,23,1,38,45,1945
40168,40168,D454F61AD8B5A1CBE1E15CE597E2F528,11491,0,6,6,36,47,1847
40169,40169,D454F61AD8B5A1CBE1E15CE597E2F528,11231,8,19,11,37,49,1899
40170,40170,D454F61AD8B5A1CBE1E15CE597E2F528,42301,21,22,1,36,47,1847
40180,40180,EAC1D4A2CA6BC033BCE82C152098CC16,42581,2,4,2,38,48,1948
40181,40181,EAC1D4A2CA6BC033BCE82C152098CC16,11914,6,16,10,37,48,1898
40182,40182,EAC1D4A2CA6BC033BCE82C152098CC16,40171,18,19,1,38,48,1948
40183,40183,EAC1D4A2CA6BC033BCE82C152098CC16,10471,20,23,3,37,48,1898
40187,40187,81DDAE7BB9B21EE23D4D27A04DA468B5,11021,0,12,12,36,49,1849
40188,40188,81DDAE7BB9B21EE23D4D27A04DA468B5,10661,13,17,4,37,49,1899
40189,40189,81DDAE7BB9B21EE23D4D27A04DA468B5,43241,19,20,1,36,46,1846
40190,40190,B400ACFA7232ADC3897E9004784F9482,11261,0,1,1,36,46,1846
40191,40191,B400ACFA7232ADC3897E9004784F9482,12491,2,5,3,36,43,1843
40192,40192,B400ACFA7232ADC3897E9004784F9482,11261,8,19,11,36,46,1846
40193,40193,2D8F7C2E000B799DCADCAEF4A15BB1AE,42471,0,6,6,35,49,1799
40194,40194,2D8F7C2E000B799DCADCAEF4A15BB1AE,11021,19,21,2,36,49,1849
40195,40195,2D8F7C2E000B799DCADCAEF4A15BB1AE,42471,21,23,2,35,49,1799
40196,40196,05B51695B375DD3A2259BF2668AD8716,42161,0,3,3,36,47,1847
40197,40197,05B51695B375DD3A2259BF2668AD8716,11731,3,4,1,36,48,1848
40198,40198,05B51695B375DD3A2259BF2668AD8716,42161,7,22,15,36,47,1847
40199,40199,34A4600E2EBB00DA28DDECA5142B5287,16241,0,7,7,3,3,153
40200,40200,34A4600E2EBB00DA28DDECA5142B5287,16181,7,11,4,4,2,202
40201,40201,34A4600E2EBB00DA28DDECA5142B5287,16241,11,23,12,3,3,153
40202,40202,BF1AC1F102D56BEE1075F47B7B2A8C77,42501,1,6,5,28,47,1447
40203,40203,BF1AC1F102D56BEE1075F47B7B2A8C77,11861,7,18,11,32,47,1647
40204,40204,BF1AC1F102D56BEE1075F47B7B2A8C77,42501,18,20,2,28,47,1447
40213,40213,2ADCF428548E73CC98C7E324C7C8C16C,42491,0,11,11,32,46,1646
40214,40214,2ADCF428548E73CC98C7E324C7C8C16C,42523,14,16,2,31,47,1597
40215,40215,2ADCF428548E73CC98C7E324C7C8C16C,42491,16,17,1,32,46,1646
40216,40216,2ADCF428548E73CC98C7E324C7C8C16C,12131,21,22,1,32,47,1647
40226,40226,BB39D64AF4BA5797CA6434108C1B1053,10681,0,12,12,30,48,1548
40227,40227,BB39D64AF4BA5797CA6434108C1B1053,11061,14,17,3,29,48,1498
40228,40228,BB39D64AF4BA5797CA6434108C1B1053,10681,17,23,6,30,48,1548
40241,40241,1041DD51501D42503CBB8634F6E0E847,10107,0,8,8,38,49,1949
40242,40242,1041DD51501D42503CBB8634F6E0E847,11481,8,16,8,41,48,2098
40243,40243,1041DD51501D42503CBB8634F6E0E847,11551,17,23,6,39,49,1999
40244,40244,2FCEA8AFEE1EB24BBCF386268B1232AC,11161,1,2,1,32,48,1648
40245,40245,2FCEA8AFEE1EB24BBCF386268B1232AC,43311,12,13,1,31,48,1598
40246,40246,2FCEA8AFEE1EB24BBCF386268B1232AC,11061,19,21,2,29,48,1498
40250,40250,1E2BDCE897234CB8450E391543ADF518,42351,8,10,2,38,45,1945
40251,40251,1E2BDCE897234CB8450E391543ADF518,42511,13,16,3,37,47,1897
40252,40252,1E2BDCE897234CB8450E391543ADF518,42231,17,18,1,37,46,1896
40268,40268,00B2DA8947AAAAB43DE6265C0D049D18,11091,4,7,3,29,47,1497
40269,40269,00B2DA8947AAAAB43DE6265C0D049D18,10292,10,11,1,30,47,1547
40270,40270,00B2DA8947AAAAB43DE6265C0D049D18,11091,13,14,1,29,47,1497
40271,40271,00B2DA8947AAAAB43DE6265C0D049D18,11381,18,20,2,30,47,1547
40272,40272,53DE27C3988F5D22526FCC360F8F3A99,11321,1,5,4,31,46,1596
40273,40273,53DE27C3988F5D22526FCC360F8F3A99,42523,7,18,11,31,47,1597
40274,40274,53DE27C3988F5D22526FCC360F8F3A99,11324,19,23,4,31,46,1596
40284,40284,9D3AFAB836497D9B20982A4423B1B10D,11151,0,8,8,30,48,1548
40285,40285,9D3AFAB836497D9B20982A4423B1B10D,11381,8,9,1,30,47,1547
40286,40286,9D3AFAB836497D9B20982A4423B1B10D,10681,10,11,1,30,48,1548
40287,40287,9D3AFAB836497D9B20982A4423B1B10D,11381,15,21,6,30,47,1547
40288,40288,8A2B6A3BBB67F4CA1B157F83176E3E9B,11151,0,7,7,30,48,1548
40289,40289,8A2B6A3BBB67F4CA1B157F83176E3E9B,42831,11,12,1,27,48,1398
40290,40290,8A2B6A3BBB67F4CA1B157F83176E3E9B,11151,16,19,3,30,48,1548
40291,40291,B6B9FD86337BD93E048A74A5E56BF693,10111,0,8,8,37,47,1897
40292,40292,B6B9FD86337BD93E048A74A5E56BF693,11751,10,12,2,35,48,1798
40293,40293,B6B9FD86337BD93E048A74A5E56BF693,40951,12,13,1,36,49,1849
40294,40294,B6B9FD86337BD93E048A74A5E56BF693,10111,16,23,7,37,47,1897
40295,40295,E02F57B26F613B95B8A8C38410D07E2A,42681,0,6,6,24,48,1248
40296,40296,E02F57B26F613B95B8A8C38410D07E2A,42481,9,11,2,22,49,1149
40297,40297,E02F57B26F613B95B8A8C38410D07E2A,42681,14,23,9,24,48,1248
40307,40307,58FF60972C1637520443DC5766A2AB67,13411,0,5,5,49,42,2492
40308,40308,58FF60972C1637520443DC5766A2AB67,43951,6,18,12,49,41,2491
40309,40309,58FF60972C1637520443DC5766A2AB67,13411,21,23,2,49,42,2492
40310,40310,D3F6CC79419CB8E677F2F17C3DF072CD,13121,2,5,3,38,46,1946
40311,40311,D3F6CC79419CB8E677F2F17C3DF072CD,11941,7,19,12,37,46,1896
40312,40312,D3F6CC79419CB8E677F2F17C3DF072CD,13121,21,23,2,38,46,1946
40318,40318,17BFCEDD973B29E8302E2E7670AFE303,10471,7,9,2,37,48,1898
40319,40319,17BFCEDD973B29E8302E2E7670AFE303,11921,9,11,2,38,48,1948
40320,40320,17BFCEDD973B29E8302E2E7670AFE303,10471,12,23,11,37,48,1898
40324,40324,EE10AC6477FFD3D50107E111E624E05D,11171,0,5,5,33,48,1698
40325,40325,EE10AC6477FFD3D50107E111E624E05D,11161,7,14,7,32,48,1648
40326,40326,EE10AC6477FFD3D50107E111E624E05D,10471,14,18,4,37,48,1898
40327,40327,CAC95EFB43F5E49190A4EAC08FB5B4EF,40637,0,4,4,36,47,1847
40328,40328,CAC95EFB43F5E49190A4EAC08FB5B4EF,10251,8,20,12,35,47,1797
40329,40329,CAC95EFB43F5E49190A4EAC08FB5B4EF,10281,21,22,1,33,48,1698
40330,40330,28AE6FF44E8686DC354D2E3DF7700FCC,42461,0,13,13,45,47,2297
40331,40331,28AE6FF44E8686DC354D2E3DF7700FCC,42321,13,16,3,43,47,2197
40332,40332,28AE6FF44E8686DC354D2E3DF7700FCC,42461,19,22,3,45,47,2297
40337,40337,A0C13743AF441FE8099AA940DA71C612,42581,0,5,5,38,48,1948
40338,40338,A0C13743AF441FE8099AA940DA71C612,11914,8,17,9,37,48,1898
40339,40339,A0C13743AF441FE8099AA940DA71C612,42581,19,23,4,38,48,1948
40349,40349,94A66B099C3B286235DEE73BAE7FEB6C,11861,0,10,10,32,47,1647
40350,40350,94A66B099C3B286235DEE73BAE7FEB6C,10281,15,16,1,33,48,1698
40351,40351,94A66B099C3B286235DEE73BAE7FEB6C,11861,16,22,6,32,47,1647
40352,40352,A6F4E0A14DDF72AB1602B3834CD2AC43,11914,0,13,13,37,48,1898
40353,40353,A6F4E0A14DDF72AB1602B3834CD2AC43,43361,16,19,3,38,48,1948
40354,40354,A6F4E0A14DDF72AB1602B3834CD2AC43,11914,21,22,1,37,48,1898
40355,40355,CA846E977C574581372BF484E6107101,11074,1,12,11,37,47,1897
40356,40356,CA846E977C574581372BF484E6107101,13331,12,13,1,38,47,1947
40357,40357,CA846E977C574581372BF484E6107101,11074,13,21,8,37,47,1897
40368,40368,549B8A34E419FBD57213E9641A5E14A7,12121,0,10,10,29,47,1497
40369,40369,549B8A34E419FBD57213E9641A5E14A7,10681,10,20,10,30,48,1548
40370,40370,549B8A34E419FBD57213E9641A5E14A7,11061,21,22,1,29,48,1498
40383,40383,872EA7042E221A40D168D3255557BABA,43761,0,5,5,32,47,1647
40384,40384,872EA7042E221A40D168D3255557BABA,11384,8,9,1,30,47,1547
40385,40385,872EA7042E221A40D168D3255557BABA,43761,11,21,10,32,47,1647
40386,40386,E798B778C510EAE2B47A353D8CC843E2,40961,2,12,10,35,47,1797
40387,40387,E798B778C510EAE2B47A353D8CC843E2,11751,16,17,1,35,48,1798
40388,40388,E798B778C510EAE2B47A353D8CC843E2,12381,19,20,1,32,48,1648
40389,40389,3B0409DBAF33EAE6E983CBE096017943,11811,0,8,8,38,49,1949
40390,40390,3B0409DBAF33EAE6E983CBE096017943,10841,10,17,7,37,47,1897
40391,40391,3B0409DBAF33EAE6E983CBE096017943,11811,21,23,2,38,49,1949
40392,40392,FCF6425DA3F542476DF1F93935C075D8,42581,0,14,14,38,48,1948
40393,40393,FCF6425DA3F542476DF1F93935C075D8,11914,14,17,3,37,48,1898
40394,40394,FCF6425DA3F542476DF1F93935C075D8,42581,17,23,6,38,48,1948
40395,40395,A02E7FCD783D3B9FF6BA938561F51C11,42161,0,6,6,36,47,1847
40396,40396,A02E7FCD783D3B9FF6BA938561F51C11,10251,12,15,3,35,47,1797
40397,40397,A02E7FCD783D3B9FF6BA938561F51C11,42161,20,23,3,36,47,1847
40398,40398,A178FA23835F7340CB9C26A1AEC90741,11324,1,7,6,31,46,1596
40399,40399,A178FA23835F7340CB9C26A1AEC90741,11381,8,13,5,30,47,1547
40400,40400,A178FA23835F7340CB9C26A1AEC90741,11875,13,14,1,30,46,1546
40401,40401,A178FA23835F7340CB9C26A1AEC90741,11381,15,23,8,30,47,1547
40409,40409,3544B9900CDDC16C4606729762F4FE67,11151,0,12,12,30,48,1548
40410,40410,3544B9900CDDC16C4606729762F4FE67,43391,14,15,1,29,48,1498
40411,40411,3544B9900CDDC16C4606729762F4FE67,11151,17,18,1,30,48,1548
40412,40412,D64DF2C2FAB80CB42859AD7194DBB705,11921,0,7,7,38,48,1948
40413,40413,D64DF2C2FAB80CB42859AD7194DBB705,11074,9,15,6,37,47,1897
40414,40414,D64DF2C2FAB80CB42859AD7194DBB705,11921,16,23,7,38,48,1948
40419,40419,FAEDDD1B29EBE8271DF7B0EAB61C34DD,11491,0,1,1,36,47,1847
40420,40420,FAEDDD1B29EBE8271DF7B0EAB61C34DD,41401,1,3,2,37,46,1896
40421,40421,FAEDDD1B29EBE8271DF7B0EAB61C34DD,11491,4,18,14,36,47,1847
40422,40422,FAEDDD1B29EBE8271DF7B0EAB61C34DD,41401,18,20,2,37,46,1896
40432,40432,63A1194DA67A916294F825B4249AD293,42161,0,4,4,36,47,1847
40433,40433,63A1194DA67A916294F825B4249AD293,42351,4,6,2,38,45,1945
40434,40434,63A1194DA67A916294F825B4249AD293,11261,14,17,3,36,46,1846
40435,40435,63A1194DA67A916294F825B4249AD293,42161,21,23,2,36,47,1847
40442,40442,5D123B558F47D2F0257DC9DC15A60AB1,11381,6,10,4,30,47,1547
40443,40443,5D123B558F47D2F0257DC9DC15A60AB1,42521,11,13,2,31,47,1597
40444,40444,5D123B558F47D2F0257DC9DC15A60AB1,13651,14,23,9,30,47,1547
40449,40449,33C1E114C3D832CC53C9AF80A4C6EA55,11074,0,8,8,37,47,1897
40450,40450,33C1E114C3D832CC53C9AF80A4C6EA55,12083,10,12,2,36,49,1849
40451,40451,33C1E114C3D832CC53C9AF80A4C6EA55,11541,12,18,6,35,49,1799
40452,40452,33C1E114C3D832CC53C9AF80A4C6EA55,10841,19,20,1,37,47,1897
40453,40453,7F73A642AA11134206C46BA15C785E40,10295,6,8,2,30,47,1547
40454,40454,7F73A642AA11134206C46BA15C785E40,42521,11,13,2,31,47,1597
40455,40455,7F73A642AA11134206C46BA15C785E40,10295,17,23,6,30,47,1547
40469,40469,A1F76E9AE160B1A2577BA1E3948B2B29,42864,0,14,14,38,44,1944
40470,40470,A1F76E9AE160B1A2577BA1E3948B2B29,11261,14,15,1,36,46,1846
40471,40471,A1F76E9AE160B1A2577BA1E3948B2B29,42861,18,23,5,37,44,1894
40482,40482,E0D41457C8D4504CBCFD58670A0877B7,10634,0,15,15,27,45,1395
40483,40483,E0D41457C8D4504CBCFD58670A0877B7,13671,16,17,1,27,43,1393
40484,40484,E0D41457C8D4504CBCFD58670A0877B7,12311,21,22,1,30,44,1544
40485,40485,51E8861068F901C8E015AE95E3FE760A,42231,0,5,5,37,46,1896
40486,40486,51E8861068F901C8E015AE95E3FE760A,13711,5,16,11,38,46,1946
40487,40487,51E8861068F901C8E015AE95E3FE760A,42231,20,21,1,37,46,1896
40491,40491,C9D665B3C9EBDA06C3FFA7578620C242,13271,0,15,15,41,47,2097
40492,40492,C9D665B3C9EBDA06C3FFA7578620C242,40691,15,16,1,42,48,2148
40493,40493,C9D665B3C9EBDA06C3FFA7578620C242,13941,18,20,2,41,47,2097
40494,40494,C9D665B3C9EBDA06C3FFA7578620C242,12651,21,22,1,43,47,2197
40499,40499,5ED8949BAC5CDF05EDA1019FB7CA4B17,40171,0,6,6,38,48,1948
40500,40500,5ED8949BAC5CDF05EDA1019FB7CA4B17,11811,7,8,1,38,49,1949
40501,40501,5ED8949BAC5CDF05EDA1019FB7CA4B17,10471,11,23,12,37,48,1898
40522,40522,237962DBB18496F2783A3B20C32A525F,11861,0,5,5,32,47,1647
40523,40523,237962DBB18496F2783A3B20C32A525F,11381,9,10,1,30,47,1547
40524,40524,237962DBB18496F2783A3B20C32A525F,42521,13,14,1,31,47,1597
40525,40525,237962DBB18496F2783A3B20C32A525F,11861,19,23,4,32,47,1647
40526,40526,8DCAF37ED3930530D1428017CC321DFA,13601,0,8,8,34,47,1747
40527,40527,8DCAF37ED3930530D1428017CC321DFA,42401,9,10,1,36,47,1847
40528,40528,8DCAF37ED3930530D1428017CC321DFA,10154,10,23,13,33,47,1697
40532,40532,990703A9F6DB38E7CE8B4E2D5CEDFBAD,10471,0,11,11,37,48,1898
40533,40533,990703A9F6DB38E7CE8B4E2D5CEDFBAD,43731,13,15,2,34,47,1747
40534,40534,990703A9F6DB38E7CE8B4E2D5CEDFBAD,10471,15,23,8,37,48,1898
40535,40535,CAB71ABEEBF1083C80884DF4D3D5CD01,10471,0,9,9,37,48,1898
40536,40536,CAB71ABEEBF1083C80884DF4D3D5CD01,10107,11,16,5,38,49,1949
40537,40537,CAB71ABEEBF1083C80884DF4D3D5CD01,10471,17,23,6,37,48,1898
40542,40542,BB44A13BCAB0B022B18D7F4EDDEC4037,11231,0,2,2,37,49,1899
40543,40543,BB44A13BCAB0B022B18D7F4EDDEC4037,42301,2,17,15,36,47,1847
40544,40544,BB44A13BCAB0B022B18D7F4EDDEC4037,11231,20,23,3,37,49,1899
40581,40581,C644771D2D9F4182BC18DB70E907DF2B,42581,1,5,4,38,48,1948
40582,40582,C644771D2D9F4182BC18DB70E907DF2B,11914,6,9,3,37,48,1898
40583,40583,C644771D2D9F4182BC18DB70E907DF2B,42581,11,22,11,38,48,1948
40587,40587,6F947024A8B73B97F8430A4C48FA1DF6,12391,0,7,7,36,49,1849
40588,40588,6F947024A8B73B97F8430A4C48FA1DF6,13741,9,18,9,37,49,1899
40589,40589,6F947024A8B73B97F8430A4C48FA1DF6,12083,22,23,1,36,49,1849
40599,40599,C27CAD921E0A90627C5337FD9A33D6C8,11151,1,7,6,30,48,1548
40600,40600,C27CAD921E0A90627C5337FD9A33D6C8,12311,10,11,1,30,44,1544
40601,40601,C27CAD921E0A90627C5337FD9A33D6C8,11875,11,13,2,30,46,1546
40602,40602,C27CAD921E0A90627C5337FD9A33D6C8,11861,15,22,7,32,47,1647
40609,40609,C8ADEB543E01A2D7ED3A1B441DD7985B,40673,0,14,14,36,48,1848
40610,40610,C8ADEB543E01A2D7ED3A1B441DD7985B,42581,16,18,2,38,48,1948
40611,40611,C8ADEB543E01A2D7ED3A1B441DD7985B,11231,18,23,5,37,49,1899
40619,40619,AA3D7E1DC0C99DC660096C9CD53B9E64,11074,0,15,15,37,47,1897
40620,40620,AA3D7E1DC0C99DC660096C9CD53B9E64,11914,16,19,3,37,48,1898
40621,40621,AA3D7E1DC0C99DC660096C9CD53B9E64,11074,19,21,2,37,47,1897
40628,40628,1788FF83230593384DFEF88881720D90,13551,0,17,17,45,38,2288
40629,40629,1788FF83230593384DFEF88881720D90,43101,17,21,4,46,40,2340
40630,40630,1788FF83230593384DFEF88881720D90,13551,21,22,1,45,38,2288
40635,40635,F7F6E311089E545E2ADE21E1CFF4D206,11861,1,4,3,32,47,1647
40636,40636,F7F6E311089E545E2ADE21E1CFF4D206,42021,4,8,4,33,47,1697
40637,40637,F7F6E311089E545E2ADE21E1CFF4D206,43761,10,18,8,32,47,1647
40638,40638,F7F6E311089E545E2ADE21E1CFF4D206,40636,20,22,2,35,48,1798
40645,40645,BCBB915A68F656D68AA2B85F9E93EB53,11381,0,9,9,30,47,1547
40646,40646,BCBB915A68F656D68AA2B85F9E93EB53,42291,12,14,2,29,48,1498
40647,40647,BCBB915A68F656D68AA2B85F9E93EB53,40381,17,20,3,32,46,1646
40648,40648,BCBB915A68F656D68AA2B85F9E93EB53,11381,21,23,2,30,47,1547
40649,40649,4C3E8C1CDF60EC341D8B9147E6C7B114,10691,0,6,6,33,48,1698
40650,40650,4C3E8C1CDF60EC341D8B9147E6C7B114,42491,7,17,10,32,46,1646
40651,40651,4C3E8C1CDF60EC341D8B9147E6C7B114,10431,18,19,1,33,49,1699
40652,40652,4C3E8C1CDF60EC341D8B9147E6C7B114,10691,20,23,3,33,48,1698
40653,40653,C328A2915A4792A71AC58E7C60675781,40673,8,10,2,36,48,1848
40654,40654,C328A2915A4792A71AC58E7C60675781,11914,11,12,1,37,48,1898
40655,40655,C328A2915A4792A71AC58E7C60675781,40673,15,18,3,36,48,1848
40656,40656,C328A2915A4792A71AC58E7C60675781,11914,19,21,2,37,48,1898
40675,40675,996E78B516B54BE4ADEF09770F316D9D,13341,0,4,4,44,45,2245
40676,40676,996E78B516B54BE4ADEF09770F316D9D,12211,8,9,1,41,44,2094
40677,40677,996E78B516B54BE4ADEF09770F316D9D,13341,12,16,4,44,45,2245
40678,40678,996E78B516B54BE4ADEF09770F316D9D,12211,20,22,2,41,44,2094
40687,40687,3AEA3CF422288C2FFB9C65FD7BE694C9,19931,1,5,4,7,43,393
40688,40688,3AEA3CF422288C2FFB9C65FD7BE694C9,12921,6,10,4,9,41,491
40689,40689,3AEA3CF422288C2FFB9C65FD7BE694C9,19931,15,19,4,7,43,393
40690,40690,3AEA3CF422288C2FFB9C65FD7BE694C9,12921,21,22,1,9,41,491
40691,40691,586F3AD64B483C4FDBF6963F85B66D9A,13271,0,6,6,41,47,2097
40692,40692,586F3AD64B483C4FDBF6963F85B66D9A,42201,18,19,1,43,46,2196
40693,40693,586F3AD64B483C4FDBF6963F85B66D9A,11805,21,23,2,41,48,2098
40694,40694,2EF88513976088C07EC19077B1D8877A,11941,0,7,7,37,46,1896
40695,40695,2EF88513976088C07EC19077B1D8877A,13121,9,18,9,38,46,1946
40696,40696,2EF88513976088C07EC19077B1D8877A,11941,21,23,2,37,46,1896
40697,40697,725F4DF1678770995D2853C4CA844B3D,43761,2,8,6,32,47,1647
40698,40698,725F4DF1678770995D2853C4CA844B3D,11061,12,14,2,29,48,1498
40699,40699,725F4DF1678770995D2853C4CA844B3D,10295,17,18,1,30,47,1547
40700,40700,3717F18D88C40095DBADE8C95C390E6F,42861,9,10,1,37,44,1894
40701,40701,3717F18D88C40095DBADE8C95C390E6F,42151,10,11,1,35,45,1795
40702,40702,3717F18D88C40095DBADE8C95C390E6F,42861,12,19,7,37,44,1894
40703,40703,3717F18D88C40095DBADE8C95C390E6F,42151,21,23,2,35,45,1795
40704,40704,7AB79D926E727A8AEF71F6B1C3F55FB0,42921,0,1,1,33,47,1697
40705,40705,7AB79D926E727A8AEF71F6B1C3F55FB0,43161,1,6,5,35,47,1797
40706,40706,7AB79D926E727A8AEF71F6B1C3F55FB0,10731,6,15,9,33,47,1697
40707,40707,7AB79D926E727A8AEF71F6B1C3F55FB0,10221,18,23,5,34,49,1749
40719,40719,0093840E8B844EFC30056E0D57FB1861,10621,2,15,13,41,49,2099
40720,40720,0093840E8B844EFC30056E0D57FB1861,42321,17,18,1,43,47,2197
40721,40721,0093840E8B844EFC30056E0D57FB1861,11701,19,20,1,43,48,2198
40722,40722,66C0548F02598D44AE0CA78CDFFA7E48,10401,2,7,5,33,49,1699
40723,40723,66C0548F02598D44AE0CA78CDFFA7E48,11954,9,11,2,32,49,1649
40724,40724,66C0548F02598D44AE0CA78CDFFA7E48,10401,13,23,10,33,49,1699
40725,40725,BE4022FD09507A436FA862517AE2A3AD,12521,0,13,13,35,41,1791
40726,40726,BE4022FD09507A436FA862517AE2A3AD,42381,13,14,1,39,41,1991
40727,40727,BE4022FD09507A436FA862517AE2A3AD,43451,14,21,7,37,40,1890
40728,40728,BE4022FD09507A436FA862517AE2A3AD,42381,21,23,2,39,41,1991
40750,40750,31D4ECBF6E20300058A6DBF4B1DCA2FB,42523,0,4,4,31,47,1597
40751,40751,31D4ECBF6E20300058A6DBF4B1DCA2FB,13651,4,14,10,30,47,1547
40752,40752,31D4ECBF6E20300058A6DBF4B1DCA2FB,42491,14,17,3,32,46,1646
40753,40753,31D4ECBF6E20300058A6DBF4B1DCA2FB,13651,17,19,2,30,47,1547
40763,40763,AE65B3A0546214F4AAD15746865FEBCB,10292,0,13,13,30,47,1547
40764,40764,AE65B3A0546214F4AAD15746865FEBCB,12971,15,17,2,32,48,1648
40765,40765,AE65B3A0546214F4AAD15746865FEBCB,10292,20,23,3,30,47,1547
40766,40766,018A1CC117B204501E34F73B68B137CB,42581,3,15,12,38,48,1948
40767,40767,018A1CC117B204501E34F73B68B137CB,11914,17,19,2,37,48,1898
40768,40768,018A1CC117B204501E34F73B68B137CB,42191,20,21,1,38,49,1949
40769,40769,AD24687CE009DD38418E30D2A06E4D4E,10121,0,9,9,36,49,1849
40770,40770,AD24687CE009DD38418E30D2A06E4D4E,11753,11,12,1,35,48,1798
40771,40771,AD24687CE009DD38418E30D2A06E4D4E,10121,17,23,6,36,49,1849
40780,40780,EBCAFED47778B422FDE48CF06630FC82,11001,0,6,6,42,47,2147
40781,40781,EBCAFED47778B422FDE48CF06630FC82,11301,13,16,3,41,49,2099
40782,40782,EBCAFED47778B422FDE48CF06630FC82,11001,20,23,3,42,47,2147
40787,40787,B92E89796812211C5B5F4FA9439F7E3F,11061,7,8,1,29,48,1498
40788,40788,B92E89796812211C5B5F4FA9439F7E3F,43971,8,10,2,30,48,1548
40789,40789,B92E89796812211C5B5F4FA9439F7E3F,11061,10,20,10,29,48,1498
40813,40813,91BDEDAC648767D3A83A88B3F0D48C25,42151,7,11,4,35,45,1795
40814,40814,91BDEDAC648767D3A83A88B3F0D48C25,12491,12,13,1,36,43,1843
40815,40815,91BDEDAC648767D3A83A88B3F0D48C25,42151,15,23,8,35,45,1795
40840,40840,3BE46C14B2CA2CE1D859CAF16A631486,13341,0,1,1,44,45,2245
40841,40841,3BE46C14B2CA2CE1D859CAF16A631486,12561,3,5,2,45,43,2293
40842,40842,3BE46C14B2CA2CE1D859CAF16A631486,13341,5,22,17,44,45,2245
40843,40843,70619C12864537A38240D50CF723CEF7,13111,0,6,6,42,46,2146
40844,40844,70619C12864537A38240D50CF723CEF7,42091,8,10,2,43,46,2196
40845,40845,70619C12864537A38240D50CF723CEF7,13111,11,21,10,42,46,2146
40846,40846,0BAA79890EA0F7AB20060E73BF283A5D,43161,1,8,7,35,47,1797
40847,40847,0BAA79890EA0F7AB20060E73BF283A5D,42161,8,11,3,36,47,1847
40848,40848,0BAA79890EA0F7AB20060E73BF283A5D,43161,12,14,2,35,47,1797
40849,40849,0BAA79890EA0F7AB20060E73BF283A5D,42161,15,23,8,36,47,1847
40866,40866,7BBD15EB45C3F1BA6E572F56B02ABEDA,10841,0,7,7,37,47,1897
40867,40867,7BBD15EB45C3F1BA6E572F56B02ABEDA,12514,10,11,1,38,47,1947
40868,40868,7BBD15EB45C3F1BA6E572F56B02ABEDA,10841,12,23,11,37,47,1897
40883,40883,C7DA09D84BB6D5A3ABEAD976C8C0731E,42861,0,5,5,37,44,1894
40884,40884,C7DA09D84BB6D5A3ABEAD976C8C0731E,11261,6,10,4,36,46,1846
40885,40885,C7DA09D84BB6D5A3ABEAD976C8C0731E,42861,12,22,10,37,44,1894
40894,40894,81E9C3858C44D7DA57E9FCCB87C1B34F,10251,0,8,8,35,47,1797
40895,40895,81E9C3858C44D7DA57E9FCCB87C1B34F,10491,8,11,3,33,48,1698
40896,40896,81E9C3858C44D7DA57E9FCCB87C1B34F,11231,11,14,3,37,49,1899
40897,40897,81E9C3858C44D7DA57E9FCCB87C1B34F,43361,15,18,3,38,48,1948
40898,40898,B8DB030E6F574F75DC469AA0B11A44D5,10531,0,7,7,34,46,1746
40899,40899,B8DB030E6F574F75DC469AA0B11A44D5,42921,9,17,8,33,47,1697
40900,40900,B8DB030E6F574F75DC469AA0B11A44D5,10151,19,23,4,34,47,1747
40904,40904,92E340B82C56A45F91D53CD2B709557E,11914,2,3,1,37,48,1898
40905,40905,92E340B82C56A45F91D53CD2B709557E,42581,4,6,2,38,48,1948
40906,40906,92E340B82C56A45F91D53CD2B709557E,10471,8,17,9,37,48,1898
40907,40907,92E340B82C56A45F91D53CD2B709557E,42581,20,23,3,38,48,1948
40919,40919,07815E504E2AE025D7C40FE3C561B8BA,11074,0,7,7,37,47,1897
40920,40920,07815E504E2AE025D7C40FE3C561B8BA,13221,8,9,1,40,47,2047
40921,40921,07815E504E2AE025D7C40FE3C561B8BA,10601,12,13,1,39,47,1997
40922,40922,07815E504E2AE025D7C40FE3C561B8BA,11074,16,21,5,37,47,1897
40949,40949,C6869A64CA9EF97A25D7192A00726FC2,42401,0,9,9,36,47,1847
40950,40950,C6869A64CA9EF97A25D7192A00726FC2,10781,10,18,8,35,47,1797
40951,40951,C6869A64CA9EF97A25D7192A00726FC2,42401,19,23,4,36,47,1847
40967,40967,078D744FD5840DE4508E7DD5C66617FF,11261,0,11,11,36,46,1846
40968,40968,078D744FD5840DE4508E7DD5C66617FF,42351,14,18,4,38,45,1945
40969,40969,078D744FD5840DE4508E7DD5C66617FF,11261,19,23,4,36,46,1846
40980,40980,283D32F18C3BA6BD8207C085157E283B,12311,0,14,14,30,44,1544
40981,40981,283D32F18C3BA6BD8207C085157E283B,10301,17,19,2,31,45,1595
40982,40982,283D32F18C3BA6BD8207C085157E283B,12311,21,23,2,30,44,1544
40988,40988,E1C859FD8CC74565ED07635B54DBAB6A,43761,3,6,3,32,47,1647
40989,40989,E1C859FD8CC74565ED07635B54DBAB6A,11061,9,18,9,29,48,1498
40990,40990,E1C859FD8CC74565ED07635B54DBAB6A,43761,19,23,4,32,47,1647
40998,40998,44F255EB791E9538C3D1A23F5B6DAF16,13121,0,8,8,38,46,1946
40999,40999,44F255EB791E9538C3D1A23F5B6DAF16,42161,11,14,3,36,47,1847
41000,41000,44F255EB791E9538C3D1A23F5B6DAF16,43161,16,21,5,35,47,1797
41007,41007,E25E47AB022C606F7CB99E3DAFA11216,13121,1,5,4,38,46,1946
41008,41008,E25E47AB022C606F7CB99E3DAFA11216,42511,6,17,11,37,47,1897
41009,41009,E25E47AB022C606F7CB99E3DAFA11216,13121,17,23,6,38,46,1946
41018,41018,2B05CC2BC211341FBD9F6EA8966B4690,11914,3,14,11,37,48,1898
41019,41019,2B05CC2BC211341FBD9F6EA8966B4690,42581,18,20,2,38,48,1948
41020,41020,2B05CC2BC211341FBD9F6EA8966B4690,11914,20,23,3,37,48,1898
41021,41021,55533B9612A041F560AB09E0A0C2A735,10251,0,9,9,35,47,1797
41022,41022,55533B9612A041F560AB09E0A0C2A735,43731,9,22,13,34,47,1747
41023,41023,55533B9612A041F560AB09E0A0C2A735,10251,22,23,1,35,47,1797
41024,41024,8B64A37D8B7B668CCB979C41E8D11439,13791,0,6,6,42,47,2147
41025,41025,8B64A37D8B7B668CCB979C41E8D11439,13371,6,17,11,41,47,2097
41026,41026,8B64A37D8B7B668CCB979C41E8D11439,13791,19,23,4,42,47,2147
41031,41031,6E71207F40ABEC46B7131A267F90969E,19901,0,5,5,7,44,394
41032,41032,6E71207F40ABEC46B7131A267F90969E,19114,8,12,4,7,43,393
41033,41033,6E71207F40ABEC46B7131A267F90969E,12641,12,19,7,10,43,543
41034,41034,6E71207F40ABEC46B7131A267F90969E,19114,19,23,4,7,43,393
41051,41051,AE4A6270CFE8D53376809A1F5BCB61EF,40421,0,3,3,37,48,1898
41052,41052,AE4A6270CFE8D53376809A1F5BCB61EF,11074,7,9,2,37,47,1897
41053,41053,AE4A6270CFE8D53376809A1F5BCB61EF,40421,13,22,9,37,48,1898
41066,41066,F714E7BCDABF2B2F99991B80BC6098B2,19904,1,5,4,9,44,494
41067,41067,F714E7BCDABF2B2F99991B80BC6098B2,12641,6,16,10,10,43,543
41068,41068,F714E7BCDABF2B2F99991B80BC6098B2,19021,16,18,2,10,45,545
41069,41069,F714E7BCDABF2B2F99991B80BC6098B2,19904,20,22,2,9,44,494
41070,41070,31275DFA17969AA9C0A6BD17354AF87F,12311,0,14,14,30,44,1544
41071,41071,31275DFA17969AA9C0A6BD17354AF87F,12661,14,17,3,32,45,1645
41072,41072,31275DFA17969AA9C0A6BD17354AF87F,12311,19,21,2,30,44,1544
41077,41077,05EC089A039EAFCC5C0761E74BD23505,42021,0,7,7,33,47,1697
41078,41078,05EC089A039EAFCC5C0761E74BD23505,11131,8,17,9,33,48,1698
41079,41079,05EC089A039EAFCC5C0761E74BD23505,10731,20,21,1,33,47,1697
41080,41080,05EC089A039EAFCC5C0761E74BD23505,43161,21,22,1,35,47,1797
41081,41081,EAB1206E637968E97F3FFF57BD5C26A6,11521,0,14,14,41,48,2098
41082,41082,EAB1206E637968E97F3FFF57BD5C26A6,42031,16,21,5,40,46,2046
41083,41083,EAB1206E637968E97F3FFF57BD5C26A6,13961,22,23,1,42,48,2148
41087,41087,03FE0D0BD52A528C1B4DF1F3C44F085B,43241,0,4,4,36,46,1846
41088,41088,03FE0D0BD52A528C1B4DF1F3C44F085B,11941,6,8,2,37,46,1896
41089,41089,03FE0D0BD52A528C1B4DF1F3C44F085B,42351,11,12,1,38,45,1945
41090,41090,03FE0D0BD52A528C1B4DF1F3C44F085B,11941,17,19,2,37,46,1896
41097,41097,8476DE1F73F96264B26BFC785A955A1A,11281,10,13,3,27,40,1390
41098,41098,8476DE1F73F96264B26BFC785A955A1A,13671,13,18,5,27,43,1393
41099,41099,8476DE1F73F96264B26BFC785A955A1A,11281,19,21,2,27,40,1390
41100,41100,8476DE1F73F96264B26BFC785A955A1A,13671,21,23,2,27,43,1393
41111,41111,8BA18E97407504A64FBC0BC02C038518,11861,0,15,15,32,47,1647
41112,41112,8BA18E97407504A64FBC0BC02C038518,10281,16,17,1,33,48,1698
41113,41113,8BA18E97407504A64FBC0BC02C038518,11861,18,23,5,32,47,1647
41114,41114,479BB88DD9C776BA69F274C628C53893,13121,0,5,5,38,46,1946
41115,41115,479BB88DD9C776BA69F274C628C53893,10271,7,19,12,37,46,1896
41116,41116,479BB88DD9C776BA69F274C628C53893,13121,19,22,3,38,46,1946
41151,41151,0BA677AEFA1FE879EC9FCA98466C3A1A,11641,0,8,8,22,49,1149
41152,41152,0BA677AEFA1FE879EC9FCA98466C3A1A,42681,8,10,2,24,48,1248
41153,41153,0BA677AEFA1FE879EC9FCA98466C3A1A,11641,10,23,13,22,49,1149
41181,41181,F12F8E00334F113D8D0E1B9B5E5B88ED,19441,0,8,8,8,46,446
41182,41182,F12F8E00334F113D8D0E1B9B5E5B88ED,42041,8,9,1,10,47,547
41183,41183,F12F8E00334F113D8D0E1B9B5E5B88ED,19441,9,20,11,8,46,446
41184,41184,1CD741282378ACECE229BFA3E57C9431,19441,1,12,11,8,46,446
41185,41185,1CD741282378ACECE229BFA3E57C9431,42041,16,17,1,10,47,547
41186,41186,1CD741282378ACECE229BFA3E57C9431,19441,18,20,2,8,46,446
41187,41187,6AF9BC3BC00A2DB4E93E7EFAFF6696BB,43761,2,14,12,32,47,1647
41188,41188,6AF9BC3BC00A2DB4E93E7EFAFF6696BB,40203,14,16,2,33,49,1699
41189,41189,6AF9BC3BC00A2DB4E93E7EFAFF6696BB,10151,18,20,2,34,47,1747
41196,41196,64C897065E9EDCA8A69F38A94EFB9055,10151,0,9,9,34,47,1747
41197,41197,64C897065E9EDCA8A69F38A94EFB9055,11021,9,14,5,36,49,1849
41198,41198,64C897065E9EDCA8A69F38A94EFB9055,10151,17,23,6,34,47,1747
41205,41205,9F07E2341EC43516CD02BDC269F3E6AA,11061,4,5,1,29,48,1498
41206,41206,9F07E2341EC43516CD02BDC269F3E6AA,11381,5,22,17,30,47,1547
41207,41207,9F07E2341EC43516CD02BDC269F3E6AA,11061,22,23,1,29,48,1498
41213,41213,795B19542A85BBCF6E0BEEABCE2E1262,11381,3,5,2,30,47,1547
41214,41214,795B19542A85BBCF6E0BEEABCE2E1262,42501,6,8,2,28,47,1447
41215,41215,795B19542A85BBCF6E0BEEABCE2E1262,10951,13,22,9,29,48,1498
41227,41227,8FABCF9CE3A0C1922B4386B62EDC8AD0,42871,0,7,7,30,45,1545
41228,41228,8FABCF9CE3A0C1922B4386B62EDC8AD0,10301,9,18,9,31,45,1595
41229,41229,8FABCF9CE3A0C1922B4386B62EDC8AD0,42871,22,23,1,30,45,1545
41230,41230,6BC25D943F92E8D81D0DD10A27C42A3A,11381,8,10,2,30,47,1547
41231,41231,6BC25D943F92E8D81D0DD10A27C42A3A,11061,11,12,1,29,48,1498
41232,41232,6BC25D943F92E8D81D0DD10A27C42A3A,10681,13,15,2,30,48,1548
41233,41233,6BC25D943F92E8D81D0DD10A27C42A3A,11381,16,23,7,30,47,1547
41234,41234,AA94328A21E669C14B53998CC009A981,43951,3,6,3,49,41,2491
41235,41235,AA94328A21E669C14B53998CC009A981,13411,11,13,2,49,42,2492
41236,41236,AA94328A21E669C14B53998CC009A981,43951,13,19,6,49,41,2491
41237,41237,F20C6F9EEDC5052A0219DBE6439067E2,11871,0,1,1,29,46,1496
41238,41238,F20C6F9EEDC5052A0219DBE6439067E2,11091,2,3,1,29,47,1497
41239,41239,F20C6F9EEDC5052A0219DBE6439067E2,11871,3,22,19,29,46,1496
41255,41255,6166F4BC9B2530F6FDAD5A0233FBAAD6,42581,3,4,1,38,48,1948
41256,41256,6166F4BC9B2530F6FDAD5A0233FBAAD6,11914,6,20,14,37,48,1898
41257,41257,6166F4BC9B2530F6FDAD5A0233FBAAD6,42581,20,23,3,38,48,1948
41266,41266,859846C23309918FCF7E37DF9FD45D9F,13911,0,14,14,39,46,1996
41267,41267,859846C23309918FCF7E37DF9FD45D9F,42231,17,18,1,37,46,1896
41268,41268,859846C23309918FCF7E37DF9FD45D9F,13911,21,23,2,39,46,1996
41269,41269,65D4345A2D3576315A5C944F8DDA0CFE,42864,0,14,14,38,44,1944
41270,41270,65D4345A2D3576315A5C944F8DDA0CFE,11261,17,18,1,36,46,1846
41271,41271,65D4345A2D3576315A5C944F8DDA0CFE,42864,21,23,2,38,44,1944
41272,41272,48DCE60D429B0B1E7F2F1B7A462BF9BF,42523,0,12,12,31,47,1597
41273,41273,48DCE60D429B0B1E7F2F1B7A462BF9BF,13651,13,18,5,30,47,1547
41274,41274,48DCE60D429B0B1E7F2F1B7A462BF9BF,42523,18,19,1,31,47,1597
41275,41275,63407EB936631E067EBCB2C7C7D38F7B,13601,0,8,8,34,47,1747
41276,41276,63407EB936631E067EBCB2C7C7D38F7B,10731,10,18,8,33,47,1697
41277,41277,63407EB936631E067EBCB2C7C7D38F7B,13601,21,23,2,34,47,1747
41278,41278,3C4F290E088B2251F5A11549B4DEDAFC,42511,0,6,6,37,47,1897
41279,41279,3C4F290E088B2251F5A11549B4DEDAFC,40123,7,18,11,38,47,1947
41280,41280,3C4F290E088B2251F5A11549B4DEDAFC,10191,19,21,2,40,48,2048
41281,41281,36E4D456967ADF7C503C23EAE8460AAD,42523,7,8,1,31,47,1597
41282,41282,36E4D456967ADF7C503C23EAE8460AAD,13651,13,14,1,30,47,1547
41283,41283,36E4D456967ADF7C503C23EAE8460AAD,42523,14,18,4,31,47,1597
41284,41284,36E4D456967ADF7C503C23EAE8460AAD,13651,18,19,1,30,47,1547
41285,41285,5BF45B486C4CF16F8A7FCFB6A5FB4FA5,12381,0,7,7,32,48,1648
41286,41286,5BF45B486C4CF16F8A7FCFB6A5FB4FA5,10251,8,18,10,35,47,1797
41287,41287,5BF45B486C4CF16F8A7FCFB6A5FB4FA5,10611,21,23,2,32,48,1648
41294,41294,005153E0FE31F466A837EBBB771B5AC5,10951,4,13,9,29,48,1498
41295,41295,005153E0FE31F466A837EBBB771B5AC5,11381,17,18,1,30,47,1547
41296,41296,005153E0FE31F466A837EBBB771B5AC5,10951,20,23,3,29,48,1498
41301,41301,F50EBF656A1E4E39FE103C10C9308636,11861,0,7,7,32,47,1647
41302,41302,F50EBF656A1E4E39FE103C10C9308636,10431,8,14,6,33,49,1699
41303,41303,F50EBF656A1E4E39FE103C10C9308636,42141,18,23,5,32,47,1647
41304,41304,6460FC216A34C188FE4998AEEFF35C56,43451,3,9,6,37,40,1890
41305,41305,6460FC216A34C188FE4998AEEFF35C56,12521,10,12,2,35,41,1791
41306,41306,6460FC216A34C188FE4998AEEFF35C56,43451,12,16,4,37,40,1890
41307,41307,6460FC216A34C188FE4998AEEFF35C56,12521,19,21,2,35,41,1791
41319,41319,0A27EAE690B1EA20001899CE496B6598,19744,2,10,8,6,43,343
41320,41320,0A27EAE690B1EA20001899CE496B6598,12641,13,19,6,10,43,543
41321,41321,0A27EAE690B1EA20001899CE496B6598,19744,20,22,2,6,43,343
41325,41325,66026EF77CBEF7186A8C71238274BA4B,10681,0,9,9,30,48,1548
41326,41326,66026EF77CBEF7186A8C71238274BA4B,11061,10,13,3,29,48,1498
41327,41327,66026EF77CBEF7186A8C71238274BA4B,42521,13,15,2,31,47,1597
41328,41328,66026EF77CBEF7186A8C71238274BA4B,10681,17,21,4,30,48,1548
41332,41332,3202A7F9C47E4AF3E4587FA7438FD62F,10811,0,7,7,38,46,1946
41333,41333,3202A7F9C47E4AF3E4587FA7438FD62F,11261,12,14,2,36,46,1846
41334,41334,3202A7F9C47E4AF3E4587FA7438FD62F,10811,15,21,6,38,46,1946
41335,41335,4EE5C60035D807126AEE0DC0CD563832,42581,1,14,13,38,48,1948
41336,41336,4EE5C60035D807126AEE0DC0CD563832,11914,17,18,1,37,48,1898
41337,41337,4EE5C60035D807126AEE0DC0CD563832,42581,21,22,1,38,48,1948
41367,41367,D01D236B816B958BA0840FB83B5A7890,13711,10,12,2,38,46,1946
41368,41368,D01D236B816B958BA0840FB83B5A7890,10271,15,16,1,37,46,1896
41369,41369,D01D236B816B958BA0840FB83B5A7890,13711,17,19,2,38,46,1946
41370,41370,D01D236B816B958BA0840FB83B5A7890,42331,21,23,2,39,46,1996
41371,41371,00E229D5017B589CE7FFE9861CCFAEEA,42011,0,7,7,36,46,1846
41372,41372,00E229D5017B589CE7FFE9861CCFAEEA,13121,12,13,1,38,46,1946
41373,41373,00E229D5017B589CE7FFE9861CCFAEEA,43241,14,22,8,36,46,1846
41386,41386,60B3904EE9AFD7C630994F95D4C927AC,11231,0,2,2,37,49,1899
41387,41387,60B3904EE9AFD7C630994F95D4C927AC,40925,3,4,1,35,49,1799
41388,41388,60B3904EE9AFD7C630994F95D4C927AC,13561,5,23,18,37,49,1899
41389,41389,674739CE22833F185CB01F6007DDCCC0,11021,3,4,1,36,49,1849
41390,41390,674739CE22833F185CB01F6007DDCCC0,40271,8,9,1,35,49,1799
41391,41391,674739CE22833F185CB01F6007DDCCC0,11021,9,10,1,36,49,1849
41392,41392,674739CE22833F185CB01F6007DDCCC0,42471,13,22,9,35,49,1799
41397,41397,D1DB6120B128D9B18D49ED97832CD7DC,11261,0,5,5,36,46,1846
41398,41398,D1DB6120B128D9B18D49ED97832CD7DC,13911,7,9,2,39,46,1996
41399,41399,D1DB6120B128D9B18D49ED97832CD7DC,11261,10,21,11,36,46,1846
41405,41405,E313A3FC46307A9F2F9C66DB55A7DB7F,11914,0,6,6,37,48,1898
41406,41406,E313A3FC46307A9F2F9C66DB55A7DB7F,40171,8,15,7,38,48,1948
41407,41407,E313A3FC46307A9F2F9C66DB55A7DB7F,11914,15,23,8,37,48,1898
41408,41408,EE6B8585E25BB845D2DA0A95F88FAB79,13911,6,10,4,39,46,1996
41409,41409,EE6B8585E25BB845D2DA0A95F88FAB79,42231,11,19,8,37,46,1896
41410,41410,EE6B8585E25BB845D2DA0A95F88FAB79,42351,22,23,1,38,45,1945
41411,41411,5C087BE097BD7C65E07DEF266C8D9DC9,43731,2,4,2,34,47,1747
41412,41412,5C087BE097BD7C65E07DEF266C8D9DC9,42161,5,6,1,36,47,1847
41413,41413,5C087BE097BD7C65E07DEF266C8D9DC9,43731,10,12,2,34,47,1747
41414,41414,5C087BE097BD7C65E07DEF266C8D9DC9,42161,16,18,2,36,47,1847
41415,41415,6EB93CCAB2222C7D454DB87232E2BFCB,43181,2,4,2,39,48,1998
41416,41416,6EB93CCAB2222C7D454DB87232E2BFCB,11914,4,6,2,37,48,1898
41417,41417,6EB93CCAB2222C7D454DB87232E2BFCB,10931,6,18,12,41,48,2098
41418,41418,6EB93CCAB2222C7D454DB87232E2BFCB,11914,21,23,2,37,48,1898
41431,41431,34460EAE07C3CF26D59119C1F819471C,12131,0,7,7,32,47,1647
41432,41432,34460EAE07C3CF26D59119C1F819471C,11381,7,13,6,30,47,1547
41433,41433,34460EAE07C3CF26D59119C1F819471C,12381,19,21,2,32,48,1648
41434,41434,34460EAE07C3CF26D59119C1F819471C,12131,22,23,1,32,47,1647
41440,41440,11C499CF4C5502A8BD8FCB899394C650,10121,0,6,6,36,49,1849
41441,41441,11C499CF4C5502A8BD8FCB899394C650,13561,7,9,2,37,49,1899
41442,41442,11C499CF4C5502A8BD8FCB899394C650,10121,9,23,14,36,49,1849
41448,41448,15D46EC570105A948AAA5BD130B0DCB7,10111,0,12,12,37,47,1897
41449,41449,15D46EC570105A948AAA5BD130B0DCB7,42161,13,18,5,36,47,1847
41450,41450,15D46EC570105A948AAA5BD130B0DCB7,10111,19,23,4,37,47,1897
41459,41459,81C7B7CEB06954770CA2C889DCC58FC5,42141,0,19,19,32,47,1647
41460,41460,81C7B7CEB06954770CA2C889DCC58FC5,11161,20,21,1,32,48,1648
41461,41461,81C7B7CEB06954770CA2C889DCC58FC5,42141,22,23,1,32,47,1647
41473,41473,FDF3A555382668B3FCFD730AFF8664D2,10411,0,8,8,36,48,1848
41474,41474,FDF3A555382668B3FCFD730AFF8664D2,11231,10,16,6,37,49,1899
41475,41475,FDF3A555382668B3FCFD730AFF8664D2,10411,18,23,5,36,48,1848
41476,41476,4F8B7BBA258CD1F67D426A660E7D36AD,11381,0,6,6,30,47,1547
41477,41477,4F8B7BBA258CD1F67D426A660E7D36AD,11061,7,13,6,29,48,1498
41478,41478,4F8B7BBA258CD1F67D426A660E7D36AD,11954,17,18,1,32,49,1649
41479,41479,4F8B7BBA258CD1F67D426A660E7D36AD,11381,20,22,2,30,47,1547
41486,41486,EAAB672210C677BA2879CCE67BDB7DF5,11151,0,5,5,30,48,1548
41487,41487,EAAB672210C677BA2879CCE67BDB7DF5,42831,6,8,2,27,48,1398
41488,41488,EAAB672210C677BA2879CCE67BDB7DF5,11151,11,23,12,30,48,1548
41489,41489,95DB3946E88F7B999F0F025B61C989DE,43241,3,5,2,36,46,1846
41490,41490,95DB3946E88F7B999F0F025B61C989DE,13711,5,15,10,38,46,1946
41491,41491,95DB3946E88F7B999F0F025B61C989DE,42861,15,17,2,37,44,1894
41492,41492,95DB3946E88F7B999F0F025B61C989DE,11941,18,20,2,37,46,1896
41493,41493,0E7262AB05FEE95538206F690BF1ED85,12121,2,7,5,29,47,1497
41494,41494,0E7262AB05FEE95538206F690BF1ED85,10951,12,14,2,29,48,1498
41495,41495,0E7262AB05FEE95538206F690BF1ED85,11381,16,22,6,30,47,1547
41496,41496,F36A9C530F88290C9D611D428C0B8F3A,11021,0,7,7,36,49,1849
41497,41497,F36A9C530F88290C9D611D428C0B8F3A,40261,9,11,2,35,49,1799
41498,41498,F36A9C530F88290C9D611D428C0B8F3A,11021,12,19,7,36,49,1849
41508,41508,DE7BE47E05724D2B7B84051451E0119E,42161,0,1,1,36,47,1847
41509,41509,DE7BE47E05724D2B7B84051451E0119E,11261,2,9,7,36,46,1846
41510,41510,DE7BE47E05724D2B7B84051451E0119E,10111,12,23,11,37,47,1897
41511,41511,DB020001015A5B58B041C450BD45A3E6,11381,0,9,9,30,47,1547
41512,41512,DB020001015A5B58B041C450BD45A3E6,10951,13,14,1,29,48,1498
41513,41513,DB020001015A5B58B041C450BD45A3E6,42501,18,20,2,28,47,1447
41517,41517,6197D1F5F199B2AF14F376E050B6EC88,10107,0,8,8,38,49,1949
41518,41518,6197D1F5F199B2AF14F376E050B6EC88,11231,9,19,10,37,49,1899
41519,41519,6197D1F5F199B2AF14F376E050B6EC88,10107,20,23,3,38,49,1949
41520,41520,7E03092DEE367172A9BC29A7D77B903A,10611,0,9,9,32,48,1648
41521,41521,7E03092DEE367172A9BC29A7D77B903A,42021,13,14,1,33,47,1697
41522,41522,7E03092DEE367172A9BC29A7D77B903A,10491,19,20,1,33,48,1698
41523,41523,7E03092DEE367172A9BC29A7D77B903A,10611,21,23,2,32,48,1648
41524,41524,CDB8954535B1E24855DD1CA6D51F5A16,11321,0,7,7,31,46,1596
41525,41525,CDB8954535B1E24855DD1CA6D51F5A16,42021,11,12,1,33,47,1697
41526,41526,CDB8954535B1E24855DD1CA6D51F5A16,13601,16,17,1,34,47,1747
41527,41527,CDB8954535B1E24855DD1CA6D51F5A16,11321,21,23,2,31,46,1596
41528,41528,B362B5E77BA1E28CC69DD6493B38125B,42511,0,8,8,37,47,1897
41529,41529,B362B5E77BA1E28CC69DD6493B38125B,13331,9,11,2,38,47,1947
41530,41530,B362B5E77BA1E28CC69DD6493B38125B,42511,12,13,1,37,47,1897
41531,41531,B362B5E77BA1E28CC69DD6493B38125B,13331,14,20,6,38,47,1947
41536,41536,8820D655222FFDC13E2E08EC252AACD5,42161,0,9,9,36,47,1847
41537,41537,8820D655222FFDC13E2E08EC252AACD5,10971,9,19,10,35,47,1797
41538,41538,8820D655222FFDC13E2E08EC252AACD5,42161,21,23,2,36,47,1847
41539,41539,A4BC16FDE84BA1A928A7C6E482678E7C,10634,0,5,5,27,45,1395
41540,41540,A4BC16FDE84BA1A928A7C6E482678E7C,10351,6,7,1,28,45,1445
41541,41541,A4BC16FDE84BA1A928A7C6E482678E7C,10634,11,22,11,27,45,1395
41550,41550,EC8D784C19C185B8F2C30A9ECA831652,13911,0,4,4,39,46,1996
41551,41551,EC8D784C19C185B8F2C30A9ECA831652,12211,4,6,2,41,44,2094
41552,41552,EC8D784C19C185B8F2C30A9ECA831652,11261,6,18,12,36,46,1846
41553,41553,EC8D784C19C185B8F2C30A9ECA831652,13911,19,20,1,39,46,1996
41562,41562,E528C1BCF7730647027A4A7EFB058975,42631,0,7,7,43,45,2195
41563,41563,E528C1BCF7730647027A4A7EFB058975,13341,7,12,5,44,45,2245
41564,41564,E528C1BCF7730647027A4A7EFB058975,43061,12,16,4,43,46,2196
41565,41565,E528C1BCF7730647027A4A7EFB058975,42631,17,19,2,43,45,2195
41566,41566,DC7EAE7EECE01D707EFD944E26B57A96,40421,0,7,7,37,48,1898
41567,41567,DC7EAE7EECE01D707EFD944E26B57A96,11074,7,12,5,37,47,1897
41568,41568,DC7EAE7EECE01D707EFD944E26B57A96,40421,14,16,2,37,48,1898
41569,41569,DC7EAE7EECE01D707EFD944E26B57A96,11074,18,23,5,37,47,1897
41587,41587,007883C4896DAF2F56308DBC4E144D6F,42921,0,7,7,33,47,1697
41588,41588,007883C4896DAF2F56308DBC4E144D6F,12381,8,17,9,32,48,1648
41589,41589,007883C4896DAF2F56308DBC4E144D6F,42921,20,23,3,33,47,1697
41595,41595,27B730B7822AB6D4A174BB8FC85850AF,10295,1,7,6,30,47,1547
41596,41596,27B730B7822AB6D4A174BB8FC85850AF,42491,8,13,5,32,46,1646
41597,41597,27B730B7822AB6D4A174BB8FC85850AF,10341,14,22,8,31,47,1597
41598,41598,CD2585849A7FE9163559CFCE38246D6F,10681,0,7,7,30,48,1548
41599,41599,CD2585849A7FE9163559CFCE38246D6F,40331,8,14,6,30,47,1547
41600,41600,CD2585849A7FE9163559CFCE38246D6F,11061,18,21,3,29,48,1498
41601,41601,079E309E76444CFA74DEE7817C8EB0DE,10521,0,6,6,41,47,2097
41602,41602,079E309E76444CFA74DEE7817C8EB0DE,42201,7,10,3,43,46,2196
41603,41603,079E309E76444CFA74DEE7817C8EB0DE,10521,12,22,10,41,47,2097
41613,41613,909FE24282032BE2FFBF86A121DA90F1,10471,0,9,9,37,48,1898
41614,41614,909FE24282032BE2FFBF86A121DA90F1,11541,12,14,2,35,49,1799
41615,41615,909FE24282032BE2FFBF86A121DA90F1,10471,16,23,7,37,48,1898
41616,41616,0A501EA010779C8F9EB8C2F8834C3F4F,10301,5,6,1,31,45,1595
41617,41617,0A501EA010779C8F9EB8C2F8834C3F4F,10351,9,11,2,28,45,1445
41618,41618,0A501EA010779C8F9EB8C2F8834C3F4F,10301,12,13,1,31,45,1595
41619,41619,0A501EA010779C8F9EB8C2F8834C3F4F,10351,17,18,1,28,45,1445
41623,41623,7A89F90274317B23FC53152227A2C065,49201,0,5,5,7,41,391
41624,41624,7A89F90274317B23FC53152227A2C065,12921,6,7,1,9,41,491
41625,41625,7A89F90274317B23FC53152227A2C065,49201,7,19,12,7,41,391
41626,41626,A26526FCE25758DA240C3B314B205E8A,19024,0,6,6,9,45,495
41627,41627,A26526FCE25758DA240C3B314B205E8A,19114,8,15,7,7,43,393
41628,41628,A26526FCE25758DA240C3B314B205E8A,19024,20,23,3,9,45,495
41632,41632,FE157E2906F39F22EFF42EFD9B7DC358,11381,0,11,11,30,47,1547
41633,41633,FE157E2906F39F22EFF42EFD9B7DC358,11061,12,15,3,29,48,1498
41634,41634,FE157E2906F39F22EFF42EFD9B7DC358,11381,16,23,7,30,47,1547
41638,41638,CC8BB02540EA07EFAAED4BE50A02D87B,10271,0,15,15,37,46,1896
41639,41639,CC8BB02540EA07EFAAED4BE50A02D87B,13711,19,20,1,38,46,1946
41640,41640,CC8BB02540EA07EFAAED4BE50A02D87B,10271,20,22,2,37,46,1896
41648,41648,5CBB3BFC4ED61841A41A893768B01036,13911,0,5,5,39,46,1996
41649,41649,5CBB3BFC4ED61841A41A893768B01036,11261,9,21,12,36,46,1846
41650,41650,5CBB3BFC4ED61841A41A893768B01036,13911,22,23,1,39,46,1996
41658,41658,CC9D6055E50B8BEAE50E7B56B0FCD1E7,10471,0,9,9,37,48,1898
41659,41659,CC9D6055E50B8BEAE50E7B56B0FCD1E7,12021,16,20,4,37,49,1899
41660,41660,CC9D6055E50B8BEAE50E7B56B0FCD1E7,10471,21,23,2,37,48,1898
41661,41661,1034142F75291CE14678BFA41218477C,11231,1,4,3,37,49,1899
41662,41662,1034142F75291CE14678BFA41218477C,12083,5,6,1,36,49,1849
41663,41663,1034142F75291CE14678BFA41218477C,42961,7,8,1,35,49,1799
41664,41664,1034142F75291CE14678BFA41218477C,11231,10,22,12,37,49,1899
41665,41665,A584DB5FF6EE02AE16BAE873BBEDDAA1,12921,0,7,7,9,41,491
41666,41666,A584DB5FF6EE02AE16BAE873BBEDDAA1,12641,9,10,1,10,43,543
41667,41667,A584DB5FF6EE02AE16BAE873BBEDDAA1,12921,10,19,9,9,41,491
41673,41673,14C205DF57BD0AA586E26BE4ED695846,42581,0,10,10,38,48,1948
41674,41674,14C205DF57BD0AA586E26BE4ED695846,11914,10,11,1,37,48,1898
41675,41675,14C205DF57BD0AA586E26BE4ED695846,42581,12,20,8,38,48,1948
41676,41676,15BA009B68D87958E0A9656ADB01E7D6,42371,0,9,9,34,46,1746
41677,41677,15BA009B68D87958E0A9656ADB01E7D6,10511,10,14,4,35,46,1796
41678,41678,15BA009B68D87958E0A9656ADB01E7D6,42491,15,17,2,32,46,1646
41679,41679,15BA009B68D87958E0A9656ADB01E7D6,10511,17,19,2,35,46,1796
41680,41680,08B76115004F6EB3AEFC7DEF1A1E7865,42161,0,1,1,36,47,1847
41681,41681,08B76115004F6EB3AEFC7DEF1A1E7865,10251,3,19,16,35,47,1797
41682,41682,08B76115004F6EB3AEFC7DEF1A1E7865,40637,19,22,3,36,47,1847
41688,41688,576CE5376F585B527BE021172C69A2B2,42471,0,15,15,35,49,1799
41689,41689,576CE5376F585B527BE021172C69A2B2,40171,15,17,2,38,48,1948
41690,41690,576CE5376F585B527BE021172C69A2B2,42471,18,21,3,35,49,1799
41691,41691,FC3B8910035FE6AFFCEFAAF1A5BD46D7,10471,0,9,9,37,48,1898
41692,41692,FC3B8910035FE6AFFCEFAAF1A5BD46D7,42191,10,12,2,38,49,1949
41693,41693,FC3B8910035FE6AFFCEFAAF1A5BD46D7,11271,15,23,8,37,48,1898
41694,41694,3C5BF8354C7B22C00BFA5438C070BC0F,13711,0,9,9,38,46,1946
41695,41695,3C5BF8354C7B22C00BFA5438C070BC0F,43241,9,11,2,36,46,1846
41696,41696,3C5BF8354C7B22C00BFA5438C070BC0F,13711,11,21,10,38,46,1946
41706,41706,D75859C5199E26E4E069299921FEC112,42921,1,8,7,33,47,1697
41707,41707,D75859C5199E26E4E069299921FEC112,43761,9,14,5,32,47,1647
41708,41708,D75859C5199E26E4E069299921FEC112,42921,15,20,5,33,47,1697
41709,41709,D75859C5199E26E4E069299921FEC112,43761,20,22,2,32,47,1647
41710,41710,227550B71384889A67AC4E901F7C17A1,10151,0,11,11,34,47,1747
41711,41711,227550B71384889A67AC4E901F7C17A1,11861,13,17,4,32,47,1647
41712,41712,227550B71384889A67AC4E901F7C17A1,10151,19,23,4,34,47,1747
41713,41713,214185BB061E179DA7C528A208CA1EA2,42501,0,11,11,28,47,1447
41714,41714,214185BB061E179DA7C528A208CA1EA2,12121,12,13,1,29,47,1497
41715,41715,214185BB061E179DA7C528A208CA1EA2,43761,16,18,2,32,47,1647
41716,41716,09F64A9A641B3F2B92615DE97B925264,10351,3,7,4,28,45,1445
41717,41717,09F64A9A641B3F2B92615DE97B925264,10634,8,11,3,27,45,1395
41718,41718,09F64A9A641B3F2B92615DE97B925264,10351,13,23,10,28,45,1445
41725,41725,EA7259828C59286A0C8476F89AAE54B8,11261,6,9,3,36,46,1846
41726,41726,EA7259828C59286A0C8476F89AAE54B8,42351,9,10,1,38,45,1945
41727,41727,EA7259828C59286A0C8476F89AAE54B8,11261,11,18,7,36,46,1846
41733,41733,4092C0011A7A7F2831696C3518280DE8,42221,2,4,2,38,48,1948
41734,41734,4092C0011A7A7F2831696C3518280DE8,13101,7,11,4,40,47,2047
41735,41735,4092C0011A7A7F2831696C3518280DE8,11481,15,18,3,41,48,2098
41739,41739,0E002027D741B8AED4EE58E469659344,10501,0,4,4,22,46,1146
41740,41740,0E002027D741B8AED4EE58E469659344,12601,6,15,9,25,47,1297
41741,41741,0E002027D741B8AED4EE58E469659344,10061,17,19,2,20,46,1046
41742,41742,0E002027D741B8AED4EE58E469659344,12601,20,23,3,25,47,1297
41761,41761,C619BC39ADD64D285F289B032026DA59,10841,2,8,6,37,47,1897
41762,41762,C619BC39ADD64D285F289B032026DA59,42231,10,16,6,37,46,1896
41763,41763,C619BC39ADD64D285F289B032026DA59,10841,19,20,1,37,47,1897
41764,41764,9C819019C9FBB04766CC6EE29C66CE0E,42401,0,1,1,36,47,1847
41765,41765,9C819019C9FBB04766CC6EE29C66CE0E,10111,1,10,9,37,47,1897
41766,41766,9C819019C9FBB04766CC6EE29C66CE0E,40673,12,16,4,36,48,1848
41767,41767,9C819019C9FBB04766CC6EE29C66CE0E,10111,18,23,5,37,47,1897
41768,41768,246B9DA3EFDA0E64D291387D5A19302A,19931,10,12,2,7,43,393
41769,41769,246B9DA3EFDA0E64D291387D5A19302A,12641,14,15,1,10,43,543
41770,41770,246B9DA3EFDA0E64D291387D5A19302A,19114,19,20,1,7,43,393
41776,41776,A18BBFB8111CE9788BEEE3B918FD7EDC,42941,0,7,7,37,47,1897
41777,41777,A18BBFB8111CE9788BEEE3B918FD7EDC,10411,8,16,8,36,48,1848
41778,41778,A18BBFB8111CE9788BEEE3B918FD7EDC,42941,21,22,1,37,47,1897
41784,41784,3B9989389C2FB72384F3330F9A990AB0,13911,0,6,6,39,46,1996
41785,41785,3B9989389C2FB72384F3330F9A990AB0,42231,6,19,13,37,46,1896
41786,41786,3B9989389C2FB72384F3330F9A990AB0,13911,21,22,1,39,46,1996
41787,41787,8721A90F0F0902926D0D708FD844AAE9,11921,0,8,8,38,48,1948
41788,41788,8721A90F0F0902926D0D708FD844AAE9,11914,8,9,1,37,48,1898
41789,41789,8721A90F0F0902926D0D708FD844AAE9,42221,13,20,7,38,48,1948
41790,41790,E16566CAC1D2263C830A92E3D7A4B3A9,42351,0,4,4,38,45,1945
41791,41791,E16566CAC1D2263C830A92E3D7A4B3A9,42231,5,16,11,37,46,1896
41792,41792,E16566CAC1D2263C830A92E3D7A4B3A9,42351,18,19,1,38,45,1945
41793,41793,B53C313F28E9C152305715765AEEF04B,42151,0,14,14,35,45,1795
41794,41794,B53C313F28E9C152305715765AEEF04B,42861,14,15,1,37,44,1894
41795,41795,B53C313F28E9C152305715765AEEF04B,42151,15,19,4,35,45,1795
41796,41796,B53C313F28E9C152305715765AEEF04B,42861,20,21,1,37,44,1894
41797,41797,BE3AECD016F8A1FBFAF949C87F9A7762,19441,3,4,1,8,46,446
41798,41798,BE3AECD016F8A1FBFAF949C87F9A7762,42041,8,9,1,10,47,547
41799,41799,BE3AECD016F8A1FBFAF949C87F9A7762,19441,12,19,7,8,46,446
41800,41800,BE3AECD016F8A1FBFAF949C87F9A7762,42041,22,23,1,10,47,547
41805,41805,ACB823DB33D22CC4344D979C1DDF92F4,42861,4,10,6,37,44,1894
41806,41806,ACB823DB33D22CC4344D979C1DDF92F4,11261,11,12,1,36,46,1846
41807,41807,ACB823DB33D22CC4344D979C1DDF92F4,42861,15,17,2,37,44,1894
41808,41808,ACB823DB33D22CC4344D979C1DDF92F4,11261,18,20,2,36,46,1846
41820,41820,C6A8E88AF4FAB8E3B900B709C1644500,40673,0,7,7,36,48,1848
41821,41821,C6A8E88AF4FAB8E3B900B709C1644500,41591,15,16,1,34,49,1749
41822,41822,C6A8E88AF4FAB8E3B900B709C1644500,10251,20,23,3,35,47,1797
41826,41826,09772B9B7A41227D3BC5A618E4F7F229,10521,1,16,15,41,47,2097
41827,41827,09772B9B7A41227D3BC5A618E4F7F229,12514,18,19,1,38,47,1947
41828,41828,09772B9B7A41227D3BC5A618E4F7F229,13941,20,21,1,41,47,2097
41829,41829,3BA5FA710EA7575C057415E520D57C01,10111,0,1,1,37,47,1897
41830,41830,3BA5FA710EA7575C057415E520D57C01,42191,1,4,3,38,49,1949
41831,41831,3BA5FA710EA7575C057415E520D57C01,10111,4,18,14,37,47,1897
41832,41832,3BA5FA710EA7575C057415E520D57C01,43281,21,23,2,37,48,1898
41833,41833,3FBA130DE96D19DDB92B7C1710211CF0,10611,0,7,7,32,48,1648
41834,41834,3FBA130DE96D19DDB92B7C1710211CF0,10251,7,15,8,35,47,1797
41835,41835,3FBA130DE96D19DDB92B7C1710211CF0,10611,17,23,6,32,48,1648
41836,41836,AA71E9A6AEA764D2564D532D0321512B,42041,2,13,11,10,47,547
41837,41837,AA71E9A6AEA764D2564D532D0321512B,19441,15,17,2,8,46,446
41838,41838,AA71E9A6AEA764D2564D532D0321512B,42041,18,22,4,10,47,547
41856,41856,43DBC097DABD3DD07A95B28C32F20D40,13371,0,14,14,41,47,2097
41857,41857,43DBC097DABD3DD07A95B28C32F20D40,11661,15,16,1,40,49,2049
41858,41858,43DBC097DABD3DD07A95B28C32F20D40,13371,18,23,5,41,47,2097
41862,41862,8420BC80E057341A3D646D0572754A34,11074,0,6,6,37,47,1897
41863,41863,8420BC80E057341A3D646D0572754A34,10531,11,13,2,34,46,1746
41864,41864,8420BC80E057341A3D646D0572754A34,10841,15,17,2,37,47,1897
41865,41865,8420BC80E057341A3D646D0572754A34,13371,18,19,1,41,47,2097
41866,41866,AFF2B1944207762129EB0E25C3502ADB,13711,0,13,13,38,46,1946
41867,41867,AFF2B1944207762129EB0E25C3502ADB,11941,14,15,1,37,46,1896
41868,41868,AFF2B1944207762129EB0E25C3502ADB,13711,16,23,7,38,46,1946
41869,41869,F5C1BE202F75E1C698FE38620F315458,10921,2,8,6,43,48,2198
41870,41870,F5C1BE202F75E1C698FE38620F315458,42601,9,10,1,44,48,2248
41871,41871,F5C1BE202F75E1C698FE38620F315458,10921,15,23,8,43,48,2198
41872,41872,10D4ECB5748779C9E514DAF1CC0CDD65,11861,0,10,10,32,47,1647
41873,41873,10D4ECB5748779C9E514DAF1CC0CDD65,11161,11,12,1,32,48,1648
41874,41874,10D4ECB5748779C9E514DAF1CC0CDD65,11861,12,23,11,32,47,1647
41875,41875,660D2150C1391153938CD9B90E2CE919,12641,1,5,4,10,43,543
41876,41876,660D2150C1391153938CD9B90E2CE919,19021,6,17,11,10,45,545
41877,41877,660D2150C1391153938CD9B90E2CE919,12641,20,22,2,10,43,543
41888,41888,37D12B9A785069D9567B986D8917ECC5,10351,1,9,8,28,45,1445
41889,41889,37D12B9A785069D9567B986D8917ECC5,10634,10,11,1,27,45,1395
41890,41890,37D12B9A785069D9567B986D8917ECC5,10351,11,22,11,28,45,1445
41894,41894,83BB102D42B106B02532A9E858086CAC,11061,0,15,15,29,48,1498
41895,41895,83BB102D42B106B02532A9E858086CAC,10681,15,17,2,30,48,1548
41896,41896,83BB102D42B106B02532A9E858086CAC,11061,20,21,1,29,48,1498
41897,41897,5FB7FCDE8733B3DE0082FB61D42FC13D,13941,0,6,6,41,47,2097
41898,41898,5FB7FCDE8733B3DE0082FB61D42FC13D,42321,8,21,13,43,47,2197
41899,41899,5FB7FCDE8733B3DE0082FB61D42FC13D,13941,22,23,1,41,47,2097
41900,41900,8D4403CD84975AE0D9A403E49725512D,10121,0,10,10,36,49,1849
41901,41901,8D4403CD84975AE0D9A403E49725512D,11201,11,12,1,35,49,1799
41902,41902,8D4403CD84975AE0D9A403E49725512D,10121,12,23,11,36,49,1849
41903,41903,669C34237215178780FBCDB7F5444D7E,43311,1,11,10,31,48,1598
41904,41904,669C34237215178780FBCDB7F5444D7E,11061,13,16,3,29,48,1498
41905,41905,669C34237215178780FBCDB7F5444D7E,11381,19,21,2,30,47,1547
41906,41906,669C34237215178780FBCDB7F5444D7E,10951,21,23,2,29,48,1498
41914,41914,A0E829F4319BFCF37BA7414AFCB09FF1,11074,3,10,7,37,47,1897
41915,41915,A0E829F4319BFCF37BA7414AFCB09FF1,42221,12,13,1,38,48,1948
41916,41916,A0E829F4319BFCF37BA7414AFCB09FF1,11074,17,23,6,37,47,1897
41917,41917,4ECF535B69201A355EA7749BD213A59C,11231,0,3,3,37,49,1899
41918,41918,4ECF535B69201A355EA7749BD213A59C,40502,4,10,6,36,48,1848
41919,41919,4ECF535B69201A355EA7749BD213A59C,11231,11,23,12,37,49,1899
41920,41920,0A61C8BC2E2F3B8A439DFBB7542FD5B0,13371,0,9,9,41,47,2097
41921,41921,0A61C8BC2E2F3B8A439DFBB7542FD5B0,13121,9,10,1,38,46,1946
41922,41922,0A61C8BC2E2F3B8A439DFBB7542FD5B0,13371,12,23,11,41,47,2097
41931,41931,700A8469B8648E235281334EF5CC8DA1,10471,1,10,9,37,48,1898
41932,41932,700A8469B8648E235281334EF5CC8DA1,10371,12,17,5,37,49,1899
41933,41933,700A8469B8648E235281334EF5CC8DA1,10471,17,20,3,37,48,1898
41943,41943,5373610F890B22380CA1FA8F103E6F99,11381,1,13,12,30,47,1547
41944,41944,5373610F890B22380CA1FA8F103E6F99,11061,16,17,1,29,48,1498
41945,41945,5373610F890B22380CA1FA8F103E6F99,11381,17,18,1,30,47,1547
41951,41951,0AE1F060A9917578AF6CC39BEF4A5FD7,11914,0,4,4,37,48,1898
41952,41952,0AE1F060A9917578AF6CC39BEF4A5FD7,11074,4,7,3,37,47,1897
41953,41953,0AE1F060A9917578AF6CC39BEF4A5FD7,10371,8,18,10,37,49,1899
41954,41954,0AE1F060A9917578AF6CC39BEF4A5FD7,11074,20,21,1,37,47,1897
41966,41966,E9DE0465C25ACD29F5AA7BA8CFD57DED,42521,0,5,5,31,47,1597
41967,41967,E9DE0465C25ACD29F5AA7BA8CFD57DED,10295,6,10,4,30,47,1547
41968,41968,E9DE0465C25ACD29F5AA7BA8CFD57DED,42521,10,19,9,31,47,1597
41973,41973,C187943D20D187183526E0228C45660E,11021,0,7,7,36,49,1849
41974,41974,C187943D20D187183526E0228C45660E,11081,8,17,9,35,46,1796
41975,41975,C187943D20D187183526E0228C45660E,11021,18,22,4,36,49,1849
41990,41990,B5672F8DB79E27C9C56BFFFB9CA6DB37,13511,0,11,11,34,48,1748
41991,41991,B5672F8DB79E27C9C56BFFFB9CA6DB37,40951,12,13,1,36,49,1849
41992,41992,B5672F8DB79E27C9C56BFFFB9CA6DB37,13511,21,22,1,34,48,1748
41993,41993,5B51BC643A26489396AC90A6305DBADE,11231,0,7,7,37,49,1899
41994,41994,5B51BC643A26489396AC90A6305DBADE,13731,8,11,3,33,49,1699
41995,41995,5B51BC643A26489396AC90A6305DBADE,11231,18,23,5,37,49,1899
42001,42001,5B606639B0DDA81D89C67819EC5B7D64,13271,0,8,8,41,47,2097
42002,42002,5B606639B0DDA81D89C67819EC5B7D64,12514,9,12,3,38,47,1947
42003,42003,5B606639B0DDA81D89C67819EC5B7D64,13101,17,20,3,40,47,2047
42004,42004,85D24FB9589B92B54BC0934C456D6DAF,12511,0,7,7,39,47,1997
42005,42005,85D24FB9589B92B54BC0934C456D6DAF,10251,11,17,6,35,47,1797
42006,42006,85D24FB9589B92B54BC0934C456D6DAF,42271,21,23,2,40,47,2047
42011,42011,D3E46B15B35DC3C198E6EE945D227259,11806,0,5,5,41,48,2098
42012,42012,D3E46B15B35DC3C198E6EE945D227259,13381,5,7,2,39,47,1997
42013,42013,D3E46B15B35DC3C198E6EE945D227259,42271,7,11,4,40,47,2047
42014,42014,D3E46B15B35DC3C198E6EE945D227259,13381,12,22,10,39,47,1997
42015,42015,394B81CC36B31D897120A6153D7C1457,11061,0,3,3,29,48,1498
42016,42016,394B81CC36B31D897120A6153D7C1457,12121,6,18,12,29,47,1497
42017,42017,394B81CC36B31D897120A6153D7C1457,11061,18,23,5,29,48,1498
42018,42018,C69E0CA9901BB33595EAB544526AEF15,11001,4,13,9,42,47,2147
42019,42019,C69E0CA9901BB33595EAB544526AEF15,11806,14,15,1,41,48,2098
42020,42020,C69E0CA9901BB33595EAB544526AEF15,11001,19,21,2,42,47,2147
42025,42025,4560AA6E9FF5488D13E472C26129D09F,12514,2,9,7,38,47,1947
42026,42026,4560AA6E9FF5488D13E472C26129D09F,10841,9,14,5,37,47,1897
42027,42027,4560AA6E9FF5488D13E472C26129D09F,12514,15,19,4,38,47,1947
42028,42028,4560AA6E9FF5488D13E472C26129D09F,42511,22,23,1,37,47,1897
42029,42029,112D73984BEFF27B4D8267205C95643D,13121,0,7,7,38,46,1946
42030,42030,112D73984BEFF27B4D8267205C95643D,42633,11,13,2,42,46,2146
42031,42031,112D73984BEFF27B4D8267205C95643D,13121,21,22,1,38,46,1946
42035,42035,9B3CEEB5258D8C7EE02AB18106A0FB98,42351,0,1,1,38,45,1945
42036,42036,9B3CEEB5258D8C7EE02AB18106A0FB98,11261,6,11,5,36,46,1846
42037,42037,9B3CEEB5258D8C7EE02AB18106A0FB98,42861,14,19,5,37,44,1894
42038,42038,2DF3C6DC9E553CA01AAB34763FB8D366,11001,0,7,7,42,47,2147
42039,42039,2DF3C6DC9E553CA01AAB34763FB8D366,13341,8,9,1,44,45,2245
42040,42040,2DF3C6DC9E553CA01AAB34763FB8D366,11001,12,23,11,42,47,2147
42041,42041,9D5FAD2D946916458AB09D98B7F6CB85,42623,1,14,13,22,49,1149
42042,42042,9D5FAD2D946916458AB09D98B7F6CB85,42081,15,17,2,24,49,1249
42043,42043,9D5FAD2D946916458AB09D98B7F6CB85,11641,21,22,1,22,49,1149
42050,42050,7A5DEDC7FE052035815232A8310135E2,11061,1,6,5,29,48,1498
42051,42051,7A5DEDC7FE052035815232A8310135E2,11151,9,14,5,30,48,1548
42052,42052,7A5DEDC7FE052035815232A8310135E2,11061,15,16,1,29,48,1498
42053,42053,7A5DEDC7FE052035815232A8310135E2,11151,18,19,1,30,48,1548
42054,42054,2873DE93703B028193B7B9719DCFE691,12521,0,6,6,35,41,1791
42055,42055,2873DE93703B028193B7B9719DCFE691,43451,7,11,4,37,40,1890
42056,42056,2873DE93703B028193B7B9719DCFE691,12521,12,23,11,35,41,1791
42057,42057,70E50AA138C0538910E5623295B506D8,42351,1,14,13,38,45,1945
42058,42058,70E50AA138C0538910E5623295B506D8,11261,16,19,3,36,46,1846
42059,42059,70E50AA138C0538910E5623295B506D8,42351,19,21,2,38,45,1945
42060,42060,E51EE41655D386174398555E16D6604B,12381,0,9,9,32,48,1648
42061,42061,E51EE41655D386174398555E16D6604B,10544,10,11,1,28,48,1448
42062,42062,E51EE41655D386174398555E16D6604B,12381,12,21,9,32,48,1648
42076,42076,F109A6B5CB90E4D043A6ADA6FCD2AFAB,10611,0,9,9,32,48,1648
42077,42077,F109A6B5CB90E4D043A6ADA6FCD2AFAB,10951,12,13,1,29,48,1498
42078,42078,F109A6B5CB90E4D043A6ADA6FCD2AFAB,11381,14,15,1,30,47,1547
42079,42079,F109A6B5CB90E4D043A6ADA6FCD2AFAB,10611,19,23,4,32,48,1648
42086,42086,804B7737707030C63DF2E4BD94DF220F,11806,0,9,9,41,48,2098
42087,42087,804B7737707030C63DF2E4BD94DF220F,13101,11,13,2,40,47,2047
42088,42088,804B7737707030C63DF2E4BD94DF220F,11806,15,23,8,41,48,2098
42089,42089,C69DB833C5C233DF7718BBF8E4312DAA,42021,0,10,10,33,47,1697
42090,42090,C69DB833C5C233DF7718BBF8E4312DAA,10301,11,13,2,31,45,1595
42091,42091,C69DB833C5C233DF7718BBF8E4312DAA,11875,18,19,1,30,46,1546
42092,42092,C69DB833C5C233DF7718BBF8E4312DAA,11861,21,23,2,32,47,1647
42098,42098,00B181DD66423FB09C5417E3C6EB3025,13371,0,10,10,41,47,2097
42099,42099,00B181DD66423FB09C5417E3C6EB3025,42321,12,14,2,43,47,2197
42100,42100,00B181DD66423FB09C5417E3C6EB3025,13941,18,19,1,41,47,2097
42104,42104,1F586282DD0AC03725A5E548411F5D82,12514,0,3,3,38,47,1947
42105,42105,1F586282DD0AC03725A5E548411F5D82,42511,4,7,3,37,47,1897
42106,42106,1F586282DD0AC03725A5E548411F5D82,12514,7,21,14,38,47,1947
42113,42113,8E0D20320C5276BDD797BA6D65B9C51D,11074,0,7,7,37,47,1897
42114,42114,8E0D20320C5276BDD797BA6D65B9C51D,11231,8,17,9,37,49,1899
42115,42115,8E0D20320C5276BDD797BA6D65B9C51D,11074,19,23,4,37,47,1897
42125,42125,24F2A352225621D0B0829DDA5AA34835,10841,0,14,14,37,47,1897
42126,42126,24F2A352225621D0B0829DDA5AA34835,11271,16,17,1,37,48,1898
42127,42127,24F2A352225621D0B0829DDA5AA34835,11074,18,21,3,37,47,1897
42137,42137,A9CB10B468D8E4AF35699B759EB26E7B,10251,0,11,11,35,47,1797
42138,42138,A9CB10B468D8E4AF35699B759EB26E7B,10411,13,16,3,36,48,1848
42139,42139,A9CB10B468D8E4AF35699B759EB26E7B,10251,21,23,2,35,47,1797
42149,42149,7446641F73809A823733CBB6864B4050,42861,0,7,7,37,44,1894
42150,42150,7446641F73809A823733CBB6864B4050,11261,9,10,1,36,46,1846
42151,42151,7446641F73809A823733CBB6864B4050,42861,10,18,8,37,44,1894
42152,42152,B9F4C9D18F82BAF4FF50860E0E28B6F2,42161,0,8,8,36,47,1847
42153,42153,B9F4C9D18F82BAF4FF50860E0E28B6F2,40952,11,18,7,36,49,1849
42154,42154,B9F4C9D18F82BAF4FF50860E0E28B6F2,11201,19,21,2,35,49,1799
42155,42155,EB3039C415C508F2A2DCF6403E75C42C,12921,0,15,15,9,41,491
42156,42156,EB3039C415C508F2A2DCF6403E75C42C,12641,17,21,4,10,43,543
42157,42157,EB3039C415C508F2A2DCF6403E75C42C,12921,21,23,2,9,41,491
42158,42158,FA584217376E1ED7E1BDEF3FE9A645C6,42581,1,4,3,38,48,1948
42159,42159,FA584217376E1ED7E1BDEF3FE9A645C6,11271,7,8,1,37,48,1898
42160,42160,FA584217376E1ED7E1BDEF3FE9A645C6,42581,11,22,11,38,48,1948
42161,42161,81412EDBF21D783B9E4A866ACE793116,11431,0,7,7,29,47,1497
42162,42162,81412EDBF21D783B9E4A866ACE793116,11381,10,14,4,30,47,1547
42163,42163,81412EDBF21D783B9E4A866ACE793116,12311,16,18,2,30,44,1544
42164,42164,81412EDBF21D783B9E4A866ACE793116,11381,20,21,1,30,47,1547
42165,42165,2E18E8DF093288689E2805A1F3FB2A40,12641,0,4,4,10,43,543
42166,42166,2E18E8DF093288689E2805A1F3FB2A40,12921,4,15,11,9,41,491
42167,42167,2E18E8DF093288689E2805A1F3FB2A40,12641,17,18,1,10,43,543
42172,42172,857A8E0D6DC1B408B8273E584D9A8FC4,13371,0,12,12,41,47,2097
42173,42173,857A8E0D6DC1B408B8273E584D9A8FC4,11806,15,17,2,41,48,2098
42174,42174,857A8E0D6DC1B408B8273E584D9A8FC4,13371,18,22,4,41,47,2097
42180,42180,E45E3AA86D4C7662B7021B0B55258130,10531,9,11,2,34,46,1746
42181,42181,E45E3AA86D4C7662B7021B0B55258130,10511,14,16,2,35,46,1796
42182,42182,E45E3AA86D4C7662B7021B0B55258130,40277,18,23,5,35,49,1799
42191,42191,2A710B220FA31F52EF7662151DDBA6BE,42281,0,7,7,40,48,2048
42192,42192,2A710B220FA31F52EF7662151DDBA6BE,11481,8,14,6,41,48,2098
42193,42193,2A710B220FA31F52EF7662151DDBA6BE,42281,15,17,2,40,48,2048
42194,42194,2A710B220FA31F52EF7662151DDBA6BE,11481,19,21,2,41,48,2098
42198,42198,89084C54499EDD168F6753B4E522A173,42581,2,3,1,38,48,1948
42199,42199,89084C54499EDD168F6753B4E522A173,12514,6,7,1,38,47,1947
42200,42200,89084C54499EDD168F6753B4E522A173,42581,12,21,9,38,48,1948
42209,42209,7779D5C4E5073D864A9050EB76A5AC64,11261,0,11,11,36,46,1846
42210,42210,7779D5C4E5073D864A9050EB76A5AC64,10271,14,16,2,37,46,1896
42211,42211,7779D5C4E5073D864A9050EB76A5AC64,11261,18,20,2,36,46,1846
42222,42222,EF7A20DA8B1B5B9AEB04342FCDE03590,42271,0,14,14,40,47,2047
42223,42223,EF7A20DA8B1B5B9AEB04342FCDE03590,13331,15,16,1,38,47,1947
42224,42224,EF7A20DA8B1B5B9AEB04342FCDE03590,42271,16,23,7,40,47,2047
42225,42225,E46021F2EBB1FF86CE07D74A4E5B9C9F,12921,0,6,6,9,41,491
42226,42226,E46021F2EBB1FF86CE07D74A4E5B9C9F,49201,8,11,3,7,41,391
42227,42227,E46021F2EBB1FF86CE07D74A4E5B9C9F,12921,13,15,2,9,41,491
42228,42228,E46021F2EBB1FF86CE07D74A4E5B9C9F,49201,16,19,3,7,41,391
42232,42232,AF11A116F876E89A4D582C37AC3B2D5C,13671,2,7,5,27,43,1393
42233,42233,AF11A116F876E89A4D582C37AC3B2D5C,11281,8,13,5,27,40,1390
42234,42234,AF11A116F876E89A4D582C37AC3B2D5C,13671,13,18,5,27,43,1393
42238,42238,F1D52E271AD2CA60B9DB39C5E4BE77A4,12641,2,4,2,10,43,543
42239,42239,F1D52E271AD2CA60B9DB39C5E4BE77A4,19021,6,16,10,10,45,545
42240,42240,F1D52E271AD2CA60B9DB39C5E4BE77A4,12641,19,21,2,10,43,543
42241,42241,6EBC343B289E845421579091E3F37018,42091,0,6,6,43,46,2196
42242,42242,6EBC343B289E845421579091E3F37018,42461,10,12,2,45,47,2297
42243,42243,6EBC343B289E845421579091E3F37018,42091,12,19,7,43,46,2196
42250,42250,582FCEF67ED9C80E5B2E8667690F61FB,42221,0,6,6,38,48,1948
42251,42251,582FCEF67ED9C80E5B2E8667690F61FB,10251,7,9,2,35,47,1797
42252,42252,582FCEF67ED9C80E5B2E8667690F61FB,40637,9,18,9,36,47,1847
42253,42253,582FCEF67ED9C80E5B2E8667690F61FB,42221,20,23,3,38,48,1948
42258,42258,BB84F849A5F794F98ED9E8F635142ED5,11914,0,4,4,37,48,1898
42259,42259,BB84F849A5F794F98ED9E8F635142ED5,43181,5,6,1,39,48,1998
42260,42260,BB84F849A5F794F98ED9E8F635142ED5,10471,9,18,9,37,48,1898
42261,42261,BB84F849A5F794F98ED9E8F635142ED5,40171,21,22,1,38,48,1948
42262,42262,C6CE1BC9B69267948B78869F2B1A69E1,10731,0,10,10,33,47,1697
42263,42263,C6CE1BC9B69267948B78869F2B1A69E1,11831,12,18,6,32,45,1645
42264,42264,C6CE1BC9B69267948B78869F2B1A69E1,10731,21,22,1,33,47,1697
42282,42282,A349D8C83E1914464A7CDA23A563E70B,42523,3,11,8,31,47,1597
42283,42283,A349D8C83E1914464A7CDA23A563E70B,43761,14,16,2,32,47,1647
42284,42284,A349D8C83E1914464A7CDA23A563E70B,42523,17,21,4,31,47,1597
42288,42288,78C0E1E992CFF9ECB9C6D46D3E929FD4,12121,0,7,7,29,47,1497
42289,42289,78C0E1E992CFF9ECB9C6D46D3E929FD4,11381,8,9,1,30,47,1547
42290,42290,78C0E1E992CFF9ECB9C6D46D3E929FD4,12121,11,21,10,29,47,1497
42301,42301,A86A2549CD02B65958808F3EC9B7BFBD,13911,1,6,5,39,46,1996
42302,42302,A86A2549CD02B65958808F3EC9B7BFBD,11261,8,14,6,36,46,1846
42303,42303,A86A2549CD02B65958808F3EC9B7BFBD,13911,14,16,2,39,46,1996
42304,42304,A86A2549CD02B65958808F3EC9B7BFBD,11261,17,18,1,36,46,1846
42305,42305,2BC714C204CBBFEE616B46CC493E087B,12921,9,10,1,9,41,491
42306,42306,2BC714C204CBBFEE616B46CC493E087B,12641,13,14,1,10,43,543
42307,42307,2BC714C204CBBFEE616B46CC493E087B,12921,16,17,1,9,41,491
42308,42308,2BC714C204CBBFEE616B46CC493E087B,12641,17,21,4,10,43,543
42319,42319,506260504ADDFFEBDF6F921DD8023DFE,11381,0,2,2,30,47,1547
42320,42320,506260504ADDFFEBDF6F921DD8023DFE,12121,4,16,12,29,47,1497
42321,42321,506260504ADDFFEBDF6F921DD8023DFE,11381,19,22,3,30,47,1547
42322,42322,DDA6B604E3064A212A44C754B2E5E179,11261,1,7,6,36,46,1846
42323,42323,DDA6B604E3064A212A44C754B2E5E179,42151,9,16,7,35,45,1795
42324,42324,DDA6B604E3064A212A44C754B2E5E179,13911,20,22,2,39,46,1996
42325,42325,D9FB9F3F4820A4EF951566780A770C45,11261,0,12,12,36,46,1846
42326,42326,D9FB9F3F4820A4EF951566780A770C45,13911,14,17,3,39,46,1996
42327,42327,D9FB9F3F4820A4EF951566780A770C45,11261,17,23,6,36,46,1846
42352,42352,829F3CF969A99106A0CF5C6D0ED0FE14,10251,0,9,9,35,47,1797
42353,42353,829F3CF969A99106A0CF5C6D0ED0FE14,11751,9,16,7,35,48,1798
42354,42354,829F3CF969A99106A0CF5C6D0ED0FE14,10251,17,22,5,35,47,1797
42368,42368,EBE74CAA370851CCC599E73574A1082B,42221,0,2,2,38,48,1948
42369,42369,EBE74CAA370851CCC599E73574A1082B,11074,2,21,19,37,47,1897
42370,42370,EBE74CAA370851CCC599E73574A1082B,42221,21,23,2,38,48,1948
42388,42388,A922D7161F816C1FD25F52BCCB616DFE,40673,0,5,5,36,48,1848
42389,42389,A922D7161F816C1FD25F52BCCB616DFE,10251,8,19,11,35,47,1797
42390,42390,A922D7161F816C1FD25F52BCCB616DFE,40673,20,23,3,36,48,1848
42391,42391,48B6D3EBCD784EB1CC7B582D8882FC51,43481,0,1,1,39,48,1998
42392,42392,48B6D3EBCD784EB1CC7B582D8882FC51,10841,2,19,17,37,47,1897
42393,42393,48B6D3EBCD784EB1CC7B582D8882FC51,11231,19,23,4,37,49,1899
42401,42401,09F8BD5A1700423D339AD241358C49BB,11231,0,8,8,37,49,1899
42402,42402,09F8BD5A1700423D339AD241358C49BB,12083,12,15,3,36,49,1849
42403,42403,09F8BD5A1700423D339AD241358C49BB,11231,17,23,6,37,49,1899
42407,42407,5AF85D9ED958D0E5348613692DAC5B4D,10661,0,1,1,37,49,1899
42408,42408,5AF85D9ED958D0E5348613692DAC5B4D,12083,4,16,12,36,49,1849
42409,42409,5AF85D9ED958D0E5348613692DAC5B4D,10901,16,23,7,35,48,1798
42410,42410,ECE0FA03A797FCAE4E058BD1C3356073,42401,0,8,8,36,47,1847
42411,42411,ECE0FA03A797FCAE4E058BD1C3356073,10111,9,18,9,37,47,1897
42412,42412,ECE0FA03A797FCAE4E058BD1C3356073,42161,19,23,4,36,47,1847
42433,42433,48BB422A95FD2D89DF5A1FA1BC78EC22,11231,0,4,4,37,49,1899
42434,42434,48BB422A95FD2D89DF5A1FA1BC78EC22,12083,5,7,2,36,49,1849
42435,42435,48BB422A95FD2D89DF5A1FA1BC78EC22,11231,8,19,11,37,49,1899
42436,42436,1B16AD0182878B49E352925C1FB99700,12514,0,1,1,38,47,1947
42437,42437,1B16AD0182878B49E352925C1FB99700,13011,3,4,1,39,47,1997
42438,42438,1B16AD0182878B49E352925C1FB99700,12514,5,23,18,38,47,1947
42439,42439,64812FF1B8835C5669BB93C0D5307414,11231,0,14,14,37,49,1899
42440,42440,64812FF1B8835C5669BB93C0D5307414,41271,15,16,1,38,48,1948
42441,42441,64812FF1B8835C5669BB93C0D5307414,11231,17,23,6,37,49,1899
42442,42442,D7B4DEFCB86C55D027A1210EEC02063B,11591,1,2,1,36,49,1849
42443,42443,D7B4DEFCB86C55D027A1210EEC02063B,10471,2,3,1,37,48,1898
42444,42444,D7B4DEFCB86C55D027A1210EEC02063B,11021,3,19,16,36,49,1849
42445,42445,D7B4DEFCB86C55D027A1210EEC02063B,11231,19,23,4,37,49,1899
42469,42469,3F29D0D409D1B6D4E7D2087740FD0BBC,42401,0,7,7,36,47,1847
42470,42470,3F29D0D409D1B6D4E7D2087740FD0BBC,10251,8,11,3,35,47,1797
42471,42471,3F29D0D409D1B6D4E7D2087740FD0BBC,42161,16,19,3,36,47,1847
42472,42472,3F29D0D409D1B6D4E7D2087740FD0BBC,11331,20,21,1,37,48,1898
42477,42477,E3E732D8AF8C8F184FCA265E43641BD4,40381,10,12,2,32,46,1646
42478,42478,E3E732D8AF8C8F184FCA265E43641BD4,43761,13,14,1,32,47,1647
42479,42479,E3E732D8AF8C8F184FCA265E43641BD4,42021,18,23,5,33,47,1697
42485,42485,84725685301668EC3A1E7D2CAE0AC87B,10721,0,7,7,31,48,1598
42486,42486,84725685301668EC3A1E7D2CAE0AC87B,11151,11,13,2,30,48,1548
42487,42487,84725685301668EC3A1E7D2CAE0AC87B,10721,17,23,6,31,48,1598
42494,42494,F49EE04071D0B4FCCD4263F4C2BBEA7A,10681,0,5,5,30,48,1548
42495,42495,F49EE04071D0B4FCCD4263F4C2BBEA7A,11061,7,11,4,29,48,1498
42496,42496,F49EE04071D0B4FCCD4263F4C2BBEA7A,42521,11,13,2,31,47,1597
42497,42497,F49EE04071D0B4FCCD4263F4C2BBEA7A,11061,13,23,10,29,48,1498
42503,42503,B93C16A242FE2C6BDA83A87AD4FAA434,12601,0,7,7,25,47,1297
42504,42504,B93C16A242FE2C6BDA83A87AD4FAA434,10501,8,15,7,22,46,1146
42505,42505,B93C16A242FE2C6BDA83A87AD4FAA434,12601,19,21,2,25,47,1297
42514,42514,90AEF58BB4CABDF543DA1FFF777671DC,11381,0,9,9,30,47,1547
42515,42515,90AEF58BB4CABDF543DA1FFF777671DC,42521,10,11,1,31,47,1597
42516,42516,90AEF58BB4CABDF543DA1FFF777671DC,11381,11,23,12,30,47,1547
42527,42527,984E4D82629620E0325C1D05ACADE424,11861,0,11,11,32,47,1647
42528,42528,984E4D82629620E0325C1D05ACADE424,10292,12,18,6,30,47,1547
42529,42529,984E4D82629620E0325C1D05ACADE424,13601,19,20,1,34,47,1747
42530,42530,984E4D82629620E0325C1D05ACADE424,11861,21,23,2,32,47,1647
42534,42534,660D0729A871FB18966DF6415A58AEF7,11381,6,8,2,30,47,1547
42535,42535,660D0729A871FB18966DF6415A58AEF7,43761,8,16,8,32,47,1647
42536,42536,660D0729A871FB18966DF6415A58AEF7,11061,18,19,1,29,48,1498
42546,42546,0ACD42FBA28A767F44D73783967C8C23,10731,0,8,8,33,47,1697
42547,42547,0ACD42FBA28A767F44D73783967C8C23,12381,11,12,1,32,48,1648
42548,42548,0ACD42FBA28A767F44D73783967C8C23,10731,12,23,11,33,47,1697
42552,42552,B74EA35C5A9DA42B01DED0E1AF551D1E,11074,0,11,11,37,47,1897
42553,42553,B74EA35C5A9DA42B01DED0E1AF551D1E,12511,12,15,3,39,47,1997
42554,42554,B74EA35C5A9DA42B01DED0E1AF551D1E,13221,19,21,2,40,47,2047
42564,42564,8884870431ED537B3D06301C04C58F0C,11061,0,19,19,29,48,1498
42565,42565,8884870431ED537B3D06301C04C58F0C,11381,20,21,1,30,47,1547
42566,42566,8884870431ED537B3D06301C04C58F0C,11061,21,22,1,29,48,1498
42567,42567,868D62D07021FFB7BE9F078FE4596C54,11731,0,8,8,36,48,1848
42568,42568,868D62D07021FFB7BE9F078FE4596C54,10251,11,13,2,35,47,1797
42569,42569,868D62D07021FFB7BE9F078FE4596C54,42151,15,16,1,35,45,1795
42570,42570,868D62D07021FFB7BE9F078FE4596C54,12083,18,23,5,36,49,1849
42571,42571,DA48B2E36E15ABB44629D2690A371238,12121,0,1,1,29,47,1497
42572,42572,DA48B2E36E15ABB44629D2690A371238,11151,2,8,6,30,48,1548
42573,42573,DA48B2E36E15ABB44629D2690A371238,11061,9,20,11,29,48,1498
42574,42574,DA48B2E36E15ABB44629D2690A371238,11151,20,23,3,30,48,1548
42584,42584,3F0EDFFC6E18B4A03094543F5DAD11AE,42521,0,7,7,31,47,1597
42585,42585,3F0EDFFC6E18B4A03094543F5DAD11AE,42141,9,13,4,32,47,1647
42586,42586,3F0EDFFC6E18B4A03094543F5DAD11AE,42521,18,19,1,31,47,1597
42601,42601,51F784C888CDC439364E57C73AA7020C,42141,0,10,10,32,47,1647
42602,42602,51F784C888CDC439364E57C73AA7020C,10951,11,15,4,29,48,1498
42603,42603,51F784C888CDC439364E57C73AA7020C,42141,16,21,5,32,47,1647
42604,42604,458EBC255B183BF22B23CE89879E2CC9,13471,2,11,9,47,49,2399
42605,42605,458EBC255B183BF22B23CE89879E2CC9,42601,13,17,4,44,48,2248
42606,42606,458EBC255B183BF22B23CE89879E2CC9,13471,19,22,3,47,49,2399
42607,42607,6268A79D87E3CFA4E65FA8A748F9969C,11481,0,7,7,41,48,2098
42608,42608,6268A79D87E3CFA4E65FA8A748F9969C,13271,7,20,13,41,47,2097
42609,42609,6268A79D87E3CFA4E65FA8A748F9969C,13101,21,22,1,40,47,2047
42610,42610,561E2984C2DF271A35E12215ED59F7C8,10491,0,13,13,33,48,1698
42611,42611,561E2984C2DF271A35E12215ED59F7C8,42523,14,15,1,31,47,1597
42612,42612,561E2984C2DF271A35E12215ED59F7C8,10491,18,23,5,33,48,1698
42618,42618,780CF605B987CE4335E0B64DFA86ACBF,12514,1,9,8,38,47,1947
42619,42619,780CF605B987CE4335E0B64DFA86ACBF,11921,14,19,5,38,48,1948
42620,42620,780CF605B987CE4335E0B64DFA86ACBF,11461,21,23,2,37,49,1899
42621,42621,21214DF25ABBFE57C13DD19922691751,13911,0,7,7,39,46,1996
42622,42622,21214DF25ABBFE57C13DD19922691751,11261,9,12,3,36,46,1846
42623,42623,21214DF25ABBFE57C13DD19922691751,13231,16,20,4,39,46,1996
42624,42624,14221EE63F6EE55805EE5B3069F379DA,11914,3,4,1,37,48,1898
42625,42625,14221EE63F6EE55805EE5B3069F379DA,42581,6,15,9,38,48,1948
42626,42626,14221EE63F6EE55805EE5B3069F379DA,11914,18,19,1,37,48,1898
42627,42627,CF7DA1891D00F069E0E0214450037183,11381,0,7,7,30,47,1547
42628,42628,CF7DA1891D00F069E0E0214450037183,11061,7,10,3,29,48,1498
42629,42629,CF7DA1891D00F069E0E0214450037183,11381,11,16,5,30,47,1547
42630,42630,CF7DA1891D00F069E0E0214450037183,11061,18,22,4,29,48,1498
42631,42631,1C752316BF3BA3B641D891EF9B0BCA45,13711,1,7,6,38,46,1946
42632,42632,1C752316BF3BA3B641D891EF9B0BCA45,42011,9,12,3,36,46,1846
42633,42633,1C752316BF3BA3B641D891EF9B0BCA45,10271,14,16,2,37,46,1896
42634,42634,1C752316BF3BA3B641D891EF9B0BCA45,13711,19,20,1,38,46,1946
42644,42644,AFAE133FA88B98A999C46702AA923186,10841,0,8,8,37,47,1897
42645,42645,AFAE133FA88B98A999C46702AA923186,10601,12,15,3,39,47,1997
42646,42646,AFAE133FA88B98A999C46702AA923186,13331,18,21,3,38,47,1947
42647,42647,AFAE133FA88B98A999C46702AA923186,10601,21,23,2,39,47,1997
42648,42648,FD8C757A10FC8342CB9359B3B019D044,10901,0,7,7,35,48,1798
42649,42649,FD8C757A10FC8342CB9359B3B019D044,11231,8,18,10,37,49,1899
42650,42650,FD8C757A10FC8342CB9359B3B019D044,10901,18,23,5,35,48,1798
42651,42651,7F8A8DCE46D67556DD5B831711335E3B,10951,0,17,17,29,48,1498
42652,42652,7F8A8DCE46D67556DD5B831711335E3B,11381,17,20,3,30,47,1547
42653,42653,7F8A8DCE46D67556DD5B831711335E3B,10951,21,22,1,29,48,1498
42668,42668,1B3E2B40FE85118B6153584A8B129202,11231,2,19,17,37,49,1899
42669,42669,1B3E2B40FE85118B6153584A8B129202,11731,19,20,1,36,48,1848
42670,42670,1B3E2B40FE85118B6153584A8B129202,10661,21,23,2,37,49,1899
42688,42688,E6F8B18996A93B41942201687916F106,11231,0,2,2,37,49,1899
42689,42689,E6F8B18996A93B41942201687916F106,10471,5,6,1,37,48,1898
42690,42690,E6F8B18996A93B41942201687916F106,11231,10,22,12,37,49,1899
42691,42691,C40D699CADD813ADF2CC74C0A1FAAA12,13111,1,9,8,42,46,2146
42692,42692,C40D699CADD813ADF2CC74C0A1FAAA12,13791,12,15,3,42,47,2147
42693,42693,C40D699CADD813ADF2CC74C0A1FAAA12,43041,15,18,3,41,46,2096
42694,42694,C40D699CADD813ADF2CC74C0A1FAAA12,10421,19,20,1,41,48,2098
42695,42695,FCA3C665B5BF337F331669EDB597A6AC,42151,0,7,7,35,45,1795
42696,42696,FCA3C665B5BF337F331669EDB597A6AC,13121,8,17,9,38,46,1946
42697,42697,FCA3C665B5BF337F331669EDB597A6AC,10271,17,18,1,37,46,1896
42698,42698,FCA3C665B5BF337F331669EDB597A6AC,42791,21,23,2,35,45,1795
42706,42706,2DC21D8E880037CF338AA2F08717310D,42161,4,5,1,36,47,1847
42707,42707,2DC21D8E880037CF338AA2F08717310D,42921,9,10,1,33,47,1697
42708,42708,2DC21D8E880037CF338AA2F08717310D,10251,10,16,6,35,47,1797
42709,42709,2DC21D8E880037CF338AA2F08717310D,10491,17,20,3,33,48,1698
42729,42729,9ECA5557B94DDF8D494B58216329A377,42864,1,2,1,38,44,1944
42730,42730,9ECA5557B94DDF8D494B58216329A377,11261,3,13,10,36,46,1846
42731,42731,9ECA5557B94DDF8D494B58216329A377,42351,14,16,2,38,45,1945
42732,42732,9ECA5557B94DDF8D494B58216329A377,11261,16,22,6,36,46,1846
42744,42744,A7E367ED35CC8BB7AC221D01E7EE426D,43971,0,7,7,30,48,1548
42745,42745,A7E367ED35CC8BB7AC221D01E7EE426D,43761,10,12,2,32,47,1647
42746,42746,A7E367ED35CC8BB7AC221D01E7EE426D,43971,12,14,2,30,48,1548
42747,42747,A7E367ED35CC8BB7AC221D01E7EE426D,11061,16,22,6,29,48,1498
42748,42748,446EC6FA87AAECEACF7165EBCE633713,13651,1,7,6,30,47,1547
42749,42749,446EC6FA87AAECEACF7165EBCE633713,42523,12,13,1,31,47,1597
42750,42750,446EC6FA87AAECEACF7165EBCE633713,13651,17,20,3,30,47,1547
42751,42751,36A5DA74A38B0FD57799D67573348D49,13681,1,6,5,38,47,1947
42752,42752,36A5DA74A38B0FD57799D67573348D49,40673,9,11,2,36,48,1848
42753,42753,36A5DA74A38B0FD57799D67573348D49,42511,12,23,11,37,47,1897
42771,42771,D22FBCE24A9E402EADCDBC576DAC9D49,10691,0,6,6,33,48,1698
42772,42772,D22FBCE24A9E402EADCDBC576DAC9D49,10401,12,14,2,33,49,1699
42773,42773,D22FBCE24A9E402EADCDBC576DAC9D49,10691,19,23,4,33,48,1698
42777,42777,221907A0B5FBDE67A1B2826B991290F1,11381,1,3,2,30,47,1547
42778,42778,221907A0B5FBDE67A1B2826B991290F1,11061,8,10,2,29,48,1498
42779,42779,221907A0B5FBDE67A1B2826B991290F1,11381,10,19,9,30,47,1547
42787,42787,351E6B8076E18B700A96370C0A34F55F,10801,0,6,6,42,47,2147
42788,42788,351E6B8076E18B700A96370C0A34F55F,42321,11,14,3,43,47,2197
42789,42789,351E6B8076E18B700A96370C0A34F55F,10801,14,17,3,42,47,2147
42790,42790,351E6B8076E18B700A96370C0A34F55F,42321,20,22,2,43,47,2197
42791,42791,785F4EBA3F4642EC7BD5BE5F80643D2E,43731,0,9,9,34,47,1747
42792,42792,785F4EBA3F4642EC7BD5BE5F80643D2E,11861,11,12,1,32,47,1647
42793,42793,785F4EBA3F4642EC7BD5BE5F80643D2E,43731,16,20,4,34,47,1747
42794,42794,785F4EBA3F4642EC7BD5BE5F80643D2E,42921,22,23,1,33,47,1697
42814,42814,9773FE9F976C1E69F4E2B147F595ED8B,43051,1,6,5,46,45,2345
42815,42815,9773FE9F976C1E69F4E2B147F595ED8B,42631,8,9,1,43,45,2195
42816,42816,9773FE9F976C1E69F4E2B147F595ED8B,13341,17,23,6,44,45,2245
42817,42817,F0A1BB763F378032A1CC33E7783B3D13,11021,0,4,4,36,49,1849
42818,42818,F0A1BB763F378032A1CC33E7783B3D13,10661,5,11,6,37,49,1899
42819,42819,F0A1BB763F378032A1CC33E7783B3D13,11021,12,22,10,36,49,1849
42834,42834,583602182C31C8E2D985404EA5592339,12641,1,6,5,10,43,543
42835,42835,583602182C31C8E2D985404EA5592339,12921,6,17,11,9,41,491
42836,42836,583602182C31C8E2D985404EA5592339,12641,21,22,1,10,43,543
42841,42841,96056246DD9856C2DDE7E703B0D16D68,11381,0,11,11,30,47,1547
42842,42842,96056246DD9856C2DDE7E703B0D16D68,10341,13,20,7,31,47,1597
42843,42843,96056246DD9856C2DDE7E703B0D16D68,11381,20,23,3,30,47,1547
42844,42844,EA454BA750B94FE328BB9998EA4F4BA4,42161,0,12,12,36,47,1847
42845,42845,EA454BA750B94FE328BB9998EA4F4BA4,10971,13,18,5,35,47,1797
42846,42846,EA454BA750B94FE328BB9998EA4F4BA4,43731,22,23,1,34,47,1747
42855,42855,A03944DF166507623EE4657E15EFF705,10901,8,11,3,35,48,1798
42856,42856,A03944DF166507623EE4657E15EFF705,42981,12,13,1,36,49,1849
42857,42857,A03944DF166507623EE4657E15EFF705,10161,13,16,3,35,49,1799
42858,42858,A03944DF166507623EE4657E15EFF705,42981,18,19,1,36,49,1849
42862,42862,70F4E7C7C32C909D21E260DE46FC3C7A,13411,6,8,2,49,42,2492
42863,42863,70F4E7C7C32C909D21E260DE46FC3C7A,43951,8,11,3,49,41,2491
42864,42864,70F4E7C7C32C909D21E260DE46FC3C7A,13411,12,23,11,49,42,2492
42871,42871,B9287F02ABAC7483714B47918ABD611A,11161,0,7,7,32,48,1648
42872,42872,B9287F02ABAC7483714B47918ABD611A,11061,18,19,1,29,48,1498
42873,42873,B9287F02ABAC7483714B47918ABD611A,11161,21,23,2,32,48,1648
42877,42877,FE84C5B6FD29AD1D9C75D32BF19FA780,11261,0,1,1,36,46,1846
42878,42878,FE84C5B6FD29AD1D9C75D32BF19FA780,42861,1,10,9,37,44,1894
42879,42879,FE84C5B6FD29AD1D9C75D32BF19FA780,11261,11,21,10,36,46,1846
42880,42880,5E3DAD543888AED453CFEE13BBCB613D,13911,6,9,3,39,46,1996
42881,42881,5E3DAD543888AED453CFEE13BBCB613D,42351,9,10,1,38,45,1945
42882,42882,5E3DAD543888AED453CFEE13BBCB613D,13911,15,23,8,39,46,1996
42888,42888,B669243E54B52E3D637E736D2859715A,43731,0,7,7,34,47,1747
42889,42889,B669243E54B52E3D637E736D2859715A,10491,10,11,1,33,48,1698
42890,42890,B669243E54B52E3D637E736D2859715A,43731,12,20,8,34,47,1747
42897,42897,5DAE8FB10D3FBEF5B02F98DB4BFD46E9,42351,0,8,8,38,45,1945
42898,42898,5DAE8FB10D3FBEF5B02F98DB4BFD46E9,42231,9,19,10,37,46,1896
42899,42899,5DAE8FB10D3FBEF5B02F98DB4BFD46E9,42511,21,22,1,37,47,1897
42910,42910,D454F61AD8B5A1CBE1E15CE597E2F528,11491,1,5,4,36,47,1847
42911,42911,D454F61AD8B5A1CBE1E15CE597E2F528,42511,6,7,1,37,47,1897
42912,42912,D454F61AD8B5A1CBE1E15CE597E2F528,11231,7,20,13,37,49,1899
42913,42913,D454F61AD8B5A1CBE1E15CE597E2F528,42301,20,22,2,36,47,1847
42914,42914,16B2F0D78BEB849442A93B3F29FB7F4E,42271,0,11,11,40,47,2047
42915,42915,16B2F0D78BEB849442A93B3F29FB7F4E,11806,14,15,1,41,48,2098
42916,42916,16B2F0D78BEB849442A93B3F29FB7F4E,42271,15,17,2,40,47,2047
42917,42917,16B2F0D78BEB849442A93B3F29FB7F4E,11806,19,23,4,41,48,2098
42923,42923,51CA45CA2AACCC83748D6918E9F511C1,12661,0,7,7,32,45,1645
42924,42924,51CA45CA2AACCC83748D6918E9F511C1,42151,8,17,9,35,45,1795
42925,42925,51CA45CA2AACCC83748D6918E9F511C1,12661,20,21,1,32,45,1645
42926,42926,BF1AC1F102D56BEE1075F47B7B2A8C77,42501,0,5,5,28,47,1447
42927,42927,BF1AC1F102D56BEE1075F47B7B2A8C77,11861,6,16,10,32,47,1647
42928,42928,BF1AC1F102D56BEE1075F47B7B2A8C77,42501,17,19,2,28,47,1447
42929,42929,4C8E92DBB85921608C1C92929A7A8C92,42521,0,6,6,31,47,1597
42930,42930,4C8E92DBB85921608C1C92929A7A8C92,13651,9,11,2,30,47,1547
42931,42931,4C8E92DBB85921608C1C92929A7A8C92,42521,11,23,12,31,47,1597
42937,42937,2ADCF428548E73CC98C7E324C7C8C16C,12131,0,7,7,32,47,1647
42938,42938,2ADCF428548E73CC98C7E324C7C8C16C,42491,8,9,1,32,46,1646
42939,42939,2ADCF428548E73CC98C7E324C7C8C16C,42523,13,16,3,31,47,1597
42940,42940,2ADCF428548E73CC98C7E324C7C8C16C,12131,18,19,1,32,47,1647
42949,42949,8C6728922EF1CCC03B1E56C8334750DD,42481,1,6,5,22,49,1149
42950,42950,8C6728922EF1CCC03B1E56C8334750DD,42681,9,20,11,24,48,1248
42951,42951,8C6728922EF1CCC03B1E56C8334750DD,42481,21,23,2,22,49,1149
42957,42957,1311DE2B902FCAF1CBC790AD8F564F3C,43101,3,4,1,46,40,2340
42958,42958,1311DE2B902FCAF1CBC790AD8F564F3C,13551,9,12,3,45,38,2288
42959,42959,1311DE2B902FCAF1CBC790AD8F564F3C,43101,13,19,6,46,40,2340
42960,42960,3F458F6ABA1F2A91C8D3DACF4A48895B,11381,0,17,17,30,47,1547
42961,42961,3F458F6ABA1F2A91C8D3DACF4A48895B,11061,17,19,2,29,48,1498
42962,42962,3F458F6ABA1F2A91C8D3DACF4A48895B,11381,20,21,1,30,47,1547
42963,42963,6A0394A16431C3763362EDB77E0D6861,10544,0,6,6,28,48,1448
42964,42964,6A0394A16431C3763362EDB77E0D6861,42071,6,8,2,31,49,1599
42965,42965,6A0394A16431C3763362EDB77E0D6861,10544,8,12,4,28,48,1448
42966,42966,6A0394A16431C3763362EDB77E0D6861,42071,13,22,9,31,49,1599
42967,42967,5DFF6366B43BB94F1691F2243A8F8344,19441,0,5,5,8,46,446
42968,42968,5DFF6366B43BB94F1691F2243A8F8344,42041,9,11,2,10,47,547
42969,42969,5DFF6366B43BB94F1691F2243A8F8344,19441,12,20,8,8,46,446
42970,42970,A9A3A3D193DC50B4BBAF47FFC9E9C2E1,11491,0,8,8,36,47,1847
42971,42971,A9A3A3D193DC50B4BBAF47FFC9E9C2E1,11074,11,13,2,37,47,1897
42972,42972,A9A3A3D193DC50B4BBAF47FFC9E9C2E1,10411,16,17,1,36,48,1848
42973,42973,A9A3A3D193DC50B4BBAF47FFC9E9C2E1,42161,17,19,2,36,47,1847
42986,42986,ED0E6C9E2DD3C5F4EC6D1451F3BA50DE,10711,5,8,3,29,46,1496
42987,42987,ED0E6C9E2DD3C5F4EC6D1451F3BA50DE,12311,11,13,2,30,44,1544
42988,42988,ED0E6C9E2DD3C5F4EC6D1451F3BA50DE,42531,15,16,1,31,45,1595
42989,42989,ED0E6C9E2DD3C5F4EC6D1451F3BA50DE,11151,18,19,1,30,48,1548
42997,42997,7880FD83CA3B2C2EBE599ECD394C4782,19441,0,12,12,8,46,446
42998,42998,7880FD83CA3B2C2EBE599ECD394C4782,19024,12,13,1,9,45,495
42999,42999,7880FD83CA3B2C2EBE599ECD394C4782,19441,15,21,6,8,46,446
43000,43000,24C52F5FD3AA43CF1A9BAB6BC0B1DF40,42161,0,4,4,36,47,1847
43001,43001,24C52F5FD3AA43CF1A9BAB6BC0B1DF40,43161,7,9,2,35,47,1797
43002,43002,24C52F5FD3AA43CF1A9BAB6BC0B1DF40,42021,13,20,7,33,47,1697
43003,43003,CC04DF57CD476D56A9C2711AACC54374,42861,0,1,1,37,44,1894
43004,43004,CC04DF57CD476D56A9C2711AACC54374,11261,4,16,12,36,46,1846
43005,43005,CC04DF57CD476D56A9C2711AACC54374,42861,20,21,1,37,44,1894
43006,43006,53DE27C3988F5D22526FCC360F8F3A99,11321,0,6,6,31,46,1596
43007,43007,53DE27C3988F5D22526FCC360F8F3A99,42523,8,15,7,31,47,1597
43008,43008,53DE27C3988F5D22526FCC360F8F3A99,10716,16,18,2,30,46,1546
43009,43009,53DE27C3988F5D22526FCC360F8F3A99,11321,22,23,1,31,46,1596
43026,43026,E3950B228FF57BC4F70CD2EC3D90B5FF,13711,9,10,1,38,46,1946
43027,43027,E3950B228FF57BC4F70CD2EC3D90B5FF,42151,12,15,3,35,45,1795
43028,43028,E3950B228FF57BC4F70CD2EC3D90B5FF,13711,18,19,1,38,46,1946
43035,43035,B6B9FD86337BD93E048A74A5E56BF693,10111,0,14,14,37,47,1897
43036,43036,B6B9FD86337BD93E048A74A5E56BF693,11751,18,20,2,35,48,1798
43037,43037,B6B9FD86337BD93E048A74A5E56BF693,40951,20,21,1,36,49,1849
43041,43041,D2007E56CDD263F500CAE75A804D6B50,42871,0,14,14,30,45,1545
43042,43042,D2007E56CDD263F500CAE75A804D6B50,12311,15,16,1,30,44,1544
43043,43043,D2007E56CDD263F500CAE75A804D6B50,42871,18,19,1,30,45,1545
43044,43044,D2007E56CDD263F500CAE75A804D6B50,12311,21,22,1,30,44,1544
43054,43054,4A7EF801268FA87DD49AA705DCA560E1,12514,1,2,1,38,47,1947
43055,43055,4A7EF801268FA87DD49AA705DCA560E1,11914,3,5,2,37,48,1898
43056,43056,4A7EF801268FA87DD49AA705DCA560E1,42581,8,15,7,38,48,1948
43057,43057,4A7EF801268FA87DD49AA705DCA560E1,11914,16,18,2,37,48,1898
43063,43063,58FF60972C1637520443DC5766A2AB67,13411,0,5,5,49,42,2492
43064,43064,58FF60972C1637520443DC5766A2AB67,43951,6,8,2,49,41,2491
43065,43065,58FF60972C1637520443DC5766A2AB67,13411,11,23,12,49,42,2492
43075,43075,AE64A3DFBE9C3342907BF204A8902B7B,12311,0,9,9,30,44,1544
43076,43076,AE64A3DFBE9C3342907BF204A8902B7B,10301,14,16,2,31,45,1595
43077,43077,AE64A3DFBE9C3342907BF204A8902B7B,12311,21,23,2,30,44,1544
43083,43083,9A519709635398D7673DD5F4D42C6C46,42151,0,10,10,35,45,1795
43084,43084,9A519709635398D7673DD5F4D42C6C46,12491,12,13,1,36,43,1843
43085,43085,9A519709635398D7673DD5F4D42C6C46,42151,13,22,9,35,45,1795
43099,43099,F9DC2F592D6193343BD07B6C3149B9BD,11131,2,6,4,33,48,1698
43100,43100,F9DC2F592D6193343BD07B6C3149B9BD,42161,9,10,1,36,47,1847
43101,43101,F9DC2F592D6193343BD07B6C3149B9BD,43731,12,20,8,34,47,1747
43102,43102,4F3F717E93BC5AFE00C4421DCBF0AA01,42864,7,8,1,38,44,1944
43103,43103,4F3F717E93BC5AFE00C4421DCBF0AA01,11261,9,10,1,36,46,1846
43104,43104,4F3F717E93BC5AFE00C4421DCBF0AA01,42864,14,19,5,38,44,1944
43105,43105,F808ABC7A00624398DD0E1E1BEE09822,11021,0,15,15,36,49,1849
43106,43106,F808ABC7A00624398DD0E1E1BEE09822,11201,19,20,1,35,49,1799
43107,43107,F808ABC7A00624398DD0E1E1BEE09822,11021,22,23,1,36,49,1849
43108,43108,A0C13743AF441FE8099AA940DA71C612,42581,0,16,16,38,48,1948
43109,43109,A0C13743AF441FE8099AA940DA71C612,11914,16,17,1,37,48,1898
43110,43110,A0C13743AF441FE8099AA940DA71C612,42581,17,23,6,38,48,1948
43111,43111,E6D51256D639E50C250F722318EB6B74,43391,0,16,16,29,48,1498
43112,43112,E6D51256D639E50C250F722318EB6B74,10381,16,18,2,31,49,1599
43113,43113,E6D51256D639E50C250F722318EB6B74,43391,18,21,3,29,48,1498
43130,43130,D0D38893985EC78F4373109BF26E8599,13511,0,11,11,34,48,1748
43131,43131,D0D38893985EC78F4373109BF26E8599,10251,18,19,1,35,47,1797
43132,43132,D0D38893985EC78F4373109BF26E8599,13511,20,23,3,34,48,1748
43133,43133,BC76CCD190FA1A5238AAD9129E2B96C9,40463,3,7,4,38,49,1949
43134,43134,BC76CCD190FA1A5238AAD9129E2B96C9,11461,9,12,3,37,49,1899
43135,43135,BC76CCD190FA1A5238AAD9129E2B96C9,10471,14,19,5,37,48,1898
43140,43140,0FE0CB5B1537A46530A03C70C6DF2DF8,11171,0,6,6,33,48,1698
43141,43141,0FE0CB5B1537A46530A03C70C6DF2DF8,11861,7,16,9,32,47,1647
43142,43142,0FE0CB5B1537A46530A03C70C6DF2DF8,10491,20,23,3,33,48,1698
43148,43148,F840A9907CA895CBF9E085175B717C5C,10121,0,15,15,36,49,1849
43149,43149,F840A9907CA895CBF9E085175B717C5C,13561,16,17,1,37,49,1899
43150,43150,F840A9907CA895CBF9E085175B717C5C,10121,17,23,6,36,49,1849
43156,43156,2FC158799FF19F821FBD3DC4EFE863DB,13551,0,8,8,45,38,2288
43157,43157,2FC158799FF19F821FBD3DC4EFE863DB,43101,12,17,5,46,40,2340
43158,43158,2FC158799FF19F821FBD3DC4EFE863DB,13551,18,20,2,45,38,2288
43163,43163,209CBAFCECFCFAF5ADEC7A13A8F80FC5,19114,1,12,11,7,43,393
43164,43164,209CBAFCECFCFAF5ADEC7A13A8F80FC5,12921,12,13,1,9,41,491
43165,43165,209CBAFCECFCFAF5ADEC7A13A8F80FC5,19114,14,22,8,7,43,393
43176,43176,872EA7042E221A40D168D3255557BABA,42523,3,4,1,31,47,1597
43177,43177,872EA7042E221A40D168D3255557BABA,43761,7,9,2,32,47,1647
43178,43178,872EA7042E221A40D168D3255557BABA,42521,13,14,1,31,47,1597
43179,43179,872EA7042E221A40D168D3255557BABA,43761,17,20,3,32,47,1647
43193,43193,A178FA23835F7340CB9C26A1AEC90741,11324,1,8,7,31,46,1596
43194,43194,A178FA23835F7340CB9C26A1AEC90741,11381,9,18,9,30,47,1547
43195,43195,A178FA23835F7340CB9C26A1AEC90741,10721,21,22,1,31,48,1598
43196,43196,D4191700C633456D6E890AE49001CB88,10951,0,6,6,29,48,1498
43197,43197,D4191700C633456D6E890AE49001CB88,11381,7,11,4,30,47,1547
43198,43198,D4191700C633456D6E890AE49001CB88,10951,12,19,7,29,48,1498
43199,43199,D4191700C633456D6E890AE49001CB88,12121,20,21,1,29,47,1497
43204,43204,64125BF70ADD2A9D2C91BE766AA2E78E,13911,5,6,1,39,46,1996
43205,43205,64125BF70ADD2A9D2C91BE766AA2E78E,11261,10,19,9,36,46,1846
43206,43206,64125BF70ADD2A9D2C91BE766AA2E78E,13911,22,23,1,39,46,1996
43219,43219,63A1194DA67A916294F825B4249AD293,42161,2,6,4,36,47,1847
43220,43220,63A1194DA67A916294F825B4249AD293,11261,11,17,6,36,46,1846
43221,43221,63A1194DA67A916294F825B4249AD293,10841,18,23,5,37,47,1897
43228,43228,F6B1EC121BC516EE907F624461A71EC1,10731,0,15,15,33,47,1697
43229,43229,F6B1EC121BC516EE907F624461A71EC1,43731,19,21,2,34,47,1747
43230,43230,F6B1EC121BC516EE907F624461A71EC1,10731,21,23,2,33,47,1697
43237,43237,4A69CEF881C930B26BF97D2854913ACB,43951,0,13,13,49,41,2491
43238,43238,4A69CEF881C930B26BF97D2854913ACB,43101,15,16,1,46,40,2340
43239,43239,4A69CEF881C930B26BF97D2854913ACB,43951,19,23,4,49,41,2491
43240,43240,A68637AA89BD62624E677D9E66C32FAD,11021,10,12,2,36,49,1849
43241,43241,A68637AA89BD62624E677D9E66C32FAD,10107,12,14,2,38,49,1949
43242,43242,A68637AA89BD62624E677D9E66C32FAD,11201,16,19,3,35,49,1799
43243,43243,FC707C73D6614611D82A13C2F325D332,42511,4,6,2,37,47,1897
43244,43244,FC707C73D6614611D82A13C2F325D332,42161,7,8,1,36,47,1847
43245,43245,FC707C73D6614611D82A13C2F325D332,41081,11,21,10,36,49,1849
43258,43258,D950A9D3ACBEF7AFBBFB96859587E38D,42523,1,14,13,31,47,1597
43259,43259,D950A9D3ACBEF7AFBBFB96859587E38D,13651,15,16,1,30,47,1547
43260,43260,D950A9D3ACBEF7AFBBFB96859587E38D,42523,18,22,4,31,47,1597
43261,43261,5ED8949BAC5CDF05EDA1019FB7CA4B17,40171,0,6,6,38,48,1948
43262,43262,5ED8949BAC5CDF05EDA1019FB7CA4B17,10471,8,19,11,37,48,1898
43263,43263,5ED8949BAC5CDF05EDA1019FB7CA4B17,40171,19,23,4,38,48,1948
43267,43267,DD4D28FDBCFFE930AF28BD3956ED9308,11381,0,15,15,30,47,1547
43268,43268,DD4D28FDBCFFE930AF28BD3956ED9308,40381,16,18,2,32,46,1646
43269,43269,DD4D28FDBCFFE930AF28BD3956ED9308,11381,18,21,3,30,47,1547
43270,43270,54E9147B0F88496112EA8083546467E6,12311,2,8,6,30,44,1544
43271,43271,54E9147B0F88496112EA8083546467E6,12661,9,12,3,32,45,1645
43272,43272,54E9147B0F88496112EA8083546467E6,12311,15,19,4,30,44,1544
43273,43273,54E9147B0F88496112EA8083546467E6,40381,20,21,1,32,46,1646
43283,43283,C26F0AB1B8AD896B177DE30E7C0A729F,11061,2,7,5,29,48,1498
43284,43284,C26F0AB1B8AD896B177DE30E7C0A729F,11381,8,15,7,30,47,1547
43285,43285,C26F0AB1B8AD896B177DE30E7C0A729F,11061,17,23,6,29,48,1498
43293,43293,99EF4A4C6EEE35257A93BB52B8A18E43,11481,0,12,12,41,48,2098
43294,43294,99EF4A4C6EEE35257A93BB52B8A18E43,10821,13,14,1,40,47,2047
43295,43295,99EF4A4C6EEE35257A93BB52B8A18E43,11481,15,23,8,41,48,2098
43296,43296,FDEBDED0DFB744B954CD43B345635AE9,40505,0,8,8,36,48,1848
43297,43297,FDEBDED0DFB744B954CD43B345635AE9,10271,10,12,2,37,46,1896
43298,43298,FDEBDED0DFB744B954CD43B345635AE9,13121,16,22,6,38,46,1946
43305,43305,BB44A13BCAB0B022B18D7F4EDDEC4037,42511,4,11,7,37,47,1897
43306,43306,BB44A13BCAB0B022B18D7F4EDDEC4037,42301,14,18,4,36,47,1847
43307,43307,BB44A13BCAB0B022B18D7F4EDDEC4037,11231,20,23,3,37,49,1899
43315,43315,B304D2AD98C7DE24CAE6DD0DA65095F0,10431,0,7,7,33,49,1699
43316,43316,B304D2AD98C7DE24CAE6DD0DA65095F0,43581,8,18,10,33,48,1698
43317,43317,B304D2AD98C7DE24CAE6DD0DA65095F0,10431,21,23,2,33,49,1699
43318,43318,4B2C5F1CB416544E575393F8DC112063,10281,0,6,6,33,48,1698
43319,43319,4B2C5F1CB416544E575393F8DC112063,11861,6,18,12,32,47,1647
43320,43320,4B2C5F1CB416544E575393F8DC112063,10281,19,22,3,33,48,1698
43321,43321,E368078C59121EE7A89865E85A806516,11541,0,7,7,35,49,1799
43322,43322,E368078C59121EE7A89865E85A806516,42641,8,15,7,33,49,1699
43323,43323,E368078C59121EE7A89865E85A806516,11541,19,23,4,35,49,1799
43331,43331,A5630108861A248FF687B4053732186B,12083,0,10,10,36,49,1849
43332,43332,A5630108861A248FF687B4053732186B,43361,13,14,1,38,48,1948
43333,43333,A5630108861A248FF687B4053732186B,43181,18,19,1,39,48,1998
43334,43334,A5630108861A248FF687B4053732186B,43361,21,22,1,38,48,1948
43344,43344,DC4909E42C27451AF7115D80FD524792,11381,0,14,14,30,47,1547
43345,43345,DC4909E42C27451AF7115D80FD524792,12121,17,19,2,29,47,1497
43346,43346,DC4909E42C27451AF7115D80FD524792,11381,19,23,4,30,47,1547
43350,43350,B2FF699F2D213EDD8D43D893134155CA,11381,0,13,13,30,47,1547
43351,43351,B2FF699F2D213EDD8D43D893134155CA,10951,16,17,1,29,48,1498
43352,43352,B2FF699F2D213EDD8D43D893134155CA,11381,20,21,1,30,47,1547
43353,43353,F5CAB8F803ECE6BB91E5E9B3677179B2,10111,0,8,8,37,47,1897
43354,43354,F5CAB8F803ECE6BB91E5E9B3677179B2,42401,10,15,5,36,47,1847
43355,43355,F5CAB8F803ECE6BB91E5E9B3677179B2,10111,18,23,5,37,47,1897
43356,43356,35DE934E09014E3A56964C528E95BB57,11651,0,11,11,33,47,1697
43357,43357,35DE934E09014E3A56964C528E95BB57,12121,13,15,2,29,47,1497
43358,43358,35DE934E09014E3A56964C528E95BB57,10731,15,16,1,33,47,1697
43359,43359,35DE934E09014E3A56964C528E95BB57,12121,19,22,3,29,47,1497
43360,43360,C644771D2D9F4182BC18DB70E907DF2B,42581,0,16,16,38,48,1948
43361,43361,C644771D2D9F4182BC18DB70E907DF2B,11914,16,20,4,37,48,1898
43362,43362,C644771D2D9F4182BC18DB70E907DF2B,42581,20,23,3,38,48,1948
43370,43370,C27CAD921E0A90627C5337FD9A33D6C8,10721,0,7,7,31,48,1598
43371,43371,C27CAD921E0A90627C5337FD9A33D6C8,11875,11,13,2,30,46,1546
43372,43372,C27CAD921E0A90627C5337FD9A33D6C8,10281,14,18,4,33,48,1698
43376,43376,89A29DA093E55F037F89890FCC2F6E32,43101,0,7,7,46,40,2340
43377,43377,89A29DA093E55F037F89890FCC2F6E32,43951,12,21,9,49,41,2491
43378,43378,89A29DA093E55F037F89890FCC2F6E32,13551,21,22,1,45,38,2288
43379,43379,8264E4C9B3FD12AEBEFEE8F213AF239D,11901,0,11,11,42,49,2149
43380,43380,8264E4C9B3FD12AEBEFEE8F213AF239D,10921,11,13,2,43,48,2198
43381,43381,8264E4C9B3FD12AEBEFEE8F213AF239D,11901,13,23,10,42,49,2149
43382,43382,3C5D029D57650D7A9CE83503042F1003,42864,9,10,1,38,44,1944
43383,43383,3C5D029D57650D7A9CE83503042F1003,11261,14,19,5,36,46,1846
43384,43384,3C5D029D57650D7A9CE83503042F1003,42864,22,23,1,38,44,1944
43385,43385,AA3D7E1DC0C99DC660096C9CD53B9E64,11074,0,7,7,37,47,1897
43386,43386,AA3D7E1DC0C99DC660096C9CD53B9E64,11914,11,12,1,37,48,1898
43387,43387,AA3D7E1DC0C99DC660096C9CD53B9E64,11074,13,23,10,37,47,1897
43388,43388,11C5ACA60B0246DE7069023057E8285F,11381,0,5,5,30,47,1547
43389,43389,11C5ACA60B0246DE7069023057E8285F,11061,7,9,2,29,48,1498
43390,43390,11C5ACA60B0246DE7069023057E8285F,11381,12,23,11,30,47,1547
43397,43397,B75BCB143B608EA57EF37455962D78CA,10381,6,8,2,31,49,1599
43398,43398,B75BCB143B608EA57EF37455962D78CA,10681,9,11,2,30,48,1548
43399,43399,B75BCB143B608EA57EF37455962D78CA,10381,11,19,8,31,49,1599
43400,43400,0DFD98C5BF618352145AEF64606DF221,40673,1,8,7,36,48,1848
43401,43401,0DFD98C5BF618352145AEF64606DF221,42401,8,19,11,36,47,1847
43402,43402,0DFD98C5BF618352145AEF64606DF221,40673,22,23,1,36,48,1848
43403,43403,72E3711AB2F1551FB5E5D7BBFCDF93B2,10531,0,7,7,34,46,1746
43404,43404,72E3711AB2F1551FB5E5D7BBFCDF93B2,11541,8,13,5,35,49,1799
43405,43405,72E3711AB2F1551FB5E5D7BBFCDF93B2,10151,15,20,5,34,47,1747
43406,43406,72E3711AB2F1551FB5E5D7BBFCDF93B2,10531,21,23,2,34,46,1746
43429,43429,CFD70B56FA65C02C4B76645FBAC9B18F,40431,0,5,5,36,47,1847
43430,43430,CFD70B56FA65C02C4B76645FBAC9B18F,43161,9,14,5,35,47,1797
43431,43431,CFD70B56FA65C02C4B76645FBAC9B18F,40431,18,22,4,36,47,1847
43432,43432,78175891E6FD6B0E257EBF3991882D8E,10531,0,9,9,34,46,1746
43433,43433,78175891E6FD6B0E257EBF3991882D8E,10251,12,19,7,35,47,1797
43434,43434,78175891E6FD6B0E257EBF3991882D8E,10531,21,23,2,34,46,1746
43435,43435,3581D9B5A78056D15A4B2FD671FBBA6B,40201,9,13,4,32,49,1649
43436,43436,3581D9B5A78056D15A4B2FD671FBBA6B,11021,14,16,2,36,49,1849
43437,43437,3581D9B5A78056D15A4B2FD671FBBA6B,11531,17,20,3,34,49,1749
43486,43486,2F1F7798F5E8889B4080CA59D71F0274,10271,4,15,11,37,46,1896
43487,43487,2F1F7798F5E8889B4080CA59D71F0274,13711,17,19,2,38,46,1946
43488,43488,2F1F7798F5E8889B4080CA59D71F0274,10271,19,23,4,37,46,1896
43502,43502,B6F80668987D76AE8AEC48092E44D3BD,10271,0,11,11,37,46,1896
43503,43503,B6F80668987D76AE8AEC48092E44D3BD,42511,15,16,1,37,47,1897
43504,43504,B6F80668987D76AE8AEC48092E44D3BD,10271,17,22,5,37,46,1896
43505,43505,6A22B907A7F1FA4A685D409A00615D34,13911,0,7,7,39,46,1996
43506,43506,6A22B907A7F1FA4A685D409A00615D34,11261,9,11,2,36,46,1846
43507,43507,6A22B907A7F1FA4A685D409A00615D34,13911,15,18,3,39,46,1996
43508,43508,6A22B907A7F1FA4A685D409A00615D34,11261,19,21,2,36,46,1846
43509,43509,D7DE5735B7F76B89CCFEC789CF375D07,11074,0,7,7,37,47,1897
43510,43510,D7DE5735B7F76B89CCFEC789CF375D07,42864,12,17,5,38,44,1944
43511,43511,D7DE5735B7F76B89CCFEC789CF375D07,10841,18,21,3,37,47,1897
43512,43512,831704567A0B8CDF382FA5741F6A7093,11321,0,6,6,31,46,1596
43513,43513,831704567A0B8CDF382FA5741F6A7093,12311,9,10,1,30,44,1544
43514,43514,831704567A0B8CDF382FA5741F6A7093,11321,11,23,12,31,46,1596
43523,43523,5C72B0A7D2D9BEA9D0832F659C47AFA7,42471,0,12,12,35,49,1799
43524,43524,5C72B0A7D2D9BEA9D0832F659C47AFA7,11591,14,19,5,36,49,1849
43525,43525,5C72B0A7D2D9BEA9D0832F659C47AFA7,11271,20,21,1,37,48,1898
43526,43526,CDE8FE40EADF2B44E5E250702BA48429,10381,1,7,6,31,49,1599
43527,43527,CDE8FE40EADF2B44E5E250702BA48429,11061,12,13,1,29,48,1498
43528,43528,CDE8FE40EADF2B44E5E250702BA48429,11151,13,14,1,30,48,1548
43529,43529,CDE8FE40EADF2B44E5E250702BA48429,10381,18,23,5,31,49,1599
43538,43538,13CD17A8850630D31FADD0E88D1F2704,10841,1,12,11,37,47,1897
43539,43539,13CD17A8850630D31FADD0E88D1F2704,42221,13,15,2,38,48,1948
43540,43540,13CD17A8850630D31FADD0E88D1F2704,10841,19,21,2,37,47,1897
43541,43541,13CD17A8850630D31FADD0E88D1F2704,42221,21,22,1,38,48,1948
43545,43545,181802B57A29F4FAE1E7EF60B334A9D5,42351,0,1,1,38,45,1945
43546,43546,181802B57A29F4FAE1E7EF60B334A9D5,13911,2,14,12,39,46,1996
43547,43547,181802B57A29F4FAE1E7EF60B334A9D5,11261,15,17,2,36,46,1846
43548,43548,181802B57A29F4FAE1E7EF60B334A9D5,10331,19,23,4,39,46,1996
43556,43556,C93472097C0B4D55CCD338A50A14B134,11061,1,7,6,29,48,1498
43557,43557,C93472097C0B4D55CCD338A50A14B134,12381,10,12,2,32,48,1648
43558,43558,C93472097C0B4D55CCD338A50A14B134,11061,14,19,5,29,48,1498
43559,43559,C93472097C0B4D55CCD338A50A14B134,12381,21,22,1,32,48,1648
43563,43563,195CF2CC6DC9A17A35D04D89649F0846,43621,9,11,2,46,48,2348
43564,43564,195CF2CC6DC9A17A35D04D89649F0846,12651,12,13,1,43,47,2197
43565,43565,195CF2CC6DC9A17A35D04D89649F0846,43621,14,22,8,46,48,2348
43573,43573,53B9F7992DB29A9E3000FDBC39A3F0DF,42271,0,11,11,40,47,2047
43574,43574,53B9F7992DB29A9E3000FDBC39A3F0DF,11921,13,15,2,38,48,1948
43575,43575,53B9F7992DB29A9E3000FDBC39A3F0DF,11074,15,21,6,37,47,1897
43581,43581,7BBD15EB45C3F1BA6E572F56B02ABEDA,10841,0,12,12,37,47,1897
43582,43582,7BBD15EB45C3F1BA6E572F56B02ABEDA,12514,14,15,1,38,47,1947
43583,43583,7BBD15EB45C3F1BA6E572F56B02ABEDA,10841,17,18,1,37,47,1897
43587,43587,826B40817E61853148AFBFECB1C48C70,11261,0,6,6,36,46,1846
43588,43588,826B40817E61853148AFBFECB1C48C70,42861,6,18,12,37,44,1894
43589,43589,826B40817E61853148AFBFECB1C48C70,11261,19,23,4,36,46,1846
43590,43590,AC0F9A0DA655EB0858F47B6C2577B3DE,13671,0,9,9,27,43,1393
43591,43591,AC0F9A0DA655EB0858F47B6C2577B3DE,11281,10,15,5,27,40,1390
43592,43592,AC0F9A0DA655EB0858F47B6C2577B3DE,13671,18,19,1,27,43,1393
43599,43599,92E340B82C56A45F91D53CD2B709557E,42581,4,6,2,38,48,1948
43600,43600,92E340B82C56A45F91D53CD2B709557E,11914,7,16,9,37,48,1898
43601,43601,92E340B82C56A45F91D53CD2B709557E,42581,18,19,1,38,48,1948
43605,43605,34A2FC46F5506FA0BC3D478FC273A5B1,11481,1,6,5,41,48,2098
43606,43606,34A2FC46F5506FA0BC3D478FC273A5B1,11801,8,15,7,42,48,2148
43607,43607,34A2FC46F5506FA0BC3D478FC273A5B1,13271,18,21,3,41,47,2097
43613,43613,6C96EE989846ABECA961FEB7DAD4E3B3,43361,0,5,5,38,48,1948
43614,43614,6C96EE989846ABECA961FEB7DAD4E3B3,10471,7,11,4,37,48,1898
43615,43615,6C96EE989846ABECA961FEB7DAD4E3B3,43361,12,14,2,38,48,1948
43616,43616,6C96EE989846ABECA961FEB7DAD4E3B3,10471,15,23,8,37,48,1898
43623,43623,57068447BEEE4D7969FF166D57966ECA,42541,0,6,6,25,47,1297
43624,43624,57068447BEEE4D7969FF166D57966ECA,11361,6,16,10,22,48,1148
43625,43625,57068447BEEE4D7969FF166D57966ECA,42541,20,22,2,25,47,1297
43626,43626,5282F43DA1098E1CCE157C02623C4D9B,10121,0,14,14,36,49,1849
43627,43627,5282F43DA1098E1CCE157C02623C4D9B,11201,15,16,1,35,49,1799
43628,43628,5282F43DA1098E1CCE157C02623C4D9B,10121,17,23,6,36,49,1849
43645,43645,8EA53D8E1525E5DC764AA8B750C1926A,43951,0,1,1,49,41,2491
43646,43646,8EA53D8E1525E5DC764AA8B750C1926A,13411,4,5,1,49,42,2492
43647,43647,8EA53D8E1525E5DC764AA8B750C1926A,43951,7,21,14,49,41,2491
43648,43648,7561007C44C9B9B43A5E78AE0FF299F7,13341,1,12,11,44,45,2245
43649,43649,7561007C44C9B9B43A5E78AE0FF299F7,42201,15,16,1,43,46,2196
43650,43650,7561007C44C9B9B43A5E78AE0FF299F7,13341,19,22,3,44,45,2245
43651,43651,D8963F7C81A647B0DB7A8BBF70036A0B,12514,2,7,5,38,47,1947
43652,43652,D8963F7C81A647B0DB7A8BBF70036A0B,10471,9,16,7,37,48,1898
43653,43653,D8963F7C81A647B0DB7A8BBF70036A0B,12514,19,20,1,38,47,1947
43654,43654,D8963F7C81A647B0DB7A8BBF70036A0B,13741,21,22,1,37,49,1899
43659,43659,2B05CC2BC211341FBD9F6EA8966B4690,11914,8,9,1,37,48,1898
43660,43660,2B05CC2BC211341FBD9F6EA8966B4690,42581,10,11,1,38,48,1948
43661,43661,2B05CC2BC211341FBD9F6EA8966B4690,11914,15,21,6,37,48,1898
43662,43662,55533B9612A041F560AB09E0A0C2A735,10251,0,8,8,35,47,1797
43663,43663,55533B9612A041F560AB09E0A0C2A735,43731,8,19,11,34,47,1747
43664,43664,55533B9612A041F560AB09E0A0C2A735,10251,20,23,3,35,47,1797
43665,43665,9936C0BC7C8E5C695B3A454E94E542C6,42471,0,7,7,35,49,1799
43666,43666,9936C0BC7C8E5C695B3A454E94E542C6,11021,10,17,7,36,49,1849
43667,43667,9936C0BC7C8E5C695B3A454E94E542C6,11541,17,19,2,35,49,1799
43668,43668,9936C0BC7C8E5C695B3A454E94E542C6,11021,19,22,3,36,49,1849
43669,43669,D15FA3A7ABA08E6217DD058A5361DEF7,13651,0,9,9,30,47,1547
43670,43670,D15FA3A7ABA08E6217DD058A5361DEF7,42521,9,11,2,31,47,1597
43671,43671,D15FA3A7ABA08E6217DD058A5361DEF7,13651,16,23,7,30,47,1547
43672,43672,F290BC2D6D41CD48C300FC7C586626F2,13911,0,12,12,39,46,1996
43673,43673,F290BC2D6D41CD48C300FC7C586626F2,42231,13,19,6,37,46,1896
43674,43674,F290BC2D6D41CD48C300FC7C586626F2,13911,21,23,2,39,46,1996
43675,43675,7CF8DBF6631714E9AE321164C994CF85,42151,1,15,14,35,45,1795
43676,43676,7CF8DBF6631714E9AE321164C994CF85,42861,17,18,1,37,44,1894
43677,43677,7CF8DBF6631714E9AE321164C994CF85,42151,18,21,3,35,45,1795
43678,43678,7CF8DBF6631714E9AE321164C994CF85,42861,22,23,1,37,44,1894
43679,43679,98FCD0E7592CE3BE44D1E20097E37B5B,42401,8,10,2,36,47,1847
43680,43680,98FCD0E7592CE3BE44D1E20097E37B5B,10111,10,18,8,37,47,1897
43681,43681,98FCD0E7592CE3BE44D1E20097E37B5B,11331,19,22,3,37,48,1898
43691,43691,441E401293D6FFC8E080552D376784E1,42581,0,1,1,38,48,1948
43692,43692,441E401293D6FFC8E080552D376784E1,43181,2,4,2,39,48,1998
43693,43693,441E401293D6FFC8E080552D376784E1,11914,6,8,2,37,48,1898
43694,43694,441E401293D6FFC8E080552D376784E1,40171,13,18,5,38,48,1948
43700,43700,AD3E01B55BE3A10979B701E17C93952E,11361,0,12,12,22,48,1148
43701,43701,AD3E01B55BE3A10979B701E17C93952E,12581,16,20,4,24,48,1248
43702,43702,AD3E01B55BE3A10979B701E17C93952E,11361,21,23,2,22,48,1148
43703,43703,0D2316649A2D549905568D93C6BB460E,11541,0,11,11,35,49,1799
43704,43704,0D2316649A2D549905568D93C6BB460E,40951,12,14,2,36,49,1849
43705,43705,0D2316649A2D549905568D93C6BB460E,11541,15,22,7,35,49,1799
43706,43706,EAB1206E637968E97F3FFF57BD5C26A6,11521,0,14,14,41,48,2098
43707,43707,EAB1206E637968E97F3FFF57BD5C26A6,10771,15,16,1,41,46,2096
43708,43708,EAB1206E637968E97F3FFF57BD5C26A6,42031,18,19,1,40,46,2046
43713,43713,E2323F15BA30686339C25751444BC0EC,43361,0,6,6,38,48,1948
43714,43714,E2323F15BA30686339C25751444BC0EC,10471,9,21,12,37,48,1898
43715,43715,E2323F15BA30686339C25751444BC0EC,40171,21,23,2,38,48,1948
43716,43716,95F5650709CACF923AC8764BA8D78995,42531,3,14,11,31,45,1595
43717,43717,95F5650709CACF923AC8764BA8D78995,12311,19,20,1,30,44,1544
43718,43718,95F5650709CACF923AC8764BA8D78995,42531,20,23,3,31,45,1595
43719,43719,0C6F299849FC2AE726FA95F83B756CC5,11871,9,10,1,29,46,1496
43720,43720,0C6F299849FC2AE726FA95F83B756CC5,12311,14,15,1,30,44,1544
43721,43721,0C6F299849FC2AE726FA95F83B756CC5,11841,19,20,1,33,46,1696
43735,43735,54CD4B8B5A5868CA95B1E706B8A9BA0F,42121,0,8,8,26,49,1349
43736,43736,54CD4B8B5A5868CA95B1E706B8A9BA0F,42621,10,12,2,24,49,1249
43737,43737,54CD4B8B5A5868CA95B1E706B8A9BA0F,11061,16,18,2,29,48,1498
43758,43758,03CC5102FB306C3254027D35E65D966E,42581,0,13,13,38,48,1948
43759,43759,03CC5102FB306C3254027D35E65D966E,11914,16,20,4,37,48,1898
43760,43760,03CC5102FB306C3254027D35E65D966E,42581,21,22,1,38,48,1948
43773,43773,6F6F174BF3BBBF4A283E7794B5A58265,11914,2,4,2,37,48,1898
43774,43774,6F6F174BF3BBBF4A283E7794B5A58265,42581,6,7,1,38,48,1948
43775,43775,6F6F174BF3BBBF4A283E7794B5A58265,11914,9,11,2,37,48,1898
43776,43776,6F6F174BF3BBBF4A283E7794B5A58265,42581,11,21,10,38,48,1948
43791,43791,B103546F88903BAA077A28BC1468C0D4,12921,0,17,17,9,41,491
43792,43792,B103546F88903BAA077A28BC1468C0D4,12641,18,21,3,10,43,543
43793,43793,B103546F88903BAA077A28BC1468C0D4,12921,22,23,1,9,41,491
43794,43794,7258BD809B9533F9D882FC2A6D37FD1F,13371,0,18,18,41,47,2097
43795,43795,7258BD809B9533F9D882FC2A6D37FD1F,13711,19,20,1,38,46,1946
43796,43796,7258BD809B9533F9D882FC2A6D37FD1F,13371,21,23,2,41,47,2097
43805,43805,0722208BA05F2FA64560C4BADA491D8E,12121,2,7,5,29,47,1497
43806,43806,0722208BA05F2FA64560C4BADA491D8E,11381,8,17,9,30,47,1547
43807,43807,0722208BA05F2FA64560C4BADA491D8E,12121,20,22,2,29,47,1497
43818,43818,E83888D24F9B489390D1BDDD69FB71BE,42401,0,2,2,36,47,1847
43819,43819,E83888D24F9B489390D1BDDD69FB71BE,13231,5,6,1,39,46,1996
43820,43820,E83888D24F9B489390D1BDDD69FB71BE,42861,7,23,16,37,44,1894
43829,43829,E5C174D2FF195FD116006ADE577A953D,11061,0,6,6,29,48,1498
43830,43830,E5C174D2FF195FD116006ADE577A953D,11151,8,16,8,30,48,1548
43831,43831,E5C174D2FF195FD116006ADE577A953D,11061,20,21,1,29,48,1498
43832,43832,BE0962E36708C29E65978ADB79B846A8,12661,0,7,7,32,45,1645
43833,43833,BE0962E36708C29E65978ADB79B846A8,12311,12,13,1,30,44,1544
43834,43834,BE0962E36708C29E65978ADB79B846A8,11381,15,16,1,30,47,1547
43835,43835,BE0962E36708C29E65978ADB79B846A8,11834,18,23,5,32,45,1645
43836,43836,CC263F7223914351461D35AE74AF3FAC,12971,0,10,10,32,48,1648
43837,43837,CC263F7223914351461D35AE74AF3FAC,10292,14,15,1,30,47,1547
43838,43838,CC263F7223914351461D35AE74AF3FAC,12971,18,20,2,32,48,1648
43845,43845,1DD1A250791E8DE9D0B949B1DAE230C8,11861,0,14,14,32,47,1647
43846,43846,1DD1A250791E8DE9D0B949B1DAE230C8,10281,15,18,3,33,48,1698
43847,43847,1DD1A250791E8DE9D0B949B1DAE230C8,11861,18,20,2,32,47,1647
43851,43851,0CEDFC599FE515911C8AF1ADD0F867C7,10841,0,4,4,37,47,1897
43852,43852,0CEDFC599FE515911C8AF1ADD0F867C7,42301,5,9,4,36,47,1847
43853,43853,0CEDFC599FE515911C8AF1ADD0F867C7,42511,12,20,8,37,47,1897
43857,43857,B90520ED7BDDE423CEFE3ED6913620C9,10271,1,7,6,37,46,1896
43858,43858,B90520ED7BDDE423CEFE3ED6913620C9,10841,10,16,6,37,47,1897
43859,43859,B90520ED7BDDE423CEFE3ED6913620C9,12514,17,19,2,38,47,1947
43860,43860,859846C23309918FCF7E37DF9FD45D9F,13911,0,6,6,39,46,1996
43861,43861,859846C23309918FCF7E37DF9FD45D9F,42231,6,10,4,37,46,1896
43862,43862,859846C23309918FCF7E37DF9FD45D9F,13911,12,13,1,39,46,1996
43863,43863,859846C23309918FCF7E37DF9FD45D9F,42231,14,18,4,37,46,1896
43873,43873,D19CCADD05AE7D38BD327DD3B3A1E602,42351,0,7,7,38,45,1945
43874,43874,D19CCADD05AE7D38BD327DD3B3A1E602,42231,8,9,1,37,46,1896
43875,43875,D19CCADD05AE7D38BD327DD3B3A1E602,42351,12,13,1,38,45,1945
43876,43876,D19CCADD05AE7D38BD327DD3B3A1E602,42231,15,22,7,37,46,1896
43897,43897,F18C7871BFB82CA1A349E44A5DE6D0B7,11021,0,18,18,36,49,1849
43898,43898,F18C7871BFB82CA1A349E44A5DE6D0B7,10221,19,21,2,34,49,1749
43899,43899,F18C7871BFB82CA1A349E44A5DE6D0B7,11021,22,23,1,36,49,1849
43907,43907,6460FC216A34C188FE4998AEEFF35C56,43451,2,4,2,37,40,1890
43908,43908,6460FC216A34C188FE4998AEEFF35C56,12521,8,10,2,35,41,1791
43909,43909,6460FC216A34C188FE4998AEEFF35C56,43451,13,23,10,37,40,1890
43910,43910,09803726F3C2A40BEF93389F75159E93,10281,0,16,16,33,48,1698
43911,43911,09803726F3C2A40BEF93389F75159E93,10251,17,18,1,35,47,1797
43912,43912,09803726F3C2A40BEF93389F75159E93,10281,18,20,2,33,48,1698
43913,43913,1DA7D70236936C90EAC57F810F371773,12131,8,11,3,32,47,1647
43914,43914,1DA7D70236936C90EAC57F810F371773,10281,11,19,8,33,48,1698
43915,43915,1DA7D70236936C90EAC57F810F371773,11861,19,23,4,32,47,1647
43924,43924,210582EEAC6D1F2BB5FAA5A446D73BC0,10381,0,7,7,31,49,1599
43925,43925,210582EEAC6D1F2BB5FAA5A446D73BC0,12381,10,15,5,32,48,1648
43926,43926,210582EEAC6D1F2BB5FAA5A446D73BC0,10381,16,18,2,31,49,1599
43927,43927,210582EEAC6D1F2BB5FAA5A446D73BC0,11531,20,22,2,34,49,1749
43933,43933,775D2A8F104041B3D53BA2721A326EFF,42151,8,9,1,35,45,1795
43934,43934,775D2A8F104041B3D53BA2721A326EFF,42861,10,16,6,37,44,1894
43935,43935,775D2A8F104041B3D53BA2721A326EFF,42151,17,20,3,35,45,1795
43936,43936,44B913A66AFA5E271FF541EC61CC9838,10111,0,2,2,37,47,1897
43937,43937,44B913A66AFA5E271FF541EC61CC9838,42301,3,4,1,36,47,1847
43938,43938,44B913A66AFA5E271FF541EC61CC9838,10111,4,23,19,37,47,1897
43939,43939,24576DC2C63BF30A46BA06C33A71F868,11261,5,9,4,36,46,1846
43940,43940,24576DC2C63BF30A46BA06C33A71F868,13911,9,10,1,39,46,1996
43941,43941,24576DC2C63BF30A46BA06C33A71F868,11261,14,18,4,36,46,1846
43942,43942,24576DC2C63BF30A46BA06C33A71F868,42511,19,20,1,37,47,1897
43946,43946,A38841C5C4A883D379ECA50564160D63,10281,0,6,6,33,48,1698
43947,43947,A38841C5C4A883D379ECA50564160D63,11381,6,18,12,30,47,1547
43948,43948,A38841C5C4A883D379ECA50564160D63,10281,19,20,1,33,48,1698
43965,43965,597064D826C3E01F204980F028CA1A17,42861,0,17,17,37,44,1894
43966,43966,597064D826C3E01F204980F028CA1A17,11261,17,18,1,36,46,1846
43967,43967,597064D826C3E01F204980F028CA1A17,42861,18,23,5,37,44,1894
43973,43973,94C244793C9D289B150510A6E7ED4D21,12491,3,4,1,36,43,1843
43974,43974,94C244793C9D289B150510A6E7ED4D21,42151,14,16,2,35,45,1795
43975,43975,94C244793C9D289B150510A6E7ED4D21,42861,21,22,1,37,44,1894
43976,43976,FEBD122FF83E402204912098A86567F3,42921,0,14,14,33,47,1697
43977,43977,FEBD122FF83E402204912098A86567F3,11861,16,20,4,32,47,1647
43978,43978,FEBD122FF83E402204912098A86567F3,42921,21,23,2,33,47,1697
43984,43984,4F985171E935EB3DC7536EAA1C4743E5,42623,2,4,2,22,49,1149
43985,43985,4F985171E935EB3DC7536EAA1C4743E5,42121,4,5,1,26,49,1349
43986,43986,4F985171E935EB3DC7536EAA1C4743E5,42623,6,21,15,22,49,1149
43998,43998,E24AFDE053B6D01DE83CD0A896B93907,11921,2,12,10,38,48,1948
43999,43999,E24AFDE053B6D01DE83CD0A896B93907,11331,13,14,1,37,48,1898
44000,44000,E24AFDE053B6D01DE83CD0A896B93907,11921,19,23,4,38,48,1948
44004,44004,E06FC86426E546DF6B8D146F4C749C15,11861,0,7,7,32,47,1647
44005,44005,E06FC86426E546DF6B8D146F4C749C15,10295,9,10,1,30,47,1547
44006,44006,E06FC86426E546DF6B8D146F4C749C15,11861,11,23,12,32,47,1647
44030,44030,FC32FCDE5EA162E6A3931CE10EF22190,11021,1,6,5,36,49,1849
44031,44031,FC32FCDE5EA162E6A3931CE10EF22190,11231,8,9,1,37,49,1899
44032,44032,FC32FCDE5EA162E6A3931CE10EF22190,11021,13,23,10,36,49,1849
44048,44048,935FCB4619C3634B9AF35CE40D9BEC6A,13341,0,8,8,44,45,2245
44049,44049,935FCB4619C3634B9AF35CE40D9BEC6A,42631,11,17,6,43,45,2195
44050,44050,935FCB4619C3634B9AF35CE40D9BEC6A,13341,17,18,1,44,45,2245
44057,44057,D0472C9DD91559BE905CC394F1918AAD,42321,0,7,7,43,47,2197
44058,44058,D0472C9DD91559BE905CC394F1918AAD,10801,8,9,1,42,47,2147
44059,44059,D0472C9DD91559BE905CC394F1918AAD,42321,13,22,9,43,47,2197
44060,44060,3EEA719324F26AC72664E6F0F99088AB,43391,10,14,4,29,48,1498
44061,44061,3EEA719324F26AC72664E6F0F99088AB,42071,18,19,1,31,49,1599
44062,44062,3EEA719324F26AC72664E6F0F99088AB,10951,20,21,1,29,48,1498
44067,44067,D1B0AAD57AE84B44D296B489B010F051,10281,2,7,5,33,48,1698
44068,44068,D1B0AAD57AE84B44D296B489B010F051,43661,11,14,3,33,47,1697
44069,44069,D1B0AAD57AE84B44D296B489B010F051,10281,18,22,4,33,48,1698
44079,44079,130A3F07110C04FAA25AF414856A2109,43731,0,6,6,34,47,1747
44080,44080,130A3F07110C04FAA25AF414856A2109,10731,9,13,4,33,47,1697
44081,44081,130A3F07110C04FAA25AF414856A2109,10281,15,18,3,33,48,1698
44082,44082,130A3F07110C04FAA25AF414856A2109,10731,21,23,2,33,47,1697
44087,44087,4E7614A4B91A30F096E19E723EE62442,10634,0,6,6,27,45,1395
44088,44088,4E7614A4B91A30F096E19E723EE62442,11871,7,10,3,29,46,1496
44089,44089,4E7614A4B91A30F096E19E723EE62442,10634,13,21,8,27,45,1395
44090,44090,EAAB672210C677BA2879CCE67BDB7DF5,11151,0,6,6,30,48,1548
44091,44091,EAAB672210C677BA2879CCE67BDB7DF5,42831,6,8,2,27,48,1398
44092,44092,EAAB672210C677BA2879CCE67BDB7DF5,11151,11,13,2,30,48,1548
44093,44093,EAAB672210C677BA2879CCE67BDB7DF5,42831,16,18,2,27,48,1398
44097,44097,60E47AB33736AC41E2674A67294A03D4,12491,8,10,2,36,43,1843
44098,44098,60E47AB33736AC41E2674A67294A03D4,11261,14,19,5,36,46,1846
44099,44099,60E47AB33736AC41E2674A67294A03D4,12491,19,21,2,36,43,1843
44100,44100,6B9FDBAAD19DC3CF76E1F01F4E6AA1D3,13711,0,7,7,38,46,1946
44101,44101,6B9FDBAAD19DC3CF76E1F01F4E6AA1D3,11491,9,17,8,36,47,1847
44102,44102,6B9FDBAAD19DC3CF76E1F01F4E6AA1D3,42011,18,19,1,36,46,1846
44103,44103,6B9FDBAAD19DC3CF76E1F01F4E6AA1D3,13711,21,22,1,38,46,1946
44112,44112,13FEB49EBF8CBBDDDEE7B78BF37E951A,10251,0,10,10,35,47,1797
44113,44113,13FEB49EBF8CBBDDDEE7B78BF37E951A,43731,12,17,5,34,47,1747
44114,44114,13FEB49EBF8CBBDDDEE7B78BF37E951A,10251,19,23,4,35,47,1797
44115,44115,534F3B1CD78FDD46A8ACE2B5E3E0C898,13231,3,10,7,39,46,1996
44116,44116,534F3B1CD78FDD46A8ACE2B5E3E0C898,11261,13,17,4,36,46,1846
44117,44117,534F3B1CD78FDD46A8ACE2B5E3E0C898,13221,20,21,1,40,47,2047
44118,44118,7308A861032DD6CDA204025A180927B9,19114,0,11,11,7,43,393
44119,44119,7308A861032DD6CDA204025A180927B9,12641,15,17,2,10,43,543
44120,44120,7308A861032DD6CDA204025A180927B9,19114,17,22,5,7,43,393
44121,44121,DE7BE47E05724D2B7B84051451E0119E,11261,0,1,1,36,46,1846
44122,44122,DE7BE47E05724D2B7B84051451E0119E,12491,1,7,6,36,43,1843
44123,44123,DE7BE47E05724D2B7B84051451E0119E,10111,9,21,12,37,47,1897
44124,44124,DE7BE47E05724D2B7B84051451E0119E,42161,21,23,2,36,47,1847
44152,44152,1F6BCFEB56D245CBF5160F742055C8A2,11151,0,6,6,30,48,1548
44153,44153,1F6BCFEB56D245CBF5160F742055C8A2,11061,6,16,10,29,48,1498
44154,44154,1F6BCFEB56D245CBF5160F742055C8A2,11151,18,23,5,30,48,1548
44160,44160,6197D1F5F199B2AF14F376E050B6EC88,10107,0,8,8,38,49,1949
44161,44161,6197D1F5F199B2AF14F376E050B6EC88,11231,9,18,9,37,49,1899
44162,44162,6197D1F5F199B2AF14F376E050B6EC88,10107,19,23,4,38,49,1949
44166,44166,04C024AD6716C59AEF71765CE69E1D56,10781,0,14,14,35,47,1797
44167,44167,04C024AD6716C59AEF71765CE69E1D56,43731,16,17,1,34,47,1747
44168,44168,04C024AD6716C59AEF71765CE69E1D56,10781,18,23,5,35,47,1797
44169,44169,3856DC85E96E9F6D602A278A8886E1C3,10351,0,16,16,28,45,1445
44170,44170,3856DC85E96E9F6D602A278A8886E1C3,10634,18,20,2,27,45,1395
44171,44171,3856DC85E96E9F6D602A278A8886E1C3,10351,21,22,1,28,45,1445
44179,44179,C89DD497B3E25F408D5F4E0FF457EA4C,11914,0,9,9,37,48,1898
44180,44180,C89DD497B3E25F408D5F4E0FF457EA4C,42581,9,10,1,38,48,1948
44181,44181,C89DD497B3E25F408D5F4E0FF457EA4C,11914,12,21,9,37,48,1898
44182,44182,8820D655222FFDC13E2E08EC252AACD5,42161,0,7,7,36,47,1847
44183,44183,8820D655222FFDC13E2E08EC252AACD5,10971,8,9,1,35,47,1797
44184,44184,8820D655222FFDC13E2E08EC252AACD5,43731,13,15,2,34,47,1747
44185,44185,8820D655222FFDC13E2E08EC252AACD5,40431,19,21,2,36,47,1847
44189,44189,7A880FE847C48EF3051E04A866E8ED9A,13221,1,6,5,40,47,2047
44190,44190,7A880FE847C48EF3051E04A866E8ED9A,11551,6,14,8,39,49,1999
44191,44191,7A880FE847C48EF3051E04A866E8ED9A,13221,18,19,1,40,47,2047
44192,44192,7A880FE847C48EF3051E04A866E8ED9A,11741,20,23,3,42,49,2149
44223,44223,5A8308F9DAAF40265186D4E63F2640C9,12381,0,7,7,32,48,1648
44224,44224,5A8308F9DAAF40265186D4E63F2640C9,13731,7,16,9,33,49,1699
44225,44225,5A8308F9DAAF40265186D4E63F2640C9,10721,19,23,4,31,48,1598
44248,44248,1AA4035AA5CAFF9DEDB0DEF2EBA8DFEF,11914,1,9,8,37,48,1898
44249,44249,1AA4035AA5CAFF9DEDB0DEF2EBA8DFEF,10191,12,13,1,40,48,2048
44250,44250,1AA4035AA5CAFF9DEDB0DEF2EBA8DFEF,11914,14,23,9,37,48,1898
44251,44251,0B82B0E8C50E14C64D4857F2553CA64D,42231,0,6,6,37,46,1896
44252,44252,0B82B0E8C50E14C64D4857F2553CA64D,13121,10,12,2,38,46,1946
44253,44253,0B82B0E8C50E14C64D4857F2553CA64D,42011,14,17,3,36,46,1846
44254,44254,0B82B0E8C50E14C64D4857F2553CA64D,42351,20,21,1,38,45,1945
44259,44259,8DBE84C49365F516DF2160EF0C19F4A0,11261,0,7,7,36,46,1846
44260,44260,8DBE84C49365F516DF2160EF0C19F4A0,12083,16,18,2,36,49,1849
44261,44261,8DBE84C49365F516DF2160EF0C19F4A0,11261,18,19,1,36,46,1846
44262,44262,8DBE84C49365F516DF2160EF0C19F4A0,10151,19,23,4,34,47,1747
44270,44270,1D20B498D42204F7DA0BA75047AF3620,11271,0,10,10,37,48,1898
44271,44271,1D20B498D42204F7DA0BA75047AF3620,11531,15,16,1,34,49,1749
44272,44272,1D20B498D42204F7DA0BA75047AF3620,11271,17,19,2,37,48,1898
44273,44273,1D20B498D42204F7DA0BA75047AF3620,10971,19,22,3,35,47,1797
44280,44280,A3527B28F943747FD3E7236787EEF029,11861,0,3,3,32,47,1647
44281,44281,A3527B28F943747FD3E7236787EEF029,42921,3,12,9,33,47,1697
44282,44282,A3527B28F943747FD3E7236787EEF029,11861,14,16,2,32,47,1647
44283,44283,A3527B28F943747FD3E7236787EEF029,42921,18,22,4,33,47,1697
44293,44293,A26526FCE25758DA240C3B314B205E8A,19024,0,3,3,9,45,495
44294,44294,A26526FCE25758DA240C3B314B205E8A,12641,7,18,11,10,43,543
44295,44295,A26526FCE25758DA240C3B314B205E8A,19024,19,23,4,9,45,495
44296,44296,2E071E958DC228D15CF6E43A0AA0F938,43761,0,6,6,32,47,1647
44297,44297,2E071E958DC228D15CF6E43A0AA0F938,42523,6,8,2,31,47,1597
44298,44298,2E071E958DC228D15CF6E43A0AA0F938,43761,10,20,10,32,47,1647
44310,44310,189C54EA37D8896B78DBF80EEA026F2F,19931,2,6,4,7,43,393
44311,44311,189C54EA37D8896B78DBF80EEA026F2F,12641,7,8,1,10,43,543
44312,44312,189C54EA37D8896B78DBF80EEA026F2F,19931,11,18,7,7,43,393
44321,44321,5CBB3BFC4ED61841A41A893768B01036,13911,0,10,10,39,46,1996
44322,44322,5CBB3BFC4ED61841A41A893768B01036,11261,11,12,1,36,46,1846
44323,44323,5CBB3BFC4ED61841A41A893768B01036,13911,14,23,9,39,46,1996
44332,44332,EABF28797D97856E54EB3FDF8463D413,13911,0,7,7,39,46,1996
44333,44333,EABF28797D97856E54EB3FDF8463D413,10231,8,10,2,39,49,1999
44334,44334,EABF28797D97856E54EB3FDF8463D413,11781,11,20,9,38,49,1949
44335,44335,EABF28797D97856E54EB3FDF8463D413,10231,21,22,1,39,49,1999
44340,44340,0277E6ABE6E23FB8B51E9078601CBBC1,42491,0,8,8,32,46,1646
44341,44341,0277E6ABE6E23FB8B51E9078601CBBC1,10292,11,13,2,30,47,1547
44342,44342,0277E6ABE6E23FB8B51E9078601CBBC1,42523,13,17,4,31,47,1597
44343,44343,0277E6ABE6E23FB8B51E9078601CBBC1,42491,18,20,2,32,46,1646
44349,44349,2FC852B4FFDF067DECF04814ED84AACA,13681,0,2,2,38,47,1947
44350,44350,2FC852B4FFDF067DECF04814ED84AACA,42511,2,11,9,37,47,1897
44351,44351,2FC852B4FFDF067DECF04814ED84AACA,13681,16,17,1,38,47,1947
44352,44352,2FC852B4FFDF067DECF04814ED84AACA,42511,21,23,2,37,47,1897
44358,44358,2C92D9A1E7726DE0B07E3A3E97221DE4,42941,0,14,14,37,47,1897
44359,44359,2C92D9A1E7726DE0B07E3A3E97221DE4,12083,16,17,1,36,49,1849
44360,44360,2C92D9A1E7726DE0B07E3A3E97221DE4,10107,17,20,3,38,49,1949
44361,44361,F8EA0C68F3C8266C3E7BA4F2FCE6F8BC,19441,0,7,7,8,46,446
44362,44362,F8EA0C68F3C8266C3E7BA4F2FCE6F8BC,42041,10,11,1,10,47,547
44363,44363,F8EA0C68F3C8266C3E7BA4F2FCE6F8BC,19441,12,23,11,8,46,446
44377,44377,1E80787B69718C7476B2A0E1C06850FD,10111,0,9,9,37,47,1897
44378,44378,1E80787B69718C7476B2A0E1C06850FD,42161,11,15,4,36,47,1847
44379,44379,1E80787B69718C7476B2A0E1C06850FD,10111,18,22,4,37,47,1897
44380,44380,59562AEEA1EC6BCB6F4C7AC842D59FB8,43281,0,13,13,37,48,1898
44381,44381,59562AEEA1EC6BCB6F4C7AC842D59FB8,12083,14,19,5,36,49,1849
44382,44382,59562AEEA1EC6BCB6F4C7AC842D59FB8,43281,20,23,3,37,48,1898
44383,44383,29F1C4A8CFA8E7584C80E5B03BFAE793,10841,0,10,10,37,47,1897
44384,44384,29F1C4A8CFA8E7584C80E5B03BFAE793,11781,11,17,6,38,49,1949
44385,44385,29F1C4A8CFA8E7584C80E5B03BFAE793,10841,22,23,1,37,47,1897
44389,44389,F5640B3ED25403D6D9CD74278C7FCA06,10971,0,9,9,35,47,1797
44390,44390,F5640B3ED25403D6D9CD74278C7FCA06,42161,13,14,1,36,47,1847
44391,44391,F5640B3ED25403D6D9CD74278C7FCA06,10971,15,19,4,35,47,1797
44392,44392,4B706CBBBDE9BF48F90679E8BB90E0D8,13911,3,14,11,39,46,1996
44393,44393,4B706CBBBDE9BF48F90679E8BB90E0D8,42231,15,20,5,37,46,1896
44394,44394,4B706CBBBDE9BF48F90679E8BB90E0D8,42351,21,22,1,38,45,1945
44395,44395,805EE774A2BBF9DBFC5B48F9642AD1F7,10111,0,7,7,37,47,1897
44396,44396,805EE774A2BBF9DBFC5B48F9642AD1F7,42301,10,12,2,36,47,1847
44397,44397,805EE774A2BBF9DBFC5B48F9642AD1F7,11074,12,14,2,37,47,1897
44398,44398,805EE774A2BBF9DBFC5B48F9642AD1F7,42301,17,23,6,36,47,1847
44412,44412,D75859C5199E26E4E069299921FEC112,42921,2,9,7,33,47,1697
44413,44413,D75859C5199E26E4E069299921FEC112,43761,9,14,5,32,47,1647
44414,44414,D75859C5199E26E4E069299921FEC112,42921,14,19,5,33,47,1697
44415,44415,D75859C5199E26E4E069299921FEC112,43761,19,22,3,32,47,1647
44416,44416,968616CCBF964040CCE17F91EF27B356,13941,0,8,8,41,47,2097
44417,44417,968616CCBF964040CCE17F91EF27B356,10924,10,15,5,43,49,2199
44418,44418,968616CCBF964040CCE17F91EF27B356,11806,18,19,1,41,48,2098
44419,44419,11084E1187B5716831AF529F7984FD11,13941,0,2,2,41,47,2097
44420,44420,11084E1187B5716831AF529F7984FD11,11001,4,19,15,42,47,2147
44421,44421,11084E1187B5716831AF529F7984FD11,13941,20,23,3,41,47,2097
44422,44422,47D09A36F483F0AC540B1F4631B34CE2,41392,0,14,14,43,48,2198
44423,44423,47D09A36F483F0AC540B1F4631B34CE2,10421,16,18,2,41,48,2098
44424,44424,47D09A36F483F0AC540B1F4631B34CE2,41392,19,23,4,43,48,2198
44425,44425,44AA91905A7E8DBC24B0A51CC88C9204,42151,0,13,13,35,45,1795
44426,44426,44AA91905A7E8DBC24B0A51CC88C9204,11261,13,18,5,36,46,1846
44427,44427,44AA91905A7E8DBC24B0A51CC88C9204,42151,18,23,5,35,45,1795
44433,44433,D429059E8DAFE4585A03A4BAC5119A7D,42271,0,7,7,40,47,2047
44434,44434,D429059E8DAFE4585A03A4BAC5119A7D,11806,11,12,1,41,48,2098
44435,44435,D429059E8DAFE4585A03A4BAC5119A7D,42271,15,23,8,40,47,2047
44436,44436,58160F8286644CCBCCC72FA14DAD9C05,19114,0,5,5,7,43,393
44437,44437,58160F8286644CCBCCC72FA14DAD9C05,12641,6,17,11,10,43,543
44438,44438,58160F8286644CCBCCC72FA14DAD9C05,19114,18,22,4,7,43,393
44442,44442,76780BDA1CE8853E5C6D6B4A56C0AC5B,12121,8,9,1,29,47,1497
44443,44443,76780BDA1CE8853E5C6D6B4A56C0AC5B,11381,9,15,6,30,47,1547
44444,44444,76780BDA1CE8853E5C6D6B4A56C0AC5B,12121,17,18,1,29,47,1497
44445,44445,76780BDA1CE8853E5C6D6B4A56C0AC5B,11381,18,21,3,30,47,1547
44446,44446,8E56A2D7B8313A9FB3CAF238A13A9C29,11541,0,11,11,35,49,1799
44447,44447,8E56A2D7B8313A9FB3CAF238A13A9C29,11021,12,18,6,36,49,1849
44448,44448,8E56A2D7B8313A9FB3CAF238A13A9C29,11541,21,23,2,35,49,1799
44457,44457,EA7259828C59286A0C8476F89AAE54B8,11261,2,19,17,36,46,1846
44458,44458,EA7259828C59286A0C8476F89AAE54B8,42351,20,21,1,38,45,1945
44459,44459,EA7259828C59286A0C8476F89AAE54B8,11261,21,23,2,36,46,1846
44460,44460,B8DCAC0FC6FA981D871032E55C240C8E,11914,0,12,12,37,48,1898
44461,44461,B8DCAC0FC6FA981D871032E55C240C8E,40171,14,16,2,38,48,1948
44462,44462,B8DCAC0FC6FA981D871032E55C240C8E,11914,16,18,2,37,48,1898
44463,44463,B8DCAC0FC6FA981D871032E55C240C8E,42581,20,22,2,38,48,1948
44490,44490,12915B7CE801D56C12C57B7092EB877D,11914,7,8,1,37,48,1898
44491,44491,12915B7CE801D56C12C57B7092EB877D,43181,8,14,6,39,48,1998
44492,44492,12915B7CE801D56C12C57B7092EB877D,11914,16,19,3,37,48,1898
44493,44493,12915B7CE801D56C12C57B7092EB877D,42581,22,23,1,38,48,1948
44497,44497,42A16EFB84F2A02AEC5229D088C54FF3,42351,1,5,4,38,45,1945
44498,44498,42A16EFB84F2A02AEC5229D088C54FF3,13911,6,7,1,39,46,1996
44499,44499,42A16EFB84F2A02AEC5229D088C54FF3,42231,9,10,1,37,46,1896
44500,44500,42A16EFB84F2A02AEC5229D088C54FF3,13911,13,23,10,39,46,1996
44501,44501,B85E363F1908670706C802EE57B36E76,10281,0,9,9,33,48,1698
44502,44502,B85E363F1908670706C802EE57B36E76,11861,9,11,2,32,47,1647
44503,44503,B85E363F1908670706C802EE57B36E76,12381,15,16,1,32,48,1648
44504,44504,B85E363F1908670706C802EE57B36E76,11861,21,22,1,32,47,1647
44505,44505,92C8015915103969F85C9CE1A5B066AB,11861,0,14,14,32,47,1647
44506,44506,92C8015915103969F85C9CE1A5B066AB,10281,15,17,2,33,48,1698
44507,44507,92C8015915103969F85C9CE1A5B066AB,11861,17,23,6,32,47,1647
44518,44518,C619BC39ADD64D285F289B032026DA59,11074,0,8,8,37,47,1897
44519,44519,C619BC39ADD64D285F289B032026DA59,43671,9,10,1,35,48,1798
44520,44520,C619BC39ADD64D285F289B032026DA59,11941,12,16,4,37,46,1896
44521,44521,C619BC39ADD64D285F289B032026DA59,11074,19,22,3,37,47,1897
44533,44533,9C819019C9FBB04766CC6EE29C66CE0E,10111,0,6,6,37,47,1897
44534,44534,9C819019C9FBB04766CC6EE29C66CE0E,12514,8,9,1,38,47,1947
44535,44535,9C819019C9FBB04766CC6EE29C66CE0E,11074,12,17,5,37,47,1897
44536,44536,9C819019C9FBB04766CC6EE29C66CE0E,10411,19,21,2,36,48,1848
44537,44537,6B3F914E788F6572FB4693A6E74B7B94,12511,0,10,10,39,47,1997
44538,44538,6B3F914E788F6572FB4693A6E74B7B94,11911,11,13,2,37,48,1898
44539,44539,6B3F914E788F6572FB4693A6E74B7B94,13381,13,23,10,39,47,1997
44568,44568,FBE2A77FF5C759F401BA1AFF769A4FE3,11461,0,9,9,37,49,1899
44569,44569,FBE2A77FF5C759F401BA1AFF769A4FE3,11021,11,18,7,36,49,1849
44570,44570,FBE2A77FF5C759F401BA1AFF769A4FE3,11461,19,23,4,37,49,1899
44576,44576,FC0936587C74EF8144A5D7B54D78302D,19021,3,11,8,10,45,545
44577,44577,FC0936587C74EF8144A5D7B54D78302D,11571,12,13,1,13,46,696
44578,44578,FC0936587C74EF8144A5D7B54D78302D,19024,14,19,5,9,45,495
44579,44579,36B9A094E8D22C518990766A8F925428,19114,2,4,2,7,43,393
44580,44580,36B9A094E8D22C518990766A8F925428,12641,5,14,9,10,43,543
44581,44581,36B9A094E8D22C518990766A8F925428,19114,16,18,2,7,43,393
44582,44582,C1896697E8F9082F3C179E6CB902F84B,13141,1,5,4,23,30,1180
44583,44583,C1896697E8F9082F3C179E6CB902F84B,49181,5,21,16,21,31,1081
44584,44584,C1896697E8F9082F3C179E6CB902F84B,12871,21,23,2,22,33,1133
44589,44589,111CDDD5FA2E313735C2BD7B109AA3EE,42151,3,5,2,35,45,1795
44590,44590,111CDDD5FA2E313735C2BD7B109AA3EE,42861,8,9,1,37,44,1894
44591,44591,111CDDD5FA2E313735C2BD7B109AA3EE,42151,10,12,2,35,45,1795
44592,44592,111CDDD5FA2E313735C2BD7B109AA3EE,42861,12,23,11,37,44,1894
44608,44608,2EBE142BB70D514367A5435D87FB646A,11061,0,12,12,29,48,1498
44609,44609,2EBE142BB70D514367A5435D87FB646A,10681,14,15,1,30,48,1548
44610,44610,2EBE142BB70D514367A5435D87FB646A,11061,19,21,2,29,48,1498
44611,44611,19A29A27E6506D34C07A04E6E9F52A03,12491,0,7,7,36,43,1843
44612,44612,19A29A27E6506D34C07A04E6E9F52A03,42151,8,11,3,35,45,1795
44613,44613,19A29A27E6506D34C07A04E6E9F52A03,12491,11,12,1,36,43,1843
44614,44614,19A29A27E6506D34C07A04E6E9F52A03,42151,13,22,9,35,45,1795
44621,44621,CCEAAD39A78CFEE615341AE4AEED1B86,13791,0,14,14,42,47,2147
44622,44622,CCEAAD39A78CFEE615341AE4AEED1B86,43061,15,17,2,43,46,2196
44623,44623,CCEAAD39A78CFEE615341AE4AEED1B86,13791,22,23,1,42,47,2147
44651,44651,AFF2B1944207762129EB0E25C3502ADB,13711,0,6,6,38,46,1946
44652,44652,AFF2B1944207762129EB0E25C3502ADB,11941,6,21,15,37,46,1896
44653,44653,AFF2B1944207762129EB0E25C3502ADB,13711,21,22,1,38,46,1946
44661,44661,660D2150C1391153938CD9B90E2CE919,12641,1,4,3,10,43,543
44662,44662,660D2150C1391153938CD9B90E2CE919,19021,7,17,10,10,45,545
44663,44663,660D2150C1391153938CD9B90E2CE919,12641,21,23,2,10,43,543
44669,44669,B3D9D8E72FD92A77A76B6490766A3C36,19741,8,12,4,5,44,294
44670,44670,B3D9D8E72FD92A77A76B6490766A3C36,19901,15,17,2,7,44,394
44671,44671,B3D9D8E72FD92A77A76B6490766A3C36,19114,22,23,1,7,43,393
44681,44681,394D700E14C58A7853C10805B183B24E,11381,1,6,5,30,47,1547
44682,44682,394D700E14C58A7853C10805B183B24E,11875,8,18,10,30,46,1546
44683,44683,394D700E14C58A7853C10805B183B24E,11381,19,21,2,30,47,1547
44684,44684,71C7D3BEB879651EE771977BC4EF34E5,10341,2,6,4,31,47,1597
44685,44685,71C7D3BEB879651EE771977BC4EF34E5,12661,9,17,8,32,45,1645
44686,44686,71C7D3BEB879651EE771977BC4EF34E5,10341,20,23,3,31,47,1597
44693,44693,A3BFED7EBC8273A150663075EB9361B2,40181,4,5,1,37,49,1899
44694,44694,A3BFED7EBC8273A150663075EB9361B2,11271,9,11,2,37,48,1898
44695,44695,A3BFED7EBC8273A150663075EB9361B2,40181,14,15,1,37,49,1899
44696,44696,A3BFED7EBC8273A150663075EB9361B2,11914,19,23,4,37,48,1898
44725,44725,669C34237215178780FBCDB7F5444D7E,10681,3,4,1,30,48,1548
44726,44726,669C34237215178780FBCDB7F5444D7E,42521,4,17,13,31,47,1597
44727,44727,669C34237215178780FBCDB7F5444D7E,11381,21,23,2,30,47,1547
44736,44736,EFD3CD287097CC7EB227645070325EE5,13341,0,19,19,44,45,2245
44737,44737,EFD3CD287097CC7EB227645070325EE5,10921,19,21,2,43,48,2198
44738,44738,EFD3CD287097CC7EB227645070325EE5,13341,21,23,2,44,45,2245
44744,44744,2CDE361215FD33E3DA3F37A407122C07,11641,9,10,1,22,49,1149
44745,44745,2CDE361215FD33E3DA3F37A407122C07,42081,11,20,9,24,49,1249
44746,44746,2CDE361215FD33E3DA3F37A407122C07,11641,22,23,1,22,49,1149
44758,44758,6DFA48F81EF42083077B44FC80706865,43731,0,6,6,34,47,1747
44759,44759,6DFA48F81EF42083077B44FC80706865,10971,6,9,3,35,47,1797
44760,44760,6DFA48F81EF42083077B44FC80706865,42161,12,18,6,36,47,1847
44761,44761,6DFA48F81EF42083077B44FC80706865,13511,21,22,1,34,48,1748
44765,44765,700A8469B8648E235281334EF5CC8DA1,10371,0,15,15,37,49,1899
44766,44766,700A8469B8648E235281334EF5CC8DA1,10471,16,19,3,37,48,1898
44767,44767,700A8469B8648E235281334EF5CC8DA1,10371,20,23,3,37,49,1899
44776,44776,ABC9186267E71F28FA785B0F903DDD72,40171,0,1,1,38,48,1948
44777,44777,ABC9186267E71F28FA785B0F903DDD72,10471,3,16,13,37,48,1898
44778,44778,ABC9186267E71F28FA785B0F903DDD72,40171,17,23,6,38,48,1948
44782,44782,23F8F9B0AC0C62AC07DD5CA5BCEDE820,43101,6,17,11,46,40,2340
44783,44783,23F8F9B0AC0C62AC07DD5CA5BCEDE820,13551,17,20,3,45,38,2288
44784,44784,23F8F9B0AC0C62AC07DD5CA5BCEDE820,43101,21,23,2,46,40,2340
44785,44785,E835E54D31E2053FF59F5E3D61ABCD72,11151,1,15,14,30,48,1548
44786,44786,E835E54D31E2053FF59F5E3D61ABCD72,11061,18,19,1,29,48,1498
44787,44787,E835E54D31E2053FF59F5E3D61ABCD72,11151,22,23,1,30,48,1548
44793,44793,87F0A5B37D23577900D9D67376C1E962,12381,0,14,14,32,48,1648
44794,44794,87F0A5B37D23577900D9D67376C1E962,42523,17,18,1,31,47,1597
44795,44795,87F0A5B37D23577900D9D67376C1E962,12381,19,20,1,32,48,1648
44796,44796,87F0A5B37D23577900D9D67376C1E962,11381,21,22,1,30,47,1547
44815,44815,59BD966FE7595E6B73F7A7CC1B56DA5C,12514,1,2,1,38,47,1947
44816,44816,59BD966FE7595E6B73F7A7CC1B56DA5C,11074,2,4,2,37,47,1897
44817,44817,59BD966FE7595E6B73F7A7CC1B56DA5C,12514,4,19,15,38,47,1947
44818,44818,668B25EA27DB62433F6B97341A2F29D6,10251,0,8,8,35,47,1797
44819,44819,668B25EA27DB62433F6B97341A2F29D6,43731,12,14,2,34,47,1747
44820,44820,668B25EA27DB62433F6B97341A2F29D6,42021,16,17,1,33,47,1697
44821,44821,668B25EA27DB62433F6B97341A2F29D6,10251,20,23,3,35,47,1797
44822,44822,64BD805F6D9361B926D90DA2610BBB4F,12921,0,8,8,9,41,491
44823,44823,64BD805F6D9361B926D90DA2610BBB4F,49201,9,17,8,7,41,391
44824,44824,64BD805F6D9361B926D90DA2610BBB4F,12921,18,21,3,9,41,491
44825,44825,7F8FEC3F30CB3DD9FA8B49EBAA16E6AE,10111,0,8,8,37,47,1897
44826,44826,7F8FEC3F30CB3DD9FA8B49EBAA16E6AE,13121,9,10,1,38,46,1946
44827,44827,7F8FEC3F30CB3DD9FA8B49EBAA16E6AE,10111,11,23,12,37,47,1897
44831,44831,1CE5F4D10EE2FB173CB9F2BC0746661A,42531,0,2,2,31,45,1595
44832,44832,1CE5F4D10EE2FB173CB9F2BC0746661A,12311,2,3,1,30,44,1544
44833,44833,1CE5F4D10EE2FB173CB9F2BC0746661A,42531,3,7,4,31,45,1595
44834,44834,1CE5F4D10EE2FB173CB9F2BC0746661A,12311,7,20,13,30,44,1544
44840,44840,A4A8A17ADDEADCAC8025633329473810,12971,0,14,14,32,48,1648
44841,44841,A4A8A17ADDEADCAC8025633329473810,42523,15,17,2,31,47,1597
44842,44842,A4A8A17ADDEADCAC8025633329473810,12971,19,23,4,32,48,1648
44843,44843,5B51BC643A26489396AC90A6305DBADE,11231,0,11,11,37,49,1899
44844,44844,5B51BC643A26489396AC90A6305DBADE,13731,15,16,1,33,49,1699
44845,44845,5B51BC643A26489396AC90A6305DBADE,11231,18,23,5,37,49,1899
44846,44846,CD55B44A3FD4B718A673CC03711FD344,12921,0,6,6,9,41,491
44847,44847,CD55B44A3FD4B718A673CC03711FD344,12641,10,11,1,10,43,543
44848,44848,CD55B44A3FD4B718A673CC03711FD344,12921,15,21,6,9,41,491
44858,44858,D3E46B15B35DC3C198E6EE945D227259,11806,0,5,5,41,48,2098
44859,44859,D3E46B15B35DC3C198E6EE945D227259,42271,5,11,6,40,47,2047
44860,44860,D3E46B15B35DC3C198E6EE945D227259,13381,12,16,4,39,47,1997
44861,44861,D3E46B15B35DC3C198E6EE945D227259,42271,16,18,2,40,47,2047
44862,44862,25F1B1F901DD17A5CCAEC6EC47760B2D,11541,0,5,5,35,49,1799
44863,44863,25F1B1F901DD17A5CCAEC6EC47760B2D,11021,8,15,7,36,49,1849
44864,44864,25F1B1F901DD17A5CCAEC6EC47760B2D,11541,18,22,4,35,49,1799
44874,44874,EF24F74DDF741D0DEC0CB3B2510AE4FC,10351,0,6,6,28,45,1445
44875,44875,EF24F74DDF741D0DEC0CB3B2510AE4FC,10301,8,20,12,31,45,1595
44876,44876,EF24F74DDF741D0DEC0CB3B2510AE4FC,10351,22,23,1,28,45,1445
44877,44877,9D5FAD2D946916458AB09D98B7F6CB85,42623,0,7,7,22,49,1149
44878,44878,9D5FAD2D946916458AB09D98B7F6CB85,42081,9,10,1,24,49,1249
44879,44879,9D5FAD2D946916458AB09D98B7F6CB85,42623,13,21,8,22,49,1149
44899,44899,AA999DDA1AEE251450B653F18B06EA76,42161,0,3,3,36,47,1847
44900,44900,AA999DDA1AEE251450B653F18B06EA76,11231,3,11,8,37,49,1899
44901,44901,AA999DDA1AEE251450B653F18B06EA76,42961,15,19,4,35,49,1799
44902,44902,AA999DDA1AEE251450B653F18B06EA76,11231,20,21,1,37,49,1899
44903,44903,B9B3660EABE6D031242D915A3C01CD0E,42581,0,8,8,38,48,1948
44904,44904,B9B3660EABE6D031242D915A3C01CD0E,12514,11,14,3,38,47,1947
44905,44905,B9B3660EABE6D031242D915A3C01CD0E,42581,17,21,4,38,48,1948
44906,44906,20E0A0CD7B2BF4710A85163AD8066BCE,10681,0,8,8,30,48,1548
44907,44907,20E0A0CD7B2BF4710A85163AD8066BCE,40094,9,15,6,29,48,1498
44908,44908,20E0A0CD7B2BF4710A85163AD8066BCE,11151,15,16,1,30,48,1548
44909,44909,20E0A0CD7B2BF4710A85163AD8066BCE,43311,17,22,5,31,48,1598
44924,44924,53D8E731DA65650E5B825C52CF592433,11261,2,10,8,36,46,1846
44925,44925,53D8E731DA65650E5B825C52CF592433,11081,11,13,2,35,46,1796
44926,44926,53D8E731DA65650E5B825C52CF592433,10161,13,20,7,35,49,1799
44927,44927,53D8E731DA65650E5B825C52CF592433,11261,21,22,1,36,46,1846
44928,44928,B008950D13439AAF34B6D4BE3B059216,13651,0,9,9,30,47,1547
44929,44929,B008950D13439AAF34B6D4BE3B059216,42523,10,12,2,31,47,1597
44930,44930,B008950D13439AAF34B6D4BE3B059216,13651,13,20,7,30,47,1547
44937,44937,804B7737707030C63DF2E4BD94DF220F,11806,0,5,5,41,48,2098
44938,44938,804B7737707030C63DF2E4BD94DF220F,42031,6,7,1,40,46,2046
44939,44939,804B7737707030C63DF2E4BD94DF220F,11806,7,23,16,41,48,2098
44983,44983,154B39807A422FDB28537C4227930019,11941,0,14,14,37,46,1896
44984,44984,154B39807A422FDB28537C4227930019,13711,16,18,2,38,46,1946
44985,44985,154B39807A422FDB28537C4227930019,11941,21,22,1,37,46,1896
44999,44999,1CDF6C6970CBC7D24D606B7FD41E9D6C,12921,0,5,5,9,41,491
45000,45000,1CDF6C6970CBC7D24D606B7FD41E9D6C,12641,8,9,1,10,43,543
45001,45001,1CDF6C6970CBC7D24D606B7FD41E9D6C,12921,15,19,4,9,41,491
45011,45011,874A771EE0B6F45D76A7E0A56CE9E147,10331,0,1,1,39,46,1996
45012,45012,874A771EE0B6F45D76A7E0A56CE9E147,12514,2,3,1,38,47,1947
45013,45013,874A771EE0B6F45D76A7E0A56CE9E147,43191,4,13,9,40,49,2049
45014,45014,874A771EE0B6F45D76A7E0A56CE9E147,42191,14,21,7,38,49,1949
45015,45015,9B8E3A84EF821A3E9564A6D6EAEA0FE5,42581,0,1,1,38,48,1948
45016,45016,9B8E3A84EF821A3E9564A6D6EAEA0FE5,11914,5,11,6,37,48,1898
45017,45017,9B8E3A84EF821A3E9564A6D6EAEA0FE5,10661,15,16,1,37,49,1899
45018,45018,9B8E3A84EF821A3E9564A6D6EAEA0FE5,42581,18,20,2,38,48,1948
45037,45037,A9CB10B468D8E4AF35699B759EB26E7B,10251,0,11,11,35,47,1797
45038,45038,A9CB10B468D8E4AF35699B759EB26E7B,10411,13,18,5,36,48,1848
45039,45039,A9CB10B468D8E4AF35699B759EB26E7B,10251,18,22,4,35,47,1797
45040,45040,559777BBBCD664850DC1E8E7503633C6,42531,8,10,2,31,45,1595
45041,45041,559777BBBCD664850DC1E8E7503633C6,10351,14,16,2,28,45,1445
45042,45042,559777BBBCD664850DC1E8E7503633C6,12661,19,23,4,32,45,1645
45043,45043,511248B31413344B77C12D74A5EE7CDF,43471,0,7,7,31,49,1599
45044,45044,511248B31413344B77C12D74A5EE7CDF,11151,11,19,8,30,48,1548
45045,45045,511248B31413344B77C12D74A5EE7CDF,40094,20,21,1,29,48,1498
45046,45046,511248B31413344B77C12D74A5EE7CDF,43471,21,23,2,31,49,1599
45052,45052,EB3039C415C508F2A2DCF6403E75C42C,12921,5,7,2,9,41,491
45053,45053,EB3039C415C508F2A2DCF6403E75C42C,12641,7,9,2,10,43,543
45054,45054,EB3039C415C508F2A2DCF6403E75C42C,12921,11,20,9,9,41,491
45063,45063,9C211F2E07C17475B7D2343E9DD9ED0D,10721,0,8,8,31,48,1598
45064,45064,9C211F2E07C17475B7D2343E9DD9ED0D,12381,12,13,1,32,48,1648
45065,45065,9C211F2E07C17475B7D2343E9DD9ED0D,10301,14,17,3,31,45,1595
45066,45066,9C211F2E07C17475B7D2343E9DD9ED0D,10681,20,21,1,30,48,1548
45067,45067,2C9EE2982676F60F9B700D2F26AE591C,13331,10,12,2,38,47,1947
45068,45068,2C9EE2982676F60F9B700D2F26AE591C,12511,14,16,2,39,47,1997
45069,45069,2C9EE2982676F60F9B700D2F26AE591C,13331,20,23,3,38,47,1947
45070,45070,49913D060F497A2E80EBAA132C3ADF88,10544,0,10,10,28,48,1448
45071,45071,49913D060F497A2E80EBAA132C3ADF88,11151,12,15,3,30,48,1548
45072,45072,49913D060F497A2E80EBAA132C3ADF88,10544,17,23,6,28,48,1448
45080,45080,32D6191CC25605658BD3E89421423EE3,11231,0,18,18,37,49,1899
45081,45081,32D6191CC25605658BD3E89421423EE3,10471,18,20,2,37,48,1898
45082,45082,32D6191CC25605658BD3E89421423EE3,11231,20,22,2,37,49,1899
45083,45083,5E8BB1A9FDE1AFD08848003FB8A60E0E,40673,0,13,13,36,48,1848
45084,45084,5E8BB1A9FDE1AFD08848003FB8A60E0E,43731,15,19,4,34,47,1747
45085,45085,5E8BB1A9FDE1AFD08848003FB8A60E0E,40673,20,23,3,36,48,1848
45086,45086,857A8E0D6DC1B408B8273E584D9A8FC4,13371,0,8,8,41,47,2097
45087,45087,857A8E0D6DC1B408B8273E584D9A8FC4,42091,8,10,2,43,46,2196
45088,45088,857A8E0D6DC1B408B8273E584D9A8FC4,13371,10,23,13,41,47,2097
45089,45089,FCA56E1361156CF403BABE4E6D55648E,11061,8,10,2,29,48,1498
45090,45090,FCA56E1361156CF403BABE4E6D55648E,11151,11,13,2,30,48,1548
45091,45091,FCA56E1361156CF403BABE4E6D55648E,11061,13,18,5,29,48,1498
45092,45092,FCA56E1361156CF403BABE4E6D55648E,11151,21,22,1,30,48,1548
45096,45096,48A980CCF2A198BF882581E8F9F510C5,42301,0,11,11,36,47,1847
45097,45097,48A980CCF2A198BF882581E8F9F510C5,10111,12,16,4,37,47,1897
45098,45098,48A980CCF2A198BF882581E8F9F510C5,42301,17,22,5,36,47,1847
45099,45099,5FAF2B20934BE2C9B86CDD601CF7590D,42271,0,7,7,40,47,2047
45100,45100,5FAF2B20934BE2C9B86CDD601CF7590D,11806,8,9,1,41,48,2098
45101,45101,5FAF2B20934BE2C9B86CDD601CF7590D,42271,11,23,12,40,47,2047
45102,45102,5FBB3EF700B05CB3919F800F2804B0FF,11921,0,9,9,38,48,1948
45103,45103,5FBB3EF700B05CB3919F800F2804B0FF,12514,13,14,1,38,47,1947
45104,45104,5FBB3EF700B05CB3919F800F2804B0FF,11914,16,20,4,37,48,1898
45105,45105,5FBB3EF700B05CB3919F800F2804B0FF,11921,21,22,1,38,48,1948
45135,45135,EA58C87CB2005675859CA29FF6C3C184,13511,0,2,2,34,48,1748
45136,45136,EA58C87CB2005675859CA29FF6C3C184,42021,7,16,9,33,47,1697
45137,45137,EA58C87CB2005675859CA29FF6C3C184,40636,20,23,3,35,48,1798
45153,45153,D0222A6993D213D2988CEC46E24C0985,40171,0,1,1,38,48,1948
45154,45154,D0222A6993D213D2988CEC46E24C0985,10471,3,11,8,37,48,1898
45155,45155,D0222A6993D213D2988CEC46E24C0985,40171,13,14,1,38,48,1948
45156,45156,D0222A6993D213D2988CEC46E24C0985,10111,18,20,2,37,47,1897
45162,45162,2FA830A3F4936C72A1774CB1227927A5,42161,0,7,7,36,47,1847
45163,45163,2FA830A3F4936C72A1774CB1227927A5,11861,10,15,5,32,47,1647
45164,45164,2FA830A3F4936C72A1774CB1227927A5,42161,18,23,5,36,47,1847
45178,45178,582FCEF67ED9C80E5B2E8667690F61FB,42221,0,10,10,38,48,1948
45179,45179,582FCEF67ED9C80E5B2E8667690F61FB,42161,10,18,8,36,47,1847
45180,45180,582FCEF67ED9C80E5B2E8667690F61FB,42221,19,23,4,38,48,1948
45186,45186,BB84F849A5F794F98ED9E8F635142ED5,10471,7,11,4,37,48,1898
45187,45187,BB84F849A5F794F98ED9E8F635142ED5,43181,12,13,1,39,48,1998
45188,45188,BB84F849A5F794F98ED9E8F635142ED5,10471,14,21,7,37,48,1898
45189,45189,6AE2FA19F90C6BBDAB69E2E1C7BD408D,11914,0,7,7,37,48,1898
45190,45190,6AE2FA19F90C6BBDAB69E2E1C7BD408D,11074,9,11,2,37,47,1897
45191,45191,6AE2FA19F90C6BBDAB69E2E1C7BD408D,12514,12,14,2,38,47,1947
45192,45192,6AE2FA19F90C6BBDAB69E2E1C7BD408D,11921,18,22,4,38,48,1948
45202,45202,760E5496C7CBF2B23EC48D1163A2AA2C,43081,0,13,13,27,28,1378
45203,45203,760E5496C7CBF2B23EC48D1163A2AA2C,15321,15,16,1,29,26,1476
45204,45204,760E5496C7CBF2B23EC48D1163A2AA2C,43081,18,21,3,27,28,1378
45205,45205,760E5496C7CBF2B23EC48D1163A2AA2C,15321,21,22,1,29,26,1476
45214,45214,853A16C8E6E154D13F9864F752CCB2E5,11481,0,17,17,41,48,2098
45215,45215,853A16C8E6E154D13F9864F752CCB2E5,13101,17,19,2,40,47,2047
45216,45216,853A16C8E6E154D13F9864F752CCB2E5,13271,22,23,1,41,47,2097
45226,45226,3637B25998C44A6FD1B066A0EE49BC38,11861,0,8,8,32,47,1647
45227,45227,3637B25998C44A6FD1B066A0EE49BC38,10281,9,14,5,33,48,1698
45228,45228,3637B25998C44A6FD1B066A0EE49BC38,10881,15,16,1,34,48,1748
45229,45229,3637B25998C44A6FD1B066A0EE49BC38,11861,16,23,7,32,47,1647
45230,45230,78C0E1E992CFF9ECB9C6D46D3E929FD4,12121,0,6,6,29,47,1497
45231,45231,78C0E1E992CFF9ECB9C6D46D3E929FD4,11381,7,10,3,30,47,1547
45232,45232,78C0E1E992CFF9ECB9C6D46D3E929FD4,12121,13,21,8,29,47,1497
45233,45233,A86A2549CD02B65958808F3EC9B7BFBD,11261,0,2,2,36,46,1846
45234,45234,A86A2549CD02B65958808F3EC9B7BFBD,12491,3,4,1,36,43,1843
45235,45235,A86A2549CD02B65958808F3EC9B7BFBD,13911,6,7,1,39,46,1996
45236,45236,A86A2549CD02B65958808F3EC9B7BFBD,11261,11,18,7,36,46,1846
45237,45237,535378523E09141D94880FBA59BB7297,42941,3,15,12,37,47,1897
45238,45238,535378523E09141D94880FBA59BB7297,42301,19,20,1,36,47,1847
45239,45239,535378523E09141D94880FBA59BB7297,10111,20,23,3,37,47,1897
45247,45247,2BC714C204CBBFEE616B46CC493E087B,12921,5,9,4,9,41,491
45248,45248,2BC714C204CBBFEE616B46CC493E087B,12641,13,16,3,10,43,543
45249,45249,2BC714C204CBBFEE616B46CC493E087B,12921,18,19,1,9,41,491
45250,45250,2BC714C204CBBFEE616B46CC493E087B,12641,20,21,1,10,43,543
45251,45251,0F926807C2172A873ADDB6848A592A36,42521,0,7,7,31,47,1597
45252,45252,0F926807C2172A873ADDB6848A592A36,43761,12,19,7,32,47,1647
45253,45253,0F926807C2172A873ADDB6848A592A36,42521,22,23,1,31,47,1597
45254,45254,8280BF08597DEF48A88FDD45351BCE62,11061,0,10,10,29,48,1498
45255,45255,8280BF08597DEF48A88FDD45351BCE62,10381,11,12,1,31,49,1599
45256,45256,8280BF08597DEF48A88FDD45351BCE62,11061,13,19,6,29,48,1498
45257,45257,8280BF08597DEF48A88FDD45351BCE62,12121,21,22,1,29,47,1497
45264,45264,0BC1BC9FA127A76D4558FF0A0EC8FEFB,42921,0,6,6,33,47,1697
45265,45265,0BC1BC9FA127A76D4558FF0A0EC8FEFB,10281,7,9,2,33,48,1698
45266,45266,0BC1BC9FA127A76D4558FF0A0EC8FEFB,42021,10,22,12,33,47,1697
45277,45277,17A4E00C733F721F255B23A4DF169A99,10611,0,8,8,32,48,1648
45278,45278,17A4E00C733F721F255B23A4DF169A99,11381,12,16,4,30,47,1547
45279,45279,17A4E00C733F721F255B23A4DF169A99,10611,16,19,3,32,48,1648
45280,45280,17A4E00C733F721F255B23A4DF169A99,11381,21,22,1,30,47,1547
45289,45289,FCC81FB1D89F2E284C3312E5101F2149,42151,0,15,15,35,45,1795
45290,45290,FCC81FB1D89F2E284C3312E5101F2149,42861,15,16,1,37,44,1894
45291,45291,FCC81FB1D89F2E284C3312E5101F2149,42151,16,19,3,35,45,1795
45308,45308,829F3CF969A99106A0CF5C6D0ED0FE14,10111,0,13,13,37,47,1897
45309,45309,829F3CF969A99106A0CF5C6D0ED0FE14,11751,15,22,7,35,48,1798
45310,45310,829F3CF969A99106A0CF5C6D0ED0FE14,42401,22,23,1,36,47,1847
45311,45311,A486521758A27268CCD3905C2122B6F8,11861,0,11,11,32,47,1647
45312,45312,A486521758A27268CCD3905C2122B6F8,42161,15,17,2,36,47,1847
45313,45313,A486521758A27268CCD3905C2122B6F8,11861,17,20,3,32,47,1647
45323,45323,4239C4BE67F2C831405EAFDCF28D22BA,13511,0,8,8,34,48,1748
45324,45324,4239C4BE67F2C831405EAFDCF28D22BA,10411,9,12,3,36,48,1848
45325,45325,4239C4BE67F2C831405EAFDCF28D22BA,13511,13,18,5,34,48,1748
45326,45326,4239C4BE67F2C831405EAFDCF28D22BA,11861,18,20,2,32,47,1647
45327,45327,DC202B6E6FEBB44F8F053C76074DEC47,10471,1,5,4,37,48,1898
45328,45328,DC202B6E6FEBB44F8F053C76074DEC47,10421,7,14,7,41,48,2098
45329,45329,DC202B6E6FEBB44F8F053C76074DEC47,10471,22,23,1,37,48,1898
45333,45333,00ED2280FB2BEC22D8FB36F8A7AFB1A5,42151,0,8,8,35,45,1795
45334,45334,00ED2280FB2BEC22D8FB36F8A7AFB1A5,13121,9,11,2,38,46,1946
45335,45335,00ED2280FB2BEC22D8FB36F8A7AFB1A5,10271,14,16,2,37,46,1896
45336,45336,00ED2280FB2BEC22D8FB36F8A7AFB1A5,13121,16,20,4,38,46,1946
45342,45342,BFAE3D08C48893A5C2D6FE8172F879C1,12514,3,7,4,38,47,1947
45343,45343,BFAE3D08C48893A5C2D6FE8172F879C1,12511,8,9,1,39,47,1997
45344,45344,BFAE3D08C48893A5C2D6FE8172F879C1,12514,10,16,6,38,47,1947
45345,45345,BFAE3D08C48893A5C2D6FE8172F879C1,11751,18,19,1,35,48,1798
45354,45354,47844E829FCB05D6E87386BF9A1380C3,13711,0,6,6,38,46,1946
45355,45355,47844E829FCB05D6E87386BF9A1380C3,42011,7,10,3,36,46,1846
45356,45356,47844E829FCB05D6E87386BF9A1380C3,11941,13,16,3,37,46,1896
45357,45357,47844E829FCB05D6E87386BF9A1380C3,11491,20,23,3,36,47,1847
45363,45363,F808555B77D1C0F006490F1B42959132,11875,0,5,5,30,46,1546
45364,45364,F808555B77D1C0F006490F1B42959132,42871,7,8,1,30,45,1545
45365,45365,F808555B77D1C0F006490F1B42959132,10634,11,20,9,27,45,1395
45366,45366,F808555B77D1C0F006490F1B42959132,11871,21,23,2,29,46,1496
45370,45370,CC1D3C2DA42F1EBED6688749C3DA1D87,11381,2,18,16,30,47,1547
45371,45371,CC1D3C2DA42F1EBED6688749C3DA1D87,11061,19,20,1,29,48,1498
45372,45372,CC1D3C2DA42F1EBED6688749C3DA1D87,11381,21,23,2,30,47,1547
45373,45373,64C3417B19E018B97BBD82B17F26BC9C,11061,0,15,15,29,48,1498
45374,45374,64C3417B19E018B97BBD82B17F26BC9C,11151,20,21,1,30,48,1548
45375,45375,64C3417B19E018B97BBD82B17F26BC9C,11061,21,23,2,29,48,1498
45381,45381,A012A11840DA59BA9C0B1287642AE618,13111,2,6,4,42,46,2146
45382,45382,A012A11840DA59BA9C0B1287642AE618,13791,10,13,3,42,47,2147
45383,45383,A012A11840DA59BA9C0B1287642AE618,42461,17,19,2,45,47,2297
45391,45391,2CB6953F391C73F166D02AC31E930A06,40171,0,14,14,38,48,1948
45392,45392,2CB6953F391C73F166D02AC31E930A06,11914,17,19,2,37,48,1898
45393,45393,2CB6953F391C73F166D02AC31E930A06,11921,20,23,3,38,48,1948
45394,45394,B9593B6551A775E63140069F2A62C943,10281,0,7,7,33,48,1698
45395,45395,B9593B6551A775E63140069F2A62C943,11061,8,17,9,29,48,1498
45396,45396,B9593B6551A775E63140069F2A62C943,10681,17,19,2,30,48,1548
45397,45397,B9593B6551A775E63140069F2A62C943,10281,21,23,2,33,48,1698
45410,45410,3D4D278B3D58167073B4ACCB11432DB2,12671,6,16,10,21,43,1093
45411,45411,3D4D278B3D58167073B4ACCB11432DB2,13091,16,18,2,20,42,1042
45412,45412,3D4D278B3D58167073B4ACCB11432DB2,12671,18,23,5,21,43,1093
45413,45413,9D7E28E179E5F5D009F8D277D0F434A8,10281,0,1,1,33,48,1698
45414,45414,9D7E28E179E5F5D009F8D277D0F434A8,11861,1,14,13,32,47,1647
45415,45415,9D7E28E179E5F5D009F8D277D0F434A8,42021,17,18,1,33,47,1697
45416,45416,9D7E28E179E5F5D009F8D277D0F434A8,11861,21,23,2,32,47,1647
45420,45420,C62B646712FD890D277FEC8B60EFC6B7,10381,1,2,1,31,49,1599
45421,45421,C62B646712FD890D277FEC8B60EFC6B7,11151,3,6,3,30,48,1548
45422,45422,C62B646712FD890D277FEC8B60EFC6B7,42071,11,17,6,31,49,1599
45423,45423,C62B646712FD890D277FEC8B60EFC6B7,11061,19,23,4,29,48,1498
45429,45429,31C99BE35DAA7CC1D9A6D662CA3683F3,10841,7,8,1,37,47,1897
45430,45430,31C99BE35DAA7CC1D9A6D662CA3683F3,42331,8,10,2,39,46,1996
45431,45431,31C99BE35DAA7CC1D9A6D662CA3683F3,10841,12,20,8,37,47,1897
45432,45432,08722D7A095C90179DDD0BE38D45C8CB,42523,0,6,6,31,47,1597
45433,45433,08722D7A095C90179DDD0BE38D45C8CB,42491,8,11,3,32,46,1646
45434,45434,08722D7A095C90179DDD0BE38D45C8CB,42523,11,23,12,31,47,1597
45440,45440,0BEF78F319B1AAB250126FF9A58071BB,42921,2,11,9,33,47,1697
45441,45441,0BEF78F319B1AAB250126FF9A58071BB,10281,14,17,3,33,48,1698
45442,45442,0BEF78F319B1AAB250126FF9A58071BB,43761,21,22,1,32,47,1647
45443,45443,9D25C8999E418D8C72AB77E479B8A009,11321,0,6,6,31,46,1596
45444,45444,9D25C8999E418D8C72AB77E479B8A009,10301,7,11,4,31,45,1595
45445,45445,9D25C8999E418D8C72AB77E479B8A009,11321,11,23,12,31,46,1596
45456,45456,20A8BECA840388BFF13FD19DD41FCACC,11491,0,1,1,36,47,1847
45457,45457,20A8BECA840388BFF13FD19DD41FCACC,10841,2,5,3,37,47,1897
45458,45458,20A8BECA840388BFF13FD19DD41FCACC,42221,6,8,2,38,48,1948
45459,45459,20A8BECA840388BFF13FD19DD41FCACC,10841,12,22,10,37,47,1897
45460,45460,D8B46FFCD15B641FB93B8219A29A7205,42401,2,3,1,36,47,1847
45461,45461,D8B46FFCD15B641FB93B8219A29A7205,10251,3,18,15,35,47,1797
45462,45462,D8B46FFCD15B641FB93B8219A29A7205,42161,21,23,2,36,47,1847
45467,45467,4CDC8B55805F54C701951AA286ACE261,42521,2,3,1,31,47,1597
45468,45468,4CDC8B55805F54C701951AA286ACE261,10292,5,6,1,30,47,1547
45469,45469,4CDC8B55805F54C701951AA286ACE261,11954,9,19,10,32,49,1649
45476,45476,3F29D0D409D1B6D4E7D2087740FD0BBC,42161,0,9,9,36,47,1847
45477,45477,3F29D0D409D1B6D4E7D2087740FD0BBC,10251,9,14,5,35,47,1797
45478,45478,3F29D0D409D1B6D4E7D2087740FD0BBC,11461,14,18,4,37,49,1899
45479,45479,3F29D0D409D1B6D4E7D2087740FD0BBC,42161,18,23,5,36,47,1847
45488,45488,1E12BE0EFFCA902A502DAC3B84E936AB,13101,0,8,8,40,47,2047
45489,45489,1E12BE0EFFCA902A502DAC3B84E936AB,11481,17,18,1,41,48,2098
45490,45490,1E12BE0EFFCA902A502DAC3B84E936AB,12511,20,21,1,39,47,1997
45491,45491,1E12BE0EFFCA902A502DAC3B84E936AB,13101,22,23,1,40,47,2047
45492,45492,1EB8BF3A5209A99EB5F8CDA45162250D,12661,0,8,8,32,45,1645
45493,45493,1EB8BF3A5209A99EB5F8CDA45162250D,42531,8,10,2,31,45,1595
45494,45494,1EB8BF3A5209A99EB5F8CDA45162250D,12311,14,17,3,30,44,1544
45495,45495,1EB8BF3A5209A99EB5F8CDA45162250D,12661,18,20,2,32,45,1645
45504,45504,DFD67893B33D33FDAA92DC71D5732DAF,42161,0,11,11,36,47,1847
45505,45505,DFD67893B33D33FDAA92DC71D5732DAF,42941,11,12,1,37,47,1897
45506,45506,DFD67893B33D33FDAA92DC71D5732DAF,42161,13,23,10,36,47,1847
45511,45511,F41482495C7C1BFF3B02971058475A44,42021,0,12,12,33,47,1697
45512,45512,F41482495C7C1BFF3B02971058475A44,10111,12,16,4,37,47,1897
45513,45513,F41482495C7C1BFF3B02971058475A44,42021,17,23,6,33,47,1697
45522,45522,A1BDF95E9D3FC1D1F9602700F7A63FC0,42461,0,6,6,45,47,2297
45523,45523,A1BDF95E9D3FC1D1F9602700F7A63FC0,42321,6,8,2,43,47,2197
45524,45524,A1BDF95E9D3FC1D1F9602700F7A63FC0,42461,12,23,11,45,47,2297
45529,45529,9DD3BD519BBA02AD03DEFD759DCE6799,13341,0,7,7,44,45,2245
45530,45530,9DD3BD519BBA02AD03DEFD759DCE6799,12211,11,17,6,41,44,2094
45531,45531,9DD3BD519BBA02AD03DEFD759DCE6799,12221,19,23,4,43,44,2194
45537,45537,B93C16A242FE2C6BDA83A87AD4FAA434,12601,0,14,14,25,47,1297
45538,45538,B93C16A242FE2C6BDA83A87AD4FAA434,10501,14,15,1,22,46,1146
45539,45539,B93C16A242FE2C6BDA83A87AD4FAA434,12601,18,20,2,25,47,1297
45555,45555,EBEC12643A85FF06102FB66738B5C413,11914,2,9,7,37,48,1898
45556,45556,EBEC12643A85FF06102FB66738B5C413,11461,12,13,1,37,49,1899
45557,45557,EBEC12643A85FF06102FB66738B5C413,10191,17,23,6,40,48,2048
45558,45558,69402671B7928290476FCE1242C8E0A9,11381,3,4,1,30,47,1547
45559,45559,69402671B7928290476FCE1242C8E0A9,11061,8,11,3,29,48,1498
45560,45560,69402671B7928290476FCE1242C8E0A9,11381,11,13,2,30,47,1547
45561,45561,69402671B7928290476FCE1242C8E0A9,11061,17,23,6,29,48,1498
45562,45562,DD11EC5E596BBBC5A00C9F6952DD9EC0,10281,0,11,11,33,48,1698
45563,45563,DD11EC5E596BBBC5A00C9F6952DD9EC0,10971,12,13,1,35,47,1797
45564,45564,DD11EC5E596BBBC5A00C9F6952DD9EC0,10281,16,23,7,33,48,1698
45565,45565,3475DC471371892A054AEE945F236C3D,13111,0,8,8,42,46,2146
45566,45566,3475DC471371892A054AEE945F236C3D,42201,12,15,3,43,46,2196
45567,45567,3475DC471371892A054AEE945F236C3D,13341,15,17,2,44,45,2245
45568,45568,3475DC471371892A054AEE945F236C3D,10811,21,23,2,38,46,1946
45569,45569,9C686B624E1F19B96755FA9920EEF4B6,10111,0,7,7,37,47,1897
45570,45570,9C686B624E1F19B96755FA9920EEF4B6,42921,8,10,2,33,47,1697
45571,45571,9C686B624E1F19B96755FA9920EEF4B6,13601,11,18,7,34,47,1747
45572,45572,9C686B624E1F19B96755FA9920EEF4B6,42301,19,22,3,36,47,1847
45576,45576,62A4DF59E8BCEC0DCF6C971E2D9209AC,10271,10,12,2,37,46,1896
45577,45577,62A4DF59E8BCEC0DCF6C971E2D9209AC,13121,15,16,1,38,46,1946
45578,45578,62A4DF59E8BCEC0DCF6C971E2D9209AC,10271,18,20,2,37,46,1896
45587,45587,DE3DB069CF0A068ED881835170BAD55A,12641,2,5,3,10,43,543
45588,45588,DE3DB069CF0A068ED881835170BAD55A,12921,8,20,12,9,41,491
45589,45589,DE3DB069CF0A068ED881835170BAD55A,12641,21,23,2,10,43,543
45598,45598,47415076A3FA5311F7C6963E071BA462,11061,0,10,10,29,48,1498
45599,45599,47415076A3FA5311F7C6963E071BA462,40441,11,12,1,30,48,1548
45600,45600,47415076A3FA5311F7C6963E071BA462,11061,13,21,8,29,48,1498
45612,45612,C40686ED5643A5C8B64F8DB85E1969BA,19114,0,5,5,7,43,393
45613,45613,C40686ED5643A5C8B64F8DB85E1969BA,12641,5,16,11,10,43,543
45614,45614,C40686ED5643A5C8B64F8DB85E1969BA,19114,19,23,4,7,43,393
45618,45618,CC6A63734928B4CD8F414AAB01241B9F,10611,0,8,8,32,48,1648
45619,45619,CC6A63734928B4CD8F414AAB01241B9F,10691,16,18,2,33,48,1698
45620,45620,CC6A63734928B4CD8F414AAB01241B9F,11541,18,19,1,35,49,1799
45621,45621,CC6A63734928B4CD8F414AAB01241B9F,10611,21,23,2,32,48,1648
45622,45622,EE107F15123C6DB132974358298F51B4,11914,4,5,1,37,48,1898
45623,45623,EE107F15123C6DB132974358298F51B4,43181,6,16,10,39,48,1998
45624,45624,EE107F15123C6DB132974358298F51B4,40171,18,20,2,38,48,1948
45625,45625,EE107F15123C6DB132974358298F51B4,11914,20,23,3,37,48,1898
45635,45635,573E04FF19AEF2947EF0E4BDE1A64D6A,49201,3,14,11,7,41,391
45636,45636,573E04FF19AEF2947EF0E4BDE1A64D6A,12921,14,19,5,9,41,491
45637,45637,573E04FF19AEF2947EF0E4BDE1A64D6A,49201,19,22,3,7,41,391
45645,45645,6C9D4E5454CD881626232C5D04CC40D8,10491,1,11,10,33,48,1698
45646,45646,6C9D4E5454CD881626232C5D04CC40D8,40951,13,15,2,36,49,1849
45647,45647,6C9D4E5454CD881626232C5D04CC40D8,10491,18,23,5,33,48,1698
45648,45648,9174106625D3239DC850CA622055B684,42301,0,6,6,36,47,1847
45649,45649,9174106625D3239DC850CA622055B684,42941,10,16,6,37,47,1897
45650,45650,9174106625D3239DC850CA622055B684,42301,17,23,6,36,47,1847
45651,45651,9508FAE0B774FCD97D7CFB3C4BD72215,10111,0,7,7,37,47,1897
45652,45652,9508FAE0B774FCD97D7CFB3C4BD72215,13911,9,11,2,39,46,1996
45653,45653,9508FAE0B774FCD97D7CFB3C4BD72215,42161,13,22,9,36,47,1847
45665,45665,12D74476F053068F7D2533ADA7E34270,11911,0,9,9,37,48,1898
45666,45666,12D74476F053068F7D2533ADA7E34270,11541,12,15,3,35,49,1799
45667,45667,12D74476F053068F7D2533ADA7E34270,40951,16,18,2,36,49,1849
45668,45668,12D74476F053068F7D2533ADA7E34270,11751,18,19,1,35,48,1798
45677,45677,C404F60AD0A2D6862A45A9C320EEAB5F,11261,2,4,2,36,46,1846
45678,45678,C404F60AD0A2D6862A45A9C320EEAB5F,42861,6,15,9,37,44,1894
45679,45679,C404F60AD0A2D6862A45A9C320EEAB5F,42864,16,18,2,38,44,1944
45680,45680,C404F60AD0A2D6862A45A9C320EEAB5F,11261,18,21,3,36,46,1846
45681,45681,DEAED68AE3C073AACA878B29D6C9BBC2,42231,1,9,8,37,46,1896
45682,45682,DEAED68AE3C073AACA878B29D6C9BBC2,42941,10,15,5,37,47,1897
45683,45683,DEAED68AE3C073AACA878B29D6C9BBC2,42351,19,20,1,38,45,1945
45684,45684,0DD51EE42A065AE9C7264B2B66A89D4A,19021,0,13,13,10,45,545
45685,45685,0DD51EE42A065AE9C7264B2B66A89D4A,12641,15,18,3,10,43,543
45686,45686,0DD51EE42A065AE9C7264B2B66A89D4A,19021,18,22,4,10,45,545
45690,45690,C3E732D15F022D9CEC194DCDE873E649,10471,0,14,14,37,48,1898
45691,45691,C3E732D15F022D9CEC194DCDE873E649,12021,18,21,3,37,49,1899
45692,45692,C3E732D15F022D9CEC194DCDE873E649,10471,22,23,1,37,48,1898
45693,45693,780CF605B987CE4335E0B64DFA86ACBF,11461,0,2,2,37,49,1899
45694,45694,780CF605B987CE4335E0B64DFA86ACBF,12514,2,12,10,38,47,1947
45695,45695,780CF605B987CE4335E0B64DFA86ACBF,10471,14,18,4,37,48,1898
45696,45696,780CF605B987CE4335E0B64DFA86ACBF,11921,22,23,1,38,48,1948
45697,45697,EB7A5027E5784D495DD96CBC63370DD0,11021,0,13,13,36,49,1849
45698,45698,EB7A5027E5784D495DD96CBC63370DD0,42471,18,20,2,35,49,1799
45699,45699,EB7A5027E5784D495DD96CBC63370DD0,11021,21,23,2,36,49,1849
45704,45704,CF7DA1891D00F069E0E0214450037183,11061,0,8,8,29,48,1498
45705,45705,CF7DA1891D00F069E0E0214450037183,11381,8,13,5,30,47,1547
45706,45706,CF7DA1891D00F069E0E0214450037183,11061,15,18,3,29,48,1498
45713,45713,331C93B6083F5634586EEDFC958D0A76,42351,0,8,8,38,45,1945
45714,45714,331C93B6083F5634586EEDFC958D0A76,13911,12,13,1,39,46,1996
45715,45715,331C93B6083F5634586EEDFC958D0A76,42351,16,23,7,38,45,1945
45722,45722,8827A35309A216F0F6E4CBB2FFAC456D,41031,0,8,8,32,49,1649
45723,45723,8827A35309A216F0F6E4CBB2FFAC456D,11751,10,12,2,35,48,1798
45724,45724,8827A35309A216F0F6E4CBB2FFAC456D,41031,19,23,4,32,49,1649
45735,45735,F885065D95372E09B23B607FD2D19CD4,42151,3,5,2,35,45,1795
45736,45736,F885065D95372E09B23B607FD2D19CD4,12491,5,9,4,36,43,1843
45737,45737,F885065D95372E09B23B607FD2D19CD4,42151,10,12,2,35,45,1795
45738,45738,F885065D95372E09B23B607FD2D19CD4,12521,12,22,10,35,41,1791
45739,45739,FD8C757A10FC8342CB9359B3B019D044,10901,0,7,7,35,48,1798
45740,45740,FD8C757A10FC8342CB9359B3B019D044,11231,9,11,2,37,49,1899
45741,45741,FD8C757A10FC8342CB9359B3B019D044,12083,12,13,1,36,49,1849
45742,45742,FD8C757A10FC8342CB9359B3B019D044,10901,18,23,5,35,48,1798
45750,45750,CEAC6C818D7651ADBA37DD2B6097C732,42231,4,6,2,37,46,1896
45751,45751,CEAC6C818D7651ADBA37DD2B6097C732,42351,8,9,1,38,45,1945
45752,45752,CEAC6C818D7651ADBA37DD2B6097C732,11074,20,21,1,37,47,1897
45753,45753,CEAC6C818D7651ADBA37DD2B6097C732,42231,22,23,1,37,46,1896
45754,45754,1F54E6BF7B3A6641B77A0D2E783C656A,11061,1,10,9,29,48,1498
45755,45755,1F54E6BF7B3A6641B77A0D2E783C656A,11151,10,19,9,30,48,1548
45756,45756,1F54E6BF7B3A6641B77A0D2E783C656A,11061,20,21,1,29,48,1498
45757,45757,F7622644808D15D11AFA31F5C4BF00AE,42961,0,12,12,35,49,1799
45758,45758,F7622644808D15D11AFA31F5C4BF00AE,11021,12,14,2,36,49,1849
45759,45759,F7622644808D15D11AFA31F5C4BF00AE,42961,14,23,9,35,49,1799
45767,45767,AC9A35D001464E087369411DD671E08D,43361,0,3,3,38,48,1948
45768,45768,AC9A35D001464E087369411DD671E08D,10971,3,4,1,35,47,1797
45769,45769,AC9A35D001464E087369411DD671E08D,11491,5,6,1,36,47,1847
45770,45770,AC9A35D001464E087369411DD671E08D,42941,11,23,12,37,47,1897
45771,45771,EC909F98ED0E6EF5A40A37FA5726A995,43161,0,13,13,35,47,1797
45772,45772,EC909F98ED0E6EF5A40A37FA5726A995,42511,18,19,1,37,47,1897
45773,45773,EC909F98ED0E6EF5A40A37FA5726A995,10251,20,23,3,35,47,1797
45774,45774,38B4D8D645C177BBA8ECCAA37181BC9B,13651,0,11,11,30,47,1547
45775,45775,38B4D8D645C177BBA8ECCAA37181BC9B,42521,12,13,1,31,47,1597
45776,45776,38B4D8D645C177BBA8ECCAA37181BC9B,13651,16,23,7,30,47,1547
45777,45777,9ECA5557B94DDF8D494B58216329A377,42864,1,8,7,38,44,1944
45778,45778,9ECA5557B94DDF8D494B58216329A377,11261,10,12,2,36,46,1846
45779,45779,9ECA5557B94DDF8D494B58216329A377,42861,15,17,2,37,44,1894
45780,45780,9ECA5557B94DDF8D494B58216329A377,11261,17,20,3,36,46,1846
45792,45792,806223F4E6A75E30DD9FB8BC0E922847,11061,0,1,1,29,48,1498
45793,45793,806223F4E6A75E30DD9FB8BC0E922847,11151,4,5,1,30,48,1548
45794,45794,806223F4E6A75E30DD9FB8BC0E922847,11061,8,23,15,29,48,1498
45795,45795,1D946DFA26E20CD2E7CE088353494F1E,42581,0,8,8,38,48,1948
45796,45796,1D946DFA26E20CD2E7CE088353494F1E,12514,13,14,1,38,47,1947
45797,45797,1D946DFA26E20CD2E7CE088353494F1E,43181,15,17,2,39,48,1998
45798,45798,1D946DFA26E20CD2E7CE088353494F1E,42581,17,23,6,38,48,1948
45799,45799,DE075B1092683D5AE9A7F19203622E14,12661,3,13,10,32,45,1645
45800,45800,DE075B1092683D5AE9A7F19203622E14,12311,14,15,1,30,44,1544
45801,45801,DE075B1092683D5AE9A7F19203622E14,12661,16,19,3,32,45,1645
45802,45802,659FD32FB58661B6B22DD171678F64D2,13011,1,7,6,39,47,1997
45803,45803,659FD32FB58661B6B22DD171678F64D2,11074,11,14,3,37,47,1897
45804,45804,659FD32FB58661B6B22DD171678F64D2,12514,14,23,9,38,47,1947
45817,45817,C5E92E08BD54D1F8D1119F34E806E13B,42521,2,4,2,31,47,1597
45818,45818,C5E92E08BD54D1F8D1119F34E806E13B,11861,5,6,1,32,47,1647
45819,45819,C5E92E08BD54D1F8D1119F34E806E13B,11381,17,19,2,30,47,1547
45820,45820,C5E92E08BD54D1F8D1119F34E806E13B,42521,22,23,1,31,47,1597
45832,45832,E9F5D0C2382D0D17DF61B7A5284E6ABD,12641,0,4,4,10,43,543
45833,45833,E9F5D0C2382D0D17DF61B7A5284E6ABD,19904,5,6,1,9,44,494
45834,45834,E9F5D0C2382D0D17DF61B7A5284E6ABD,12641,6,23,17,10,43,543
45841,45841,8285E7CFD2208E724767098E1AD19936,42041,0,7,7,10,47,547
45842,45842,8285E7CFD2208E724767098E1AD19936,19024,8,10,2,9,45,495
45843,45843,8285E7CFD2208E724767098E1AD19936,42041,11,12,1,10,47,547
45844,45844,8285E7CFD2208E724767098E1AD19936,19024,13,23,10,9,45,495
45845,45845,1C29D823B21418CE7B076871E0859D6A,11001,0,6,6,42,47,2147
45846,45846,1C29D823B21418CE7B076871E0859D6A,13941,7,10,3,41,47,2097
45847,45847,1C29D823B21418CE7B076871E0859D6A,11001,13,22,9,42,47,2147
45862,45862,21D029E4FB71F3A5DA880019FDFB9BC1,12491,0,13,13,36,43,1843
45863,45863,21D029E4FB71F3A5DA880019FDFB9BC1,42864,14,16,2,38,44,1944
45864,45864,21D029E4FB71F3A5DA880019FDFB9BC1,12491,20,23,3,36,43,1843
45865,45865,87268C35D2C26CE8D0D34B26791C8611,11954,2,4,2,32,49,1649
45866,45866,87268C35D2C26CE8D0D34B26791C8611,41591,4,21,17,34,49,1749
45867,45867,87268C35D2C26CE8D0D34B26791C8611,10721,21,22,1,31,48,1598
45884,45884,B2012EE6BD195EC80673B0F2B5EC1C5E,12921,0,7,7,9,41,491
45885,45885,B2012EE6BD195EC80673B0F2B5EC1C5E,49201,11,16,5,7,41,391
45886,45886,B2012EE6BD195EC80673B0F2B5EC1C5E,12921,16,18,2,9,41,491
45887,45887,B2012EE6BD195EC80673B0F2B5EC1C5E,12641,18,20,2,10,43,543
45888,45888,DB5C0024A3C9A77900C99EA6DCF506D1,11941,0,16,16,37,46,1896
45889,45889,DB5C0024A3C9A77900C99EA6DCF506D1,11261,17,19,2,36,46,1846
45890,45890,DB5C0024A3C9A77900C99EA6DCF506D1,11941,20,23,3,37,46,1896
45896,45896,106E9A53E6E31A402A96A881D88C9936,41551,0,10,10,37,46,1896
45897,45897,106E9A53E6E31A402A96A881D88C9936,10107,16,19,3,38,49,1949
45898,45898,106E9A53E6E31A402A96A881D88C9936,41551,20,23,3,37,46,1896
45899,45899,60DD6DD8666616ED1B5BCBF2A3A6C1E1,19441,0,14,14,8,46,446
45900,45900,60DD6DD8666616ED1B5BCBF2A3A6C1E1,19024,17,18,1,9,45,495
45901,45901,60DD6DD8666616ED1B5BCBF2A3A6C1E1,19901,20,22,2,7,44,394
45902,45902,705DFE0F0CF99753368D655C68C21E78,12221,0,8,8,43,44,2194
45903,45903,705DFE0F0CF99753368D655C68C21E78,12211,9,10,1,41,44,2094
45904,45904,705DFE0F0CF99753368D655C68C21E78,12221,12,18,6,43,44,2194
45909,45909,A0E96E8A9AD818FBF087A431E03695B8,11914,0,6,6,37,48,1898
45910,45910,A0E96E8A9AD818FBF087A431E03695B8,11021,8,17,9,36,49,1849
45911,45911,A0E96E8A9AD818FBF087A431E03695B8,11914,20,21,1,37,48,1898
45912,45912,656752102BA99654C7060CE5B2133D72,19114,0,13,13,7,43,393
45913,45913,656752102BA99654C7060CE5B2133D72,12921,13,18,5,9,41,491
45914,45914,656752102BA99654C7060CE5B2133D72,19114,18,23,5,7,43,393
45921,45921,9773FE9F976C1E69F4E2B147F595ED8B,13341,2,3,1,44,45,2245
45922,45922,9773FE9F976C1E69F4E2B147F595ED8B,43051,4,5,1,46,45,2345
45923,45923,9773FE9F976C1E69F4E2B147F595ED8B,13341,5,20,15,44,45,2245
45924,45924,9773FE9F976C1E69F4E2B147F595ED8B,42631,22,23,1,43,45,2195
45925,45925,F0A1BB763F378032A1CC33E7783B3D13,10121,2,13,11,36,49,1849
45926,45926,F0A1BB763F378032A1CC33E7783B3D13,10661,16,18,2,37,49,1899
45927,45927,F0A1BB763F378032A1CC33E7783B3D13,11021,19,23,4,36,49,1849
45928,45928,612F18F83615AD18C521C0260D4FB623,11914,0,12,12,37,48,1898
45929,45929,612F18F83615AD18C521C0260D4FB623,43181,12,14,2,39,48,1998
45930,45930,612F18F83615AD18C521C0260D4FB623,11914,14,23,9,37,48,1898
45931,45931,31D3A14F91521165AD8DA7BA4C9113DD,11651,0,8,8,33,47,1697
45932,45932,31D3A14F91521165AD8DA7BA4C9113DD,10151,9,10,1,34,47,1747
45933,45933,31D3A14F91521165AD8DA7BA4C9113DD,11651,14,23,9,33,47,1697
45948,45948,EA454BA750B94FE328BB9998EA4F4BA4,10971,0,2,2,35,47,1797
45949,45949,EA454BA750B94FE328BB9998EA4F4BA4,42161,3,8,5,36,47,1847
45950,45950,EA454BA750B94FE328BB9998EA4F4BA4,10971,10,23,13,35,47,1797
45954,45954,10D6E07CB2A92B35A37820638A6643C4,11811,3,4,1,38,49,1949
45955,45955,10D6E07CB2A92B35A37820638A6643C4,12514,5,8,3,38,47,1947
45956,45956,10D6E07CB2A92B35A37820638A6643C4,10841,11,13,2,37,47,1897
45957,45957,10D6E07CB2A92B35A37820638A6643C4,11771,13,23,10,39,49,1999
45970,45970,45E2591DDB181830E886EA4FBDDB1E4F,42021,0,8,8,33,47,1697
45971,45971,45E2591DDB181830E886EA4FBDDB1E4F,10151,9,17,8,34,47,1747
45972,45972,45E2591DDB181830E886EA4FBDDB1E4F,42021,17,20,3,33,47,1697
45982,45982,B36C8579A2DBF718933C4838B2421A42,42511,2,7,5,37,47,1897
45983,45983,B36C8579A2DBF718933C4838B2421A42,13121,11,16,5,38,46,1946
45984,45984,B36C8579A2DBF718933C4838B2421A42,42511,20,21,1,37,47,1897
45988,45988,234F087DE1CFEB89C762E905CED80FCE,11074,0,6,6,37,47,1897
45989,45989,234F087DE1CFEB89C762E905CED80FCE,11331,7,8,1,37,48,1898
45990,45990,234F087DE1CFEB89C762E905CED80FCE,12083,15,18,3,36,49,1849
45991,45991,234F087DE1CFEB89C762E905CED80FCE,11074,20,22,2,37,47,1897
45995,45995,37025163465687F9A2D7FAF8EF743CD1,13941,0,14,14,41,47,2097
45996,45996,37025163465687F9A2D7FAF8EF743CD1,11001,16,18,2,42,47,2147
45997,45997,37025163465687F9A2D7FAF8EF743CD1,13941,19,21,2,41,47,2097
46001,46001,FB473FBE3EAFD3A14A7452241F377171,19441,0,8,8,8,46,446
46002,46002,FB473FBE3EAFD3A14A7452241F377171,42041,11,13,2,10,47,547
46003,46003,FB473FBE3EAFD3A14A7452241F377171,19441,13,23,10,8,46,446
46004,46004,E991BAEC774210E5754B827C150F93C9,10921,2,9,7,43,48,2198
46005,46005,E991BAEC774210E5754B827C150F93C9,13371,14,16,2,41,47,2097
46006,46006,E991BAEC774210E5754B827C150F93C9,11481,18,23,5,41,48,2098
46007,46007,EDBE9058BB0B28E0915A84395E9226D9,11261,0,4,4,36,46,1846
46008,46008,EDBE9058BB0B28E0915A84395E9226D9,42861,7,8,1,37,44,1894
46009,46009,EDBE9058BB0B28E0915A84395E9226D9,11261,11,12,1,36,46,1846
46010,46010,EDBE9058BB0B28E0915A84395E9226D9,42861,14,18,4,37,44,1894
46016,46016,59D44FF2229AC9C7B96B17F069B2088B,10901,8,16,8,35,48,1798
46017,46017,59D44FF2229AC9C7B96B17F069B2088B,11794,17,19,2,38,49,1949
46018,46018,59D44FF2229AC9C7B96B17F069B2088B,11914,21,22,1,37,48,1898
46019,46019,DE3E54BB176520C8599DB39C6B8B34A3,43951,3,10,7,49,41,2491
46020,46020,DE3E54BB176520C8599DB39C6B8B34A3,13411,11,12,1,49,42,2492
46021,46021,DE3E54BB176520C8599DB39C6B8B34A3,43951,13,20,7,49,41,2491
46045,46045,396960C637D446A0C6EED7C518DC067E,42161,0,7,7,36,47,1847
46046,46046,396960C637D446A0C6EED7C518DC067E,13511,8,9,1,34,48,1748
46047,46047,396960C637D446A0C6EED7C518DC067E,10251,10,23,13,35,47,1797
46048,46048,D454F61AD8B5A1CBE1E15CE597E2F528,11491,0,6,6,36,47,1847
46049,46049,D454F61AD8B5A1CBE1E15CE597E2F528,11231,8,19,11,37,49,1899
46050,46050,D454F61AD8B5A1CBE1E15CE597E2F528,42511,19,20,1,37,47,1897
46051,46051,81DDAE7BB9B21EE23D4D27A04DA468B5,10121,0,8,8,36,49,1849
46052,46052,81DDAE7BB9B21EE23D4D27A04DA468B5,10471,8,15,7,37,48,1898
46053,46053,81DDAE7BB9B21EE23D4D27A04DA468B5,11491,18,19,1,36,47,1847
46054,46054,81DDAE7BB9B21EE23D4D27A04DA468B5,11021,20,23,3,36,49,1849
46061,46061,05B51695B375DD3A2259BF2668AD8716,42161,0,8,8,36,47,1847
46062,46062,05B51695B375DD3A2259BF2668AD8716,11074,9,10,1,37,47,1897
46063,46063,05B51695B375DD3A2259BF2668AD8716,42161,10,23,13,36,47,1847
46064,46064,4DB0308FEE808EB4AB25FA1D5CC2FE73,42861,0,15,15,37,44,1894
46065,46065,4DB0308FEE808EB4AB25FA1D5CC2FE73,11261,19,20,1,36,46,1846
46066,46066,4DB0308FEE808EB4AB25FA1D5CC2FE73,42861,20,22,2,37,44,1894
46077,46077,4E8CF0BE1A57E085938ED2B5916A9E34,11381,0,12,12,30,47,1547
46078,46078,4E8CF0BE1A57E085938ED2B5916A9E34,42291,13,15,2,29,48,1498
46079,46079,4E8CF0BE1A57E085938ED2B5916A9E34,11381,16,22,6,30,47,1547
46080,46080,43546E76BF61B1B2FB513612B75D05EB,13101,0,8,8,40,47,2047
46081,46081,43546E76BF61B1B2FB513612B75D05EB,11806,12,17,5,41,48,2098
46082,46082,43546E76BF61B1B2FB513612B75D05EB,42321,19,23,4,43,47,2197
46097,46097,6A0394A16431C3763362EDB77E0D6861,10381,0,8,8,31,49,1599
46098,46098,6A0394A16431C3763362EDB77E0D6861,10544,9,13,4,28,48,1448
46099,46099,6A0394A16431C3763362EDB77E0D6861,42071,13,23,10,31,49,1599
46108,46108,CC63EA7467D4A1FC7EF1BC76C9DAF092,11261,0,17,17,36,46,1846
46109,46109,CC63EA7467D4A1FC7EF1BC76C9DAF092,42864,17,18,1,38,44,1944
46110,46110,CC63EA7467D4A1FC7EF1BC76C9DAF092,11261,20,23,3,36,46,1846
46111,46111,8A4EE976F1E8BC4CA88390DFA08CB5DF,10621,2,17,15,41,49,2099
46112,46112,8A4EE976F1E8BC4CA88390DFA08CB5DF,10921,18,19,1,43,48,2198
46113,46113,8A4EE976F1E8BC4CA88390DFA08CB5DF,10621,21,23,2,41,49,2099
46125,46125,C25A28585FD90C5600BD444341038A54,11021,2,4,2,36,49,1849
46126,46126,C25A28585FD90C5600BD444341038A54,11231,4,11,7,37,49,1899
46127,46127,C25A28585FD90C5600BD444341038A54,10107,13,16,3,38,49,1949
46128,46128,C25A28585FD90C5600BD444341038A54,11231,21,23,2,37,49,1899
46134,46134,7880FD83CA3B2C2EBE599ECD394C4782,19441,0,11,11,8,46,446
46135,46135,7880FD83CA3B2C2EBE599ECD394C4782,42041,13,14,1,10,47,547
46136,46136,7880FD83CA3B2C2EBE599ECD394C4782,19441,17,20,3,8,46,446
46145,46145,CC04DF57CD476D56A9C2711AACC54374,42861,0,4,4,37,44,1894
46146,46146,CC04DF57CD476D56A9C2711AACC54374,11261,4,5,1,36,46,1846
46147,46147,CC04DF57CD476D56A9C2711AACC54374,42861,5,6,1,37,44,1894
46148,46148,CC04DF57CD476D56A9C2711AACC54374,11261,7,21,14,36,46,1846
46149,46149,53DE27C3988F5D22526FCC360F8F3A99,11321,0,6,6,31,46,1596
46150,46150,53DE27C3988F5D22526FCC360F8F3A99,42523,6,12,6,31,47,1597
46151,46151,53DE27C3988F5D22526FCC360F8F3A99,11321,14,23,9,31,46,1596
46152,46152,A7CD6B35F9497ACE5BF2FA9C0E963836,13231,0,14,14,39,46,1996
46153,46153,A7CD6B35F9497ACE5BF2FA9C0E963836,42031,14,17,3,40,46,2046
46154,46154,A7CD6B35F9497ACE5BF2FA9C0E963836,10471,21,23,2,37,48,1898
46155,46155,C10EEFAF39D689A1C1E5FEB245DEDC71,10681,0,1,1,30,48,1548
46156,46156,C10EEFAF39D689A1C1E5FEB245DEDC71,40872,1,11,10,30,49,1549
46157,46157,C10EEFAF39D689A1C1E5FEB245DEDC71,11061,15,22,7,29,48,1498
46161,46161,E3950B228FF57BC4F70CD2EC3D90B5FF,42231,1,8,7,37,46,1896
46162,46162,E3950B228FF57BC4F70CD2EC3D90B5FF,11811,9,10,1,38,49,1949
46163,46163,E3950B228FF57BC4F70CD2EC3D90B5FF,13711,12,23,11,38,46,1946
46167,46167,8A2B6A3BBB67F4CA1B157F83176E3E9B,11151,0,14,14,30,48,1548
46168,46168,8A2B6A3BBB67F4CA1B157F83176E3E9B,42831,19,20,1,27,48,1398
46169,46169,8A2B6A3BBB67F4CA1B157F83176E3E9B,11151,21,22,1,30,48,1548
46200,46200,9DD44F57C5C2ABBFDB5902808084C013,43241,0,8,8,36,46,1846
46201,46201,9DD44F57C5C2ABBFDB5902808084C013,11074,11,13,2,37,47,1897
46202,46202,9DD44F57C5C2ABBFDB5902808084C013,42471,14,22,8,35,49,1799
46203,46203,EE8535EFC0E3237FE1E9870ACB3D38E1,42321,6,9,3,43,47,2197
46204,46204,EE8535EFC0E3237FE1E9870ACB3D38E1,43621,10,11,1,46,48,2348
46205,46205,EE8535EFC0E3237FE1E9870ACB3D38E1,42321,14,15,1,43,47,2197
46206,46206,EE8535EFC0E3237FE1E9870ACB3D38E1,43621,16,18,2,46,48,2348
46213,46213,333863A2CE0A7D471D7CF76BFFDAB0D7,19744,0,4,4,6,43,343
46214,46214,333863A2CE0A7D471D7CF76BFFDAB0D7,12641,6,8,2,10,43,543
46215,46215,333863A2CE0A7D471D7CF76BFFDAB0D7,19931,10,11,1,7,43,393
46216,46216,333863A2CE0A7D471D7CF76BFFDAB0D7,12641,14,23,9,10,43,543
46222,46222,22654C8C41FD843CC6C6A76B44EF7C2F,13371,0,9,9,41,47,2097
46223,46223,22654C8C41FD843CC6C6A76B44EF7C2F,42031,11,13,2,40,46,2046
46224,46224,22654C8C41FD843CC6C6A76B44EF7C2F,11074,17,19,2,37,47,1897
46225,46225,22654C8C41FD843CC6C6A76B44EF7C2F,13941,21,23,2,41,47,2097
46232,46232,9951832C875ED15346443116F8C6A7D1,42331,0,7,7,39,46,1996
46233,46233,9951832C875ED15346443116F8C6A7D1,10191,8,15,7,40,48,2048
46234,46234,9951832C875ED15346443116F8C6A7D1,42331,18,23,5,39,46,1996
46254,46254,AE64A3DFBE9C3342907BF204A8902B7B,12311,0,6,6,30,44,1544
46255,46255,AE64A3DFBE9C3342907BF204A8902B7B,10301,6,8,2,31,45,1595
46256,46256,AE64A3DFBE9C3342907BF204A8902B7B,12311,13,18,5,30,44,1544
46269,46269,9D7E00B7B35F1D009A11BD7E19D6934B,13121,10,11,1,38,46,1946
46270,46270,9D7E00B7B35F1D009A11BD7E19D6934B,42511,11,13,2,37,47,1897
46271,46271,9D7E00B7B35F1D009A11BD7E19D6934B,42301,18,23,5,36,47,1847
46272,46272,17BFCEDD973B29E8302E2E7670AFE303,10471,7,12,5,37,48,1898
46273,46273,17BFCEDD973B29E8302E2E7670AFE303,11811,13,14,1,38,49,1949
46274,46274,17BFCEDD973B29E8302E2E7670AFE303,10471,18,22,4,37,48,1898
46275,46275,4395C6E2ABA59930045C5FB0134BA180,10711,0,7,7,29,46,1496
46276,46276,4395C6E2ABA59930045C5FB0134BA180,10301,7,14,7,31,45,1595
46277,46277,4395C6E2ABA59930045C5FB0134BA180,12311,14,16,2,30,44,1544
46278,46278,4395C6E2ABA59930045C5FB0134BA180,10711,16,23,7,29,46,1496
46288,46288,E478E2D9BCF7A4F7B498F875A46F0A1D,42461,1,7,6,45,47,2297
46289,46289,E478E2D9BCF7A4F7B498F875A46F0A1D,43061,12,16,4,43,46,2196
46290,46290,E478E2D9BCF7A4F7B498F875A46F0A1D,42461,19,20,1,45,47,2297
46294,46294,4F3F717E93BC5AFE00C4421DCBF0AA01,13711,0,9,9,38,46,1946
46295,46295,4F3F717E93BC5AFE00C4421DCBF0AA01,11261,12,17,5,36,46,1846
46296,46296,4F3F717E93BC5AFE00C4421DCBF0AA01,42301,21,22,1,36,47,1847
46309,46309,BC46C2C9CF0F15302C6CF8152539BE72,10721,0,11,11,31,48,1598
46310,46310,BC46C2C9CF0F15302C6CF8152539BE72,11061,14,17,3,29,48,1498
46311,46311,BC46C2C9CF0F15302C6CF8152539BE72,10721,20,23,3,31,48,1598
46318,46318,649D537EAF2002D83012C69B3CA759A0,11161,0,7,7,32,48,1648
46319,46319,649D537EAF2002D83012C69B3CA759A0,43311,8,11,3,31,48,1598
46320,46320,649D537EAF2002D83012C69B3CA759A0,11161,13,14,1,32,48,1648
46321,46321,649D537EAF2002D83012C69B3CA759A0,11061,15,20,5,29,48,1498
46333,46333,071CE09F855A64AE0576C7544BB94C70,42161,0,12,12,36,47,1847
46334,46334,071CE09F855A64AE0576C7544BB94C70,10531,13,17,4,34,46,1746
46335,46335,071CE09F855A64AE0576C7544BB94C70,42161,18,23,5,36,47,1847
46359,46359,A8DFAF39A5A26AE1BCD9E9DE060BB315,11091,0,5,5,29,47,1497
46360,46360,A8DFAF39A5A26AE1BCD9E9DE060BB315,13651,7,11,4,30,47,1547
46361,46361,A8DFAF39A5A26AE1BCD9E9DE060BB315,10951,17,19,2,29,48,1498
46362,46362,A8DFAF39A5A26AE1BCD9E9DE060BB315,11091,20,23,3,29,47,1497
46363,46363,565005545D8DAD4FBDA185A153E90618,42041,0,5,5,10,47,547
46364,46364,565005545D8DAD4FBDA185A153E90618,19441,8,9,1,8,46,446
46365,46365,565005545D8DAD4FBDA185A153E90618,42041,11,23,12,10,47,547
46366,46366,2FC158799FF19F821FBD3DC4EFE863DB,43101,0,1,1,46,40,2340
46367,46367,2FC158799FF19F821FBD3DC4EFE863DB,13551,5,11,6,45,38,2288
46368,46368,2FC158799FF19F821FBD3DC4EFE863DB,43101,11,15,4,46,40,2340
46369,46369,2FC158799FF19F821FBD3DC4EFE863DB,13551,15,23,8,45,38,2288
46377,46377,209CBAFCECFCFAF5ADEC7A13A8F80FC5,12641,1,2,1,10,43,543
46378,46378,209CBAFCECFCFAF5ADEC7A13A8F80FC5,19114,6,8,2,7,43,393
46379,46379,209CBAFCECFCFAF5ADEC7A13A8F80FC5,19901,12,15,3,7,44,394
46380,46380,209CBAFCECFCFAF5ADEC7A13A8F80FC5,19114,17,21,4,7,43,393
46389,46389,33EC6862A4D3A83DD8E8B00DCA26EE3C,43241,0,13,13,36,46,1846
46390,46390,33EC6862A4D3A83DD8E8B00DCA26EE3C,10411,16,17,1,36,48,1848
46391,46391,33EC6862A4D3A83DD8E8B00DCA26EE3C,13711,20,22,2,38,46,1946
46392,46392,1A405C5DE99A88589837D5F72AD75DAF,11331,0,6,6,37,48,1898
46393,46393,1A405C5DE99A88589837D5F72AD75DAF,11461,15,17,2,37,49,1899
46394,46394,1A405C5DE99A88589837D5F72AD75DAF,11331,18,23,5,37,48,1898
46403,46403,7523898182A4B2F028D49F08A2CA1062,11021,0,12,12,36,49,1849
46404,46404,7523898182A4B2F028D49F08A2CA1062,43234,14,16,2,37,49,1899
46405,46405,7523898182A4B2F028D49F08A2CA1062,11771,17,18,1,39,49,1999
46406,46406,7523898182A4B2F028D49F08A2CA1062,10661,21,23,2,37,49,1899
46407,46407,872EA7042E221A40D168D3255557BABA,43761,0,16,16,32,47,1647
46408,46408,872EA7042E221A40D168D3255557BABA,42521,16,18,2,31,47,1597
46409,46409,872EA7042E221A40D168D3255557BABA,43761,19,22,3,32,47,1647
46416,46416,FCF6425DA3F542476DF1F93935C075D8,42581,0,8,8,38,48,1948
46417,46417,FCF6425DA3F542476DF1F93935C075D8,43181,11,14,3,39,48,1998
46418,46418,FCF6425DA3F542476DF1F93935C075D8,42581,17,23,6,38,48,1948
46422,46422,0BB9DC41D7DF7A2695FAED0932FBBC64,11021,0,8,8,36,49,1849
46423,46423,0BB9DC41D7DF7A2695FAED0932FBBC64,11811,11,13,2,38,49,1949
46424,46424,0BB9DC41D7DF7A2695FAED0932FBBC64,11021,15,18,3,36,49,1849
46428,46428,F90954498AAC03C04B25437D1E7BA923,10271,0,18,18,37,46,1896
46429,46429,F90954498AAC03C04B25437D1E7BA923,11491,19,20,1,36,47,1847
46430,46430,F90954498AAC03C04B25437D1E7BA923,10111,20,23,3,37,47,1897
46431,46431,8AEC70FC169C492934E790E5A0010D1B,42271,0,14,14,40,47,2047
46432,46432,8AEC70FC169C492934E790E5A0010D1B,11806,15,17,2,41,48,2098
46433,46433,8AEC70FC169C492934E790E5A0010D1B,42271,21,23,2,40,47,2047
46434,46434,03C0426D798D28FFFD9A991613F3D23A,10295,0,7,7,30,47,1547
46435,46435,03C0426D798D28FFFD9A991613F3D23A,11861,8,19,11,32,47,1647
46436,46436,03C0426D798D28FFFD9A991613F3D23A,13651,20,22,2,30,47,1547
46446,46446,49C79AB3305EA0BDD0BE79CDFA7582CD,42221,7,8,1,38,48,1948
46447,46447,49C79AB3305EA0BDD0BE79CDFA7582CD,13681,10,15,5,38,47,1947
46448,46448,49C79AB3305EA0BDD0BE79CDFA7582CD,11074,16,21,5,37,47,1897
46449,46449,49C79AB3305EA0BDD0BE79CDFA7582CD,42221,21,22,1,38,48,1948
46456,46456,4B5119258FB3482B746B53277561992F,12581,6,11,5,24,48,1248
46457,46457,4B5119258FB3482B746B53277561992F,12601,12,16,4,25,47,1297
46458,46458,4B5119258FB3482B746B53277561992F,12581,17,20,3,24,48,1248
46459,46459,4B5119258FB3482B746B53277561992F,10501,21,23,2,22,46,1146
46477,46477,2764B8ABB23930F22F4F0762C2A18E7E,13121,0,14,14,38,46,1946
46478,46478,2764B8ABB23930F22F4F0762C2A18E7E,42231,15,17,2,37,46,1896
46479,46479,2764B8ABB23930F22F4F0762C2A18E7E,13711,18,21,3,38,46,1946
46480,46480,CEE3FB5F7DCCF0F51159A83755B2F924,42141,0,14,14,32,47,1647
46481,46481,CEE3FB5F7DCCF0F51159A83755B2F924,11211,15,16,1,34,49,1749
46482,46482,CEE3FB5F7DCCF0F51159A83755B2F924,42141,18,19,1,32,47,1647
46486,46486,7F73A642AA11134206C46BA15C785E40,10292,7,11,4,30,47,1547
46487,46487,7F73A642AA11134206C46BA15C785E40,42521,15,16,1,31,47,1597
46488,46488,7F73A642AA11134206C46BA15C785E40,42491,16,19,3,32,46,1646
46489,46489,BD2E300B9C24161B103FADC662539751,11271,1,11,10,37,48,1898
46490,46490,BD2E300B9C24161B103FADC662539751,43671,19,21,2,35,48,1798
46491,46491,BD2E300B9C24161B103FADC662539751,11271,21,23,2,37,48,1898
46498,46498,05D32A78CDAE6C06BE59AEA5D4CE1210,42401,0,6,6,36,47,1847
46499,46499,05D32A78CDAE6C06BE59AEA5D4CE1210,10251,7,16,9,35,47,1797
46500,46500,05D32A78CDAE6C06BE59AEA5D4CE1210,40637,17,23,6,36,47,1847
46512,46512,4DAFB85C918047225CA596E4134A09D3,42141,0,5,5,32,47,1647
46513,46513,4DAFB85C918047225CA596E4134A09D3,13651,9,10,1,30,47,1547
46514,46514,4DAFB85C918047225CA596E4134A09D3,42141,14,22,8,32,47,1647
46515,46515,5ED8949BAC5CDF05EDA1019FB7CA4B17,40171,0,6,6,38,48,1948
46516,46516,5ED8949BAC5CDF05EDA1019FB7CA4B17,10471,11,12,1,37,48,1898
46517,46517,5ED8949BAC5CDF05EDA1019FB7CA4B17,40171,13,14,1,38,48,1948
46518,46518,5ED8949BAC5CDF05EDA1019FB7CA4B17,10471,14,23,9,37,48,1898
46522,46522,54E9147B0F88496112EA8083546467E6,12311,0,4,4,30,44,1544
46523,46523,54E9147B0F88496112EA8083546467E6,12661,4,7,3,32,45,1645
46524,46524,54E9147B0F88496112EA8083546467E6,12311,9,23,14,30,44,1544
46525,46525,2CF6926FFE4B0A039252F2A1CE944213,13711,7,9,2,38,46,1946
46526,46526,2CF6926FFE4B0A039252F2A1CE944213,10191,11,15,4,40,48,2048
46527,46527,2CF6926FFE4B0A039252F2A1CE944213,41601,19,22,3,39,49,1999
46528,46528,2F79E8BB67782A6FF1E7E49281847360,43581,0,6,6,33,48,1698
46529,46529,2F79E8BB67782A6FF1E7E49281847360,11541,8,10,2,35,49,1799
46530,46530,2F79E8BB67782A6FF1E7E49281847360,10401,13,14,1,33,49,1699
46531,46531,2F79E8BB67782A6FF1E7E49281847360,43581,19,22,3,33,48,1698
46535,46535,0E9E7AFF4422B633BEB9D687C008FCF0,43761,0,19,19,32,47,1647
46536,46536,0E9E7AFF4422B633BEB9D687C008FCF0,42523,19,21,2,31,47,1597
46537,46537,0E9E7AFF4422B633BEB9D687C008FCF0,43761,21,23,2,32,47,1647
46543,46543,BB44A13BCAB0B022B18D7F4EDDEC4037,11231,0,2,2,37,49,1899
46544,46544,BB44A13BCAB0B022B18D7F4EDDEC4037,42301,2,15,13,36,47,1847
46545,46545,BB44A13BCAB0B022B18D7F4EDDEC4037,10841,16,17,1,37,47,1897
46546,46546,BB44A13BCAB0B022B18D7F4EDDEC4037,11231,20,23,3,37,49,1899
46547,46547,9A32E318CA0CDE9DA0BCF043EF40ABC3,11731,0,3,3,36,48,1848
46548,46548,9A32E318CA0CDE9DA0BCF043EF40ABC3,12021,4,14,10,37,49,1899
46549,46549,9A32E318CA0CDE9DA0BCF043EF40ABC3,11161,17,18,1,32,48,1648
46550,46550,55536669E97AF41ACDE427113BB85731,10691,0,6,6,33,48,1698
46551,46551,55536669E97AF41ACDE427113BB85731,11861,7,16,9,32,47,1647
46552,46552,55536669E97AF41ACDE427113BB85731,10691,18,22,4,33,48,1698
46556,46556,B304D2AD98C7DE24CAE6DD0DA65095F0,10431,0,5,5,33,49,1699
46557,46557,B304D2AD98C7DE24CAE6DD0DA65095F0,42491,7,9,2,32,46,1646
46558,46558,B304D2AD98C7DE24CAE6DD0DA65095F0,43581,9,16,7,33,48,1698
46559,46559,B304D2AD98C7DE24CAE6DD0DA65095F0,10431,21,23,2,33,49,1699
46560,46560,5A5B2CBA296E90D3798147AFE5312824,13561,0,10,10,37,49,1899
46561,46561,5A5B2CBA296E90D3798147AFE5312824,11541,12,14,2,35,49,1799
46562,46562,5A5B2CBA296E90D3798147AFE5312824,43361,15,17,2,38,48,1948
46563,46563,5A5B2CBA296E90D3798147AFE5312824,13561,21,23,2,37,49,1899
46567,46567,34FB5BF239A7B5016E3CA81F47968839,42161,0,9,9,36,47,1847
46568,46568,34FB5BF239A7B5016E3CA81F47968839,40951,13,16,3,36,49,1849
46569,46569,34FB5BF239A7B5016E3CA81F47968839,10901,16,18,2,35,48,1798
46577,46577,F5CAB8F803ECE6BB91E5E9B3677179B2,10111,0,8,8,37,47,1897
46578,46578,F5CAB8F803ECE6BB91E5E9B3677179B2,42401,10,14,4,36,47,1847
46579,46579,F5CAB8F803ECE6BB91E5E9B3677179B2,10111,19,22,3,37,47,1897
46580,46580,F5CAB8F803ECE6BB91E5E9B3677179B2,10331,22,23,1,39,46,1996
46581,46581,7BDBEF6BD859A286B2B81164F794B929,13101,0,12,12,40,47,2047
46582,46582,7BDBEF6BD859A286B2B81164F794B929,11491,12,17,5,36,47,1847
46583,46583,7BDBEF6BD859A286B2B81164F794B929,42321,18,20,2,43,47,2197
46584,46584,99A92AD24D04D2EBCBD0E2108B572F74,11151,2,9,7,30,48,1548
46585,46585,99A92AD24D04D2EBCBD0E2108B572F74,11061,10,15,5,29,48,1498
46586,46586,99A92AD24D04D2EBCBD0E2108B572F74,10721,15,16,1,31,48,1598
46587,46587,99A92AD24D04D2EBCBD0E2108B572F74,11061,17,23,6,29,48,1498
46601,46601,EF7FF0709933B50F4D00C87C477FCE93,43061,0,8,8,43,46,2196
46602,46602,EF7FF0709933B50F4D00C87C477FCE93,42111,11,18,7,44,46,2246
46603,46603,EF7FF0709933B50F4D00C87C477FCE93,42091,18,19,1,43,46,2196
46604,46604,EF7FF0709933B50F4D00C87C477FCE93,13111,22,23,1,42,46,2146
46622,46622,F4C8F856DD638BBA75F52C720E10C05D,12641,1,6,5,10,43,543
46623,46623,F4C8F856DD638BBA75F52C720E10C05D,12921,9,16,7,9,41,491
46624,46624,F4C8F856DD638BBA75F52C720E10C05D,12641,20,21,1,10,43,543
46625,46625,F4C8F856DD638BBA75F52C720E10C05D,12921,22,23,1,9,41,491
46626,46626,84DA01F112661472BCB344139BA68924,43061,0,6,6,43,46,2196
46627,46627,84DA01F112661472BCB344139BA68924,13341,7,14,7,44,45,2245
46628,46628,84DA01F112661472BCB344139BA68924,43061,15,23,8,43,46,2196
46629,46629,BEAFC8C79C1FC6E77C4707458CA240B2,10121,0,12,12,36,49,1849
46630,46630,BEAFC8C79C1FC6E77C4707458CA240B2,11231,14,17,3,37,49,1899
46631,46631,BEAFC8C79C1FC6E77C4707458CA240B2,10121,18,22,4,36,49,1849
46640,46640,2FC430E1448F290A8E229F5C2301E320,12921,0,1,1,9,41,491
46641,46641,2FC430E1448F290A8E229F5C2301E320,49201,4,8,4,7,41,391
46642,46642,2FC430E1448F290A8E229F5C2301E320,12921,8,14,6,9,41,491
46643,46643,2FC430E1448F290A8E229F5C2301E320,49201,14,23,9,7,41,391
46644,46644,1788FF83230593384DFEF88881720D90,13551,0,15,15,45,38,2288
46645,46645,1788FF83230593384DFEF88881720D90,43101,15,20,5,46,40,2340
46646,46646,1788FF83230593384DFEF88881720D90,13551,21,22,1,45,38,2288
46647,46647,EB3F1E97C488E972B65B1AF3C2A86B31,40123,1,11,10,38,47,1947
46648,46648,EB3F1E97C488E972B65B1AF3C2A86B31,11331,15,19,4,37,48,1898
46649,46649,EB3F1E97C488E972B65B1AF3C2A86B31,13331,21,22,1,38,47,1947
46650,46650,CB89340A1F14607CB686C927E90B3821,10111,1,9,8,37,47,1897
46651,46651,CB89340A1F14607CB686C927E90B3821,43731,11,13,2,34,47,1747
46652,46652,CB89340A1F14607CB686C927E90B3821,10251,14,17,3,35,47,1797
46653,46653,CB89340A1F14607CB686C927E90B3821,10111,19,21,2,37,47,1897
46660,46660,F7F6E311089E545E2ADE21E1CFF4D206,40636,0,1,1,35,48,1798
46661,46661,F7F6E311089E545E2ADE21E1CFF4D206,43761,2,18,16,32,47,1647
46662,46662,F7F6E311089E545E2ADE21E1CFF4D206,40636,20,23,3,35,48,1798
46663,46663,6A374E00137D245879D87467BBBF649C,42871,0,5,5,30,45,1545
46664,46664,6A374E00137D245879D87467BBBF649C,12311,5,6,1,30,44,1544
46665,46665,6A374E00137D245879D87467BBBF649C,42871,10,16,6,30,45,1545
46666,46666,6A374E00137D245879D87467BBBF649C,12311,19,21,2,30,44,1544
46667,46667,08B8EDA44B601527B128BD5FA9B83341,13821,0,3,3,49,45,2495
46668,46668,08B8EDA44B601527B128BD5FA9B83341,43951,4,18,14,49,41,2491
46669,46669,08B8EDA44B601527B128BD5FA9B83341,10751,21,22,1,47,43,2393
46674,46674,405D0397A0039CC27D91E15C636835F3,10121,0,13,13,36,49,1849
46675,46675,405D0397A0039CC27D91E15C636835F3,13561,14,19,5,37,49,1899
46676,46676,405D0397A0039CC27D91E15C636835F3,12391,19,21,2,36,49,1849
46677,46677,405D0397A0039CC27D91E15C636835F3,10901,22,23,1,35,48,1798
46681,46681,0DFD98C5BF618352145AEF64606DF221,40673,0,8,8,36,48,1848
46682,46682,0DFD98C5BF618352145AEF64606DF221,42161,8,9,1,36,47,1847
46683,46683,0DFD98C5BF618352145AEF64606DF221,40673,13,15,2,36,48,1848
46684,46684,0DFD98C5BF618352145AEF64606DF221,42401,15,22,7,36,47,1847
46685,46685,88D3AECB79C42D19C5311DB0C1B36772,42301,0,6,6,36,47,1847
46686,46686,88D3AECB79C42D19C5311DB0C1B36772,10271,6,7,1,37,46,1896
46687,46687,88D3AECB79C42D19C5311DB0C1B36772,42301,12,22,10,36,47,1847
46713,46713,47C1473BA4462B22BD05E79B53CFA190,42041,0,6,6,10,47,547
46714,46714,47C1473BA4462B22BD05E79B53CFA190,19441,14,15,1,8,46,446
46715,46715,47C1473BA4462B22BD05E79B53CFA190,42041,19,22,3,10,47,547
46716,46716,3AEA3CF422288C2FFB9C65FD7BE694C9,12921,0,11,11,9,41,491
46717,46717,3AEA3CF422288C2FFB9C65FD7BE694C9,19931,13,19,6,7,43,393
46718,46718,3AEA3CF422288C2FFB9C65FD7BE694C9,12921,19,21,2,9,41,491
46722,46722,E91A43EDDAC2E077133B2E0D42BC7DA1,11355,4,6,2,36,48,1848
46723,46723,E91A43EDDAC2E077133B2E0D42BC7DA1,42941,8,15,7,37,47,1897
46724,46724,E91A43EDDAC2E077133B2E0D42BC7DA1,12514,16,18,2,38,47,1947
46725,46725,E91A43EDDAC2E077133B2E0D42BC7DA1,11231,20,23,3,37,49,1899
46726,46726,3717F18D88C40095DBADE8C95C390E6F,42861,0,1,1,37,44,1894
46727,46727,3717F18D88C40095DBADE8C95C390E6F,42151,1,18,17,35,45,1795
46728,46728,3717F18D88C40095DBADE8C95C390E6F,42861,20,21,1,37,44,1894
46734,46734,F776CF5BFCBAFE40EFE079BFD8CF34A4,19901,0,13,13,7,44,394
46735,46735,F776CF5BFCBAFE40EFE079BFD8CF34A4,19111,16,18,2,9,45,495
46736,46736,F776CF5BFCBAFE40EFE079BFD8CF34A4,12641,18,20,2,10,43,543
46737,46737,5767DCB7927C2A22DA225038742C1BCE,13561,0,7,7,37,49,1899
46738,46738,5767DCB7927C2A22DA225038742C1BCE,11021,8,15,7,36,49,1849
46739,46739,5767DCB7927C2A22DA225038742C1BCE,13561,17,23,6,37,49,1899
46745,46745,8F2DCDB1E6ACA3D4E7FFFCA1E99BF72D,42021,1,10,9,33,47,1697
46746,46746,8F2DCDB1E6ACA3D4E7FFFCA1E99BF72D,43161,13,15,2,35,47,1797
46747,46747,8F2DCDB1E6ACA3D4E7FFFCA1E99BF72D,10292,19,23,4,30,47,1547
46764,46764,4568F4CB3839A063AA85BE5AD656F1DE,12161,9,12,3,32,46,1646
46765,46765,4568F4CB3839A063AA85BE5AD656F1DE,42781,15,17,2,36,46,1846
46766,46766,4568F4CB3839A063AA85BE5AD656F1DE,10401,20,22,2,33,49,1699
46789,46789,2F1F7798F5E8889B4080CA59D71F0274,10271,1,14,13,37,46,1896
46790,46790,2F1F7798F5E8889B4080CA59D71F0274,13711,14,21,7,38,46,1946
46791,46791,2F1F7798F5E8889B4080CA59D71F0274,10271,22,23,1,37,46,1896
46798,46798,6F30A56345792DEEB0E132F0BA3B032C,40637,0,1,1,36,47,1847
46799,46799,6F30A56345792DEEB0E132F0BA3B032C,42371,2,12,10,34,46,1746
46800,46800,6F30A56345792DEEB0E132F0BA3B032C,10251,13,18,5,35,47,1797
46808,46808,AD24687CE009DD38418E30D2A06E4D4E,10121,0,14,14,36,49,1849
46809,46809,AD24687CE009DD38418E30D2A06E4D4E,10881,14,17,3,34,48,1748
46810,46810,AD24687CE009DD38418E30D2A06E4D4E,11021,21,23,2,36,49,1849
46811,46811,FE72309A49FBEB6B76C0E42028E74707,42041,0,13,13,10,47,547
46812,46812,FE72309A49FBEB6B76C0E42028E74707,19441,15,19,4,8,46,446
46813,46813,FE72309A49FBEB6B76C0E42028E74707,42041,19,23,4,10,47,547
46817,46817,49E7F3370FE59E16FF0307AD670723B5,12083,0,10,10,36,49,1849
46818,46818,49E7F3370FE59E16FF0307AD670723B5,11231,10,19,9,37,49,1899
46819,46819,49E7F3370FE59E16FF0307AD670723B5,12083,19,23,4,36,49,1849
46832,46832,246CC93CB32541ED64BE76C965AA4ACC,42321,1,10,9,43,47,2197
46833,46833,246CC93CB32541ED64BE76C965AA4ACC,10801,11,12,1,42,47,2147
46834,46834,246CC93CB32541ED64BE76C965AA4ACC,42321,17,23,6,43,47,2197
46835,46835,A6E7C9F768A521D8C9E298A4B1559383,42581,0,6,6,38,48,1948
46836,46836,A6E7C9F768A521D8C9E298A4B1559383,11914,10,12,2,37,48,1898
46837,46837,A6E7C9F768A521D8C9E298A4B1559383,43181,12,14,2,39,48,1998
46838,46838,A6E7C9F768A521D8C9E298A4B1559383,11914,14,18,4,37,48,1898
46839,46839,21CC55DCEEB90F6907020A6CB2ED172B,11941,0,16,16,37,46,1896
46840,46840,21CC55DCEEB90F6907020A6CB2ED172B,10841,16,17,1,37,47,1897
46841,46841,21CC55DCEEB90F6907020A6CB2ED172B,11941,17,20,3,37,46,1896
46842,46842,21CC55DCEEB90F6907020A6CB2ED172B,42151,21,22,1,35,45,1795
46854,46854,1522BDE7E05C3ADAA9D8391F632D7715,11361,0,14,14,22,48,1148
46855,46855,1522BDE7E05C3ADAA9D8391F632D7715,12051,15,19,4,20,47,1047
46856,46856,1522BDE7E05C3ADAA9D8391F632D7715,11361,20,23,3,22,48,1148
46873,46873,BB2E74524CB93CF21CB552E8ADCE8AA3,42511,0,16,16,37,47,1897
46874,46874,BB2E74524CB93CF21CB552E8ADCE8AA3,40951,16,17,1,36,49,1849
46875,46875,BB2E74524CB93CF21CB552E8ADCE8AA3,42511,20,21,1,37,47,1897
46876,46876,BB2E74524CB93CF21CB552E8ADCE8AA3,42301,22,23,1,36,47,1847
46889,46889,5F5C2388C16FBBCF889B7BB88B6087BC,42631,0,5,5,43,45,2195
46890,46890,5F5C2388C16FBBCF889B7BB88B6087BC,42201,7,8,1,43,46,2196
46891,46891,5F5C2388C16FBBCF889B7BB88B6087BC,13341,8,22,14,44,45,2245
46908,46908,826B40817E61853148AFBFECB1C48C70,11261,0,3,3,36,46,1846
46909,46909,826B40817E61853148AFBFECB1C48C70,42861,5,18,13,37,44,1894
46910,46910,826B40817E61853148AFBFECB1C48C70,11261,20,21,1,36,46,1846
46914,46914,C7DA09D84BB6D5A3ABEAD976C8C0731E,42861,0,5,5,37,44,1894
46915,46915,C7DA09D84BB6D5A3ABEAD976C8C0731E,11261,6,17,11,36,46,1846
46916,46916,C7DA09D84BB6D5A3ABEAD976C8C0731E,42861,19,23,4,37,44,1894
46917,46917,280A825D237E9CE7CB403628403E758B,11261,0,5,5,36,46,1846
46918,46918,280A825D237E9CE7CB403628403E758B,42351,7,8,1,38,45,1945
46919,46919,280A825D237E9CE7CB403628403E758B,13911,9,18,9,39,46,1996
46920,46920,280A825D237E9CE7CB403628403E758B,11074,19,20,1,37,47,1897
46930,46930,71D1B1DED0BB15AF5300A56DBCB790B0,12921,1,6,5,9,41,491
46931,46931,71D1B1DED0BB15AF5300A56DBCB790B0,19114,11,12,1,7,43,393
46932,46932,71D1B1DED0BB15AF5300A56DBCB790B0,12921,13,20,7,9,41,491
46944,46944,B07F9654999A27B565B093B7A4D6A968,11661,0,14,14,40,49,2049
46945,46945,B07F9654999A27B565B093B7A4D6A968,43361,15,17,2,38,48,1948
46946,46946,B07F9654999A27B565B093B7A4D6A968,10921,18,19,1,43,48,2198
46947,46947,B07F9654999A27B565B093B7A4D6A968,11661,20,23,3,40,49,2049
46951,46951,CB569F11653BED8355DBB1B17AC5F222,11921,0,9,9,38,48,1948
46952,46952,CB569F11653BED8355DBB1B17AC5F222,11794,11,13,2,38,49,1949
46953,46953,CB569F11653BED8355DBB1B17AC5F222,40171,13,18,5,38,48,1948
46981,46981,181B5103F0FBF120AFF5BEC3A26A3DB7,43761,0,7,7,32,47,1647
46982,46982,181B5103F0FBF120AFF5BEC3A26A3DB7,10431,8,17,9,33,49,1699
46983,46983,181B5103F0FBF120AFF5BEC3A26A3DB7,43761,19,23,4,32,47,1647
46984,46984,17B467982DBE02EE2EDDF7462F3AE5CF,40925,0,2,2,35,49,1799
46985,46985,17B467982DBE02EE2EDDF7462F3AE5CF,11351,3,12,9,36,48,1848
46986,46986,17B467982DBE02EE2EDDF7462F3AE5CF,40951,14,15,1,36,49,1849
46987,46987,17B467982DBE02EE2EDDF7462F3AE5CF,40925,20,23,3,35,49,1799
46991,46991,0DD480B5A13E261C7A404CA1C7C938C6,42511,0,8,8,37,47,1897
46992,46992,0DD480B5A13E261C7A404CA1C7C938C6,13121,11,14,3,38,46,1946
46993,46993,0DD480B5A13E261C7A404CA1C7C938C6,42511,15,17,2,37,47,1897
46994,46994,0DD480B5A13E261C7A404CA1C7C938C6,13121,17,21,4,38,46,1946
47002,47002,778219C625394A352BA1FB23B1144A95,11231,0,19,19,37,49,1899
47003,47003,778219C625394A352BA1FB23B1144A95,12083,20,21,1,36,49,1849
47004,47004,778219C625394A352BA1FB23B1144A95,11231,22,23,1,37,49,1899
47010,47010,D8963F7C81A647B0DB7A8BBF70036A0B,12514,3,5,2,38,47,1947
47011,47011,D8963F7C81A647B0DB7A8BBF70036A0B,10591,9,10,1,39,48,1998
47012,47012,D8963F7C81A647B0DB7A8BBF70036A0B,42221,13,14,1,38,48,1948
47013,47013,D8963F7C81A647B0DB7A8BBF70036A0B,12514,15,23,8,38,47,1947
47020,47020,50654F68D94497D10A1C2B9ADDEB1DF4,12381,2,15,13,32,48,1648
47021,47021,50654F68D94497D10A1C2B9ADDEB1DF4,10881,18,19,1,34,48,1748
47022,47022,50654F68D94497D10A1C2B9ADDEB1DF4,12381,19,21,2,32,48,1648
47023,47023,9413FEA409947B3C236D88D3369BAB4C,42161,0,11,11,36,47,1847
47024,47024,9413FEA409947B3C236D88D3369BAB4C,11461,13,15,2,37,49,1899
47025,47025,9413FEA409947B3C236D88D3369BAB4C,10111,16,22,6,37,47,1897
47026,47026,508A53F3E777F5ECDE2E5B976BFD7315,42231,0,11,11,37,46,1896
47027,47027,508A53F3E777F5ECDE2E5B976BFD7315,42351,13,14,1,38,45,1945
47028,47028,508A53F3E777F5ECDE2E5B976BFD7315,42231,16,23,7,37,46,1896
47029,47029,1DABB12859D13B3092B5C002A09FA674,42511,0,3,3,37,47,1897
47030,47030,1DABB12859D13B3092B5C002A09FA674,10811,4,14,10,38,46,1946
47031,47031,1DABB12859D13B3092B5C002A09FA674,10971,14,16,2,35,47,1797
47032,47032,1DABB12859D13B3092B5C002A09FA674,10811,17,20,3,38,46,1946
47033,47033,65161D8F8A2EE0E4F87D9472311EE576,12514,0,2,2,38,47,1947
47034,47034,65161D8F8A2EE0E4F87D9472311EE576,10841,4,11,7,37,47,1897
47035,47035,65161D8F8A2EE0E4F87D9472311EE576,12514,13,23,10,38,47,1947
47036,47036,13FE336F780D5F9F83776798BCE67144,42351,0,1,1,38,45,1945
47037,47037,13FE336F780D5F9F83776798BCE67144,42151,3,4,1,35,45,1795
47038,47038,13FE336F780D5F9F83776798BCE67144,42351,7,11,4,38,45,1945
47039,47039,13FE336F780D5F9F83776798BCE67144,11261,12,20,8,36,46,1846
47040,47040,55E490B3039AD9BC5768906A0D6AA0A2,11151,0,17,17,30,48,1548
47041,47041,55E490B3039AD9BC5768906A0D6AA0A2,11061,18,19,1,29,48,1498
47042,47042,55E490B3039AD9BC5768906A0D6AA0A2,11151,19,20,1,30,48,1548
47047,47047,5B7E0FF980805016CA7392409D272673,10301,6,7,1,31,45,1595
47048,47048,5B7E0FF980805016CA7392409D272673,11834,10,17,7,32,45,1645
47049,47049,5B7E0FF980805016CA7392409D272673,10301,21,22,1,31,45,1595
47050,47050,441E401293D6FFC8E080552D376784E1,42581,0,5,5,38,48,1948
47051,47051,441E401293D6FFC8E080552D376784E1,11811,7,8,1,38,49,1949
47052,47052,441E401293D6FFC8E080552D376784E1,11914,8,12,4,37,48,1898
47053,47053,441E401293D6FFC8E080552D376784E1,11921,17,23,6,38,48,1948
47068,47068,C9111848A66C5E8C5A42C9C3546D9FD1,12083,0,11,11,36,49,1849
47069,47069,C9111848A66C5E8C5A42C9C3546D9FD1,11751,12,13,1,35,48,1798
47070,47070,C9111848A66C5E8C5A42C9C3546D9FD1,12391,16,23,7,36,49,1849
47081,47081,E2323F15BA30686339C25751444BC0EC,40171,1,6,5,38,48,1948
47082,47082,E2323F15BA30686339C25751444BC0EC,10471,6,18,12,37,48,1898
47083,47083,E2323F15BA30686339C25751444BC0EC,42221,21,23,2,38,48,1948
47084,47084,C7D141D00F789194C1B0DA1B7B718C58,10191,0,9,9,40,48,2048
47085,47085,C7D141D00F789194C1B0DA1B7B718C58,12401,12,15,3,39,49,1999
47086,47086,C7D141D00F789194C1B0DA1B7B718C58,43181,16,19,3,39,48,1998
47093,47093,F270E2429049EC12B817A3B7398AF53A,10841,1,10,9,37,47,1897
47094,47094,F270E2429049EC12B817A3B7398AF53A,42151,11,14,3,35,45,1795
47095,47095,F270E2429049EC12B817A3B7398AF53A,10111,17,23,6,37,47,1897
47102,47102,DD3EF8B80AABB74E65B5BE12198E023E,13121,0,2,2,38,46,1946
47103,47103,DD3EF8B80AABB74E65B5BE12198E023E,42511,5,6,1,37,47,1897
47104,47104,DD3EF8B80AABB74E65B5BE12198E023E,13121,9,20,11,38,46,1946
47105,47105,DD3EF8B80AABB74E65B5BE12198E023E,42511,20,23,3,37,47,1897
47121,47121,6CF20899EA8F1A27E67F0C12C1758D54,11061,0,7,7,29,48,1498
47122,47122,6CF20899EA8F1A27E67F0C12C1758D54,11381,9,11,2,30,47,1547
47123,47123,6CF20899EA8F1A27E67F0C12C1758D54,11061,19,20,1,29,48,1498
47127,47127,107F9CC1A4A65F34AC5024FE02E6B155,40636,1,9,8,35,48,1798
47128,47128,107F9CC1A4A65F34AC5024FE02E6B155,10731,12,13,1,33,47,1697
47129,47129,107F9CC1A4A65F34AC5024FE02E6B155,40636,20,23,3,35,48,1798
47137,47137,C34E8A8857BF41908035215A29CB4F63,13601,2,15,13,34,47,1747
47138,47138,C34E8A8857BF41908035215A29CB4F63,42371,18,20,2,34,46,1746
47139,47139,C34E8A8857BF41908035215A29CB4F63,43731,22,23,1,34,47,1747
47140,47140,B7783E40C231BF2A915C5200F2E2562A,10881,0,9,9,34,48,1748
47141,47141,B7783E40C231BF2A915C5200F2E2562A,40951,12,17,5,36,49,1849
47142,47142,B7783E40C231BF2A915C5200F2E2562A,10881,21,23,2,34,48,1748
47143,47143,746F9DB3F3845FA01FE3E393E29078E3,12841,0,10,10,37,47,1897
47144,47144,746F9DB3F3845FA01FE3E393E29078E3,11331,12,14,2,37,48,1898
47145,47145,746F9DB3F3845FA01FE3E393E29078E3,43361,15,21,6,38,48,1948
47163,47163,B969FE7CA88FA294C8201CFC44CC669E,12121,0,13,13,29,47,1497
47164,47164,B969FE7CA88FA294C8201CFC44CC669E,12601,14,15,1,25,47,1297
47165,47165,B969FE7CA88FA294C8201CFC44CC669E,12121,17,23,6,29,47,1497
47181,47181,E3EF3D7EF93CC9E529BB5EE547514ED6,42921,1,16,15,33,47,1697
47182,47182,E3EF3D7EF93CC9E529BB5EE547514ED6,10971,17,19,2,35,47,1797
47183,47183,E3EF3D7EF93CC9E529BB5EE547514ED6,42921,19,21,2,33,47,1697
47184,47184,E3EF3D7EF93CC9E529BB5EE547514ED6,11861,22,23,1,32,47,1647
47195,47195,C3302AD1420C958703F3ED8561D9186F,11531,0,7,7,34,49,1749
47196,47196,C3302AD1420C958703F3ED8561D9186F,11021,8,12,4,36,49,1849
47197,47197,C3302AD1420C958703F3ED8561D9186F,11531,13,18,5,34,49,1749
47198,47198,C3302AD1420C958703F3ED8561D9186F,42301,18,20,2,36,47,1847
47219,47219,27B6DDFE3A356062F221ABD7AD70BB14,11061,0,6,6,29,48,1498
47220,47220,27B6DDFE3A356062F221ABD7AD70BB14,10681,8,13,5,30,48,1548
47221,47221,27B6DDFE3A356062F221ABD7AD70BB14,11061,17,23,6,29,48,1498
47222,47222,3FFE7BBAD64D62393AA1BBF176760D1A,13671,0,7,7,27,43,1393
47223,47223,3FFE7BBAD64D62393AA1BBF176760D1A,11281,7,15,8,27,40,1390
47224,47224,3FFE7BBAD64D62393AA1BBF176760D1A,13671,15,23,8,27,43,1393
47225,47225,8FABCF9CE3A0C1922B4386B62EDC8AD0,42871,0,6,6,30,45,1545
47226,47226,8FABCF9CE3A0C1922B4386B62EDC8AD0,10301,8,19,11,31,45,1595
47227,47227,8FABCF9CE3A0C1922B4386B62EDC8AD0,42871,21,23,2,30,45,1545
47228,47228,6BC25D943F92E8D81D0DD10A27C42A3A,11061,1,8,7,29,48,1498
47229,47229,6BC25D943F92E8D81D0DD10A27C42A3A,11381,10,15,5,30,47,1547
47230,47230,6BC25D943F92E8D81D0DD10A27C42A3A,11061,15,17,2,29,48,1498
47231,47231,6BC25D943F92E8D81D0DD10A27C42A3A,11381,19,22,3,30,47,1547
47239,47239,6008ACD9FE609AC96038F2FC4863B492,13711,7,11,4,38,46,1946
47240,47240,6008ACD9FE609AC96038F2FC4863B492,10821,12,17,5,40,47,2047
47241,47241,6008ACD9FE609AC96038F2FC4863B492,13711,17,22,5,38,46,1946
47242,47242,25F8E9AF7E19A192B5B4860B961C3909,42633,0,7,7,42,46,2146
47243,47243,25F8E9AF7E19A192B5B4860B961C3909,13341,7,11,4,44,45,2245
47244,47244,25F8E9AF7E19A192B5B4860B961C3909,42631,11,16,5,43,45,2195
47245,47245,25F8E9AF7E19A192B5B4860B961C3909,42633,16,22,6,42,46,2146
47250,47250,1A9DAEEEE45E6D6064E98B4F317D57C3,42271,0,9,9,40,47,2047
47251,47251,1A9DAEEEE45E6D6064E98B4F317D57C3,12514,10,12,2,38,47,1947
47252,47252,1A9DAEEEE45E6D6064E98B4F317D57C3,42271,13,19,6,40,47,2047
47253,47253,1A9DAEEEE45E6D6064E98B4F317D57C3,43481,19,22,3,39,48,1998
47254,47254,8B7C73BA6B2D95910FBCFDF137038C2A,19114,0,12,12,7,43,393
47255,47255,8B7C73BA6B2D95910FBCFDF137038C2A,12921,13,14,1,9,41,491
47256,47256,8B7C73BA6B2D95910FBCFDF137038C2A,19931,16,23,7,7,43,393
47272,47272,BA865EE03D54F441A6E18D3EAF3533FA,11381,0,10,10,30,47,1547
47273,47273,BA865EE03D54F441A6E18D3EAF3533FA,11061,11,12,1,29,48,1498
47274,47274,BA865EE03D54F441A6E18D3EAF3533FA,11381,12,20,8,30,47,1547
47275,47275,BA865EE03D54F441A6E18D3EAF3533FA,11061,21,23,2,29,48,1498
47292,47292,936F3EAEFFE6D40274671E4FB3E6BD97,11941,0,5,5,37,46,1896
47293,47293,936F3EAEFFE6D40274671E4FB3E6BD97,10841,7,8,1,37,47,1897
47294,47294,936F3EAEFFE6D40274671E4FB3E6BD97,11941,10,23,13,37,46,1896
47295,47295,C60F12F63C2D7D6CCCE36F55A7BBAF31,11151,1,5,4,30,48,1548
47296,47296,C60F12F63C2D7D6CCCE36F55A7BBAF31,11061,6,11,5,29,48,1498
47297,47297,C60F12F63C2D7D6CCCE36F55A7BBAF31,11151,13,23,10,30,48,1548
47303,47303,4F717808305424D6529B2687FA7E5A49,11951,0,11,11,31,49,1599
47304,47304,4F717808305424D6529B2687FA7E5A49,40112,12,14,2,32,48,1648
47305,47305,4F717808305424D6529B2687FA7E5A49,13731,15,19,4,33,49,1699
47328,47328,A9B44FB0C38E30174C1675688859A185,10901,0,5,5,35,48,1798
47329,47329,A9B44FB0C38E30174C1675688859A185,11231,6,7,1,37,49,1899
47330,47330,A9B44FB0C38E30174C1675688859A185,10901,8,10,2,35,48,1798
47331,47331,A9B44FB0C38E30174C1675688859A185,11231,10,22,12,37,49,1899
47336,47336,F18C7871BFB82CA1A349E44A5DE6D0B7,11021,0,15,15,36,49,1849
47337,47337,F18C7871BFB82CA1A349E44A5DE6D0B7,10221,16,17,1,34,49,1749
47338,47338,F18C7871BFB82CA1A349E44A5DE6D0B7,11021,17,23,6,36,49,1849
47344,47344,5B4A62417F5A4F9410202233EBE759A1,43161,0,8,8,35,47,1797
47345,47345,5B4A62417F5A4F9410202233EBE759A1,11201,10,12,2,35,49,1799
47346,47346,5B4A62417F5A4F9410202233EBE759A1,42161,12,19,7,36,47,1847
47351,47351,6460FC216A34C188FE4998AEEFF35C56,43451,0,9,9,37,40,1890
47352,47352,6460FC216A34C188FE4998AEEFF35C56,12521,10,16,6,35,41,1791
47353,47353,6460FC216A34C188FE4998AEEFF35C56,43451,21,23,2,37,40,1890
47370,47370,210582EEAC6D1F2BB5FAA5A446D73BC0,10381,0,17,17,31,49,1599
47371,47371,210582EEAC6D1F2BB5FAA5A446D73BC0,10611,18,19,1,32,48,1648
47372,47372,210582EEAC6D1F2BB5FAA5A446D73BC0,11531,20,22,2,34,49,1749
47373,47373,4EE5C60035D807126AEE0DC0CD563832,11914,6,11,5,37,48,1898
47374,47374,4EE5C60035D807126AEE0DC0CD563832,11231,14,15,1,37,49,1899
47375,47375,4EE5C60035D807126AEE0DC0CD563832,11914,19,20,1,37,48,1898
47376,47376,0508A8D7DFA3BDA9E2048613F3F3934D,42281,3,6,3,40,48,2048
47377,47377,0508A8D7DFA3BDA9E2048613F3F3934D,42271,8,10,2,40,47,2047
47378,47378,0508A8D7DFA3BDA9E2048613F3F3934D,42221,12,22,10,38,48,1948
47379,47379,24576DC2C63BF30A46BA06C33A71F868,42151,0,1,1,35,45,1795
47380,47380,24576DC2C63BF30A46BA06C33A71F868,11261,6,7,1,36,46,1846
47381,47381,24576DC2C63BF30A46BA06C33A71F868,12491,7,9,2,36,43,1843
47382,47382,24576DC2C63BF30A46BA06C33A71F868,11261,9,20,11,36,46,1846
47383,47383,0450CE4A9EA5097186EEF727418CD364,11941,0,7,7,37,46,1896
47384,47384,0450CE4A9EA5097186EEF727418CD364,13711,7,8,1,38,46,1946
47385,47385,0450CE4A9EA5097186EEF727418CD364,11811,9,10,1,38,49,1949
47386,47386,0450CE4A9EA5097186EEF727418CD364,11941,15,20,5,37,46,1896
47390,47390,D2729AB4C70132F423F41A3669BBCC53,43761,0,14,14,32,47,1647
47391,47391,D2729AB4C70132F423F41A3669BBCC53,42521,16,17,1,31,47,1597
47392,47392,D2729AB4C70132F423F41A3669BBCC53,43761,19,21,2,32,47,1647
47393,47393,9027D7BCCA8B9488D727103093A0EE77,13341,0,4,4,44,45,2245
47394,47394,9027D7BCCA8B9488D727103093A0EE77,42631,6,11,5,43,45,2195
47395,47395,9027D7BCCA8B9488D727103093A0EE77,13341,13,15,2,44,45,2245
47396,47396,9027D7BCCA8B9488D727103093A0EE77,12561,18,19,1,45,43,2293
47401,47401,A2E16A977AA2AD3B04258F1BCB83D388,13651,0,9,9,30,47,1547
47402,47402,A2E16A977AA2AD3B04258F1BCB83D388,42141,13,14,1,32,47,1647
47403,47403,A2E16A977AA2AD3B04258F1BCB83D388,13651,16,18,2,30,47,1547
47411,47411,E090AE745FE0157CE235544725EE3E3A,42221,0,1,1,38,48,1948
47412,47412,E090AE745FE0157CE235544725EE3E3A,11074,2,4,2,37,47,1897
47413,47413,E090AE745FE0157CE235544725EE3E3A,12514,6,19,13,38,47,1947
47414,47414,E090AE745FE0157CE235544725EE3E3A,11074,22,23,1,37,47,1897
47420,47420,D0819644627AC00B1760F57708B6F7FF,41393,9,17,8,43,49,2199
47421,47421,D0819644627AC00B1760F57708B6F7FF,43621,17,19,2,46,48,2348
47422,47422,D0819644627AC00B1760F57708B6F7FF,41393,20,21,1,43,49,2199
47434,47434,24CACF86A8CD21A17E28510F56598929,10651,0,14,14,36,49,1849
47435,47435,24CACF86A8CD21A17E28510F56598929,10661,15,19,4,37,49,1899
47436,47436,24CACF86A8CD21A17E28510F56598929,11021,21,23,2,36,49,1849
47465,47465,3869E48F267B04208FDB1CED43168CE1,43761,0,6,6,32,47,1647
47466,47466,3869E48F267B04208FDB1CED43168CE1,12161,11,16,5,32,46,1646
47467,47467,3869E48F267B04208FDB1CED43168CE1,43761,21,23,2,32,47,1647
47493,47493,435E98F8E4BA1C5ED5B064CF22D1AAF1,11301,0,4,4,41,49,2099
47494,47494,435E98F8E4BA1C5ED5B064CF22D1AAF1,40302,18,19,1,40,49,2049
47495,47495,435E98F8E4BA1C5ED5B064CF22D1AAF1,11801,19,21,2,42,48,2148
47509,47509,A6B86C51D1E851C8306B13F3333CE4AD,11491,0,7,7,36,47,1847
47510,47510,A6B86C51D1E851C8306B13F3333CE4AD,13011,8,9,1,39,47,1997
47511,47511,A6B86C51D1E851C8306B13F3333CE4AD,42301,12,15,3,36,47,1847
47512,47512,A6B86C51D1E851C8306B13F3333CE4AD,10491,17,18,1,33,48,1698
47523,47523,248DE1F601C6DE5F727D6B9879F50EF5,12731,8,15,7,22,40,1140
47524,47524,248DE1F601C6DE5F727D6B9879F50EF5,13094,17,18,1,21,42,1092
47525,47525,248DE1F601C6DE5F727D6B9879F50EF5,12731,21,23,2,22,40,1140
47526,47526,132BAF41704DD845C2F70543C3732C4E,42231,0,6,6,37,46,1896
47527,47527,132BAF41704DD845C2F70543C3732C4E,13711,9,12,3,38,46,1946
47528,47528,132BAF41704DD845C2F70543C3732C4E,42231,13,18,5,37,46,1896
47535,47535,E183AEA1AD541C6BB144A110AC32B30F,12641,0,4,4,10,43,543
47536,47536,E183AEA1AD541C6BB144A110AC32B30F,19931,7,16,9,7,43,393
47537,47537,E183AEA1AD541C6BB144A110AC32B30F,12641,16,18,2,10,43,543
47538,47538,E183AEA1AD541C6BB144A110AC32B30F,19931,18,20,2,7,43,393
47539,47539,47CD6F8C499FDC2DF176C3E02C714B79,10111,0,10,10,37,47,1897
47540,47540,47CD6F8C499FDC2DF176C3E02C714B79,10251,13,15,2,35,47,1797
47541,47541,47CD6F8C499FDC2DF176C3E02C714B79,42401,19,23,4,36,47,1847
47552,47552,2AC8E4C41FCDCF53C09A83820985C782,13651,1,14,13,30,47,1547
47553,47553,2AC8E4C41FCDCF53C09A83820985C782,42523,17,18,1,31,47,1597
47554,47554,2AC8E4C41FCDCF53C09A83820985C782,10171,19,21,2,26,47,1347
47569,47569,EAAB672210C677BA2879CCE67BDB7DF5,11151,0,6,6,30,48,1548
47570,47570,EAAB672210C677BA2879CCE67BDB7DF5,42831,6,8,2,27,48,1398
47571,47571,EAAB672210C677BA2879CCE67BDB7DF5,11151,10,22,12,30,48,1548
47572,47572,21E7E3CBBE4DC92A478F3B72E14E1D90,10111,0,10,10,37,47,1897
47573,47573,21E7E3CBBE4DC92A478F3B72E14E1D90,42301,15,16,1,36,47,1847
47574,47574,21E7E3CBBE4DC92A478F3B72E14E1D90,10111,18,23,5,37,47,1897
47575,47575,44A1A512359C02E9A75BCE907A401EBD,42981,0,4,4,36,49,1849
47576,47576,44A1A512359C02E9A75BCE907A401EBD,11231,6,15,9,37,49,1899
47577,47577,44A1A512359C02E9A75BCE907A401EBD,12083,15,20,5,36,49,1849
47578,47578,44A1A512359C02E9A75BCE907A401EBD,11231,21,22,1,37,49,1899
47596,47596,E842607F485373742C16FFFEDE27F174,43181,0,4,4,39,48,1998
47597,47597,E842607F485373742C16FFFEDE27F174,40171,5,9,4,38,48,1948
47598,47598,E842607F485373742C16FFFEDE27F174,12021,14,16,2,37,49,1899
47599,47599,E842607F485373742C16FFFEDE27F174,11521,18,19,1,41,48,2098
47600,47600,9E74C4204DF0368A301BB287E42AE5CC,13371,0,8,8,41,47,2097
47601,47601,9E74C4204DF0368A301BB287E42AE5CC,10231,13,14,1,39,49,1999
47602,47602,9E74C4204DF0368A301BB287E42AE5CC,13791,15,16,1,42,47,2147
47603,47603,9E74C4204DF0368A301BB287E42AE5CC,10821,19,21,2,40,47,2047
47607,47607,E16EBF9DB1B661AB3BA331BB1570A330,12491,0,10,10,36,43,1843
47608,47608,E16EBF9DB1B661AB3BA331BB1570A330,43451,15,16,1,37,40,1890
47609,47609,E16EBF9DB1B661AB3BA331BB1570A330,12491,19,20,1,36,43,1843
47610,47610,7308A861032DD6CDA204025A180927B9,19114,0,13,13,7,43,393
47611,47611,7308A861032DD6CDA204025A180927B9,12641,17,19,2,10,43,543
47612,47612,7308A861032DD6CDA204025A180927B9,19114,19,23,4,7,43,393
47616,47616,2A299573B8ADE5EDDBBA5F82D87A0B34,42921,0,7,7,33,47,1697
47617,47617,2A299573B8ADE5EDDBBA5F82D87A0B34,13601,10,11,1,34,47,1747
47618,47618,2A299573B8ADE5EDDBBA5F82D87A0B34,42921,12,17,5,33,47,1697
47619,47619,2A299573B8ADE5EDDBBA5F82D87A0B34,13601,18,20,2,34,47,1747
47625,47625,08B6161A63F0BFCCF67BFC0EA5B81E44,42621,0,6,6,24,49,1249
47626,47626,08B6161A63F0BFCCF67BFC0EA5B81E44,40341,7,10,3,23,49,1199
47627,47627,08B6161A63F0BFCCF67BFC0EA5B81E44,42621,11,22,11,24,49,1249
47637,47637,74C90A586CDE5D22B85B5C9D6662CF52,19114,0,14,14,7,43,393
47638,47638,74C90A586CDE5D22B85B5C9D6662CF52,12641,14,19,5,10,43,543
47639,47639,74C90A586CDE5D22B85B5C9D6662CF52,19114,19,22,3,7,43,393
47647,47647,F599BD40004701EFC1748D458DE1C7F2,11861,0,5,5,32,47,1647
47648,47648,F599BD40004701EFC1748D458DE1C7F2,43161,5,11,6,35,47,1797
47649,47649,F599BD40004701EFC1748D458DE1C7F2,11861,12,18,6,32,47,1647
47650,47650,4F067AC0455A0AD68F9A6EB159316E5A,10111,0,10,10,37,47,1897
47651,47651,4F067AC0455A0AD68F9A6EB159316E5A,40833,15,18,3,41,47,2097
47652,47652,4F067AC0455A0AD68F9A6EB159316E5A,42161,18,23,5,36,47,1847
47661,47661,A11021665283D6C62A5E3EE561A2FB8C,11261,0,6,6,36,46,1846
47662,47662,A11021665283D6C62A5E3EE561A2FB8C,42351,8,9,1,38,45,1945
47663,47663,A11021665283D6C62A5E3EE561A2FB8C,13911,11,12,1,39,46,1996
47664,47664,A11021665283D6C62A5E3EE561A2FB8C,42351,14,18,4,38,45,1945
47668,47668,6E0A220D70B6915451A9F278684F62AE,10661,0,14,14,37,49,1899
47669,47669,6E0A220D70B6915451A9F278684F62AE,11531,14,16,2,34,49,1749
47670,47670,6E0A220D70B6915451A9F278684F62AE,12514,17,22,5,38,47,1947
47680,47680,4C13C3D7416FEE47C7E01DACD89CC954,10301,2,8,6,31,45,1595
47681,47681,4C13C3D7416FEE47C7E01DACD89CC954,42871,8,12,4,30,45,1545
47682,47682,4C13C3D7416FEE47C7E01DACD89CC954,10301,13,23,10,31,45,1595
47687,47687,005F29A161E0688A7FD457CFA6CB5E51,10611,0,8,8,32,48,1648
47688,47688,005F29A161E0688A7FD457CFA6CB5E51,42021,9,10,1,33,47,1697
47689,47689,005F29A161E0688A7FD457CFA6CB5E51,43311,13,14,1,31,48,1598
47690,47690,005F29A161E0688A7FD457CFA6CB5E51,10611,19,20,1,32,48,1648
47694,47694,6561265EB655B8B0AF69E03674D76359,11861,0,15,15,32,47,1647
47695,47695,6561265EB655B8B0AF69E03674D76359,11211,17,18,1,34,49,1749
47696,47696,6561265EB655B8B0AF69E03674D76359,10881,19,20,1,34,48,1748
47697,47697,6561265EB655B8B0AF69E03674D76359,11861,21,23,2,32,47,1647
47703,47703,E528C1BCF7730647027A4A7EFB058975,42631,0,6,6,43,45,2195
47704,47704,E528C1BCF7730647027A4A7EFB058975,13341,7,20,13,44,45,2245
47705,47705,E528C1BCF7730647027A4A7EFB058975,42631,21,22,1,43,45,2195
47711,47711,41BEA9D7D7C433E67F41ED8F3F4B85D2,10841,9,13,4,37,47,1897
47712,47712,41BEA9D7D7C433E67F41ED8F3F4B85D2,11331,17,18,1,37,48,1898
47713,47713,41BEA9D7D7C433E67F41ED8F3F4B85D2,11074,18,23,5,37,47,1897
47717,47717,61CC7CB5EA609C6320BD2A3529DD90CF,11911,0,6,6,37,48,1898
47718,47718,61CC7CB5EA609C6320BD2A3529DD90CF,10411,10,18,8,36,48,1848
47719,47719,61CC7CB5EA609C6320BD2A3529DD90CF,11911,20,23,3,37,48,1898
47720,47720,04FC279D8763FD0D52EBF8F599CB8F45,11021,2,8,6,36,49,1849
47721,47721,04FC279D8763FD0D52EBF8F599CB8F45,10251,10,12,2,35,47,1797
47722,47722,04FC279D8763FD0D52EBF8F599CB8F45,42301,14,17,3,36,47,1847
47723,47723,04FC279D8763FD0D52EBF8F599CB8F45,11021,21,23,2,36,49,1849
47730,47730,4512C33A5D25C12FE88068CD1CBDBC46,11921,0,6,6,38,48,1948
47731,47731,4512C33A5D25C12FE88068CD1CBDBC46,10471,7,13,6,37,48,1898
47732,47732,4512C33A5D25C12FE88068CD1CBDBC46,40171,15,16,1,38,48,1948
47733,47733,4512C33A5D25C12FE88068CD1CBDBC46,11914,16,18,2,37,48,1898
47738,47738,2F8FE383586D7058AC6D1C2DDF1F34A2,40841,0,14,14,33,49,1699
47739,47739,2F8FE383586D7058AC6D1C2DDF1F34A2,10151,14,17,3,34,47,1747
47740,47740,2F8FE383586D7058AC6D1C2DDF1F34A2,40841,18,21,3,33,49,1699
47744,47744,80DFFB63DC49A57473E5B8802778E56B,13101,0,6,6,40,47,2047
47745,47745,80DFFB63DC49A57473E5B8802778E56B,13271,8,9,1,41,47,2097
47746,47746,80DFFB63DC49A57473E5B8802778E56B,13101,9,21,12,40,47,2047
47747,47747,AC5FFFC9828085332F197D373119C99F,42531,0,12,12,31,45,1595
47748,47748,AC5FFFC9828085332F197D373119C99F,12311,15,17,2,30,44,1544
47749,47749,AC5FFFC9828085332F197D373119C99F,42151,19,20,1,35,45,1795
47750,47750,AC5FFFC9828085332F197D373119C99F,42531,22,23,1,31,45,1595
47778,47778,64FF3E93355E6DCA29977E04D316EABA,13511,1,8,7,34,48,1748
47779,47779,64FF3E93355E6DCA29977E04D316EABA,43731,12,14,2,34,47,1747
47780,47780,64FF3E93355E6DCA29977E04D316EABA,10971,17,20,3,35,47,1797
47781,47781,64FF3E93355E6DCA29977E04D316EABA,10731,20,23,3,33,47,1697
47788,47788,0F18A9274445631256C7B0403CD7E0F0,10111,1,15,14,37,47,1897
47789,47789,0F18A9274445631256C7B0403CD7E0F0,42161,15,16,1,36,47,1847
47790,47790,0F18A9274445631256C7B0403CD7E0F0,10111,17,22,5,37,47,1897
47796,47796,CA9F3291ABF3939E405884AD2ABE2445,12971,0,2,2,32,48,1648
47797,47797,CA9F3291ABF3939E405884AD2ABE2445,11651,2,9,7,33,47,1697
47798,47798,CA9F3291ABF3939E405884AD2ABE2445,12971,12,13,1,32,48,1648
47799,47799,CA9F3291ABF3939E405884AD2ABE2445,11651,17,23,6,33,47,1697
47809,47809,1D20B498D42204F7DA0BA75047AF3620,10471,1,8,7,37,48,1898
47810,47810,1D20B498D42204F7DA0BA75047AF3620,40925,13,16,3,35,49,1799
47811,47811,1D20B498D42204F7DA0BA75047AF3620,10471,17,20,3,37,48,1898
47812,47812,1D20B498D42204F7DA0BA75047AF3620,10971,21,22,1,35,47,1797
47813,47813,DFDD3FE0C2251404AC997151A5933E97,43761,5,10,5,32,47,1647
47814,47814,DFDD3FE0C2251404AC997151A5933E97,10281,14,15,1,33,48,1698
47815,47815,DFDD3FE0C2251404AC997151A5933E97,43761,15,19,4,32,47,1647
47833,47833,D92E0354220FC50EEC1FD87010105B23,11381,0,7,7,30,47,1547
47834,47834,D92E0354220FC50EEC1FD87010105B23,42501,8,19,11,28,47,1447
47835,47835,D92E0354220FC50EEC1FD87010105B23,11381,20,23,3,30,47,1547
47854,47854,621EE723701B1C2822F12413396AAE68,11431,0,6,6,29,47,1497
47855,47855,621EE723701B1C2822F12413396AAE68,12601,8,18,10,25,47,1297
47856,47856,621EE723701B1C2822F12413396AAE68,11431,19,23,4,29,47,1497
47861,47861,FF54F805BED15CA535E79C80702C6E46,10431,1,3,2,33,49,1699
47862,47862,FF54F805BED15CA535E79C80702C6E46,11171,6,7,1,33,48,1698
47863,47863,FF54F805BED15CA535E79C80702C6E46,11231,9,13,4,37,49,1899
47864,47864,FF54F805BED15CA535E79C80702C6E46,10221,15,19,4,34,49,1749
47865,47865,FE737878308133AF20804422D62FD6BC,10251,0,10,10,35,47,1797
47866,47866,FE737878308133AF20804422D62FD6BC,42941,13,14,1,37,47,1897
47867,47867,FE737878308133AF20804422D62FD6BC,12514,17,19,2,38,47,1947
47873,47873,F845329ADC53AB4D5A5EA27AB3F46BCE,11161,4,6,2,32,48,1648
47874,47874,F845329ADC53AB4D5A5EA27AB3F46BCE,43761,6,8,2,32,47,1647
47875,47875,F845329ADC53AB4D5A5EA27AB3F46BCE,42523,8,17,9,31,47,1597
47876,47876,F845329ADC53AB4D5A5EA27AB3F46BCE,43761,18,19,1,32,47,1647
47880,47880,4003E07D2A4AF66E84145561FFA003F3,10341,0,17,17,31,47,1597
47881,47881,4003E07D2A4AF66E84145561FFA003F3,42491,18,20,2,32,46,1646
47882,47882,4003E07D2A4AF66E84145561FFA003F3,10341,21,23,2,31,47,1597
47883,47883,A0B07DBD7CFEABE1E4A0E9444C496CF6,13381,0,14,14,39,47,1997
47884,47884,A0B07DBD7CFEABE1E4A0E9444C496CF6,42271,15,16,1,40,47,2047
47885,47885,A0B07DBD7CFEABE1E4A0E9444C496CF6,13381,20,23,3,39,47,1997
47886,47886,A266B45677C0A1829225C0896CE9C2C1,11074,10,14,4,37,47,1897
47887,47887,A266B45677C0A1829225C0896CE9C2C1,11921,15,17,2,38,48,1948
47888,47888,A266B45677C0A1829225C0896CE9C2C1,11074,22,23,1,37,47,1897
47899,47899,F46E1CF0FA664049260E2702628AE7C3,11171,1,8,7,33,48,1698
47900,47900,F46E1CF0FA664049260E2702628AE7C3,11211,12,15,3,34,49,1749
47901,47901,F46E1CF0FA664049260E2702628AE7C3,11171,19,22,3,33,48,1698
47907,47907,224F149278F148F19786764F4F6CF418,10491,0,17,17,33,48,1698
47908,47908,224F149278F148F19786764F4F6CF418,11201,19,21,2,35,49,1799
47909,47909,224F149278F148F19786764F4F6CF418,10491,22,23,1,33,48,1698
47910,47910,BD8BD67215D62E878894988C5EE5CD9E,11061,0,12,12,29,48,1498
47911,47911,BD8BD67215D62E878894988C5EE5CD9E,43971,12,16,4,30,48,1548
47912,47912,BD8BD67215D62E878894988C5EE5CD9E,11061,16,22,6,29,48,1498
47913,47913,0277E6ABE6E23FB8B51E9078601CBBC1,42491,0,8,8,32,46,1646
47914,47914,0277E6ABE6E23FB8B51E9078601CBBC1,42523,9,19,10,31,47,1597
47915,47915,0277E6ABE6E23FB8B51E9078601CBBC1,42491,20,23,3,32,46,1646
47926,47926,33F69AC83BDBE41253C5DF552C0F4249,11861,6,14,8,32,47,1647
47927,47927,33F69AC83BDBE41253C5DF552C0F4249,11651,15,16,1,33,47,1697
47928,47928,33F69AC83BDBE41253C5DF552C0F4249,11151,18,19,1,30,48,1548
47929,47929,9A1CB6044954B6099E36F60F8EE95A99,11381,0,4,4,30,47,1547
47930,47930,9A1CB6044954B6099E36F60F8EE95A99,10951,6,19,13,29,48,1498
47931,47931,9A1CB6044954B6099E36F60F8EE95A99,11381,20,21,1,30,47,1547
47932,47932,F8EA0C68F3C8266C3E7BA4F2FCE6F8BC,19441,0,13,13,8,46,446
47933,47933,F8EA0C68F3C8266C3E7BA4F2FCE6F8BC,42041,16,17,1,10,47,547
47934,47934,F8EA0C68F3C8266C3E7BA4F2FCE6F8BC,19441,18,19,1,8,46,446
47948,47948,E1ADA5D6F54060F04D34C1A2CB8FE108,13381,1,10,9,39,47,1997
47949,47949,E1ADA5D6F54060F04D34C1A2CB8FE108,11806,14,16,2,41,48,2098
47950,47950,E1ADA5D6F54060F04D34C1A2CB8FE108,13381,17,19,2,39,47,1997
47959,47959,916BC4263959BF562E5C6764781E4744,42531,1,4,3,31,45,1595
47960,47960,916BC4263959BF562E5C6764781E4744,12311,7,20,13,30,44,1544
47961,47961,916BC4263959BF562E5C6764781E4744,42531,22,23,1,31,45,1595
47962,47962,DA2E8CFD3E4C7709220CFEDCD0F376B2,13121,0,10,10,38,46,1946
47963,47963,DA2E8CFD3E4C7709220CFEDCD0F376B2,13271,11,13,2,41,47,2097
47964,47964,DA2E8CFD3E4C7709220CFEDCD0F376B2,13121,14,23,9,38,46,1946
47969,47969,58160F8286644CCBCCC72FA14DAD9C05,19114,0,5,5,7,43,393
47970,47970,58160F8286644CCBCCC72FA14DAD9C05,12641,5,18,13,10,43,543
47971,47971,58160F8286644CCBCCC72FA14DAD9C05,19114,18,22,4,7,43,393
47976,47976,F031FD2F854EE78DC74B73079D5A136F,42501,0,7,7,28,47,1447
47977,47977,F031FD2F854EE78DC74B73079D5A136F,11061,11,12,1,29,48,1498
47978,47978,F031FD2F854EE78DC74B73079D5A136F,10292,13,15,2,30,47,1547
47979,47979,F031FD2F854EE78DC74B73079D5A136F,12121,18,22,4,29,47,1497
47989,47989,09F64A9A641B3F2B92615DE97B925264,10351,0,13,13,28,45,1445
47990,47990,09F64A9A641B3F2B92615DE97B925264,10634,14,19,5,27,45,1395
47991,47991,09F64A9A641B3F2B92615DE97B925264,10351,20,21,1,28,45,1445
47992,47992,4376D7A41A3D5E319ED97A385A2C6159,11861,2,9,7,32,47,1647
47993,47993,4376D7A41A3D5E319ED97A385A2C6159,10611,9,18,9,32,48,1648
47994,47994,4376D7A41A3D5E319ED97A385A2C6159,10721,21,23,2,31,48,1598
48026,48026,3821B66A00758CF4502F36B7CE2D17D9,43451,0,16,16,37,40,1890
48027,48027,3821B66A00758CF4502F36B7CE2D17D9,12491,18,20,2,36,43,1843
48028,48028,3821B66A00758CF4502F36B7CE2D17D9,43451,21,22,1,37,40,1890
48035,48035,8D7D8B902AAAD378610AAECB266730E9,43471,0,8,8,31,49,1599
48036,48036,8D7D8B902AAAD378610AAECB266730E9,10281,12,17,5,33,48,1698
48037,48037,8D7D8B902AAAD378610AAECB266730E9,43471,22,23,1,31,49,1599
48043,48043,20EBDF07FAB10C468662B7339874EF65,11806,0,6,6,41,48,2098
48044,48044,20EBDF07FAB10C468662B7339874EF65,42271,7,8,1,40,47,2047
48045,48045,20EBDF07FAB10C468662B7339874EF65,11806,8,23,15,41,48,2098
48049,48049,5FC0EF97DE5C0E33CEE6EF1939F9D66B,11921,0,6,6,38,48,1948
48050,48050,5FC0EF97DE5C0E33CEE6EF1939F9D66B,11914,8,18,10,37,48,1898
48051,48051,5FC0EF97DE5C0E33CEE6EF1939F9D66B,11921,21,22,1,38,48,1948
48070,48070,BD4F1B02E335A606DD6849B8E89B0BA2,12311,2,5,3,30,44,1544
48071,48071,BD4F1B02E335A606DD6849B8E89B0BA2,42531,5,8,3,31,45,1595
48072,48072,BD4F1B02E335A606DD6849B8E89B0BA2,12311,12,17,5,30,44,1544
48073,48073,BD4F1B02E335A606DD6849B8E89B0BA2,42531,20,23,3,31,45,1595
48087,48087,E859A0BF6FB37F9B42DF06EC7EE8FF9D,42461,0,6,6,45,47,2297
48088,48088,E859A0BF6FB37F9B42DF06EC7EE8FF9D,42321,6,17,11,43,47,2197
48089,48089,E859A0BF6FB37F9B42DF06EC7EE8FF9D,42461,18,23,5,45,47,2297
48109,48109,56577D7E072F237C8DE51C5D025371C7,13561,1,3,2,37,49,1899
48110,48110,56577D7E072F237C8DE51C5D025371C7,10121,4,7,3,36,49,1849
48111,48111,56577D7E072F237C8DE51C5D025371C7,13561,9,10,1,37,49,1899
48112,48112,56577D7E072F237C8DE51C5D025371C7,11021,11,23,12,36,49,1849
48119,48119,F1089F554EDD989C3763AB8DD5D7CDEF,12921,0,5,5,9,41,491
48120,48120,F1089F554EDD989C3763AB8DD5D7CDEF,12641,6,17,11,10,43,543
48121,48121,F1089F554EDD989C3763AB8DD5D7CDEF,19904,20,22,2,9,44,494
48122,48122,E16566CAC1D2263C830A92E3D7A4B3A9,42351,0,4,4,38,45,1945
48123,48123,E16566CAC1D2263C830A92E3D7A4B3A9,42231,6,9,3,37,46,1896
48124,48124,E16566CAC1D2263C830A92E3D7A4B3A9,13911,12,13,1,39,46,1996
48125,48125,E16566CAC1D2263C830A92E3D7A4B3A9,42231,16,18,2,37,46,1896
48126,48126,03BEA4D0FA8CDF0755D9E3B2DE32836F,10901,2,8,6,35,48,1798
48127,48127,03BEA4D0FA8CDF0755D9E3B2DE32836F,10661,9,10,1,37,49,1899
48128,48128,03BEA4D0FA8CDF0755D9E3B2DE32836F,10901,11,18,7,35,48,1798
48129,48129,03BEA4D0FA8CDF0755D9E3B2DE32836F,11591,20,22,2,36,49,1849
48150,48150,19A29A27E6506D34C07A04E6E9F52A03,12491,0,1,1,36,43,1843
48151,48151,19A29A27E6506D34C07A04E6E9F52A03,42151,4,13,9,35,45,1795
48152,48152,19A29A27E6506D34C07A04E6E9F52A03,12491,15,16,1,36,43,1843
48153,48153,19A29A27E6506D34C07A04E6E9F52A03,42151,17,19,2,35,45,1795
48162,48162,3BA5FA710EA7575C057415E520D57C01,10111,2,16,14,37,47,1897
48163,48163,3BA5FA710EA7575C057415E520D57C01,42471,16,18,2,35,49,1799
48164,48164,3BA5FA710EA7575C057415E520D57C01,10111,18,23,5,37,47,1897
48165,48165,440A5BC995406F5A39B97937FE6675EC,12641,0,5,5,10,43,543
48166,48166,440A5BC995406F5A39B97937FE6675EC,12921,7,16,9,9,41,491
48167,48167,440A5BC995406F5A39B97937FE6675EC,12641,20,21,1,10,43,543
48174,48174,FFCAB4901D6A6E467D870CBD619DE91F,12031,0,6,6,33,48,1698
48175,48175,FFCAB4901D6A6E467D870CBD619DE91F,10431,11,18,7,33,49,1699
48176,48176,FFCAB4901D6A6E467D870CBD619DE91F,12031,19,22,3,33,48,1698
48185,48185,6E198FFF8A0EEA3FE2F6EEE55F7012CE,19114,0,5,5,7,43,393
48186,48186,6E198FFF8A0EEA3FE2F6EEE55F7012CE,12641,5,17,12,10,43,543
48187,48187,6E198FFF8A0EEA3FE2F6EEE55F7012CE,19114,19,23,4,7,43,393
48188,48188,AFF2B1944207762129EB0E25C3502ADB,13711,0,11,11,38,46,1946
48189,48189,AFF2B1944207762129EB0E25C3502ADB,11941,13,17,4,37,46,1896
48190,48190,AFF2B1944207762129EB0E25C3502ADB,13711,21,23,2,38,46,1946
48191,48191,52D41928FE5974AA22101E4543346076,11875,0,6,6,30,46,1546
48192,48192,52D41928FE5974AA22101E4543346076,43761,9,15,6,32,47,1647
48193,48193,52D41928FE5974AA22101E4543346076,42523,17,18,1,31,47,1597
48194,48194,52D41928FE5974AA22101E4543346076,42871,19,22,3,30,45,1545
48195,48195,B3D9D8E72FD92A77A76B6490766A3C36,19114,0,1,1,7,43,393
48196,48196,B3D9D8E72FD92A77A76B6490766A3C36,12641,3,7,4,10,43,543
48197,48197,B3D9D8E72FD92A77A76B6490766A3C36,19114,8,22,14,7,43,393
48198,48198,E41EFAEAC6CC7189E20FB98542ADB1CF,11801,3,6,3,42,48,2148
48199,48199,E41EFAEAC6CC7189E20FB98542ADB1CF,13101,12,14,2,40,47,2047
48200,48200,E41EFAEAC6CC7189E20FB98542ADB1CF,11801,16,22,6,42,48,2148
48201,48201,4CA7727345FE5410FF8669E86CE37E32,19441,1,7,6,8,46,446
48202,48202,4CA7727345FE5410FF8669E86CE37E32,19024,9,13,4,9,45,495
48203,48203,4CA7727345FE5410FF8669E86CE37E32,19441,16,17,1,8,46,446
48204,48204,4CA7727345FE5410FF8669E86CE37E32,19024,18,21,3,9,45,495
48205,48205,E779DF22EB61C0D4BA72F0FBA1762DF8,11914,0,11,11,37,48,1898
48206,48206,E779DF22EB61C0D4BA72F0FBA1762DF8,40171,15,16,1,38,48,1948
48207,48207,E779DF22EB61C0D4BA72F0FBA1762DF8,11914,17,20,3,37,48,1898
48208,48208,3578C39840212012BBEC7A08D6782A20,19441,0,1,1,8,46,446
48209,48209,3578C39840212012BBEC7A08D6782A20,19821,2,14,12,4,46,246
48210,48210,3578C39840212012BBEC7A08D6782A20,19441,18,19,1,8,46,446
48211,48211,39468BD1F4D3776AFCE6C15678DD8283,10841,1,8,7,37,47,1897
48212,48212,39468BD1F4D3776AFCE6C15678DD8283,10411,13,14,1,36,48,1848
48213,48213,39468BD1F4D3776AFCE6C15678DD8283,10841,18,23,5,37,47,1897
48219,48219,669C34237215178780FBCDB7F5444D7E,42521,2,12,10,31,47,1597
48220,48220,669C34237215178780FBCDB7F5444D7E,43971,15,17,2,30,48,1548
48221,48221,669C34237215178780FBCDB7F5444D7E,11381,19,21,2,30,47,1547
48222,48222,669C34237215178780FBCDB7F5444D7E,11061,21,22,1,29,48,1498
48223,48223,4CFE48022CAC445FF2DF9E1132BED841,10401,2,8,6,33,49,1699
48224,48224,4CFE48022CAC445FF2DF9E1132BED841,11954,8,10,2,32,49,1649
48225,48225,4CFE48022CAC445FF2DF9E1132BED841,13731,10,21,11,33,49,1699
48231,48231,6EF69708DD923556D4EF232AA0406F1C,11941,0,6,6,37,46,1896
48232,48232,6EF69708DD923556D4EF232AA0406F1C,42351,10,11,1,38,45,1945
48233,48233,6EF69708DD923556D4EF232AA0406F1C,11941,12,23,11,37,46,1896
48252,48252,7EF8399B7744B26431FFE3070C9BD313,42041,0,2,2,10,47,547
48253,48253,7EF8399B7744B26431FFE3070C9BD313,19441,5,7,2,8,46,446
48254,48254,7EF8399B7744B26431FFE3070C9BD313,42041,8,13,5,10,47,547
48255,48255,7EF8399B7744B26431FFE3070C9BD313,19441,14,23,9,8,46,446
48256,48256,AEA9D7155E09D9131D56D14B23262529,10681,0,3,3,30,48,1548
48257,48257,AEA9D7155E09D9131D56D14B23262529,11061,3,4,1,29,48,1498
48258,48258,AEA9D7155E09D9131D56D14B23262529,10681,4,5,1,30,48,1548
48259,48259,AEA9D7155E09D9131D56D14B23262529,11061,10,22,12,29,48,1498
48267,48267,2F3FBE39EE4E3AB748593134D6A2A772,42231,0,11,11,37,46,1896
48268,48268,2F3FBE39EE4E3AB748593134D6A2A772,42351,11,13,2,38,45,1945
48269,48269,2F3FBE39EE4E3AB748593134D6A2A772,42231,13,18,5,37,46,1896
48285,48285,0AE1F060A9917578AF6CC39BEF4A5FD7,11074,4,5,1,37,47,1897
48286,48286,0AE1F060A9917578AF6CC39BEF4A5FD7,10371,9,18,9,37,49,1899
48287,48287,0AE1F060A9917578AF6CC39BEF4A5FD7,11074,20,22,2,37,47,1897
48288,48288,0AE1F060A9917578AF6CC39BEF4A5FD7,42221,22,23,1,38,48,1948
48289,48289,23F8F9B0AC0C62AC07DD5CA5BCEDE820,43101,0,6,6,46,40,2340
48290,48290,23F8F9B0AC0C62AC07DD5CA5BCEDE820,13551,6,15,9,45,38,2288
48291,48291,23F8F9B0AC0C62AC07DD5CA5BCEDE820,43101,15,22,7,46,40,2340
48295,48295,508DF001F529FBF83DF8D4A342350BFA,42861,2,16,14,37,44,1894
48296,48296,508DF001F529FBF83DF8D4A342350BFA,11261,17,18,1,36,46,1846
48297,48297,508DF001F529FBF83DF8D4A342350BFA,42861,19,20,1,37,44,1894
48303,48303,508348FB1FF043CE5822244CA78BFC6A,10121,0,9,9,36,49,1849
48304,48304,508348FB1FF043CE5822244CA78BFC6A,41382,9,10,1,38,49,1949
48305,48305,508348FB1FF043CE5822244CA78BFC6A,10121,11,21,10,36,49,1849
48306,48306,87F0A5B37D23577900D9D67376C1E962,10721,9,11,2,31,48,1598
48307,48307,87F0A5B37D23577900D9D67376C1E962,12381,12,16,4,32,48,1648
48308,48308,87F0A5B37D23577900D9D67376C1E962,10721,17,22,5,31,48,1598
48314,48314,A923C41770F47C64367C4A31C06C83C7,13651,0,10,10,30,47,1547
48315,48315,A923C41770F47C64367C4A31C06C83C7,42491,10,12,2,32,46,1646
48316,48316,A923C41770F47C64367C4A31C06C83C7,13651,16,17,1,30,47,1547
48317,48317,A923C41770F47C64367C4A31C06C83C7,10341,20,22,2,31,47,1597
48327,48327,C7E598BFED6FB574843E537970B28C08,11151,0,10,10,30,48,1548
48328,48328,C7E598BFED6FB574843E537970B28C08,43391,15,16,1,29,48,1498
48329,48329,C7E598BFED6FB574843E537970B28C08,11151,18,23,5,30,48,1548
48330,48330,D570DB7C7486FBBF5A2B4FBCFDB6D24F,43981,0,16,16,36,49,1849
48331,48331,D570DB7C7486FBBF5A2B4FBCFDB6D24F,13561,17,19,2,37,49,1899
48332,48332,D570DB7C7486FBBF5A2B4FBCFDB6D24F,43981,22,23,1,36,49,1849
48344,48344,B1891B03CB53C325B13F0CF9131A1E17,12921,4,8,4,9,41,491
48345,48345,B1891B03CB53C325B13F0CF9131A1E17,12641,11,12,1,10,43,543
48346,48346,B1891B03CB53C325B13F0CF9131A1E17,12921,16,20,4,9,41,491
48352,48352,C867207851F93F2AC19343D7C4225157,42271,0,9,9,40,47,2047
48353,48353,C867207851F93F2AC19343D7C4225157,11806,11,13,2,41,48,2098
48354,48354,C867207851F93F2AC19343D7C4225157,42271,17,18,1,40,47,2047
48355,48355,A7B47D86EDC54D750D3985FD16D6CF0C,43951,0,12,12,49,41,2491
48356,48356,A7B47D86EDC54D750D3985FD16D6CF0C,43101,15,16,1,46,40,2340
48357,48357,A7B47D86EDC54D750D3985FD16D6CF0C,43951,19,21,2,49,41,2491
48358,48358,7A69176949A6F3CD56C41411DF7AEF2C,43161,2,8,6,35,47,1797
48359,48359,7A69176949A6F3CD56C41411DF7AEF2C,11271,10,12,2,37,48,1898
48360,48360,7A69176949A6F3CD56C41411DF7AEF2C,40673,14,20,6,36,48,1848
48361,48361,5B51BC643A26489396AC90A6305DBADE,12083,0,7,7,36,49,1849
48362,48362,5B51BC643A26489396AC90A6305DBADE,13731,8,15,7,33,49,1699
48363,48363,5B51BC643A26489396AC90A6305DBADE,11231,19,23,4,37,49,1899
48364,48364,33EB80EF3507331B16D7DBD52A2E512F,11941,0,7,7,37,46,1896
48365,48365,33EB80EF3507331B16D7DBD52A2E512F,40951,8,17,9,36,49,1849
48366,48366,33EB80EF3507331B16D7DBD52A2E512F,42231,18,19,1,37,46,1896
48367,48367,33EB80EF3507331B16D7DBD52A2E512F,40073,21,23,2,37,48,1898
48368,48368,D3E46B15B35DC3C198E6EE945D227259,11806,0,6,6,41,48,2098
48369,48369,D3E46B15B35DC3C198E6EE945D227259,42271,6,10,4,40,47,2047
48370,48370,D3E46B15B35DC3C198E6EE945D227259,13381,13,23,10,39,47,1997
48371,48371,013FCD4AD29F7B39A4D2C5FDC4F1DF38,10111,0,9,9,37,47,1897
48372,48372,013FCD4AD29F7B39A4D2C5FDC4F1DF38,42401,11,15,4,36,47,1847
48373,48373,013FCD4AD29F7B39A4D2C5FDC4F1DF38,10111,17,22,5,37,47,1897
48377,48377,C25B153F52F3464E9DA99600AD131486,10471,0,6,6,37,48,1898
48378,48378,C25B153F52F3464E9DA99600AD131486,10411,11,20,9,36,48,1848
48379,48379,C25B153F52F3464E9DA99600AD131486,10471,20,22,2,37,48,1898
48380,48380,303626C6E95A1B9EBF7351AEEA69D0DF,13841,0,2,2,40,46,2046
48381,48381,303626C6E95A1B9EBF7351AEEA69D0DF,13011,2,14,12,39,47,1997
48382,48382,303626C6E95A1B9EBF7351AEEA69D0DF,13371,14,15,1,41,47,2097
48383,48383,303626C6E95A1B9EBF7351AEEA69D0DF,13011,19,21,2,39,47,1997
48388,48388,9063D9BC124B90056525B5B4C08304A4,13111,0,10,10,42,46,2146
48389,48389,9063D9BC124B90056525B5B4C08304A4,42461,14,15,1,45,47,2297
48390,48390,9063D9BC124B90056525B5B4C08304A4,13121,18,19,1,38,46,1946
48391,48391,9063D9BC124B90056525B5B4C08304A4,13111,20,23,3,42,46,2146
48392,48392,22E3BF2C7186DFE217FCAD3E03BD0D76,13101,9,10,1,40,47,2047
48393,48393,22E3BF2C7186DFE217FCAD3E03BD0D76,13271,15,16,1,41,47,2097
48394,48394,22E3BF2C7186DFE217FCAD3E03BD0D76,13101,18,19,1,40,47,2047
48398,48398,9B3CEEB5258D8C7EE02AB18106A0FB98,42861,6,7,1,37,44,1894
48399,48399,9B3CEEB5258D8C7EE02AB18106A0FB98,11261,11,12,1,36,46,1846
48400,48400,9B3CEEB5258D8C7EE02AB18106A0FB98,42861,15,17,2,37,44,1894
48401,48401,9B3CEEB5258D8C7EE02AB18106A0FB98,42864,21,22,1,38,44,1944
48441,48441,53D8E731DA65650E5B825C52CF592433,11201,0,13,13,35,49,1799
48442,48442,53D8E731DA65650E5B825C52CF592433,11751,14,16,2,35,48,1798
48443,48443,53D8E731DA65650E5B825C52CF592433,11201,20,22,2,35,49,1799
48444,48444,99215A6EE9EE45501EC0F8414BE04C65,42041,0,13,13,10,47,547
48445,48445,99215A6EE9EE45501EC0F8414BE04C65,19441,13,14,1,8,46,446
48446,48446,99215A6EE9EE45501EC0F8414BE04C65,42041,18,19,1,10,47,547
48447,48447,99215A6EE9EE45501EC0F8414BE04C65,19441,20,21,1,8,46,446
48458,48458,B3EEDE261EE827DE5387BEC8B8493800,42541,0,13,13,25,47,1297
48459,48459,B3EEDE261EE827DE5387BEC8B8493800,11361,13,16,3,22,48,1148
48460,48460,B3EEDE261EE827DE5387BEC8B8493800,10171,17,19,2,26,47,1347
48461,48461,B3EEDE261EE827DE5387BEC8B8493800,42541,21,23,2,25,47,1297
48470,48470,22F3641E0471DCB2B80DB2A9F589D5C0,10151,0,7,7,34,47,1747
48471,48471,22F3641E0471DCB2B80DB2A9F589D5C0,10292,10,11,1,30,47,1547
48472,48472,22F3641E0471DCB2B80DB2A9F589D5C0,11561,14,15,1,32,49,1649
48473,48473,22F3641E0471DCB2B80DB2A9F589D5C0,10151,16,22,6,34,47,1747
48491,48491,474A8DACA51CB40E50178AB2BE706270,11806,0,2,2,41,48,2098
48492,48492,474A8DACA51CB40E50178AB2BE706270,42271,6,7,1,40,47,2047
48493,48493,474A8DACA51CB40E50178AB2BE706270,11806,7,17,10,41,48,2098
48494,48494,474A8DACA51CB40E50178AB2BE706270,10191,21,23,2,40,48,2048
48506,48506,7F683BD350227B09C7ECC1328A0C4739,42011,0,6,6,36,46,1846
48507,48507,7F683BD350227B09C7ECC1328A0C4739,13711,11,12,1,38,46,1946
48508,48508,7F683BD350227B09C7ECC1328A0C4739,42011,14,23,9,36,46,1846
48528,48528,8E8831CA308168F585F32EA6A4F05D47,12121,3,11,8,29,47,1497
48529,48529,8E8831CA308168F585F32EA6A4F05D47,10292,13,14,1,30,47,1547
48530,48530,8E8831CA308168F585F32EA6A4F05D47,10951,15,21,6,29,48,1498
48531,48531,DE6709015B79F307E57CED7DDDF807DA,12491,6,15,9,36,43,1843
48532,48532,DE6709015B79F307E57CED7DDDF807DA,42151,17,18,1,35,45,1795
48533,48533,DE6709015B79F307E57CED7DDDF807DA,12491,19,20,1,36,43,1843
48538,48538,8671664FCEA72D44791A077CF27C82B3,12641,5,18,13,10,43,543
48539,48539,8671664FCEA72D44791A077CF27C82B3,12921,18,20,2,9,41,491
48540,48540,8671664FCEA72D44791A077CF27C82B3,12641,22,23,1,10,43,543
48541,48541,9F7BD4B191C6CDB262073FE9BC5F12C5,11381,10,11,1,30,47,1547
48542,48542,9F7BD4B191C6CDB262073FE9BC5F12C5,11431,14,15,1,29,47,1497
48543,48543,9F7BD4B191C6CDB262073FE9BC5F12C5,11381,19,22,3,30,47,1547
48556,48556,7446641F73809A823733CBB6864B4050,42861,0,8,8,37,44,1894
48557,48557,7446641F73809A823733CBB6864B4050,11261,9,12,3,36,46,1846
48558,48558,7446641F73809A823733CBB6864B4050,42861,15,16,1,37,44,1894
48559,48559,7446641F73809A823733CBB6864B4050,11261,16,18,2,36,46,1846
48565,48565,6A89382A1BC3A3C9D6463538FBEC25D7,13271,0,13,13,41,47,2097
48566,48566,6A89382A1BC3A3C9D6463538FBEC25D7,42411,15,21,6,40,49,2049
48567,48567,6A89382A1BC3A3C9D6463538FBEC25D7,13271,22,23,1,41,47,2097
48594,48594,F9BB7DF37B85A58B4DA3F92DEFB1BE52,10721,0,15,15,31,48,1598
48595,48595,F9BB7DF37B85A58B4DA3F92DEFB1BE52,42521,19,20,1,31,47,1597
48596,48596,F9BB7DF37B85A58B4DA3F92DEFB1BE52,10721,21,23,2,31,48,1598
48597,48597,25DF23F398DD0B4C6CED78808A57A933,11091,0,8,8,29,47,1497
48598,48598,25DF23F398DD0B4C6CED78808A57A933,10292,9,10,1,30,47,1547
48599,48599,25DF23F398DD0B4C6CED78808A57A933,11091,10,12,2,29,47,1497
48600,48600,25DF23F398DD0B4C6CED78808A57A933,10292,13,21,8,30,47,1547
48617,48617,302A082D719F3F7E29DE57CF15EC8D1B,10691,0,10,10,33,48,1698
48618,48618,302A082D719F3F7E29DE57CF15EC8D1B,40951,12,14,2,36,49,1849
48619,48619,302A082D719F3F7E29DE57CF15EC8D1B,11751,14,20,6,35,48,1798
48623,48623,7C379A922CD86ED342B9A15D6E108CB3,10711,0,6,6,29,46,1496
48624,48624,7C379A922CD86ED342B9A15D6E108CB3,12661,7,19,12,32,45,1645
48625,48625,7C379A922CD86ED342B9A15D6E108CB3,10351,21,23,2,28,45,1445
48626,48626,6047B8F4ED31CE087C54DBB5828E319F,10111,0,17,17,37,47,1897
48627,48627,6047B8F4ED31CE087C54DBB5828E319F,41612,17,18,1,36,47,1847
48628,48628,6047B8F4ED31CE087C54DBB5828E319F,10111,21,23,2,37,47,1897
48629,48629,C1E5BCC1C7F8ECB908A80076B478386E,10691,0,6,6,33,48,1698
48630,48630,C1E5BCC1C7F8ECB908A80076B478386E,42491,8,16,8,32,46,1646
48631,48631,C1E5BCC1C7F8ECB908A80076B478386E,10691,18,23,5,33,48,1698
48632,48632,4FB7544A1E67AE742452DB3735E5F7CF,10771,0,6,6,41,46,2096
48633,48633,4FB7544A1E67AE742452DB3735E5F7CF,13341,9,17,8,44,45,2245
48634,48634,4FB7544A1E67AE742452DB3735E5F7CF,10771,21,23,2,41,46,2096
48635,48635,E46021F2EBB1FF86CE07D74A4E5B9C9F,12921,0,10,10,9,41,491
48636,48636,E46021F2EBB1FF86CE07D74A4E5B9C9F,49201,15,21,6,7,41,391
48637,48637,E46021F2EBB1FF86CE07D74A4E5B9C9F,12921,21,23,2,9,41,491
48658,48658,6EBC343B289E845421579091E3F37018,42461,0,3,3,45,47,2297
48659,48659,6EBC343B289E845421579091E3F37018,42091,4,17,13,43,46,2196
48660,48660,6EBC343B289E845421579091E3F37018,42461,18,22,4,45,47,2297
48661,48661,6EBC343B289E845421579091E3F37018,42091,22,23,1,43,46,2196
48662,48662,24CACD73BA8D75767DDD668E5EA165E2,40171,0,7,7,38,48,1948
48663,48663,24CACD73BA8D75767DDD668E5EA165E2,11331,7,9,2,37,48,1898
48664,48664,24CACD73BA8D75767DDD668E5EA165E2,40171,12,19,7,38,48,1948
48673,48673,582FCEF67ED9C80E5B2E8667690F61FB,42221,0,8,8,38,48,1948
48674,48674,582FCEF67ED9C80E5B2E8667690F61FB,42401,8,13,5,36,47,1847
48675,48675,582FCEF67ED9C80E5B2E8667690F61FB,42221,14,17,3,38,48,1948
48676,48676,582FCEF67ED9C80E5B2E8667690F61FB,42401,17,23,6,36,47,1847
48692,48692,73701CC9434D9172C828A8DD1EB9C8FD,19114,2,13,11,7,43,393
48693,48693,73701CC9434D9172C828A8DD1EB9C8FD,12921,16,17,1,9,41,491
48694,48694,73701CC9434D9172C828A8DD1EB9C8FD,19114,20,23,3,7,43,393
48698,48698,B3D3247264CC59DE8B1DE47660D9C8A8,11161,1,5,4,32,48,1648
48699,48699,B3D3247264CC59DE8B1DE47660D9C8A8,43761,5,16,11,32,47,1647
48700,48700,B3D3247264CC59DE8B1DE47660D9C8A8,11161,20,22,2,32,48,1648
48701,48701,B3D3247264CC59DE8B1DE47660D9C8A8,43761,22,23,1,32,47,1647
48733,48733,0045D13BE8E4DDAB53C0085B23256BBF,12601,10,12,2,25,47,1297
48734,48734,0045D13BE8E4DDAB53C0085B23256BBF,10171,15,16,1,26,47,1347
48735,48735,0045D13BE8E4DDAB53C0085B23256BBF,12601,17,18,1,25,47,1297
48736,48736,0045D13BE8E4DDAB53C0085B23256BBF,10171,20,21,1,26,47,1347
48742,48742,4EF13302A4A6283D4450282828263850,10611,0,8,8,32,48,1648
48743,48743,4EF13302A4A6283D4450282828263850,42141,12,14,2,32,47,1647
48744,48744,4EF13302A4A6283D4450282828263850,10491,17,19,2,33,48,1698
48745,48745,4EF13302A4A6283D4450282828263850,10611,20,23,3,32,48,1648
48746,48746,7C5210855A5DFB6ACF7A087ADA0E2F3D,13911,0,12,12,39,46,1996
48747,48747,7C5210855A5DFB6ACF7A087ADA0E2F3D,42231,14,16,2,37,46,1896
48748,48748,7C5210855A5DFB6ACF7A087ADA0E2F3D,13911,17,18,1,39,46,1996
48749,48749,0BAE22D341AA7D152039F41EE0801F08,10471,0,17,17,37,48,1898
48750,48750,0BAE22D341AA7D152039F41EE0801F08,10161,19,21,2,35,49,1799
48751,48751,0BAE22D341AA7D152039F41EE0801F08,10471,21,23,2,37,48,1898
48755,48755,06FD5A27C27B8AACE831A93421CCA5D8,42301,0,10,10,36,47,1847
48756,48756,06FD5A27C27B8AACE831A93421CCA5D8,43731,14,19,5,34,47,1747
48757,48757,06FD5A27C27B8AACE831A93421CCA5D8,42301,22,23,1,36,47,1847
48762,48762,746607B162E7EB25AA57FCC2A7B9163E,11861,0,12,12,32,47,1647
48763,48763,746607B162E7EB25AA57FCC2A7B9163E,10731,12,14,2,33,47,1697
48764,48764,746607B162E7EB25AA57FCC2A7B9163E,11861,14,23,9,32,47,1647
48765,48765,BEDA3F53DF178AFD4DE2A3B4D3458FDF,43481,0,3,3,39,48,1998
48766,48766,BEDA3F53DF178AFD4DE2A3B4D3458FDF,12514,3,4,1,38,47,1947
48767,48767,BEDA3F53DF178AFD4DE2A3B4D3458FDF,43481,9,11,2,39,48,1998
48768,48768,BEDA3F53DF178AFD4DE2A3B4D3458FDF,42271,15,23,8,40,47,2047
48769,48769,106B40E063BD21EF1C07FD923BBC4D30,10691,0,6,6,33,48,1698
48770,48770,106B40E063BD21EF1C07FD923BBC4D30,11561,8,9,1,32,49,1649
48771,48771,106B40E063BD21EF1C07FD923BBC4D30,11861,13,16,3,32,47,1647
48772,48772,106B40E063BD21EF1C07FD923BBC4D30,10491,19,23,4,33,48,1698
48776,48776,4E4FA3262DF5F7B6F1852C92067A0539,11875,0,13,13,30,46,1546
48777,48777,4E4FA3262DF5F7B6F1852C92067A0539,12311,14,17,3,30,44,1544
48778,48778,4E4FA3262DF5F7B6F1852C92067A0539,11875,19,23,4,30,46,1546
48790,48790,7681E0D68D024C184A5D43D46389C591,43761,0,1,1,32,47,1647
48791,48791,7681E0D68D024C184A5D43D46389C591,42921,3,15,12,33,47,1697
48792,48792,7681E0D68D024C184A5D43D46389C591,11861,15,23,8,32,47,1647
48796,48796,829F3CF969A99106A0CF5C6D0ED0FE14,42161,0,8,8,36,47,1847
48797,48797,829F3CF969A99106A0CF5C6D0ED0FE14,11751,9,22,13,35,48,1798
48798,48798,829F3CF969A99106A0CF5C6D0ED0FE14,42401,22,23,1,36,47,1847
48799,48799,7C98BDF484E2B085C51A4945E804FC0C,12491,0,3,3,36,43,1843
48800,48800,7C98BDF484E2B085C51A4945E804FC0C,42151,6,13,7,35,45,1795
48801,48801,7C98BDF484E2B085C51A4945E804FC0C,12491,14,15,1,36,43,1843
48802,48802,7C98BDF484E2B085C51A4945E804FC0C,42151,15,19,4,35,45,1795
48803,48803,7179E8D23C9EF0FE56A034B0F52DF3EB,42623,1,18,17,22,49,1149
48804,48804,7179E8D23C9EF0FE56A034B0F52DF3EB,42081,18,19,1,24,49,1249
48805,48805,7179E8D23C9EF0FE56A034B0F52DF3EB,42623,20,21,1,22,49,1149
48806,48806,ED36A592544F9D3B4DC283835B5C723A,11481,0,5,5,41,48,2098
48807,48807,ED36A592544F9D3B4DC283835B5C723A,40833,5,6,1,41,47,2097
48808,48808,ED36A592544F9D3B4DC283835B5C723A,11481,9,21,12,41,48,2098
48809,48809,ED36A592544F9D3B4DC283835B5C723A,42271,21,23,2,40,47,2047
48810,48810,A486521758A27268CCD3905C2122B6F8,11861,0,1,1,32,47,1647
48811,48811,A486521758A27268CCD3905C2122B6F8,10281,2,7,5,33,48,1698
48812,48812,A486521758A27268CCD3905C2122B6F8,11861,9,22,13,32,47,1647
48833,48833,C70FF977FA3BD2286D57535D98EFE336,10111,0,8,8,37,47,1897
48834,48834,C70FF977FA3BD2286D57535D98EFE336,42161,8,19,11,36,47,1847
48835,48835,C70FF977FA3BD2286D57535D98EFE336,10111,22,23,1,37,47,1897
48839,48839,A922D7161F816C1FD25F52BCCB616DFE,10251,0,10,10,35,47,1797
48840,48840,A922D7161F816C1FD25F52BCCB616DFE,40673,11,13,2,36,48,1848
48841,48841,A922D7161F816C1FD25F52BCCB616DFE,10251,14,22,8,35,47,1797
48842,48842,47844E829FCB05D6E87386BF9A1380C3,13711,3,10,7,38,46,1946
48843,48843,47844E829FCB05D6E87386BF9A1380C3,10781,13,14,1,35,47,1797
48844,48844,47844E829FCB05D6E87386BF9A1380C3,13711,18,23,5,38,46,1946
48845,48845,31CDF80C6F6D99CDF02165EC65D6A959,19441,10,12,2,8,46,446
48846,48846,31CDF80C6F6D99CDF02165EC65D6A959,42041,14,16,2,10,47,547
48847,48847,31CDF80C6F6D99CDF02165EC65D6A959,19441,18,22,4,8,46,446
48851,48851,7D37865B5EB5EEC895DCEBB0B7B7F204,12661,1,14,13,32,45,1645
48852,48852,7D37865B5EB5EEC895DCEBB0B7B7F204,42531,16,17,1,31,45,1595
48853,48853,7D37865B5EB5EEC895DCEBB0B7B7F204,12661,18,20,2,32,45,1645
48854,48854,7D37865B5EB5EEC895DCEBB0B7B7F204,12311,20,22,2,30,44,1544
48867,48867,EA84EDCB7C9475F6273168934FDD6476,19441,0,6,6,8,46,446
48868,48868,EA84EDCB7C9475F6273168934FDD6476,42041,8,11,3,10,47,547
48869,48869,EA84EDCB7C9475F6273168934FDD6476,19441,11,14,3,8,46,446
48870,48870,EA84EDCB7C9475F6273168934FDD6476,42041,18,19,1,10,47,547
48871,48871,1F7E84475EEF681E6A8B47580E5178C1,11161,0,7,7,32,48,1648
48872,48872,1F7E84475EEF681E6A8B47580E5178C1,10781,18,19,1,35,47,1797
48873,48873,1F7E84475EEF681E6A8B47580E5178C1,11161,21,23,2,32,48,1648
48879,48879,001DCCFA6F6583D96864200E111F44CD,40673,0,14,14,36,48,1848
48880,48880,001DCCFA6F6583D96864200E111F44CD,12083,14,16,2,36,49,1849
48881,48881,001DCCFA6F6583D96864200E111F44CD,10107,19,23,4,38,49,1949
48889,48889,F236F547AB02FC158D74DF8F31C9ED3C,10251,1,14,13,35,47,1797
48890,48890,F236F547AB02FC158D74DF8F31C9ED3C,40637,16,19,3,36,47,1847
48891,48891,F236F547AB02FC158D74DF8F31C9ED3C,10251,19,23,4,35,47,1797
48892,48892,3D4D278B3D58167073B4ACCB11432DB2,12671,1,13,12,21,43,1093
48893,48893,3D4D278B3D58167073B4ACCB11432DB2,13094,13,16,3,21,42,1092
48894,48894,3D4D278B3D58167073B4ACCB11432DB2,12671,17,19,2,21,43,1093
48895,48895,3D4D278B3D58167073B4ACCB11432DB2,13091,19,22,3,20,42,1042
48919,48919,D7B4DEFCB86C55D027A1210EEC02063B,11231,0,2,2,37,49,1899
48920,48920,D7B4DEFCB86C55D027A1210EEC02063B,11021,4,19,15,36,49,1849
48921,48921,D7B4DEFCB86C55D027A1210EEC02063B,11231,20,23,3,37,49,1899
48922,48922,B6C01C84BBBC0CC4609A19B67D3EE9B4,40094,0,4,4,29,48,1498
48923,48923,B6C01C84BBBC0CC4609A19B67D3EE9B4,11151,5,6,1,30,48,1548
48924,48924,B6C01C84BBBC0CC4609A19B67D3EE9B4,40094,6,23,17,29,48,1498
48935,48935,37B0B65C03C2EC08D57E1A48EE78889D,42021,3,13,10,33,47,1697
48936,48936,37B0B65C03C2EC08D57E1A48EE78889D,42401,13,18,5,36,47,1847
48937,48937,37B0B65C03C2EC08D57E1A48EE78889D,10111,18,19,1,37,47,1897
48938,48938,37B0B65C03C2EC08D57E1A48EE78889D,42301,19,23,4,36,47,1847
48942,48942,D8B46FFCD15B641FB93B8219A29A7205,40673,0,1,1,36,48,1848
48943,48943,D8B46FFCD15B641FB93B8219A29A7205,42161,2,6,4,36,47,1847
48944,48944,D8B46FFCD15B641FB93B8219A29A7205,40673,6,8,2,36,48,1848
48945,48945,D8B46FFCD15B641FB93B8219A29A7205,10251,8,21,13,35,47,1797
48946,48946,8A51E1903C4D12FB1E8FB98699BED268,49201,0,7,7,7,41,391
48947,48947,8A51E1903C4D12FB1E8FB98699BED268,19901,9,10,1,7,44,394
48948,48948,8A51E1903C4D12FB1E8FB98699BED268,49201,12,23,11,7,41,391
48952,48952,0E4B3B25FE0CAB1DCA768980553C13E7,42791,0,13,13,35,45,1795
48953,48953,0E4B3B25FE0CAB1DCA768980553C13E7,42471,18,19,1,35,49,1799
48954,48954,0E4B3B25FE0CAB1DCA768980553C13E7,42791,21,23,2,35,45,1795
48965,48965,026D9CD2D7AB3D5BF684F04063945AE0,13841,0,10,10,40,46,2046
48966,48966,026D9CD2D7AB3D5BF684F04063945AE0,10771,13,15,2,41,46,2096
48967,48967,026D9CD2D7AB3D5BF684F04063945AE0,42231,20,23,3,37,46,1896
48986,48986,AD3EE3BD5870AF753A3A96B6C340F5E0,11381,2,16,14,30,47,1547
48987,48987,AD3EE3BD5870AF753A3A96B6C340F5E0,10951,17,18,1,29,48,1498
48988,48988,AD3EE3BD5870AF753A3A96B6C340F5E0,11381,22,23,1,30,47,1547
48992,48992,DFD67893B33D33FDAA92DC71D5732DAF,42161,0,13,13,36,47,1847
48993,48993,DFD67893B33D33FDAA92DC71D5732DAF,10111,15,18,3,37,47,1897
48994,48994,DFD67893B33D33FDAA92DC71D5732DAF,42161,19,22,3,36,47,1847
49003,49003,808058724C1A7028D44C5011BD013F09,42401,0,8,8,36,47,1847
49004,49004,808058724C1A7028D44C5011BD013F09,10251,8,11,3,35,47,1797
49005,49005,808058724C1A7028D44C5011BD013F09,10111,11,23,12,37,47,1897
49014,49014,A33DC21DB912CB2F7571EAE4CD987B40,40343,1,2,1,24,49,1249
49015,49015,A33DC21DB912CB2F7571EAE4CD987B40,42121,5,19,14,26,49,1349
49016,49016,A33DC21DB912CB2F7571EAE4CD987B40,40343,21,23,2,24,49,1249
49024,49024,C3D6504B3EB48686671EA89FB93F089E,19931,0,3,3,7,43,393
49025,49025,C3D6504B3EB48686671EA89FB93F089E,12921,7,8,1,9,41,491
49026,49026,C3D6504B3EB48686671EA89FB93F089E,19114,12,23,11,7,43,393
49027,49027,DD11EC5E596BBBC5A00C9F6952DD9EC0,10281,0,11,11,33,48,1698
49028,49028,DD11EC5E596BBBC5A00C9F6952DD9EC0,11351,13,16,3,36,48,1848
49029,49029,DD11EC5E596BBBC5A00C9F6952DD9EC0,10281,18,21,3,33,48,1698
49048,49048,ED417F95DAB52C7D5E659E5FB8F28A50,12051,1,2,1,20,47,1047
49049,49049,ED417F95DAB52C7D5E659E5FB8F28A50,43751,4,6,2,19,48,998
49050,49050,ED417F95DAB52C7D5E659E5FB8F28A50,11641,9,10,1,22,49,1149
49051,49051,ED417F95DAB52C7D5E659E5FB8F28A50,43751,10,21,11,19,48,998
49063,49063,C3385B266A5088A7FA48BCC62DFDD003,43181,4,5,1,39,48,1998
49064,49064,C3385B266A5088A7FA48BCC62DFDD003,11914,5,19,14,37,48,1898
49065,49065,C3385B266A5088A7FA48BCC62DFDD003,40171,20,22,2,38,48,1948
49069,49069,034BF108F7447DC54755E0BD15E86728,42351,0,7,7,38,45,1945
49070,49070,034BF108F7447DC54755E0BD15E86728,11261,7,10,3,36,46,1846
49071,49071,034BF108F7447DC54755E0BD15E86728,42351,11,15,4,38,45,1945
49072,49072,034BF108F7447DC54755E0BD15E86728,11261,16,21,5,36,46,1846
49079,49079,88BD866547E35D038437E393C4A29F25,11261,0,3,3,36,46,1846
49080,49080,88BD866547E35D038437E393C4A29F25,42151,4,17,13,35,45,1795
49081,49081,88BD866547E35D038437E393C4A29F25,11261,22,23,1,36,46,1846
49082,49082,01067BD464140B42D6F1D4D82F8B8EE7,43481,2,3,1,39,48,1998
49083,49083,01067BD464140B42D6F1D4D82F8B8EE7,13381,6,7,1,39,47,1997
49084,49084,01067BD464140B42D6F1D4D82F8B8EE7,43481,8,9,1,39,48,1998
49085,49085,01067BD464140B42D6F1D4D82F8B8EE7,11231,13,18,5,37,49,1899
49091,49091,EE107F15123C6DB132974358298F51B4,11914,3,5,2,37,48,1898
49092,49092,EE107F15123C6DB132974358298F51B4,43181,7,15,8,39,48,1998
49093,49093,EE107F15123C6DB132974358298F51B4,11914,19,23,4,37,48,1898
49116,49116,7D5000772E957DD3A483CE8963A15A13,12121,0,1,1,29,47,1497
49117,49117,7D5000772E957DD3A483CE8963A15A13,11381,2,11,9,30,47,1547
49118,49118,7D5000772E957DD3A483CE8963A15A13,12121,13,19,6,29,47,1497
49119,49119,7D5000772E957DD3A483CE8963A15A13,11381,19,21,2,30,47,1547
49123,49123,449E7811DCD6E8CD500501049B5A906E,13231,1,9,8,39,46,1996
49124,49124,449E7811DCD6E8CD500501049B5A906E,11261,9,12,3,36,46,1846
49125,49125,449E7811DCD6E8CD500501049B5A906E,13911,16,22,6,39,46,1996
49134,49134,9174106625D3239DC850CA622055B684,42301,0,6,6,36,47,1847
49135,49135,9174106625D3239DC850CA622055B684,11331,8,10,2,37,48,1898
49136,49136,9174106625D3239DC850CA622055B684,42301,10,23,13,36,47,1847
49142,49142,458EBC255B183BF22B23CE89879E2CC9,13471,1,11,10,47,49,2399
49143,49143,458EBC255B183BF22B23CE89879E2CC9,42601,14,17,3,44,48,2248
49144,49144,458EBC255B183BF22B23CE89879E2CC9,13471,20,21,1,47,49,2399
49166,49166,DEAED68AE3C073AACA878B29D6C9BBC2,42231,1,18,17,37,46,1896
49167,49167,DEAED68AE3C073AACA878B29D6C9BBC2,42351,19,20,1,38,45,1945
49168,49168,DEAED68AE3C073AACA878B29D6C9BBC2,42231,20,23,3,37,46,1896
49174,49174,FF16D1104349162E539969031BE39A02,43481,0,1,1,39,48,1998
49175,49175,FF16D1104349162E539969031BE39A02,12511,2,12,10,39,47,1997
49176,49176,FF16D1104349162E539969031BE39A02,43481,12,13,1,39,48,1998
49177,49177,FF16D1104349162E539969031BE39A02,12511,15,18,3,39,47,1997
49188,49188,CF7DA1891D00F069E0E0214450037183,11061,0,1,1,29,48,1498
49189,49189,CF7DA1891D00F069E0E0214450037183,11381,1,7,6,30,47,1547
49190,49190,CF7DA1891D00F069E0E0214450037183,11061,12,20,8,29,48,1498
49191,49191,CF7DA1891D00F069E0E0214450037183,11381,22,23,1,30,47,1547
49192,49192,1C752316BF3BA3B641D891EF9B0BCA45,13711,0,14,14,38,46,1946
49193,49193,1C752316BF3BA3B641D891EF9B0BCA45,10271,15,18,3,37,46,1896
49194,49194,1C752316BF3BA3B641D891EF9B0BCA45,13711,20,21,1,38,46,1946
49195,49195,1C752316BF3BA3B641D891EF9B0BCA45,42011,21,23,2,36,46,1846
49203,49203,77DF4FFF07ED187D96784A198A251A61,11861,0,16,16,32,47,1647
49204,49204,77DF4FFF07ED187D96784A198A251A61,10381,16,19,3,31,49,1599
49205,49205,77DF4FFF07ED187D96784A198A251A61,11861,19,22,3,32,47,1647
49206,49206,8D86E284D185DE22084CD86C6BFE1A08,11875,0,13,13,30,46,1546
49207,49207,8D86E284D185DE22084CD86C6BFE1A08,12311,15,18,3,30,44,1544
49208,49208,8D86E284D185DE22084CD86C6BFE1A08,11875,18,23,5,30,46,1546
49222,49222,D42F3D612047952BED7D9F4DD55904E0,42481,0,14,14,22,49,1149
49223,49223,D42F3D612047952BED7D9F4DD55904E0,10451,17,19,2,25,48,1298
49224,49224,D42F3D612047952BED7D9F4DD55904E0,42481,20,21,1,22,49,1149
49225,49225,7B4CE5C29FDE9D686A69DBA50B685421,10841,0,9,9,37,47,1897
49226,49226,7B4CE5C29FDE9D686A69DBA50B685421,10271,9,11,2,37,46,1896
49227,49227,7B4CE5C29FDE9D686A69DBA50B685421,13121,11,12,1,38,46,1946
49228,49228,7B4CE5C29FDE9D686A69DBA50B685421,10841,13,23,10,37,47,1897
49263,49263,F0D3FEBF4CC350A5851C8C36AA32D49C,42401,2,17,15,36,47,1847
49264,49264,F0D3FEBF4CC350A5851C8C36AA32D49C,10111,18,19,1,37,47,1897
49265,49265,F0D3FEBF4CC350A5851C8C36AA32D49C,42401,22,23,1,36,47,1847
49266,49266,9ECA5557B94DDF8D494B58216329A377,11261,2,12,10,36,46,1846
49267,49267,9ECA5557B94DDF8D494B58216329A377,42861,14,17,3,37,44,1894
49268,49268,9ECA5557B94DDF8D494B58216329A377,11261,20,21,1,36,46,1846
49282,49282,06CD0D9A51BF6B03AA66A2A0C792CAB3,10731,0,4,4,33,47,1697
49283,49283,06CD0D9A51BF6B03AA66A2A0C792CAB3,10841,7,8,1,37,47,1897
49284,49284,06CD0D9A51BF6B03AA66A2A0C792CAB3,10731,11,22,11,33,47,1697
49294,49294,CBA3EEB115425BF46575E225F464D168,13941,1,9,8,41,47,2097
49295,49295,CBA3EEB115425BF46575E225F464D168,42321,13,14,1,43,47,2197
49296,49296,CBA3EEB115425BF46575E225F464D168,13941,16,23,7,41,47,2097
49302,49302,446EC6FA87AAECEACF7165EBCE633713,13651,0,1,1,30,47,1547
49303,49303,446EC6FA87AAECEACF7165EBCE633713,42523,2,8,6,31,47,1597
49304,49304,446EC6FA87AAECEACF7165EBCE633713,13651,9,10,1,30,47,1547
49305,49305,446EC6FA87AAECEACF7165EBCE633713,42523,14,23,9,31,47,1597
49315,49315,2DF13F3C6B51FEAFB9527CE1523C2712,13651,3,11,8,30,47,1547
49316,49316,2DF13F3C6B51FEAFB9527CE1523C2712,12121,16,17,1,29,47,1497
49317,49317,2DF13F3C6B51FEAFB9527CE1523C2712,11381,20,22,2,30,47,1547
49324,49324,B7D511FB044C88D5B341BC9FD986DC28,10841,0,12,12,37,47,1897
49325,49325,B7D511FB044C88D5B341BC9FD986DC28,42771,13,14,1,36,47,1847
49326,49326,B7D511FB044C88D5B341BC9FD986DC28,10841,15,17,2,37,47,1897
49327,49327,B7D511FB044C88D5B341BC9FD986DC28,42771,17,19,2,36,47,1847
49335,49335,1F7B3179DF46FBD4BF02920F94E8EEB6,10471,2,13,11,37,48,1898
49336,49336,1F7B3179DF46FBD4BF02920F94E8EEB6,10661,14,17,3,37,49,1899
49337,49337,1F7B3179DF46FBD4BF02920F94E8EEB6,10471,22,23,1,37,48,1898
49338,49338,0BD3FC3DC96663BA0AF558EDBE5EE026,10471,0,8,8,37,48,1898
49339,49339,0BD3FC3DC96663BA0AF558EDBE5EE026,12481,11,13,2,37,49,1899
49340,49340,0BD3FC3DC96663BA0AF558EDBE5EE026,10471,13,23,10,37,48,1898
49341,49341,221907A0B5FBDE67A1B2826B991290F1,11061,1,9,8,29,48,1498
49342,49342,221907A0B5FBDE67A1B2826B991290F1,11381,13,15,2,30,47,1547
49343,49343,221907A0B5FBDE67A1B2826B991290F1,12121,16,19,3,29,47,1497
49344,49344,180AA3F84DC825F9579791300FE98A46,42161,0,17,17,36,47,1847
49345,49345,180AA3F84DC825F9579791300FE98A46,11841,18,20,2,33,46,1696
49346,49346,180AA3F84DC825F9579791300FE98A46,11861,21,23,2,32,47,1647
49360,49360,A8CFBCA9A33C65DE4AB357D9A64460F4,12514,0,4,4,38,47,1947
49361,49361,A8CFBCA9A33C65DE4AB357D9A64460F4,42301,4,6,2,36,47,1847
49362,49362,A8CFBCA9A33C65DE4AB357D9A64460F4,12514,6,14,8,38,47,1947
49363,49363,A8CFBCA9A33C65DE4AB357D9A64460F4,13791,19,20,1,42,47,2147
49364,49364,857C3921F6189FC26243BBC3EB8CEED0,12161,9,10,1,32,46,1646
49365,49365,857C3921F6189FC26243BBC3EB8CEED0,11381,13,15,2,30,47,1547
49366,49366,857C3921F6189FC26243BBC3EB8CEED0,12131,17,18,1,32,47,1647
49367,49367,857C3921F6189FC26243BBC3EB8CEED0,11381,21,23,2,30,47,1547
49372,49372,A7FE8E41915767D2C4848876E9D15FC8,11541,0,14,14,35,49,1799
49373,49373,A7FE8E41915767D2C4848876E9D15FC8,13561,14,15,1,37,49,1899
49374,49374,A7FE8E41915767D2C4848876E9D15FC8,11541,15,23,8,35,49,1799
49380,49380,36B936017BBF0DDAD946C2D46806D07F,42231,0,10,10,37,46,1896
49381,49381,36B936017BBF0DDAD946C2D46806D07F,13121,10,11,1,38,46,1946
49382,49382,36B936017BBF0DDAD946C2D46806D07F,42231,16,17,1,37,46,1896
49383,49383,36B936017BBF0DDAD946C2D46806D07F,13121,17,19,2,38,46,1946
49384,49384,251CF6F7D24D01C5A979C85F40AA6FB8,10251,0,9,9,35,47,1797
49385,49385,251CF6F7D24D01C5A979C85F40AA6FB8,11331,10,11,1,37,48,1898
49386,49386,251CF6F7D24D01C5A979C85F40AA6FB8,42161,12,23,11,36,47,1847
49390,49390,3B4974BCE1FDC807E971BF7260BAE82E,19441,0,3,3,8,46,446
49391,49391,3B4974BCE1FDC807E971BF7260BAE82E,42041,4,5,1,10,47,547
49392,49392,3B4974BCE1FDC807E971BF7260BAE82E,19441,7,18,11,8,46,446
49393,49393,3B4974BCE1FDC807E971BF7260BAE82E,42041,21,23,2,10,47,547
49397,49397,B2012EE6BD195EC80673B0F2B5EC1C5E,12921,0,4,4,9,41,491
49398,49398,B2012EE6BD195EC80673B0F2B5EC1C5E,49201,4,5,1,7,41,391
49399,49399,B2012EE6BD195EC80673B0F2B5EC1C5E,12921,7,19,12,9,41,491
49400,49400,B2012EE6BD195EC80673B0F2B5EC1C5E,12641,19,20,1,10,43,543
49417,49417,C8EB41C6B7152CD714709DA811B3B245,10681,0,14,14,30,48,1548
49418,49418,C8EB41C6B7152CD714709DA811B3B245,40094,14,17,3,29,48,1498
49419,49419,C8EB41C6B7152CD714709DA811B3B245,11151,17,21,4,30,48,1548
49420,49420,D44EDEFE20C6E53FAD2290D9CECCD593,19441,0,5,5,8,46,446
49421,49421,D44EDEFE20C6E53FAD2290D9CECCD593,42041,5,6,1,10,47,547
49422,49422,D44EDEFE20C6E53FAD2290D9CECCD593,19441,10,21,11,8,46,446
49426,49426,583602182C31C8E2D985404EA5592339,12641,4,5,1,10,43,543
49427,49427,583602182C31C8E2D985404EA5592339,12921,7,20,13,9,41,491
49428,49428,583602182C31C8E2D985404EA5592339,19114,22,23,1,7,43,393
49429,49429,EB7EB6074C1F2A07A41462E31EDA6629,42161,0,10,10,36,47,1847
49430,49430,EB7EB6074C1F2A07A41462E31EDA6629,10111,11,17,6,37,47,1897
49431,49431,EB7EB6074C1F2A07A41462E31EDA6629,42161,19,23,4,36,47,1847
49432,49432,96056246DD9856C2DDE7E703B0D16D68,11381,1,15,14,30,47,1547
49433,49433,96056246DD9856C2DDE7E703B0D16D68,42523,15,17,2,31,47,1597
49434,49434,96056246DD9856C2DDE7E703B0D16D68,11381,17,19,2,30,47,1547
49435,49435,96056246DD9856C2DDE7E703B0D16D68,10341,20,23,3,31,47,1597
49446,49446,EA454BA750B94FE328BB9998EA4F4BA4,10971,0,14,14,35,47,1797
49447,49447,EA454BA750B94FE328BB9998EA4F4BA4,42161,19,20,1,36,47,1847
49448,49448,EA454BA750B94FE328BB9998EA4F4BA4,10971,22,23,1,35,47,1797
49462,49462,B36C8579A2DBF718933C4838B2421A42,42511,0,11,11,37,47,1897
49463,49463,B36C8579A2DBF718933C4838B2421A42,13121,11,13,2,38,46,1946
49464,49464,B36C8579A2DBF718933C4838B2421A42,42511,18,20,2,37,47,1897
49468,49468,1A439866C72DC101B5B9389EACAD1E10,10681,0,9,9,30,48,1548
49469,49469,1A439866C72DC101B5B9389EACAD1E10,42501,12,13,1,28,47,1447
49470,49470,1A439866C72DC101B5B9389EACAD1E10,10681,13,23,10,30,48,1548
49471,49471,6956378A253C7395153F3B39EE4EF188,43361,4,18,14,38,48,1948
49472,49472,6956378A253C7395153F3B39EE4EF188,42583,20,21,1,40,48,2048
49473,49473,6956378A253C7395153F3B39EE4EF188,10591,22,23,1,39,48,1998
49488,49488,FE84C5B6FD29AD1D9C75D32BF19FA780,42861,0,10,10,37,44,1894
49489,49489,FE84C5B6FD29AD1D9C75D32BF19FA780,11261,11,13,2,36,46,1846
49490,49490,FE84C5B6FD29AD1D9C75D32BF19FA780,42861,18,19,1,37,44,1894
49491,49491,5E3DAD543888AED453CFEE13BBCB613D,13911,0,7,7,39,46,1996
49492,49492,5E3DAD543888AED453CFEE13BBCB613D,42231,10,20,10,37,46,1896
49493,49493,5E3DAD543888AED453CFEE13BBCB613D,13911,21,22,1,39,46,1996
49503,49503,994BA369046D8B99F80604E02227FCEB,42581,1,11,10,38,48,1948
49504,49504,994BA369046D8B99F80604E02227FCEB,11914,15,18,3,37,48,1898
49505,49505,994BA369046D8B99F80604E02227FCEB,42581,22,23,1,38,48,1948
49514,49514,59D44FF2229AC9C7B96B17F069B2088B,42981,2,11,9,36,49,1849
49515,49515,59D44FF2229AC9C7B96B17F069B2088B,11914,12,13,1,37,48,1898
49516,49516,59D44FF2229AC9C7B96B17F069B2088B,42981,14,17,3,36,49,1849
49517,49517,59D44FF2229AC9C7B96B17F069B2088B,10901,19,20,1,35,48,1798
49518,49518,2FF3CE0DD1F763BE6C529146FEEF0C11,42301,0,7,7,36,47,1847
49519,49519,2FF3CE0DD1F763BE6C529146FEEF0C11,42941,8,9,1,37,47,1897
49520,49520,2FF3CE0DD1F763BE6C529146FEEF0C11,42301,10,23,13,36,47,1847
49536,49536,D454F61AD8B5A1CBE1E15CE597E2F528,42301,0,6,6,36,47,1847
49537,49537,D454F61AD8B5A1CBE1E15CE597E2F528,11231,8,18,10,37,49,1899
49538,49538,D454F61AD8B5A1CBE1E15CE597E2F528,42511,18,23,5,37,47,1897
49539,49539,D8DDB7680275E0BD85AEE2B6F249AE80,11541,0,16,16,35,49,1799
49540,49540,D8DDB7680275E0BD85AEE2B6F249AE80,10221,17,20,3,34,49,1749
49541,49541,D8DDB7680275E0BD85AEE2B6F249AE80,11541,21,23,2,35,49,1799
49542,49542,05B51695B375DD3A2259BF2668AD8716,42161,0,5,5,36,47,1847
49543,49543,05B51695B375DD3A2259BF2668AD8716,11074,8,9,1,37,47,1897
49544,49544,05B51695B375DD3A2259BF2668AD8716,42161,12,22,10,36,47,1847
49551,49551,B20D4CCCBBF9B534BB9F26A35B371E4C,11941,0,6,6,37,46,1896
49552,49552,B20D4CCCBBF9B534BB9F26A35B371E4C,13911,8,11,3,39,46,1996
49553,49553,B20D4CCCBBF9B534BB9F26A35B371E4C,42351,11,15,4,38,45,1945
49554,49554,B20D4CCCBBF9B534BB9F26A35B371E4C,11941,19,21,2,37,46,1896
49555,49555,51CA45CA2AACCC83748D6918E9F511C1,12661,0,7,7,32,45,1645
49556,49556,51CA45CA2AACCC83748D6918E9F511C1,42151,7,18,11,35,45,1795
49557,49557,51CA45CA2AACCC83748D6918E9F511C1,12661,19,20,1,32,45,1645
49558,49558,532174BB6C7E593BB5F059675D341CD9,12641,0,14,14,10,43,543
49559,49559,532174BB6C7E593BB5F059675D341CD9,19901,16,17,1,7,44,394
49560,49560,532174BB6C7E593BB5F059675D341CD9,12641,21,23,2,10,43,543
49561,49561,4C8E92DBB85921608C1C92929A7A8C92,42521,0,14,14,31,47,1597
49562,49562,4C8E92DBB85921608C1C92929A7A8C92,13651,15,17,2,30,47,1547
49563,49563,4C8E92DBB85921608C1C92929A7A8C92,42521,20,22,2,31,47,1597
49564,49564,2B40102221C7241E8489A9F070B481CB,11861,0,2,2,32,47,1647
49565,49565,2B40102221C7241E8489A9F070B481CB,42921,3,11,8,33,47,1697
49566,49566,2B40102221C7241E8489A9F070B481CB,10281,15,18,3,33,48,1698
49567,49567,2B40102221C7241E8489A9F070B481CB,43761,19,23,4,32,47,1647
49582,49582,43546E76BF61B1B2FB513612B75D05EB,42321,0,3,3,43,47,2197
49583,49583,43546E76BF61B1B2FB513612B75D05EB,11806,4,15,11,41,48,2098
49584,49584,43546E76BF61B1B2FB513612B75D05EB,13101,17,18,1,40,47,2047
49585,49585,43546E76BF61B1B2FB513612B75D05EB,11806,21,23,2,41,48,2098
49586,49586,9ED625402B3991AE30ACC095EEDE57BB,42111,3,9,6,44,46,2246
49587,49587,9ED625402B3991AE30ACC095EEDE57BB,42461,9,18,9,45,47,2297
49588,49588,9ED625402B3991AE30ACC095EEDE57BB,42111,19,20,1,44,46,2246
49589,49589,9ED625402B3991AE30ACC095EEDE57BB,42461,20,22,2,45,47,2297
49600,49600,2E539AC6B5EE453A303FF282CE24EA33,19931,0,6,6,7,43,393
49601,49601,2E539AC6B5EE453A303FF282CE24EA33,12921,7,8,1,9,41,491
49602,49602,2E539AC6B5EE453A303FF282CE24EA33,19931,12,23,11,7,43,393
49603,49603,5DFF6366B43BB94F1691F2243A8F8344,19441,2,10,8,8,46,446
49604,49604,5DFF6366B43BB94F1691F2243A8F8344,42041,12,13,1,10,47,547
49605,49605,5DFF6366B43BB94F1691F2243A8F8344,19441,18,23,5,8,46,446
49609,49609,CC63EA7467D4A1FC7EF1BC76C9DAF092,11261,0,1,1,36,46,1846
49610,49610,CC63EA7467D4A1FC7EF1BC76C9DAF092,42864,2,5,3,38,44,1944
49611,49611,CC63EA7467D4A1FC7EF1BC76C9DAF092,11261,6,20,14,36,46,1846
49620,49620,79F70A1AE08CEE215DA71360DE1B25EA,11811,0,6,6,38,49,1949
49621,49621,79F70A1AE08CEE215DA71360DE1B25EA,42231,6,20,14,37,46,1896
49622,49622,79F70A1AE08CEE215DA71360DE1B25EA,42191,20,23,3,38,49,1949
49623,49623,D429753EEB35077FBB0F7FD7B24671DA,42381,0,6,6,39,41,1991
49624,49624,D429753EEB35077FBB0F7FD7B24671DA,43451,6,17,11,37,40,1890
49625,49625,D429753EEB35077FBB0F7FD7B24671DA,42381,22,23,1,39,41,1991
49626,49626,5134C03EB3276C610A7AB253ED006E01,42981,1,8,7,36,49,1849
49627,49627,5134C03EB3276C610A7AB253ED006E01,11331,14,16,2,37,48,1898
49628,49628,5134C03EB3276C610A7AB253ED006E01,42981,18,23,5,36,49,1849
49629,49629,3CA59C7696A3F1D3B3B3AC13E43E394F,13711,1,7,6,38,46,1946
49630,49630,3CA59C7696A3F1D3B3B3AC13E43E394F,11941,10,21,11,37,46,1896
49631,49631,3CA59C7696A3F1D3B3B3AC13E43E394F,13711,22,23,1,38,46,1946
49648,49648,F04EE7F7E05AB27B1A8EDA5AA08E2E0B,10271,7,9,2,37,46,1896
49649,49649,F04EE7F7E05AB27B1A8EDA5AA08E2E0B,11231,12,16,4,37,49,1899
49650,49650,F04EE7F7E05AB27B1A8EDA5AA08E2E0B,13121,17,19,2,38,46,1946
49651,49651,F04EE7F7E05AB27B1A8EDA5AA08E2E0B,10271,19,22,3,37,46,1896
49665,49665,05286C4B5017A260B39768783F7D4555,42581,0,13,13,38,48,1948
49666,49666,05286C4B5017A260B39768783F7D4555,10471,16,18,2,37,48,1898
49667,49667,05286C4B5017A260B39768783F7D4555,42581,21,22,1,38,48,1948
49676,49676,D2007E56CDD263F500CAE75A804D6B50,42871,0,6,6,30,45,1545
49677,49677,D2007E56CDD263F500CAE75A804D6B50,11324,8,12,4,31,46,1596
49678,49678,D2007E56CDD263F500CAE75A804D6B50,42871,13,21,8,30,45,1545
49679,49679,22E0CD429C1B1E7AC6170F90C318BE33,40833,0,5,5,41,47,2097
49680,49680,22E0CD429C1B1E7AC6170F90C318BE33,10421,14,17,3,41,48,2098
49681,49681,22E0CD429C1B1E7AC6170F90C318BE33,40833,19,23,4,41,47,2097
49682,49682,EE8535EFC0E3237FE1E9870ACB3D38E1,43621,6,8,2,46,48,2348
49683,49683,EE8535EFC0E3237FE1E9870ACB3D38E1,42321,8,11,3,43,47,2197
49684,49684,EE8535EFC0E3237FE1E9870ACB3D38E1,43621,14,18,4,46,48,2348
49685,49685,EE8535EFC0E3237FE1E9870ACB3D38E1,42321,19,23,4,43,47,2197
49686,49686,4A7EF801268FA87DD49AA705DCA560E1,42581,0,8,8,38,48,1948
49687,49687,4A7EF801268FA87DD49AA705DCA560E1,11914,11,13,2,37,48,1898
49688,49688,4A7EF801268FA87DD49AA705DCA560E1,42581,14,16,2,38,48,1948
49689,49689,4A7EF801268FA87DD49AA705DCA560E1,11914,16,18,2,37,48,1898
49690,49690,58FF60972C1637520443DC5766A2AB67,13411,0,5,5,49,42,2492
49691,49691,58FF60972C1637520443DC5766A2AB67,43951,6,18,12,49,41,2491
49692,49692,58FF60972C1637520443DC5766A2AB67,13411,18,22,4,49,42,2492
49693,49693,D3F6CC79419CB8E677F2F17C3DF072CD,42331,7,8,1,39,46,1996
49694,49694,D3F6CC79419CB8E677F2F17C3DF072CD,11941,13,17,4,37,46,1896
49695,49695,D3F6CC79419CB8E677F2F17C3DF072CD,10911,18,20,2,39,46,1996
49696,49696,D3F6CC79419CB8E677F2F17C3DF072CD,13121,20,23,3,38,46,1946
49700,49700,8D4B76C00151174BC318A19D72794912,42531,9,11,2,31,45,1595
49701,49701,8D4B76C00151174BC318A19D72794912,12661,11,13,2,32,45,1645
49702,49702,8D4B76C00151174BC318A19D72794912,42871,16,17,1,30,45,1545
49703,49703,8D4B76C00151174BC318A19D72794912,12661,19,21,2,32,45,1645
49708,49708,8E1DB9D4ECEC1F108A151A8D21BA1A04,42231,0,15,15,37,46,1896
49709,49709,8E1DB9D4ECEC1F108A151A8D21BA1A04,13911,16,17,1,39,46,1996
49710,49710,8E1DB9D4ECEC1F108A151A8D21BA1A04,42231,18,23,5,37,46,1896
49711,49711,22DF08AB8625FB5CE36A655BC50A3649,40271,0,10,10,35,49,1799
49712,49712,22DF08AB8625FB5CE36A655BC50A3649,11021,15,19,4,36,49,1849
49713,49713,22DF08AB8625FB5CE36A655BC50A3649,11794,20,22,2,38,49,1949
49714,49714,A573FF285872EC96818445928AD4461A,11281,0,1,1,27,40,1390
49715,49715,A573FF285872EC96818445928AD4461A,13671,2,9,7,27,43,1393
49716,49716,A573FF285872EC96818445928AD4461A,11281,13,14,1,27,40,1390
49717,49717,A573FF285872EC96818445928AD4461A,13671,15,21,6,27,43,1393
49731,49731,057935907C2B481CA4E4D08E6E9B9029,10531,0,9,9,34,46,1746
49732,49732,057935907C2B481CA4E4D08E6E9B9029,11201,14,16,2,35,49,1799
49733,49733,057935907C2B481CA4E4D08E6E9B9029,10531,18,23,5,34,46,1746
49734,49734,73C431267E9D15126DD630F092950C8C,42111,0,3,3,44,46,2246
49735,49735,73C431267E9D15126DD630F092950C8C,42461,7,16,9,45,47,2297
49736,49736,73C431267E9D15126DD630F092950C8C,42111,19,22,3,44,46,2246
49747,49747,43584BBDE312EB588DC6CED59E529573,10921,3,7,4,43,48,2198
49748,49748,43584BBDE312EB588DC6CED59E529573,13941,7,9,2,41,47,2097
49749,49749,43584BBDE312EB588DC6CED59E529573,10921,10,22,12,43,48,2198
49768,49768,549B8A34E419FBD57213E9641A5E14A7,11061,0,7,7,29,48,1498
49769,49769,549B8A34E419FBD57213E9641A5E14A7,10681,11,20,9,30,48,1548
49770,49770,549B8A34E419FBD57213E9641A5E14A7,11061,21,23,2,29,48,1498
49771,49771,41A6C8E34EA0693C5F034A18C8C1F295,10421,0,8,8,41,48,2098
49772,49772,41A6C8E34EA0693C5F034A18C8C1F295,40691,13,14,1,42,48,2148
49773,49773,41A6C8E34EA0693C5F034A18C8C1F295,10421,15,18,3,41,48,2098
49774,49774,41A6C8E34EA0693C5F034A18C8C1F295,11701,22,23,1,43,48,2198
49780,49780,DEF0EFC34A012D2C5BCF4C0A7A8572D9,11161,0,10,10,32,48,1648
49781,49781,DEF0EFC34A012D2C5BCF4C0A7A8572D9,42141,11,20,9,32,47,1647
49782,49782,DEF0EFC34A012D2C5BCF4C0A7A8572D9,11161,21,23,2,32,48,1648
49793,49793,07C511897AFB92061FA4CF9BC4771D74,13711,0,2,2,38,46,1946
49794,49794,07C511897AFB92061FA4CF9BC4771D74,10231,2,3,1,39,49,1999
49795,49795,07C511897AFB92061FA4CF9BC4771D74,10811,4,15,11,38,46,1946
49796,49796,07C511897AFB92061FA4CF9BC4771D74,10107,15,19,4,38,49,1949
49797,49797,31C7D6EBBE109EA14915A4B3065924CF,42601,0,13,13,44,48,2248
49798,49798,31C7D6EBBE109EA14915A4B3065924CF,43621,14,15,1,46,48,2348
49799,49799,31C7D6EBBE109EA14915A4B3065924CF,42601,17,23,6,44,48,2248
49804,49804,DE7FC178F713ED896B713C6ED0D06066,42871,0,5,5,30,45,1545
49805,49805,DE7FC178F713ED896B713C6ED0D06066,12311,6,8,2,30,44,1544
49806,49806,DE7FC178F713ED896B713C6ED0D06066,42871,10,23,13,30,45,1545
49807,49807,55AB1B83138C13AA6E73E5A0A4A6FB86,10471,0,8,8,37,48,1898
49808,49808,55AB1B83138C13AA6E73E5A0A4A6FB86,12481,11,13,2,37,49,1899
49809,49809,55AB1B83138C13AA6E73E5A0A4A6FB86,10471,13,23,10,37,48,1898
49810,49810,FCF6425DA3F542476DF1F93935C075D8,42581,2,19,17,38,48,1948
49811,49811,FCF6425DA3F542476DF1F93935C075D8,11914,19,20,1,37,48,1898
49812,49812,FCF6425DA3F542476DF1F93935C075D8,42581,22,23,1,38,48,1948
49835,49835,3544B9900CDDC16C4606729762F4FE67,11151,8,9,1,30,48,1548
49836,49836,3544B9900CDDC16C4606729762F4FE67,11061,10,12,2,29,48,1498
49837,49837,3544B9900CDDC16C4606729762F4FE67,11151,15,21,6,30,48,1548
49838,49838,03C0426D798D28FFFD9A991613F3D23A,13651,2,7,5,30,47,1547
49839,49839,03C0426D798D28FFFD9A991613F3D23A,11861,10,19,9,32,47,1647
49840,49840,03C0426D798D28FFFD9A991613F3D23A,10295,20,21,1,30,47,1547
49846,49846,B0CA59461CE535DA6C80DC6682EBEAFB,42271,0,6,6,40,47,2047
49847,49847,B0CA59461CE535DA6C80DC6682EBEAFB,11291,8,13,5,40,49,2049
49848,49848,B0CA59461CE535DA6C80DC6682EBEAFB,42271,17,19,2,40,47,2047
49849,49849,27289575C2D71F6A39E74F86EA523847,12731,4,11,7,22,40,1140
49850,49850,27289575C2D71F6A39E74F86EA523847,13094,11,12,1,21,42,1092
49851,49851,27289575C2D71F6A39E74F86EA523847,12731,14,18,4,22,40,1140
49852,49852,49C79AB3305EA0BDD0BE79CDFA7582CD,11074,9,11,2,37,47,1897
49853,49853,49C79AB3305EA0BDD0BE79CDFA7582CD,42221,11,13,2,38,48,1948
49854,49854,49C79AB3305EA0BDD0BE79CDFA7582CD,11074,14,20,6,37,47,1897
49863,49863,67EEF12624F5A3B71954681C5774CEB1,42331,0,8,8,39,46,1996
49864,49864,67EEF12624F5A3B71954681C5774CEB1,42221,9,17,8,38,48,1948
49865,49865,67EEF12624F5A3B71954681C5774CEB1,13681,17,19,2,38,47,1947
49886,49886,66BFEA069F1D513607C207FE0BA6E568,11161,0,10,10,32,48,1648
49887,49887,66BFEA069F1D513607C207FE0BA6E568,40661,11,13,2,33,48,1698
49888,49888,66BFEA069F1D513607C207FE0BA6E568,43311,21,23,2,31,48,1598
49889,49889,278E052036B3D515D9E893B8DA72FDF8,11031,0,8,8,42,49,2149
49890,49890,278E052036B3D515D9E893B8DA72FDF8,13371,9,17,8,41,47,2097
49891,49891,278E052036B3D515D9E893B8DA72FDF8,11741,19,21,2,42,49,2149
49895,49895,13E7DB2A8792678EF526CBD80A3FC081,11261,9,15,6,36,46,1846
49896,49896,13E7DB2A8792678EF526CBD80A3FC081,42864,16,18,2,38,44,1944
49897,49897,13E7DB2A8792678EF526CBD80A3FC081,11261,20,21,1,36,46,1846
49898,49898,77EA23FEBF1AF98A4F6293E826F27BD4,42271,7,8,1,40,47,2047
49899,49899,77EA23FEBF1AF98A4F6293E826F27BD4,11806,8,9,1,41,48,2098
49900,49900,77EA23FEBF1AF98A4F6293E826F27BD4,10601,11,20,9,39,47,1997
49901,49901,7F73A642AA11134206C46BA15C785E40,10295,0,7,7,30,47,1547
49902,49902,7F73A642AA11134206C46BA15C785E40,42521,8,12,4,31,47,1597
49903,49903,7F73A642AA11134206C46BA15C785E40,10292,12,18,6,30,47,1547
49904,49904,7F73A642AA11134206C46BA15C785E40,42521,20,23,3,31,47,1597
49923,49923,A8FE6CFECD0860615708930D316AC04E,12511,7,12,5,39,47,1997
49924,49924,A8FE6CFECD0860615708930D316AC04E,11074,14,15,1,37,47,1897
49925,49925,A8FE6CFECD0860615708930D316AC04E,12511,18,20,2,39,47,1997
49929,49929,FC707C73D6614611D82A13C2F325D332,11074,2,14,12,37,47,1897
49930,49930,FC707C73D6614611D82A13C2F325D332,11021,15,20,5,36,49,1849
49931,49931,FC707C73D6614611D82A13C2F325D332,11074,21,22,1,37,47,1897
49936,49936,51E8861068F901C8E015AE95E3FE760A,42231,0,5,5,37,46,1896
49937,49937,51E8861068F901C8E015AE95E3FE760A,13711,6,9,3,38,46,1946
49938,49938,51E8861068F901C8E015AE95E3FE760A,42231,10,23,13,37,46,1896
49939,49939,5ED8949BAC5CDF05EDA1019FB7CA4B17,11811,0,7,7,38,49,1949
49940,49940,5ED8949BAC5CDF05EDA1019FB7CA4B17,10471,9,14,5,37,48,1898
49941,49941,5ED8949BAC5CDF05EDA1019FB7CA4B17,42191,15,20,5,38,49,1949
49942,49942,5ED8949BAC5CDF05EDA1019FB7CA4B17,40171,21,23,2,38,48,1948
49961,49961,61D4369B95803102112EEFE32BD36465,11161,0,1,1,32,48,1648
49962,49962,61D4369B95803102112EEFE32BD36465,10295,4,5,1,30,47,1547
49963,49963,61D4369B95803102112EEFE32BD36465,43761,5,22,17,32,47,1647
49964,49964,76C1AD58514D4D9A45E0EEB9F2C75470,12561,0,7,7,45,43,2293
49965,49965,76C1AD58514D4D9A45E0EEB9F2C75470,42631,9,10,1,43,45,2195
49966,49966,76C1AD58514D4D9A45E0EEB9F2C75470,12561,10,19,9,45,43,2293
49985,49985,55536669E97AF41ACDE427113BB85731,10691,0,6,6,33,48,1698
49986,49986,55536669E97AF41ACDE427113BB85731,11861,7,9,2,32,47,1647
49987,49987,55536669E97AF41ACDE427113BB85731,42021,9,10,1,33,47,1697
49988,49988,55536669E97AF41ACDE427113BB85731,10691,12,23,11,33,48,1698
49989,49989,53493041487B5321836147FAAD536213,40833,5,13,8,41,47,2097
49990,49990,53493041487B5321836147FAAD536213,13101,13,17,4,40,47,2047
49991,49991,53493041487B5321836147FAAD536213,11481,18,20,2,41,48,2098
49992,49992,53493041487B5321836147FAAD536213,13101,20,22,2,40,47,2047
50002,50002,65F728ACB010BFAB42CA8AF85ABE5116,12491,1,13,12,36,43,1843
50003,50003,65F728ACB010BFAB42CA8AF85ABE5116,42151,17,18,1,35,45,1795
50004,50004,65F728ACB010BFAB42CA8AF85ABE5116,12491,19,21,2,36,43,1843
50005,50005,28C900416D6AF4E146D9298312A567F1,10107,10,13,3,38,49,1949
50006,50006,28C900416D6AF4E146D9298312A567F1,10411,13,15,2,36,48,1848
50007,50007,28C900416D6AF4E146D9298312A567F1,13561,16,20,4,37,49,1899
50016,50016,4ACD9CEDD58F292A9193AED63019558C,10801,1,8,7,42,47,2147
50017,50017,4ACD9CEDD58F292A9193AED63019558C,13941,8,9,1,41,47,2097
50018,50018,4ACD9CEDD58F292A9193AED63019558C,11001,13,17,4,42,47,2147
50019,50019,4ACD9CEDD58F292A9193AED63019558C,13371,18,23,5,41,47,2097
50020,50020,C644771D2D9F4182BC18DB70E907DF2B,42581,1,14,13,38,48,1948
50021,50021,C644771D2D9F4182BC18DB70E907DF2B,11914,15,18,3,37,48,1898
50022,50022,C644771D2D9F4182BC18DB70E907DF2B,42581,20,23,3,38,48,1948
50041,50041,E880DD3703242558096D10770FE10A54,42861,0,6,6,37,44,1894
50042,50042,E880DD3703242558096D10770FE10A54,11261,11,12,1,36,46,1846
50043,50043,E880DD3703242558096D10770FE10A54,42861,16,18,2,37,44,1894
50050,50050,B7117683EA831A9FE9BD60D82D9F84F9,42461,0,7,7,45,47,2297
50051,50051,B7117683EA831A9FE9BD60D82D9F84F9,42201,12,14,2,43,46,2196
50052,50052,B7117683EA831A9FE9BD60D82D9F84F9,42461,17,19,2,45,47,2297
50060,50060,86877F32D6D32D1728C272FD8E7855F4,42141,0,11,11,32,47,1647
50061,50061,86877F32D6D32D1728C272FD8E7855F4,42021,14,18,4,33,47,1697
50062,50062,86877F32D6D32D1728C272FD8E7855F4,11861,20,21,1,32,47,1647
50066,50066,FA2D28010932A69EC54A9BD3610B89DB,10471,0,8,8,37,48,1898
50067,50067,FA2D28010932A69EC54A9BD3610B89DB,12481,12,13,1,37,49,1899
50068,50068,FA2D28010932A69EC54A9BD3610B89DB,10471,13,23,10,37,48,1898
50072,50072,6274E9CC7D59011B35AFD50F03FD1063,11806,10,11,1,41,48,2098
50073,50073,6274E9CC7D59011B35AFD50F03FD1063,42271,12,13,1,40,47,2047
50074,50074,6274E9CC7D59011B35AFD50F03FD1063,11806,16,18,2,41,48,2098
50080,50080,5487427E39C73D6D38EF674DFDFC2E03,11861,0,9,9,32,47,1647
50081,50081,5487427E39C73D6D38EF674DFDFC2E03,10491,15,16,1,33,48,1698
50082,50082,5487427E39C73D6D38EF674DFDFC2E03,11861,16,23,7,32,47,1647
50083,50083,E253B2B9512D99ED8C10EBC79E0769EF,12601,0,11,11,25,47,1297
50084,50084,E253B2B9512D99ED8C10EBC79E0769EF,10501,15,16,1,22,46,1146
50085,50085,E253B2B9512D99ED8C10EBC79E0769EF,12601,21,23,2,25,47,1297
50086,50086,6A374E00137D245879D87467BBBF649C,12311,10,12,2,30,44,1544
50087,50087,6A374E00137D245879D87467BBBF649C,42871,15,17,2,30,45,1545
50088,50088,6A374E00137D245879D87467BBBF649C,12311,18,19,1,30,44,1544
50089,50089,6A374E00137D245879D87467BBBF649C,12661,22,23,1,32,45,1645
50090,50090,2DE22AB0B6F9EDBA14CA1FCBE64062BC,10681,0,14,14,30,48,1548
50091,50091,2DE22AB0B6F9EDBA14CA1FCBE64062BC,13511,15,17,2,34,48,1748
50092,50092,2DE22AB0B6F9EDBA14CA1FCBE64062BC,10681,19,21,2,30,48,1548
50093,50093,2DE22AB0B6F9EDBA14CA1FCBE64062BC,13511,22,23,1,34,48,1748
50099,50099,1034E32537CD89A54195B02D13F8F6C7,42581,0,9,9,38,48,1948
50100,50100,1034E32537CD89A54195B02D13F8F6C7,11914,10,11,1,37,48,1898
50101,50101,1034E32537CD89A54195B02D13F8F6C7,42581,12,22,10,38,48,1948
50102,50102,E19B6362BDAAF6A6C06421D843903CE3,43731,9,14,5,34,47,1747
50103,50103,E19B6362BDAAF6A6C06421D843903CE3,13511,14,15,1,34,48,1748
50104,50104,E19B6362BDAAF6A6C06421D843903CE3,43731,16,23,7,34,47,1747
50105,50105,51A9FC1A3DFEB953E9CFA40FC77B0AC2,11921,1,6,5,38,48,1948
50106,50106,51A9FC1A3DFEB953E9CFA40FC77B0AC2,42941,7,19,12,37,47,1897
50107,50107,51A9FC1A3DFEB953E9CFA40FC77B0AC2,42301,21,22,1,36,47,1847
50115,50115,9A5138FE50A5516A3590C769AAB53571,10621,3,7,4,41,49,2099
50116,50116,9A5138FE50A5516A3590C769AAB53571,40302,7,17,10,40,49,2049
50117,50117,9A5138FE50A5516A3590C769AAB53571,10191,20,21,1,40,48,2048
50118,50118,9A5138FE50A5516A3590C769AAB53571,42341,22,23,1,43,49,2199
50123,50123,88D3AECB79C42D19C5311DB0C1B36772,42301,0,5,5,36,47,1847
50124,50124,88D3AECB79C42D19C5311DB0C1B36772,10271,6,7,1,37,46,1896
50125,50125,88D3AECB79C42D19C5311DB0C1B36772,42301,11,14,3,36,47,1847
50126,50126,88D3AECB79C42D19C5311DB0C1B36772,10271,15,21,6,37,46,1896
50133,50133,67BCB76F611F63115F44CBB7619B7D68,43161,0,12,12,35,47,1797
50134,50134,67BCB76F611F63115F44CBB7619B7D68,42161,13,16,3,36,47,1847
50135,50135,67BCB76F611F63115F44CBB7619B7D68,43161,17,19,2,35,47,1797
50136,50136,67BCB76F611F63115F44CBB7619B7D68,42161,19,23,4,36,47,1847
50137,50137,30C49EE7A31FEEE7EEC894E81C72E143,11731,0,5,5,36,48,1848
50138,50138,30C49EE7A31FEEE7EEC894E81C72E143,42581,7,10,3,38,48,1948
50139,50139,30C49EE7A31FEEE7EEC894E81C72E143,11914,10,12,2,37,48,1898
50140,50140,30C49EE7A31FEEE7EEC894E81C72E143,42581,15,23,8,38,48,1948
50150,50150,62CA9C2DB4CCD42E20C60BB9A4960A48,11861,0,10,10,32,47,1647
50151,50151,62CA9C2DB4CCD42E20C60BB9A4960A48,42021,12,13,1,33,47,1697
50152,50152,62CA9C2DB4CCD42E20C60BB9A4960A48,11861,17,23,6,32,47,1647
50153,50153,A10AD66CE81CDFBC974C36FAC5FE4CAA,42531,0,8,8,31,45,1595
50154,50154,A10AD66CE81CDFBC974C36FAC5FE4CAA,10351,9,10,1,28,45,1445
50155,50155,A10AD66CE81CDFBC974C36FAC5FE4CAA,11834,12,13,1,32,45,1645
50156,50156,A10AD66CE81CDFBC974C36FAC5FE4CAA,42531,14,21,7,31,45,1595
50157,50157,9AF6F4C6C4937C91C918EC9853CABA28,42861,0,6,6,37,44,1894
50158,50158,9AF6F4C6C4937C91C918EC9853CABA28,11261,6,10,4,36,46,1846
50159,50159,9AF6F4C6C4937C91C918EC9853CABA28,42861,11,13,2,37,44,1894
50160,50160,9AF6F4C6C4937C91C918EC9853CABA28,11261,16,18,2,36,46,1846
50161,50161,93C87ADE4FBD02048670A9DCD4C6ECEA,42864,0,5,5,38,44,1944
50162,50162,93C87ADE4FBD02048670A9DCD4C6ECEA,42861,8,10,2,37,44,1894
50163,50163,93C87ADE4FBD02048670A9DCD4C6ECEA,11261,12,23,11,36,46,1846
50164,50164,47C1473BA4462B22BD05E79B53CFA190,19441,3,14,11,8,46,446
50165,50165,47C1473BA4462B22BD05E79B53CFA190,42041,14,17,3,10,47,547
50166,50166,47C1473BA4462B22BD05E79B53CFA190,19441,21,22,1,8,46,446
50177,50177,591ECB3527B6C2BDC258BE3B79DCC125,42271,9,12,3,40,47,2047
50178,50178,591ECB3527B6C2BDC258BE3B79DCC125,10591,12,14,2,39,48,1998
50179,50179,591ECB3527B6C2BDC258BE3B79DCC125,12514,14,23,9,38,47,1947
50185,50185,E6AC57452A564977FA8F4CD52CD9B295,10281,0,11,11,33,48,1698
50186,50186,E6AC57452A564977FA8F4CD52CD9B295,11201,14,17,3,35,49,1799
50187,50187,E6AC57452A564977FA8F4CD52CD9B295,10281,19,23,4,33,48,1698
50188,50188,99E7A69682ADA3DC350489A1187F33F9,10281,1,7,6,33,48,1698
50189,50189,99E7A69682ADA3DC350489A1187F33F9,11861,8,19,11,32,47,1647
50190,50190,99E7A69682ADA3DC350489A1187F33F9,10281,20,21,1,33,48,1698
50191,50191,99E7A69682ADA3DC350489A1187F33F9,42141,22,23,1,32,47,1647
50199,50199,FFC82A5377A1B8878F0174F77D838706,13121,0,1,1,38,46,1946
50200,50200,FFC82A5377A1B8878F0174F77D838706,43361,12,13,1,38,48,1948
50201,50201,FFC82A5377A1B8878F0174F77D838706,42941,22,23,1,37,47,1897
50217,50217,FAA2A83085DED75B2B76B1A263011697,11061,2,9,7,29,48,1498
50218,50218,FAA2A83085DED75B2B76B1A263011697,11381,13,18,5,30,47,1547
50219,50219,FAA2A83085DED75B2B76B1A263011697,11061,20,21,1,29,48,1498
50227,50227,0C01415A0EFA6231B4B08FFD94123F97,10471,0,8,8,37,48,1898
50228,50228,0C01415A0EFA6231B4B08FFD94123F97,12481,12,13,1,37,49,1899
50229,50229,0C01415A0EFA6231B4B08FFD94123F97,10471,13,22,9,37,48,1898
50240,50240,D0D54F11AE6E916A7FB4D7681D5BE6D5,19441,0,1,1,8,46,446
50241,50241,D0D54F11AE6E916A7FB4D7681D5BE6D5,19821,2,14,12,4,46,246
50242,50242,D0D54F11AE6E916A7FB4D7681D5BE6D5,19441,19,21,2,8,46,446
50250,50250,2F1F7798F5E8889B4080CA59D71F0274,10271,6,14,8,37,46,1896
50251,50251,2F1F7798F5E8889B4080CA59D71F0274,13711,14,18,4,38,46,1946
50252,50252,2F1F7798F5E8889B4080CA59D71F0274,10271,19,23,4,37,46,1896
50253,50253,D1B134FECA3DB6C7BE84FCB03A2CF8F7,10661,0,9,9,37,49,1899
50254,50254,D1B134FECA3DB6C7BE84FCB03A2CF8F7,10431,10,11,1,33,49,1699
50255,50255,D1B134FECA3DB6C7BE84FCB03A2CF8F7,40171,12,13,1,38,48,1948
50256,50256,D1B134FECA3DB6C7BE84FCB03A2CF8F7,10661,17,23,6,37,49,1899
50260,50260,FE72309A49FBEB6B76C0E42028E74707,42041,0,3,3,10,47,547
50261,50261,FE72309A49FBEB6B76C0E42028E74707,19441,7,12,5,8,46,446
50262,50262,FE72309A49FBEB6B76C0E42028E74707,42041,14,21,7,10,47,547
50263,50263,20A7975366758E3C48A8CB4E3CD0626C,42121,5,7,2,26,49,1349
50264,50264,20A7975366758E3C48A8CB4E3CD0626C,40343,8,15,7,24,49,1249
50265,50265,20A7975366758E3C48A8CB4E3CD0626C,42121,15,19,4,26,49,1349
50266,50266,73118727834AEF72D14D5BE83EC91BD1,13941,1,6,5,41,47,2097
50267,50267,73118727834AEF72D14D5BE83EC91BD1,11074,8,15,7,37,47,1897
50268,50268,73118727834AEF72D14D5BE83EC91BD1,11001,19,20,1,42,47,2147
50269,50269,B92E89796812211C5B5F4FA9439F7E3F,11061,7,17,10,29,48,1498
50270,50270,B92E89796812211C5B5F4FA9439F7E3F,43971,17,18,1,30,48,1548
50271,50271,B92E89796812211C5B5F4FA9439F7E3F,11061,20,21,1,29,48,1498
50272,50272,600D7AE0D829582E691D7BDBD387E918,19441,5,7,2,8,46,446
50273,50273,600D7AE0D829582E691D7BDBD387E918,42041,11,13,2,10,47,547
50274,50274,600D7AE0D829582E691D7BDBD387E918,19441,16,20,4,8,46,446
50279,50279,831704567A0B8CDF382FA5741F6A7093,11321,0,12,12,31,46,1596
50280,50280,831704567A0B8CDF382FA5741F6A7093,12311,15,17,2,30,44,1544
50281,50281,831704567A0B8CDF382FA5741F6A7093,11321,18,23,5,31,46,1596
50298,50298,C994B0BB00A5F5442EEA247C000D74C5,42531,0,15,15,31,45,1595
50299,50299,C994B0BB00A5F5442EEA247C000D74C5,12311,15,17,2,30,44,1544
50300,50300,C994B0BB00A5F5442EEA247C000D74C5,42531,18,20,2,31,45,1595
50301,50301,1061DFB56DB0A9815BF450E4D94C3D77,11151,0,16,16,30,48,1548
50302,50302,1061DFB56DB0A9815BF450E4D94C3D77,11061,16,19,3,29,48,1498
50303,50303,1061DFB56DB0A9815BF450E4D94C3D77,11151,20,23,3,30,48,1548
50304,50304,D9026A3CE10A3841EFEE0C49DAE389C6,19901,0,5,5,7,44,394
50305,50305,D9026A3CE10A3841EFEE0C49DAE389C6,19114,6,18,12,7,43,393
50306,50306,D9026A3CE10A3841EFEE0C49DAE389C6,12641,19,21,2,10,43,543
50312,50312,692AC6DE13BF1FE0F43D1EA4E139D774,10841,2,8,6,37,47,1897
50313,50313,692AC6DE13BF1FE0F43D1EA4E139D774,13331,9,15,6,38,47,1947
50314,50314,692AC6DE13BF1FE0F43D1EA4E139D774,40463,15,16,1,38,49,1949
50315,50315,692AC6DE13BF1FE0F43D1EA4E139D774,10841,21,22,1,37,47,1897
50331,50331,9EE10D053E0D0FEE91EC61F0A8AFA62E,19114,7,10,3,7,43,393
50332,50332,9EE10D053E0D0FEE91EC61F0A8AFA62E,12641,13,14,1,10,43,543
50333,50333,9EE10D053E0D0FEE91EC61F0A8AFA62E,19114,15,19,4,7,43,393
50337,50337,7BBD15EB45C3F1BA6E572F56B02ABEDA,10841,0,11,11,37,47,1897
50338,50338,7BBD15EB45C3F1BA6E572F56B02ABEDA,12083,15,18,3,36,49,1849
50339,50339,7BBD15EB45C3F1BA6E572F56B02ABEDA,10841,18,23,5,37,47,1897
50340,50340,826B40817E61853148AFBFECB1C48C70,11261,0,4,4,36,46,1846
50341,50341,826B40817E61853148AFBFECB1C48C70,42861,7,17,10,37,44,1894
50342,50342,826B40817E61853148AFBFECB1C48C70,11261,20,23,3,36,46,1846
50346,50346,C7DA09D84BB6D5A3ABEAD976C8C0731E,42861,0,5,5,37,44,1894
50347,50347,C7DA09D84BB6D5A3ABEAD976C8C0731E,11261,6,17,11,36,46,1846
50348,50348,C7DA09D84BB6D5A3ABEAD976C8C0731E,42861,19,23,4,37,44,1894
50349,50349,B8DB030E6F574F75DC469AA0B11A44D5,10531,0,7,7,34,46,1746
50350,50350,B8DB030E6F574F75DC469AA0B11A44D5,42921,10,17,7,33,47,1697
50351,50351,B8DB030E6F574F75DC469AA0B11A44D5,10531,19,23,4,34,46,1746
50352,50352,92E340B82C56A45F91D53CD2B709557E,40171,7,9,2,38,48,1948
50353,50353,92E340B82C56A45F91D53CD2B709557E,11914,9,10,1,37,48,1898
50354,50354,92E340B82C56A45F91D53CD2B709557E,42581,13,14,1,38,48,1948
50355,50355,92E340B82C56A45F91D53CD2B709557E,11914,14,18,4,37,48,1898
50356,50356,07815E504E2AE025D7C40FE3C561B8BA,11074,0,9,9,37,47,1897
50357,50357,07815E504E2AE025D7C40FE3C561B8BA,13941,18,19,1,41,47,2097
50358,50358,07815E504E2AE025D7C40FE3C561B8BA,11074,20,23,3,37,47,1897
50370,50370,6C96EE989846ABECA961FEB7DAD4E3B3,43361,0,5,5,38,48,1948
50371,50371,6C96EE989846ABECA961FEB7DAD4E3B3,10471,6,19,13,37,48,1898
50372,50372,6C96EE989846ABECA961FEB7DAD4E3B3,43361,22,23,1,38,48,1948
50395,50395,D618A6C3100C9BD1930907167F1B2D2D,42461,1,7,6,45,47,2297
50396,50396,D618A6C3100C9BD1930907167F1B2D2D,42091,8,9,1,43,46,2196
50397,50397,D618A6C3100C9BD1930907167F1B2D2D,42461,15,20,5,45,47,2297
50398,50398,D618A6C3100C9BD1930907167F1B2D2D,42091,22,23,1,43,46,2196
50405,50405,3A84D2B8914ED9C906F97950F8E00F96,41021,0,12,12,38,47,1947
50406,50406,3A84D2B8914ED9C906F97950F8E00F96,10841,13,16,3,37,47,1897
50407,50407,3A84D2B8914ED9C906F97950F8E00F96,41021,17,19,2,38,47,1947
50408,50408,3A84D2B8914ED9C906F97950F8E00F96,12021,20,21,1,37,49,1899
50412,50412,D8F26E13541A4D201885591EA4BE04DA,19114,0,5,5,7,43,393
50413,50413,D8F26E13541A4D201885591EA4BE04DA,12641,7,9,2,10,43,543
50414,50414,D8F26E13541A4D201885591EA4BE04DA,19114,10,22,12,7,43,393
50415,50415,0DD480B5A13E261C7A404CA1C7C938C6,42511,0,5,5,37,47,1897
50416,50416,0DD480B5A13E261C7A404CA1C7C938C6,13121,8,17,9,38,46,1946
50417,50417,0DD480B5A13E261C7A404CA1C7C938C6,42511,18,22,4,37,47,1897
50418,50418,0DD480B5A13E261C7A404CA1C7C938C6,13121,22,23,1,38,46,1946
50422,50422,A857CFF84C275147F1A5FD53E913C52F,11231,0,14,14,37,49,1899
50423,50423,A857CFF84C275147F1A5FD53E913C52F,10471,15,16,1,37,48,1898
50424,50424,A857CFF84C275147F1A5FD53E913C52F,11231,16,22,6,37,49,1899
50434,50434,90568B514F9B63E4374F225CB87C45A4,11021,0,14,14,36,49,1849
50435,50435,90568B514F9B63E4374F225CB87C45A4,40271,18,19,1,35,49,1799
50436,50436,90568B514F9B63E4374F225CB87C45A4,11021,19,23,4,36,49,1849
50437,50437,F725A3F859B25741A70E1B3AC0517A8A,10111,0,8,8,37,47,1897
50438,50438,F725A3F859B25741A70E1B3AC0517A8A,13561,9,10,1,37,49,1899
50439,50439,F725A3F859B25741A70E1B3AC0517A8A,10111,14,22,8,37,47,1897
50440,50440,65161D8F8A2EE0E4F87D9472311EE576,12514,0,1,1,38,47,1947
50441,50441,65161D8F8A2EE0E4F87D9472311EE576,10841,1,17,16,37,47,1897
50442,50442,65161D8F8A2EE0E4F87D9472311EE576,12514,19,20,1,38,47,1947
50443,50443,65161D8F8A2EE0E4F87D9472311EE576,12511,20,23,3,39,47,1997
50449,50449,2C985E374948E01B1511C56B4538B456,42861,0,6,6,37,44,1894
50450,50450,2C985E374948E01B1511C56B4538B456,11261,9,10,1,36,46,1846
50451,50451,2C985E374948E01B1511C56B4538B456,42861,11,23,12,37,44,1894
50452,50452,9CAF9D4766C52431BBA0063BD723C357,13101,0,8,8,40,47,2047
50453,50453,9CAF9D4766C52431BBA0063BD723C357,13271,9,11,2,41,47,2097
50454,50454,9CAF9D4766C52431BBA0063BD723C357,13101,14,23,9,40,47,2047
50455,50455,7E9E870E7E7D6A03AC4927C4843DD06A,12651,0,2,2,43,47,2197
50456,50456,7E9E870E7E7D6A03AC4927C4843DD06A,10801,4,16,12,42,47,2147
50457,50457,7E9E870E7E7D6A03AC4927C4843DD06A,13271,18,19,1,41,47,2097
50458,50458,7E9E870E7E7D6A03AC4927C4843DD06A,12651,21,23,2,43,47,2197
50459,50459,75219378BBB10FFE07C7301517B53FE1,42271,5,7,2,40,47,2047
50460,50460,75219378BBB10FFE07C7301517B53FE1,11701,10,11,1,43,48,2198
50461,50461,75219378BBB10FFE07C7301517B53FE1,42271,14,17,3,40,47,2047
50462,50462,75219378BBB10FFE07C7301517B53FE1,11481,20,23,3,41,48,2098
50468,50468,98FCD0E7592CE3BE44D1E20097E37B5B,10111,8,13,5,37,47,1897
50469,50469,98FCD0E7592CE3BE44D1E20097E37B5B,11331,16,17,1,37,48,1898
50470,50470,98FCD0E7592CE3BE44D1E20097E37B5B,10111,20,21,1,37,47,1897
50471,50471,98FCD0E7592CE3BE44D1E20097E37B5B,42401,22,23,1,36,47,1847
50472,50472,990529BE48C6A8DFFA6A404F72B17A5A,11261,1,4,3,36,46,1846
50473,50473,990529BE48C6A8DFFA6A404F72B17A5A,42861,7,9,2,37,44,1894
50474,50474,990529BE48C6A8DFFA6A404F72B17A5A,11261,11,12,1,36,46,1846
50475,50475,990529BE48C6A8DFFA6A404F72B17A5A,42861,12,22,10,37,44,1894
50476,50476,6C7DE4B4696563CBDA9D3C6E4FCAB652,10341,0,14,14,31,47,1597
50477,50477,6C7DE4B4696563CBDA9D3C6E4FCAB652,12661,15,16,1,32,45,1645
50478,50478,6C7DE4B4696563CBDA9D3C6E4FCAB652,10341,18,23,5,31,47,1597
50483,50483,C9111848A66C5E8C5A42C9C3546D9FD1,12083,0,8,8,36,49,1849
50484,50484,C9111848A66C5E8C5A42C9C3546D9FD1,13561,8,10,2,37,49,1899
50485,50485,C9111848A66C5E8C5A42C9C3546D9FD1,12083,12,23,11,36,49,1849
50500,50500,1351E7666B434C302203B50F903A519B,43761,5,15,10,32,47,1647
50501,50501,1351E7666B434C302203B50F903A519B,42021,19,20,1,33,47,1697
50502,50502,1351E7666B434C302203B50F903A519B,43761,21,22,1,32,47,1647
50506,50506,6CF20899EA8F1A27E67F0C12C1758D54,11381,0,2,2,30,47,1547
50507,50507,6CF20899EA8F1A27E67F0C12C1758D54,11061,3,18,15,29,48,1498
50508,50508,6CF20899EA8F1A27E67F0C12C1758D54,11381,18,19,1,30,47,1547
50509,50509,642E530AC0B9954883C291456EA07C44,10731,0,10,10,33,47,1697
50510,50510,642E530AC0B9954883C291456EA07C44,43761,10,11,1,32,47,1647
50511,50511,642E530AC0B9954883C291456EA07C44,11074,14,23,9,37,47,1897
50516,50516,06D551A8B84FE30AD5961028E6C3C756,19441,0,6,6,8,46,446
50517,50517,06D551A8B84FE30AD5961028E6C3C756,42041,6,7,1,10,47,547
50518,50518,06D551A8B84FE30AD5961028E6C3C756,19441,11,23,12,8,46,446
50524,50524,7416ABA9B70926119329485C1E15D038,42071,4,5,1,31,49,1599
50525,50525,7416ABA9B70926119329485C1E15D038,13731,8,9,1,33,49,1699
50526,50526,7416ABA9B70926119329485C1E15D038,11951,14,21,7,31,49,1599
50530,50530,B330B6F87FA34F7466DC67C7BC5F8853,11921,1,11,10,38,48,1948
50531,50531,B330B6F87FA34F7466DC67C7BC5F8853,12514,12,18,6,38,47,1947
50532,50532,B330B6F87FA34F7466DC67C7BC5F8853,11921,20,21,1,38,48,1948
50533,50533,B7783E40C231BF2A915C5200F2E2562A,12031,0,9,9,33,48,1698
50534,50534,B7783E40C231BF2A915C5200F2E2562A,10901,10,11,1,35,48,1798
50535,50535,B7783E40C231BF2A915C5200F2E2562A,40951,12,18,6,36,49,1849
50536,50536,B7783E40C231BF2A915C5200F2E2562A,10881,19,22,3,34,48,1748
50557,50557,1CD741282378ACECE229BFA3E57C9431,19441,0,7,7,8,46,446
50558,50558,1CD741282378ACECE229BFA3E57C9431,42041,7,11,4,10,47,547
50559,50559,1CD741282378ACECE229BFA3E57C9431,19441,12,18,6,8,46,446
50560,50560,1CD741282378ACECE229BFA3E57C9431,42041,19,20,1,10,47,547
50561,50561,015DD3F8879090CB78AF6455AEBAF5CD,11211,10,13,3,34,49,1749
50562,50562,015DD3F8879090CB78AF6455AEBAF5CD,13561,13,15,2,37,49,1899
50563,50563,015DD3F8879090CB78AF6455AEBAF5CD,11211,16,18,2,34,49,1749
50564,50564,015DD3F8879090CB78AF6455AEBAF5CD,13561,22,23,1,37,49,1899
50569,50569,88B9ED484BFC88A3E18D812526B753D0,42861,6,10,4,37,44,1894
50570,50570,88B9ED484BFC88A3E18D812526B753D0,11261,11,12,1,36,46,1846
50571,50571,88B9ED484BFC88A3E18D812526B753D0,42864,14,18,4,38,44,1944
50572,50572,88B9ED484BFC88A3E18D812526B753D0,11261,20,23,3,36,46,1846
50573,50573,AE5EC73B53E9C3CD1EC48FB8238BD121,10221,0,9,9,34,49,1749
50574,50574,AE5EC73B53E9C3CD1EC48FB8238BD121,42961,13,16,3,35,49,1799
50575,50575,AE5EC73B53E9C3CD1EC48FB8238BD121,10221,17,19,2,34,49,1749
50576,50576,AE5EC73B53E9C3CD1EC48FB8238BD121,10107,20,22,2,38,49,1949
50577,50577,341EA4B6DED87D9D6B7D3B05E26A35CA,10281,0,8,8,33,48,1698
50578,50578,341EA4B6DED87D9D6B7D3B05E26A35CA,10611,9,17,8,32,48,1648
50579,50579,341EA4B6DED87D9D6B7D3B05E26A35CA,42161,19,23,4,36,47,1847
50583,50583,7525C5E0D4A1F16451ECCF96F09BECD1,11861,1,10,9,32,47,1647
50584,50584,7525C5E0D4A1F16451ECCF96F09BECD1,10281,11,18,7,33,48,1698
50585,50585,7525C5E0D4A1F16451ECCF96F09BECD1,42021,19,20,1,33,47,1697
50586,50586,7525C5E0D4A1F16451ECCF96F09BECD1,10281,21,23,2,33,48,1698
50587,50587,DCE9BDF4C30776F61FC7C0FB237D8FCF,40941,0,9,9,32,48,1648
50588,50588,DCE9BDF4C30776F61FC7C0FB237D8FCF,11541,11,12,1,35,49,1799
50589,50589,DCE9BDF4C30776F61FC7C0FB237D8FCF,10721,13,23,10,31,48,1598
50590,50590,9F07E2341EC43516CD02BDC269F3E6AA,11381,0,13,13,30,47,1547
50591,50591,9F07E2341EC43516CD02BDC269F3E6AA,11431,14,15,1,29,47,1497
50592,50592,9F07E2341EC43516CD02BDC269F3E6AA,11381,17,22,5,30,47,1547
50593,50593,200194CA33DD57C0E0CC791C5F2E51EB,40123,3,11,8,38,47,1947
50594,50594,200194CA33DD57C0E0CC791C5F2E51EB,11081,13,14,1,35,46,1796
50595,50595,200194CA33DD57C0E0CC791C5F2E51EB,12514,19,21,2,38,47,1947
50596,50596,200194CA33DD57C0E0CC791C5F2E51EB,10151,22,23,1,34,47,1747
50607,50607,62E083FD6CCFD94FFA49C92986AAE56D,10281,0,8,8,33,48,1698
50608,50608,62E083FD6CCFD94FFA49C92986AAE56D,11381,10,11,1,30,47,1547
50609,50609,62E083FD6CCFD94FFA49C92986AAE56D,43761,13,16,3,32,47,1647
50610,50610,62E083FD6CCFD94FFA49C92986AAE56D,10281,17,21,4,33,48,1698
50615,50615,6BC25D943F92E8D81D0DD10A27C42A3A,11061,0,11,11,29,48,1498
50616,50616,6BC25D943F92E8D81D0DD10A27C42A3A,11381,13,14,1,30,47,1547
50617,50617,6BC25D943F92E8D81D0DD10A27C42A3A,11061,17,20,3,29,48,1498
50618,50618,97EED02186157B67ACCA35C5CC13851D,43731,0,18,18,34,47,1747
50619,50619,97EED02186157B67ACCA35C5CC13851D,10251,19,21,2,35,47,1797
50620,50620,97EED02186157B67ACCA35C5CC13851D,10221,22,23,1,34,49,1749
50621,50621,1E4ADDBFBD1C3EEA7DB4E1CBF005793C,11061,2,5,3,29,48,1498
50622,50622,1E4ADDBFBD1C3EEA7DB4E1CBF005793C,11111,8,9,1,26,48,1348
50623,50623,1E4ADDBFBD1C3EEA7DB4E1CBF005793C,11061,13,23,10,29,48,1498
50647,50647,1DD1A250791E8DE9D0B949B1DAE230C8,11861,0,14,14,32,47,1647
50648,50648,1DD1A250791E8DE9D0B949B1DAE230C8,10281,14,17,3,33,48,1698
50649,50649,1DD1A250791E8DE9D0B949B1DAE230C8,11861,18,21,3,32,47,1647
50672,50672,8AAB036B09D3D2F76995D9AF3741FD6E,43391,7,13,6,29,48,1498
50673,50673,8AAB036B09D3D2F76995D9AF3741FD6E,42071,14,20,6,31,49,1599
50674,50674,8AAB036B09D3D2F76995D9AF3741FD6E,43391,21,22,1,29,48,1498
50675,50675,8AAB036B09D3D2F76995D9AF3741FD6E,10381,22,23,1,31,49,1599
50676,50676,859846C23309918FCF7E37DF9FD45D9F,42351,0,4,4,38,45,1945
50677,50677,859846C23309918FCF7E37DF9FD45D9F,42231,9,11,2,37,46,1896
50678,50678,859846C23309918FCF7E37DF9FD45D9F,13911,12,23,11,39,46,1996
50695,50695,4F717808305424D6529B2687FA7E5A49,13731,2,8,6,33,49,1699
50696,50696,4F717808305424D6529B2687FA7E5A49,11951,10,13,3,31,49,1599
50697,50697,4F717808305424D6529B2687FA7E5A49,11954,15,23,8,32,49,1649
50701,50701,2C9F9127F2AECFBA8069624790D23C60,10471,0,13,13,37,48,1898
50702,50702,2C9F9127F2AECFBA8069624790D23C60,40171,18,19,1,38,48,1948
50703,50703,2C9F9127F2AECFBA8069624790D23C60,41591,20,21,1,34,49,1749
50704,50704,2C9F9127F2AECFBA8069624790D23C60,10471,22,23,1,37,48,1898
50705,50705,A9B44FB0C38E30174C1675688859A185,11231,4,12,8,37,49,1899
50706,50706,A9B44FB0C38E30174C1675688859A185,10901,16,17,1,35,48,1798
50707,50707,A9B44FB0C38E30174C1675688859A185,11231,18,23,5,37,49,1899
50708,50708,36E4D456967ADF7C503C23EAE8460AAD,13651,0,8,8,30,47,1547
50709,50709,36E4D456967ADF7C503C23EAE8460AAD,42523,12,13,1,31,47,1597
50710,50710,36E4D456967ADF7C503C23EAE8460AAD,13651,14,16,2,30,47,1547
50711,50711,36E4D456967ADF7C503C23EAE8460AAD,42523,17,19,2,31,47,1597
50712,50712,3DABBE7AD4BBA6D6461EC91F04F7CCEC,42461,0,18,18,45,47,2297
50713,50713,3DABBE7AD4BBA6D6461EC91F04F7CCEC,43621,18,20,2,46,48,2348
50714,50714,3DABBE7AD4BBA6D6461EC91F04F7CCEC,42321,20,22,2,43,47,2197
50715,50715,3DABBE7AD4BBA6D6461EC91F04F7CCEC,43621,22,23,1,46,48,2348
50716,50716,25433ECFD440230652F6EBAFA6DF34B9,40431,0,14,14,36,47,1847
50717,50717,25433ECFD440230652F6EBAFA6DF34B9,42941,14,17,3,37,47,1897
50718,50718,25433ECFD440230652F6EBAFA6DF34B9,11171,18,20,2,33,48,1698
50719,50719,25433ECFD440230652F6EBAFA6DF34B9,40261,21,22,1,35,49,1799
50730,50730,5CF14B2B10725E82307DC412844C30B7,12311,0,8,8,30,44,1544
50731,50731,5CF14B2B10725E82307DC412844C30B7,42531,8,12,4,31,45,1595
50732,50732,5CF14B2B10725E82307DC412844C30B7,12311,13,18,5,30,44,1544
50733,50733,5CF14B2B10725E82307DC412844C30B7,11321,21,23,2,31,46,1596
50734,50734,9CA777C26F090A99FBBCE57B69E10F32,11161,0,7,7,32,48,1648
50735,50735,9CA777C26F090A99FBBCE57B69E10F32,43761,7,9,2,32,47,1647
50736,50736,9CA777C26F090A99FBBCE57B69E10F32,42521,13,17,4,31,47,1597
50737,50737,9CA777C26F090A99FBBCE57B69E10F32,11161,18,23,5,32,48,1648
50756,50756,A863A8AA32D1F33FE257FE3F1CDA98F2,10471,0,8,8,37,48,1898
50757,50757,A863A8AA32D1F33FE257FE3F1CDA98F2,12481,11,13,2,37,49,1899
50758,50758,A863A8AA32D1F33FE257FE3F1CDA98F2,10471,13,23,10,37,48,1898
50759,50759,4EE5C60035D807126AEE0DC0CD563832,42581,1,17,16,38,48,1948
50760,50760,4EE5C60035D807126AEE0DC0CD563832,11914,20,21,1,37,48,1898
50761,50761,4EE5C60035D807126AEE0DC0CD563832,42581,21,22,1,38,48,1948
50776,50776,9027D7BCCA8B9488D727103093A0EE77,13341,0,7,7,44,45,2245
50777,50777,9027D7BCCA8B9488D727103093A0EE77,12141,8,9,1,42,45,2145
50778,50778,9027D7BCCA8B9488D727103093A0EE77,13341,13,20,7,44,45,2245
50779,50779,9027D7BCCA8B9488D727103093A0EE77,12561,21,22,1,45,43,2293
50796,50796,D0819644627AC00B1760F57708B6F7FF,41393,9,13,4,43,49,2199
50797,50797,D0819644627AC00B1760F57708B6F7FF,43621,14,15,1,46,48,2348
50798,50798,D0819644627AC00B1760F57708B6F7FF,41393,15,22,7,43,49,2199
50807,50807,B356CA0B3EC2AF6FE1AFADC30EDEFA9C,42311,0,13,13,41,46,2096
50808,50808,B356CA0B3EC2AF6FE1AFADC30EDEFA9C,13101,15,17,2,40,47,2047
50809,50809,B356CA0B3EC2AF6FE1AFADC30EDEFA9C,42311,19,23,4,41,46,2096
50810,50810,44FA260E09CBCFE04103D6D8067B71FF,11871,0,1,1,29,46,1496
50811,50811,44FA260E09CBCFE04103D6D8067B71FF,11875,3,13,10,30,46,1546
50812,50812,44FA260E09CBCFE04103D6D8067B71FF,12311,14,15,1,30,44,1544
50813,50813,44FA260E09CBCFE04103D6D8067B71FF,11871,19,22,3,29,46,1496
50814,50814,AC414DB8853E95A441FB40B4893530F7,10634,3,4,1,27,45,1395
50815,50815,AC414DB8853E95A441FB40B4893530F7,10351,4,6,2,28,45,1445
50816,50816,AC414DB8853E95A441FB40B4893530F7,10634,11,17,6,27,45,1395
50817,50817,AC414DB8853E95A441FB40B4893530F7,11871,17,18,1,29,46,1496
50818,50818,94C244793C9D289B150510A6E7ED4D21,42151,1,11,10,35,45,1795
50819,50819,94C244793C9D289B150510A6E7ED4D21,42861,14,16,2,37,44,1894
50820,50820,94C244793C9D289B150510A6E7ED4D21,42151,16,18,2,35,45,1795
50826,50826,033D572A71C2A065F335205114BD8E8C,12971,0,8,8,32,48,1648
50827,50827,033D572A71C2A065F335205114BD8E8C,10721,13,14,1,31,48,1598
50828,50828,033D572A71C2A065F335205114BD8E8C,12381,19,23,4,32,48,1648
50836,50836,AD7F7BB46EF09C86333AC9999F5D1555,10271,0,6,6,37,46,1896
50837,50837,AD7F7BB46EF09C86333AC9999F5D1555,10821,7,8,1,40,47,2047
50838,50838,AD7F7BB46EF09C86333AC9999F5D1555,10271,11,23,12,37,46,1896
50842,50842,3869E48F267B04208FDB1CED43168CE1,43761,1,7,6,32,47,1647
50843,50843,3869E48F267B04208FDB1CED43168CE1,12161,9,17,8,32,46,1646
50844,50844,3869E48F267B04208FDB1CED43168CE1,43761,19,21,2,32,47,1647
50860,50860,60B3904EE9AFD7C630994F95D4C927AC,13561,8,14,6,37,49,1899
50861,50861,60B3904EE9AFD7C630994F95D4C927AC,43671,14,16,2,35,48,1798
50862,50862,60B3904EE9AFD7C630994F95D4C927AC,11231,19,23,4,37,49,1899
50866,50866,9ED06C73B88BB4839B692590DA94AEEC,42091,0,8,8,43,46,2196
50867,50867,9ED06C73B88BB4839B692590DA94AEEC,13791,10,12,2,42,47,2147
50868,50868,9ED06C73B88BB4839B692590DA94AEEC,42091,13,18,5,43,46,2196
50878,50878,7593D7AED856FF2FC2E20D8E8570438A,11271,1,6,5,37,48,1898
50879,50879,7593D7AED856FF2FC2E20D8E8570438A,10107,7,8,1,38,49,1949
50880,50880,7593D7AED856FF2FC2E20D8E8570438A,40171,10,11,1,38,48,1948
50881,50881,7593D7AED856FF2FC2E20D8E8570438A,10471,12,22,10,37,48,1898
50882,50882,559B7EB9533AB89EF08E78738E69752D,10281,0,8,8,33,48,1698
50883,50883,559B7EB9533AB89EF08E78738E69752D,42921,10,11,1,33,47,1697
50884,50884,559B7EB9533AB89EF08E78738E69752D,10281,12,22,10,33,48,1698
50885,50885,F047C14D10AD9FBC70288E89E0E137C9,43761,1,5,4,32,47,1647
50886,50886,F047C14D10AD9FBC70288E89E0E137C9,42491,6,7,1,32,46,1646
50887,50887,F047C14D10AD9FBC70288E89E0E137C9,42161,12,13,1,36,47,1847
50888,50888,F047C14D10AD9FBC70288E89E0E137C9,42491,13,20,7,32,46,1646
50896,50896,AD235EE6A83CA7956AB86E8BC887D3C7,11541,0,6,6,35,49,1799
50897,50897,AD235EE6A83CA7956AB86E8BC887D3C7,11021,6,18,12,36,49,1849
50898,50898,AD235EE6A83CA7956AB86E8BC887D3C7,11541,21,23,2,35,49,1799
50914,50914,5B005239AD91B224060A740123F8C94E,13231,0,4,4,39,46,1996
50915,50915,5B005239AD91B224060A740123F8C94E,42231,7,15,8,37,46,1896
50916,50916,5B005239AD91B224060A740123F8C94E,13911,17,19,2,39,46,1996
50928,50928,52DE1B5B29EB088C4F7CC0D4865B38F5,42151,7,8,1,35,45,1795
50929,50929,52DE1B5B29EB088C4F7CC0D4865B38F5,42861,8,14,6,37,44,1894
50930,50930,52DE1B5B29EB088C4F7CC0D4865B38F5,42151,14,16,2,35,45,1795
50931,50931,52DE1B5B29EB088C4F7CC0D4865B38F5,42861,17,21,4,37,44,1894
50932,50932,132BAF41704DD845C2F70543C3732C4E,13711,0,1,1,38,46,1946
50933,50933,132BAF41704DD845C2F70543C3732C4E,42231,1,21,20,37,46,1896
50934,50934,132BAF41704DD845C2F70543C3732C4E,13711,21,23,2,38,46,1946
50954,50954,3817ED13C89DC986F3BE205F1215C1F8,43581,0,7,7,33,48,1698
50955,50955,3817ED13C89DC986F3BE205F1215C1F8,10731,10,11,1,33,47,1697
50956,50956,3817ED13C89DC986F3BE205F1215C1F8,43581,21,23,2,33,48,1698
50957,50957,15D46EC570105A948AAA5BD130B0DCB7,10111,2,11,9,37,47,1897
50958,50958,15D46EC570105A948AAA5BD130B0DCB7,42161,13,17,4,36,47,1847
50959,50959,15D46EC570105A948AAA5BD130B0DCB7,10111,18,21,3,37,47,1897
50960,50960,A0E37408EE9803F2A3B48F0DEC5190F0,10971,3,4,1,35,47,1797
50961,50961,A0E37408EE9803F2A3B48F0DEC5190F0,10531,5,9,4,34,46,1746
50962,50962,A0E37408EE9803F2A3B48F0DEC5190F0,43161,19,23,4,35,47,1797
50967,50967,D48C648C1D8E99D79DDC90BDE949351A,13231,1,4,3,39,46,1996
50968,50968,D48C648C1D8E99D79DDC90BDE949351A,11261,4,8,4,36,46,1846
50969,50969,D48C648C1D8E99D79DDC90BDE949351A,42351,9,10,1,38,45,1945
50970,50970,D48C648C1D8E99D79DDC90BDE949351A,11261,11,22,11,36,46,1846
50974,50974,2AC8E4C41FCDCF53C09A83820985C782,11381,6,15,9,30,47,1547
50975,50975,2AC8E4C41FCDCF53C09A83820985C782,10171,18,20,2,26,47,1347
50976,50976,2AC8E4C41FCDCF53C09A83820985C782,11381,20,23,3,30,47,1547
50983,50983,6B9B8D827AD1E80848E05B71B545DCBC,10681,0,6,6,30,48,1548
50984,50984,6B9B8D827AD1E80848E05B71B545DCBC,11061,10,16,6,29,48,1498
50985,50985,6B9B8D827AD1E80848E05B71B545DCBC,10681,20,23,3,30,48,1548
50986,50986,E1BB7B2CDA075A402737990C0757A672,40632,0,8,8,35,48,1798
50987,50987,E1BB7B2CDA075A402737990C0757A672,10881,10,11,1,34,48,1748
50988,50988,E1BB7B2CDA075A402737990C0757A672,11491,13,14,1,36,47,1847
50989,50989,E1BB7B2CDA075A402737990C0757A672,12083,21,23,2,36,49,1849
50990,50990,56524A83FB5DB3B819DF4EB8293FB334,40673,1,6,5,36,48,1848
50991,50991,56524A83FB5DB3B819DF4EB8293FB334,10151,9,10,1,34,47,1747
50992,50992,56524A83FB5DB3B819DF4EB8293FB334,40673,13,16,3,36,48,1848
50993,50993,56524A83FB5DB3B819DF4EB8293FB334,13561,20,23,3,37,49,1899
50994,50994,79F5F6FF92A1AB4EFE8FBCDCDB3E722F,12381,8,14,6,32,48,1648
50995,50995,79F5F6FF92A1AB4EFE8FBCDCDB3E722F,42021,16,17,1,33,47,1697
50996,50996,79F5F6FF92A1AB4EFE8FBCDCDB3E722F,11161,19,21,2,32,48,1648
51001,51001,4E7614A4B91A30F096E19E723EE62442,10634,0,11,11,27,45,1395
51002,51002,4E7614A4B91A30F096E19E723EE62442,12121,14,16,2,29,47,1497
51003,51003,4E7614A4B91A30F096E19E723EE62442,10634,20,23,3,27,45,1395
51011,51011,EAAB672210C677BA2879CCE67BDB7DF5,11151,0,6,6,30,48,1548
51012,51012,EAAB672210C677BA2879CCE67BDB7DF5,42831,7,8,1,27,48,1398
51013,51013,EAAB672210C677BA2879CCE67BDB7DF5,11151,8,23,15,30,48,1548
51023,51023,44A1A512359C02E9A75BCE907A401EBD,12083,0,11,11,36,49,1849
51024,51024,44A1A512359C02E9A75BCE907A401EBD,11231,12,15,3,37,49,1899
51025,51025,44A1A512359C02E9A75BCE907A401EBD,12083,19,22,3,36,49,1849
51031,51031,F587555054424F7ED0D63829AAEB0C06,11806,0,6,6,41,48,2098
51032,51032,F587555054424F7ED0D63829AAEB0C06,42271,8,11,3,40,47,2047
51033,51033,F587555054424F7ED0D63829AAEB0C06,11806,13,18,5,41,48,2098
51043,51043,528421A4A4CF40E840301284E0AFB525,42161,1,11,10,36,47,1847
51044,51044,528421A4A4CF40E840301284E0AFB525,10111,13,14,1,37,47,1897
51045,51045,528421A4A4CF40E840301284E0AFB525,42161,16,23,7,36,47,1847
51046,51046,13FEB49EBF8CBBDDDEE7B78BF37E951A,10251,0,10,10,35,47,1797
51047,51047,13FEB49EBF8CBBDDDEE7B78BF37E951A,10111,11,19,8,37,47,1897
51048,51048,13FEB49EBF8CBBDDDEE7B78BF37E951A,10251,20,23,3,35,47,1797
51055,51055,8C7DCF60D5A91C4294A8C14ABFA5CFBF,43181,1,4,3,39,48,1998
51056,51056,8C7DCF60D5A91C4294A8C14ABFA5CFBF,11271,8,19,11,37,48,1898
51057,51057,8C7DCF60D5A91C4294A8C14ABFA5CFBF,40171,22,23,1,38,48,1948
51067,51067,E16EBF9DB1B661AB3BA331BB1570A330,12491,0,10,10,36,43,1843
51068,51068,E16EBF9DB1B661AB3BA331BB1570A330,43451,11,19,8,37,40,1890
51069,51069,E16EBF9DB1B661AB3BA331BB1570A330,12491,22,23,1,36,43,1843
51075,51075,6521FFE7376C4CFC0D41F09B0DCEAAEC,42041,9,11,2,10,47,547
51076,51076,6521FFE7376C4CFC0D41F09B0DCEAAEC,19021,14,15,1,10,45,545
51077,51077,6521FFE7376C4CFC0D41F09B0DCEAAEC,42041,20,21,1,10,47,547
51078,51078,6521FFE7376C4CFC0D41F09B0DCEAAEC,19441,21,23,2,8,46,446
51079,51079,81677BBF6981E3D6E202B916ACF354DA,42301,0,1,1,36,47,1847
51080,51080,81677BBF6981E3D6E202B916ACF354DA,10111,2,7,5,37,47,1897
51081,51081,81677BBF6981E3D6E202B916ACF354DA,42301,8,19,11,36,47,1847
51082,51082,81677BBF6981E3D6E202B916ACF354DA,10111,19,20,1,37,47,1897
51083,51083,D366589B3E90DFE9BB97263FFFDAB40D,13911,0,6,6,39,46,1996
51084,51084,D366589B3E90DFE9BB97263FFFDAB40D,42231,7,10,3,37,46,1896
51085,51085,D366589B3E90DFE9BB97263FFFDAB40D,13911,11,23,12,39,46,1996
51095,51095,7F318075F1920D130758C373B5DCA844,11231,0,11,11,37,49,1899
51096,51096,7F318075F1920D130758C373B5DCA844,11731,15,16,1,36,48,1848
51097,51097,7F318075F1920D130758C373B5DCA844,11231,16,23,7,37,49,1899
51112,51112,4F067AC0455A0AD68F9A6EB159316E5A,12841,0,9,9,37,47,1897
51113,51113,4F067AC0455A0AD68F9A6EB159316E5A,42161,10,13,3,36,47,1847
51114,51114,4F067AC0455A0AD68F9A6EB159316E5A,12841,13,16,3,37,47,1897
51115,51115,4F067AC0455A0AD68F9A6EB159316E5A,11331,17,19,2,37,48,1898
51125,51125,C89DD497B3E25F408D5F4E0FF457EA4C,11914,4,6,2,37,48,1898
51126,51126,C89DD497B3E25F408D5F4E0FF457EA4C,42581,8,16,8,38,48,1948
51127,51127,C89DD497B3E25F408D5F4E0FF457EA4C,11914,17,23,6,37,48,1898
51128,51128,E9E9C9DE1050FFAD63256F714329F12B,42201,0,16,16,43,46,2196
51129,51129,E9E9C9DE1050FFAD63256F714329F12B,42111,16,17,1,44,46,2246
51130,51130,E9E9C9DE1050FFAD63256F714329F12B,42201,17,23,6,43,46,2196
51135,51135,02395C4612FFF78C33F511305F173678,11321,0,8,8,31,46,1596
51136,51136,02395C4612FFF78C33F511305F173678,11381,12,15,3,30,47,1547
51137,51137,02395C4612FFF78C33F511305F173678,12121,16,19,3,29,47,1497
51138,51138,4C13C3D7416FEE47C7E01DACD89CC954,10301,0,5,5,31,45,1595
51139,51139,4C13C3D7416FEE47C7E01DACD89CC954,42871,6,9,3,30,45,1545
51140,51140,4C13C3D7416FEE47C7E01DACD89CC954,10301,9,22,13,31,45,1595
51141,51141,8820D655222FFDC13E2E08EC252AACD5,10251,0,12,12,35,47,1797
51142,51142,8820D655222FFDC13E2E08EC252AACD5,42161,18,19,1,36,47,1847
51143,51143,8820D655222FFDC13E2E08EC252AACD5,43731,19,21,2,34,47,1747
51144,51144,005F29A161E0688A7FD457CFA6CB5E51,13601,6,12,6,34,47,1747
51145,51145,005F29A161E0688A7FD457CFA6CB5E51,42021,13,14,1,33,47,1697
51146,51146,005F29A161E0688A7FD457CFA6CB5E51,10721,18,21,3,31,48,1598
51156,51156,5204223B386753C6A1ECB449A9C1A58C,10271,2,19,17,37,46,1896
51157,51157,5204223B386753C6A1ECB449A9C1A58C,13121,20,21,1,38,46,1946
51158,51158,5204223B386753C6A1ECB449A9C1A58C,10271,22,23,1,37,46,1896
51165,51165,86F3BF3DB98B06CCC824A62642D0F12B,11331,0,9,9,37,48,1898
51166,51166,86F3BF3DB98B06CCC824A62642D0F12B,40673,11,12,1,36,48,1848
51167,51167,86F3BF3DB98B06CCC824A62642D0F12B,12514,13,16,3,38,47,1947
51168,51168,86F3BF3DB98B06CCC824A62642D0F12B,40951,18,20,2,36,49,1849
51172,51172,5A94336DADEC71A201B6EE1AC7B33E86,10191,0,8,8,40,48,2048
51173,51173,5A94336DADEC71A201B6EE1AC7B33E86,40171,9,10,1,38,48,1948
51174,51174,5A94336DADEC71A201B6EE1AC7B33E86,10191,18,23,5,40,48,2048
51192,51192,2446E8F15BFC2A49F5E456D12DC187B8,10381,3,8,5,31,49,1599
51193,51193,2446E8F15BFC2A49F5E456D12DC187B8,43391,9,12,3,29,48,1498
51194,51194,2446E8F15BFC2A49F5E456D12DC187B8,10381,15,21,6,31,49,1599
51195,51195,2A061F0906BDB70C1FC1A6A84055B40D,11021,0,11,11,36,49,1849
51196,51196,2A061F0906BDB70C1FC1A6A84055B40D,42471,13,20,7,35,49,1799
51197,51197,2A061F0906BDB70C1FC1A6A84055B40D,10231,21,22,1,39,49,1999
51210,51210,5A8308F9DAAF40265186D4E63F2640C9,10721,0,8,8,31,48,1598
51211,51211,5A8308F9DAAF40265186D4E63F2640C9,13731,12,13,1,33,49,1699
51212,51212,5A8308F9DAAF40265186D4E63F2640C9,10721,17,23,6,31,48,1598
51221,51221,B532F93B6517A3D30211D466DC2FD209,11331,0,6,6,37,48,1898
51222,51222,B532F93B6517A3D30211D466DC2FD209,12511,7,21,14,39,47,1997
51223,51223,B532F93B6517A3D30211D466DC2FD209,11074,22,23,1,37,47,1897
51224,51224,EDAA922713654FF36B4E3A7C199ADC11,19111,0,7,7,9,45,495
51225,51225,EDAA922713654FF36B4E3A7C199ADC11,12921,7,9,2,9,41,491
51226,51226,EDAA922713654FF36B4E3A7C199ADC11,19111,10,18,8,9,45,495
51227,51227,9F99A72527E81B89BEB16DB21B613CC0,10281,1,7,6,33,48,1698
51228,51228,9F99A72527E81B89BEB16DB21B613CC0,42021,8,17,9,33,47,1697
51229,51229,9F99A72527E81B89BEB16DB21B613CC0,10281,17,23,6,33,48,1698
51230,51230,9A07AABA1CD597B2A71A4D590465987D,43161,0,7,7,35,47,1797
51231,51231,9A07AABA1CD597B2A71A4D590465987D,40271,14,19,5,35,49,1799
51232,51232,9A07AABA1CD597B2A71A4D590465987D,43161,21,23,2,35,47,1797
51241,51241,38BAD20AF3F1C2D76FC5AB52738907B1,10281,9,10,1,33,48,1698
51242,51242,38BAD20AF3F1C2D76FC5AB52738907B1,10341,10,13,3,31,47,1597
51243,51243,38BAD20AF3F1C2D76FC5AB52738907B1,10281,13,18,5,33,48,1698
51244,51244,38BAD20AF3F1C2D76FC5AB52738907B1,10341,18,23,5,31,47,1597
51245,51245,2B796358390FD846EE57DE8924EDBF14,42581,1,6,5,38,48,1948
51246,51246,2B796358390FD846EE57DE8924EDBF14,11914,6,10,4,37,48,1898
51247,51247,2B796358390FD846EE57DE8924EDBF14,42581,13,16,3,38,48,1948
51248,51248,2B796358390FD846EE57DE8924EDBF14,11914,19,22,3,37,48,1898
51258,51258,905AFBF8C9D2DC6B48AC77C3F506268E,13561,0,6,6,37,49,1899
51259,51259,905AFBF8C9D2DC6B48AC77C3F506268E,11021,7,18,11,36,49,1849
51260,51260,905AFBF8C9D2DC6B48AC77C3F506268E,13561,22,23,1,37,49,1899
51277,51277,2287B0D379AE62342F9E5A8FE93DC228,11021,0,2,2,36,49,1849
51278,51278,2287B0D379AE62342F9E5A8FE93DC228,13561,2,6,4,37,49,1899
51279,51279,2287B0D379AE62342F9E5A8FE93DC228,11021,7,22,15,36,49,1849
51291,51291,A26526FCE25758DA240C3B314B205E8A,19024,0,6,6,9,45,495
51292,51292,A26526FCE25758DA240C3B314B205E8A,12641,10,19,9,10,43,543
51293,51293,A26526FCE25758DA240C3B314B205E8A,19024,20,21,1,9,45,495
51313,51313,FE157E2906F39F22EFF42EFD9B7DC358,11061,2,8,6,29,48,1498
51314,51314,FE157E2906F39F22EFF42EFD9B7DC358,11381,12,14,2,30,47,1547
51315,51315,FE157E2906F39F22EFF42EFD9B7DC358,11061,14,23,9,29,48,1498
51316,51316,6448AD2FDBA33B773228F13A91A3786C,43761,0,17,17,32,47,1647
51317,51317,6448AD2FDBA33B773228F13A91A3786C,10281,17,18,1,33,48,1698
51318,51318,6448AD2FDBA33B773228F13A91A3786C,43761,20,22,2,32,47,1647
51319,51319,F38AB0098BE65E711BE711E13E868DCB,13561,0,14,14,37,49,1899
51320,51320,F38AB0098BE65E711BE711E13E868DCB,10811,14,17,3,38,46,1946
51321,51321,F38AB0098BE65E711BE711E13E868DCB,13561,21,23,2,37,49,1899
51322,51322,8E7E1D3BA1392AF853A6068E181E9940,12381,1,18,17,32,48,1648
51323,51323,8E7E1D3BA1392AF853A6068E181E9940,11211,20,21,1,34,49,1749
51324,51324,8E7E1D3BA1392AF853A6068E181E9940,11751,21,22,1,35,48,1798
51325,51325,69F62EC905965E951064324714771523,19741,0,10,10,5,44,294
51326,51326,69F62EC905965E951064324714771523,19744,18,19,1,6,43,343
51327,51327,69F62EC905965E951064324714771523,19741,19,23,4,5,44,294
51341,51341,2158D922C46E0A92417041C9C40770E9,42091,0,8,8,43,46,2196
51342,51342,2158D922C46E0A92417041C9C40770E9,40691,11,12,1,42,48,2148
51343,51343,2158D922C46E0A92417041C9C40770E9,42091,13,23,10,43,46,2196
51358,51358,85E6B4DC96BFA3920E08895C266F386F,13681,1,8,7,38,47,1947
51359,51359,85E6B4DC96BFA3920E08895C266F386F,13121,9,10,1,38,46,1946
51360,51360,85E6B4DC96BFA3920E08895C266F386F,13681,12,16,4,38,47,1947
51361,51361,85E6B4DC96BFA3920E08895C266F386F,13121,17,23,6,38,46,1946
51362,51362,73593D45B177E41853350436B1BE57EF,43161,0,11,11,35,47,1797
51363,51363,73593D45B177E41853350436B1BE57EF,40673,14,18,4,36,48,1848
51364,51364,73593D45B177E41853350436B1BE57EF,43161,19,20,1,35,47,1797
51365,51365,73593D45B177E41853350436B1BE57EF,40951,21,23,2,36,49,1849
51366,51366,14C205DF57BD0AA586E26BE4ED695846,42581,0,14,14,38,48,1948
51367,51367,14C205DF57BD0AA586E26BE4ED695846,11914,14,16,2,37,48,1898
51368,51368,14C205DF57BD0AA586E26BE4ED695846,42581,21,23,2,38,48,1948
51369,51369,2C92D9A1E7726DE0B07E3A3E97221DE4,11491,0,7,7,36,47,1847
51370,51370,2C92D9A1E7726DE0B07E3A3E97221DE4,10161,12,13,1,35,49,1799
51371,51371,2C92D9A1E7726DE0B07E3A3E97221DE4,42301,18,19,1,36,47,1847
51372,51372,2C92D9A1E7726DE0B07E3A3E97221DE4,10107,20,23,3,38,49,1949
51377,51377,88FF5CE18E7F7CBBD7D16D8A3302404F,42491,2,5,3,32,46,1646
51378,51378,88FF5CE18E7F7CBBD7D16D8A3302404F,13601,6,7,1,34,47,1747
51379,51379,88FF5CE18E7F7CBBD7D16D8A3302404F,42523,9,15,6,31,47,1597
51380,51380,88FF5CE18E7F7CBBD7D16D8A3302404F,42641,22,23,1,33,49,1699
51394,51394,FF54487E0B5C80FA4088AB1638FB8194,42581,0,11,11,38,48,1948
51395,51395,FF54487E0B5C80FA4088AB1638FB8194,11914,15,21,6,37,48,1898
51396,51396,FF54487E0B5C80FA4088AB1638FB8194,42581,22,23,1,38,48,1948
51397,51397,82C76E11D915A158FD556BC2A80846B4,10544,6,10,4,28,48,1448
51398,51398,82C76E11D915A158FD556BC2A80846B4,42071,13,14,1,31,49,1599
51399,51399,82C76E11D915A158FD556BC2A80846B4,42121,16,18,2,26,49,1349
51400,51400,6E1487869B5E12737EA94495C079C41B,42231,0,6,6,37,46,1896
51401,51401,6E1487869B5E12737EA94495C079C41B,42351,6,9,3,38,45,1945
51402,51402,6E1487869B5E12737EA94495C079C41B,42231,10,23,13,37,46,1896
51403,51403,2E20B16C1266C4D64D72FF46F0C43B63,42481,1,6,5,22,49,1149
51404,51404,2E20B16C1266C4D64D72FF46F0C43B63,42081,8,11,3,24,49,1249
51405,51405,2E20B16C1266C4D64D72FF46F0C43B63,11641,15,21,6,22,49,1149
51410,51410,227550B71384889A67AC4E901F7C17A1,10151,0,8,8,34,47,1747
51411,51411,227550B71384889A67AC4E901F7C17A1,11861,10,17,7,32,47,1647
51412,51412,227550B71384889A67AC4E901F7C17A1,10151,19,23,4,34,47,1747
51413,51413,9B27AA39D08A4AD4F1A3555FC349C4D1,10341,0,8,8,31,47,1597
51414,51414,9B27AA39D08A4AD4F1A3555FC349C4D1,10292,9,10,1,30,47,1547
51415,51415,9B27AA39D08A4AD4F1A3555FC349C4D1,10341,12,22,10,31,47,1597
51430,51430,33E38F12F8713108E12BCC9991D28568,43621,6,11,5,46,48,2348
51431,51431,33E38F12F8713108E12BCC9991D28568,42461,13,14,1,45,47,2297
51432,51432,33E38F12F8713108E12BCC9991D28568,11701,17,19,2,43,48,2198
51433,51433,C7FD2E7279929E720FB03466CB10E8E1,10841,0,9,9,37,47,1897
51434,51434,C7FD2E7279929E720FB03466CB10E8E1,12514,13,14,1,38,47,1947
51435,51435,C7FD2E7279929E720FB03466CB10E8E1,10841,18,20,2,37,47,1897
51436,51436,C7FD2E7279929E720FB03466CB10E8E1,12514,20,22,2,38,47,1947
51450,51450,CB9FC3FE9195AF3F0A6A77B7B82B22F1,11021,6,7,1,36,49,1849
51451,51451,CB9FC3FE9195AF3F0A6A77B7B82B22F1,42471,9,10,1,35,49,1799
51452,51452,CB9FC3FE9195AF3F0A6A77B7B82B22F1,11591,10,18,8,36,49,1849
51453,51453,3821B66A00758CF4502F36B7CE2D17D9,12491,2,3,1,36,43,1843
51454,51454,3821B66A00758CF4502F36B7CE2D17D9,43451,5,15,10,37,40,1890
51455,51455,3821B66A00758CF4502F36B7CE2D17D9,12491,20,21,1,36,43,1843
51456,51456,715F7A42E71CC3B03C35CCDCAA47978E,12921,0,5,5,9,41,491
51457,51457,715F7A42E71CC3B03C35CCDCAA47978E,12641,7,11,4,10,43,543
51458,51458,715F7A42E71CC3B03C35CCDCAA47978E,12921,12,13,1,9,41,491
51459,51459,715F7A42E71CC3B03C35CCDCAA47978E,12641,17,20,3,10,43,543
51460,51460,E027C6DF2BA6829258B902FDF86E0C52,11914,0,3,3,37,48,1898
51461,51461,E027C6DF2BA6829258B902FDF86E0C52,11921,4,6,2,38,48,1948
51462,51462,E027C6DF2BA6829258B902FDF86E0C52,11914,7,23,16,37,48,1898
51463,51463,92C8015915103969F85C9CE1A5B066AB,11861,0,15,15,32,47,1647
51464,51464,92C8015915103969F85C9CE1A5B066AB,10281,18,20,2,33,48,1698
51465,51465,92C8015915103969F85C9CE1A5B066AB,11861,22,23,1,32,47,1647
51469,51469,EDA2C4329FB051DF0E6F73929F00D19F,11231,2,12,10,37,49,1899
51470,51470,EDA2C4329FB051DF0E6F73929F00D19F,43281,15,16,1,37,48,1898
51471,51471,EDA2C4329FB051DF0E6F73929F00D19F,12083,20,21,1,36,49,1849
51489,51489,309C2EBD6881FB9505C9BCE9119A811B,13731,6,15,9,33,49,1699
51490,51490,309C2EBD6881FB9505C9BCE9119A811B,11954,19,21,2,32,49,1649
51491,51491,309C2EBD6881FB9505C9BCE9119A811B,13731,21,23,2,33,49,1699
51492,51492,6B233920E3ADCD98186EA0225BEE346B,13271,3,7,4,41,47,2097
51493,51493,6B233920E3ADCD98186EA0225BEE346B,13121,9,18,9,38,46,1946
51494,51494,6B233920E3ADCD98186EA0225BEE346B,13271,18,21,3,41,47,2097
51495,51495,6B233920E3ADCD98186EA0225BEE346B,10801,22,23,1,42,47,2147
51496,51496,1DFA47B14F32C6AE13AA4486CBC3E827,42681,0,1,1,24,48,1248
51497,51497,1DFA47B14F32C6AE13AA4486CBC3E827,42081,1,21,20,24,49,1249
51498,51498,1DFA47B14F32C6AE13AA4486CBC3E827,42681,21,22,1,24,48,1248
51499,51499,E859A0BF6FB37F9B42DF06EC7EE8FF9D,42461,0,6,6,45,47,2297
51500,51500,E859A0BF6FB37F9B42DF06EC7EE8FF9D,42321,8,15,7,43,47,2197
51501,51501,E859A0BF6FB37F9B42DF06EC7EE8FF9D,42461,19,23,4,45,47,2297
51507,51507,A300EE82D3804DCD52238D1B3DB8649A,11074,0,8,8,37,47,1897
51508,51508,A300EE82D3804DCD52238D1B3DB8649A,11261,9,12,3,36,46,1846
51509,51509,A300EE82D3804DCD52238D1B3DB8649A,11074,14,19,5,37,47,1897
51510,51510,A300EE82D3804DCD52238D1B3DB8649A,11914,21,22,1,37,48,1898
51511,51511,A18BBFB8111CE9788BEEE3B918FD7EDC,42941,0,7,7,37,47,1897
51512,51512,A18BBFB8111CE9788BEEE3B918FD7EDC,10411,9,16,7,36,48,1848
51513,51513,A18BBFB8111CE9788BEEE3B918FD7EDC,42941,18,22,4,37,47,1897
51523,51523,9D0C016FAC9B03B23F695C0F283D602D,42581,1,14,13,38,48,1948
51524,51524,9D0C016FAC9B03B23F695C0F283D602D,11751,17,18,1,35,48,1798
51525,51525,9D0C016FAC9B03B23F695C0F283D602D,11271,19,20,1,37,48,1898
51526,51526,7158BB5FE54F024DF86B9682428D7D80,10471,0,5,5,37,48,1898
51527,51527,7158BB5FE54F024DF86B9682428D7D80,42581,8,14,6,38,48,1948
51528,51528,7158BB5FE54F024DF86B9682428D7D80,10471,18,20,2,37,48,1898
51536,51536,BEE4B7ECEAE25C94FE4223BC44E1414A,42231,5,6,1,37,46,1896
51537,51537,BEE4B7ECEAE25C94FE4223BC44E1414A,13121,6,9,3,38,46,1946
51538,51538,BEE4B7ECEAE25C94FE4223BC44E1414A,42231,12,14,2,37,46,1896
51539,51539,BEE4B7ECEAE25C94FE4223BC44E1414A,13121,16,21,5,38,46,1946
51540,51540,440A5BC995406F5A39B97937FE6675EC,12641,4,6,2,10,43,543
51541,51541,440A5BC995406F5A39B97937FE6675EC,12921,6,16,10,9,41,491
51542,51542,440A5BC995406F5A39B97937FE6675EC,12641,20,23,3,10,43,543
51543,51543,E6D049947968658F47DDC695A59302A1,42321,0,5,5,43,47,2197
51544,51544,E6D049947968658F47DDC695A59302A1,42461,6,16,10,45,47,2297
51545,51545,E6D049947968658F47DDC695A59302A1,42321,20,23,3,43,47,2197
51549,51549,644074FAED2D07B771DBBC3C2ED7ABF4,43951,7,12,5,49,41,2491
51550,51550,644074FAED2D07B771DBBC3C2ED7ABF4,13411,12,13,1,49,42,2492
51551,51551,644074FAED2D07B771DBBC3C2ED7ABF4,43951,14,20,6,49,41,2491
51552,51552,644074FAED2D07B771DBBC3C2ED7ABF4,13411,20,23,3,49,42,2492
51553,51553,43DBC097DABD3DD07A95B28C32F20D40,13371,0,7,7,41,47,2097
51554,51554,43DBC097DABD3DD07A95B28C32F20D40,11805,8,11,3,41,48,2098
51555,51555,43DBC097DABD3DD07A95B28C32F20D40,13371,12,23,11,41,47,2097
51561,51561,6E198FFF8A0EEA3FE2F6EEE55F7012CE,19114,0,5,5,7,43,393
51562,51562,6E198FFF8A0EEA3FE2F6EEE55F7012CE,12641,5,10,5,10,43,543
51563,51563,6E198FFF8A0EEA3FE2F6EEE55F7012CE,19114,10,23,13,7,43,393
51564,51564,895085FE0B62D7BCDF8725B5DB48E546,43971,0,6,6,30,48,1548
51565,51565,895085FE0B62D7BCDF8725B5DB48E546,11061,6,15,9,29,48,1498
51566,51566,895085FE0B62D7BCDF8725B5DB48E546,43971,15,23,8,30,48,1548
51567,51567,E779DF22EB61C0D4BA72F0FBA1762DF8,11914,7,12,5,37,48,1898
51568,51568,E779DF22EB61C0D4BA72F0FBA1762DF8,40171,15,16,1,38,48,1948
51569,51569,E779DF22EB61C0D4BA72F0FBA1762DF8,10471,16,18,2,37,48,1898
51570,51570,E779DF22EB61C0D4BA72F0FBA1762DF8,42581,19,21,2,38,48,1948
51571,51571,99FFCD965CAA649DA67969C50837B09B,19441,0,6,6,8,46,446
51572,51572,99FFCD965CAA649DA67969C50837B09B,42041,8,9,1,10,47,547
51573,51573,99FFCD965CAA649DA67969C50837B09B,19441,10,23,13,8,46,446
51574,51574,2D7ACF8AD7E4B49F2A7FD23DB75DC6F1,42971,0,6,6,43,49,2199
51575,51575,2D7ACF8AD7E4B49F2A7FD23DB75DC6F1,10921,8,9,1,43,48,2198
51576,51576,2D7ACF8AD7E4B49F2A7FD23DB75DC6F1,11741,9,10,1,42,49,2149
51577,51577,2D7ACF8AD7E4B49F2A7FD23DB75DC6F1,42971,12,23,11,43,49,2199
51578,51578,71C7D3BEB879651EE771977BC4EF34E5,10341,0,6,6,31,47,1597
51579,51579,71C7D3BEB879651EE771977BC4EF34E5,43761,7,21,14,32,47,1647
51580,51580,71C7D3BEB879651EE771977BC4EF34E5,10341,21,23,2,31,47,1597
51581,51581,A655C67D52402CE056E16AFA14815F89,13271,0,4,4,41,47,2097
51582,51582,A655C67D52402CE056E16AFA14815F89,13101,7,8,1,40,47,2047
51583,51583,A655C67D52402CE056E16AFA14815F89,11481,9,17,8,41,48,2098
51584,51584,A655C67D52402CE056E16AFA14815F89,13271,17,22,5,41,47,2097
51585,51585,A8491B4932A74BB29E61F0906E6D23DE,42461,0,5,5,45,47,2297
51586,51586,A8491B4932A74BB29E61F0906E6D23DE,42111,14,16,2,44,46,2246
51587,51587,A8491B4932A74BB29E61F0906E6D23DE,42461,16,18,2,45,47,2297
51588,51588,697EB06F67653D08CFE9378AC3AAB5E4,11001,0,9,9,42,47,2147
51589,51589,697EB06F67653D08CFE9378AC3AAB5E4,13941,14,18,4,41,47,2097
51590,51590,697EB06F67653D08CFE9378AC3AAB5E4,11001,20,23,3,42,47,2147
51591,51591,AE931B79E80BF3CFA2F48EF7F9685CA5,11261,5,16,11,36,46,1846
51592,51592,AE931B79E80BF3CFA2F48EF7F9685CA5,13911,17,18,1,39,46,1996
51593,51593,AE931B79E80BF3CFA2F48EF7F9685CA5,11261,19,21,2,36,46,1846
51602,51602,4ABA99D6A62884CB0B8CB2A0246467C6,13121,0,7,7,38,46,1946
51603,51603,4ABA99D6A62884CB0B8CB2A0246467C6,11081,8,13,5,35,46,1796
51604,51604,4ABA99D6A62884CB0B8CB2A0246467C6,12514,18,19,1,38,47,1947
51625,51625,83BB102D42B106B02532A9E858086CAC,11061,0,2,2,29,48,1498
51626,51626,83BB102D42B106B02532A9E858086CAC,10681,2,3,1,30,48,1548
51627,51627,83BB102D42B106B02532A9E858086CAC,11061,3,22,19,29,48,1498
51628,51628,8F79DEBEC2513ED357831F892A2CF021,11541,0,6,6,35,49,1799
51629,51629,8F79DEBEC2513ED357831F892A2CF021,11021,16,18,2,36,49,1849
51630,51630,8F79DEBEC2513ED357831F892A2CF021,11541,21,23,2,35,49,1799
51643,51643,ED1B197D1A6AAA8BFAE9A2A66FB2A911,19181,0,6,6,8,40,440
51644,51644,ED1B197D1A6AAA8BFAE9A2A66FB2A911,49201,8,16,8,7,41,391
51645,51645,ED1B197D1A6AAA8BFAE9A2A66FB2A911,12921,19,22,3,9,41,491
51651,51651,9B13D95106A4BC5C142691820306BA23,12514,0,15,15,38,47,1947
51652,51652,9B13D95106A4BC5C142691820306BA23,10841,16,17,1,37,47,1897
51653,51653,9B13D95106A4BC5C142691820306BA23,12514,19,22,3,38,47,1947
51654,51654,700A8469B8648E235281334EF5CC8DA1,10371,0,9,9,37,49,1899
51655,51655,700A8469B8648E235281334EF5CC8DA1,10471,9,10,1,37,48,1898
51656,51656,700A8469B8648E235281334EF5CC8DA1,11231,10,23,13,37,49,1899
51663,51663,B0E329B00E3FA297B870177AA9BA63AC,42141,0,8,8,32,47,1647
51664,51664,B0E329B00E3FA297B870177AA9BA63AC,42523,8,9,1,31,47,1597
51665,51665,B0E329B00E3FA297B870177AA9BA63AC,43761,16,17,1,32,47,1647
51666,51666,B0E329B00E3FA297B870177AA9BA63AC,10281,21,23,2,33,48,1698
51680,51680,508DF001F529FBF83DF8D4A342350BFA,42861,0,5,5,37,44,1894
51681,51681,508DF001F529FBF83DF8D4A342350BFA,11261,9,12,3,36,46,1846
51682,51682,508DF001F529FBF83DF8D4A342350BFA,42861,17,18,1,37,44,1894
51683,51683,508DF001F529FBF83DF8D4A342350BFA,11261,21,22,1,36,46,1846
51701,51701,8FD8A2625A535E652B355D27B5B6AB25,13121,0,15,15,38,46,1946
51702,51702,8FD8A2625A535E652B355D27B5B6AB25,12021,17,20,3,37,49,1899
51703,51703,8FD8A2625A535E652B355D27B5B6AB25,13121,20,22,2,38,46,1946
51707,51707,75FABF5E0D5E0E03C82CE19A7C98A3F7,10221,9,12,3,34,49,1749
51708,51708,75FABF5E0D5E0E03C82CE19A7C98A3F7,43581,12,14,2,33,48,1698
51709,51709,75FABF5E0D5E0E03C82CE19A7C98A3F7,10221,14,18,4,34,49,1749
51718,51718,4D0E6BC8FFC2074F1438B051D586C0DA,13651,6,7,1,30,47,1547
51719,51719,4D0E6BC8FFC2074F1438B051D586C0DA,11061,8,9,1,29,48,1498
51720,51720,4D0E6BC8FFC2074F1438B051D586C0DA,11381,14,20,6,30,47,1547
51721,51721,939FA949AB60EC8B412E25FA33D74BE6,11491,0,6,6,36,47,1847
51722,51722,939FA949AB60EC8B412E25FA33D74BE6,13121,7,9,2,38,46,1946
51723,51723,939FA949AB60EC8B412E25FA33D74BE6,11491,13,18,5,36,47,1847
51724,51724,939FA949AB60EC8B412E25FA33D74BE6,10107,20,21,1,38,49,1949
51725,51725,394B81CC36B31D897120A6153D7C1457,11061,0,3,3,29,48,1498
51726,51726,394B81CC36B31D897120A6153D7C1457,12121,6,17,11,29,47,1497
51727,51727,394B81CC36B31D897120A6153D7C1457,11061,22,23,1,29,48,1498
51733,51733,303626C6E95A1B9EBF7351AEEA69D0DF,13271,0,2,2,41,47,2097
51734,51734,303626C6E95A1B9EBF7351AEEA69D0DF,10601,2,10,8,39,47,1997
51735,51735,303626C6E95A1B9EBF7351AEEA69D0DF,11031,19,21,2,42,49,2149
51736,51736,4560AA6E9FF5488D13E472C26129D09F,42511,1,5,4,37,47,1897
51737,51737,4560AA6E9FF5488D13E472C26129D09F,12514,5,10,5,38,47,1947
51738,51738,4560AA6E9FF5488D13E472C26129D09F,42511,14,20,6,37,47,1897
51739,51739,9063D9BC124B90056525B5B4C08304A4,13111,0,15,15,42,46,2146
51740,51740,9063D9BC124B90056525B5B4C08304A4,42461,16,18,2,45,47,2297
51741,51741,9063D9BC124B90056525B5B4C08304A4,13111,21,23,2,42,46,2146
51747,51747,BAAEF1F815128F9C42A2F609EF6E43D2,10151,0,14,14,34,47,1747
51748,51748,BAAEF1F815128F9C42A2F609EF6E43D2,42161,17,18,1,36,47,1847
51749,51749,BAAEF1F815128F9C42A2F609EF6E43D2,10511,19,20,1,35,46,1796
51750,51750,BAAEF1F815128F9C42A2F609EF6E43D2,13601,20,22,2,34,47,1747
51751,51751,CF7D34E0CAAC53341408143F5EE5A475,10951,2,4,2,29,48,1498
51752,51752,CF7D34E0CAAC53341408143F5EE5A475,40331,6,7,1,30,47,1547
51753,51753,CF7D34E0CAAC53341408143F5EE5A475,10951,8,10,2,29,48,1498
51754,51754,CF7D34E0CAAC53341408143F5EE5A475,40331,12,19,7,30,47,1547
51755,51755,17AEFEF657B11D131BDD3C3B66C9A042,42011,0,8,8,36,46,1846
51756,51756,17AEFEF657B11D131BDD3C3B66C9A042,10271,12,18,6,37,46,1896
51757,51757,17AEFEF657B11D131BDD3C3B66C9A042,42011,19,20,1,36,46,1846
51781,51781,84C4203DC7777E0973D17ADA3B6E2922,13371,2,5,3,41,47,2097
51782,51782,84C4203DC7777E0973D17ADA3B6E2922,42321,5,6,1,43,47,2197
51783,51783,84C4203DC7777E0973D17ADA3B6E2922,13941,6,23,17,41,47,2097
51784,51784,99215A6EE9EE45501EC0F8414BE04C65,19441,0,11,11,8,46,446
51785,51785,99215A6EE9EE45501EC0F8414BE04C65,42041,11,12,1,10,47,547
51786,51786,99215A6EE9EE45501EC0F8414BE04C65,19441,15,23,8,8,46,446
51790,51790,0AFAF8C12B0A136F334DBF2EEFFABEC7,10251,0,7,7,35,47,1797
51791,51791,0AFAF8C12B0A136F334DBF2EEFFABEC7,42161,8,20,12,36,47,1847
51792,51792,0AFAF8C12B0A136F334DBF2EEFFABEC7,10411,20,22,2,36,48,1848
51796,51796,7FD9072832AAE29AE2915CDEF233B942,10801,0,4,4,42,47,2147
51797,51797,7FD9072832AAE29AE2915CDEF233B942,42321,8,17,9,43,47,2197
51798,51798,7FD9072832AAE29AE2915CDEF233B942,10801,18,22,4,42,47,2147
51799,51799,72EE059838FC074BF0955787969E7967,11231,0,4,4,37,49,1899
51800,51800,72EE059838FC074BF0955787969E7967,11911,4,19,15,37,48,1898
51801,51801,72EE059838FC074BF0955787969E7967,10371,19,23,4,37,49,1899
51805,51805,43857F135F7541B4685E34097E43A46E,12921,0,3,3,9,41,491
51806,51806,43857F135F7541B4685E34097E43A46E,12641,3,20,17,10,43,543
51807,51807,43857F135F7541B4685E34097E43A46E,12921,22,23,1,9,41,491
51812,51812,8E8831CA308168F585F32EA6A4F05D47,12121,2,12,10,29,47,1497
51813,51813,8E8831CA308168F585F32EA6A4F05D47,40381,15,16,1,32,46,1646
51814,51814,8E8831CA308168F585F32EA6A4F05D47,12121,17,23,6,29,47,1497
51815,51815,FD26A6D5BBA5F38876B2DAAB4BBFF5D0,11061,9,12,3,29,48,1498
51816,51816,FD26A6D5BBA5F38876B2DAAB4BBFF5D0,12121,12,21,9,29,47,1497
51817,51817,FD26A6D5BBA5F38876B2DAAB4BBFF5D0,42523,22,23,1,31,47,1597
51818,51818,8167EF05D15F996A6B93D96BD3E78468,10521,0,11,11,41,47,2097
51819,51819,8167EF05D15F996A6B93D96BD3E78468,43481,12,13,1,39,48,1998
51820,51820,8167EF05D15F996A6B93D96BD3E78468,42271,14,17,3,40,47,2047
51821,51821,8167EF05D15F996A6B93D96BD3E78468,43481,18,19,1,39,48,1998
51822,51822,B7E1FA8163F9E5C37489B32682514507,10295,0,11,11,30,47,1547
51823,51823,B7E1FA8163F9E5C37489B32682514507,42523,12,13,1,31,47,1597
51824,51824,B7E1FA8163F9E5C37489B32682514507,10295,14,18,4,30,47,1547
51829,51829,DDF363C64B8F6ACF3450F0B1AA087EA1,19441,0,17,17,8,46,446
51830,51830,DDF363C64B8F6ACF3450F0B1AA087EA1,19114,19,20,1,7,43,393
51831,51831,DDF363C64B8F6ACF3450F0B1AA087EA1,19441,22,23,1,8,46,446
51837,51837,E940BE4D41CC0CB4C8FE35BF5D7A199F,13101,0,8,8,40,47,2047
51838,51838,E940BE4D41CC0CB4C8FE35BF5D7A199F,42031,11,12,1,40,46,2046
51839,51839,E940BE4D41CC0CB4C8FE35BF5D7A199F,11481,13,15,2,41,48,2098
51840,51840,E940BE4D41CC0CB4C8FE35BF5D7A199F,13101,16,18,2,40,47,2047
51844,51844,9F7BD4B191C6CDB262073FE9BC5F12C5,13651,0,1,1,30,47,1547
51845,51845,9F7BD4B191C6CDB262073FE9BC5F12C5,11061,3,4,1,29,48,1498
51846,51846,9F7BD4B191C6CDB262073FE9BC5F12C5,13651,5,23,18,30,47,1547
51851,51851,8E0D20320C5276BDD797BA6D65B9C51D,11074,0,7,7,37,47,1897
51852,51852,8E0D20320C5276BDD797BA6D65B9C51D,11231,10,16,6,37,49,1899
51853,51853,8E0D20320C5276BDD797BA6D65B9C51D,11074,19,22,3,37,47,1897
51854,51854,A6555ADD1FDD22671BB225447AB03AF9,19744,1,2,1,6,43,343
51855,51855,A6555ADD1FDD22671BB225447AB03AF9,12641,5,16,11,10,43,543
51856,51856,A6555ADD1FDD22671BB225447AB03AF9,19931,18,19,1,7,43,393
51857,51857,A6555ADD1FDD22671BB225447AB03AF9,19901,20,21,1,7,44,394
51866,51866,5D3AB87CDE152EA5E956E4DDC06AC59B,40171,0,13,13,38,48,1948
51867,51867,5D3AB87CDE152EA5E956E4DDC06AC59B,10471,14,15,1,37,48,1898
51868,51868,5D3AB87CDE152EA5E956E4DDC06AC59B,42581,17,23,6,38,48,1948
51869,51869,C35D795DA33BE0311413852FD4760F3A,11261,0,18,18,36,46,1846
51870,51870,C35D795DA33BE0311413852FD4760F3A,13911,19,21,2,39,46,1996
51871,51871,C35D795DA33BE0311413852FD4760F3A,11261,21,23,2,36,46,1846
51877,51877,511248B31413344B77C12D74A5EE7CDF,43471,0,6,6,31,49,1599
51878,51878,511248B31413344B77C12D74A5EE7CDF,11151,11,19,8,30,48,1548
51879,51879,511248B31413344B77C12D74A5EE7CDF,40872,20,23,3,30,49,1549
51880,51880,164DF51AA6ED954014D50FCEFF961260,19904,0,5,5,9,44,494
51881,51881,164DF51AA6ED954014D50FCEFF961260,19021,8,10,2,10,45,545
51882,51882,164DF51AA6ED954014D50FCEFF961260,12641,10,18,8,10,43,543
51883,51883,DA48F6EEC4784B4505CA1BBB58EA121A,10292,6,12,6,30,47,1547
51884,51884,DA48F6EEC4784B4505CA1BBB58EA121A,10341,12,14,2,31,47,1597
51885,51885,DA48F6EEC4784B4505CA1BBB58EA121A,10292,14,23,9,30,47,1547
51889,51889,208B57C758C5786CB2BCCDDB8DCE6703,42141,0,15,15,32,47,1647
51890,51890,208B57C758C5786CB2BCCDDB8DCE6703,40331,15,16,1,30,47,1547
51891,51891,208B57C758C5786CB2BCCDDB8DCE6703,11861,18,21,3,32,47,1647
51892,51892,FA584217376E1ED7E1BDEF3FE9A645C6,11271,7,10,3,37,48,1898
51893,51893,FA584217376E1ED7E1BDEF3FE9A645C6,42581,11,13,2,38,48,1948
51894,51894,FA584217376E1ED7E1BDEF3FE9A645C6,11271,16,18,2,37,48,1898
51895,51895,FA584217376E1ED7E1BDEF3FE9A645C6,42581,22,23,1,38,48,1948
51919,51919,E45E3AA86D4C7662B7021B0B55258130,40277,0,10,10,35,49,1799
51920,51920,E45E3AA86D4C7662B7021B0B55258130,11081,15,16,1,35,46,1796
51921,51921,E45E3AA86D4C7662B7021B0B55258130,10161,16,19,3,35,49,1799
51922,51922,0933B06061F8F3536F06AEF0D300106F,11941,0,6,6,37,46,1896
51923,51923,0933B06061F8F3536F06AEF0D300106F,13711,7,18,11,38,46,1946
51924,51924,0933B06061F8F3536F06AEF0D300106F,11941,18,21,3,37,46,1896
51925,51925,4A7E0C26D094908459DFDB4A502F3938,42161,0,14,14,36,47,1847
51926,51926,4A7E0C26D094908459DFDB4A502F3938,10111,16,18,2,37,47,1897
51927,51927,4A7E0C26D094908459DFDB4A502F3938,42161,18,23,5,36,47,1847
51928,51928,89084C54499EDD168F6753B4E522A173,42581,2,14,12,38,48,1948
51929,51929,89084C54499EDD168F6753B4E522A173,12514,17,18,1,38,47,1947
51930,51930,89084C54499EDD168F6753B4E522A173,42581,21,22,1,38,48,1948
51931,51931,AB344DE4B941A811FEF62BEEA16971A6,43471,0,7,7,31,49,1599
51932,51932,AB344DE4B941A811FEF62BEEA16971A6,12971,7,8,1,32,48,1648
51933,51933,AB344DE4B941A811FEF62BEEA16971A6,10731,13,17,4,33,47,1697
51934,51934,AB344DE4B941A811FEF62BEEA16971A6,43471,17,23,6,31,49,1599
51951,51951,E46021F2EBB1FF86CE07D74A4E5B9C9F,12921,0,5,5,9,41,491
51952,51952,E46021F2EBB1FF86CE07D74A4E5B9C9F,49201,7,11,4,7,41,391
51953,51953,E46021F2EBB1FF86CE07D74A4E5B9C9F,12921,12,15,3,9,41,491
51954,51954,E46021F2EBB1FF86CE07D74A4E5B9C9F,49201,16,21,5,7,41,391
51955,51955,69E543DFF7ABD4903EB302CAAC6962DA,11921,0,7,7,38,48,1948
51956,51956,69E543DFF7ABD4903EB302CAAC6962DA,11591,11,15,4,36,49,1849
51957,51957,69E543DFF7ABD4903EB302CAAC6962DA,11921,19,21,2,38,48,1948
51969,51969,6EBC343B289E845421579091E3F37018,42091,1,6,5,43,46,2196
51970,51970,6EBC343B289E845421579091E3F37018,42321,12,14,2,43,47,2197
51971,51971,6EBC343B289E845421579091E3F37018,13791,14,17,3,42,47,2147
51972,51972,6EBC343B289E845421579091E3F37018,42091,21,23,2,43,46,2196
51973,51973,DF460CBD4C09A51D06C2038FDA368680,42041,1,4,3,10,47,547
51974,51974,DF460CBD4C09A51D06C2038FDA368680,19441,6,7,1,8,46,446
51975,51975,DF460CBD4C09A51D06C2038FDA368680,42041,9,12,3,10,47,547
51976,51976,DF460CBD4C09A51D06C2038FDA368680,19441,16,20,4,8,46,446
51981,51981,6044840CFD66768767F795D814077A8F,10271,0,4,4,37,46,1896
51982,51982,6044840CFD66768767F795D814077A8F,13121,8,14,6,38,46,1946
51983,51983,6044840CFD66768767F795D814077A8F,10271,16,21,5,37,46,1896
51984,51984,4DFCA00DE8A1EE33D561C65FAD863DDF,10951,0,6,6,29,48,1498
51985,51985,4DFCA00DE8A1EE33D561C65FAD863DDF,11381,6,8,2,30,47,1547
51986,51986,4DFCA00DE8A1EE33D561C65FAD863DDF,10951,10,11,1,29,48,1498
51987,51987,4DFCA00DE8A1EE33D561C65FAD863DDF,11381,12,20,8,30,47,1547
51994,51994,AB35C432DC3D59E7929F031635A675AA,10501,1,2,1,22,46,1146
51995,51995,AB35C432DC3D59E7929F031635A675AA,12601,3,15,12,25,47,1297
51996,51996,AB35C432DC3D59E7929F031635A675AA,10061,17,18,1,20,46,1046
51997,51997,AB35C432DC3D59E7929F031635A675AA,12601,19,23,4,25,47,1297
52019,52019,853A16C8E6E154D13F9864F752CCB2E5,13101,3,4,1,40,47,2047
52020,52020,853A16C8E6E154D13F9864F752CCB2E5,13271,8,9,1,41,47,2097
52021,52021,853A16C8E6E154D13F9864F752CCB2E5,13101,9,23,14,40,47,2047
52036,52036,973CBB8ACF14D70BBBAD8D3118A4D55F,43061,0,10,10,43,46,2196
52037,52037,973CBB8ACF14D70BBBAD8D3118A4D55F,11701,10,11,1,43,48,2198
52038,52038,973CBB8ACF14D70BBBAD8D3118A4D55F,42601,13,15,2,44,48,2248
52039,52039,973CBB8ACF14D70BBBAD8D3118A4D55F,42091,18,22,4,43,46,2196
52040,52040,0045D13BE8E4DDAB53C0085B23256BBF,11111,0,6,6,26,48,1348
52041,52041,0045D13BE8E4DDAB53C0085B23256BBF,12601,8,19,11,25,47,1297
52042,52042,0045D13BE8E4DDAB53C0085B23256BBF,10171,21,23,2,26,47,1347
52046,52046,7C5210855A5DFB6ACF7A087ADA0E2F3D,42351,1,2,1,38,45,1945
52047,52047,7C5210855A5DFB6ACF7A087ADA0E2F3D,13911,3,6,3,39,46,1996
52048,52048,7C5210855A5DFB6ACF7A087ADA0E2F3D,42231,6,9,3,37,46,1896
52049,52049,7C5210855A5DFB6ACF7A087ADA0E2F3D,13911,13,23,10,39,46,1996
52050,52050,053138E4DD06C9756C34D015D055BBCE,10681,1,4,3,30,48,1548
52051,52051,053138E4DD06C9756C34D015D055BBCE,11061,9,12,3,29,48,1498
52052,52052,053138E4DD06C9756C34D015D055BBCE,10681,16,18,2,30,48,1548
52058,52058,0BC1BC9FA127A76D4558FF0A0EC8FEFB,42921,0,6,6,33,47,1697
52059,52059,0BC1BC9FA127A76D4558FF0A0EC8FEFB,10281,8,9,1,33,48,1698
52060,52060,0BC1BC9FA127A76D4558FF0A0EC8FEFB,42921,13,23,10,33,47,1697
52065,52065,17A4E00C733F721F255B23A4DF169A99,10491,0,12,12,33,48,1698
52066,52066,17A4E00C733F721F255B23A4DF169A99,10611,13,14,1,32,48,1648
52067,52067,17A4E00C733F721F255B23A4DF169A99,11381,14,23,9,30,47,1547
52073,52073,6947BD8C9EBED5217B88529152FD3051,42151,0,7,7,35,45,1795
52074,52074,6947BD8C9EBED5217B88529152FD3051,12491,8,12,4,36,43,1843
52075,52075,6947BD8C9EBED5217B88529152FD3051,42151,14,22,8,35,45,1795
52076,52076,FCC81FB1D89F2E284C3312E5101F2149,42151,0,4,4,35,45,1795
52077,52077,FCC81FB1D89F2E284C3312E5101F2149,42861,4,6,2,37,44,1894
52078,52078,FCC81FB1D89F2E284C3312E5101F2149,42151,8,14,6,35,45,1795
52079,52079,FCC81FB1D89F2E284C3312E5101F2149,42861,16,20,4,37,44,1894
52080,52080,0A1386913DE713CBA72662A5149627A3,13711,0,14,14,38,46,1946
52081,52081,0A1386913DE713CBA72662A5149627A3,11941,19,21,2,37,46,1896
52082,52082,0A1386913DE713CBA72662A5149627A3,13711,21,23,2,38,46,1946
52083,52083,7681E0D68D024C184A5D43D46389C591,42021,0,12,12,33,47,1697
52084,52084,7681E0D68D024C184A5D43D46389C591,11861,13,20,7,32,47,1647
52085,52085,7681E0D68D024C184A5D43D46389C591,42921,21,23,2,33,47,1697
52086,52086,1B07591FD91BB6CC4456958534AA55B3,10271,0,9,9,37,46,1896
52087,52087,1B07591FD91BB6CC4456958534AA55B3,10841,9,10,1,37,47,1897
52088,52088,1B07591FD91BB6CC4456958534AA55B3,10271,11,14,3,37,46,1896
52089,52089,1B07591FD91BB6CC4456958534AA55B3,42161,15,23,8,36,47,1847
52090,52090,ED36A592544F9D3B4DC283835B5C723A,11481,8,15,7,41,48,2098
52091,52091,ED36A592544F9D3B4DC283835B5C723A,13101,16,18,2,40,47,2047
52092,52092,ED36A592544F9D3B4DC283835B5C723A,11481,19,23,4,41,48,2098
52096,52096,66A1757BF5A4116BA4BCC483D90F56EF,42231,0,14,14,37,46,1896
52097,52097,66A1757BF5A4116BA4BCC483D90F56EF,42351,17,18,1,38,45,1945
52098,52098,66A1757BF5A4116BA4BCC483D90F56EF,42231,18,23,5,37,46,1896
52104,52104,C96AF7724AE07D1D1BE56C246C9FE7FC,13341,0,14,14,44,45,2245
52105,52105,C96AF7724AE07D1D1BE56C246C9FE7FC,42631,14,16,2,43,45,2195
52106,52106,C96AF7724AE07D1D1BE56C246C9FE7FC,13341,20,21,1,44,45,2245
52113,52113,C70FF977FA3BD2286D57535D98EFE336,10111,0,8,8,37,47,1897
52114,52114,C70FF977FA3BD2286D57535D98EFE336,42161,8,18,10,36,47,1847
52115,52115,C70FF977FA3BD2286D57535D98EFE336,10111,19,22,3,37,47,1897
52116,52116,F9B50F8C0BC548F341BD45D3142A9731,43671,0,8,8,35,48,1798
52117,52117,F9B50F8C0BC548F341BD45D3142A9731,10221,10,15,5,34,49,1749
52118,52118,F9B50F8C0BC548F341BD45D3142A9731,43671,16,22,6,35,48,1798
52150,52150,8CD5156CF883DA15618BAFE58DDCF2A7,42581,0,5,5,38,48,1948
52151,52151,8CD5156CF883DA15618BAFE58DDCF2A7,11914,6,8,2,37,48,1898
52152,52152,8CD5156CF883DA15618BAFE58DDCF2A7,42581,8,23,15,38,48,1948
52188,52188,3D4D278B3D58167073B4ACCB11432DB2,13094,0,3,3,21,42,1092
52189,52189,3D4D278B3D58167073B4ACCB11432DB2,12671,6,17,11,21,43,1093
52190,52190,3D4D278B3D58167073B4ACCB11432DB2,13091,20,21,1,20,42,1042
52196,52196,7F4342DFDF3B17AEEB7219197E15E7BE,10251,1,9,8,35,47,1797
52197,52197,7F4342DFDF3B17AEEB7219197E15E7BE,11861,12,13,1,32,47,1647
52198,52198,7F4342DFDF3B17AEEB7219197E15E7BE,42401,13,15,2,36,47,1847
52199,52199,7F4342DFDF3B17AEEB7219197E15E7BE,11861,15,22,7,32,47,1647
52205,52205,91FB7E11CCB9539E71578F3DFA4AFBA7,19181,0,1,1,8,40,440
52206,52206,91FB7E11CCB9539E71578F3DFA4AFBA7,49201,2,15,13,7,41,391
52207,52207,91FB7E11CCB9539E71578F3DFA4AFBA7,19181,17,22,5,8,40,440
52208,52208,11D0C3BFA1EEA48E71CAB72BD84A5D2F,10351,0,1,1,28,45,1445
52209,52209,11D0C3BFA1EEA48E71CAB72BD84A5D2F,13671,4,6,2,27,43,1393
52210,52210,11D0C3BFA1EEA48E71CAB72BD84A5D2F,10351,6,8,2,28,45,1445
52211,52211,11D0C3BFA1EEA48E71CAB72BD84A5D2F,10711,12,20,8,29,46,1496
52216,52216,E45B0EC44E00842EDD865C65A561543D,10471,8,11,3,37,48,1898
52217,52217,E45B0EC44E00842EDD865C65A561543D,11231,11,15,4,37,49,1899
52218,52218,E45B0EC44E00842EDD865C65A561543D,10471,16,18,2,37,48,1898
52219,52219,E45B0EC44E00842EDD865C65A561543D,11231,20,22,2,37,49,1899
52224,52224,F65E3BB6EC86C48CCE482A30FA9EC6F6,11091,8,9,1,29,47,1497
52225,52225,F65E3BB6EC86C48CCE482A30FA9EC6F6,42521,10,12,2,31,47,1597
52226,52226,F65E3BB6EC86C48CCE482A30FA9EC6F6,40112,12,13,1,32,48,1648
52227,52227,F65E3BB6EC86C48CCE482A30FA9EC6F6,11324,16,20,4,31,46,1596
52228,52228,F004825C5EEC7F8B7A184D4985895C55,13341,5,7,2,44,45,2245
52229,52229,F004825C5EEC7F8B7A184D4985895C55,42631,8,16,8,43,45,2195
52230,52230,F004825C5EEC7F8B7A184D4985895C55,13341,18,20,2,44,45,2245
52234,52234,5B7CA3A3B8568D19F1FF7908AEEC1A02,42531,0,4,4,31,45,1595
52235,52235,5B7CA3A3B8568D19F1FF7908AEEC1A02,11875,7,11,4,30,46,1546
52236,52236,5B7CA3A3B8568D19F1FF7908AEEC1A02,12311,14,18,4,30,44,1544
52237,52237,2FC977AAECB05F28AE0C53353C4DD1FC,13121,0,6,6,38,46,1946
52238,52238,2FC977AAECB05F28AE0C53353C4DD1FC,10271,6,19,13,37,46,1896
52239,52239,2FC977AAECB05F28AE0C53353C4DD1FC,13121,22,23,1,38,46,1946
52240,52240,9552ADEB6DCDC64B46CF1570AC45DA60,13411,3,4,1,49,42,2492
52241,52241,9552ADEB6DCDC64B46CF1570AC45DA60,43951,6,20,14,49,41,2491
52242,52242,9552ADEB6DCDC64B46CF1570AC45DA60,13411,21,22,1,49,42,2492
52243,52243,03807BDFECD796862E0B81DEAB9E0723,11131,3,14,11,33,48,1698
52244,52244,03807BDFECD796862E0B81DEAB9E0723,42161,14,17,3,36,47,1847
52245,52245,03807BDFECD796862E0B81DEAB9E0723,11131,17,23,6,33,48,1698
52251,52251,0C2B805EE888E91F034AB21F925F07C4,12641,9,12,3,10,43,543
52252,52252,0C2B805EE888E91F034AB21F925F07C4,19114,12,13,1,7,43,393
52253,52253,0C2B805EE888E91F034AB21F925F07C4,19901,13,15,2,7,44,394
52254,52254,0C2B805EE888E91F034AB21F925F07C4,12641,16,21,5,10,43,543
52297,52297,B4259326ECC267D7C02CA8515B349769,11021,0,3,3,36,49,1849
52298,52298,B4259326ECC267D7C02CA8515B349769,13511,11,18,7,34,48,1748
52299,52299,B4259326ECC267D7C02CA8515B349769,11201,20,21,1,35,49,1799
52300,52300,0E1208E76DAA7EDCAA41CA6CF6A73776,11381,0,11,11,30,47,1547
52301,52301,0E1208E76DAA7EDCAA41CA6CF6A73776,11061,11,13,2,29,48,1498
52302,52302,0E1208E76DAA7EDCAA41CA6CF6A73776,11381,13,23,10,30,47,1547
52316,52316,29B536EE93C2E266619D50C15F53EE29,42531,0,5,5,31,45,1595
52317,52317,29B536EE93C2E266619D50C15F53EE29,12311,7,11,4,30,44,1544
52318,52318,29B536EE93C2E266619D50C15F53EE29,42531,11,18,7,31,45,1595
52319,52319,29B536EE93C2E266619D50C15F53EE29,12311,18,21,3,30,44,1544
52324,52324,C3385B266A5088A7FA48BCC62DFDD003,11914,0,4,4,37,48,1898
52325,52325,C3385B266A5088A7FA48BCC62DFDD003,40171,6,13,7,38,48,1948
52326,52326,C3385B266A5088A7FA48BCC62DFDD003,42191,14,16,2,38,49,1949
52327,52327,C3385B266A5088A7FA48BCC62DFDD003,40171,20,21,1,38,48,1948
52328,52328,60DB2F1E5C63BE640D47B87EE3CFB05B,42461,0,6,6,45,47,2297
52329,52329,60DB2F1E5C63BE640D47B87EE3CFB05B,42321,10,15,5,43,47,2197
52330,52330,60DB2F1E5C63BE640D47B87EE3CFB05B,42461,19,23,4,45,47,2297
52355,52355,3F7BFF26419AB43EAAC9D4DF4B7C2705,42301,0,5,5,36,47,1847
52356,52356,3F7BFF26419AB43EAAC9D4DF4B7C2705,42151,7,17,10,35,45,1795
52357,52357,3F7BFF26419AB43EAAC9D4DF4B7C2705,42301,19,23,4,36,47,1847
52368,52368,449E7811DCD6E8CD500501049B5A906E,13231,0,4,4,39,46,1996
52369,52369,449E7811DCD6E8CD500501049B5A906E,11261,6,7,1,36,46,1846
52370,52370,449E7811DCD6E8CD500501049B5A906E,13911,11,16,5,39,46,1996
52371,52371,449E7811DCD6E8CD500501049B5A906E,11261,20,22,2,36,46,1846
52390,52390,065D89FD95640CBD7977FF2633652773,42531,7,11,4,31,45,1595
52391,52391,065D89FD95640CBD7977FF2633652773,10351,12,13,1,28,45,1445
52392,52392,065D89FD95640CBD7977FF2633652773,42531,15,23,8,31,45,1595
52401,52401,628C7824651436AFEE1874B5B2874BA1,10711,2,5,3,29,46,1496
52402,52402,628C7824651436AFEE1874B5B2874BA1,10351,8,13,5,28,45,1445
52403,52403,628C7824651436AFEE1874B5B2874BA1,10711,14,15,1,29,46,1496
52404,52404,628C7824651436AFEE1874B5B2874BA1,10351,18,23,5,28,45,1445
52417,52417,C404F60AD0A2D6862A45A9C320EEAB5F,11261,0,6,6,36,46,1846
52418,52418,C404F60AD0A2D6862A45A9C320EEAB5F,42861,9,11,2,37,44,1894
52419,52419,C404F60AD0A2D6862A45A9C320EEAB5F,42864,14,15,1,38,44,1944
52420,52420,C404F60AD0A2D6862A45A9C320EEAB5F,11261,20,21,1,36,46,1846
52427,52427,21214DF25ABBFE57C13DD19922691751,13911,0,7,7,39,46,1996
52428,52428,21214DF25ABBFE57C13DD19922691751,11261,10,20,10,36,46,1846
52429,52429,21214DF25ABBFE57C13DD19922691751,13911,22,23,1,39,46,1996
52430,52430,14221EE63F6EE55805EE5B3069F379DA,11914,1,5,4,37,48,1898
52431,52431,14221EE63F6EE55805EE5B3069F379DA,42581,5,18,13,38,48,1948
52432,52432,14221EE63F6EE55805EE5B3069F379DA,11914,20,21,1,37,48,1898
52433,52433,1C752316BF3BA3B641D891EF9B0BCA45,13711,1,6,5,38,46,1946
52434,52434,1C752316BF3BA3B641D891EF9B0BCA45,10271,9,11,2,37,46,1896
52435,52435,1C752316BF3BA3B641D891EF9B0BCA45,13711,14,20,6,38,46,1946
52436,52436,1C752316BF3BA3B641D891EF9B0BCA45,10271,20,23,3,37,46,1896
52437,52437,0781E535CBB143640477269330BEC7EE,42161,0,7,7,36,47,1847
52438,52438,0781E535CBB143640477269330BEC7EE,40411,8,9,1,34,48,1748
52439,52439,0781E535CBB143640477269330BEC7EE,10221,10,12,2,34,49,1749
52440,52440,0781E535CBB143640477269330BEC7EE,40411,15,18,3,34,48,1748
52458,52458,6DDEE1FE5DEAA10574D4FF4CB295DF53,13711,0,7,7,38,46,1946
52459,52459,6DDEE1FE5DEAA10574D4FF4CB295DF53,10271,8,10,2,37,46,1896
52460,52460,6DDEE1FE5DEAA10574D4FF4CB295DF53,13711,12,15,3,38,46,1946
52461,52461,6DDEE1FE5DEAA10574D4FF4CB295DF53,42941,19,20,1,37,47,1897
52476,52476,A19E3763AF6D1AE648298A93AD871A9C,10161,10,18,8,35,49,1799
52477,52477,A19E3763AF6D1AE648298A93AD871A9C,43161,19,21,2,35,47,1797
52478,52478,A19E3763AF6D1AE648298A93AD871A9C,40925,22,23,1,35,49,1799
52499,52499,2DC21D8E880037CF338AA2F08717310D,10251,0,5,5,35,47,1797
52500,52500,2DC21D8E880037CF338AA2F08717310D,10491,8,12,4,33,48,1698
52501,52501,2DC21D8E880037CF338AA2F08717310D,10251,15,16,1,35,47,1797
52502,52502,2DC21D8E880037CF338AA2F08717310D,42161,18,20,2,36,47,1847
52503,52503,667DA38911C3C96DC83EC0865AF97CD1,42581,8,13,5,38,48,1948
52504,52504,667DA38911C3C96DC83EC0865AF97CD1,11914,15,16,1,37,48,1898
52505,52505,667DA38911C3C96DC83EC0865AF97CD1,42581,20,22,2,38,48,1948
52515,52515,806223F4E6A75E30DD9FB8BC0E922847,11061,0,8,8,29,48,1498
52516,52516,806223F4E6A75E30DD9FB8BC0E922847,11151,9,11,2,30,48,1548
52517,52517,806223F4E6A75E30DD9FB8BC0E922847,11061,12,23,11,29,48,1498
52522,52522,A7E367ED35CC8BB7AC221D01E7EE426D,43971,2,6,4,30,48,1548
52523,52523,A7E367ED35CC8BB7AC221D01E7EE426D,42521,8,9,1,31,47,1597
52524,52524,A7E367ED35CC8BB7AC221D01E7EE426D,43761,9,11,2,32,47,1647
52525,52525,A7E367ED35CC8BB7AC221D01E7EE426D,43971,13,23,10,30,48,1548
52526,52526,06CD0D9A51BF6B03AA66A2A0C792CAB3,11651,6,12,6,33,47,1697
52527,52527,06CD0D9A51BF6B03AA66A2A0C792CAB3,10971,13,14,1,35,47,1797
52528,52528,06CD0D9A51BF6B03AA66A2A0C792CAB3,11861,17,19,2,32,47,1647
52529,52529,ADA7A37C20CD0B9D86937CBAFEF7FD65,11753,0,18,18,35,48,1798
52530,52530,ADA7A37C20CD0B9D86937CBAFEF7FD65,10111,19,21,2,37,47,1897
52531,52531,ADA7A37C20CD0B9D86937CBAFEF7FD65,13511,22,23,1,34,48,1748
52532,52532,32D54E641C550F1191577801F5A35620,12581,3,4,1,24,48,1248
52533,52533,32D54E641C550F1191577801F5A35620,11641,4,10,6,22,49,1149
52534,52534,32D54E641C550F1191577801F5A35620,12581,12,20,8,24,48,1248
52535,52535,963CA57EF8523CDAFA4F1E3B7EDA337F,12514,0,13,13,38,47,1947
52536,52536,963CA57EF8523CDAFA4F1E3B7EDA337F,11074,14,17,3,37,47,1897
52537,52537,963CA57EF8523CDAFA4F1E3B7EDA337F,10271,18,19,1,37,46,1896
52538,52538,963CA57EF8523CDAFA4F1E3B7EDA337F,12514,20,22,2,38,47,1947
52549,52549,DB2A7AF4E3CE5306702B394040D91F34,42231,0,9,9,37,46,1896
52550,52550,DB2A7AF4E3CE5306702B394040D91F34,42351,10,11,1,38,45,1945
52551,52551,DB2A7AF4E3CE5306702B394040D91F34,42231,13,20,7,37,46,1896
52552,52552,1511CFAF94B568A5555A92AE32FB6139,40171,0,1,1,38,48,1948
52553,52553,1511CFAF94B568A5555A92AE32FB6139,43181,2,13,11,39,48,1998
52554,52554,1511CFAF94B568A5555A92AE32FB6139,40171,18,20,2,38,48,1948
52555,52555,1511CFAF94B568A5555A92AE32FB6139,43181,22,23,1,39,48,1998
52556,52556,C029AF0117516DFB61719988C968750E,13711,2,15,13,38,46,1946
52557,52557,C029AF0117516DFB61719988C968750E,43241,18,19,1,36,46,1846
52558,52558,C029AF0117516DFB61719988C968750E,13711,19,23,4,38,46,1946
52559,52559,19783D60B70DD47851602F72E0868D88,43311,0,7,7,31,48,1598
52560,52560,19783D60B70DD47851602F72E0868D88,11211,14,15,1,34,49,1749
52561,52561,19783D60B70DD47851602F72E0868D88,43581,18,23,5,33,48,1698
52574,52574,A8CFBCA9A33C65DE4AB357D9A64460F4,12514,1,2,1,38,47,1947
52575,52575,A8CFBCA9A33C65DE4AB357D9A64460F4,42301,3,6,3,36,47,1847
52576,52576,A8CFBCA9A33C65DE4AB357D9A64460F4,12514,7,22,15,38,47,1947
52577,52577,87268C35D2C26CE8D0D34B26791C8611,11731,0,1,1,36,48,1848
52578,52578,87268C35D2C26CE8D0D34B26791C8611,41591,3,15,12,34,49,1749
52579,52579,87268C35D2C26CE8D0D34B26791C8611,11751,17,18,1,35,48,1798
52586,52586,251CF6F7D24D01C5A979C85F40AA6FB8,42161,0,15,15,36,47,1847
52587,52587,251CF6F7D24D01C5A979C85F40AA6FB8,10601,16,17,1,39,47,1997
52588,52588,251CF6F7D24D01C5A979C85F40AA6FB8,42161,17,23,6,36,47,1847
52593,52593,A0E96E8A9AD818FBF087A431E03695B8,11914,0,8,8,37,48,1898
52594,52594,A0E96E8A9AD818FBF087A431E03695B8,11021,8,17,9,36,49,1849
52595,52595,A0E96E8A9AD818FBF087A431E03695B8,11461,18,20,2,37,49,1899
52596,52596,A0E96E8A9AD818FBF087A431E03695B8,40171,21,22,1,38,48,1948
52602,52602,C2938F6FA2A943D6DFC754D5D6C219D6,42221,0,4,4,38,48,1948
52603,52603,C2938F6FA2A943D6DFC754D5D6C219D6,11074,8,11,3,37,47,1897
52604,52604,C2938F6FA2A943D6DFC754D5D6C219D6,12514,15,23,8,38,47,1947
52605,52605,C8EB41C6B7152CD714709DA811B3B245,10681,0,8,8,30,48,1548
52606,52606,C8EB41C6B7152CD714709DA811B3B245,11061,8,21,13,29,48,1498
52607,52607,C8EB41C6B7152CD714709DA811B3B245,10681,22,23,1,30,48,1548
52608,52608,2E7CC4EF44F5328D020B21B2138E3C1D,11061,0,7,7,29,48,1498
52609,52609,2E7CC4EF44F5328D020B21B2138E3C1D,10716,9,10,1,30,46,1546
52610,52610,2E7CC4EF44F5328D020B21B2138E3C1D,11061,14,19,5,29,48,1498
52614,52614,F736C39F560B9A4948E68A46A6A6DDA8,41031,0,14,14,32,49,1649
52615,52615,F736C39F560B9A4948E68A46A6A6DDA8,10431,16,18,2,33,49,1699
52616,52616,F736C39F560B9A4948E68A46A6A6DDA8,41031,19,23,4,32,49,1649
52622,52622,478F01BCCD8ECC2639B5EA3CD060CD5E,11201,0,10,10,35,49,1799
52623,52623,478F01BCCD8ECC2639B5EA3CD060CD5E,11751,10,13,3,35,48,1798
52624,52624,478F01BCCD8ECC2639B5EA3CD060CD5E,13511,17,18,1,34,48,1748
52625,52625,478F01BCCD8ECC2639B5EA3CD060CD5E,11201,19,23,4,35,49,1799
52626,52626,96056246DD9856C2DDE7E703B0D16D68,11381,0,12,12,30,47,1547
52627,52627,96056246DD9856C2DDE7E703B0D16D68,10341,13,18,5,31,47,1597
52628,52628,96056246DD9856C2DDE7E703B0D16D68,11381,18,19,1,30,47,1547
52629,52629,96056246DD9856C2DDE7E703B0D16D68,10341,20,23,3,31,47,1597
52633,52633,EA454BA750B94FE328BB9998EA4F4BA4,43161,0,12,12,35,47,1797
52634,52634,EA454BA750B94FE328BB9998EA4F4BA4,42161,14,16,2,36,47,1847
52635,52635,EA454BA750B94FE328BB9998EA4F4BA4,10971,16,19,3,35,47,1797
52640,52640,A234A4542640E3C0130ED919B7094A96,10471,0,14,14,37,48,1898
52641,52641,A234A4542640E3C0130ED919B7094A96,11231,14,18,4,37,49,1899
52642,52642,A234A4542640E3C0130ED919B7094A96,10471,18,23,5,37,48,1898
52646,52646,B36C8579A2DBF718933C4838B2421A42,42511,1,9,8,37,47,1897
52647,52647,B36C8579A2DBF718933C4838B2421A42,13121,11,15,4,38,46,1946
52648,52648,B36C8579A2DBF718933C4838B2421A42,42511,16,21,5,37,47,1897
52649,52649,B36C8579A2DBF718933C4838B2421A42,40123,22,23,1,38,47,1947
52650,52650,45E2591DDB181830E886EA4FBDDB1E4F,10531,0,5,5,34,46,1746
52651,52651,45E2591DDB181830E886EA4FBDDB1E4F,11861,6,9,3,32,47,1647
52652,52652,45E2591DDB181830E886EA4FBDDB1E4F,10151,10,18,8,34,47,1747
52653,52653,45E2591DDB181830E886EA4FBDDB1E4F,11861,18,20,2,32,47,1647
52654,52654,FB473FBE3EAFD3A14A7452241F377171,19441,0,13,13,8,46,446
52655,52655,FB473FBE3EAFD3A14A7452241F377171,42041,16,18,2,10,47,547
52656,52656,FB473FBE3EAFD3A14A7452241F377171,19441,21,23,2,8,46,446
52660,52660,267A36CBF6FADE60E151261B3CF154A0,10411,0,8,8,36,48,1848
52661,52661,267A36CBF6FADE60E151261B3CF154A0,43281,13,15,2,37,48,1898
52662,52662,267A36CBF6FADE60E151261B3CF154A0,13121,18,21,3,38,46,1946
52663,52663,267A36CBF6FADE60E151261B3CF154A0,12083,21,23,2,36,49,1849
52664,52664,37025163465687F9A2D7FAF8EF743CD1,13941,0,9,9,41,47,2097
52665,52665,37025163465687F9A2D7FAF8EF743CD1,11001,11,17,6,42,47,2147
52666,52666,37025163465687F9A2D7FAF8EF743CD1,11481,18,20,2,41,48,2098
52667,52667,37025163465687F9A2D7FAF8EF743CD1,13941,21,23,2,41,47,2097
52675,52675,5E3DAD543888AED453CFEE13BBCB613D,42231,0,1,1,37,46,1896
52676,52676,5E3DAD543888AED453CFEE13BBCB613D,13911,1,6,5,39,46,1996
52677,52677,5E3DAD543888AED453CFEE13BBCB613D,42231,8,13,5,37,46,1896
52678,52678,5E3DAD543888AED453CFEE13BBCB613D,42351,14,18,4,38,45,1945
52679,52679,72CCFF68A8139FE3616EAEC5752357DB,10251,0,17,17,35,47,1797
52680,52680,72CCFF68A8139FE3616EAEC5752357DB,11921,19,20,1,38,48,1948
52681,52681,72CCFF68A8139FE3616EAEC5752357DB,10251,21,23,2,35,47,1797
52682,52682,AC99EF29AA0F113BC79242FCDFA9AAC0,10661,0,1,1,37,49,1899
52683,52683,AC99EF29AA0F113BC79242FCDFA9AAC0,10121,3,6,3,36,49,1849
52684,52684,AC99EF29AA0F113BC79242FCDFA9AAC0,40302,6,20,14,40,49,2049
52685,52685,AC99EF29AA0F113BC79242FCDFA9AAC0,11301,21,22,1,41,49,2099
52686,52686,7FD3A8702ABEC11D94682CB695A579C6,40302,1,17,16,40,49,2049
52687,52687,7FD3A8702ABEC11D94682CB695A579C6,42971,17,20,3,43,49,2199
52688,52688,7FD3A8702ABEC11D94682CB695A579C6,40302,21,23,2,40,49,2049
52689,52689,C8AE21C26108F7AFBD515ED916A6E09A,10841,0,1,1,37,47,1897
52690,52690,C8AE21C26108F7AFBD515ED916A6E09A,12514,2,5,3,38,47,1947
52691,52691,C8AE21C26108F7AFBD515ED916A6E09A,10841,8,20,12,37,47,1897
52692,52692,9B57EAB93FFEB861CF4D7AFFA4D55B0B,10681,10,12,2,30,48,1548
52693,52693,9B57EAB93FFEB861CF4D7AFFA4D55B0B,11061,12,13,1,29,48,1498
52694,52694,9B57EAB93FFEB861CF4D7AFFA4D55B0B,10681,13,23,10,30,48,1548
52701,52701,D454F61AD8B5A1CBE1E15CE597E2F528,42301,4,9,5,36,47,1847
52702,52702,D454F61AD8B5A1CBE1E15CE597E2F528,11231,9,20,11,37,49,1899
52703,52703,D454F61AD8B5A1CBE1E15CE597E2F528,40171,20,22,2,38,48,1948
52708,52708,05B51695B375DD3A2259BF2668AD8716,42161,0,13,13,36,47,1847
52709,52709,05B51695B375DD3A2259BF2668AD8716,11331,14,21,7,37,48,1898
52710,52710,05B51695B375DD3A2259BF2668AD8716,42161,21,23,2,36,47,1847
52711,52711,B20D4CCCBBF9B534BB9F26A35B371E4C,42351,2,11,9,38,45,1945
52712,52712,B20D4CCCBBF9B534BB9F26A35B371E4C,11941,13,19,6,37,46,1896
52713,52713,B20D4CCCBBF9B534BB9F26A35B371E4C,13841,21,22,1,40,46,2046
52730,52730,E428A2146487F7DA252A6BC2E421F512,11074,0,12,12,37,47,1897
52731,52731,E428A2146487F7DA252A6BC2E421F512,12514,14,16,2,38,47,1947
52732,52732,E428A2146487F7DA252A6BC2E421F512,11074,18,23,5,37,47,1897
52747,52747,FD25FFCA5F46CAEB4AF16FD428D5BE01,43061,0,9,9,43,46,2196
52748,52748,FD25FFCA5F46CAEB4AF16FD428D5BE01,42461,9,12,3,45,47,2297
52749,52749,FD25FFCA5F46CAEB4AF16FD428D5BE01,42091,12,19,7,43,46,2196
52750,52750,79F70A1AE08CEE215DA71360DE1B25EA,42191,0,6,6,38,49,1949
52751,52751,79F70A1AE08CEE215DA71360DE1B25EA,42231,6,17,11,37,46,1896
52752,52752,79F70A1AE08CEE215DA71360DE1B25EA,42191,20,23,3,38,49,1949
52753,52753,347A31E9527C6F1D2B24E19393D7EBED,43971,0,4,4,30,48,1548
52754,52754,347A31E9527C6F1D2B24E19393D7EBED,11061,5,7,2,29,48,1498
52755,52755,347A31E9527C6F1D2B24E19393D7EBED,43971,9,22,13,30,48,1548
52756,52756,D429753EEB35077FBB0F7FD7B24671DA,42381,1,2,1,39,41,1991
52757,52757,D429753EEB35077FBB0F7FD7B24671DA,43451,6,15,9,37,40,1890
52758,52758,D429753EEB35077FBB0F7FD7B24671DA,42381,19,20,1,39,41,1991
52776,52776,53DE27C3988F5D22526FCC360F8F3A99,42523,0,1,1,31,47,1597
52777,52777,53DE27C3988F5D22526FCC360F8F3A99,42491,2,5,3,32,46,1646
52778,52778,53DE27C3988F5D22526FCC360F8F3A99,42523,9,14,5,31,47,1597
52779,52779,53DE27C3988F5D22526FCC360F8F3A99,11324,15,22,7,31,46,1596
52780,52780,59E8BD2B3B6F40BDD7AA0B26E7BC6262,13471,1,6,5,47,49,2399
52781,52781,59E8BD2B3B6F40BDD7AA0B26E7BC6262,43621,8,9,1,46,48,2348
52782,52782,59E8BD2B3B6F40BDD7AA0B26E7BC6262,13351,12,14,2,48,48,2448
52783,52783,59E8BD2B3B6F40BDD7AA0B26E7BC6262,13471,19,20,1,47,49,2399
52784,52784,2171BA5B7B40327EED0C90AA4F7372A5,42301,0,9,9,36,47,1847
52785,52785,2171BA5B7B40327EED0C90AA4F7372A5,10111,10,11,1,37,47,1897
52786,52786,2171BA5B7B40327EED0C90AA4F7372A5,42301,13,18,5,36,47,1847
52787,52787,2171BA5B7B40327EED0C90AA4F7372A5,10111,21,22,1,37,47,1897
52803,52803,4EC8CDFD9ACA8FBC9C617E8D400F2F94,11914,7,8,1,37,48,1898
52804,52804,4EC8CDFD9ACA8FBC9C617E8D400F2F94,42961,13,17,4,35,49,1799
52805,52805,4EC8CDFD9ACA8FBC9C617E8D400F2F94,42581,17,18,1,38,48,1948
52817,52817,D2007E56CDD263F500CAE75A804D6B50,42871,0,7,7,30,45,1545
52818,52818,D2007E56CDD263F500CAE75A804D6B50,11324,9,12,3,31,46,1596
52819,52819,D2007E56CDD263F500CAE75A804D6B50,42871,13,20,7,30,45,1545
52820,52820,D2007E56CDD263F500CAE75A804D6B50,12311,21,22,1,30,44,1544
52821,52821,1C18101ADA4B02F048DFDA93997493B8,42491,1,14,13,32,46,1646
52822,52822,1C18101ADA4B02F048DFDA93997493B8,42523,14,21,7,31,47,1597
52823,52823,1C18101ADA4B02F048DFDA93997493B8,42491,22,23,1,32,46,1646
52824,52824,5882BE4B58FAB8E912EEA6361A42F654,10721,0,11,11,31,48,1598
52825,52825,5882BE4B58FAB8E912EEA6361A42F654,40733,15,17,2,32,48,1648
52826,52826,5882BE4B58FAB8E912EEA6361A42F654,10721,18,19,1,31,48,1598
52827,52827,5EAAFAC3ED008D6394DF94C4111C8AD6,11381,2,17,15,30,47,1547
52828,52828,5EAAFAC3ED008D6394DF94C4111C8AD6,11061,19,20,1,29,48,1498
52829,52829,5EAAFAC3ED008D6394DF94C4111C8AD6,11381,21,23,2,30,47,1547
52850,52850,333863A2CE0A7D471D7CF76BFFDAB0D7,12641,0,2,2,10,43,543
52851,52851,333863A2CE0A7D471D7CF76BFFDAB0D7,19744,2,3,1,6,43,343
52852,52852,333863A2CE0A7D471D7CF76BFFDAB0D7,12641,4,22,18,10,43,543
52853,52853,B951230F2D8FB21FF5FBA5B70040A128,11151,0,9,9,30,48,1548
52854,52854,B951230F2D8FB21FF5FBA5B70040A128,11061,14,15,1,29,48,1498
52855,52855,B951230F2D8FB21FF5FBA5B70040A128,11151,16,22,6,30,48,1548
52856,52856,8D4B76C00151174BC318A19D72794912,12661,0,5,5,32,45,1645
52857,52857,8D4B76C00151174BC318A19D72794912,12311,6,11,5,30,44,1544
52858,52858,8D4B76C00151174BC318A19D72794912,12661,14,20,6,32,45,1645
52859,52859,9EBD792C30B963491A648A1AF083878E,12641,6,8,2,10,43,543
52860,52860,9EBD792C30B963491A648A1AF083878E,19111,11,18,7,9,45,495
52861,52861,9EBD792C30B963491A648A1AF083878E,12641,21,23,2,10,43,543
52867,52867,BD863194C2279CADB3036229DB39BCE7,40872,0,4,4,30,49,1549
52868,52868,BD863194C2279CADB3036229DB39BCE7,10381,8,10,2,31,49,1599
52869,52869,BD863194C2279CADB3036229DB39BCE7,42831,12,14,2,27,48,1398
52870,52870,BD863194C2279CADB3036229DB39BCE7,10381,16,21,5,31,49,1599
52871,52871,A573FF285872EC96818445928AD4461A,13671,0,6,6,27,43,1393
52872,52872,A573FF285872EC96818445928AD4461A,11281,7,12,5,27,40,1390
52873,52873,A573FF285872EC96818445928AD4461A,13671,15,23,8,27,43,1393
52882,52882,EE10AC6477FFD3D50107E111E624E05D,11171,1,12,11,33,48,1698
52883,52883,EE10AC6477FFD3D50107E111E624E05D,10471,15,17,2,37,48,1898
52884,52884,EE10AC6477FFD3D50107E111E624E05D,11751,20,22,2,35,48,1798
52885,52885,28AE6FF44E8686DC354D2E3DF7700FCC,42461,0,13,13,45,47,2297
52886,52886,28AE6FF44E8686DC354D2E3DF7700FCC,11701,14,16,2,43,48,2198
52887,52887,28AE6FF44E8686DC354D2E3DF7700FCC,43001,18,19,1,47,47,2397
52888,52888,28AE6FF44E8686DC354D2E3DF7700FCC,42461,21,23,2,45,47,2297
52889,52889,F9DC2F592D6193343BD07B6C3149B9BD,43731,0,4,4,34,47,1747
52890,52890,F9DC2F592D6193343BD07B6C3149B9BD,10731,5,17,12,33,47,1697
52891,52891,F9DC2F592D6193343BD07B6C3149B9BD,43731,20,23,3,34,47,1747
52901,52901,A0C13743AF441FE8099AA940DA71C612,42581,0,5,5,38,48,1948
52902,52902,A0C13743AF441FE8099AA940DA71C612,11914,5,11,6,37,48,1898
52903,52903,A0C13743AF441FE8099AA940DA71C612,42581,13,23,10,38,48,1948
52909,52909,1317C72E5A9622054904D4946F5A3E59,11381,0,13,13,30,47,1547
52910,52910,1317C72E5A9622054904D4946F5A3E59,10151,15,19,4,34,47,1747
52911,52911,1317C72E5A9622054904D4946F5A3E59,12121,21,23,2,29,47,1497
52919,52919,80C0EEA514919BA1530C5D6E0ACCF011,10381,0,13,13,31,49,1599
52920,52920,80C0EEA514919BA1530C5D6E0ACCF011,11381,14,17,3,30,47,1547
52921,52921,80C0EEA514919BA1530C5D6E0ACCF011,10381,22,23,1,31,49,1599
52922,52922,A6F4E0A14DDF72AB1602B3834CD2AC43,11914,0,13,13,37,48,1898
52923,52923,A6F4E0A14DDF72AB1602B3834CD2AC43,43361,15,17,2,38,48,1948
52924,52924,A6F4E0A14DDF72AB1602B3834CD2AC43,11914,21,23,2,37,48,1898
52938,52938,3904BFA0DAEEBCA85365DF524DB867F2,19931,10,11,1,7,43,393
52939,52939,3904BFA0DAEEBCA85365DF524DB867F2,12641,12,13,1,10,43,543
52940,52940,3904BFA0DAEEBCA85365DF524DB867F2,12921,13,14,1,9,41,491
52941,52941,3904BFA0DAEEBCA85365DF524DB867F2,12641,14,18,4,10,43,543
52965,52965,FCF6425DA3F542476DF1F93935C075D8,42581,0,9,9,38,48,1948
52966,52966,FCF6425DA3F542476DF1F93935C075D8,11914,9,12,3,37,48,1898
52967,52967,FCF6425DA3F542476DF1F93935C075D8,42581,13,17,4,38,48,1948
52968,52968,FCF6425DA3F542476DF1F93935C075D8,11914,18,19,1,37,48,1898
52969,52969,F3DCE8C3C3FF003CDF3D27C94852CCE1,13731,0,1,1,33,49,1699
52970,52970,F3DCE8C3C3FF003CDF3D27C94852CCE1,11954,1,3,2,32,49,1649
52971,52971,F3DCE8C3C3FF003CDF3D27C94852CCE1,13731,13,23,10,33,49,1699
52975,52975,BED343B3F226383209994F36981004E5,43281,0,2,2,37,48,1898
52976,52976,BED343B3F226383209994F36981004E5,10661,2,8,6,37,49,1899
52977,52977,BED343B3F226383209994F36981004E5,10151,12,19,7,34,47,1747
52978,52978,BED343B3F226383209994F36981004E5,11201,21,23,2,35,49,1799
52979,52979,1129CFAE9FE6FF8D7F89EAB9AE20D07F,19441,0,9,9,8,46,446
52980,52980,1129CFAE9FE6FF8D7F89EAB9AE20D07F,42041,9,11,2,10,47,547
52981,52981,1129CFAE9FE6FF8D7F89EAB9AE20D07F,19441,12,23,11,8,46,446
52991,52991,B45CB2E1B244B3B7583778DACAAA9799,11074,0,9,9,37,47,1897
52992,52992,B45CB2E1B244B3B7583778DACAAA9799,12514,13,15,2,38,47,1947
52993,52993,B45CB2E1B244B3B7583778DACAAA9799,11074,15,19,4,37,47,1897
52994,52994,63A1194DA67A916294F825B4249AD293,42161,0,2,2,36,47,1847
52995,52995,63A1194DA67A916294F825B4249AD293,42351,2,5,3,38,45,1945
52996,52996,63A1194DA67A916294F825B4249AD293,11261,9,18,9,36,46,1846
52997,52997,63A1194DA67A916294F825B4249AD293,42771,22,23,1,36,47,1847
53002,53002,9E02584A62ABEE132C2795ACE1B5DB9C,13121,0,10,10,38,46,1946
53003,53003,9E02584A62ABEE132C2795ACE1B5DB9C,12511,13,14,1,39,47,1997
53004,53004,9E02584A62ABEE132C2795ACE1B5DB9C,13121,16,22,6,38,46,1946
53005,53005,B7302D8E572D5F6EE74B792A6D710F90,10491,2,8,6,33,48,1698
53006,53006,B7302D8E572D5F6EE74B792A6D710F90,11324,11,16,5,31,46,1596
53007,53007,B7302D8E572D5F6EE74B792A6D710F90,11151,20,21,1,30,48,1548
53011,53011,249945D8BC225A84B9C0C3C523B07C14,42381,0,3,3,39,41,1991
53012,53012,249945D8BC225A84B9C0C3C523B07C14,43011,3,6,3,40,42,2042
53013,53013,249945D8BC225A84B9C0C3C523B07C14,43451,8,10,2,37,40,1890
53014,53014,249945D8BC225A84B9C0C3C523B07C14,42381,11,23,12,39,41,1991
53015,53015,7F73A642AA11134206C46BA15C785E40,10292,7,13,6,30,47,1547
53016,53016,7F73A642AA11134206C46BA15C785E40,42523,13,21,8,31,47,1597
53017,53017,7F73A642AA11134206C46BA15C785E40,13651,21,23,2,30,47,1547
53018,53018,7B8572C6FE24DE020A4C00FC6C37C208,41021,2,12,10,38,47,1947
53019,53019,7B8572C6FE24DE020A4C00FC6C37C208,10841,13,19,6,37,47,1897
53020,53020,7B8572C6FE24DE020A4C00FC6C37C208,40124,20,23,3,38,47,1947
53021,53021,EE2908C44939767BC0627C82B456437A,12121,0,7,7,29,47,1497
53022,53022,EE2908C44939767BC0627C82B456437A,11381,11,15,4,30,47,1547
53023,53023,EE2908C44939767BC0627C82B456437A,12121,19,23,4,29,47,1497
53024,53024,56380B9BCFA6857A7D3E4BBFC0E5BBBD,12514,0,7,7,38,47,1947
53025,53025,56380B9BCFA6857A7D3E4BBFC0E5BBBD,11074,16,17,1,37,47,1897
53026,53026,56380B9BCFA6857A7D3E4BBFC0E5BBBD,41005,20,21,1,38,47,1947
53027,53027,9E8454E3BE651FEBAAD2CFCFB76D7A82,42921,4,7,3,33,47,1697
53028,53028,9E8454E3BE651FEBAAD2CFCFB76D7A82,10221,8,10,2,34,49,1749
53029,53029,9E8454E3BE651FEBAAD2CFCFB76D7A82,42921,14,18,4,33,47,1697
53030,53030,4E5B59644819D7FCE2AE20E3C8904250,12514,2,7,5,38,47,1947
53031,53031,4E5B59644819D7FCE2AE20E3C8904250,42221,8,10,2,38,48,1948
53032,53032,4E5B59644819D7FCE2AE20E3C8904250,11074,10,23,13,37,47,1897
53033,53033,B207D5D3140535CF644F21B83755D02D,10471,0,8,8,37,48,1898
53034,53034,B207D5D3140535CF644F21B83755D02D,43361,9,18,9,38,48,1948
53035,53035,B207D5D3140535CF644F21B83755D02D,10471,19,23,4,37,48,1898
53036,53036,FC707C73D6614611D82A13C2F325D332,11074,2,11,9,37,47,1897
53037,53037,FC707C73D6614611D82A13C2F325D332,11021,13,21,8,36,49,1849
53038,53038,FC707C73D6614611D82A13C2F325D332,11074,21,22,1,37,47,1897
53042,53042,0B4FC5EECD02B70E005F45BBF7FE8BA8,10471,8,17,9,37,48,1898
53043,53043,0B4FC5EECD02B70E005F45BBF7FE8BA8,11811,18,19,1,38,49,1949
53044,53044,0B4FC5EECD02B70E005F45BBF7FE8BA8,10471,20,23,3,37,48,1898
53048,53048,D048F4DA46E2BE459D38C00513A81B07,11271,8,9,1,37,48,1898
53049,53049,D048F4DA46E2BE459D38C00513A81B07,40171,13,16,3,38,48,1948
53050,53050,D048F4DA46E2BE459D38C00513A81B07,11271,19,23,4,37,48,1898
53067,53067,54E9147B0F88496112EA8083546467E6,12661,10,12,2,32,45,1645
53068,53068,54E9147B0F88496112EA8083546467E6,12311,14,19,5,30,44,1544
53069,53069,54E9147B0F88496112EA8083546467E6,11834,20,21,1,32,45,1645
53070,53070,54E9147B0F88496112EA8083546467E6,12311,21,23,2,30,44,1544
53071,53071,61D4369B95803102112EEFE32BD36465,42141,0,6,6,32,47,1647
53072,53072,61D4369B95803102112EEFE32BD36465,42523,6,8,2,31,47,1597
53073,53073,61D4369B95803102112EEFE32BD36465,43761,8,22,14,32,47,1647
53074,53074,A282F8B8C498C4B735512F5B780D9B09,43581,0,7,7,33,48,1698
53075,53075,A282F8B8C498C4B735512F5B780D9B09,11061,7,18,11,29,48,1498
53076,53076,A282F8B8C498C4B735512F5B780D9B09,43581,19,23,4,33,48,1698
53077,53077,302E13281DC08AB4B0CB613D73ADA12A,11381,0,6,6,30,47,1547
53078,53078,302E13281DC08AB4B0CB613D73ADA12A,11091,8,14,6,29,47,1497
53079,53079,302E13281DC08AB4B0CB613D73ADA12A,11381,18,23,5,30,47,1547
53080,53080,9BCD563089A1D0EF43A278605DE25081,13911,0,1,1,39,46,1996
53081,53081,9BCD563089A1D0EF43A278605DE25081,42351,2,3,1,38,45,1945
53082,53082,9BCD563089A1D0EF43A278605DE25081,13911,3,23,20,39,46,1996
53103,53103,0AD8838435D12A1009D3BADE4EAE690D,11381,0,18,18,30,47,1547
53104,53104,0AD8838435D12A1009D3BADE4EAE690D,11061,18,20,2,29,48,1498
53105,53105,0AD8838435D12A1009D3BADE4EAE690D,11381,20,22,2,30,47,1547
53106,53106,4D5F3AD35DC755EFFA8D428280AF81F0,42961,0,2,2,35,49,1799
53107,53107,4D5F3AD35DC755EFFA8D428280AF81F0,11231,3,5,2,37,49,1899
53108,53108,4D5F3AD35DC755EFFA8D428280AF81F0,10901,6,23,17,35,48,1798
53115,53115,B304D2AD98C7DE24CAE6DD0DA65095F0,10431,0,10,10,33,49,1699
53116,53116,B304D2AD98C7DE24CAE6DD0DA65095F0,43581,13,15,2,33,48,1698
53117,53117,B304D2AD98C7DE24CAE6DD0DA65095F0,10431,18,22,4,33,49,1699
53124,53124,E368078C59121EE7A89865E85A806516,11541,0,7,7,35,49,1799
53125,53125,E368078C59121EE7A89865E85A806516,41061,8,10,2,34,49,1749
53126,53126,E368078C59121EE7A89865E85A806516,11561,13,14,1,32,49,1649
53127,53127,E368078C59121EE7A89865E85A806516,11541,18,23,5,35,49,1799
53136,53136,CED2E140B216F950F7D7F7935269042E,40241,0,13,13,35,49,1799
53137,53137,CED2E140B216F950F7D7F7935269042E,10431,14,16,2,33,49,1699
53138,53138,CED2E140B216F950F7D7F7935269042E,12021,19,20,1,37,49,1899
53139,53139,C644771D2D9F4182BC18DB70E907DF2B,42581,0,9,9,38,48,1948
53140,53140,C644771D2D9F4182BC18DB70E907DF2B,11914,10,15,5,37,48,1898
53141,53141,C644771D2D9F4182BC18DB70E907DF2B,42581,15,18,3,38,48,1948
53142,53142,C644771D2D9F4182BC18DB70E907DF2B,11914,18,20,2,37,48,1898
53158,53158,A3BE9432FF74D3B76F4DB77603BE1A4E,40891,2,7,5,37,47,1897
53159,53159,A3BE9432FF74D3B76F4DB77603BE1A4E,10251,10,11,1,35,47,1797
53160,53160,A3BE9432FF74D3B76F4DB77603BE1A4E,40891,13,14,1,37,47,1897
53161,53161,A3BE9432FF74D3B76F4DB77603BE1A4E,10251,16,22,6,35,47,1797
53162,53162,2C532A7222AF88EEFF1A714538B3778A,11491,0,2,2,36,47,1847
53163,53163,2C532A7222AF88EEFF1A714538B3778A,42941,3,4,1,37,47,1897
53164,53164,2C532A7222AF88EEFF1A714538B3778A,42301,6,22,16,36,47,1847
53165,53165,3F66BF458A5705051246FFE01EDCC7C3,42861,0,9,9,37,44,1894
53166,53166,3F66BF458A5705051246FFE01EDCC7C3,12491,13,15,2,36,43,1843
53167,53167,3F66BF458A5705051246FFE01EDCC7C3,42151,15,18,3,35,45,1795
53183,53183,8264E4C9B3FD12AEBEFEE8F213AF239D,11901,0,11,11,42,49,2149
53184,53184,8264E4C9B3FD12AEBEFEE8F213AF239D,10921,12,13,1,43,48,2198
53185,53185,8264E4C9B3FD12AEBEFEE8F213AF239D,11901,13,23,10,42,49,2149
53189,53189,F013124D9273BD657C510566C98EAA28,13651,2,9,7,30,47,1547
53190,53190,F013124D9273BD657C510566C98EAA28,42523,11,13,2,31,47,1597
53191,53191,F013124D9273BD657C510566C98EAA28,13651,17,19,2,30,47,1547
53192,53192,991DCC539DF9AF7FC2591EFBC5B38D76,10341,0,6,6,31,47,1597
53193,53193,991DCC539DF9AF7FC2591EFBC5B38D76,10281,7,8,1,33,48,1698
53194,53194,991DCC539DF9AF7FC2591EFBC5B38D76,10341,9,23,14,31,47,1597
53198,53198,84DA01F112661472BCB344139BA68924,43061,0,14,14,43,46,2196
53199,53199,84DA01F112661472BCB344139BA68924,13341,19,20,1,44,45,2245
53200,53200,84DA01F112661472BCB344139BA68924,43061,21,23,2,43,46,2196
53210,53210,F7F6E311089E545E2ADE21E1CFF4D206,43761,0,15,15,32,47,1647
53211,53211,F7F6E311089E545E2ADE21E1CFF4D206,42523,17,19,2,31,47,1597
53212,53212,F7F6E311089E545E2ADE21E1CFF4D206,40636,20,23,3,35,48,1798
53216,53216,1034E32537CD89A54195B02D13F8F6C7,42581,0,19,19,38,48,1948
53217,53217,1034E32537CD89A54195B02D13F8F6C7,11914,19,21,2,37,48,1898
53218,53218,1034E32537CD89A54195B02D13F8F6C7,42581,21,22,1,38,48,1948
53219,53219,B83FF91D2DCD52808890AEE4E198ECA8,42231,0,9,9,37,46,1896
53220,53220,B83FF91D2DCD52808890AEE4E198ECA8,43481,11,12,1,39,48,1998
53221,53221,B83FF91D2DCD52808890AEE4E198ECA8,42231,15,23,8,37,46,1896
53228,53228,33FC0B489C5E05541F85476129992AFD,42981,0,7,7,36,49,1849
53229,53229,33FC0B489C5E05541F85476129992AFD,11231,7,9,2,37,49,1899
53230,53230,33FC0B489C5E05541F85476129992AFD,42981,10,23,13,36,49,1849
53231,53231,0DFD98C5BF618352145AEF64606DF221,42401,2,7,5,36,47,1847
53232,53232,0DFD98C5BF618352145AEF64606DF221,40673,8,10,2,36,48,1848
53233,53233,0DFD98C5BF618352145AEF64606DF221,42161,14,23,9,36,47,1847
53246,53246,30C49EE7A31FEEE7EEC894E81C72E143,11914,2,8,6,37,48,1898
53247,53247,30C49EE7A31FEEE7EEC894E81C72E143,43181,8,9,1,39,48,1998
53248,53248,30C49EE7A31FEEE7EEC894E81C72E143,40171,12,20,8,38,48,1948
53256,53256,93C87ADE4FBD02048670A9DCD4C6ECEA,42864,0,5,5,38,44,1944
53257,53257,93C87ADE4FBD02048670A9DCD4C6ECEA,11261,5,7,2,36,46,1846
53258,53258,93C87ADE4FBD02048670A9DCD4C6ECEA,42864,12,13,1,38,44,1944
53259,53259,93C87ADE4FBD02048670A9DCD4C6ECEA,11261,17,18,1,36,46,1846
53264,53264,2EF88513976088C07EC19077B1D8877A,42511,0,5,5,37,47,1897
53265,53265,2EF88513976088C07EC19077B1D8877A,11491,6,7,1,36,47,1847
53266,53266,2EF88513976088C07EC19077B1D8877A,13121,8,18,10,38,46,1946
53267,53267,2EF88513976088C07EC19077B1D8877A,42511,22,23,1,37,47,1897
53287,53287,B09144E053E0EC9288D632948891CAF2,13911,5,15,10,39,46,1996
53288,53288,B09144E053E0EC9288D632948891CAF2,11261,15,17,2,36,46,1846
53289,53289,B09144E053E0EC9288D632948891CAF2,42231,19,20,1,37,46,1896
53290,53290,B09144E053E0EC9288D632948891CAF2,13911,20,23,3,39,46,1996
53295,53295,5767DCB7927C2A22DA225038742C1BCE,13561,0,6,6,37,49,1899
53296,53296,5767DCB7927C2A22DA225038742C1BCE,11021,9,11,2,36,49,1849
53297,53297,5767DCB7927C2A22DA225038742C1BCE,13561,11,23,12,37,49,1899
53298,53298,1D9B3BEAA73444A543D0673D1FBABCFF,42161,2,8,6,36,47,1847
53299,53299,1D9B3BEAA73444A543D0673D1FBABCFF,42511,9,11,2,37,47,1897
53300,53300,1D9B3BEAA73444A543D0673D1FBABCFF,42161,12,13,1,36,47,1847
53301,53301,1D9B3BEAA73444A543D0673D1FBABCFF,42511,13,23,10,37,47,1897
53308,53308,458D4C98BF56E065F2379A94D370F10D,43731,0,9,9,34,47,1747
53309,53309,458D4C98BF56E065F2379A94D370F10D,42921,10,13,3,33,47,1697
53310,53310,458D4C98BF56E065F2379A94D370F10D,42161,13,20,7,36,47,1847
53311,53311,458D4C98BF56E065F2379A94D370F10D,43161,20,23,3,35,47,1797
53328,53328,2F1F7798F5E8889B4080CA59D71F0274,10271,6,10,4,37,46,1896
53329,53329,2F1F7798F5E8889B4080CA59D71F0274,10111,12,16,4,37,47,1897
53330,53330,2F1F7798F5E8889B4080CA59D71F0274,10271,16,23,7,37,46,1896
53331,53331,9D27A1D6D841B5A6A86263553CA4E022,13071,0,1,1,41,41,2091
53332,53332,9D27A1D6D841B5A6A86263553CA4E022,43011,10,19,9,40,42,2042
53333,53333,9D27A1D6D841B5A6A86263553CA4E022,42381,20,21,1,39,41,1991
53334,53334,9D27A1D6D841B5A6A86263553CA4E022,43011,22,23,1,40,42,2042
53335,53335,1F953F5DDA94789CC05A9CC3A1537BDC,11914,0,1,1,37,48,1898
53336,53336,1F953F5DDA94789CC05A9CC3A1537BDC,42581,4,7,3,38,48,1948
53337,53337,1F953F5DDA94789CC05A9CC3A1537BDC,13381,19,21,2,39,47,1997
53338,53338,1F953F5DDA94789CC05A9CC3A1537BDC,42581,21,22,1,38,48,1948
53342,53342,D704FA89E57F0C291D131CEF0F4F7938,42491,0,14,14,32,46,1646
53343,53343,D704FA89E57F0C291D131CEF0F4F7938,42523,15,16,1,31,47,1597
53344,53344,D704FA89E57F0C291D131CEF0F4F7938,42491,19,22,3,32,46,1646
53345,53345,6A22B907A7F1FA4A685D409A00615D34,11261,0,2,2,36,46,1846
53346,53346,6A22B907A7F1FA4A685D409A00615D34,13911,5,10,5,39,46,1996
53347,53347,6A22B907A7F1FA4A685D409A00615D34,11261,11,23,12,36,46,1846
53373,53373,59E34F75FDC653B4B227666538D2D441,42191,1,6,5,38,49,1949
53374,53374,59E34F75FDC653B4B227666538D2D441,10841,6,12,6,37,47,1897
53375,53375,59E34F75FDC653B4B227666538D2D441,13221,15,17,2,40,47,2047
53376,53376,59E34F75FDC653B4B227666538D2D441,10841,19,22,3,37,47,1897
53381,53381,7EBD3BA762C40F1F8A712F803B7D8FD3,42791,4,5,1,35,45,1795
53382,53382,7EBD3BA762C40F1F8A712F803B7D8FD3,12491,5,9,4,36,43,1843
53383,53383,7EBD3BA762C40F1F8A712F803B7D8FD3,42151,10,19,9,35,45,1795
53384,53384,8EC6592A5302140A9CA2CC55F2BCF8B9,42201,0,7,7,43,46,2196
53385,53385,8EC6592A5302140A9CA2CC55F2BCF8B9,10771,20,22,2,41,46,2096
53386,53386,8EC6592A5302140A9CA2CC55F2BCF8B9,42201,22,23,1,43,46,2196
53387,53387,D9026A3CE10A3841EFEE0C49DAE389C6,12641,0,6,6,10,43,543
53388,53388,D9026A3CE10A3841EFEE0C49DAE389C6,19114,6,18,12,7,43,393
53389,53389,D9026A3CE10A3841EFEE0C49DAE389C6,12641,19,23,4,10,43,543
53390,53390,D814AC010A265CB560CDCBE882AB02E6,43951,0,10,10,49,41,2491
53391,53391,D814AC010A265CB560CDCBE882AB02E6,13411,14,18,4,49,42,2492
53392,53392,D814AC010A265CB560CDCBE882AB02E6,43951,18,21,3,49,41,2491
53408,53408,F93D646A1BCE1AFF390EB78A01863C9E,40171,0,5,5,38,48,1948
53409,53409,F93D646A1BCE1AFF390EB78A01863C9E,10471,10,17,7,37,48,1898
53410,53410,F93D646A1BCE1AFF390EB78A01863C9E,40171,19,21,2,38,48,1948
53411,53411,F93D646A1BCE1AFF390EB78A01863C9E,10471,21,23,2,37,48,1898
53421,53421,826B40817E61853148AFBFECB1C48C70,11261,5,6,1,36,46,1846
53422,53422,826B40817E61853148AFBFECB1C48C70,42861,7,15,8,37,44,1894
53423,53423,826B40817E61853148AFBFECB1C48C70,11261,19,23,4,36,46,1846
53424,53424,B586EAB297E83D0A90DD54A60924E8FC,10111,0,12,12,37,47,1897
53425,53425,B586EAB297E83D0A90DD54A60924E8FC,42271,12,18,6,40,47,2047
53426,53426,B586EAB297E83D0A90DD54A60924E8FC,11781,19,20,1,38,49,1949
53441,53441,C6869A64CA9EF97A25D7192A00726FC2,42401,0,9,9,36,47,1847
53442,53442,C6869A64CA9EF97A25D7192A00726FC2,10781,10,17,7,35,47,1797
53443,53443,C6869A64CA9EF97A25D7192A00726FC2,42161,18,23,5,36,47,1847
53447,53447,57068447BEEE4D7969FF166D57966ECA,42541,0,5,5,25,47,1297
53448,53448,57068447BEEE4D7969FF166D57966ECA,11361,7,14,7,22,48,1148
53449,53449,57068447BEEE4D7969FF166D57966ECA,12581,15,17,2,24,48,1248
53450,53450,57068447BEEE4D7969FF166D57966ECA,42541,20,23,3,25,47,1297
53462,53462,181B5103F0FBF120AFF5BEC3A26A3DB7,11161,0,6,6,32,48,1648
53463,53463,181B5103F0FBF120AFF5BEC3A26A3DB7,10431,7,12,5,33,49,1699
53464,53464,181B5103F0FBF120AFF5BEC3A26A3DB7,11561,14,18,4,32,49,1649
53465,53465,181B5103F0FBF120AFF5BEC3A26A3DB7,43761,19,22,3,32,47,1647
53476,53476,D8F26E13541A4D201885591EA4BE04DA,19114,0,13,13,7,43,393
53477,53477,D8F26E13541A4D201885591EA4BE04DA,12641,14,15,1,10,43,543
53478,53478,D8F26E13541A4D201885591EA4BE04DA,19114,20,21,1,7,43,393
53484,53484,8EA53D8E1525E5DC764AA8B750C1926A,43951,9,13,4,49,41,2491
53485,53485,8EA53D8E1525E5DC764AA8B750C1926A,13411,15,16,1,49,42,2492
53486,53486,8EA53D8E1525E5DC764AA8B750C1926A,43951,21,22,1,49,41,2491
53487,53487,D8963F7C81A647B0DB7A8BBF70036A0B,12514,0,4,4,38,47,1947
53488,53488,D8963F7C81A647B0DB7A8BBF70036A0B,10471,8,16,8,37,48,1898
53489,53489,D8963F7C81A647B0DB7A8BBF70036A0B,12514,20,23,3,38,47,1947
53498,53498,E311A49FD79CE1E67702DBA9B7887B92,12641,0,6,6,10,43,543
53499,53499,E311A49FD79CE1E67702DBA9B7887B92,19021,6,15,9,10,45,545
53500,53500,E311A49FD79CE1E67702DBA9B7887B92,12641,16,22,6,10,43,543
53501,53501,2B05CC2BC211341FBD9F6EA8966B4690,11914,7,12,5,37,48,1898
53502,53502,2B05CC2BC211341FBD9F6EA8966B4690,40171,12,20,8,38,48,1948
53503,53503,2B05CC2BC211341FBD9F6EA8966B4690,11914,22,23,1,37,48,1898
53504,53504,55533B9612A041F560AB09E0A0C2A735,10251,0,7,7,35,47,1797
53505,53505,55533B9612A041F560AB09E0A0C2A735,43731,10,20,10,34,47,1747
53506,53506,55533B9612A041F560AB09E0A0C2A735,10251,21,23,2,35,47,1797
53513,53513,F290BC2D6D41CD48C300FC7C586626F2,13911,1,2,1,39,46,1996
53514,53514,F290BC2D6D41CD48C300FC7C586626F2,42231,6,11,5,37,46,1896
53515,53515,F290BC2D6D41CD48C300FC7C586626F2,13911,13,20,7,39,46,1996
53516,53516,F290BC2D6D41CD48C300FC7C586626F2,42231,22,23,1,37,46,1896
53517,53517,65161D8F8A2EE0E4F87D9472311EE576,12514,0,4,4,38,47,1947
53518,53518,65161D8F8A2EE0E4F87D9472311EE576,10841,5,6,1,37,47,1897
53519,53519,65161D8F8A2EE0E4F87D9472311EE576,10271,7,10,3,37,46,1896
53520,53520,65161D8F8A2EE0E4F87D9472311EE576,12514,12,20,8,38,47,1947
53524,53524,6817DB094271302744F441100FAF5A74,10931,0,13,13,41,48,2098
53525,53525,6817DB094271302744F441100FAF5A74,42271,14,15,1,40,47,2047
53526,53526,6817DB094271302744F441100FAF5A74,10931,20,23,3,41,48,2098
53536,53536,75219378BBB10FFE07C7301517B53FE1,42271,4,7,3,40,47,2047
53537,53537,75219378BBB10FFE07C7301517B53FE1,13381,8,11,3,39,47,1997
53538,53538,75219378BBB10FFE07C7301517B53FE1,11491,12,17,5,36,47,1847
53539,53539,75219378BBB10FFE07C7301517B53FE1,11074,18,21,3,37,47,1897
53540,53540,1B83FAC3F59813014CE45FBC6E21E9E8,13331,7,10,3,38,47,1947
53541,53541,1B83FAC3F59813014CE45FBC6E21E9E8,10841,10,11,1,37,47,1897
53542,53542,1B83FAC3F59813014CE45FBC6E21E9E8,13331,11,12,1,38,47,1947
53543,53543,1B83FAC3F59813014CE45FBC6E21E9E8,11074,15,23,8,37,47,1897
53547,53547,47BD90FF18C5C6120B29A51C7AAA3770,42351,0,4,4,38,45,1945
53548,53548,47BD90FF18C5C6120B29A51C7AAA3770,42861,7,9,2,37,44,1894
53549,53549,47BD90FF18C5C6120B29A51C7AAA3770,11261,9,18,9,36,46,1846
53550,53550,47BD90FF18C5C6120B29A51C7AAA3770,42861,18,21,3,37,44,1894
53551,53551,F4C7E5FA3049E67B406C91429B254CBD,43481,0,13,13,39,48,1998
53552,53552,F4C7E5FA3049E67B406C91429B254CBD,42271,15,18,3,40,47,2047
53553,53553,F4C7E5FA3049E67B406C91429B254CBD,13941,18,21,3,41,47,2097
53565,53565,AD3E01B55BE3A10979B701E17C93952E,12581,0,12,12,24,48,1248
53566,53566,AD3E01B55BE3A10979B701E17C93952E,11361,17,19,2,22,48,1148
53567,53567,AD3E01B55BE3A10979B701E17C93952E,12581,22,23,1,24,48,1248
53568,53568,624D06F305E2EADC36A1E30F9DEA4023,10421,0,12,12,41,48,2098
53569,53569,624D06F305E2EADC36A1E30F9DEA4023,13101,16,20,4,40,47,2047
53570,53570,624D06F305E2EADC36A1E30F9DEA4023,10421,22,23,1,41,48,2098
53574,53574,3AA9BE0F4E1B61D1C6E30A6B8E6DAEAB,13711,0,7,7,38,46,1946
53575,53575,3AA9BE0F4E1B61D1C6E30A6B8E6DAEAB,11941,10,16,6,37,46,1896
53576,53576,3AA9BE0F4E1B61D1C6E30A6B8E6DAEAB,13711,17,23,6,38,46,1946
53577,53577,1103EA92F8A3099B032C71C7031363DC,10951,8,15,7,29,48,1498
53578,53578,1103EA92F8A3099B032C71C7031363DC,42121,17,18,1,26,49,1349
53579,53579,1103EA92F8A3099B032C71C7031363DC,42071,18,20,2,31,49,1599
53588,53588,642E530AC0B9954883C291456EA07C44,10731,0,6,6,33,47,1697
53589,53589,642E530AC0B9954883C291456EA07C44,11074,7,15,8,37,47,1897
53590,53590,642E530AC0B9954883C291456EA07C44,10731,17,19,2,33,47,1697
53594,53594,E0F1670DB5561200EEDBAB1833327673,10111,0,2,2,37,47,1897
53595,53595,E0F1670DB5561200EEDBAB1833327673,11921,2,9,7,38,48,1948
53596,53596,E0F1670DB5561200EEDBAB1833327673,10111,10,19,9,37,47,1897
53597,53597,E0F1670DB5561200EEDBAB1833327673,11921,20,23,3,38,48,1948
53607,53607,A99656E991272E2D0207AAB7A175C1B5,42981,1,9,8,36,49,1849
53608,53608,A99656E991272E2D0207AAB7A175C1B5,40171,10,12,2,38,48,1948
53609,53609,A99656E991272E2D0207AAB7A175C1B5,10471,14,20,6,37,48,1898
53610,53610,A99656E991272E2D0207AAB7A175C1B5,11531,21,23,2,34,49,1749
53617,53617,88182B8F0A08A7B6CD3790FE87C79F47,42351,0,7,7,38,45,1945
53618,53618,88182B8F0A08A7B6CD3790FE87C79F47,42231,7,11,4,37,46,1896
53619,53619,88182B8F0A08A7B6CD3790FE87C79F47,42351,12,23,11,38,45,1945
53630,53630,1CD741282378ACECE229BFA3E57C9431,19441,0,7,7,8,46,446
53631,53631,1CD741282378ACECE229BFA3E57C9431,42041,8,10,2,10,47,547
53632,53632,1CD741282378ACECE229BFA3E57C9431,19441,12,21,9,8,46,446
53633,53633,015DD3F8879090CB78AF6455AEBAF5CD,11211,2,5,3,34,49,1749
53634,53634,015DD3F8879090CB78AF6455AEBAF5CD,11541,6,11,5,35,49,1799
53635,53635,015DD3F8879090CB78AF6455AEBAF5CD,40463,13,17,4,38,49,1949
53636,53636,015DD3F8879090CB78AF6455AEBAF5CD,13561,20,23,3,37,49,1899
53643,53643,88B9ED484BFC88A3E18D812526B753D0,11261,0,3,3,36,46,1846
53644,53644,88B9ED484BFC88A3E18D812526B753D0,13231,5,6,1,39,46,1996
53645,53645,88B9ED484BFC88A3E18D812526B753D0,42861,7,16,9,37,44,1894
53646,53646,88B9ED484BFC88A3E18D812526B753D0,11261,17,21,4,36,46,1846
53647,53647,5E618C9CCD0F8D37A37B93116A5B6554,42081,2,3,1,24,49,1249
53648,53648,5E618C9CCD0F8D37A37B93116A5B6554,42623,5,7,2,22,49,1149
53649,53649,5E618C9CCD0F8D37A37B93116A5B6554,42081,7,21,14,24,49,1249
53666,53666,6BC25D943F92E8D81D0DD10A27C42A3A,11061,1,5,4,29,48,1498
53667,53667,6BC25D943F92E8D81D0DD10A27C42A3A,11381,9,15,6,30,47,1547
53668,53668,6BC25D943F92E8D81D0DD10A27C42A3A,11061,16,18,2,29,48,1498
53669,53669,6BC25D943F92E8D81D0DD10A27C42A3A,11381,19,23,4,30,47,1547
53687,53687,96452439FA8965CAF4B8DE42BC3B7A33,12971,0,9,9,32,48,1648
53688,53688,96452439FA8965CAF4B8DE42BC3B7A33,41591,12,20,8,34,49,1749
53689,53689,96452439FA8965CAF4B8DE42BC3B7A33,40051,20,22,2,32,49,1649
53693,53693,CF6720160B9CEF85B4F75679005CFCE7,11875,0,12,12,30,46,1546
53694,53694,CF6720160B9CEF85B4F75679005CFCE7,12311,13,14,1,30,44,1544
53695,53695,CF6720160B9CEF85B4F75679005CFCE7,42871,14,15,1,30,45,1545
53696,53696,CF6720160B9CEF85B4F75679005CFCE7,11875,15,23,8,30,46,1546
53697,53697,1A9DAEEEE45E6D6064E98B4F317D57C3,42271,0,1,1,40,47,2047
53698,53698,1A9DAEEEE45E6D6064E98B4F317D57C3,12514,4,5,1,38,47,1947
53699,53699,1A9DAEEEE45E6D6064E98B4F317D57C3,42271,8,23,15,40,47,2047
53705,53705,C910BD0B6C804D8FBB0567C9BD082512,42271,0,7,7,40,47,2047
53706,53706,C910BD0B6C804D8FBB0567C9BD082512,11074,7,8,1,37,47,1897
53707,53707,C910BD0B6C804D8FBB0567C9BD082512,43481,12,23,11,39,48,1998
53732,53732,D19CCADD05AE7D38BD327DD3B3A1E602,13911,0,7,7,39,46,1996
53733,53733,D19CCADD05AE7D38BD327DD3B3A1E602,42351,7,14,7,38,45,1945
53734,53734,D19CCADD05AE7D38BD327DD3B3A1E602,42231,15,16,1,37,46,1896
53735,53735,D19CCADD05AE7D38BD327DD3B3A1E602,13911,17,18,1,39,46,1996
53736,53736,B9E52D07F5AA84B0FEC3B2146C780B6A,11231,0,13,13,37,49,1899
53737,53737,B9E52D07F5AA84B0FEC3B2146C780B6A,42161,14,16,2,36,47,1847
53738,53738,B9E52D07F5AA84B0FEC3B2146C780B6A,11231,18,23,5,37,49,1899
53749,53749,8FFFB1045B67B7DEF96CD971C93188B0,11954,1,7,6,32,49,1649
53750,53750,8FFFB1045B67B7DEF96CD971C93188B0,13731,14,17,3,33,49,1699
53751,53751,8FFFB1045B67B7DEF96CD971C93188B0,42071,20,21,1,31,49,1599
53765,53765,92FB499978AE5927D502ECEF0280A31F,42511,1,11,10,37,47,1897
53766,53766,92FB499978AE5927D502ECEF0280A31F,12514,13,15,2,38,47,1947
53767,53767,92FB499978AE5927D502ECEF0280A31F,10841,17,19,2,37,47,1897
53784,53784,6B2E238C2A4978AFB452986609DB74C2,42523,9,17,8,31,47,1597
53785,53785,6B2E238C2A4978AFB452986609DB74C2,43761,19,21,2,32,47,1647
53786,53786,6B2E238C2A4978AFB452986609DB74C2,42523,22,23,1,31,47,1597
53798,53798,12ADB141CA14BE5E4E819B1A4FBA459C,11941,0,2,2,37,46,1896
53799,53799,12ADB141CA14BE5E4E819B1A4FBA459C,13711,2,4,2,38,46,1946
53800,53800,12ADB141CA14BE5E4E819B1A4FBA459C,11941,5,21,16,37,46,1896
53801,53801,4E51106F693AC28D6C8DBF18AA35F4D1,10341,0,8,8,31,47,1597
53802,53802,4E51106F693AC28D6C8DBF18AA35F4D1,43761,8,10,2,32,47,1647
53803,53803,4E51106F693AC28D6C8DBF18AA35F4D1,10341,10,23,13,31,47,1597
53804,53804,BEF31F045A546CF30A63CFBCD60FD3FA,42351,0,10,10,38,45,1945
53805,53805,BEF31F045A546CF30A63CFBCD60FD3FA,42231,11,12,1,37,46,1896
53806,53806,BEF31F045A546CF30A63CFBCD60FD3FA,13911,12,14,2,39,46,1996
53807,53807,BEF31F045A546CF30A63CFBCD60FD3FA,42231,16,23,7,37,46,1896
53818,53818,44B913A66AFA5E271FF541EC61CC9838,10111,0,6,6,37,47,1897
53819,53819,44B913A66AFA5E271FF541EC61CC9838,42281,7,9,2,40,48,2048
53820,53820,44B913A66AFA5E271FF541EC61CC9838,10111,12,19,7,37,47,1897
53824,53824,A38841C5C4A883D379ECA50564160D63,10281,0,5,5,33,48,1698
53825,53825,A38841C5C4A883D379ECA50564160D63,11381,6,19,13,30,47,1547
53826,53826,A38841C5C4A883D379ECA50564160D63,10281,19,21,2,33,48,1698
53834,53834,B45D59A19F6B61302F993D2909F39450,12031,0,7,7,33,48,1698
53835,53835,B45D59A19F6B61302F993D2909F39450,11061,7,9,2,29,48,1498
53836,53836,B45D59A19F6B61302F993D2909F39450,12031,13,22,9,33,48,1698
53837,53837,2B978F14522F2408660E90AEA6143CDF,42071,0,15,15,31,49,1599
53838,53838,2B978F14522F2408660E90AEA6143CDF,10544,15,18,3,28,48,1448
53839,53839,2B978F14522F2408660E90AEA6143CDF,42071,19,23,4,31,49,1599
53840,53840,4FEDDE4724DDA61E19979F6B8E0B84B5,42301,0,8,8,36,47,1847
53841,53841,4FEDDE4724DDA61E19979F6B8E0B84B5,13121,10,11,1,38,46,1946
53842,53842,4FEDDE4724DDA61E19979F6B8E0B84B5,10271,11,18,7,37,46,1896
53843,53843,4FEDDE4724DDA61E19979F6B8E0B84B5,13121,18,20,2,38,46,1946
53852,53852,5C68005FCE275073B922C918E043BC34,42521,0,11,11,31,47,1597
53853,53853,5C68005FCE275073B922C918E043BC34,11381,16,17,1,30,47,1547
53854,53854,5C68005FCE275073B922C918E043BC34,42521,22,23,1,31,47,1597
53871,53871,3869E48F267B04208FDB1CED43168CE1,43761,0,7,7,32,47,1647
53872,53872,3869E48F267B04208FDB1CED43168CE1,12161,8,16,8,32,46,1646
53873,53873,3869E48F267B04208FDB1CED43168CE1,10251,18,20,2,35,47,1797
53874,53874,3869E48F267B04208FDB1CED43168CE1,43761,22,23,1,32,47,1647
53898,53898,44204903DA6B531E6F888417C2B4381D,10251,0,8,8,35,47,1797
53899,53899,44204903DA6B531E6F888417C2B4381D,42221,10,16,6,38,48,1948
53900,53900,44204903DA6B531E6F888417C2B4381D,10491,17,23,6,33,48,1698
53901,53901,0D5DB46D532644D0868091E24BFE7F7C,13711,0,8,8,38,46,1946
53902,53902,0D5DB46D532644D0868091E24BFE7F7C,41382,12,14,2,38,49,1949
53903,53903,0D5DB46D532644D0868091E24BFE7F7C,13121,18,19,1,38,46,1946
53904,53904,0D5DB46D532644D0868091E24BFE7F7C,10271,20,21,1,37,46,1896
53909,53909,435E98F8E4BA1C5ED5B064CF22D1AAF1,11301,0,7,7,41,49,2099
53910,53910,435E98F8E4BA1C5ED5B064CF22D1AAF1,40302,7,12,5,40,49,2049
53911,53911,435E98F8E4BA1C5ED5B064CF22D1AAF1,11771,13,17,4,39,49,1999
53912,53912,435E98F8E4BA1C5ED5B064CF22D1AAF1,40302,18,20,2,40,49,2049
53921,53921,9442E3EC91A3D04B42A116A2BBC7FD9D,11481,10,13,3,41,48,2098
53922,53922,9442E3EC91A3D04B42A116A2BBC7FD9D,10107,14,15,1,38,49,1949
53923,53923,9442E3EC91A3D04B42A116A2BBC7FD9D,11481,15,23,8,41,48,2098
53924,53924,52DE1B5B29EB088C4F7CC0D4865B38F5,42861,2,7,5,37,44,1894
53925,53925,52DE1B5B29EB088C4F7CC0D4865B38F5,42151,8,11,3,35,45,1795
53926,53926,52DE1B5B29EB088C4F7CC0D4865B38F5,42861,12,22,10,37,44,1894
53927,53927,B1886EF8F5487F8E8F1A6E89D17F4DF6,12311,0,5,5,30,44,1544
53928,53928,B1886EF8F5487F8E8F1A6E89D17F4DF6,42531,9,10,1,31,45,1595
53929,53929,B1886EF8F5487F8E8F1A6E89D17F4DF6,12311,11,13,2,30,44,1544
53930,53930,B1886EF8F5487F8E8F1A6E89D17F4DF6,42531,15,21,6,31,45,1595
53953,53953,C141F27ABEA543C73AD6F8EBE2B6C37C,43241,0,8,8,36,46,1846
53954,53954,C141F27ABEA543C73AD6F8EBE2B6C37C,11081,10,16,6,35,46,1796
53955,53955,C141F27ABEA543C73AD6F8EBE2B6C37C,42231,18,20,2,37,46,1896
53956,53956,CDF6ADDC899F34326492126BCC50D6B8,12601,3,5,2,25,47,1297
53957,53957,CDF6ADDC899F34326492126BCC50D6B8,11361,5,12,7,22,48,1148
53958,53958,CDF6ADDC899F34326492126BCC50D6B8,10171,16,20,4,26,47,1347
53959,53959,2CB9AFC277AD7A353A034C42F442E473,10491,2,8,6,33,48,1698
53960,53960,2CB9AFC277AD7A353A034C42F442E473,11324,11,16,5,31,46,1596
53961,53961,2CB9AFC277AD7A353A034C42F442E473,11151,20,21,1,30,48,1548
53962,53962,81C7B7CEB06954770CA2C889DCC58FC5,42141,0,14,14,32,47,1647
53963,53963,81C7B7CEB06954770CA2C889DCC58FC5,10281,15,17,2,33,48,1698
53964,53964,81C7B7CEB06954770CA2C889DCC58FC5,43761,21,22,1,32,47,1647
53970,53970,B7D6EFF1A712C97E66620534B8D3DEAE,10471,2,15,13,37,48,1898
53971,53971,B7D6EFF1A712C97E66620534B8D3DEAE,41271,17,20,3,38,48,1948
53972,53972,B7D6EFF1A712C97E66620534B8D3DEAE,10471,22,23,1,37,48,1898
53973,53973,E2FC80C995A3EFA4B2AF01BAD4B24C1C,42221,0,7,7,38,48,1948
53974,53974,E2FC80C995A3EFA4B2AF01BAD4B24C1C,12083,8,18,10,36,49,1849
53975,53975,E2FC80C995A3EFA4B2AF01BAD4B24C1C,13741,18,19,1,37,49,1899
53979,53979,1C4D9C3B4ACCE12D2B04BB20561492BF,13101,0,3,3,40,47,2047
53980,53980,1C4D9C3B4ACCE12D2B04BB20561492BF,13271,8,15,7,41,47,2097
53981,53981,1C4D9C3B4ACCE12D2B04BB20561492BF,11805,18,21,3,41,48,2098
53982,53982,44A1A512359C02E9A75BCE907A401EBD,42981,0,6,6,36,49,1849
53983,53983,44A1A512359C02E9A75BCE907A401EBD,11231,6,8,2,37,49,1899
53984,53984,44A1A512359C02E9A75BCE907A401EBD,12083,8,11,3,36,49,1849
53985,53985,44A1A512359C02E9A75BCE907A401EBD,11231,11,23,12,37,49,1899
53989,53989,ABFEC9A9640B730EDC57A96D9582F3E9,42281,0,7,7,40,48,2048
53990,53990,ABFEC9A9640B730EDC57A96D9582F3E9,11074,7,9,2,37,47,1897
53991,53991,ABFEC9A9640B730EDC57A96D9582F3E9,42281,11,23,12,40,48,2048
53992,53992,528421A4A4CF40E840301284E0AFB525,42161,0,9,9,36,47,1847
53993,53993,528421A4A4CF40E840301284E0AFB525,11201,11,14,3,35,49,1799
53994,53994,528421A4A4CF40E840301284E0AFB525,42301,17,18,1,36,47,1847
53998,53998,F36A9C530F88290C9D611D428C0B8F3A,11021,0,11,11,36,49,1849
53999,53999,F36A9C530F88290C9D611D428C0B8F3A,40261,13,20,7,35,49,1799
54000,54000,F36A9C530F88290C9D611D428C0B8F3A,11021,20,23,3,36,49,1849
54001,54001,8C7DCF60D5A91C4294A8C14ABFA5CFBF,42581,1,5,4,38,48,1948
54002,54002,8C7DCF60D5A91C4294A8C14ABFA5CFBF,11914,5,19,14,37,48,1898
54003,54003,8C7DCF60D5A91C4294A8C14ABFA5CFBF,42581,21,23,2,38,48,1948
54004,54004,FD926C96A4F9758B0E89829758CD18F3,10151,0,7,7,34,47,1747
54005,54005,FD926C96A4F9758B0E89829758CD18F3,11021,8,14,6,36,49,1849
54006,54006,FD926C96A4F9758B0E89829758CD18F3,10531,18,19,1,34,46,1746
54007,54007,104C7B4B7606A62E54D0F0C8A8FC6416,10295,0,7,7,30,47,1547
54008,54008,104C7B4B7606A62E54D0F0C8A8FC6416,42491,7,8,1,32,46,1646
54009,54009,104C7B4B7606A62E54D0F0C8A8FC6416,10295,20,23,3,30,47,1547
54010,54010,085A54B112E93B58F53705ABE7F444E7,42601,10,12,2,44,48,2248
54011,54011,085A54B112E93B58F53705ABE7F444E7,43621,15,17,2,46,48,2348
54012,54012,085A54B112E93B58F53705ABE7F444E7,42601,17,19,2,44,48,2248
54013,54013,085A54B112E93B58F53705ABE7F444E7,13471,20,21,1,47,49,2399
54018,54018,0315C10DA707626634C97FD0DD4A337B,10281,0,13,13,33,48,1698
54019,54019,0315C10DA707626634C97FD0DD4A337B,11861,17,18,1,32,47,1647
54020,54020,0315C10DA707626634C97FD0DD4A337B,10281,18,23,5,33,48,1698
54021,54021,DE7BE47E05724D2B7B84051451E0119E,42161,0,1,1,36,47,1847
54022,54022,DE7BE47E05724D2B7B84051451E0119E,11261,2,8,6,36,46,1846
54023,54023,DE7BE47E05724D2B7B84051451E0119E,10111,10,19,9,37,47,1897
54024,54024,DE7BE47E05724D2B7B84051451E0119E,42161,20,23,3,36,47,1847
54040,54040,B8E7E289F9430AF8CDDF4777B090A6CC,42161,0,14,14,36,47,1847
54041,54041,B8E7E289F9430AF8CDDF4777B090A6CC,42981,16,17,1,36,49,1849
54042,54042,B8E7E289F9430AF8CDDF4777B090A6CC,42161,19,23,4,36,47,1847
54048,54048,50A8D48EEDC025C19A5AA5E39B3A8340,11861,0,1,1,32,47,1647
54049,54049,50A8D48EEDC025C19A5AA5E39B3A8340,43731,5,6,1,34,47,1747
54050,54050,50A8D48EEDC025C19A5AA5E39B3A8340,43761,7,23,16,32,47,1647
54051,54051,B2B648550DDCA6742E226B630323B4A8,19101,2,14,12,17,29,879
54052,54052,B2B648550DDCA6742E226B630323B4A8,19531,15,17,2,17,30,880
54053,54053,B2B648550DDCA6742E226B630323B4A8,19101,18,19,1,17,29,879
54057,54057,64CD015D410FD64E05B4431B458C1C51,13821,0,7,7,49,45,2495
54058,54058,64CD015D410FD64E05B4431B458C1C51,43951,12,13,1,49,41,2491
54059,54059,64CD015D410FD64E05B4431B458C1C51,13411,18,20,2,49,42,2492
54067,54067,B362B5E77BA1E28CC69DD6493B38125B,42511,5,7,2,37,47,1897
54068,54068,B362B5E77BA1E28CC69DD6493B38125B,13331,11,16,5,38,47,1947
54069,54069,B362B5E77BA1E28CC69DD6493B38125B,42511,16,19,3,37,47,1897
54070,54070,E9660EFA353EF12B7418397D8A5F75B6,13511,0,10,10,34,48,1748
54071,54071,E9660EFA353EF12B7418397D8A5F75B6,10731,11,14,3,33,47,1697
54072,54072,E9660EFA353EF12B7418397D8A5F75B6,13511,16,18,2,34,48,1748
54073,54073,E9660EFA353EF12B7418397D8A5F75B6,42161,19,21,2,36,47,1847
54082,54082,A0A71327A9D731CA16F03823C8D4670A,11231,0,11,11,37,49,1899
54083,54083,A0A71327A9D731CA16F03823C8D4670A,10107,11,14,3,38,49,1949
54084,54084,A0A71327A9D731CA16F03823C8D4670A,13741,21,23,2,37,49,1899
54085,54085,4C13C3D7416FEE47C7E01DACD89CC954,10301,0,13,13,31,45,1595
54086,54086,4C13C3D7416FEE47C7E01DACD89CC954,42871,14,16,2,30,45,1545
54087,54087,4C13C3D7416FEE47C7E01DACD89CC954,10301,17,20,3,31,45,1595
54088,54088,8820D655222FFDC13E2E08EC252AACD5,43161,0,11,11,35,47,1797
54089,54089,8820D655222FFDC13E2E08EC252AACD5,43731,16,18,2,34,47,1747
54090,54090,8820D655222FFDC13E2E08EC252AACD5,41591,20,21,1,34,49,1749
54117,54117,E528C1BCF7730647027A4A7EFB058975,42631,0,6,6,43,45,2195
54118,54118,E528C1BCF7730647027A4A7EFB058975,13341,8,16,8,44,45,2245
54119,54119,E528C1BCF7730647027A4A7EFB058975,42631,19,23,4,43,45,2195
54120,54120,46B3DE812748722328FAB277775E5F5A,11074,2,3,1,37,47,1897
54121,54121,46B3DE812748722328FAB277775E5F5A,42221,4,9,5,38,48,1948
54122,54122,46B3DE812748722328FAB277775E5F5A,12514,12,22,10,38,47,1947
54144,54144,F49F5A0F1C44EBAB5BE16379854ACBEE,43971,7,8,1,30,48,1548
54145,54145,F49F5A0F1C44EBAB5BE16379854ACBEE,11061,9,10,1,29,48,1498
54146,54146,F49F5A0F1C44EBAB5BE16379854ACBEE,11381,13,19,6,30,47,1547
54147,54147,8B90954203DF4E7E8B8F7A420A0E2644,11781,0,10,10,38,49,1949
54148,54148,8B90954203DF4E7E8B8F7A420A0E2644,10231,13,21,8,39,49,1999
54149,54149,8B90954203DF4E7E8B8F7A420A0E2644,11271,21,22,1,37,48,1898
54150,54150,9F99A72527E81B89BEB16DB21B613CC0,10281,0,7,7,33,48,1698
54151,54151,9F99A72527E81B89BEB16DB21B613CC0,11861,8,16,8,32,47,1647
54152,54152,9F99A72527E81B89BEB16DB21B613CC0,10281,17,23,6,33,48,1698
54162,54162,38BAD20AF3F1C2D76FC5AB52738907B1,10341,0,13,13,31,47,1597
54163,54163,38BAD20AF3F1C2D76FC5AB52738907B1,11861,14,15,1,32,47,1647
54164,54164,38BAD20AF3F1C2D76FC5AB52738907B1,10341,18,22,4,31,47,1597
54165,54165,CE26B8570DA2E6BAF7525A9993322910,11901,1,7,6,42,49,2149
54166,54166,CE26B8570DA2E6BAF7525A9993322910,10921,14,15,1,43,48,2198
54167,54167,CE26B8570DA2E6BAF7525A9993322910,11301,18,22,4,41,49,2099
54180,54180,192B69B185DD207A801CC9E47680182A,10471,0,17,17,37,48,1898
54181,54181,192B69B185DD207A801CC9E47680182A,11794,18,20,2,38,49,1949
54182,54182,192B69B185DD207A801CC9E47680182A,10471,21,23,2,37,48,1898
54183,54183,11EAD48A8DBCD5D84EF731E1C3CF71B3,12514,0,9,9,38,47,1947
54184,54184,11EAD48A8DBCD5D84EF731E1C3CF71B3,10841,11,17,6,37,47,1897
54185,54185,11EAD48A8DBCD5D84EF731E1C3CF71B3,13121,18,19,1,38,46,1946
54186,54186,11EAD48A8DBCD5D84EF731E1C3CF71B3,10841,20,21,1,37,47,1897
54205,54205,0B1AFB24DF884F60B6F408AA4B8B069D,11061,1,4,3,29,48,1498
54206,54206,0B1AFB24DF884F60B6F408AA4B8B069D,11151,4,7,3,30,48,1548
54207,54207,0B1AFB24DF884F60B6F408AA4B8B069D,11061,12,19,7,29,48,1498
54208,54208,0B1AFB24DF884F60B6F408AA4B8B069D,11151,21,22,1,30,48,1548
54209,54209,6018E60F7EF227E666276C10649512A9,42491,1,6,5,32,46,1646
54210,54210,6018E60F7EF227E666276C10649512A9,10292,6,15,9,30,47,1547
54211,54211,6018E60F7EF227E666276C10649512A9,42523,16,22,6,31,47,1597
54212,54212,F410F9904FD94EFD0B3E11C9C6E71ABD,12491,0,8,8,36,43,1843
54213,54213,F410F9904FD94EFD0B3E11C9C6E71ABD,42151,9,17,8,35,45,1795
54214,54214,F410F9904FD94EFD0B3E11C9C6E71ABD,12491,22,23,1,36,43,1843
54218,54218,3C89D3E050BD396C6E176628C3E38174,42161,1,7,6,36,47,1847
54219,54219,3C89D3E050BD396C6E176628C3E38174,43241,9,11,2,36,46,1846
54220,54220,3C89D3E050BD396C6E176628C3E38174,42161,21,23,2,36,47,1847
54224,54224,8B3D2561F13388CB90E1E1F238F66E64,11301,0,9,9,41,49,2099
54225,54225,8B3D2561F13388CB90E1E1F238F66E64,11521,12,13,1,41,48,2098
54226,54226,8B3D2561F13388CB90E1E1F238F66E64,11301,13,19,6,41,49,2099
54227,54227,8B3D2561F13388CB90E1E1F238F66E64,11521,21,23,2,41,48,2098
54228,54228,891C63A7FCD795A9067DDBCBE0342E42,13711,0,8,8,38,46,1946
54229,54229,891C63A7FCD795A9067DDBCBE0342E42,11941,9,10,1,37,46,1896
54230,54230,891C63A7FCD795A9067DDBCBE0342E42,13711,12,18,6,38,46,1946
54231,54231,891C63A7FCD795A9067DDBCBE0342E42,11941,22,23,1,37,46,1896
54232,54232,0D9AA89290D1F445356B85B4B256A343,11001,0,14,14,42,47,2147
54233,54233,0D9AA89290D1F445356B85B4B256A343,13941,18,20,2,41,47,2097
54234,54234,0D9AA89290D1F445356B85B4B256A343,11001,21,23,2,42,47,2147
54246,54246,A584DB5FF6EE02AE16BAE873BBEDDAA1,12921,0,8,8,9,41,491
54247,54247,A584DB5FF6EE02AE16BAE873BBEDDAA1,12641,10,11,1,10,43,543
54248,54248,A584DB5FF6EE02AE16BAE873BBEDDAA1,12921,11,22,11,9,41,491
54249,54249,9A1CB6044954B6099E36F60F8EE95A99,11381,0,6,6,30,47,1547
54250,54250,9A1CB6044954B6099E36F60F8EE95A99,10951,10,11,1,29,48,1498
54251,54251,9A1CB6044954B6099E36F60F8EE95A99,11381,16,18,2,30,47,1547
54264,54264,DAFE070AC8164EB683B9455E05DD84E1,40833,0,5,5,41,47,2097
54265,54265,DAFE070AC8164EB683B9455E05DD84E1,13101,5,13,8,40,47,2047
54266,54266,DAFE070AC8164EB683B9455E05DD84E1,11481,17,21,4,41,48,2098
54267,54267,3C5BF8354C7B22C00BFA5438C070BC0F,13711,0,9,9,38,46,1946
54268,54268,3C5BF8354C7B22C00BFA5438C070BC0F,42011,9,10,1,36,46,1846
54269,54269,3C5BF8354C7B22C00BFA5438C070BC0F,13711,11,19,8,38,46,1946
54270,54270,FC3B8910035FE6AFFCEFAAF1A5BD46D7,10471,0,13,13,37,48,1898
54271,54271,FC3B8910035FE6AFFCEFAAF1A5BD46D7,42191,14,17,3,38,49,1949
54272,54272,FC3B8910035FE6AFFCEFAAF1A5BD46D7,10471,19,23,4,37,48,1898
54285,54285,1F8D58B5730B6C0C264ABCDF1183B8AF,11861,0,13,13,32,47,1647
54286,54286,1F8D58B5730B6C0C264ABCDF1183B8AF,43311,13,17,4,31,48,1598
54287,54287,1F8D58B5730B6C0C264ABCDF1183B8AF,11861,18,23,5,32,47,1647
54288,54288,486CB5BD65AE78E65550BD0B017142BF,10251,0,7,7,35,47,1797
54289,54289,486CB5BD65AE78E65550BD0B017142BF,42161,10,17,7,36,47,1847
54290,54290,486CB5BD65AE78E65550BD0B017142BF,10251,17,23,6,35,47,1797
54296,54296,10408678F614A9A9A865462A0B0CF562,42161,0,14,14,36,47,1847
54297,54297,10408678F614A9A9A865462A0B0CF562,43161,18,19,1,35,47,1797
54298,54298,10408678F614A9A9A865462A0B0CF562,42161,20,22,2,36,47,1847
54306,54306,33E38F12F8713108E12BCC9991D28568,11701,0,6,6,43,48,2198
54307,54307,33E38F12F8713108E12BCC9991D28568,42321,8,9,1,43,47,2197
54308,54308,33E38F12F8713108E12BCC9991D28568,11701,12,23,11,43,48,2198
54309,54309,7B63B781AF1E5C1909C9ECFED6946980,43761,0,6,6,32,47,1647
54310,54310,7B63B781AF1E5C1909C9ECFED6946980,42523,6,8,2,31,47,1597
54311,54311,7B63B781AF1E5C1909C9ECFED6946980,43761,8,16,8,32,47,1647
54312,54312,7B63B781AF1E5C1909C9ECFED6946980,42523,16,23,7,31,47,1597
54330,54330,12915B7CE801D56C12C57B7092EB877D,42581,0,5,5,38,48,1948
54331,54331,12915B7CE801D56C12C57B7092EB877D,10471,8,12,4,37,48,1898
54332,54332,12915B7CE801D56C12C57B7092EB877D,42581,17,18,1,38,48,1948
54353,54353,9C819019C9FBB04766CC6EE29C66CE0E,43281,0,1,1,37,48,1898
54354,54354,9C819019C9FBB04766CC6EE29C66CE0E,12514,2,16,14,38,47,1947
54355,54355,9C819019C9FBB04766CC6EE29C66CE0E,10111,20,23,3,37,47,1897
54356,54356,246B9DA3EFDA0E64D291387D5A19302A,12641,2,5,3,10,43,543
54357,54357,246B9DA3EFDA0E64D291387D5A19302A,19931,6,9,3,7,43,393
54358,54358,246B9DA3EFDA0E64D291387D5A19302A,12641,11,20,9,10,43,543
54359,54359,6B3F914E788F6572FB4693A6E74B7B94,12511,0,7,7,39,47,1997
54360,54360,6B3F914E788F6572FB4693A6E74B7B94,42221,8,9,1,38,48,1948
54361,54361,6B3F914E788F6572FB4693A6E74B7B94,42311,11,17,6,41,46,2096
54362,54362,6B3F914E788F6572FB4693A6E74B7B94,12511,20,22,2,39,47,1997
54374,54374,53650105F7F25F79263F92D3A7D439AB,42461,0,10,10,45,47,2297
54375,54375,53650105F7F25F79263F92D3A7D439AB,13371,14,16,2,41,47,2097
54376,54376,53650105F7F25F79263F92D3A7D439AB,42461,20,23,3,45,47,2297
54389,54389,A18BBFB8111CE9788BEEE3B918FD7EDC,42941,0,13,13,37,47,1897
54390,54390,A18BBFB8111CE9788BEEE3B918FD7EDC,10411,16,17,1,36,48,1848
54391,54391,A18BBFB8111CE9788BEEE3B918FD7EDC,11074,20,21,1,37,47,1897
54397,54397,F14B27CFA07BFF1C03E8748CE04AA105,10341,0,8,8,31,47,1597
54398,54398,F14B27CFA07BFF1C03E8748CE04AA105,11061,11,14,3,29,48,1498
54399,54399,F14B27CFA07BFF1C03E8748CE04AA105,10341,17,23,6,31,47,1597
54400,54400,FC0936587C74EF8144A5D7B54D78302D,19441,0,3,3,8,46,446
54401,54401,FC0936587C74EF8144A5D7B54D78302D,19021,3,5,2,10,45,545
54402,54402,FC0936587C74EF8144A5D7B54D78302D,19901,9,19,10,7,44,394
54403,54403,FC0936587C74EF8144A5D7B54D78302D,19021,21,22,1,10,45,545
54420,54420,8C520BCE0747255A0316AFF9746369D9,10431,0,13,13,33,49,1699
54421,54421,8C520BCE0747255A0316AFF9746369D9,11861,13,16,3,32,47,1647
54422,54422,8C520BCE0747255A0316AFF9746369D9,10401,18,19,1,33,49,1699
54432,54432,ACB823DB33D22CC4344D979C1DDF92F4,42861,7,19,12,37,44,1894
54433,54433,ACB823DB33D22CC4344D979C1DDF92F4,11261,19,20,1,36,46,1846
54434,54434,ACB823DB33D22CC4344D979C1DDF92F4,42861,21,22,1,37,44,1894
54438,54438,EA9A666FA0B23AFFCF7291147CEC4E64,12841,0,9,9,37,47,1897
54439,54439,EA9A666FA0B23AFFCF7291147CEC4E64,13101,11,12,1,40,47,2047
54440,54440,EA9A666FA0B23AFFCF7291147CEC4E64,11074,16,18,2,37,47,1897
54466,54466,3FBA130DE96D19DDB92B7C1710211CF0,10611,0,7,7,32,48,1648
54467,54467,3FBA130DE96D19DDB92B7C1710211CF0,10251,7,14,7,35,47,1797
54468,54468,3FBA130DE96D19DDB92B7C1710211CF0,11381,15,16,1,30,47,1547
54469,54469,3FBA130DE96D19DDB92B7C1710211CF0,10611,17,23,6,32,48,1648
54470,54470,E6D049947968658F47DDC695A59302A1,42461,5,11,6,45,47,2297
54471,54471,E6D049947968658F47DDC695A59302A1,42111,15,16,1,44,46,2246
54472,54472,E6D049947968658F47DDC695A59302A1,42461,16,18,2,45,47,2297
54473,54473,AA71E9A6AEA764D2564D532D0321512B,42041,4,5,1,10,47,547
54474,54474,AA71E9A6AEA764D2564D532D0321512B,11471,8,9,1,12,48,648
54475,54475,AA71E9A6AEA764D2564D532D0321512B,19441,13,19,6,8,46,446
54487,54487,10CE970ADBFDF0EB0AA90452C27FCACE,42921,6,7,1,33,47,1697
54488,54488,10CE970ADBFDF0EB0AA90452C27FCACE,43731,16,17,1,34,47,1747
54489,54489,10CE970ADBFDF0EB0AA90452C27FCACE,10731,22,23,1,33,47,1697
54490,54490,F74E1805BD471CD67AFEC7E33078A7FE,11914,0,4,4,37,48,1898
54491,54491,F74E1805BD471CD67AFEC7E33078A7FE,43361,5,18,13,38,48,1948
54492,54492,F74E1805BD471CD67AFEC7E33078A7FE,11914,19,22,3,37,48,1898
54493,54493,ED39FFF9DCC8B1E2AFD625755D8B1585,19441,0,10,10,8,46,446
54494,54494,ED39FFF9DCC8B1E2AFD625755D8B1585,42041,11,16,5,10,47,547
54495,54495,ED39FFF9DCC8B1E2AFD625755D8B1585,19441,20,23,3,8,46,446
54496,54496,B3D9D8E72FD92A77A76B6490766A3C36,19901,0,4,4,7,44,394
54497,54497,B3D9D8E72FD92A77A76B6490766A3C36,12641,4,8,4,10,43,543
54498,54498,B3D9D8E72FD92A77A76B6490766A3C36,19114,9,22,13,7,43,393
54506,54506,19FEA72E933762654AA8076BEF887027,43471,0,3,3,31,49,1599
54507,54507,19FEA72E933762654AA8076BEF887027,10292,3,8,5,30,47,1547
54508,54508,19FEA72E933762654AA8076BEF887027,43471,10,12,2,31,49,1599
54509,54509,19FEA72E933762654AA8076BEF887027,10292,12,18,6,30,47,1547
54510,54510,1C6B014A9F7E5BF6538ED8D07E462CBD,11074,0,4,4,37,47,1897
54511,54511,1C6B014A9F7E5BF6538ED8D07E462CBD,42221,4,5,1,38,48,1948
54512,54512,1C6B014A9F7E5BF6538ED8D07E462CBD,11074,5,22,17,37,47,1897
54513,54513,9B628FEA6BCA8EB97BB3F7B5F63CD306,13231,0,16,16,39,46,1996
54514,54514,9B628FEA6BCA8EB97BB3F7B5F63CD306,11074,19,21,2,37,47,1897
54515,54515,9B628FEA6BCA8EB97BB3F7B5F63CD306,13911,22,23,1,39,46,1996
54516,54516,3578C39840212012BBEC7A08D6782A20,19441,0,5,5,8,46,446
54517,54517,3578C39840212012BBEC7A08D6782A20,19821,8,21,13,4,46,246
54518,54518,3578C39840212012BBEC7A08D6782A20,19621,21,22,1,5,46,296
54519,54519,83BB102D42B106B02532A9E858086CAC,11061,0,18,18,29,48,1498
54520,54520,83BB102D42B106B02532A9E858086CAC,10681,19,20,1,30,48,1548
54521,54521,83BB102D42B106B02532A9E858086CAC,11061,21,23,2,29,48,1498
54527,54527,D1348284A12247DBF7195CE953852CD8,11161,1,5,4,32,48,1648
54528,54528,D1348284A12247DBF7195CE953852CD8,43311,5,17,12,31,48,1598
54529,54529,D1348284A12247DBF7195CE953852CD8,11061,17,19,2,29,48,1498
54530,54530,BF5242715718EEF665EE93EC69F552EB,13271,0,7,7,41,47,2097
54531,54531,BF5242715718EEF665EE93EC69F552EB,13101,7,16,9,40,47,2047
54532,54532,BF5242715718EEF665EE93EC69F552EB,11481,17,18,1,41,48,2098
54533,54533,BF5242715718EEF665EE93EC69F552EB,13101,20,21,1,40,47,2047
54534,54534,A79B530D2C24A6DA0A95FCC8A927C5D7,11161,2,15,13,32,48,1648
54535,54535,A79B530D2C24A6DA0A95FCC8A927C5D7,11384,16,17,1,30,47,1547
54536,54536,A79B530D2C24A6DA0A95FCC8A927C5D7,10681,18,20,2,30,48,1548
54545,54545,44E7185831084C05A6216294F3C62039,42231,0,6,6,37,46,1896
54546,54546,44E7185831084C05A6216294F3C62039,13711,11,13,2,38,46,1946
54547,54547,44E7185831084C05A6216294F3C62039,42231,16,21,5,37,46,1896
54559,54559,B5F3581649228AFCDFA595ACA1F1686A,11861,0,7,7,32,47,1647
54560,54560,B5F3581649228AFCDFA595ACA1F1686A,42161,10,12,2,36,47,1847
54561,54561,B5F3581649228AFCDFA595ACA1F1686A,10251,13,18,5,35,47,1797
54562,54562,B5F3581649228AFCDFA595ACA1F1686A,11861,18,23,5,32,47,1647
54576,54576,23F8F9B0AC0C62AC07DD5CA5BCEDE820,43101,1,5,4,46,40,2340
54577,54577,23F8F9B0AC0C62AC07DD5CA5BCEDE820,13551,5,7,2,45,38,2288
54578,54578,23F8F9B0AC0C62AC07DD5CA5BCEDE820,43101,10,22,12,46,40,2340
54583,54583,E9419CF3CD3CC1EF09B7A7931644F385,13271,0,12,12,41,47,2097
54584,54584,E9419CF3CD3CC1EF09B7A7931644F385,11001,14,16,2,42,47,2147
54585,54585,E9419CF3CD3CC1EF09B7A7931644F385,42321,18,19,1,43,47,2197
54586,54586,E9419CF3CD3CC1EF09B7A7931644F385,13271,20,22,2,41,47,2097
54597,54597,97B6D6D29EC4E9F125FDF48E88E16061,43971,10,11,1,30,48,1548
54598,54598,97B6D6D29EC4E9F125FDF48E88E16061,11381,13,15,2,30,47,1547
54599,54599,97B6D6D29EC4E9F125FDF48E88E16061,10681,17,19,2,30,48,1548
54603,54603,1CE5F4D10EE2FB173CB9F2BC0746661A,42531,0,14,14,31,45,1595
54604,54604,1CE5F4D10EE2FB173CB9F2BC0746661A,12311,16,18,2,30,44,1544
54605,54605,1CE5F4D10EE2FB173CB9F2BC0746661A,42531,19,20,1,31,45,1595
54606,54606,9018E334510830C940D94E13413D361F,13941,1,9,8,41,47,2097
54607,54607,9018E334510830C940D94E13413D361F,10787,11,15,4,38,46,1946
54608,54608,9018E334510830C940D94E13413D361F,13911,15,16,1,39,46,1996
54609,54609,9018E334510830C940D94E13413D361F,10787,18,19,1,38,46,1946
54637,54637,BAAEF1F815128F9C42A2F609EF6E43D2,42921,1,7,6,33,47,1697
54638,54638,BAAEF1F815128F9C42A2F609EF6E43D2,42161,8,9,1,36,47,1847
54639,54639,BAAEF1F815128F9C42A2F609EF6E43D2,42921,17,18,1,33,47,1697
54640,54640,17AEFEF657B11D131BDD3C3B66C9A042,10271,0,12,12,37,46,1896
54641,54641,17AEFEF657B11D131BDD3C3B66C9A042,13121,18,19,1,38,46,1946
54642,54642,17AEFEF657B11D131BDD3C3B66C9A042,10271,22,23,1,37,46,1896
54643,54643,537D82A817A1381A8BFD833A3BEC4C9C,12491,0,6,6,36,43,1843
54644,54644,537D82A817A1381A8BFD833A3BEC4C9C,11261,8,10,2,36,46,1846
54645,54645,537D82A817A1381A8BFD833A3BEC4C9C,12491,12,23,11,36,43,1843
54646,54646,F13D3DEE3873922393A59999280D3E31,42081,1,3,2,24,49,1249
54647,54647,F13D3DEE3873922393A59999280D3E31,10451,4,5,1,25,48,1298
54648,54648,F13D3DEE3873922393A59999280D3E31,42081,7,19,12,24,49,1249
54655,54655,99215A6EE9EE45501EC0F8414BE04C65,19441,0,16,16,8,46,446
54656,54656,99215A6EE9EE45501EC0F8414BE04C65,42041,18,20,2,10,47,547
54657,54657,99215A6EE9EE45501EC0F8414BE04C65,19441,21,23,2,8,46,446
54677,54677,A50C650BD813B6D195D37ED8F6B1810B,42521,2,7,5,31,47,1597
54678,54678,A50C650BD813B6D195D37ED8F6B1810B,43761,8,9,1,32,47,1647
54679,54679,A50C650BD813B6D195D37ED8F6B1810B,42521,10,22,12,31,47,1597
54688,54688,B730A33E99587C5901F2126A9B1336FE,11261,1,2,1,36,46,1846
54689,54689,B730A33E99587C5901F2126A9B1336FE,42151,5,6,1,35,45,1795
54690,54690,B730A33E99587C5901F2126A9B1336FE,11261,9,23,14,36,46,1846
54691,54691,C02E7CB04CF45CC282E2DD753C8B9300,11461,0,6,6,37,49,1899
54692,54692,C02E7CB04CF45CC282E2DD753C8B9300,10471,8,15,7,37,48,1898
54693,54693,C02E7CB04CF45CC282E2DD753C8B9300,12021,15,21,6,37,49,1899
54709,54709,0AFAF8C12B0A136F334DBF2EEFFABEC7,42161,0,13,13,36,47,1847
54710,54710,0AFAF8C12B0A136F334DBF2EEFFABEC7,13711,14,15,1,38,46,1946
54711,54711,0AFAF8C12B0A136F334DBF2EEFFABEC7,42161,16,19,3,36,47,1847
54712,54712,0AFAF8C12B0A136F334DBF2EEFFABEC7,10411,21,23,2,36,48,1848
54718,54718,72EE059838FC074BF0955787969E7967,11231,0,4,4,37,49,1899
54719,54719,72EE059838FC074BF0955787969E7967,11911,4,19,15,37,48,1898
54720,54720,72EE059838FC074BF0955787969E7967,11231,19,21,2,37,49,1899
54731,54731,8167EF05D15F996A6B93D96BD3E78468,10521,0,10,10,41,47,2097
54732,54732,8167EF05D15F996A6B93D96BD3E78468,12514,12,16,4,38,47,1947
54733,54733,8167EF05D15F996A6B93D96BD3E78468,43481,17,18,1,39,48,1998
54734,54734,8167EF05D15F996A6B93D96BD3E78468,12514,21,22,1,38,47,1947
54754,54754,8E0D20320C5276BDD797BA6D65B9C51D,11074,0,7,7,37,47,1897
54755,54755,8E0D20320C5276BDD797BA6D65B9C51D,11231,9,18,9,37,49,1899
54756,54756,8E0D20320C5276BDD797BA6D65B9C51D,11074,19,23,4,37,47,1897
54781,54781,71406CAB7DAA1D3016D1EDF130C6F573,10491,0,12,12,33,48,1698
54782,54782,71406CAB7DAA1D3016D1EDF130C6F573,10431,15,17,2,33,49,1699
54783,54783,71406CAB7DAA1D3016D1EDF130C6F573,10491,18,23,5,33,48,1698
54789,54789,DF6451E86EE4B7B98BCA60FC558F51EE,11151,3,5,2,30,48,1548
54790,54790,DF6451E86EE4B7B98BCA60FC558F51EE,12121,9,10,1,29,47,1497
54791,54791,DF6451E86EE4B7B98BCA60FC558F51EE,11151,12,14,2,30,48,1548
54792,54792,DF6451E86EE4B7B98BCA60FC558F51EE,12121,15,19,4,29,47,1497
54793,54793,511248B31413344B77C12D74A5EE7CDF,43471,0,7,7,31,49,1599
54794,54794,511248B31413344B77C12D74A5EE7CDF,11151,7,16,9,30,48,1548
54795,54795,511248B31413344B77C12D74A5EE7CDF,11381,19,22,3,30,47,1547
54796,54796,DA48F6EEC4784B4505CA1BBB58EA121A,10341,0,7,7,31,47,1597
54797,54797,DA48F6EEC4784B4505CA1BBB58EA121A,10292,8,18,10,30,47,1547
54798,54798,DA48F6EEC4784B4505CA1BBB58EA121A,10341,18,23,5,31,47,1597
54813,54813,99A6F2BFC43DC2A47DFE76E77682AD15,43341,0,1,1,41,46,2096
54814,54814,99A6F2BFC43DC2A47DFE76E77682AD15,10821,5,6,1,40,47,2047
54815,54815,99A6F2BFC43DC2A47DFE76E77682AD15,10771,6,22,16,41,46,2096
54822,54822,857A8E0D6DC1B408B8273E584D9A8FC4,13371,0,13,13,41,47,2097
54823,54823,857A8E0D6DC1B408B8273E584D9A8FC4,13221,13,15,2,40,47,2047
54824,54824,857A8E0D6DC1B408B8273E584D9A8FC4,11806,16,17,1,41,48,2098
54825,54825,857A8E0D6DC1B408B8273E584D9A8FC4,13371,18,23,5,41,47,2097
54829,54829,D918AB959FC04B9F76C490D41025EBC5,11161,0,13,13,32,48,1648
54830,54830,D918AB959FC04B9F76C490D41025EBC5,12131,14,16,2,32,47,1647
54831,54831,D918AB959FC04B9F76C490D41025EBC5,42523,16,20,4,31,47,1597
54838,54838,50897C798DD981F790935635A0EC3137,12601,4,8,4,25,47,1297
54839,54839,50897C798DD981F790935635A0EC3137,42501,8,16,8,28,47,1447
54840,54840,50897C798DD981F790935635A0EC3137,10501,17,18,1,22,46,1146
54841,54841,50897C798DD981F790935635A0EC3137,12601,20,22,2,25,47,1297
54852,54852,91764B4567AC3A3991286EF06C97A20D,42161,0,7,7,36,47,1847
54853,54853,91764B4567AC3A3991286EF06C97A20D,11351,9,10,1,36,48,1848
54854,54854,91764B4567AC3A3991286EF06C97A20D,42161,10,23,13,36,47,1847
54862,54862,7AEC96944ABDE836F2A5F23132A96D0B,10841,1,7,6,37,47,1897
54863,54863,7AEC96944ABDE836F2A5F23132A96D0B,13711,7,9,2,38,46,1946
54864,54864,7AEC96944ABDE836F2A5F23132A96D0B,42511,10,19,9,37,47,1897
54865,54865,7AEC96944ABDE836F2A5F23132A96D0B,10107,21,23,2,38,49,1949
54866,54866,26A4E7AD001291610BB2E4F05F35E9EC,10841,4,7,3,37,47,1897
54867,54867,26A4E7AD001291610BB2E4F05F35E9EC,42161,9,10,1,36,47,1847
54868,54868,26A4E7AD001291610BB2E4F05F35E9EC,10841,10,21,11,37,47,1897
54869,54869,2FA830A3F4936C72A1774CB1227927A5,42161,0,6,6,36,47,1847
54870,54870,2FA830A3F4936C72A1774CB1227927A5,11861,8,16,8,32,47,1647
54871,54871,2FA830A3F4936C72A1774CB1227927A5,42161,18,23,5,36,47,1847
54877,54877,CA5A17D561EB9E25269F629C4481540B,19441,1,7,6,8,46,446
54878,54878,CA5A17D561EB9E25269F629C4481540B,42041,9,11,2,10,47,547
54879,54879,CA5A17D561EB9E25269F629C4481540B,19441,14,21,7,8,46,446
54886,54886,ED70E4FFEFCCC0655C158EA3C526D0EE,11271,0,9,9,37,48,1898
54887,54887,ED70E4FFEFCCC0655C158EA3C526D0EE,42581,11,16,5,38,48,1948
54888,54888,ED70E4FFEFCCC0655C158EA3C526D0EE,11914,17,21,4,37,48,1898
54889,54889,E9A6854809AA21C1B70C29D20C0730F1,42583,0,5,5,40,48,2048
54890,54890,E9A6854809AA21C1B70C29D20C0730F1,42271,9,17,8,40,47,2047
54891,54891,E9A6854809AA21C1B70C29D20C0730F1,42583,18,23,5,40,48,2048
54892,54892,D3E93108E73ADFBA18AB9EBB04FADE2A,13711,0,7,7,38,46,1946
54893,54893,D3E93108E73ADFBA18AB9EBB04FADE2A,11941,9,10,1,37,46,1896
54894,54894,D3E93108E73ADFBA18AB9EBB04FADE2A,13711,14,23,9,38,46,1946
54895,54895,6044840CFD66768767F795D814077A8F,10271,2,3,1,37,46,1896
54896,54896,6044840CFD66768767F795D814077A8F,13121,7,10,3,38,46,1946
54897,54897,6044840CFD66768767F795D814077A8F,10271,11,20,9,37,46,1896
54906,54906,53173294ED5BF12AABAED82F9B761816,10161,0,13,13,35,49,1799
54907,54907,53173294ED5BF12AABAED82F9B761816,43281,14,15,1,37,48,1898
54908,54908,53173294ED5BF12AABAED82F9B761816,10161,17,23,6,35,49,1799
54914,54914,6AE2FA19F90C6BBDAB69E2E1C7BD408D,11914,0,2,2,37,48,1898
54915,54915,6AE2FA19F90C6BBDAB69E2E1C7BD408D,11921,2,6,4,38,48,1948
54916,54916,6AE2FA19F90C6BBDAB69E2E1C7BD408D,11914,7,10,3,37,48,1898
54917,54917,6AE2FA19F90C6BBDAB69E2E1C7BD408D,11921,10,20,10,38,48,1948
54921,54921,823BB637426A4B64F4A56D087D45C241,49201,0,6,6,7,41,391
54922,54922,823BB637426A4B64F4A56D087D45C241,12921,7,8,1,9,41,491
54923,54923,823BB637426A4B64F4A56D087D45C241,19181,10,11,1,8,40,440
54924,54924,823BB637426A4B64F4A56D087D45C241,49201,11,22,11,7,41,391
54934,54934,B3D3247264CC59DE8B1DE47660D9C8A8,43761,4,13,9,32,47,1647
54935,54935,B3D3247264CC59DE8B1DE47660D9C8A8,11161,18,20,2,32,48,1648
54936,54936,B3D3247264CC59DE8B1DE47660D9C8A8,43761,20,22,2,32,47,1647
54937,54937,FE5BD9848E0FBBF0629F9C0576D0DEBF,13231,0,15,15,39,46,1996
54938,54938,FE5BD9848E0FBBF0629F9C0576D0DEBF,13271,16,17,1,41,47,2097
54939,54939,FE5BD9848E0FBBF0629F9C0576D0DEBF,13111,20,21,1,42,46,2146
54940,54940,FE5BD9848E0FBBF0629F9C0576D0DEBF,13371,22,23,1,41,47,2097
54941,54941,1444CF26498FCF95995CE1D21CF4BAA6,12121,0,10,10,29,47,1497
54942,54942,1444CF26498FCF95995CE1D21CF4BAA6,11381,10,12,2,30,47,1547
54943,54943,1444CF26498FCF95995CE1D21CF4BAA6,12121,12,14,2,29,47,1497
54944,54944,1444CF26498FCF95995CE1D21CF4BAA6,10951,19,20,1,29,48,1498
54945,54945,0407AC9F4B447C49ABB57DABBBF0B0D5,10107,0,8,8,38,49,1949
54946,54946,0407AC9F4B447C49ABB57DABBBF0B0D5,43321,13,14,1,36,49,1849
54947,54947,0407AC9F4B447C49ABB57DABBBF0B0D5,10841,18,20,2,37,47,1897
54948,54948,0407AC9F4B447C49ABB57DABBBF0B0D5,11461,21,23,2,37,49,1899
54949,54949,78C0E1E992CFF9ECB9C6D46D3E929FD4,11381,0,8,8,30,47,1547
54950,54950,78C0E1E992CFF9ECB9C6D46D3E929FD4,10951,12,16,4,29,48,1498
54951,54951,78C0E1E992CFF9ECB9C6D46D3E929FD4,11381,18,21,3,30,47,1547
54975,54975,0BC1BC9FA127A76D4558FF0A0EC8FEFB,42921,0,7,7,33,47,1697
54976,54976,0BC1BC9FA127A76D4558FF0A0EC8FEFB,10281,7,10,3,33,48,1698
54977,54977,0BC1BC9FA127A76D4558FF0A0EC8FEFB,42921,10,21,11,33,47,1697
54985,54985,D9FB9F3F4820A4EF951566780A770C45,11261,1,14,13,36,46,1846
54986,54986,D9FB9F3F4820A4EF951566780A770C45,13911,14,15,1,39,46,1996
54987,54987,D9FB9F3F4820A4EF951566780A770C45,11261,15,22,7,36,46,1846
55014,55014,7C98BDF484E2B085C51A4945E804FC0C,12491,2,3,1,36,43,1843
55015,55015,7C98BDF484E2B085C51A4945E804FC0C,42151,6,8,2,35,45,1795
55016,55016,7C98BDF484E2B085C51A4945E804FC0C,12491,9,10,1,36,43,1843
55017,55017,7C98BDF484E2B085C51A4945E804FC0C,42151,12,22,10,35,45,1795
55018,55018,829F3CF969A99106A0CF5C6D0ED0FE14,42401,0,8,8,36,47,1847
55019,55019,829F3CF969A99106A0CF5C6D0ED0FE14,11751,9,15,6,35,48,1798
55020,55020,829F3CF969A99106A0CF5C6D0ED0FE14,42161,15,23,8,36,47,1847
55025,55025,A486521758A27268CCD3905C2122B6F8,11861,0,6,6,32,47,1647
55026,55026,A486521758A27268CCD3905C2122B6F8,10281,8,10,2,33,48,1698
55027,55027,A486521758A27268CCD3905C2122B6F8,11861,12,23,11,32,47,1647
55028,55028,E0FF7520EFDD25C189B1D0DD253AAD45,10491,5,16,11,33,48,1698
55029,55029,E0FF7520EFDD25C189B1D0DD253AAD45,13601,16,18,2,34,47,1747
55030,55030,E0FF7520EFDD25C189B1D0DD253AAD45,10491,20,21,1,33,48,1698
55031,55031,4D407CD47CFEED22A9E812F9DCEEE880,42541,0,7,7,25,47,1297
55032,55032,4D407CD47CFEED22A9E812F9DCEEE880,11111,9,10,1,26,48,1348
55033,55033,4D407CD47CFEED22A9E812F9DCEEE880,42541,12,19,7,25,47,1297
55034,55034,0C3EDD26A7ED891A1146E2AB7A623C19,10151,1,8,7,34,47,1747
55035,55035,0C3EDD26A7ED891A1146E2AB7A623C19,10971,8,11,3,35,47,1797
55036,55036,0C3EDD26A7ED891A1146E2AB7A623C19,40981,12,23,11,34,47,1747
55056,55056,5D8FA5419FA0CA7A8C3CA55000085D74,11021,0,13,13,36,49,1849
55057,55057,5D8FA5419FA0CA7A8C3CA55000085D74,10231,16,19,3,39,49,1999
55058,55058,5D8FA5419FA0CA7A8C3CA55000085D74,11021,19,23,4,36,49,1849
55071,55071,70001957DCF2B9125DCB996733DDF49B,11381,0,11,11,30,47,1547
55072,55072,70001957DCF2B9125DCB996733DDF49B,11061,11,12,1,29,48,1498
55073,55073,70001957DCF2B9125DCB996733DDF49B,11381,14,23,9,30,47,1547
55084,55084,5AF85D9ED958D0E5348613692DAC5B4D,12083,0,13,13,36,49,1849
55085,55085,5AF85D9ED958D0E5348613692DAC5B4D,10471,18,19,1,37,48,1898
55086,55086,5AF85D9ED958D0E5348613692DAC5B4D,10661,21,22,1,37,49,1899
55090,55090,232A65D7E72D31ED563D0041FCDF23A8,12491,3,4,1,36,43,1843
55091,55091,232A65D7E72D31ED563D0041FCDF23A8,42151,4,11,7,35,45,1795
55092,55092,232A65D7E72D31ED563D0041FCDF23A8,12491,11,15,4,36,43,1843
55093,55093,232A65D7E72D31ED563D0041FCDF23A8,42151,15,20,5,35,45,1795
55097,55097,E24F34B965BE1054DCE4AF1C1CD48137,43761,2,7,5,32,47,1647
55098,55098,E24F34B965BE1054DCE4AF1C1CD48137,11875,9,20,11,30,46,1546
55099,55099,E24F34B965BE1054DCE4AF1C1CD48137,42523,22,23,1,31,47,1597
55100,55100,2C8F3D11EF1554D46E77DD772B97CCCA,10281,0,7,7,33,48,1698
55101,55101,2C8F3D11EF1554D46E77DD772B97CCCA,11211,8,17,9,34,49,1749
55102,55102,2C8F3D11EF1554D46E77DD772B97CCCA,11861,18,22,4,32,47,1647
55129,55129,E45B0EC44E00842EDD865C65A561543D,11791,0,7,7,38,49,1949
55130,55130,E45B0EC44E00842EDD865C65A561543D,11231,10,16,6,37,49,1899
55131,55131,E45B0EC44E00842EDD865C65A561543D,10471,16,21,5,37,48,1898
55132,55132,F004825C5EEC7F8B7A184D4985895C55,13341,0,9,9,44,45,2245
55133,55133,F004825C5EEC7F8B7A184D4985895C55,42631,12,13,1,43,45,2195
55134,55134,F004825C5EEC7F8B7A184D4985895C55,13341,16,19,3,44,45,2245
55141,55141,537B866E49840CD2552EC8B3E30E45EA,42921,2,8,6,33,47,1697
55142,55142,537B866E49840CD2552EC8B3E30E45EA,42523,10,12,2,31,47,1597
55143,55143,537B866E49840CD2552EC8B3E30E45EA,42021,15,23,8,33,47,1697
55147,55147,2DF528642956EE7F281EE1C987DEF31F,10271,0,13,13,37,46,1896
55148,55148,2DF528642956EE7F281EE1C987DEF31F,13711,17,19,2,38,46,1946
55149,55149,2DF528642956EE7F281EE1C987DEF31F,43241,19,23,4,36,46,1846
55155,55155,0C2B805EE888E91F034AB21F925F07C4,12641,0,1,1,10,43,543
55156,55156,0C2B805EE888E91F034AB21F925F07C4,19901,3,5,2,7,44,394
55157,55157,0C2B805EE888E91F034AB21F925F07C4,12641,8,16,8,10,43,543
55158,55158,0C2B805EE888E91F034AB21F925F07C4,19901,18,23,5,7,44,394
55162,55162,DFD67893B33D33FDAA92DC71D5732DAF,42161,0,8,8,36,47,1847
55163,55163,DFD67893B33D33FDAA92DC71D5732DAF,10111,9,11,2,37,47,1897
55164,55164,DFD67893B33D33FDAA92DC71D5732DAF,42161,15,23,8,36,47,1847
55165,55165,F49EE04071D0B4FCCD4263F4C2BBEA7A,11061,0,9,9,29,48,1498
55166,55166,F49EE04071D0B4FCCD4263F4C2BBEA7A,42521,10,13,3,31,47,1597
55167,55167,F49EE04071D0B4FCCD4263F4C2BBEA7A,11061,13,15,2,29,48,1498
55168,55168,F49EE04071D0B4FCCD4263F4C2BBEA7A,11161,18,19,1,32,48,1648
55176,55176,B93C16A242FE2C6BDA83A87AD4FAA434,12601,1,14,13,25,47,1297
55177,55177,B93C16A242FE2C6BDA83A87AD4FAA434,10501,17,18,1,22,46,1146
55178,55178,B93C16A242FE2C6BDA83A87AD4FAA434,12601,21,23,2,25,47,1297
55188,55188,A9F1EF87A848BD2C4BF1249EFA267D70,43391,6,8,2,29,48,1498
55189,55189,A9F1EF87A848BD2C4BF1249EFA267D70,11151,10,19,9,30,48,1548
55190,55190,A9F1EF87A848BD2C4BF1249EFA267D70,43391,19,21,2,29,48,1498
55191,55191,38FB09D98F279F59CE399773ACB503E3,13651,0,9,9,30,47,1547
55192,55192,38FB09D98F279F59CE399773ACB503E3,42523,12,13,1,31,47,1597
55193,55193,38FB09D98F279F59CE399773ACB503E3,13651,13,15,2,30,47,1547
55194,55194,38FB09D98F279F59CE399773ACB503E3,42523,16,22,6,31,47,1597
55200,55200,E03F688C8922274B8BAEDCD028D40933,11211,0,6,6,34,49,1749
55201,55201,E03F688C8922274B8BAEDCD028D40933,12083,8,10,2,36,49,1849
55202,55202,E03F688C8922274B8BAEDCD028D40933,11541,14,18,4,35,49,1799
55209,55209,11534B45DBFCE23E4C62C21170401294,10381,0,16,16,31,49,1599
55210,55210,11534B45DBFCE23E4C62C21170401294,11151,17,19,2,30,48,1548
55211,55211,11534B45DBFCE23E4C62C21170401294,11061,20,21,1,29,48,1498
55218,55218,C5798701E778871D8F320C9FF390C5D0,42981,0,2,2,36,49,1849
55219,55219,C5798701E778871D8F320C9FF390C5D0,11231,5,13,8,37,49,1899
55220,55220,C5798701E778871D8F320C9FF390C5D0,10901,19,21,2,35,48,1798
55224,55224,C3385B266A5088A7FA48BCC62DFDD003,11914,1,2,1,37,48,1898
55225,55225,C3385B266A5088A7FA48BCC62DFDD003,43181,7,12,5,39,48,1998
55226,55226,C3385B266A5088A7FA48BCC62DFDD003,42583,15,16,1,40,48,2048
55227,55227,C3385B266A5088A7FA48BCC62DFDD003,11914,18,22,4,37,48,1898
55228,55228,29B536EE93C2E266619D50C15F53EE29,42531,4,5,1,31,45,1595
55229,55229,29B536EE93C2E266619D50C15F53EE29,12311,9,10,1,30,44,1544
55230,55230,29B536EE93C2E266619D50C15F53EE29,42531,12,13,1,31,45,1595
55231,55231,29B536EE93C2E266619D50C15F53EE29,12311,15,20,5,30,44,1544
55235,55235,9BBBC00C93BA6A3176E2B008E6F8A88E,13911,0,7,7,39,46,1996
55236,55236,9BBBC00C93BA6A3176E2B008E6F8A88E,11261,7,17,10,36,46,1846
55237,55237,9BBBC00C93BA6A3176E2B008E6F8A88E,42351,22,23,1,38,45,1945
55238,55238,8AA4A8CCD104CA281FD495C84503BAAA,40123,0,10,10,38,47,1947
55239,55239,8AA4A8CCD104CA281FD495C84503BAAA,10841,10,18,8,37,47,1897
55240,55240,8AA4A8CCD104CA281FD495C84503BAAA,12511,21,23,2,39,47,1997
55264,55264,5DC656AE1F755A21D4CE0049D29039D4,12491,1,16,15,36,43,1843
55265,55265,5DC656AE1F755A21D4CE0049D29039D4,11261,16,18,2,36,46,1846
55266,55266,5DC656AE1F755A21D4CE0049D29039D4,12491,20,22,2,36,43,1843
55283,55283,449E7811DCD6E8CD500501049B5A906E,13231,0,4,4,39,46,1996
55284,55284,449E7811DCD6E8CD500501049B5A906E,11261,6,9,3,36,46,1846
55285,55285,449E7811DCD6E8CD500501049B5A906E,13231,14,22,8,39,46,1996
55316,55316,EAAC45FB100EE8A458EC0FF985DACA2D,11271,0,6,6,37,48,1898
55317,55317,EAAC45FB100EE8A458EC0FF985DACA2D,11231,8,19,11,37,49,1899
55318,55318,EAAC45FB100EE8A458EC0FF985DACA2D,11751,21,23,2,35,48,1798
55319,55319,FF16D1104349162E539969031BE39A02,12511,1,12,11,39,47,1997
55320,55320,FF16D1104349162E539969031BE39A02,43481,12,13,1,39,48,1998
55321,55321,FF16D1104349162E539969031BE39A02,12514,15,17,2,38,47,1947
55322,55322,FF16D1104349162E539969031BE39A02,43481,20,23,3,39,48,1998
55326,55326,14221EE63F6EE55805EE5B3069F379DA,11914,3,4,1,37,48,1898
55327,55327,14221EE63F6EE55805EE5B3069F379DA,42581,5,17,12,38,48,1948
55328,55328,14221EE63F6EE55805EE5B3069F379DA,11914,22,23,1,37,48,1898
55337,55337,01308B72F71E3AACC045F922DA6CAE4D,42523,2,3,1,31,47,1597
55338,55338,01308B72F71E3AACC045F922DA6CAE4D,42141,8,12,4,32,47,1647
55339,55339,01308B72F71E3AACC045F922DA6CAE4D,42523,14,17,3,31,47,1597
55340,55340,01308B72F71E3AACC045F922DA6CAE4D,43761,17,19,2,32,47,1647
55341,55341,7875A34DC3B1C1A6D18480769685A825,13911,1,6,5,39,46,1996
55342,55342,7875A34DC3B1C1A6D18480769685A825,42231,10,15,5,37,46,1896
55343,55343,7875A34DC3B1C1A6D18480769685A825,42351,15,17,2,38,45,1945
55344,55344,7875A34DC3B1C1A6D18480769685A825,42231,20,22,2,37,46,1896
55349,55349,775CA947FF37432092AA3395F5AA137B,42161,0,7,7,36,47,1847
55350,55350,775CA947FF37432092AA3395F5AA137B,10971,8,9,1,35,47,1797
55351,55351,775CA947FF37432092AA3395F5AA137B,43731,9,16,7,34,47,1747
55352,55352,775CA947FF37432092AA3395F5AA137B,11171,21,23,2,33,48,1698
55353,55353,422DDC348F4AAA002A648FA0F6118A74,43761,2,6,4,32,47,1647
55354,55354,422DDC348F4AAA002A648FA0F6118A74,11161,7,14,7,32,48,1648
55355,55355,422DDC348F4AAA002A648FA0F6118A74,43761,15,18,3,32,47,1647
55356,55356,AB5381797B6ADC5A15B6453B748F1596,42301,10,11,1,36,47,1847
55357,55357,AB5381797B6ADC5A15B6453B748F1596,42231,12,15,3,37,46,1896
55358,55358,AB5381797B6ADC5A15B6453B748F1596,42301,16,19,3,36,47,1847
55359,55359,AB5381797B6ADC5A15B6453B748F1596,42231,22,23,1,37,46,1896
55363,55363,D5C29F54FD64D9CE1AEFE2D9CA4F33A5,11481,0,8,8,41,48,2098
55364,55364,D5C29F54FD64D9CE1AEFE2D9CA4F33A5,13101,8,10,2,40,47,2047
55365,55365,D5C29F54FD64D9CE1AEFE2D9CA4F33A5,13271,14,15,1,41,47,2097
55366,55366,D5C29F54FD64D9CE1AEFE2D9CA4F33A5,13101,16,22,6,40,47,2047
55370,55370,673C7752ED9E3B3369D8D81C56DEA1B1,11151,10,12,2,30,48,1548
55371,55371,673C7752ED9E3B3369D8D81C56DEA1B1,13731,15,18,3,33,49,1699
55372,55372,673C7752ED9E3B3369D8D81C56DEA1B1,10381,19,21,2,31,49,1599
55389,55389,6902B095816DEE42BB8BCB5226AA6999,42071,0,5,5,31,49,1599
55390,55390,6902B095816DEE42BB8BCB5226AA6999,12971,6,7,1,32,48,1648
55391,55391,6902B095816DEE42BB8BCB5226AA6999,42071,8,23,15,31,49,1599
55403,55403,6FD652D798368C322ABC17921EC65CA1,12511,2,10,8,39,47,1997
55404,55404,6FD652D798368C322ABC17921EC65CA1,13221,12,14,2,40,47,2047
55405,55405,6FD652D798368C322ABC17921EC65CA1,12511,15,16,1,39,47,1997
55406,55406,6FD652D798368C322ABC17921EC65CA1,13221,18,20,2,40,47,2047
55407,55407,4675C8D710D5EDCBB642FE322F526AC8,10271,0,6,6,37,46,1896
55408,55408,4675C8D710D5EDCBB642FE322F526AC8,13121,14,15,1,38,46,1946
55409,55409,4675C8D710D5EDCBB642FE322F526AC8,10271,20,23,3,37,46,1896
55413,55413,1DFC063262F02B96AF96AED120E22A58,40673,0,9,9,36,48,1848
55414,55414,1DFC063262F02B96AF96AED120E22A58,11231,9,18,9,37,49,1899
55415,55415,1DFC063262F02B96AF96AED120E22A58,40673,20,23,3,36,48,1848
55440,55440,F0A1BB763F378032A1CC33E7783B3D13,11231,10,12,2,37,49,1899
55441,55441,F0A1BB763F378032A1CC33E7783B3D13,11021,12,13,1,36,49,1849
55442,55442,F0A1BB763F378032A1CC33E7783B3D13,10661,15,16,1,37,49,1899
55443,55443,F0A1BB763F378032A1CC33E7783B3D13,11021,16,21,5,36,49,1849
55450,55450,EB7EB6074C1F2A07A41462E31EDA6629,42401,0,17,17,36,47,1847
55451,55451,EB7EB6074C1F2A07A41462E31EDA6629,10781,19,20,1,35,47,1797
55452,55452,EB7EB6074C1F2A07A41462E31EDA6629,42401,22,23,1,36,47,1847
55480,55480,DD628D137A372FD9F2379158E8EE3966,12921,10,15,5,9,41,491
55481,55481,DD628D137A372FD9F2379158E8EE3966,49201,17,18,1,7,41,391
55482,55482,DD628D137A372FD9F2379158E8EE3966,12921,20,23,3,9,41,491
55486,55486,BD517E29BD7069EA61B2CA0844AA760E,10731,0,6,6,33,47,1697
55487,55487,BD517E29BD7069EA61B2CA0844AA760E,43761,8,9,1,32,47,1647
55488,55488,BD517E29BD7069EA61B2CA0844AA760E,42523,9,11,2,31,47,1597
55489,55489,BD517E29BD7069EA61B2CA0844AA760E,43761,11,19,8,32,47,1647
55494,55494,5DAE8FB10D3FBEF5B02F98DB4BFD46E9,13911,4,8,4,39,46,1996
55495,55495,5DAE8FB10D3FBEF5B02F98DB4BFD46E9,42231,8,19,11,37,46,1896
55496,55496,5DAE8FB10D3FBEF5B02F98DB4BFD46E9,42351,20,23,3,38,45,1945
55520,55520,51CA45CA2AACCC83748D6918E9F511C1,12661,0,5,5,32,45,1645
55521,55521,51CA45CA2AACCC83748D6918E9F511C1,42151,8,9,1,35,45,1795
55522,55522,51CA45CA2AACCC83748D6918E9F511C1,12661,12,20,8,32,45,1645
55531,55531,8C6728922EF1CCC03B1E56C8334750DD,11641,0,7,7,22,49,1149
55532,55532,8C6728922EF1CCC03B1E56C8334750DD,42681,9,10,1,24,48,1248
55533,55533,8C6728922EF1CCC03B1E56C8334750DD,42481,13,15,2,22,49,1149
55534,55534,8C6728922EF1CCC03B1E56C8334750DD,42681,16,19,3,24,48,1248
55535,55535,6A0394A16431C3763362EDB77E0D6861,42071,0,3,3,31,49,1599
55536,55536,6A0394A16431C3763362EDB77E0D6861,10544,3,11,8,28,48,1448
55537,55537,6A0394A16431C3763362EDB77E0D6861,42071,13,22,9,31,49,1599
55538,55538,6A0394A16431C3763362EDB77E0D6861,10544,22,23,1,28,48,1448
55539,55539,CC63EA7467D4A1FC7EF1BC76C9DAF092,42864,1,5,4,38,44,1944
55540,55540,CC63EA7467D4A1FC7EF1BC76C9DAF092,11261,5,9,4,36,46,1846
55541,55541,CC63EA7467D4A1FC7EF1BC76C9DAF092,42864,11,12,1,38,44,1944
55542,55542,CC63EA7467D4A1FC7EF1BC76C9DAF092,11261,13,23,10,36,46,1846
55552,55552,79F70A1AE08CEE215DA71360DE1B25EA,42191,0,6,6,38,49,1949
55553,55553,79F70A1AE08CEE215DA71360DE1B25EA,42231,6,16,10,37,46,1896
55554,55554,79F70A1AE08CEE215DA71360DE1B25EA,42191,18,23,5,38,49,1949
55555,55555,F41A8974955ECE62F73018566CCACF3F,10221,0,7,7,34,49,1749
55556,55556,F41A8974955ECE62F73018566CCACF3F,11021,12,17,5,36,49,1849
55557,55557,F41A8974955ECE62F73018566CCACF3F,10221,20,23,3,34,49,1749
55561,55561,24C52F5FD3AA43CF1A9BAB6BC0B1DF40,43731,10,14,4,34,47,1747
55562,55562,24C52F5FD3AA43CF1A9BAB6BC0B1DF40,42161,14,16,2,36,47,1847
55563,55563,24C52F5FD3AA43CF1A9BAB6BC0B1DF40,43731,16,18,2,34,47,1747
55570,55570,6AE77A399A63A8DDF88CC6FDD4441AB8,42041,1,4,3,10,47,547
55571,55571,6AE77A399A63A8DDF88CC6FDD4441AB8,19441,8,9,1,8,46,446
55572,55572,6AE77A399A63A8DDF88CC6FDD4441AB8,42041,10,12,2,10,47,547
55573,55573,6AE77A399A63A8DDF88CC6FDD4441AB8,19441,15,23,8,8,46,446
55588,55588,8A2B6A3BBB67F4CA1B157F83176E3E9B,11151,0,1,1,30,48,1548
55589,55589,8A2B6A3BBB67F4CA1B157F83176E3E9B,42071,2,6,4,31,49,1599
55590,55590,8A2B6A3BBB67F4CA1B157F83176E3E9B,11151,11,21,10,30,48,1548
55591,55591,4EC8CDFD9ACA8FBC9C617E8D400F2F94,42581,2,7,5,38,48,1948
55592,55592,4EC8CDFD9ACA8FBC9C617E8D400F2F94,11914,10,11,1,37,48,1898
55593,55593,4EC8CDFD9ACA8FBC9C617E8D400F2F94,42581,13,16,3,38,48,1948
55594,55594,4EC8CDFD9ACA8FBC9C617E8D400F2F94,11914,16,19,3,37,48,1898
55599,55599,EE8535EFC0E3237FE1E9870ACB3D38E1,43621,0,2,2,46,48,2348
55600,55600,EE8535EFC0E3237FE1E9870ACB3D38E1,42321,6,7,1,43,47,2197
55601,55601,EE8535EFC0E3237FE1E9870ACB3D38E1,43621,7,9,2,46,48,2348
55602,55602,EE8535EFC0E3237FE1E9870ACB3D38E1,42321,9,19,10,43,47,2197
55603,55603,4A7EF801268FA87DD49AA705DCA560E1,42581,0,1,1,38,48,1948
55604,55604,4A7EF801268FA87DD49AA705DCA560E1,12514,2,7,5,38,47,1947
55605,55605,4A7EF801268FA87DD49AA705DCA560E1,42581,11,23,12,38,48,1948
55622,55622,B951230F2D8FB21FF5FBA5B70040A128,11151,0,6,6,30,48,1548
55623,55623,B951230F2D8FB21FF5FBA5B70040A128,11061,7,10,3,29,48,1498
55624,55624,B951230F2D8FB21FF5FBA5B70040A128,10681,11,20,9,30,48,1548
55625,55625,83B65A620AA8887006B94BCE755E769B,10351,0,3,3,28,45,1445
55626,55626,83B65A620AA8887006B94BCE755E769B,10634,7,9,2,27,45,1395
55627,55627,83B65A620AA8887006B94BCE755E769B,10351,14,19,5,28,45,1445
55628,55628,8D4B76C00151174BC318A19D72794912,12661,1,6,5,32,45,1645
55629,55629,8D4B76C00151174BC318A19D72794912,12311,8,17,9,30,44,1544
55630,55630,8D4B76C00151174BC318A19D72794912,12661,19,21,2,32,45,1645
55641,55641,9A519709635398D7673DD5F4D42C6C46,42151,0,12,12,35,45,1795
55642,55642,9A519709635398D7673DD5F4D42C6C46,12491,13,14,1,36,43,1843
55643,55643,9A519709635398D7673DD5F4D42C6C46,42151,18,21,3,35,45,1795
55655,55655,17BFCEDD973B29E8302E2E7670AFE303,10471,6,7,1,37,48,1898
55656,55656,17BFCEDD973B29E8302E2E7670AFE303,40171,8,9,1,38,48,1948
55657,55657,17BFCEDD973B29E8302E2E7670AFE303,10471,9,23,14,37,48,1898
55658,55658,ACCF31A5720FF13E0E965CEAB6D95C92,10301,2,16,14,31,45,1595
55659,55659,ACCF31A5720FF13E0E965CEAB6D95C92,12311,16,17,1,30,44,1544
55660,55660,ACCF31A5720FF13E0E965CEAB6D95C92,10301,18,22,4,31,45,1595
55669,55669,17E50CF48AD5982A5D80F473E9B91696,10901,1,11,10,35,48,1798
55670,55670,17E50CF48AD5982A5D80F473E9B91696,11231,15,16,1,37,49,1899
55671,55671,17E50CF48AD5982A5D80F473E9B91696,10901,16,23,7,35,48,1798
55672,55672,A0C13743AF441FE8099AA940DA71C612,42581,0,7,7,38,48,1948
55673,55673,A0C13743AF441FE8099AA940DA71C612,42191,8,9,1,38,49,1949
55674,55674,A0C13743AF441FE8099AA940DA71C612,42581,14,22,8,38,48,1948
55688,55688,29EECA43EEFE59ADAFABFF01A5C4E8B8,19441,0,8,8,8,46,446
55689,55689,29EECA43EEFE59ADAFABFF01A5C4E8B8,42041,9,12,3,10,47,547
55690,55690,29EECA43EEFE59ADAFABFF01A5C4E8B8,19901,13,15,2,7,44,394
55691,55691,29EECA43EEFE59ADAFABFF01A5C4E8B8,19441,17,18,1,8,46,446
55703,55703,A8DFAF39A5A26AE1BCD9E9DE060BB315,11091,0,13,13,29,47,1497
55704,55704,A8DFAF39A5A26AE1BCD9E9DE060BB315,11381,15,16,1,30,47,1547
55705,55705,A8DFAF39A5A26AE1BCD9E9DE060BB315,11091,17,22,5,29,47,1497
55706,55706,565005545D8DAD4FBDA185A153E90618,42041,0,5,5,10,47,547
55707,55707,565005545D8DAD4FBDA185A153E90618,19441,6,8,2,8,46,446
55708,55708,565005545D8DAD4FBDA185A153E90618,42041,11,23,12,10,47,547
55709,55709,E88F39A65DCBFC647F6F44FF9039942F,10634,7,9,2,27,45,1395
55710,55710,E88F39A65DCBFC647F6F44FF9039942F,12601,13,14,1,25,47,1297
55711,55711,E88F39A65DCBFC647F6F44FF9039942F,10634,14,16,2,27,45,1395
55712,55712,E88F39A65DCBFC647F6F44FF9039942F,12601,20,21,1,25,47,1297
55713,55713,2FC158799FF19F821FBD3DC4EFE863DB,43101,3,4,1,46,40,2340
55714,55714,2FC158799FF19F821FBD3DC4EFE863DB,13551,6,12,6,45,38,2288
55715,55715,2FC158799FF19F821FBD3DC4EFE863DB,43101,15,23,8,46,40,2340
55725,55725,FCF6425DA3F542476DF1F93935C075D8,42581,0,15,15,38,48,1948
55726,55726,FCF6425DA3F542476DF1F93935C075D8,11914,16,19,3,37,48,1898
55727,55727,FCF6425DA3F542476DF1F93935C075D8,42581,20,23,3,38,48,1948
55735,55735,1F03E949F65971052B846E0446B9192F,42021,1,2,1,33,47,1697
55736,55736,1F03E949F65971052B846E0446B9192F,43761,4,6,2,32,47,1647
55737,55737,1F03E949F65971052B846E0446B9192F,10281,11,15,4,33,48,1698
55738,55738,1F03E949F65971052B846E0446B9192F,11861,15,19,4,32,47,1647
55743,55743,EA1FD587726044750D83B82036123867,10191,0,7,7,40,48,2048
55744,55744,EA1FD587726044750D83B82036123867,10921,11,16,5,43,48,2198
55745,55745,EA1FD587726044750D83B82036123867,43361,19,21,2,38,48,1948
55746,55746,EA1FD587726044750D83B82036123867,10191,22,23,1,40,48,2048
55747,55747,0447A6B040BE8662ECE5520F8BE6530D,13101,7,13,6,40,47,2047
55748,55748,0447A6B040BE8662ECE5520F8BE6530D,11801,13,15,2,42,48,2148
55749,55749,0447A6B040BE8662ECE5520F8BE6530D,13101,17,23,6,40,47,2047
55750,55750,03C0426D798D28FFFD9A991613F3D23A,11324,0,6,6,31,46,1596
55751,55751,03C0426D798D28FFFD9A991613F3D23A,10295,8,17,9,30,47,1547
55752,55752,03C0426D798D28FFFD9A991613F3D23A,11324,18,23,5,31,46,1596
55759,55759,E1531D1016DAB55BA101619305B887D8,11361,0,4,4,22,48,1148
55760,55760,E1531D1016DAB55BA101619305B887D8,10451,7,19,12,25,48,1298
55761,55761,E1531D1016DAB55BA101619305B887D8,11361,21,22,1,22,48,1148
55762,55762,206CFB71EEA9807DA9AEE382197E4091,43161,0,6,6,35,47,1797
55763,55763,206CFB71EEA9807DA9AEE382197E4091,43761,9,10,1,32,47,1647
55764,55764,206CFB71EEA9807DA9AEE382197E4091,42161,12,19,7,36,47,1847
55765,55765,206CFB71EEA9807DA9AEE382197E4091,10251,20,21,1,35,47,1797
55766,55766,67324219FD0B98BECEBB85768BC60718,13791,0,1,1,42,47,2147
55767,55767,67324219FD0B98BECEBB85768BC60718,13111,2,11,9,42,46,2146
55768,55768,67324219FD0B98BECEBB85768BC60718,13791,12,13,1,42,47,2147
55769,55769,67324219FD0B98BECEBB85768BC60718,42091,15,21,6,43,46,2196
55781,55781,63A1194DA67A916294F825B4249AD293,42161,0,6,6,36,47,1847
55782,55782,63A1194DA67A916294F825B4249AD293,11261,8,17,9,36,46,1846
55783,55783,63A1194DA67A916294F825B4249AD293,42161,22,23,1,36,47,1847
55798,55798,EFA18B326F5752ABB01E6830CBCEF37F,13011,0,8,8,39,47,1997
55799,55799,EFA18B326F5752ABB01E6830CBCEF37F,10801,9,18,9,42,47,2147
55800,55800,EFA18B326F5752ABB01E6830CBCEF37F,13371,18,22,4,41,47,2097
55801,55801,63D46256AD6F86C8491C2B2581A93893,11291,2,6,4,40,49,2049
55802,55802,63D46256AD6F86C8491C2B2581A93893,11021,15,16,1,36,49,1849
55803,55803,63D46256AD6F86C8491C2B2581A93893,11291,21,23,2,40,49,2049
55804,55804,A2F45BD656CFFF997F97BA7E53A45E3F,11951,7,12,5,31,49,1599
55805,55805,A2F45BD656CFFF997F97BA7E53A45E3F,13731,13,17,4,33,49,1699
55806,55806,A2F45BD656CFFF997F97BA7E53A45E3F,11951,19,21,2,31,49,1599
55826,55826,A1F76E9AE160B1A2577BA1E3948B2B29,42864,0,13,13,38,44,1944
55827,55827,A1F76E9AE160B1A2577BA1E3948B2B29,11261,15,17,2,36,46,1846
55828,55828,A1F76E9AE160B1A2577BA1E3948B2B29,42861,20,23,3,37,44,1894
55829,55829,C7FA80290FB045053FA2F8726750C68B,42523,9,10,1,31,47,1597
55830,55830,C7FA80290FB045053FA2F8726750C68B,13651,10,17,7,30,47,1547
55831,55831,C7FA80290FB045053FA2F8726750C68B,42523,17,21,4,31,47,1597
55832,55832,C7FA80290FB045053FA2F8726750C68B,13651,21,23,2,30,47,1547
55833,55833,4DAFB85C918047225CA596E4134A09D3,42141,1,4,3,32,47,1647
55834,55834,4DAFB85C918047225CA596E4134A09D3,13651,8,17,9,30,47,1547
55835,55835,4DAFB85C918047225CA596E4134A09D3,42141,17,23,6,32,47,1647
55854,55854,C26F0AB1B8AD896B177DE30E7C0A729F,11381,0,8,8,30,47,1547
55855,55855,C26F0AB1B8AD896B177DE30E7C0A729F,11061,11,13,2,29,48,1498
55856,55856,C26F0AB1B8AD896B177DE30E7C0A729F,11381,18,20,2,30,47,1547
55857,55857,C26F0AB1B8AD896B177DE30E7C0A729F,11061,20,22,2,29,48,1498
55858,55858,978C0CFF80BE5323032978AAED91F75F,10811,7,9,2,38,46,1946
55859,55859,978C0CFF80BE5323032978AAED91F75F,42301,12,13,1,36,47,1847
55860,55860,978C0CFF80BE5323032978AAED91F75F,40322,18,22,4,38,46,1946
55865,55865,1940CC384468326D0591B825867214FA,10271,0,7,7,37,46,1896
55866,55866,1940CC384468326D0591B825867214FA,42511,10,11,1,37,47,1897
55867,55867,1940CC384468326D0591B825867214FA,10271,11,23,12,37,46,1896
55871,55871,FDEBDED0DFB744B954CD43B345635AE9,40505,0,7,7,36,48,1848
55872,55872,FDEBDED0DFB744B954CD43B345635AE9,42511,7,13,6,37,47,1897
55873,55873,FDEBDED0DFB744B954CD43B345635AE9,13121,14,17,3,38,46,1946
55874,55874,FDEBDED0DFB744B954CD43B345635AE9,40505,18,23,5,36,48,1848
55881,55881,55536669E97AF41ACDE427113BB85731,10691,0,6,6,33,48,1698
55882,55882,55536669E97AF41ACDE427113BB85731,42491,7,15,8,32,46,1646
55883,55883,55536669E97AF41ACDE427113BB85731,10691,19,23,4,33,48,1698
55884,55884,D65506EDDA59637632B53755416666C4,11914,0,5,5,37,48,1898
55885,55885,D65506EDDA59637632B53755416666C4,42221,7,9,2,38,48,1948
55886,55886,D65506EDDA59637632B53755416666C4,12514,14,15,1,38,47,1947
55887,55887,D65506EDDA59637632B53755416666C4,11914,19,21,2,37,48,1898
55903,55903,1E78C6812CC13AC596F7D7BD80A5DD70,11921,0,14,14,38,48,1948
55904,55904,1E78C6812CC13AC596F7D7BD80A5DD70,11074,15,20,5,37,47,1897
55905,55905,1E78C6812CC13AC596F7D7BD80A5DD70,11914,20,23,3,37,48,1898
55906,55906,39E8FB5C4AE9A0E0783441178F244CD5,10341,0,17,17,31,47,1597
55907,55907,39E8FB5C4AE9A0E0783441178F244CD5,10154,19,20,1,33,47,1697
55908,55908,39E8FB5C4AE9A0E0783441178F244CD5,10341,20,23,3,31,47,1597
55909,55909,E880DD3703242558096D10770FE10A54,42861,0,12,12,37,44,1894
55910,55910,E880DD3703242558096D10770FE10A54,11261,13,14,1,36,46,1846
55911,55911,E880DD3703242558096D10770FE10A54,42861,15,22,7,37,44,1894
55915,55915,139E323C8869BB23D1CEE92D77CF1FFD,11541,0,6,6,35,49,1799
55916,55916,139E323C8869BB23D1CEE92D77CF1FFD,11531,8,11,3,34,49,1749
55917,55917,139E323C8869BB23D1CEE92D77CF1FFD,11541,12,14,2,35,49,1799
55918,55918,139E323C8869BB23D1CEE92D77CF1FFD,11531,16,18,2,34,49,1749
55919,55919,E65C345ADE53D8117A4A02C1268A6FBE,42041,0,6,6,10,47,547
55920,55920,E65C345ADE53D8117A4A02C1268A6FBE,19441,7,8,1,8,46,446
55921,55921,E65C345ADE53D8117A4A02C1268A6FBE,42041,11,13,2,10,47,547
55922,55922,E65C345ADE53D8117A4A02C1268A6FBE,19441,14,18,4,8,46,446
55926,55926,84DA01F112661472BCB344139BA68924,43061,0,14,14,43,46,2196
55927,55927,84DA01F112661472BCB344139BA68924,13341,14,17,3,44,45,2245
55928,55928,84DA01F112661472BCB344139BA68924,43061,18,23,5,43,46,2196
55934,55934,1788FF83230593384DFEF88881720D90,13551,0,6,6,45,38,2288
55935,55935,1788FF83230593384DFEF88881720D90,43101,7,19,12,46,40,2340
55936,55936,1788FF83230593384DFEF88881720D90,13551,21,23,2,45,38,2288
55949,55949,172F302F5199600F927C0E74978E3B3A,42471,0,4,4,35,49,1799
55950,55950,172F302F5199600F927C0E74978E3B3A,42401,6,12,6,36,47,1847
55951,55951,172F302F5199600F927C0E74978E3B3A,10111,21,23,2,37,47,1897
55952,55952,F5449661B4478E818EBFB16B1D5C019C,10411,0,8,8,36,48,1848
55953,55953,F5449661B4478E818EBFB16B1D5C019C,10221,15,16,1,34,49,1749
55954,55954,F5449661B4478E818EBFB16B1D5C019C,11731,20,22,2,36,48,1848
55960,55960,8D191329823199E09F5A5847FD92A1BF,40343,1,2,1,24,49,1249
55961,55961,8D191329823199E09F5A5847FD92A1BF,42261,5,7,2,25,49,1299
55962,55962,8D191329823199E09F5A5847FD92A1BF,11641,8,16,8,22,49,1149
55963,55963,8D191329823199E09F5A5847FD92A1BF,10451,18,19,1,25,48,1298
55973,55973,2937B23EEDB796179FFFF39113F778F2,42221,0,2,2,38,48,1948
55974,55974,2937B23EEDB796179FFFF39113F778F2,12514,3,7,4,38,47,1947
55975,55975,2937B23EEDB796179FFFF39113F778F2,42221,11,23,12,38,48,1948
55976,55976,30C49EE7A31FEEE7EEC894E81C72E143,40171,9,10,1,38,48,1948
55977,55977,30C49EE7A31FEEE7EEC894E81C72E143,11914,15,16,1,37,48,1898
55978,55978,30C49EE7A31FEEE7EEC894E81C72E143,40171,21,23,2,38,48,1948
55979,55979,F76771986E3380E81FE4B24340A7D518,10161,0,7,7,35,49,1799
55980,55980,F76771986E3380E81FE4B24340A7D518,11211,11,12,1,34,49,1749
55981,55981,F76771986E3380E81FE4B24340A7D518,11021,13,14,1,36,49,1849
55982,55982,F76771986E3380E81FE4B24340A7D518,10161,18,23,5,35,49,1799
55983,55983,2EF88513976088C07EC19077B1D8877A,42511,0,15,15,37,47,1897
55984,55984,2EF88513976088C07EC19077B1D8877A,13121,15,18,3,38,46,1946
55985,55985,2EF88513976088C07EC19077B1D8877A,11941,21,23,2,37,46,1896
55991,55991,E9E78448A0B6BEA2407D42EC36610250,42601,9,11,2,44,48,2248
55992,55992,E9E78448A0B6BEA2407D42EC36610250,11701,12,15,3,43,48,2198
55993,55993,E9E78448A0B6BEA2407D42EC36610250,13351,15,16,1,48,48,2448
55994,55994,E9E78448A0B6BEA2407D42EC36610250,42601,18,23,5,44,48,2248
55995,55995,3717F18D88C40095DBADE8C95C390E6F,42861,2,6,4,37,44,1894
55996,55996,3717F18D88C40095DBADE8C95C390E6F,42151,9,19,10,35,45,1795
55997,55997,3717F18D88C40095DBADE8C95C390E6F,42861,19,20,1,37,44,1894
55998,55998,B09144E053E0EC9288D632948891CAF2,42231,0,1,1,37,46,1896
55999,55999,B09144E053E0EC9288D632948891CAF2,13911,1,17,16,39,46,1996
56000,56000,B09144E053E0EC9288D632948891CAF2,42231,18,23,5,37,46,1896
56009,56009,63F0032DC427373C2FAEC549A8871599,13121,0,15,15,38,46,1946
56010,56010,63F0032DC427373C2FAEC549A8871599,10271,16,17,1,37,46,1896
56011,56011,63F0032DC427373C2FAEC549A8871599,13121,17,22,5,38,46,1946
56012,56012,BFB5F99311B260572E316DE64B3EB913,11131,0,7,7,33,48,1698
56013,56013,BFB5F99311B260572E316DE64B3EB913,10901,11,17,6,35,48,1798
56014,56014,BFB5F99311B260572E316DE64B3EB913,11131,20,23,3,33,48,1698
56015,56015,96FE08600264D55F9260850729AEC7B8,42301,0,10,10,36,47,1847
56016,56016,96FE08600264D55F9260850729AEC7B8,10251,12,19,7,35,47,1797
56017,56017,96FE08600264D55F9260850729AEC7B8,42301,22,23,1,36,47,1847
56022,56022,73F6FD09D1A0135DB3E352EF6E0DEC34,11731,0,8,8,36,48,1848
56023,56023,73F6FD09D1A0135DB3E352EF6E0DEC34,11231,15,19,4,37,49,1899
56024,56024,73F6FD09D1A0135DB3E352EF6E0DEC34,40502,21,22,1,36,48,1848
56028,56028,CB910955F051BE957D3F0A1B91598EBD,11061,1,6,5,29,48,1498
56029,56029,CB910955F051BE957D3F0A1B91598EBD,10681,8,13,5,30,48,1548
56030,56030,CB910955F051BE957D3F0A1B91598EBD,11061,15,20,5,29,48,1498
56040,56040,D0D54F11AE6E916A7FB4D7681D5BE6D5,19621,5,7,2,5,46,296
56041,56041,D0D54F11AE6E916A7FB4D7681D5BE6D5,19821,8,14,6,4,46,246
56042,56042,D0D54F11AE6E916A7FB4D7681D5BE6D5,19621,14,15,1,5,46,296
56043,56043,D0D54F11AE6E916A7FB4D7681D5BE6D5,19821,18,23,5,4,46,246
56044,56044,B6E06BECFD200E305BD11D4E181199C8,11951,0,13,13,31,49,1599
56045,56045,B6E06BECFD200E305BD11D4E181199C8,10431,15,17,2,33,49,1699
56046,56046,B6E06BECFD200E305BD11D4E181199C8,12971,19,20,1,32,48,1648
56047,56047,B6E06BECFD200E305BD11D4E181199C8,11951,21,23,2,31,49,1599
56048,56048,2F1F7798F5E8889B4080CA59D71F0274,10271,0,17,17,37,46,1896
56049,56049,2F1F7798F5E8889B4080CA59D71F0274,13711,18,19,1,38,46,1946
56050,56050,2F1F7798F5E8889B4080CA59D71F0274,10271,21,23,2,37,46,1896
56057,56057,B92E89796812211C5B5F4FA9439F7E3F,10381,9,10,1,31,49,1599
56058,56058,B92E89796812211C5B5F4FA9439F7E3F,43971,14,19,5,30,48,1548
56059,56059,B92E89796812211C5B5F4FA9439F7E3F,11061,19,20,1,29,48,1498
56060,56060,498FA21A928D94A5AF2C1CBF48D37607,40331,0,16,16,30,47,1547
56061,56061,498FA21A928D94A5AF2C1CBF48D37607,10731,17,18,1,33,47,1697
56062,56062,498FA21A928D94A5AF2C1CBF48D37607,11381,18,23,5,30,47,1547
56063,56063,0601C1762592A99CA3F0778FC011A2CE,10601,0,9,9,39,47,1997
56064,56064,0601C1762592A99CA3F0778FC011A2CE,10841,13,16,3,37,47,1897
56065,56065,0601C1762592A99CA3F0778FC011A2CE,10601,19,22,3,39,47,1997
56071,56071,831704567A0B8CDF382FA5741F6A7093,11321,0,13,13,31,46,1596
56072,56072,831704567A0B8CDF382FA5741F6A7093,10351,14,20,6,28,45,1445
56073,56073,831704567A0B8CDF382FA5741F6A7093,11321,21,23,2,31,46,1596
56074,56074,7C4094307F6A0F86FFBFC6DDBC266209,41005,0,12,12,38,47,1947
56075,56075,7C4094307F6A0F86FFBFC6DDBC266209,10971,14,16,2,35,47,1797
56076,56076,7C4094307F6A0F86FFBFC6DDBC266209,41005,17,18,1,38,47,1947
56077,56077,672E46CD1A2289C6109AAA4160C503F8,13911,7,9,2,39,46,1996
56078,56078,672E46CD1A2289C6109AAA4160C503F8,42351,11,12,1,38,45,1945
56079,56079,672E46CD1A2289C6109AAA4160C503F8,11261,13,20,7,36,46,1846
56089,56089,1061DFB56DB0A9815BF450E4D94C3D77,11151,1,11,10,30,48,1548
56090,56090,1061DFB56DB0A9815BF450E4D94C3D77,11061,12,13,1,29,48,1498
56091,56091,1061DFB56DB0A9815BF450E4D94C3D77,11151,13,23,10,30,48,1548
56092,56092,0C7E73E19555119658A50BFA1BA26718,10161,0,13,13,35,49,1799
56093,56093,0C7E73E19555119658A50BFA1BA26718,40505,17,21,4,36,48,1848
56094,56094,0C7E73E19555119658A50BFA1BA26718,10161,22,23,1,35,49,1799
56095,56095,181802B57A29F4FAE1E7EF60B334A9D5,42351,0,5,5,38,45,1945
56096,56096,181802B57A29F4FAE1E7EF60B334A9D5,42231,6,10,4,37,46,1896
56097,56097,181802B57A29F4FAE1E7EF60B334A9D5,13911,11,23,12,39,46,1996
56098,56098,5E3291503FC27DAA0248AA453FC4D60A,19441,0,8,8,8,46,446
56099,56099,5E3291503FC27DAA0248AA453FC4D60A,42041,10,12,2,10,47,547
56100,56100,5E3291503FC27DAA0248AA453FC4D60A,19441,13,20,7,8,46,446
56105,56105,D9026A3CE10A3841EFEE0C49DAE389C6,19114,1,17,16,7,43,393
56106,56106,D9026A3CE10A3841EFEE0C49DAE389C6,12641,18,19,1,10,43,543
56107,56107,D9026A3CE10A3841EFEE0C49DAE389C6,19114,21,22,1,7,43,393
56134,56134,F93D646A1BCE1AFF390EB78A01863C9E,40171,5,6,1,38,48,1948
56135,56135,F93D646A1BCE1AFF390EB78A01863C9E,10471,10,21,11,37,48,1898
56136,56136,F93D646A1BCE1AFF390EB78A01863C9E,40171,21,22,1,38,48,1948
56137,56137,C51EE78995B692FB9DA132D6AABD43B2,10651,0,7,7,36,49,1849
56138,56138,C51EE78995B692FB9DA132D6AABD43B2,42231,11,16,5,37,46,1896
56139,56139,C51EE78995B692FB9DA132D6AABD43B2,10651,18,22,4,36,49,1849
56140,56140,545B57FE377B53DF15322A3E629D81E6,12921,0,10,10,9,41,491
56141,56141,545B57FE377B53DF15322A3E629D81E6,49201,11,13,2,7,41,391
56142,56142,545B57FE377B53DF15322A3E629D81E6,12921,15,23,8,9,41,491
56156,56156,7ABD93A331FC0F542107A4FEF4369E36,19441,0,18,18,8,46,446
56157,56157,7ABD93A331FC0F542107A4FEF4369E36,42041,18,19,1,10,47,547
56158,56158,7ABD93A331FC0F542107A4FEF4369E36,19441,20,23,3,8,46,446
56159,56159,81E9C3858C44D7DA57E9FCCB87C1B34F,10251,2,17,15,35,47,1797
56160,56160,81E9C3858C44D7DA57E9FCCB87C1B34F,11355,19,20,1,36,48,1848
56161,56161,81E9C3858C44D7DA57E9FCCB87C1B34F,43361,21,23,2,38,48,1948
56162,56162,280A825D237E9CE7CB403628403E758B,11261,0,4,4,36,46,1846
56163,56163,280A825D237E9CE7CB403628403E758B,42351,4,12,8,38,45,1945
56164,56164,280A825D237E9CE7CB403628403E758B,13911,13,16,3,39,46,1996
56165,56165,280A825D237E9CE7CB403628403E758B,11261,17,18,1,36,46,1846
56176,56176,B586EAB297E83D0A90DD54A60924E8FC,42271,1,6,5,40,47,2047
56177,56177,B586EAB297E83D0A90DD54A60924E8FC,10111,9,20,11,37,47,1897
56178,56178,B586EAB297E83D0A90DD54A60924E8FC,10911,21,23,2,39,46,1996
56179,56179,2C19FDC386B0B2E924F75B25676D719F,42351,2,8,6,38,45,1945
56180,56180,2C19FDC386B0B2E924F75B25676D719F,42231,10,11,1,37,46,1896
56181,56181,2C19FDC386B0B2E924F75B25676D719F,42351,14,23,9,38,45,1945
56182,56182,F2229754FABF7F398D6839D6208AC86F,10544,0,7,7,28,48,1448
56183,56183,F2229754FABF7F398D6839D6208AC86F,10381,10,11,1,31,49,1599
56184,56184,F2229754FABF7F398D6839D6208AC86F,10544,12,22,10,28,48,1448
56188,56188,B07F9654999A27B565B093B7A4D6A968,11661,0,7,7,40,49,2049
56189,56189,B07F9654999A27B565B093B7A4D6A968,11021,12,18,6,36,49,1849
56190,56190,B07F9654999A27B565B093B7A4D6A968,11661,21,23,2,40,49,2049
56191,56191,CB569F11653BED8355DBB1B17AC5F222,40171,2,8,6,38,48,1948
56192,56192,CB569F11653BED8355DBB1B17AC5F222,11914,8,11,3,37,48,1898
56193,56193,CB569F11653BED8355DBB1B17AC5F222,40171,12,18,6,38,48,1948
56194,56194,CB569F11653BED8355DBB1B17AC5F222,11914,19,20,1,37,48,1898
56195,56195,5E6AB6B686A00A7ED3B8EAE75C21937D,42864,1,7,6,38,44,1944
56196,56196,5E6AB6B686A00A7ED3B8EAE75C21937D,11261,9,10,1,36,46,1846
56197,56197,5E6AB6B686A00A7ED3B8EAE75C21937D,42864,12,18,6,38,44,1944
56198,56198,5E6AB6B686A00A7ED3B8EAE75C21937D,11261,18,20,2,36,46,1846
56207,56207,6C96EE989846ABECA961FEB7DAD4E3B3,40171,0,7,7,38,48,1948
56208,56208,6C96EE989846ABECA961FEB7DAD4E3B3,10471,8,18,10,37,48,1898
56209,56209,6C96EE989846ABECA961FEB7DAD4E3B3,40171,18,23,5,38,48,1948
56210,56210,6D11D3FEB14395619B2C8DA34BCD86CD,11001,0,12,12,42,47,2147
56211,56211,6D11D3FEB14395619B2C8DA34BCD86CD,13941,12,15,3,41,47,2097
56212,56212,6D11D3FEB14395619B2C8DA34BCD86CD,11001,16,23,7,42,47,2147
56213,56213,E36756C340C5516EE61A79FCEF182B66,42491,2,10,8,32,46,1646
56214,56214,E36756C340C5516EE61A79FCEF182B66,42523,11,13,2,31,47,1597
56215,56215,E36756C340C5516EE61A79FCEF182B66,12131,16,17,1,32,47,1647
56216,56216,E36756C340C5516EE61A79FCEF182B66,42491,20,21,1,32,46,1646
56221,56221,C6869A64CA9EF97A25D7192A00726FC2,10111,0,9,9,37,47,1897
56222,56222,C6869A64CA9EF97A25D7192A00726FC2,10781,10,19,9,35,47,1797
56223,56223,C6869A64CA9EF97A25D7192A00726FC2,42401,19,23,4,36,47,1847
56236,56236,181B5103F0FBF120AFF5BEC3A26A3DB7,42521,2,3,1,31,47,1597
56237,56237,181B5103F0FBF120AFF5BEC3A26A3DB7,42141,7,18,11,32,47,1647
56238,56238,181B5103F0FBF120AFF5BEC3A26A3DB7,42521,20,21,1,31,47,1597
56239,56239,7578F97B766BC3FE852CD90B052DC94F,11871,8,9,1,29,46,1496
56240,56240,7578F97B766BC3FE852CD90B052DC94F,42531,12,20,8,31,45,1595
56241,56241,7578F97B766BC3FE852CD90B052DC94F,11871,21,23,2,29,46,1496
56242,56242,70E7EA9862CE7C9D4FA1C73735060256,13731,0,1,1,33,49,1699
56243,56243,70E7EA9862CE7C9D4FA1C73735060256,11954,5,7,2,32,49,1649
56244,56244,70E7EA9862CE7C9D4FA1C73735060256,13731,17,22,5,33,49,1699
56245,56245,300A1885BA30CEEF17B7B730D91F8A14,11551,0,8,8,39,49,1999
56246,56246,300A1885BA30CEEF17B7B730D91F8A14,11781,16,17,1,38,49,1949
56247,56247,300A1885BA30CEEF17B7B730D91F8A14,11291,17,23,6,40,49,2049
56248,56248,D8963F7C81A647B0DB7A8BBF70036A0B,42221,1,6,5,38,48,1948
56249,56249,D8963F7C81A647B0DB7A8BBF70036A0B,10471,8,17,9,37,48,1898
56250,56250,D8963F7C81A647B0DB7A8BBF70036A0B,12514,19,23,4,38,47,1947
56251,56251,7561007C44C9B9B43A5E78AE0FF299F7,42201,2,3,1,43,46,2196
56252,56252,7561007C44C9B9B43A5E78AE0FF299F7,13341,5,11,6,44,45,2245
56253,56253,7561007C44C9B9B43A5E78AE0FF299F7,42201,11,16,5,43,46,2196
56254,56254,7561007C44C9B9B43A5E78AE0FF299F7,13341,18,23,5,44,45,2245
56258,56258,DFBF186CE4D64E515520CAB6408AFD45,11151,0,10,10,30,48,1548
56259,56259,DFBF186CE4D64E515520CAB6408AFD45,43391,11,12,1,29,48,1498
56260,56260,DFBF186CE4D64E515520CAB6408AFD45,11151,16,19,3,30,48,1548
56274,56274,C1BC146C1B557BAE93465B186B08C3FA,12661,4,5,1,32,45,1645
56275,56275,C1BC146C1B557BAE93465B186B08C3FA,12311,10,14,4,30,44,1544
56276,56276,C1BC146C1B557BAE93465B186B08C3FA,12661,19,20,1,32,45,1645
56277,56277,D2E6AB586A09EFBBD099D10181890291,11061,0,9,9,29,48,1498
56278,56278,D2E6AB586A09EFBBD099D10181890291,11151,13,15,2,30,48,1548
56279,56279,D2E6AB586A09EFBBD099D10181890291,11061,15,23,8,29,48,1498
56283,56283,D5824D8021BBCB42234B74EBF20648B2,11151,0,12,12,30,48,1548
56284,56284,D5824D8021BBCB42234B74EBF20648B2,11061,16,19,3,29,48,1498
56285,56285,D5824D8021BBCB42234B74EBF20648B2,11151,19,22,3,30,48,1548
56290,56290,65161D8F8A2EE0E4F87D9472311EE576,10841,1,9,8,37,47,1897
56291,56291,65161D8F8A2EE0E4F87D9472311EE576,12514,12,15,3,38,47,1947
56292,56292,65161D8F8A2EE0E4F87D9472311EE576,10841,15,17,2,37,47,1897
56293,56293,65161D8F8A2EE0E4F87D9472311EE576,12514,17,23,6,38,47,1947
56294,56294,6817DB094271302744F441100FAF5A74,10931,0,6,6,41,48,2098
56295,56295,6817DB094271302744F441100FAF5A74,42281,9,11,2,40,48,2048
56296,56296,6817DB094271302744F441100FAF5A74,10931,12,23,11,41,48,2098
56297,56297,1B83FAC3F59813014CE45FBC6E21E9E8,10841,0,12,12,37,47,1897
56298,56298,1B83FAC3F59813014CE45FBC6E21E9E8,12514,12,14,2,38,47,1947
56299,56299,1B83FAC3F59813014CE45FBC6E21E9E8,10841,17,19,2,37,47,1897
56300,56300,BF5BCA14D860AAF096A7D7D4ED7BBBF7,10271,1,8,7,37,46,1896
56301,56301,BF5BCA14D860AAF096A7D7D4ED7BBBF7,13121,12,13,1,38,46,1946
56302,56302,BF5BCA14D860AAF096A7D7D4ED7BBBF7,10271,16,21,5,37,46,1896
56303,56303,A99DE7D86F2D30649282D24CB5ECED25,42301,0,8,8,36,47,1847
56304,56304,A99DE7D86F2D30649282D24CB5ECED25,10111,9,11,2,37,47,1897
56305,56305,A99DE7D86F2D30649282D24CB5ECED25,42301,12,15,3,36,47,1847
56306,56306,A99DE7D86F2D30649282D24CB5ECED25,42941,18,21,3,37,47,1897
56312,56312,03ED86F5BE3D351350BAE58E2A3698E8,13331,4,5,1,38,47,1947
56313,56313,03ED86F5BE3D351350BAE58E2A3698E8,11231,9,16,7,37,49,1899
56314,56314,03ED86F5BE3D351350BAE58E2A3698E8,40124,20,22,2,38,47,1947
56328,56328,127B5F9F1F05466E9EADC605685A6520,13271,10,13,3,41,47,2097
56329,56329,127B5F9F1F05466E9EADC605685A6520,13101,16,18,2,40,47,2047
56330,56330,127B5F9F1F05466E9EADC605685A6520,13271,20,22,2,41,47,2097
56342,56342,95F5650709CACF923AC8764BA8D78995,42531,0,8,8,31,45,1595
56343,56343,95F5650709CACF923AC8764BA8D78995,12311,11,12,1,30,44,1544
56344,56344,95F5650709CACF923AC8764BA8D78995,42531,13,23,10,31,45,1595
56351,56351,6CF20899EA8F1A27E67F0C12C1758D54,11061,0,13,13,29,48,1498
56352,56352,6CF20899EA8F1A27E67F0C12C1758D54,11381,15,18,3,30,47,1547
56353,56353,6CF20899EA8F1A27E67F0C12C1758D54,11061,22,23,1,29,48,1498
56357,56357,19CFADE53A4E618D30CBCE45D478F0C7,12921,0,1,1,9,41,491
56358,56358,19CFADE53A4E618D30CBCE45D478F0C7,12641,1,6,5,10,43,543
56359,56359,19CFADE53A4E618D30CBCE45D478F0C7,12921,7,22,15,9,41,491
56360,56360,E0F1670DB5561200EEDBAB1833327673,11921,0,5,5,38,48,1948
56361,56361,E0F1670DB5561200EEDBAB1833327673,11231,5,12,7,37,49,1899
56362,56362,E0F1670DB5561200EEDBAB1833327673,10111,12,22,10,37,47,1897
56363,56363,0BA677AEFA1FE879EC9FCA98466C3A1A,11641,0,14,14,22,49,1149
56364,56364,0BA677AEFA1FE879EC9FCA98466C3A1A,43751,15,16,1,19,48,998
56365,56365,0BA677AEFA1FE879EC9FCA98466C3A1A,42481,18,23,5,22,49,1149
56371,56371,8F8152ABCDBBD4CE857B1EFCB582F5D2,11074,0,11,11,37,47,1897
56372,56372,8F8152ABCDBBD4CE857B1EFCB582F5D2,10251,15,17,2,35,47,1797
56373,56373,8F8152ABCDBBD4CE857B1EFCB582F5D2,11074,18,21,3,37,47,1897
56374,56374,A99656E991272E2D0207AAB7A175C1B5,42981,0,11,11,36,49,1849
56375,56375,A99656E991272E2D0207AAB7A175C1B5,10471,15,19,4,37,48,1898
56376,56376,A99656E991272E2D0207AAB7A175C1B5,42981,20,21,1,36,49,1849
56377,56377,6F6F174BF3BBBF4A283E7794B5A58265,42581,0,7,7,38,48,1948
56378,56378,6F6F174BF3BBBF4A283E7794B5A58265,11914,9,11,2,37,48,1898
56379,56379,6F6F174BF3BBBF4A283E7794B5A58265,42581,12,14,2,38,48,1948
56380,56380,6F6F174BF3BBBF4A283E7794B5A58265,10821,19,20,1,40,47,2047
56385,56385,B969FE7CA88FA294C8201CFC44CC669E,12121,0,12,12,29,47,1497
56386,56386,B969FE7CA88FA294C8201CFC44CC669E,12601,12,15,3,25,47,1297
56387,56387,B969FE7CA88FA294C8201CFC44CC669E,12121,17,23,6,29,47,1497
56388,56388,3CDE88E41494ADADB515291429110B2E,43481,0,16,16,39,48,1998
56389,56389,3CDE88E41494ADADB515291429110B2E,11781,18,19,1,38,49,1949
56390,56390,3CDE88E41494ADADB515291429110B2E,10191,20,22,2,40,48,2048
56407,56407,9119A525BCFAA853FBF8FD004A9B236E,42261,1,12,11,25,49,1299
56408,56408,9119A525BCFAA853FBF8FD004A9B236E,42623,16,17,1,22,49,1149
56409,56409,9119A525BCFAA853FBF8FD004A9B236E,42261,21,22,1,25,49,1299
56410,56410,64C897065E9EDCA8A69F38A94EFB9055,10151,0,9,9,34,47,1747
56411,56411,64C897065E9EDCA8A69F38A94EFB9055,10841,11,13,2,37,47,1897
56412,56412,64C897065E9EDCA8A69F38A94EFB9055,11021,14,15,1,36,49,1849
56413,56413,64C897065E9EDCA8A69F38A94EFB9055,10151,18,23,5,34,47,1747
56414,56414,795B19542A85BBCF6E0BEEABCE2E1262,10951,5,14,9,29,48,1498
56415,56415,795B19542A85BBCF6E0BEEABCE2E1262,11381,15,17,2,30,47,1547
56416,56416,795B19542A85BBCF6E0BEEABCE2E1262,11151,19,21,2,30,48,1548
56417,56417,27B6DDFE3A356062F221ABD7AD70BB14,11061,0,6,6,29,48,1498
56418,56418,27B6DDFE3A356062F221ABD7AD70BB14,10681,9,13,4,30,48,1548
56419,56419,27B6DDFE3A356062F221ABD7AD70BB14,11061,13,23,10,29,48,1498
56439,56439,8EBB95E9E256AA88E48FC39B09C04C22,11231,0,1,1,37,49,1899
56440,56440,8EBB95E9E256AA88E48FC39B09C04C22,40101,1,3,2,34,49,1749
56441,56441,8EBB95E9E256AA88E48FC39B09C04C22,10661,4,17,13,37,49,1899
56442,56442,8EBB95E9E256AA88E48FC39B09C04C22,11731,18,19,1,36,48,1848
56443,56443,AA94328A21E669C14B53998CC009A981,43951,0,6,6,49,41,2491
56444,56444,AA94328A21E669C14B53998CC009A981,13411,6,11,5,49,42,2492
56445,56445,AA94328A21E669C14B53998CC009A981,43951,14,19,5,49,41,2491
56451,56451,5E3A7142BBDC1E249B155588A0E138DD,12641,0,8,8,10,43,543
56452,56452,5E3A7142BBDC1E249B155588A0E138DD,19114,9,11,2,7,43,393
56453,56453,5E3A7142BBDC1E249B155588A0E138DD,12641,13,17,4,10,43,543
56454,56454,5E3A7142BBDC1E249B155588A0E138DD,19114,19,21,2,7,43,393
56468,56468,0A15402BF50F336CD996C3C85D01B359,11231,0,1,1,37,49,1899
56469,56469,0A15402BF50F336CD996C3C85D01B359,10471,2,7,5,37,48,1898
56470,56470,0A15402BF50F336CD996C3C85D01B359,13511,8,20,12,34,48,1748
56471,56471,0A15402BF50F336CD996C3C85D01B359,10471,21,23,2,37,48,1898
56486,56486,859846C23309918FCF7E37DF9FD45D9F,13911,0,15,15,39,46,1996
56487,56487,859846C23309918FCF7E37DF9FD45D9F,42351,19,21,2,38,45,1945
56488,56488,859846C23309918FCF7E37DF9FD45D9F,13911,22,23,1,39,46,1996
56489,56489,48DCE60D429B0B1E7F2F1B7A462BF9BF,42523,0,1,1,31,47,1597
56490,56490,48DCE60D429B0B1E7F2F1B7A462BF9BF,13651,1,3,2,30,47,1547
56491,56491,48DCE60D429B0B1E7F2F1B7A462BF9BF,42523,4,18,14,31,47,1597
56492,56492,48DCE60D429B0B1E7F2F1B7A462BF9BF,11861,20,23,3,32,47,1647
56503,56503,63407EB936631E067EBCB2C7C7D38F7B,42921,8,12,4,33,47,1697
56504,56504,63407EB936631E067EBCB2C7C7D38F7B,13601,13,16,3,34,47,1747
56505,56505,63407EB936631E067EBCB2C7C7D38F7B,42921,20,23,3,33,47,1697
56511,56511,3C4F290E088B2251F5A11549B4DEDAFC,12514,0,8,8,38,47,1947
56512,56512,3C4F290E088B2251F5A11549B4DEDAFC,10841,9,11,2,37,47,1897
56513,56513,3C4F290E088B2251F5A11549B4DEDAFC,13331,14,23,9,38,47,1947
56514,56514,235C15EE336FD644D7DF598E25164C0E,40637,0,8,8,36,47,1847
56515,56515,235C15EE336FD644D7DF598E25164C0E,43161,9,18,9,35,47,1797
56516,56516,235C15EE336FD644D7DF598E25164C0E,40637,22,23,1,36,47,1847
56522,56522,2CF73DDA8C5E74B4300779F1FD471C57,12491,0,6,6,36,43,1843
56523,56523,2CF73DDA8C5E74B4300779F1FD471C57,11261,6,8,2,36,46,1846
56524,56524,2CF73DDA8C5E74B4300779F1FD471C57,12491,10,14,4,36,43,1843
56525,56525,2CF73DDA8C5E74B4300779F1FD471C57,11261,16,22,6,36,46,1846
56534,56534,AE8377260EAF9DB8782B0CB0BAED6C5E,49181,2,4,2,21,31,1081
56535,56535,AE8377260EAF9DB8782B0CB0BAED6C5E,12871,4,5,1,22,33,1133
56536,56536,AE8377260EAF9DB8782B0CB0BAED6C5E,49181,7,18,11,21,31,1081
56537,56537,AE8377260EAF9DB8782B0CB0BAED6C5E,12871,22,23,1,22,33,1133
56543,56543,28BF547E7687F7F5E67A0E7318136E68,13011,1,4,3,39,47,1997
56544,56544,28BF547E7687F7F5E67A0E7318136E68,10911,4,8,4,39,46,1996
56545,56545,28BF547E7687F7F5E67A0E7318136E68,13011,12,23,11,39,47,1997
56560,56560,44BA65919A80728667B0D62571A4968D,13121,0,18,18,38,46,1946
56561,56561,44BA65919A80728667B0D62571A4968D,42511,19,21,2,37,47,1897
56562,56562,44BA65919A80728667B0D62571A4968D,13121,22,23,1,38,46,1946
56571,56571,EA76F6018E37635F2D98F3C61FC7376D,10841,0,1,1,37,47,1897
56572,56572,EA76F6018E37635F2D98F3C61FC7376D,13331,2,16,14,38,47,1947
56573,56573,EA76F6018E37635F2D98F3C61FC7376D,10841,19,20,1,37,47,1897
56574,56574,1AA169564F26346ABB6AD9BF731FCA16,43581,0,6,6,33,48,1698
56575,56575,1AA169564F26346ABB6AD9BF731FCA16,43731,7,17,10,34,47,1747
56576,56576,1AA169564F26346ABB6AD9BF731FCA16,43581,20,23,3,33,48,1698
56582,56582,A80358E64F8337F82B0DC9D276184F9D,10501,5,8,3,22,46,1146
56583,56583,A80358E64F8337F82B0DC9D276184F9D,12601,8,11,3,25,47,1297
56584,56584,A80358E64F8337F82B0DC9D276184F9D,10501,14,16,2,22,46,1146
56585,56585,A80358E64F8337F82B0DC9D276184F9D,12601,16,23,7,25,47,1297
56586,56586,4EE5C60035D807126AEE0DC0CD563832,42581,3,7,4,38,48,1948
56587,56587,4EE5C60035D807126AEE0DC0CD563832,11914,9,11,2,37,48,1898
56588,56588,4EE5C60035D807126AEE0DC0CD563832,42581,11,15,4,38,48,1948
56589,56589,4EE5C60035D807126AEE0DC0CD563832,11914,15,20,5,37,48,1898
56590,56590,DFA44588B9F7612E59AB24A1351E5F4F,12921,0,8,8,9,41,491
56591,56591,DFA44588B9F7612E59AB24A1351E5F4F,49201,10,12,2,7,41,391
56592,56592,DFA44588B9F7612E59AB24A1351E5F4F,12921,13,14,1,9,41,491
56593,56593,DFA44588B9F7612E59AB24A1351E5F4F,49201,16,20,4,7,41,391
56594,56594,44B913A66AFA5E271FF541EC61CC9838,10111,7,14,7,37,47,1897
56595,56595,44B913A66AFA5E271FF541EC61CC9838,42301,15,18,3,36,47,1847
56596,56596,44B913A66AFA5E271FF541EC61CC9838,10111,21,22,1,37,47,1897
56602,56602,B45D59A19F6B61302F993D2909F39450,12031,0,8,8,33,48,1698
56603,56603,B45D59A19F6B61302F993D2909F39450,43971,8,11,3,30,48,1548
56604,56604,B45D59A19F6B61302F993D2909F39450,12031,12,23,11,33,48,1698
56616,56616,5E1BBAE6A1AB78C09E8201C8FF351A4E,12514,0,14,14,38,47,1947
56617,56617,5E1BBAE6A1AB78C09E8201C8FF351A4E,10841,19,20,1,37,47,1897
56618,56618,5E1BBAE6A1AB78C09E8201C8FF351A4E,12514,21,22,1,38,47,1947
56619,56619,09C2A5500F5ABAEEAC932C07F5628EC4,11021,0,8,8,36,49,1849
56620,56620,09C2A5500F5ABAEEAC932C07F5628EC4,43161,8,12,4,35,47,1797
56621,56621,09C2A5500F5ABAEEAC932C07F5628EC4,42161,15,19,4,36,47,1847
56622,56622,09C2A5500F5ABAEEAC932C07F5628EC4,11021,20,23,3,36,49,1849
56635,56635,7555BE56ECBD7A21A433BB338C4AD042,19114,2,14,12,7,43,393
56636,56636,7555BE56ECBD7A21A433BB338C4AD042,12641,18,20,2,10,43,543
56637,56637,7555BE56ECBD7A21A433BB338C4AD042,19114,22,23,1,7,43,393
56647,56647,BC96E9BE9AB8282E9B536BDC3B7082D4,12514,1,7,6,38,47,1947
56648,56648,BC96E9BE9AB8282E9B536BDC3B7082D4,11074,8,18,10,37,47,1897
56649,56649,BC96E9BE9AB8282E9B536BDC3B7082D4,12514,22,23,1,38,47,1947
56653,56653,9ED06C73B88BB4839B692590DA94AEEC,42091,0,6,6,43,46,2196
56654,56654,9ED06C73B88BB4839B692590DA94AEEC,13791,9,19,10,42,47,2147
56655,56655,9ED06C73B88BB4839B692590DA94AEEC,42091,21,22,1,43,46,2196
56660,56660,686D4F0D299962ED76BF11C36F11CE9B,42511,0,8,8,37,47,1897
56661,56661,686D4F0D299962ED76BF11C36F11CE9B,13331,8,10,2,38,47,1947
56662,56662,686D4F0D299962ED76BF11C36F11CE9B,42511,12,13,1,37,47,1897
56663,56663,686D4F0D299962ED76BF11C36F11CE9B,13331,18,20,2,38,47,1947
56673,56673,E06FC86426E546DF6B8D146F4C749C15,11861,0,13,13,32,47,1647
56674,56674,E06FC86426E546DF6B8D146F4C749C15,11954,14,17,3,32,49,1649
56675,56675,E06FC86426E546DF6B8D146F4C749C15,11861,20,23,3,32,47,1647
56676,56676,B0FF888F2A2CE698F2B8641BCE4B074A,10631,2,8,6,28,46,1446
56677,56677,B0FF888F2A2CE698F2B8641BCE4B074A,10351,8,10,2,28,45,1445
56678,56678,B0FF888F2A2CE698F2B8641BCE4B074A,10634,11,23,12,27,45,1395
56679,56679,AD235EE6A83CA7956AB86E8BC887D3C7,11541,0,6,6,35,49,1799
56680,56680,AD235EE6A83CA7956AB86E8BC887D3C7,11021,10,17,7,36,49,1849
56681,56681,AD235EE6A83CA7956AB86E8BC887D3C7,11541,19,23,4,35,49,1799
56696,56696,CABDD8B2A8DF9C3C6F2F674E6DD5C884,11061,2,3,1,29,48,1498
56697,56697,CABDD8B2A8DF9C3C6F2F674E6DD5C884,11381,4,5,1,30,47,1547
56698,56698,CABDD8B2A8DF9C3C6F2F674E6DD5C884,11061,8,15,7,29,48,1498
56699,56699,CABDD8B2A8DF9C3C6F2F674E6DD5C884,11381,19,21,2,30,47,1547
56712,56712,132BAF41704DD845C2F70543C3732C4E,13711,0,7,7,38,46,1946
56713,56713,132BAF41704DD845C2F70543C3732C4E,42231,8,20,12,37,46,1896
56714,56714,132BAF41704DD845C2F70543C3732C4E,13711,20,23,3,38,46,1946
56715,56715,B1886EF8F5487F8E8F1A6E89D17F4DF6,12311,0,8,8,30,44,1544
56716,56716,B1886EF8F5487F8E8F1A6E89D17F4DF6,42531,10,12,2,31,45,1595
56717,56717,B1886EF8F5487F8E8F1A6E89D17F4DF6,12311,12,13,1,30,44,1544
56718,56718,B1886EF8F5487F8E8F1A6E89D17F4DF6,42531,18,19,1,31,45,1595
56719,56719,FA73CEEF86E3045F96788E3868F3C71A,10161,1,9,8,35,49,1799
56720,56720,FA73CEEF86E3045F96788E3868F3C71A,11331,14,18,4,37,48,1898
56721,56721,FA73CEEF86E3045F96788E3868F3C71A,10161,22,23,1,35,49,1799
56722,56722,29058CC1262C8826A9CAA2947C5743E5,49181,0,18,18,21,31,1081
56723,56723,29058CC1262C8826A9CAA2947C5743E5,12871,19,20,1,22,33,1133
56724,56724,29058CC1262C8826A9CAA2947C5743E5,49181,22,23,1,21,31,1081
56740,56740,49B78CFF3B4B71F1A51E0E68984D5D41,10111,10,14,4,37,47,1897
56741,56741,49B78CFF3B4B71F1A51E0E68984D5D41,10251,14,18,4,35,47,1797
56742,56742,49B78CFF3B4B71F1A51E0E68984D5D41,10111,18,21,3,37,47,1897
56743,56743,49B78CFF3B4B71F1A51E0E68984D5D41,40637,22,23,1,36,47,1847
56749,56749,182A42BB7961D14AD940FD065D4EDF33,10271,8,11,3,37,46,1896
56750,56750,182A42BB7961D14AD940FD065D4EDF33,13121,12,14,2,38,46,1946
56751,56751,182A42BB7961D14AD940FD065D4EDF33,11941,16,18,2,37,46,1896
56752,56752,182A42BB7961D14AD940FD065D4EDF33,13711,21,23,2,38,46,1946
56753,56753,44A1A512359C02E9A75BCE907A401EBD,11231,0,9,9,37,49,1899
56754,56754,44A1A512359C02E9A75BCE907A401EBD,42981,9,11,2,36,49,1849
56755,56755,44A1A512359C02E9A75BCE907A401EBD,11231,11,23,12,37,49,1899
56784,56784,850131E8C9E92CFF67EAC657858E5B85,12514,9,12,3,38,47,1947
56785,56785,850131E8C9E92CFF67EAC657858E5B85,10841,12,15,3,37,47,1897
56786,56786,850131E8C9E92CFF67EAC657858E5B85,42351,22,23,1,38,45,1945
56787,56787,FF6FF9B0197A91C0352AF48B73895F85,42201,0,7,7,43,46,2196
56788,56788,FF6FF9B0197A91C0352AF48B73895F85,13341,7,9,2,44,45,2245
56789,56789,FF6FF9B0197A91C0352AF48B73895F85,42201,12,21,9,43,46,2196
56790,56790,DE7BE47E05724D2B7B84051451E0119E,42161,0,1,1,36,47,1847
56791,56791,DE7BE47E05724D2B7B84051451E0119E,11261,2,7,5,36,46,1846
56792,56792,DE7BE47E05724D2B7B84051451E0119E,10111,9,21,12,37,47,1897
56793,56793,DE7BE47E05724D2B7B84051451E0119E,40431,21,23,2,36,47,1847
56807,56807,1F6BCFEB56D245CBF5160F742055C8A2,11151,0,6,6,30,48,1548
56808,56808,1F6BCFEB56D245CBF5160F742055C8A2,11061,9,10,1,29,48,1498
56809,56809,1F6BCFEB56D245CBF5160F742055C8A2,11151,13,22,9,30,48,1548
56813,56813,CEF1E24EB6DE8D3601A93286A0518B66,11301,1,15,14,41,49,2099
56814,56814,CEF1E24EB6DE8D3601A93286A0518B66,11031,17,19,2,42,49,2149
56815,56815,CEF1E24EB6DE8D3601A93286A0518B66,11301,22,23,1,41,49,2099
56816,56816,B362B5E77BA1E28CC69DD6493B38125B,42511,5,6,1,37,47,1897
56817,56817,B362B5E77BA1E28CC69DD6493B38125B,13681,9,15,6,38,47,1947
56818,56818,B362B5E77BA1E28CC69DD6493B38125B,42511,18,19,1,37,47,1897
56819,56819,B362B5E77BA1E28CC69DD6493B38125B,13331,21,23,2,38,47,1947
56825,56825,A4BC16FDE84BA1A928A7C6E482678E7C,10634,0,16,16,27,45,1395
56826,56826,A4BC16FDE84BA1A928A7C6E482678E7C,10351,16,18,2,28,45,1445
56827,56827,A4BC16FDE84BA1A928A7C6E482678E7C,10634,22,23,1,27,45,1395
56835,56835,E528C1BCF7730647027A4A7EFB058975,42631,0,7,7,43,45,2195
56836,56836,E528C1BCF7730647027A4A7EFB058975,13341,7,21,14,44,45,2245
56837,56837,E528C1BCF7730647027A4A7EFB058975,42631,21,23,2,43,45,2195
56838,56838,453CF8B71EBFA2B26AAAC1B1A809BFF0,11381,0,9,9,30,47,1547
56839,56839,453CF8B71EBFA2B26AAAC1B1A809BFF0,10281,10,12,2,33,48,1698
56840,56840,453CF8B71EBFA2B26AAAC1B1A809BFF0,11381,13,23,10,30,47,1547
56846,56846,F49F5A0F1C44EBAB5BE16379854ACBEE,11061,0,10,10,29,48,1498
56847,56847,F49F5A0F1C44EBAB5BE16379854ACBEE,43971,10,11,1,30,48,1548
56848,56848,F49F5A0F1C44EBAB5BE16379854ACBEE,11381,13,19,6,30,47,1547
56849,56849,E4A99F1C3E7ED34FBD67066F6ADB6F92,12311,0,9,9,30,44,1544
56850,56850,E4A99F1C3E7ED34FBD67066F6ADB6F92,10301,9,10,1,31,45,1595
56851,56851,E4A99F1C3E7ED34FBD67066F6ADB6F92,12311,10,18,8,30,44,1544
56852,56852,ED57081FEDFCA9B3E2228C4E0C491121,10111,0,13,13,37,47,1897
56853,56853,ED57081FEDFCA9B3E2228C4E0C491121,40637,16,18,2,36,47,1847
56854,56854,ED57081FEDFCA9B3E2228C4E0C491121,10111,20,23,3,37,47,1897
56855,56855,9F99A72527E81B89BEB16DB21B613CC0,10281,0,7,7,33,48,1698
56856,56856,9F99A72527E81B89BEB16DB21B613CC0,11861,8,16,8,32,47,1647
56857,56857,9F99A72527E81B89BEB16DB21B613CC0,10281,17,23,6,33,48,1698
56885,56885,192B69B185DD207A801CC9E47680182A,10471,0,11,11,37,48,1898
56886,56886,192B69B185DD207A801CC9E47680182A,11541,13,14,1,35,49,1799
56887,56887,192B69B185DD207A801CC9E47680182A,10471,14,23,9,37,48,1898
56894,56894,0A501EA010779C8F9EB8C2F8834C3F4F,10351,0,1,1,28,45,1445
56895,56895,0A501EA010779C8F9EB8C2F8834C3F4F,10301,2,21,19,31,45,1595
56896,56896,0A501EA010779C8F9EB8C2F8834C3F4F,10351,21,23,2,28,45,1445
56897,56897,40DFEFDD084B7E6FA138B7FBB6CFBE81,13711,0,2,2,38,46,1946
56898,56898,40DFEFDD084B7E6FA138B7FBB6CFBE81,42011,2,4,2,36,46,1846
56899,56899,40DFEFDD084B7E6FA138B7FBB6CFBE81,13711,6,14,8,38,46,1946
56900,56900,40DFEFDD084B7E6FA138B7FBB6CFBE81,11074,18,19,1,37,47,1897
56901,56901,C8853D20D98FBDC677FE97E63FEF8305,11351,0,6,6,36,48,1848
56902,56902,C8853D20D98FBDC677FE97E63FEF8305,12083,10,14,4,36,49,1849
56903,56903,C8853D20D98FBDC677FE97E63FEF8305,43281,22,23,1,37,48,1898
56915,56915,5102B42C348B7F58F60DC6DAF5653AF2,11914,3,16,13,37,48,1898
56916,56916,5102B42C348B7F58F60DC6DAF5653AF2,42581,18,19,1,38,48,1948
56917,56917,5102B42C348B7F58F60DC6DAF5653AF2,11914,21,22,1,37,48,1898
56921,56921,F38AB0098BE65E711BE711E13E868DCB,13561,0,8,8,37,49,1899
56922,56922,F38AB0098BE65E711BE711E13E868DCB,10651,12,13,1,36,49,1849
56923,56923,F38AB0098BE65E711BE711E13E868DCB,13561,18,20,2,37,49,1899
56927,56927,3C89D3E050BD396C6E176628C3E38174,42161,0,8,8,36,47,1847
56928,56928,3C89D3E050BD396C6E176628C3E38174,43241,12,15,3,36,46,1846
56929,56929,3C89D3E050BD396C6E176628C3E38174,10111,19,22,3,37,47,1897
56930,56930,3C89D3E050BD396C6E176628C3E38174,42161,22,23,1,36,47,1847
56951,56951,891C63A7FCD795A9067DDBCBE0342E42,11941,2,12,10,37,46,1896
56952,56952,891C63A7FCD795A9067DDBCBE0342E42,13711,13,14,1,38,46,1946
56953,56953,891C63A7FCD795A9067DDBCBE0342E42,43341,15,17,2,41,46,2096
56954,56954,891C63A7FCD795A9067DDBCBE0342E42,13711,20,23,3,38,46,1946
56955,56955,A0B07DBD7CFEABE1E4A0E9444C496CF6,13381,0,6,6,39,47,1997
56956,56956,A0B07DBD7CFEABE1E4A0E9444C496CF6,42271,6,10,4,40,47,2047
56957,56957,A0B07DBD7CFEABE1E4A0E9444C496CF6,13381,11,18,7,39,47,1997
56958,56958,A0B07DBD7CFEABE1E4A0E9444C496CF6,42271,19,23,4,40,47,2047
56966,56966,0277E6ABE6E23FB8B51E9078601CBBC1,42491,0,7,7,32,46,1646
56967,56967,0277E6ABE6E23FB8B51E9078601CBBC1,42523,8,20,12,31,47,1597
56968,56968,0277E6ABE6E23FB8B51E9078601CBBC1,42491,20,21,1,32,46,1646
56986,56986,91349C48DDEC6EB80D3AF85EC01EB45D,11261,0,5,5,36,46,1846
56987,56987,91349C48DDEC6EB80D3AF85EC01EB45D,42864,8,10,2,38,44,1944
56988,56988,91349C48DDEC6EB80D3AF85EC01EB45D,11261,14,18,4,36,46,1846
56989,56989,91349C48DDEC6EB80D3AF85EC01EB45D,42351,21,23,2,38,45,1945
56990,56990,0FAD7E3F153ED46D0B4D3B9B189CD783,42531,0,12,12,31,45,1595
56991,56991,0FAD7E3F153ED46D0B4D3B9B189CD783,10351,14,15,1,28,45,1445
56992,56992,0FAD7E3F153ED46D0B4D3B9B189CD783,42531,15,16,1,31,45,1595
56993,56993,0FAD7E3F153ED46D0B4D3B9B189CD783,12311,17,22,5,30,44,1544
56997,56997,FA05CF18A6BF06D3E5C89C49E2940179,11381,0,10,10,30,47,1547
56998,56998,FA05CF18A6BF06D3E5C89C49E2940179,11061,14,15,1,29,48,1498
56999,56999,FA05CF18A6BF06D3E5C89C49E2940179,11381,15,20,5,30,47,1547
57005,57005,916BC4263959BF562E5C6764781E4744,42531,1,6,5,31,45,1595
57006,57006,916BC4263959BF562E5C6764781E4744,12311,9,18,9,30,44,1544
57007,57007,916BC4263959BF562E5C6764781E4744,42531,20,21,1,31,45,1595
57008,57008,916BC4263959BF562E5C6764781E4744,12311,21,23,2,30,44,1544
57009,57009,3C5BF8354C7B22C00BFA5438C070BC0F,13711,0,14,14,38,46,1946
57010,57010,3C5BF8354C7B22C00BFA5438C070BC0F,43241,15,16,1,36,46,1846
57011,57011,3C5BF8354C7B22C00BFA5438C070BC0F,13711,18,20,2,38,46,1946
57020,57020,AB549C59FCD93A3593309CBEEEB0538B,11381,0,18,18,30,47,1547
57021,57021,AB549C59FCD93A3593309CBEEEB0538B,11161,19,21,2,32,48,1648
57022,57022,AB549C59FCD93A3593309CBEEEB0538B,11381,22,23,1,30,47,1547
57023,57023,2510A335FA627692203CB5C3136C3C6E,43081,0,9,9,27,28,1378
57024,57024,2510A335FA627692203CB5C3136C3C6E,15321,13,16,3,29,26,1476
57025,57025,2510A335FA627692203CB5C3136C3C6E,43081,16,17,1,27,28,1378
57026,57026,2510A335FA627692203CB5C3136C3C6E,15321,19,21,2,29,26,1476
57027,57027,D96C351A2D3BF2CB9C84E8F01C9997B6,12641,0,6,6,10,43,543
57028,57028,D96C351A2D3BF2CB9C84E8F01C9997B6,19021,8,9,1,10,45,545
57029,57029,D96C351A2D3BF2CB9C84E8F01C9997B6,12641,12,16,4,10,43,543
57030,57030,D96C351A2D3BF2CB9C84E8F01C9997B6,19114,19,21,2,7,43,393
57031,57031,B67FA5B6A32C471E8F98193F5D4C43FD,11551,7,8,1,39,49,1999
57032,57032,B67FA5B6A32C471E8F98193F5D4C43FD,10191,10,12,2,40,48,2048
57033,57033,B67FA5B6A32C471E8F98193F5D4C43FD,10931,17,18,1,41,48,2098
57039,57039,227550B71384889A67AC4E901F7C17A1,10151,0,7,7,34,47,1747
57040,57040,227550B71384889A67AC4E901F7C17A1,11861,9,18,9,32,47,1647
57041,57041,227550B71384889A67AC4E901F7C17A1,10151,18,23,5,34,47,1747
57042,57042,974334C13D3A5053FECD6B88791CD634,43281,1,9,8,37,48,1898
57043,57043,974334C13D3A5053FECD6B88791CD634,11201,13,15,2,35,49,1799
57044,57044,974334C13D3A5053FECD6B88791CD634,10471,16,18,2,37,48,1898
57045,57045,96B100113D40E22B39686C026F5DA397,13231,0,5,5,39,46,1996
57046,57046,96B100113D40E22B39686C026F5DA397,42864,6,8,2,38,44,1944
57047,57047,96B100113D40E22B39686C026F5DA397,11261,10,19,9,36,46,1846
57048,57048,3C02B5838EDEAB0B15A337805B269A42,13011,0,5,5,39,47,1997
57049,57049,3C02B5838EDEAB0B15A337805B269A42,42321,6,19,13,43,47,2197
57050,57050,3C02B5838EDEAB0B15A337805B269A42,13011,20,23,3,39,47,1997
57054,57054,7B63B781AF1E5C1909C9ECFED6946980,42523,0,4,4,31,47,1597
57055,57055,7B63B781AF1E5C1909C9ECFED6946980,43761,5,7,2,32,47,1647
57056,57056,7B63B781AF1E5C1909C9ECFED6946980,42523,7,8,1,31,47,1597
57057,57057,7B63B781AF1E5C1909C9ECFED6946980,43761,10,23,13,32,47,1647
57058,57058,67319AE9F58C4C8E1B88AE77DEDF1C54,13671,0,10,10,27,43,1393
57059,57059,67319AE9F58C4C8E1B88AE77DEDF1C54,11281,12,19,7,27,40,1390
57060,57060,67319AE9F58C4C8E1B88AE77DEDF1C54,13671,20,22,2,27,43,1393
57061,57061,67319AE9F58C4C8E1B88AE77DEDF1C54,11281,22,23,1,27,40,1390
57069,57069,7BB31A1D059FD6D88C054A61BB3B7FB1,42531,0,15,15,31,45,1595
57070,57070,7BB31A1D059FD6D88C054A61BB3B7FB1,12311,15,19,4,30,44,1544
57071,57071,7BB31A1D059FD6D88C054A61BB3B7FB1,42531,20,23,3,31,45,1595
57072,57072,40E9EC52478C6E620C1F9A08ACEF6556,40171,1,8,7,38,48,1948
57073,57073,40E9EC52478C6E620C1F9A08ACEF6556,11231,9,17,8,37,49,1899
57074,57074,40E9EC52478C6E620C1F9A08ACEF6556,43181,21,22,1,39,48,1998
57080,57080,946768BFA72752D5660750415178C67F,11081,9,10,1,35,46,1796
57081,57081,946768BFA72752D5660750415178C67F,10901,15,17,2,35,48,1798
57082,57082,946768BFA72752D5660750415178C67F,11021,17,20,3,36,49,1849
57083,57083,CB9FC3FE9195AF3F0A6A77B7B82B22F1,11591,0,1,1,36,49,1849
57084,57084,CB9FC3FE9195AF3F0A6A77B7B82B22F1,42471,5,6,1,35,49,1799
57085,57085,CB9FC3FE9195AF3F0A6A77B7B82B22F1,11591,9,23,14,36,49,1849
57086,57086,23938B8CBED0514FF17E1734652299B6,11074,4,12,8,37,47,1897
57087,57087,23938B8CBED0514FF17E1734652299B6,11081,16,18,2,35,46,1796
57088,57088,23938B8CBED0514FF17E1734652299B6,11074,19,22,3,37,47,1897
57097,57097,EACB94785D7D8588CB35DC947218B89F,43311,4,10,6,31,48,1598
57098,57098,EACB94785D7D8588CB35DC947218B89F,10281,12,15,3,33,48,1698
57099,57099,EACB94785D7D8588CB35DC947218B89F,43311,15,16,1,31,48,1598
57100,57100,EACB94785D7D8588CB35DC947218B89F,42021,19,20,1,33,47,1697
57108,57108,04A010DE5CF0CEB9D2E52B01453B2E1E,10471,0,11,11,37,48,1898
57109,57109,04A010DE5CF0CEB9D2E52B01453B2E1E,42471,12,13,1,35,49,1799
57110,57110,04A010DE5CF0CEB9D2E52B01453B2E1E,10471,14,23,9,37,48,1898
57120,57120,C619BC39ADD64D285F289B032026DA59,11074,4,8,4,37,47,1897
57121,57121,C619BC39ADD64D285F289B032026DA59,11941,10,15,5,37,46,1896
57122,57122,C619BC39ADD64D285F289B032026DA59,13711,15,16,1,38,46,1946
57123,57123,C619BC39ADD64D285F289B032026DA59,11074,20,22,2,37,47,1897
57131,57131,E859A0BF6FB37F9B42DF06EC7EE8FF9D,42461,0,6,6,45,47,2297
57132,57132,E859A0BF6FB37F9B42DF06EC7EE8FF9D,42321,7,19,12,43,47,2197
57133,57133,E859A0BF6FB37F9B42DF06EC7EE8FF9D,42461,21,22,1,45,47,2297
57137,57137,964156E683797EC321E31C806CD19178,11331,2,10,8,37,48,1898
57138,57138,964156E683797EC321E31C806CD19178,10191,14,18,4,40,48,2048
57139,57139,964156E683797EC321E31C806CD19178,11914,19,23,4,37,48,1898
57140,57140,53650105F7F25F79263F92D3A7D439AB,42461,0,1,1,45,47,2297
57141,57141,53650105F7F25F79263F92D3A7D439AB,42601,2,7,5,44,48,2248
57142,57142,53650105F7F25F79263F92D3A7D439AB,42461,8,23,15,45,47,2297
57143,57143,A18BBFB8111CE9788BEEE3B918FD7EDC,42941,0,6,6,37,47,1897
57144,57144,A18BBFB8111CE9788BEEE3B918FD7EDC,10411,8,10,2,36,48,1848
57145,57145,A18BBFB8111CE9788BEEE3B918FD7EDC,42941,12,18,6,37,47,1897
57151,57151,36B9A094E8D22C518990766A8F925428,19901,0,1,1,7,44,394
57152,57152,36B9A094E8D22C518990766A8F925428,12641,5,11,6,10,43,543
57153,57153,36B9A094E8D22C518990766A8F925428,19114,12,16,4,7,43,393
57154,57154,36B9A094E8D22C518990766A8F925428,12641,17,18,1,10,43,543
57155,57155,3B9989389C2FB72384F3330F9A990AB0,13911,3,4,1,39,46,1996
57156,57156,3B9989389C2FB72384F3330F9A990AB0,42231,7,17,10,37,46,1896
57157,57157,3B9989389C2FB72384F3330F9A990AB0,13911,18,19,1,39,46,1996
57158,57158,8721A90F0F0902926D0D708FD844AAE9,11921,2,9,7,38,48,1948
57159,57159,8721A90F0F0902926D0D708FD844AAE9,11914,11,21,10,37,48,1898
57160,57160,8721A90F0F0902926D0D708FD844AAE9,11921,21,23,2,38,48,1948
57165,57165,E16566CAC1D2263C830A92E3D7A4B3A9,42231,6,8,2,37,46,1896
57166,57166,E16566CAC1D2263C830A92E3D7A4B3A9,42351,9,10,1,38,45,1945
57167,57167,E16566CAC1D2263C830A92E3D7A4B3A9,42231,13,16,3,37,46,1896
57168,57168,E16566CAC1D2263C830A92E3D7A4B3A9,42351,21,23,2,38,45,1945
57177,57177,A4E401AD660AFE224AC7625C8D3FB39A,10681,0,5,5,30,48,1548
57178,57178,A4E401AD660AFE224AC7625C8D3FB39A,11381,8,11,3,30,47,1547
57179,57179,A4E401AD660AFE224AC7625C8D3FB39A,11061,11,23,12,29,48,1498
57192,57192,7B7E4788D0880A4F3030299258F97D5E,40891,1,7,6,37,47,1897
57193,57193,7B7E4788D0880A4F3030299258F97D5E,42231,10,11,1,37,46,1896
57194,57194,7B7E4788D0880A4F3030299258F97D5E,40891,13,14,1,37,47,1897
57195,57195,7B7E4788D0880A4F3030299258F97D5E,42231,18,19,1,37,46,1896
57196,57196,FA2623C606924F5ED8F11D0D6105AE9C,11861,0,8,8,32,47,1647
57197,57197,FA2623C606924F5ED8F11D0D6105AE9C,10281,8,11,3,33,48,1698
57198,57198,FA2623C606924F5ED8F11D0D6105AE9C,11861,11,22,11,32,47,1647
57199,57199,19A29A27E6506D34C07A04E6E9F52A03,42151,0,6,6,35,45,1795
57200,57200,19A29A27E6506D34C07A04E6E9F52A03,12491,9,10,1,36,43,1843
57201,57201,19A29A27E6506D34C07A04E6E9F52A03,42151,10,20,10,35,45,1795
57202,57202,A4B13605C78797589D9B98BC8787EDD0,19114,3,6,3,7,43,393
57203,57203,A4B13605C78797589D9B98BC8787EDD0,49201,9,10,1,7,41,391
57204,57204,A4B13605C78797589D9B98BC8787EDD0,12921,15,16,1,9,41,491
57205,57205,A4B13605C78797589D9B98BC8787EDD0,19931,20,22,2,7,43,393
57211,57211,AA71E9A6AEA764D2564D532D0321512B,42041,0,5,5,10,47,547
57212,57212,AA71E9A6AEA764D2564D532D0321512B,19441,6,8,2,8,46,446
57213,57213,AA71E9A6AEA764D2564D532D0321512B,42041,12,21,9,10,47,547
57214,57214,AA71E9A6AEA764D2564D532D0321512B,11571,22,23,1,13,46,696
57218,57218,F74E1805BD471CD67AFEC7E33078A7FE,11914,0,5,5,37,48,1898
57219,57219,F74E1805BD471CD67AFEC7E33078A7FE,43361,5,18,13,38,48,1948
57220,57220,F74E1805BD471CD67AFEC7E33078A7FE,11914,19,21,2,37,48,1898
57228,57228,ED39FFF9DCC8B1E2AFD625755D8B1585,19441,0,9,9,8,46,446
57229,57229,ED39FFF9DCC8B1E2AFD625755D8B1585,42041,11,20,9,10,47,547
57230,57230,ED39FFF9DCC8B1E2AFD625755D8B1585,19821,22,23,1,4,46,246
57231,57231,B3D9D8E72FD92A77A76B6490766A3C36,19901,0,3,3,7,44,394
57232,57232,B3D9D8E72FD92A77A76B6490766A3C36,12641,6,7,1,10,43,543
57233,57233,B3D9D8E72FD92A77A76B6490766A3C36,19114,8,22,14,7,43,393
57242,57242,C480B777251B620ACAA88D390354CC87,42301,0,6,6,36,47,1847
57243,57243,C480B777251B620ACAA88D390354CC87,10111,10,11,1,37,47,1897
57244,57244,C480B777251B620ACAA88D390354CC87,42301,14,16,2,36,47,1847
57245,57245,C480B777251B620ACAA88D390354CC87,10111,17,22,5,37,47,1897
57250,57250,A3BFED7EBC8273A150663075EB9361B2,11271,1,8,7,37,48,1898
57251,57251,A3BFED7EBC8273A150663075EB9361B2,40181,8,11,3,37,49,1899
57252,57252,A3BFED7EBC8273A150663075EB9361B2,11921,14,22,8,38,48,1948
57256,57256,67BFE671A2A3401B4F4B1413592F3381,10431,0,6,6,33,49,1699
57257,57257,67BFE671A2A3401B4F4B1413592F3381,43581,9,10,1,33,48,1698
57258,57258,67BFE671A2A3401B4F4B1413592F3381,10431,11,23,12,33,49,1699
57262,57262,9FC853D14B199D9AE09B3905110E90BD,12514,0,7,7,38,47,1947
57263,57263,9FC853D14B199D9AE09B3905110E90BD,42221,8,10,2,38,48,1948
57264,57264,9FC853D14B199D9AE09B3905110E90BD,12514,12,23,11,38,47,1947
57265,57265,ECD1768E70E5706355D045A9A7240640,42141,0,7,7,32,47,1647
57266,57266,ECD1768E70E5706355D045A9A7240640,10281,8,11,3,33,48,1698
57267,57267,ECD1768E70E5706355D045A9A7240640,42141,11,22,11,32,47,1647
57268,57268,3B51D35312366F465063EC96C6FBF2FE,43581,0,7,7,33,48,1698
57269,57269,3B51D35312366F465063EC96C6FBF2FE,13651,8,16,8,30,47,1547
57270,57270,3B51D35312366F465063EC96C6FBF2FE,43581,20,22,2,33,48,1698
57271,57271,3C20A4FB5A5B0FD7EA7A50D0F5C8CA66,12641,0,5,5,10,43,543
57272,57272,3C20A4FB5A5B0FD7EA7A50D0F5C8CA66,12921,5,10,5,9,41,491
57273,57273,3C20A4FB5A5B0FD7EA7A50D0F5C8CA66,12641,11,13,2,10,43,543
57274,57274,3C20A4FB5A5B0FD7EA7A50D0F5C8CA66,12921,15,19,4,9,41,491
57275,57275,D67CCCAEEDDE4707F0E74F81F0018500,42021,0,1,1,33,47,1697
57276,57276,D67CCCAEEDDE4707F0E74F81F0018500,10281,3,4,1,33,48,1698
57277,57277,D67CCCAEEDDE4707F0E74F81F0018500,40941,4,22,18,32,48,1648
57278,57278,2B4C8200B930C7563C781E360D03B430,12381,0,2,2,32,48,1648
57279,57279,2B4C8200B930C7563C781E360D03B430,11151,3,13,10,30,48,1548
57280,57280,2B4C8200B930C7563C781E360D03B430,40094,15,23,8,29,48,1498
57288,57288,ED1B197D1A6AAA8BFAE9A2A66FB2A911,12921,10,12,2,9,41,491
57289,57289,ED1B197D1A6AAA8BFAE9A2A66FB2A911,49201,16,17,1,7,41,391
57290,57290,ED1B197D1A6AAA8BFAE9A2A66FB2A911,19111,19,21,2,9,45,495
57291,57291,9B13D95106A4BC5C142691820306BA23,12514,0,16,16,38,47,1947
57292,57292,9B13D95106A4BC5C142691820306BA23,10841,19,21,2,37,47,1897
57293,57293,9B13D95106A4BC5C142691820306BA23,12514,22,23,1,38,47,1947
57299,57299,6DFA48F81EF42083077B44FC80706865,43161,0,8,8,35,47,1797
57300,57300,6DFA48F81EF42083077B44FC80706865,10161,8,11,3,35,49,1799
57301,57301,6DFA48F81EF42083077B44FC80706865,43161,12,18,6,35,47,1797
57302,57302,6DFA48F81EF42083077B44FC80706865,43731,20,23,3,34,47,1747
57306,57306,700A8469B8648E235281334EF5CC8DA1,10371,0,10,10,37,49,1899
57307,57307,700A8469B8648E235281334EF5CC8DA1,10471,10,11,1,37,48,1898
57308,57308,700A8469B8648E235281334EF5CC8DA1,10371,11,23,12,37,49,1899
57309,57309,9578C0DC67ACE68D6F89F515DBD5C8C2,19114,0,6,6,7,43,393
57310,57310,9578C0DC67ACE68D6F89F515DBD5C8C2,12921,7,8,1,9,41,491
57311,57311,9578C0DC67ACE68D6F89F515DBD5C8C2,19744,13,14,1,6,43,343
57312,57312,9578C0DC67ACE68D6F89F515DBD5C8C2,12921,14,18,4,9,41,491
57313,57313,E7F37D656C2100FD6268D14C43379587,13271,0,7,7,41,47,2097
57314,57314,E7F37D656C2100FD6268D14C43379587,40302,13,16,3,40,49,2049
57315,57315,E7F37D656C2100FD6268D14C43379587,13271,19,21,2,41,47,2097
57321,57321,B5F3581649228AFCDFA595ACA1F1686A,11861,0,7,7,32,47,1647
57322,57322,B5F3581649228AFCDFA595ACA1F1686A,10251,9,11,2,35,47,1797
57323,57323,B5F3581649228AFCDFA595ACA1F1686A,42401,14,16,2,36,47,1847
57324,57324,B5F3581649228AFCDFA595ACA1F1686A,10251,16,18,2,35,47,1797
57325,57325,981FF39DB0050476FC5E5BA7D49F90F5,42864,0,11,11,38,44,1944
57326,57326,981FF39DB0050476FC5E5BA7D49F90F5,11261,15,18,3,36,46,1846
57327,57327,981FF39DB0050476FC5E5BA7D49F90F5,42864,22,23,1,38,44,1944
57331,57331,B0E329B00E3FA297B870177AA9BA63AC,42141,0,11,11,32,47,1647
57332,57332,B0E329B00E3FA297B870177AA9BA63AC,42501,12,13,1,28,47,1447
57333,57333,B0E329B00E3FA297B870177AA9BA63AC,42141,14,19,5,32,47,1647
57334,57334,DFB165CFE9559A5506E7B4D8DE725042,43671,0,2,2,35,48,1798
57335,57335,DFB165CFE9559A5506E7B4D8DE725042,12971,10,11,1,32,48,1648
57336,57336,DFB165CFE9559A5506E7B4D8DE725042,11491,17,18,1,36,47,1847
57337,57337,DFB165CFE9559A5506E7B4D8DE725042,10781,19,23,4,35,47,1797
57338,57338,0AE1F060A9917578AF6CC39BEF4A5FD7,11914,0,6,6,37,48,1898
57339,57339,0AE1F060A9917578AF6CC39BEF4A5FD7,10371,8,18,10,37,49,1899
57340,57340,0AE1F060A9917578AF6CC39BEF4A5FD7,11074,20,21,1,37,47,1897
57341,57341,23F8F9B0AC0C62AC07DD5CA5BCEDE820,13551,1,8,7,45,38,2288
57342,57342,23F8F9B0AC0C62AC07DD5CA5BCEDE820,43101,10,16,6,46,40,2340
57343,57343,23F8F9B0AC0C62AC07DD5CA5BCEDE820,13551,17,20,3,45,38,2288
57347,57347,E835E54D31E2053FF59F5E3D61ABCD72,11151,0,8,8,30,48,1548
57348,57348,E835E54D31E2053FF59F5E3D61ABCD72,11061,9,10,1,29,48,1498
57349,57349,E835E54D31E2053FF59F5E3D61ABCD72,11151,11,23,12,30,48,1548
57350,57350,508DF001F529FBF83DF8D4A342350BFA,11261,8,12,4,36,46,1846
57351,57351,508DF001F529FBF83DF8D4A342350BFA,42861,12,13,1,37,44,1894
57352,57352,508DF001F529FBF83DF8D4A342350BFA,11261,15,17,2,36,46,1846
57353,57353,508DF001F529FBF83DF8D4A342350BFA,42861,19,21,2,37,44,1894
57354,57354,F96749D4BA3E2CF52A7AC27CA361290D,11381,2,4,2,30,47,1547
57355,57355,F96749D4BA3E2CF52A7AC27CA361290D,11061,4,5,1,29,48,1498
57356,57356,F96749D4BA3E2CF52A7AC27CA361290D,11381,9,19,10,30,47,1547
57357,57357,F96749D4BA3E2CF52A7AC27CA361290D,42521,20,21,1,31,47,1597
57365,57365,8141A730EF01126DFD9282AFDEA49317,11061,0,14,14,29,48,1498
57366,57366,8141A730EF01126DFD9282AFDEA49317,11431,17,18,1,29,47,1497
57367,57367,8141A730EF01126DFD9282AFDEA49317,11061,22,23,1,29,48,1498
57379,57379,E44757DC5C96DAA3D4F68F9ED452A860,11271,0,17,17,37,48,1898
57380,57380,E44757DC5C96DAA3D4F68F9ED452A860,11531,19,21,2,34,49,1749
57381,57381,E44757DC5C96DAA3D4F68F9ED452A860,12391,21,23,2,36,49,1849
57382,57382,B1891B03CB53C325B13F0CF9131A1E17,12921,0,9,9,9,41,491
57383,57383,B1891B03CB53C325B13F0CF9131A1E17,12641,9,10,1,10,43,543
57384,57384,B1891B03CB53C325B13F0CF9131A1E17,12921,15,23,8,9,41,491
57388,57388,DFFD8263F8D171E98D9F6788AFF5A2A7,42271,0,8,8,40,47,2047
57389,57389,DFFD8263F8D171E98D9F6788AFF5A2A7,11481,12,13,1,41,48,2098
57390,57390,DFFD8263F8D171E98D9F6788AFF5A2A7,42271,13,23,10,40,47,2047
57398,57398,1CE5F4D10EE2FB173CB9F2BC0746661A,12311,0,8,8,30,44,1544
57399,57399,1CE5F4D10EE2FB173CB9F2BC0746661A,42531,9,10,1,31,45,1595
57400,57400,1CE5F4D10EE2FB173CB9F2BC0746661A,12311,10,18,8,30,44,1544
57401,57401,1CE5F4D10EE2FB173CB9F2BC0746661A,42531,18,22,4,31,45,1595
57402,57402,EB24244BB73BD551F4B0247AA2F1F50A,12381,0,7,7,32,48,1648
57403,57403,EB24244BB73BD551F4B0247AA2F1F50A,10221,8,18,10,34,49,1749
57404,57404,EB24244BB73BD551F4B0247AA2F1F50A,12381,21,23,2,32,48,1648
57408,57408,CD55B44A3FD4B718A673CC03711FD344,12921,1,16,15,9,41,491
57409,57409,CD55B44A3FD4B718A673CC03711FD344,12641,17,19,2,10,43,543
57410,57410,CD55B44A3FD4B718A673CC03711FD344,12921,21,22,1,9,41,491
57415,57415,394B81CC36B31D897120A6153D7C1457,11061,0,4,4,29,48,1498
57416,57416,394B81CC36B31D897120A6153D7C1457,12121,6,16,10,29,47,1497
57417,57417,394B81CC36B31D897120A6153D7C1457,11061,20,23,3,29,48,1498
57418,57418,3F2FE95AB24E5E71D935604E5158C97B,11701,0,15,15,43,48,2198
57419,57419,3F2FE95AB24E5E71D935604E5158C97B,40302,18,20,2,40,49,2049
57420,57420,3F2FE95AB24E5E71D935604E5158C97B,41392,20,23,3,43,48,2198
57421,57421,7D40FDA16D9F775EEBE4F7D8E79E845C,42521,1,16,15,31,47,1597
57422,57422,7D40FDA16D9F775EEBE4F7D8E79E845C,10681,18,20,2,30,48,1548
57423,57423,7D40FDA16D9F775EEBE4F7D8E79E845C,11861,21,23,2,32,47,1647
57424,57424,4560AA6E9FF5488D13E472C26129D09F,13011,6,9,3,39,47,1997
57425,57425,4560AA6E9FF5488D13E472C26129D09F,12514,11,13,2,38,47,1947
57426,57426,4560AA6E9FF5488D13E472C26129D09F,42511,14,15,1,37,47,1897
57427,57427,4560AA6E9FF5488D13E472C26129D09F,42301,19,21,2,36,47,1847
57433,57433,BA285F01E6926591864F1F3184565800,42581,0,6,6,38,48,1948
57434,57434,BA285F01E6926591864F1F3184565800,10471,8,10,2,37,48,1898
57435,57435,BA285F01E6926591864F1F3184565800,42581,15,23,8,38,48,1948
57439,57439,9D5FAD2D946916458AB09D98B7F6CB85,42623,0,6,6,22,49,1149
57440,57440,9D5FAD2D946916458AB09D98B7F6CB85,42081,10,11,1,24,49,1249
57441,57441,9D5FAD2D946916458AB09D98B7F6CB85,11641,14,20,6,22,49,1149
57442,57442,17AEFEF657B11D131BDD3C3B66C9A042,10271,0,8,8,37,46,1896
57443,57443,17AEFEF657B11D131BDD3C3B66C9A042,13711,9,12,3,38,46,1946
57444,57444,17AEFEF657B11D131BDD3C3B66C9A042,42011,15,21,6,36,46,1846
57469,57469,75D26EF2979B76AF3B88B994D0C67B7D,10811,0,6,6,38,46,1946
57470,57470,75D26EF2979B76AF3B88B994D0C67B7D,42231,11,13,2,37,46,1896
57471,57471,75D26EF2979B76AF3B88B994D0C67B7D,11261,13,15,2,36,46,1846
57472,57472,75D26EF2979B76AF3B88B994D0C67B7D,42231,19,20,1,37,46,1896
57473,57473,8216976CCAE5E4C68F70476A01BDA009,42381,2,5,3,39,41,1991
57474,57474,8216976CCAE5E4C68F70476A01BDA009,43451,8,9,1,37,40,1890
57475,57475,8216976CCAE5E4C68F70476A01BDA009,42381,12,23,11,39,41,1991
57476,57476,E4F5FFA2D6B1B5B03E37AA2E37DE4BFE,10951,0,3,3,29,48,1498
57477,57477,E4F5FFA2D6B1B5B03E37AA2E37DE4BFE,11381,6,13,7,30,47,1547
57478,57478,E4F5FFA2D6B1B5B03E37AA2E37DE4BFE,10951,15,17,2,29,48,1498
57479,57479,E4F5FFA2D6B1B5B03E37AA2E37DE4BFE,11381,17,23,6,30,47,1547
57502,57502,9F7BBEBDE25379D4345B2CB89A6224BC,10295,0,9,9,30,47,1547
57503,57503,9F7BBEBDE25379D4345B2CB89A6224BC,42831,10,11,1,27,48,1398
57504,57504,9F7BBEBDE25379D4345B2CB89A6224BC,10295,13,23,10,30,47,1547
57505,57505,63943FE4F7EDF153E7C6647314D59F7F,10511,0,12,12,35,46,1796
57506,57506,63943FE4F7EDF153E7C6647314D59F7F,42021,13,15,2,33,47,1697
57507,57507,63943FE4F7EDF153E7C6647314D59F7F,10511,15,23,8,35,46,1796
57508,57508,7F683BD350227B09C7ECC1328A0C4739,13711,0,2,2,38,46,1946
57509,57509,7F683BD350227B09C7ECC1328A0C4739,10271,3,13,10,37,46,1896
57510,57510,7F683BD350227B09C7ECC1328A0C4739,42011,16,21,5,36,46,1846
57515,57515,4B4CE8350EE5983D88D79AB387613407,42581,0,10,10,38,48,1948
57516,57516,4B4CE8350EE5983D88D79AB387613407,11914,10,11,1,37,48,1898
57517,57517,4B4CE8350EE5983D88D79AB387613407,42581,14,21,7,38,48,1948
57524,57524,5C7F8A03755C44742187CEE0EDAF92C8,19021,10,11,1,10,45,545
57525,57525,5C7F8A03755C44742187CEE0EDAF92C8,11571,12,14,2,13,46,696
57526,57526,5C7F8A03755C44742187CEE0EDAF92C8,19021,14,19,5,10,45,545
57552,57552,9B8E3A84EF821A3E9564A6D6EAEA0FE5,42581,3,8,5,38,48,1948
57553,57553,9B8E3A84EF821A3E9564A6D6EAEA0FE5,11914,9,15,6,37,48,1898
57554,57554,9B8E3A84EF821A3E9564A6D6EAEA0FE5,42581,19,20,1,38,48,1948
57558,57558,F8FD16629819B20972FEBA21A43C5924,42921,6,13,7,33,47,1697
57559,57559,F8FD16629819B20972FEBA21A43C5924,11861,17,19,2,32,47,1647
57560,57560,F8FD16629819B20972FEBA21A43C5924,42921,19,23,4,33,47,1697
57561,57561,8E0D20320C5276BDD797BA6D65B9C51D,11074,0,7,7,37,47,1897
57562,57562,8E0D20320C5276BDD797BA6D65B9C51D,12083,8,18,10,36,49,1849
57563,57563,8E0D20320C5276BDD797BA6D65B9C51D,11074,19,23,4,37,47,1897
57575,57575,5D3AB87CDE152EA5E956E4DDC06AC59B,40171,1,12,11,38,48,1948
57576,57576,5D3AB87CDE152EA5E956E4DDC06AC59B,10471,12,14,2,37,48,1898
57577,57577,5D3AB87CDE152EA5E956E4DDC06AC59B,40171,18,23,5,38,48,1948
57586,57586,C35D795DA33BE0311413852FD4760F3A,11261,0,6,6,36,46,1846
57587,57587,C35D795DA33BE0311413852FD4760F3A,42864,8,10,2,38,44,1944
57588,57588,C35D795DA33BE0311413852FD4760F3A,11261,11,23,12,36,46,1846
57589,57589,416A91B7DEFDE658C6F804F6E96AE459,42981,0,12,12,36,49,1849
57590,57590,416A91B7DEFDE658C6F804F6E96AE459,11751,13,15,2,35,48,1798
57591,57591,416A91B7DEFDE658C6F804F6E96AE459,10161,15,17,2,35,49,1799
57592,57592,416A91B7DEFDE658C6F804F6E96AE459,11231,20,23,3,37,49,1899
57593,57593,017E7601FB9C9C3C9E5F1FE87B4C9BCD,42231,0,11,11,37,46,1896
57594,57594,017E7601FB9C9C3C9E5F1FE87B4C9BCD,13911,11,12,1,39,46,1996
57595,57595,017E7601FB9C9C3C9E5F1FE87B4C9BCD,42231,14,23,9,37,46,1896
57596,57596,6221B7D255495D2F4CD9AE538066AFFC,42231,0,16,16,37,46,1896
57597,57597,6221B7D255495D2F4CD9AE538066AFFC,11261,17,18,1,36,46,1846
57598,57598,6221B7D255495D2F4CD9AE538066AFFC,42231,20,23,3,37,46,1896
57599,57599,3F92550AE7FA536C6ED9DF3D484ADD7A,10811,0,7,7,38,46,1946
57600,57600,3F92550AE7FA536C6ED9DF3D484ADD7A,11261,9,10,1,36,46,1846
57601,57601,3F92550AE7FA536C6ED9DF3D484ADD7A,10811,11,14,3,38,46,1946
57602,57602,3F92550AE7FA536C6ED9DF3D484ADD7A,11261,17,19,2,36,46,1846
57612,57612,8D188B1328CA03E5FCB5F80DC745FFDD,42523,0,16,16,31,47,1597
57613,57613,8D188B1328CA03E5FCB5F80DC745FFDD,10721,17,18,1,31,48,1598
57614,57614,8D188B1328CA03E5FCB5F80DC745FFDD,10341,19,23,4,31,47,1597
57615,57615,A09953F67FED80A8C2308F84F83FE6DA,13711,8,11,3,38,46,1946
57616,57616,A09953F67FED80A8C2308F84F83FE6DA,43241,14,18,4,36,46,1846
57617,57617,A09953F67FED80A8C2308F84F83FE6DA,13711,20,22,2,38,46,1946
57618,57618,89084C54499EDD168F6753B4E522A173,42581,4,18,14,38,48,1948
57619,57619,89084C54499EDD168F6753B4E522A173,11914,18,20,2,37,48,1898
57620,57620,89084C54499EDD168F6753B4E522A173,42581,21,23,2,38,48,1948
57624,57624,1607BA6A625F09858B43E48B2EC869F9,12311,0,7,7,30,44,1544
57625,57625,1607BA6A625F09858B43E48B2EC869F9,10292,8,16,8,30,47,1547
57626,57626,1607BA6A625F09858B43E48B2EC869F9,12311,21,23,2,30,44,1544
57627,57627,D918AB959FC04B9F76C490D41025EBC5,42523,8,10,2,31,47,1597
57628,57628,D918AB959FC04B9F76C490D41025EBC5,12131,10,12,2,32,47,1647
57629,57629,D918AB959FC04B9F76C490D41025EBC5,42523,13,16,3,31,47,1597
57630,57630,D918AB959FC04B9F76C490D41025EBC5,11161,19,23,4,32,48,1648
57637,57637,7BD5666208D4C4EF90CAAD8A97E6ED7C,12491,0,6,6,36,43,1843
57638,57638,7BD5666208D4C4EF90CAAD8A97E6ED7C,42151,7,18,11,35,45,1795
57639,57639,7BD5666208D4C4EF90CAAD8A97E6ED7C,12491,22,23,1,36,43,1843
57640,57640,7779D5C4E5073D864A9050EB76A5AC64,11261,9,10,1,36,46,1846
57641,57641,7779D5C4E5073D864A9050EB76A5AC64,42351,11,12,1,38,45,1945
57642,57642,7779D5C4E5073D864A9050EB76A5AC64,11261,15,20,5,36,46,1846
57643,57643,50897C798DD981F790935635A0EC3137,42501,9,13,4,28,47,1447
57644,57644,50897C798DD981F790935635A0EC3137,12601,14,15,1,25,47,1297
57645,57645,50897C798DD981F790935635A0EC3137,10171,15,16,1,26,47,1347
57646,57646,50897C798DD981F790935635A0EC3137,12601,19,23,4,25,47,1297
57661,57661,30F94368F131A73FAC48CF4BAF636AD7,42161,0,7,7,36,47,1847
57662,57662,30F94368F131A73FAC48CF4BAF636AD7,13681,8,18,10,38,47,1947
57663,57663,30F94368F131A73FAC48CF4BAF636AD7,42161,19,23,4,36,47,1847
57664,57664,76A50127C9E8E4C112EB1B61B027BCBF,11631,0,1,1,12,49,649
57665,57665,76A50127C9E8E4C112EB1B61B027BCBF,12621,2,4,2,10,48,548
57666,57666,76A50127C9E8E4C112EB1B61B027BCBF,11631,6,23,17,12,49,649
57667,57667,7AEC96944ABDE836F2A5F23132A96D0B,42511,0,7,7,37,47,1897
57668,57668,7AEC96944ABDE836F2A5F23132A96D0B,42301,8,13,5,36,47,1847
57669,57669,7AEC96944ABDE836F2A5F23132A96D0B,42961,17,22,5,35,49,1799
57678,57678,92281A0D755891E7CE6879F8990277A0,10111,0,5,5,37,47,1897
57679,57679,92281A0D755891E7CE6879F8990277A0,11081,8,9,1,35,46,1796
57680,57680,92281A0D755891E7CE6879F8990277A0,10111,12,13,1,37,47,1897
57681,57681,92281A0D755891E7CE6879F8990277A0,11081,16,23,7,35,46,1796
57706,57706,B6F6F13D49C5F5D8607D76C442F8E8EC,11491,0,11,11,36,47,1847
57707,57707,B6F6F13D49C5F5D8607D76C442F8E8EC,13121,12,14,2,38,46,1946
57708,57708,B6F6F13D49C5F5D8607D76C442F8E8EC,11491,16,22,6,36,47,1847
57709,57709,853A16C8E6E154D13F9864F752CCB2E5,13101,0,9,9,40,47,2047
57710,57710,853A16C8E6E154D13F9864F752CCB2E5,11481,10,12,2,41,48,2098
57711,57711,853A16C8E6E154D13F9864F752CCB2E5,13101,12,22,10,40,47,2047
57728,57728,D2E89B4D6E128AABB422EC89600FDDFE,13511,0,8,8,34,48,1748
57729,57729,D2E89B4D6E128AABB422EC89600FDDFE,43761,10,17,7,32,47,1647
57730,57730,D2E89B4D6E128AABB422EC89600FDDFE,40636,21,23,2,35,48,1798
57731,57731,DC9866094212A637CCAC17CF01FE4B5F,42861,0,10,10,37,44,1894
57732,57732,DC9866094212A637CCAC17CF01FE4B5F,11261,14,16,2,36,46,1846
57733,57733,DC9866094212A637CCAC17CF01FE4B5F,42861,18,23,5,37,44,1894
57734,57734,A06465C33822DBAACCFCA67CF792360D,42491,0,1,1,32,46,1646
57735,57735,A06465C33822DBAACCFCA67CF792360D,10295,1,15,14,30,47,1547
57736,57736,A06465C33822DBAACCFCA67CF792360D,42523,17,19,2,31,47,1597
57743,57743,446AC7E279C6659F3E40FC9C0B9B7F45,13341,6,9,3,44,45,2245
57744,57744,446AC7E279C6659F3E40FC9C0B9B7F45,42631,12,13,1,43,45,2195
57745,57745,446AC7E279C6659F3E40FC9C0B9B7F45,13341,14,23,9,44,45,2245
57746,57746,D9FB9F3F4820A4EF951566780A770C45,11261,0,9,9,36,46,1846
57747,57747,D9FB9F3F4820A4EF951566780A770C45,13911,9,11,2,39,46,1996
57748,57748,D9FB9F3F4820A4EF951566780A770C45,11261,14,19,5,36,46,1846
57749,57749,4261146F2156D759CC398098D8E7463C,10221,0,1,1,34,49,1749
57750,57750,4261146F2156D759CC398098D8E7463C,13511,2,17,15,34,48,1748
57751,57751,4261146F2156D759CC398098D8E7463C,12083,18,23,5,36,49,1849
57752,57752,0A1386913DE713CBA72662A5149627A3,13711,0,5,5,38,46,1946
57753,57753,0A1386913DE713CBA72662A5149627A3,11941,9,12,3,37,46,1896
57754,57754,0A1386913DE713CBA72662A5149627A3,13711,12,23,11,38,46,1946
57755,57755,7681E0D68D024C184A5D43D46389C591,42491,0,1,1,32,46,1646
57756,57756,7681E0D68D024C184A5D43D46389C591,42921,2,13,11,33,47,1697
57757,57757,7681E0D68D024C184A5D43D46389C591,11861,13,18,5,32,47,1647
57758,57758,7C98BDF484E2B085C51A4945E804FC0C,42151,0,16,16,35,45,1795
57759,57759,7C98BDF484E2B085C51A4945E804FC0C,12491,17,18,1,36,43,1843
57760,57760,7C98BDF484E2B085C51A4945E804FC0C,42151,19,22,3,35,45,1795
57764,57764,F13BF35DDA7165459639C0E2A48EBF6C,49201,0,11,11,7,41,391
57765,57765,F13BF35DDA7165459639C0E2A48EBF6C,12921,13,16,3,9,41,491
57766,57766,F13BF35DDA7165459639C0E2A48EBF6C,49201,16,23,7,7,41,391
57767,57767,0FF23BFDB55A76F1FEA2FEA8A42CA80D,11061,0,17,17,29,48,1498
57768,57768,0FF23BFDB55A76F1FEA2FEA8A42CA80D,11381,17,18,1,30,47,1547
57769,57769,0FF23BFDB55A76F1FEA2FEA8A42CA80D,11061,20,21,1,29,48,1498
57783,57783,2A3AD4959395DC229612EE5FA4ACEA58,10681,0,7,7,30,48,1548
57784,57784,2A3AD4959395DC229612EE5FA4ACEA58,11381,9,11,2,30,47,1547
57785,57785,2A3AD4959395DC229612EE5FA4ACEA58,10681,13,14,1,30,48,1548
57786,57786,2A3AD4959395DC229612EE5FA4ACEA58,11061,16,22,6,29,48,1498
57787,57787,409EAD533DBB4CABE595F1357EB3A959,12211,0,4,4,41,44,2094
57788,57788,409EAD533DBB4CABE595F1357EB3A959,12141,5,7,2,42,45,2145
57789,57789,409EAD533DBB4CABE595F1357EB3A959,42631,8,9,1,43,45,2195
57790,57790,409EAD533DBB4CABE595F1357EB3A959,12141,14,23,9,42,45,2145
57791,57791,4AEBF51A81E0ED548D9C5ED105DCD62A,10471,0,11,11,37,48,1898
57792,57792,4AEBF51A81E0ED548D9C5ED105DCD62A,42471,12,13,1,35,49,1799
57793,57793,4AEBF51A81E0ED548D9C5ED105DCD62A,10471,14,23,9,37,48,1898
57804,57804,2CB6953F391C73F166D02AC31E930A06,40171,1,5,4,38,48,1948
57805,57805,2CB6953F391C73F166D02AC31E930A06,11914,6,19,13,37,48,1898
57806,57806,2CB6953F391C73F166D02AC31E930A06,11921,21,23,2,38,48,1948
57812,57812,6EB73BC8964AD97D01165273A919D84A,11861,5,8,3,32,47,1647
57813,57813,6EB73BC8964AD97D01165273A919D84A,42021,11,15,4,33,47,1697
57814,57814,6EB73BC8964AD97D01165273A919D84A,11861,17,21,4,32,47,1647
57815,57815,6EB73BC8964AD97D01165273A919D84A,42021,22,23,1,33,47,1697
57823,57823,4B5C492CF16B079882322240829D6566,10661,0,11,11,37,49,1899
57824,57824,4B5C492CF16B079882322240829D6566,43281,12,14,2,37,48,1898
57825,57825,4B5C492CF16B079882322240829D6566,11231,15,23,8,37,49,1899
57834,57834,2225B98FA156A14E8455FE2B9E416A4B,11781,10,12,2,38,49,1949
57835,57835,2225B98FA156A14E8455FE2B9E416A4B,12481,12,14,2,37,49,1899
57836,57836,2225B98FA156A14E8455FE2B9E416A4B,42161,21,23,2,36,47,1847
57837,57837,F16A57AEB5E96DE0600B6936E2FABAEC,10271,2,18,16,37,46,1896
57838,57838,F16A57AEB5E96DE0600B6936E2FABAEC,13711,19,20,1,38,46,1946
57839,57839,F16A57AEB5E96DE0600B6936E2FABAEC,10271,20,21,1,37,46,1896
57851,57851,D8B46FFCD15B641FB93B8219A29A7205,10251,3,9,6,35,47,1797
57852,57852,D8B46FFCD15B641FB93B8219A29A7205,42161,10,12,2,36,47,1847
57853,57853,D8B46FFCD15B641FB93B8219A29A7205,10251,14,21,7,35,47,1797
57872,57872,10998AC050402D0103054DA8672DA230,19441,0,4,4,8,46,446
57873,57873,10998AC050402D0103054DA8672DA230,42041,8,9,1,10,47,547
57874,57874,10998AC050402D0103054DA8672DA230,19441,11,19,8,8,46,446
57904,57904,99E96056F1348BE5EE68CAB62754CE87,10951,1,10,9,29,48,1498
57905,57905,99E96056F1348BE5EE68CAB62754CE87,11381,10,11,1,30,47,1547
57906,57906,99E96056F1348BE5EE68CAB62754CE87,10951,11,23,12,29,48,1498
57907,57907,E599FEB56FA765D8959145E7D77CF1E9,11521,0,8,8,41,48,2098
57908,57908,E599FEB56FA765D8959145E7D77CF1E9,11301,12,14,2,41,49,2099
57909,57909,E599FEB56FA765D8959145E7D77CF1E9,11701,15,17,2,43,48,2198
57910,57910,E599FEB56FA765D8959145E7D77CF1E9,11521,21,22,1,41,48,2098
57939,57939,0ACD42FBA28A767F44D73783967C8C23,10731,1,6,5,33,47,1697
57940,57940,0ACD42FBA28A767F44D73783967C8C23,10721,15,18,3,31,48,1598
57941,57941,0ACD42FBA28A767F44D73783967C8C23,10731,19,23,4,33,47,1697
57945,57945,AC604569EDEC121EE97D76ACCBB6C578,12521,0,7,7,35,41,1791
57946,57946,AC604569EDEC121EE97D76ACCBB6C578,42151,9,11,2,35,45,1795
57947,57947,AC604569EDEC121EE97D76ACCBB6C578,12521,12,22,10,35,41,1791
57959,57959,A1B1493AD1E4959D25E397CB780FB65E,42531,0,6,6,31,45,1595
57960,57960,A1B1493AD1E4959D25E397CB780FB65E,12311,7,9,2,30,44,1544
57961,57961,A1B1493AD1E4959D25E397CB780FB65E,42531,12,22,10,31,45,1595
57962,57962,5DC656AE1F755A21D4CE0049D29039D4,12491,0,7,7,36,43,1843
57963,57963,5DC656AE1F755A21D4CE0049D29039D4,11261,7,8,1,36,46,1846
57964,57964,5DC656AE1F755A21D4CE0049D29039D4,12491,12,23,11,36,43,1843
57965,57965,3F7BFF26419AB43EAAC9D4DF4B7C2705,42301,0,6,6,36,47,1847
57966,57966,3F7BFF26419AB43EAAC9D4DF4B7C2705,42151,9,18,9,35,45,1795
57967,57967,3F7BFF26419AB43EAAC9D4DF4B7C2705,42301,19,23,4,36,47,1847
57971,57971,4389F41A4587F9CF67E8237A86148DBC,10681,0,8,8,30,48,1548
57972,57972,4389F41A4587F9CF67E8237A86148DBC,10381,12,13,1,31,49,1599
57973,57973,4389F41A4587F9CF67E8237A86148DBC,10681,16,23,7,30,48,1548
57974,57974,3F0EDFFC6E18B4A03094543F5DAD11AE,43761,0,6,6,32,47,1647
57975,57975,3F0EDFFC6E18B4A03094543F5DAD11AE,42521,6,7,1,31,47,1597
57976,57976,3F0EDFFC6E18B4A03094543F5DAD11AE,43761,10,23,13,32,47,1647
57977,57977,449E7811DCD6E8CD500501049B5A906E,11261,0,2,2,36,46,1846
57978,57978,449E7811DCD6E8CD500501049B5A906E,13231,2,10,8,39,46,1996
57979,57979,449E7811DCD6E8CD500501049B5A906E,11261,10,12,2,36,46,1846
57980,57980,449E7811DCD6E8CD500501049B5A906E,13231,17,21,4,39,46,1996
57992,57992,81A27C2C0B80C882802D3EA956DF54A0,10731,0,7,7,33,47,1697
57993,57993,81A27C2C0B80C882802D3EA956DF54A0,10161,11,13,2,35,49,1799
57994,57994,81A27C2C0B80C882802D3EA956DF54A0,10731,15,22,7,33,47,1697
58005,58005,628C7824651436AFEE1874B5B2874BA1,10351,0,13,13,28,45,1445
58006,58006,628C7824651436AFEE1874B5B2874BA1,10634,15,17,2,27,45,1395
58007,58007,628C7824651436AFEE1874B5B2874BA1,10351,21,23,2,28,45,1445
58008,58008,E98F4CD93DDE6F42B6667EDEBD3A34DB,10841,2,11,9,37,47,1897
58009,58009,E98F4CD93DDE6F42B6667EDEBD3A34DB,43361,13,14,1,38,48,1948
58010,58010,E98F4CD93DDE6F42B6667EDEBD3A34DB,40951,15,18,3,36,49,1849
58011,58011,E98F4CD93DDE6F42B6667EDEBD3A34DB,10841,21,22,1,37,47,1897
58012,58012,08DE1E1705AB0D9289DFA85E914CA601,42151,0,16,16,35,45,1795
58013,58013,08DE1E1705AB0D9289DFA85E914CA601,42861,19,20,1,37,44,1894
58014,58014,08DE1E1705AB0D9289DFA85E914CA601,41702,21,23,2,36,46,1846
58023,58023,68D66AC2F31097852E1113FCAC38B096,12311,0,4,4,30,44,1544
58024,58024,68D66AC2F31097852E1113FCAC38B096,12121,5,6,1,29,47,1497
58025,58025,68D66AC2F31097852E1113FCAC38B096,42531,7,23,16,31,45,1595
58039,58039,780CF605B987CE4335E0B64DFA86ACBF,12514,1,6,5,38,47,1947
58040,58040,780CF605B987CE4335E0B64DFA86ACBF,11921,7,18,11,38,48,1948
58041,58041,780CF605B987CE4335E0B64DFA86ACBF,12514,19,21,2,38,47,1947
58045,58045,14221EE63F6EE55805EE5B3069F379DA,11914,1,4,3,37,48,1898
58046,58046,14221EE63F6EE55805EE5B3069F379DA,42581,6,15,9,38,48,1948
58047,58047,14221EE63F6EE55805EE5B3069F379DA,11914,18,20,2,37,48,1898
58048,58048,CF7DA1891D00F069E0E0214450037183,11381,0,7,7,30,47,1547
58049,58049,CF7DA1891D00F069E0E0214450037183,11061,9,11,2,29,48,1498
58050,58050,CF7DA1891D00F069E0E0214450037183,11381,11,13,2,30,47,1547
58051,58051,CF7DA1891D00F069E0E0214450037183,11061,16,22,6,29,48,1498
58073,58073,D6B662C0D72BBB94314A69A6BE13D66E,43761,0,10,10,32,47,1647
58074,58074,D6B662C0D72BBB94314A69A6BE13D66E,10711,13,15,2,29,46,1496
58075,58075,D6B662C0D72BBB94314A69A6BE13D66E,42501,15,16,1,28,47,1447
58076,58076,D6B662C0D72BBB94314A69A6BE13D66E,43761,19,22,3,32,47,1647
58092,58092,03C19F5F9D7D397AE6E9F2FD16BA994D,10251,0,9,9,35,47,1797
58093,58093,03C19F5F9D7D397AE6E9F2FD16BA994D,42401,11,12,1,36,47,1847
58094,58094,03C19F5F9D7D397AE6E9F2FD16BA994D,10111,17,18,1,37,47,1897
58102,58102,7875A34DC3B1C1A6D18480769685A825,13911,5,7,2,39,46,1996
58103,58103,7875A34DC3B1C1A6D18480769685A825,42231,9,19,10,37,46,1896
58104,58104,7875A34DC3B1C1A6D18480769685A825,42351,19,21,2,38,45,1945
58105,58105,7875A34DC3B1C1A6D18480769685A825,42231,22,23,1,37,46,1896
58114,58114,775CA947FF37432092AA3395F5AA137B,11171,0,7,7,33,48,1698
58115,58115,775CA947FF37432092AA3395F5AA137B,10971,10,18,8,35,47,1797
58116,58116,775CA947FF37432092AA3395F5AA137B,42161,20,23,3,36,47,1847
58117,58117,FCA3C665B5BF337F331669EDB597A6AC,42791,0,7,7,35,45,1795
58118,58118,FCA3C665B5BF337F331669EDB597A6AC,10271,8,17,9,37,46,1896
58119,58119,FCA3C665B5BF337F331669EDB597A6AC,13711,19,20,1,38,46,1946
58120,58120,71FDEFC3187A3CF24BA939D7B11B9629,11231,1,4,3,37,49,1899
58121,58121,71FDEFC3187A3CF24BA939D7B11B9629,42961,5,7,2,35,49,1799
58122,58122,71FDEFC3187A3CF24BA939D7B11B9629,10121,7,17,10,36,49,1849
58123,58123,71FDEFC3187A3CF24BA939D7B11B9629,10107,20,22,2,38,49,1949
58128,58128,170A0AC014DC9BA930EAA0E56A2C9D03,42321,0,6,6,43,47,2197
58129,58129,170A0AC014DC9BA930EAA0E56A2C9D03,11701,9,16,7,43,48,2198
58130,58130,170A0AC014DC9BA930EAA0E56A2C9D03,42321,20,22,2,43,47,2197
58134,58134,0612D01FED57D65359F997ADFD687D16,11381,1,2,1,30,47,1547
58135,58135,0612D01FED57D65359F997ADFD687D16,11061,2,5,3,29,48,1498
58136,58136,0612D01FED57D65359F997ADFD687D16,11381,7,18,11,30,47,1547
58137,58137,8FFDEB2573593D2EBFD07303D94AB87F,42321,0,15,15,43,47,2197
58138,58138,8FFDEB2573593D2EBFD07303D94AB87F,10801,15,17,2,42,47,2147
58139,58139,8FFDEB2573593D2EBFD07303D94AB87F,42321,17,23,6,43,47,2197
58149,58149,A7CD79686A076BFDAD2F291D2D57B5D6,10251,0,14,14,35,47,1797
58150,58150,A7CD79686A076BFDAD2F291D2D57B5D6,40673,14,15,1,36,48,1848
58151,58151,A7CD79686A076BFDAD2F291D2D57B5D6,10251,16,18,2,35,47,1797
58152,58152,A7CD79686A076BFDAD2F291D2D57B5D6,40673,20,22,2,36,48,1848
58153,58153,9ECA5557B94DDF8D494B58216329A377,42864,3,7,4,38,44,1944
58154,58154,9ECA5557B94DDF8D494B58216329A377,42861,7,9,2,37,44,1894
58155,58155,9ECA5557B94DDF8D494B58216329A377,42864,12,13,1,38,44,1944
58156,58156,9ECA5557B94DDF8D494B58216329A377,11261,17,23,6,36,46,1846
58157,58157,394FCA5F3AB676CBAB996A49070239BB,10107,2,7,5,38,49,1949
58158,58158,394FCA5F3AB676CBAB996A49070239BB,11231,11,19,8,37,49,1899
58159,58159,394FCA5F3AB676CBAB996A49070239BB,11794,20,22,2,38,49,1949
58164,58164,A7E367ED35CC8BB7AC221D01E7EE426D,43761,8,10,2,32,47,1647
58165,58165,A7E367ED35CC8BB7AC221D01E7EE426D,42521,11,13,2,31,47,1597
58166,58166,A7E367ED35CC8BB7AC221D01E7EE426D,11061,18,20,2,29,48,1498
58182,58182,8D2C2C42E63FD22BFD992889F79D269F,42523,0,5,5,31,47,1597
58183,58183,8D2C2C42E63FD22BFD992889F79D269F,43761,6,7,1,32,47,1647
58184,58184,8D2C2C42E63FD22BFD992889F79D269F,42291,8,21,13,29,48,1498
58194,58194,0AABE259CFB09D826E16E766093E8B6B,12131,0,6,6,32,47,1647
58195,58195,0AABE259CFB09D826E16E766093E8B6B,11875,7,8,1,30,46,1546
58196,58196,0AABE259CFB09D826E16E766093E8B6B,42523,11,17,6,31,47,1597
58197,58197,0AABE259CFB09D826E16E766093E8B6B,42491,17,19,2,32,46,1646
58203,58203,19783D60B70DD47851602F72E0868D88,11161,0,7,7,32,48,1648
58204,58204,19783D60B70DD47851602F72E0868D88,43581,8,11,3,33,48,1698
58205,58205,19783D60B70DD47851602F72E0868D88,43311,13,14,1,31,48,1598
58206,58206,19783D60B70DD47851602F72E0868D88,10281,18,23,5,33,48,1698
58220,58220,B0FDD17514A100E8977FA6C901864726,10281,0,8,8,33,48,1698
58221,58221,B0FDD17514A100E8977FA6C901864726,11861,10,14,4,32,47,1647
58222,58222,B0FDD17514A100E8977FA6C901864726,10281,14,20,6,33,48,1698
58223,58223,B0FDD17514A100E8977FA6C901864726,11861,20,23,3,32,47,1647
58242,58242,0CE1530259EA66797A9FEEF237D2664E,42861,0,5,5,37,44,1894
58243,58243,0CE1530259EA66797A9FEEF237D2664E,11261,6,8,2,36,46,1846
58244,58244,0CE1530259EA66797A9FEEF237D2664E,42861,11,23,12,37,44,1894
58245,58245,FE586DE9D28C16CA7814DB5DDA7048BE,12514,0,7,7,38,47,1947
58246,58246,FE586DE9D28C16CA7814DB5DDA7048BE,11921,12,14,2,38,48,1948
58247,58247,FE586DE9D28C16CA7814DB5DDA7048BE,12514,16,23,7,38,47,1947
58248,58248,C8EB41C6B7152CD714709DA811B3B245,10681,0,8,8,30,48,1548
58249,58249,C8EB41C6B7152CD714709DA811B3B245,11061,8,22,14,29,48,1498
58250,58250,C8EB41C6B7152CD714709DA811B3B245,10681,22,23,1,30,48,1548
58270,58270,EB7EB6074C1F2A07A41462E31EDA6629,42161,0,17,17,36,47,1847
58271,58271,EB7EB6074C1F2A07A41462E31EDA6629,11074,18,19,1,37,47,1897
58272,58272,EB7EB6074C1F2A07A41462E31EDA6629,42161,21,23,2,36,47,1847
58276,58276,49D4646AC2EAF74F42480DC74962A9FC,11941,1,8,7,37,46,1896
58277,58277,49D4646AC2EAF74F42480DC74962A9FC,13711,13,18,5,38,46,1946
58278,58278,49D4646AC2EAF74F42480DC74962A9FC,42231,19,20,1,37,46,1896
58279,58279,49D4646AC2EAF74F42480DC74962A9FC,13711,20,21,1,38,46,1946
58280,58280,96056246DD9856C2DDE7E703B0D16D68,11381,1,17,16,30,47,1547
58281,58281,96056246DD9856C2DDE7E703B0D16D68,42521,18,20,2,31,47,1597
58282,58282,96056246DD9856C2DDE7E703B0D16D68,11381,22,23,1,30,47,1547
58283,58283,B324CCFCD3F5330D2BA1EBE28CA2A657,13101,0,12,12,40,47,2047
58284,58284,B324CCFCD3F5330D2BA1EBE28CA2A657,13271,17,18,1,41,47,2097
58285,58285,B324CCFCD3F5330D2BA1EBE28CA2A657,13101,18,19,1,40,47,2047
58286,58286,055660D96102C90837257CF6FD6D548A,13911,0,7,7,39,46,1996
58287,58287,055660D96102C90837257CF6FD6D548A,11261,7,8,1,36,46,1846
58288,58288,055660D96102C90837257CF6FD6D548A,13911,12,14,2,39,46,1996
58289,58289,055660D96102C90837257CF6FD6D548A,11261,19,23,4,36,46,1846
58299,58299,C3ADC71F131BD0DCCB0467D7B3F33BAB,12641,1,11,10,10,43,543
58300,58300,C3ADC71F131BD0DCCB0467D7B3F33BAB,19901,13,20,7,7,44,394
58301,58301,C3ADC71F131BD0DCCB0467D7B3F33BAB,12641,22,23,1,10,43,543
58309,58309,70F4E7C7C32C909D21E260DE46FC3C7A,13411,3,17,14,49,42,2492
58310,58310,70F4E7C7C32C909D21E260DE46FC3C7A,43951,18,19,1,49,41,2491
58311,58311,70F4E7C7C32C909D21E260DE46FC3C7A,13411,21,22,1,49,42,2492
58315,58315,0402782E5F21E7429EB7E07EFCF9314E,10301,0,5,5,31,45,1595
58316,58316,0402782E5F21E7429EB7E07EFCF9314E,10716,6,7,1,30,46,1546
58317,58317,0402782E5F21E7429EB7E07EFCF9314E,11324,11,12,1,31,46,1596
58318,58318,0402782E5F21E7429EB7E07EFCF9314E,11875,16,20,4,30,46,1546
58322,58322,3050FFDE3300B6C31B4D24CD09BF5468,10341,0,8,8,31,47,1597
58323,58323,3050FFDE3300B6C31B4D24CD09BF5468,43761,8,18,10,32,47,1647
58324,58324,3050FFDE3300B6C31B4D24CD09BF5468,11321,20,21,1,31,46,1596
58325,58325,234F087DE1CFEB89C762E905CED80FCE,11074,7,9,2,37,47,1897
58326,58326,234F087DE1CFEB89C762E905CED80FCE,11914,12,13,1,37,48,1898
58327,58327,234F087DE1CFEB89C762E905CED80FCE,12514,14,18,4,38,47,1947
58328,58328,234F087DE1CFEB89C762E905CED80FCE,43361,20,23,3,38,48,1948
58329,58329,BD517E29BD7069EA61B2CA0844AA760E,10731,0,6,6,33,47,1697
58330,58330,BD517E29BD7069EA61B2CA0844AA760E,43761,7,18,11,32,47,1647
58331,58331,BD517E29BD7069EA61B2CA0844AA760E,10731,22,23,1,33,47,1697
58342,58342,C8AE21C26108F7AFBD515ED916A6E09A,12514,0,5,5,38,47,1947
58343,58343,C8AE21C26108F7AFBD515ED916A6E09A,42511,10,14,4,37,47,1897
58344,58344,C8AE21C26108F7AFBD515ED916A6E09A,12514,15,16,1,38,47,1947
58345,58345,C8AE21C26108F7AFBD515ED916A6E09A,10841,17,19,2,37,47,1897
58360,58360,D454F61AD8B5A1CBE1E15CE597E2F528,11491,0,8,8,36,47,1847
58361,58361,D454F61AD8B5A1CBE1E15CE597E2F528,11231,9,20,11,37,49,1899
58362,58362,D454F61AD8B5A1CBE1E15CE597E2F528,42511,20,22,2,37,47,1897
58370,58370,C883A43E18D7FEFF323D291100B41B58,11151,4,7,3,30,48,1548
58371,58371,C883A43E18D7FEFF323D291100B41B58,43391,7,13,6,29,48,1498
58372,58372,C883A43E18D7FEFF323D291100B41B58,10431,13,22,9,33,49,1699
58373,58373,05B51695B375DD3A2259BF2668AD8716,42161,0,7,7,36,47,1847
58374,58374,05B51695B375DD3A2259BF2668AD8716,11331,8,9,1,37,48,1898
58375,58375,05B51695B375DD3A2259BF2668AD8716,42161,11,20,9,36,47,1847
58376,58376,05B51695B375DD3A2259BF2668AD8716,42021,21,23,2,33,47,1697
58380,58380,16B2F0D78BEB849442A93B3F29FB7F4E,11806,0,1,1,41,48,2098
58381,58381,16B2F0D78BEB849442A93B3F29FB7F4E,42271,3,13,10,40,47,2047
58382,58382,16B2F0D78BEB849442A93B3F29FB7F4E,11806,13,22,9,41,48,2098
58383,58383,16B2F0D78BEB849442A93B3F29FB7F4E,13101,22,23,1,40,47,2047
58388,58388,1F49E26C341B3738FA1E54F232E557D3,12514,0,15,15,38,47,1947
58389,58389,1F49E26C341B3738FA1E54F232E557D3,11751,15,18,3,35,48,1798
58390,58390,1F49E26C341B3738FA1E54F232E557D3,10411,19,22,3,36,48,1848
58391,58391,569FE1B0CCF701005479FDA64CAA96A2,11074,0,8,8,37,47,1897
58392,58392,569FE1B0CCF701005479FDA64CAA96A2,11231,8,20,12,37,49,1899
58393,58393,569FE1B0CCF701005479FDA64CAA96A2,11074,20,23,3,37,47,1897
58397,58397,E7DE2A2A02890D34B473EFF69866136B,10681,0,10,10,30,48,1548
58398,58398,E7DE2A2A02890D34B473EFF69866136B,11061,12,16,4,29,48,1498
58399,58399,E7DE2A2A02890D34B473EFF69866136B,10681,20,23,3,30,48,1548
58415,58415,79F70A1AE08CEE215DA71360DE1B25EA,42191,0,6,6,38,49,1949
58416,58416,79F70A1AE08CEE215DA71360DE1B25EA,42231,7,18,11,37,46,1896
58417,58417,79F70A1AE08CEE215DA71360DE1B25EA,42191,19,21,2,38,49,1949
58423,58423,F41A8974955ECE62F73018566CCACF3F,10221,0,6,6,34,49,1749
58424,58424,F41A8974955ECE62F73018566CCACF3F,42471,9,12,3,35,49,1799
58425,58425,F41A8974955ECE62F73018566CCACF3F,11591,12,20,8,36,49,1849
58426,58426,9637A49CA49F0EFD37F0D0143383C518,42231,2,3,1,37,46,1896
58427,58427,9637A49CA49F0EFD37F0D0143383C518,13911,6,11,5,39,46,1996
58428,58428,9637A49CA49F0EFD37F0D0143383C518,42231,11,16,5,37,46,1896
58429,58429,9637A49CA49F0EFD37F0D0143383C518,13911,21,23,2,39,46,1996
58433,58433,53DE27C3988F5D22526FCC360F8F3A99,11321,0,6,6,31,46,1596
58434,58434,53DE27C3988F5D22526FCC360F8F3A99,10716,8,10,2,30,46,1546
58435,58435,53DE27C3988F5D22526FCC360F8F3A99,42523,13,23,10,31,47,1597
58440,58440,4A8B6D4A591CC4F1D4132A3A7DF0E4D7,42141,2,4,2,32,47,1647
58441,58441,4A8B6D4A591CC4F1D4132A3A7DF0E4D7,42523,8,9,1,31,47,1597
58442,58442,4A8B6D4A591CC4F1D4132A3A7DF0E4D7,43761,9,19,10,32,47,1647
58443,58443,B4C272D6464FA4793C609AB4E158FDF8,12661,1,7,6,32,45,1645
58444,58444,B4C272D6464FA4793C609AB4E158FDF8,42531,11,12,1,31,45,1595
58445,58445,B4C272D6464FA4793C609AB4E158FDF8,12661,12,13,1,32,45,1645
58446,58446,B4C272D6464FA4793C609AB4E158FDF8,10351,13,21,8,28,45,1445
58452,58452,1DD07CF7FD5B3CCCB4E85025836774E4,11331,1,7,6,37,48,1898
58453,58453,1DD07CF7FD5B3CCCB4E85025836774E4,11231,7,18,11,37,49,1899
58454,58454,1DD07CF7FD5B3CCCB4E85025836774E4,12841,19,23,4,37,47,1897
58455,58455,05286C4B5017A260B39768783F7D4555,42581,0,5,5,38,48,1948
58456,58456,05286C4B5017A260B39768783F7D4555,10471,7,18,11,37,48,1898
58457,58457,05286C4B5017A260B39768783F7D4555,42581,18,22,4,38,48,1948
58464,58464,8A2B6A3BBB67F4CA1B157F83176E3E9B,11151,0,1,1,30,48,1548
58465,58465,8A2B6A3BBB67F4CA1B157F83176E3E9B,10381,3,7,4,31,49,1599
58466,58466,8A2B6A3BBB67F4CA1B157F83176E3E9B,11151,9,23,14,30,48,1548
58483,58483,E02F57B26F613B95B8A8C38410D07E2A,42681,3,14,11,24,48,1248
58484,58484,E02F57B26F613B95B8A8C38410D07E2A,11361,14,16,2,22,48,1148
58485,58485,E02F57B26F613B95B8A8C38410D07E2A,10451,16,18,2,25,48,1298
58486,58486,E02F57B26F613B95B8A8C38410D07E2A,11361,21,22,1,22,48,1148
58487,58487,EE8535EFC0E3237FE1E9870ACB3D38E1,42461,1,5,4,45,47,2297
58488,58488,EE8535EFC0E3237FE1E9870ACB3D38E1,43621,5,8,3,46,48,2348
58489,58489,EE8535EFC0E3237FE1E9870ACB3D38E1,42321,8,18,10,43,47,2197
58490,58490,EE8535EFC0E3237FE1E9870ACB3D38E1,43621,19,22,3,46,48,2348
58491,58491,4A7EF801268FA87DD49AA705DCA560E1,42581,0,7,7,38,48,1948
58492,58492,4A7EF801268FA87DD49AA705DCA560E1,11914,8,12,4,37,48,1898
58493,58493,4A7EF801268FA87DD49AA705DCA560E1,42581,14,20,6,38,48,1948
58494,58494,58FF60972C1637520443DC5766A2AB67,13411,0,6,6,49,42,2492
58495,58495,58FF60972C1637520443DC5766A2AB67,43951,6,18,12,49,41,2491
58496,58496,58FF60972C1637520443DC5766A2AB67,13411,21,23,2,49,42,2492
58502,58502,2FD2CBA4B8A939218EA3C9AF889991B3,11914,0,13,13,37,48,1898
58503,58503,2FD2CBA4B8A939218EA3C9AF889991B3,43361,14,15,1,38,48,1948
58504,58504,2FD2CBA4B8A939218EA3C9AF889991B3,11914,16,19,3,37,48,1898
58505,58505,2FD2CBA4B8A939218EA3C9AF889991B3,42581,20,21,1,38,48,1948
58513,58513,8D4B76C00151174BC318A19D72794912,12661,1,12,11,32,45,1645
58514,58514,8D4B76C00151174BC318A19D72794912,12311,13,14,1,30,44,1544
58515,58515,8D4B76C00151174BC318A19D72794912,12661,18,23,5,32,45,1645
58538,58538,D21AD56E1413F233CB19B53125C6F06A,42221,2,16,14,38,48,1948
58539,58539,D21AD56E1413F233CB19B53125C6F06A,40491,19,20,1,39,49,1999
58540,58540,D21AD56E1413F233CB19B53125C6F06A,10931,21,22,1,41,48,2098
58541,58541,D46D481AE4A1808392E89F68BF1C527D,11061,0,15,15,29,48,1498
58542,58542,D46D481AE4A1808392E89F68BF1C527D,11381,15,17,2,30,47,1547
58543,58543,D46D481AE4A1808392E89F68BF1C527D,11061,17,23,6,29,48,1498
58544,58544,A0C13743AF441FE8099AA940DA71C612,42581,0,14,14,38,48,1948
58545,58545,A0C13743AF441FE8099AA940DA71C612,11914,14,15,1,37,48,1898
58546,58546,A0C13743AF441FE8099AA940DA71C612,42581,16,23,7,38,48,1948
58555,58555,B51D9FF5C85A339CA5BC5AEEEDDD9188,19114,2,11,9,7,43,393
58556,58556,B51D9FF5C85A339CA5BC5AEEEDDD9188,19901,13,14,1,7,44,394
58557,58557,B51D9FF5C85A339CA5BC5AEEEDDD9188,12641,15,19,4,10,43,543
58566,58566,1317C72E5A9622054904D4946F5A3E59,42501,0,1,1,28,47,1447
58567,58567,1317C72E5A9622054904D4946F5A3E59,13651,5,6,1,30,47,1547
58568,58568,1317C72E5A9622054904D4946F5A3E59,42501,7,18,11,28,47,1447
58569,58569,1317C72E5A9622054904D4946F5A3E59,13651,19,20,1,30,47,1547
58574,58574,94A66B099C3B286235DEE73BAE7FEB6C,11861,0,20,20,32,47,1647
58575,58575,94A66B099C3B286235DEE73BAE7FEB6C,10281,20,22,2,33,48,1698
58576,58576,94A66B099C3B286235DEE73BAE7FEB6C,11861,22,23,1,32,47,1647
58577,58577,BC76CCD190FA1A5238AAD9129E2B96C9,40463,0,7,7,38,49,1949
58578,58578,BC76CCD190FA1A5238AAD9129E2B96C9,11231,9,11,2,37,49,1899
58579,58579,BC76CCD190FA1A5238AAD9129E2B96C9,40463,13,14,1,38,49,1949
58580,58580,BC76CCD190FA1A5238AAD9129E2B96C9,10471,14,19,5,37,48,1898
58594,58594,CF6A7AF612D2CFA2B8383868CF93735B,42921,0,12,12,33,47,1697
58595,58595,CF6A7AF612D2CFA2B8383868CF93735B,42523,13,20,7,31,47,1597
58596,58596,CF6A7AF612D2CFA2B8383868CF93735B,42921,20,23,3,33,47,1697
58615,58615,D4191700C633456D6E890AE49001CB88,10951,0,14,14,29,48,1498
58616,58616,D4191700C633456D6E890AE49001CB88,11381,14,20,6,30,47,1547
58617,58617,D4191700C633456D6E890AE49001CB88,42501,21,22,1,28,47,1447
58627,58627,B0CA59461CE535DA6C80DC6682EBEAFB,42271,0,6,6,40,47,2047
58628,58628,B0CA59461CE535DA6C80DC6682EBEAFB,40302,8,14,6,40,49,2049
58629,58629,B0CA59461CE535DA6C80DC6682EBEAFB,42271,15,18,3,40,47,2047
58630,58630,49C79AB3305EA0BDD0BE79CDFA7582CD,11074,0,7,7,37,47,1897
58631,58631,49C79AB3305EA0BDD0BE79CDFA7582CD,42221,12,17,5,38,48,1948
58632,58632,49C79AB3305EA0BDD0BE79CDFA7582CD,11074,18,20,2,37,47,1897
58633,58633,BDE131E3985277A452A63ED13E5958AD,11381,0,6,6,30,47,1547
58634,58634,BDE131E3985277A452A63ED13E5958AD,43761,9,11,2,32,47,1647
58635,58635,BDE131E3985277A452A63ED13E5958AD,43971,12,16,4,30,48,1548
58636,58636,BDE131E3985277A452A63ED13E5958AD,11381,21,23,2,30,47,1547
58645,58645,63A1194DA67A916294F825B4249AD293,42161,0,8,8,36,47,1847
58646,58646,63A1194DA67A916294F825B4249AD293,11261,9,17,8,36,46,1846
58647,58647,63A1194DA67A916294F825B4249AD293,40891,22,23,1,37,47,1897
58648,58648,4B18376F646A8C5898CD3325A7616D50,43761,10,11,1,32,47,1647
58649,58649,4B18376F646A8C5898CD3325A7616D50,43971,12,18,6,30,48,1548
58650,58650,4B18376F646A8C5898CD3325A7616D50,11161,20,21,1,32,48,1648
58655,58655,5E2A058AE896AE135BA0B62389F16C16,10292,0,8,8,30,47,1547
58656,58656,5E2A058AE896AE135BA0B62389F16C16,43581,8,17,9,33,48,1698
58657,58657,5E2A058AE896AE135BA0B62389F16C16,42523,19,20,1,31,47,1597
58674,58674,22D95CF8B35CF82DEFAFF52E8ADB9EF4,42523,4,10,6,31,47,1597
58675,58675,22D95CF8B35CF82DEFAFF52E8ADB9EF4,42371,12,14,2,34,46,1746
58676,58676,22D95CF8B35CF82DEFAFF52E8ADB9EF4,42523,17,23,6,31,47,1597
58686,58686,FC707C73D6614611D82A13C2F325D332,42511,1,12,11,37,47,1897
58687,58687,FC707C73D6614611D82A13C2F325D332,11021,12,20,8,36,49,1849
58688,58688,FC707C73D6614611D82A13C2F325D332,11074,21,23,2,37,47,1897
58705,58705,DD4D28FDBCFFE930AF28BD3956ED9308,11381,0,17,17,30,47,1547
58706,58706,DD4D28FDBCFFE930AF28BD3956ED9308,11831,17,20,3,32,45,1645
58707,58707,DD4D28FDBCFFE930AF28BD3956ED9308,11381,21,23,2,30,47,1547
58721,58721,3DBAFDEA494877045EB98704E3E793DC,42351,0,7,7,38,45,1945
58722,58722,3DBAFDEA494877045EB98704E3E793DC,13911,11,14,3,39,46,1996
58723,58723,3DBAFDEA494877045EB98704E3E793DC,42231,19,21,2,37,46,1896
58724,58724,3DBAFDEA494877045EB98704E3E793DC,42351,21,23,2,38,45,1945
58737,58737,B407E10E40F14F417BB48241B7C62C97,13271,1,7,6,41,47,2097
58738,58738,B407E10E40F14F417BB48241B7C62C97,42583,11,13,2,40,48,2048
58739,58739,B407E10E40F14F417BB48241B7C62C97,40833,13,23,10,41,47,2097
58740,58740,0AD8838435D12A1009D3BADE4EAE690D,11381,0,8,8,30,47,1547
58741,58741,0AD8838435D12A1009D3BADE4EAE690D,11061,9,10,1,29,48,1498
58742,58742,0AD8838435D12A1009D3BADE4EAE690D,11381,13,23,10,30,47,1547
58743,58743,BB44A13BCAB0B022B18D7F4EDDEC4037,11231,0,1,1,37,49,1899
58744,58744,BB44A13BCAB0B022B18D7F4EDDEC4037,40891,1,18,17,37,47,1897
58745,58745,BB44A13BCAB0B022B18D7F4EDDEC4037,11231,19,23,4,37,49,1899
58768,58768,0CEC3D7EB4E938500D3BE15F068C3654,13121,0,11,11,38,46,1946
58769,58769,0CEC3D7EB4E938500D3BE15F068C3654,42511,12,15,3,37,47,1897
58770,58770,0CEC3D7EB4E938500D3BE15F068C3654,13121,17,22,5,38,46,1946
58777,58777,D65506EDDA59637632B53755416666C4,11914,2,20,18,37,48,1898
58778,58778,D65506EDDA59637632B53755416666C4,43181,20,21,1,39,48,1998
58779,58779,D65506EDDA59637632B53755416666C4,11914,21,22,1,37,48,1898
58783,58783,B2FF699F2D213EDD8D43D893134155CA,10951,0,9,9,29,48,1498
58784,58784,B2FF699F2D213EDD8D43D893134155CA,11381,10,12,2,30,47,1547
58785,58785,B2FF699F2D213EDD8D43D893134155CA,10951,15,21,6,29,48,1498
58786,58786,F5CAB8F803ECE6BB91E5E9B3677179B2,42401,0,14,14,36,47,1847
58787,58787,F5CAB8F803ECE6BB91E5E9B3677179B2,42921,19,20,1,33,47,1697
58788,58788,F5CAB8F803ECE6BB91E5E9B3677179B2,10111,21,23,2,37,47,1897
58799,58799,6F947024A8B73B97F8430A4C48FA1DF6,12083,0,8,8,36,49,1849
58800,58800,6F947024A8B73B97F8430A4C48FA1DF6,10107,9,13,4,38,49,1949
58801,58801,6F947024A8B73B97F8430A4C48FA1DF6,13741,15,16,1,37,49,1899
58802,58802,6F947024A8B73B97F8430A4C48FA1DF6,12083,21,23,2,36,49,1849
58807,58807,1E78C6812CC13AC596F7D7BD80A5DD70,11921,0,14,14,38,48,1948
58808,58808,1E78C6812CC13AC596F7D7BD80A5DD70,11074,14,17,3,37,47,1897
58809,58809,1E78C6812CC13AC596F7D7BD80A5DD70,11921,19,22,3,38,48,1948
58810,58810,E880DD3703242558096D10770FE10A54,42861,0,9,9,37,44,1894
58811,58811,E880DD3703242558096D10770FE10A54,11261,9,11,2,36,46,1846
58812,58812,E880DD3703242558096D10770FE10A54,42861,12,13,1,37,44,1894
58813,58813,E880DD3703242558096D10770FE10A54,11261,14,21,7,36,46,1846
58814,58814,0EDDF579FF59C973D882291999726FD0,13711,0,7,7,38,46,1946
58815,58815,0EDDF579FF59C973D882291999726FD0,42231,9,15,6,37,46,1896
58816,58816,0EDDF579FF59C973D882291999726FD0,13711,15,16,1,38,46,1946
58817,58817,0EDDF579FF59C973D882291999726FD0,42231,17,19,2,37,46,1896
58855,58855,BCBB915A68F656D68AA2B85F9E93EB53,11381,0,17,17,30,47,1547
58856,58856,BCBB915A68F656D68AA2B85F9E93EB53,11831,17,20,3,32,45,1645
58857,58857,BCBB915A68F656D68AA2B85F9E93EB53,11381,21,23,2,30,47,1547
58869,58869,67BCB76F611F63115F44CBB7619B7D68,43161,0,14,14,35,47,1797
58870,58870,67BCB76F611F63115F44CBB7619B7D68,42161,14,17,3,36,47,1847
58871,58871,67BCB76F611F63115F44CBB7619B7D68,43161,18,21,3,35,47,1797
58872,58872,67BCB76F611F63115F44CBB7619B7D68,42161,21,23,2,36,47,1847
58873,58873,BBDB42DA75B81BF6CFFA8D7C2D8FC484,11151,9,11,2,30,48,1548
58874,58874,BBDB42DA75B81BF6CFFA8D7C2D8FC484,11061,11,13,2,29,48,1498
58875,58875,BBDB42DA75B81BF6CFFA8D7C2D8FC484,11151,13,23,10,30,48,1548
58893,58893,3717F18D88C40095DBADE8C95C390E6F,42151,0,6,6,35,45,1795
58894,58894,3717F18D88C40095DBADE8C95C390E6F,43241,9,11,2,36,46,1846
58895,58895,3717F18D88C40095DBADE8C95C390E6F,42151,11,23,12,35,45,1795
58896,58896,B09144E053E0EC9288D632948891CAF2,13911,0,13,13,39,46,1996
58897,58897,B09144E053E0EC9288D632948891CAF2,42231,17,18,1,37,46,1896
58898,58898,B09144E053E0EC9288D632948891CAF2,13911,20,23,3,39,46,1996
58899,58899,61AF80679359D43A0E6925D92F08EE37,19931,10,11,1,7,43,393
58900,58900,61AF80679359D43A0E6925D92F08EE37,19744,15,17,2,6,43,343
58901,58901,61AF80679359D43A0E6925D92F08EE37,12641,17,23,6,10,43,543
58902,58902,6E3A482A59CE9925DB19971C6ACB206A,11811,0,13,13,38,49,1949
58903,58903,6E3A482A59CE9925DB19971C6ACB206A,10471,14,17,3,37,48,1898
58904,58904,6E3A482A59CE9925DB19971C6ACB206A,40171,18,21,3,38,48,1948
58905,58905,4A86637B2A2C9B6CDD58B7B3EFF83DF6,11954,0,6,6,32,49,1649
58906,58906,4A86637B2A2C9B6CDD58B7B3EFF83DF6,42071,8,16,8,31,49,1599
58907,58907,4A86637B2A2C9B6CDD58B7B3EFF83DF6,13731,17,18,1,33,49,1699
58919,58919,05F5E1C40665B68C77ECAABF0F951B28,10661,7,12,5,37,49,1899
58920,58920,05F5E1C40665B68C77ECAABF0F951B28,11751,12,15,3,35,48,1798
58921,58921,05F5E1C40665B68C77ECAABF0F951B28,11021,15,18,3,36,49,1849
58922,58922,05F5E1C40665B68C77ECAABF0F951B28,10661,20,23,3,37,49,1899
58923,58923,081C42D8164EA39CD76978886CD1161E,13331,0,8,8,38,47,1947
58924,58924,081C42D8164EA39CD76978886CD1161E,41007,10,11,1,37,47,1897
58925,58925,081C42D8164EA39CD76978886CD1161E,13331,11,23,12,38,47,1947
58931,58931,1BA9D996B3A19A747EE7BB60C0D1E1A7,12521,0,2,2,35,41,1791
58932,58932,1BA9D996B3A19A747EE7BB60C0D1E1A7,12491,3,6,3,36,43,1843
58933,58933,1BA9D996B3A19A747EE7BB60C0D1E1A7,12521,6,22,16,35,41,1791
58934,58934,31735A9A4D90E658F574CF6241C79E67,10471,0,14,14,37,48,1898
58935,58935,31735A9A4D90E658F574CF6241C79E67,11231,17,19,2,37,49,1899
58936,58936,31735A9A4D90E658F574CF6241C79E67,10471,22,23,1,37,48,1898
58954,58954,831704567A0B8CDF382FA5741F6A7093,11321,0,6,6,31,46,1596
58955,58955,831704567A0B8CDF382FA5741F6A7093,10351,7,10,3,28,45,1445
58956,58956,831704567A0B8CDF382FA5741F6A7093,11321,11,23,12,31,46,1596
58957,58957,E64644A78E82A9C1BA0F120F693E3196,42523,2,8,6,31,47,1597
58958,58958,E64644A78E82A9C1BA0F120F693E3196,13651,9,16,7,30,47,1547
58959,58959,E64644A78E82A9C1BA0F120F693E3196,42523,21,23,2,31,47,1597
58960,58960,181802B57A29F4FAE1E7EF60B334A9D5,13911,0,13,13,39,46,1996
58961,58961,181802B57A29F4FAE1E7EF60B334A9D5,11261,14,18,4,36,46,1846
58962,58962,181802B57A29F4FAE1E7EF60B334A9D5,13911,19,22,3,39,46,1996
58970,58970,F292E588F5B97B789B94F3BB973BBEB5,43761,1,17,16,32,47,1647
58971,58971,F292E588F5B97B789B94F3BB973BBEB5,10381,18,21,3,31,49,1599
58972,58972,F292E588F5B97B789B94F3BB973BBEB5,11861,22,23,1,32,47,1647
58973,58973,D9026A3CE10A3841EFEE0C49DAE389C6,12641,5,6,1,10,43,543
58974,58974,D9026A3CE10A3841EFEE0C49DAE389C6,19114,6,19,13,7,43,393
58975,58975,D9026A3CE10A3841EFEE0C49DAE389C6,12641,19,23,4,10,43,543
58976,58976,692AC6DE13BF1FE0F43D1EA4E139D774,10841,10,11,1,37,47,1897
58977,58977,692AC6DE13BF1FE0F43D1EA4E139D774,13331,12,13,1,38,47,1947
58978,58978,692AC6DE13BF1FE0F43D1EA4E139D774,10841,13,19,6,37,47,1897
58979,58979,692AC6DE13BF1FE0F43D1EA4E139D774,13331,20,21,1,38,47,1947
58997,58997,19DD9EA3315ECB699A68A051C9281E6B,10471,0,9,9,37,48,1898
58998,58998,19DD9EA3315ECB699A68A051C9281E6B,13121,9,13,4,38,46,1946
58999,58999,19DD9EA3315ECB699A68A051C9281E6B,10471,13,19,6,37,48,1898
59010,59010,545B57FE377B53DF15322A3E629D81E6,12921,0,13,13,9,41,491
59011,59011,545B57FE377B53DF15322A3E629D81E6,49201,14,15,1,7,41,391
59012,59012,545B57FE377B53DF15322A3E629D81E6,12921,17,22,5,9,41,491
59013,59013,826B40817E61853148AFBFECB1C48C70,11261,3,4,1,36,46,1846
59014,59014,826B40817E61853148AFBFECB1C48C70,42864,4,8,4,38,44,1944
59015,59015,826B40817E61853148AFBFECB1C48C70,11261,8,23,15,36,46,1846
59016,59016,AC0F9A0DA655EB0858F47B6C2577B3DE,11281,2,5,3,27,40,1390
59017,59017,AC0F9A0DA655EB0858F47B6C2577B3DE,13671,6,15,9,27,43,1393
59018,59018,AC0F9A0DA655EB0858F47B6C2577B3DE,11281,15,19,4,27,40,1390
59019,59019,C7DA09D84BB6D5A3ABEAD976C8C0731E,42861,0,13,13,37,44,1894
59020,59020,C7DA09D84BB6D5A3ABEAD976C8C0731E,11261,14,15,1,36,46,1846
59021,59021,C7DA09D84BB6D5A3ABEAD976C8C0731E,42861,16,23,7,37,44,1894
59026,59026,92E340B82C56A45F91D53CD2B709557E,42581,0,13,13,38,48,1948
59027,59027,92E340B82C56A45F91D53CD2B709557E,11914,15,17,2,37,48,1898
59028,59028,92E340B82C56A45F91D53CD2B709557E,42581,18,19,1,38,48,1948
59042,59042,5E6AB6B686A00A7ED3B8EAE75C21937D,42864,0,15,15,38,44,1944
59043,59043,5E6AB6B686A00A7ED3B8EAE75C21937D,11261,17,19,2,36,46,1846
59044,59044,5E6AB6B686A00A7ED3B8EAE75C21937D,42864,19,23,4,38,44,1944
59045,59045,ADD1A2D095231ECD229025C5CC604B13,42041,3,6,3,10,47,547
59046,59046,ADD1A2D095231ECD229025C5CC604B13,19441,9,18,9,8,46,446
59047,59047,ADD1A2D095231ECD229025C5CC604B13,42041,19,20,1,10,47,547
59048,59048,ADD1A2D095231ECD229025C5CC604B13,19441,20,21,1,8,46,446
59049,59049,6B78BA76894FB2D58CB6C48FC3CBEEF5,13911,9,12,3,39,46,1996
59050,59050,6B78BA76894FB2D58CB6C48FC3CBEEF5,42231,14,15,1,37,46,1896
59051,59051,6B78BA76894FB2D58CB6C48FC3CBEEF5,13911,18,19,1,39,46,1996
59052,59052,C6869A64CA9EF97A25D7192A00726FC2,42401,0,9,9,36,47,1847
59053,59053,C6869A64CA9EF97A25D7192A00726FC2,10781,10,19,9,35,47,1797
59054,59054,C6869A64CA9EF97A25D7192A00726FC2,42401,19,22,3,36,47,1847
59064,59064,283D32F18C3BA6BD8207C085157E283B,12311,0,12,12,30,44,1544
59065,59065,283D32F18C3BA6BD8207C085157E283B,10301,15,18,3,31,45,1595
59066,59066,283D32F18C3BA6BD8207C085157E283B,12311,22,23,1,30,44,1544
59070,59070,8D6D823064688A853913E29A2D4620F5,13331,0,7,7,38,47,1947
59071,59071,8D6D823064688A853913E29A2D4620F5,13121,10,17,7,38,46,1946
59072,59072,8D6D823064688A853913E29A2D4620F5,13331,21,22,1,38,47,1947
59077,59077,0DD480B5A13E261C7A404CA1C7C938C6,13121,4,10,6,38,46,1946
59078,59078,0DD480B5A13E261C7A404CA1C7C938C6,42511,10,12,2,37,47,1897
59079,59079,0DD480B5A13E261C7A404CA1C7C938C6,13121,13,22,9,38,46,1946
59080,59080,D8963F7C81A647B0DB7A8BBF70036A0B,42221,0,1,1,38,48,1948
59081,59081,D8963F7C81A647B0DB7A8BBF70036A0B,12514,2,3,1,38,47,1947
59082,59082,D8963F7C81A647B0DB7A8BBF70036A0B,10471,8,17,9,37,48,1898
59083,59083,D8963F7C81A647B0DB7A8BBF70036A0B,12514,20,23,3,38,47,1947
59090,59090,DDF499CD7C74162B2433F078FFBB0DE3,11061,0,5,5,29,48,1498
59091,59091,DDF499CD7C74162B2433F078FFBB0DE3,10681,6,14,8,30,48,1548
59092,59092,DDF499CD7C74162B2433F078FFBB0DE3,11061,15,22,7,29,48,1498
59093,59093,50654F68D94497D10A1C2B9ADDEB1DF4,12381,0,9,9,32,48,1648
59094,59094,50654F68D94497D10A1C2B9ADDEB1DF4,10161,10,11,1,35,49,1799
59095,59095,50654F68D94497D10A1C2B9ADDEB1DF4,12381,13,14,1,32,48,1648
59096,59096,50654F68D94497D10A1C2B9ADDEB1DF4,42521,19,20,1,31,47,1597
59097,59097,55533B9612A041F560AB09E0A0C2A735,10251,0,17,17,35,47,1797
59098,59098,55533B9612A041F560AB09E0A0C2A735,10151,20,21,1,34,47,1747
59099,59099,55533B9612A041F560AB09E0A0C2A735,10251,22,23,1,35,47,1797
59108,59108,F725A3F859B25741A70E1B3AC0517A8A,10111,0,8,8,37,47,1897
59109,59109,F725A3F859B25741A70E1B3AC0517A8A,13561,9,10,1,37,49,1899
59110,59110,F725A3F859B25741A70E1B3AC0517A8A,10111,13,17,4,37,47,1897
59111,59111,F725A3F859B25741A70E1B3AC0517A8A,12021,21,22,1,37,49,1899
59112,59112,60F7F4881031002766F8A8E2FAB27EDD,10041,0,13,13,39,49,1999
59113,59113,60F7F4881031002766F8A8E2FAB27EDD,43321,15,16,1,36,49,1849
59114,59114,60F7F4881031002766F8A8E2FAB27EDD,10041,19,23,4,39,49,1999
59115,59115,B188EC429D298D2F5FA53D895871227C,11324,4,10,6,31,46,1596
59116,59116,B188EC429D298D2F5FA53D895871227C,10292,12,16,4,30,47,1547
59117,59117,B188EC429D298D2F5FA53D895871227C,11324,18,19,1,31,46,1596
59124,59124,1DABB12859D13B3092B5C002A09FA674,10811,0,14,14,38,46,1946
59125,59125,1DABB12859D13B3092B5C002A09FA674,10971,15,17,2,35,47,1797
59126,59126,1DABB12859D13B3092B5C002A09FA674,12511,19,21,2,39,47,1997
59127,59127,1DABB12859D13B3092B5C002A09FA674,10811,22,23,1,38,46,1946
59128,59128,65161D8F8A2EE0E4F87D9472311EE576,12514,1,4,3,38,47,1947
59129,59129,65161D8F8A2EE0E4F87D9472311EE576,10841,6,18,12,37,47,1897
59130,59130,65161D8F8A2EE0E4F87D9472311EE576,12514,18,21,3,38,47,1947
59144,59144,F714E7BCDABF2B2F99991B80BC6098B2,19904,0,4,4,9,44,494
59145,59145,F714E7BCDABF2B2F99991B80BC6098B2,12641,5,11,6,10,43,543
59146,59146,F714E7BCDABF2B2F99991B80BC6098B2,19904,13,14,1,9,44,494
59147,59147,F714E7BCDABF2B2F99991B80BC6098B2,12641,17,18,1,10,43,543
59155,59155,1B83FAC3F59813014CE45FBC6E21E9E8,11074,8,9,1,37,47,1897
59156,59156,1B83FAC3F59813014CE45FBC6E21E9E8,12514,11,13,2,38,47,1947
59157,59157,1B83FAC3F59813014CE45FBC6E21E9E8,10841,13,19,6,37,47,1897
59168,59168,441E401293D6FFC8E080552D376784E1,42581,3,13,10,38,48,1948
59169,59169,441E401293D6FFC8E080552D376784E1,11914,13,16,3,37,48,1898
59170,59170,441E401293D6FFC8E080552D376784E1,42581,19,23,4,38,48,1948
59174,59174,E6A8B36EA819F0A64C66840FF99B9AB3,42581,0,6,6,38,48,1948
59175,59175,E6A8B36EA819F0A64C66840FF99B9AB3,11914,6,11,5,37,48,1898
59176,59176,E6A8B36EA819F0A64C66840FF99B9AB3,42581,12,13,1,38,48,1948
59177,59177,E6A8B36EA819F0A64C66840FF99B9AB3,11914,17,18,1,37,48,1898
59178,59178,694B62B0D9A911C3789F47CFCFF37B49,10471,0,6,6,37,48,1898
59179,59179,694B62B0D9A911C3789F47CFCFF37B49,42231,7,17,10,37,46,1896
59180,59180,694B62B0D9A911C3789F47CFCFF37B49,42351,17,18,1,38,45,1945
59181,59181,694B62B0D9A911C3789F47CFCFF37B49,42191,19,23,4,38,49,1949
59182,59182,4FA50ACEDD30F1F921CEE6F85693AFFB,42161,0,7,7,36,47,1847
59183,59183,4FA50ACEDD30F1F921CEE6F85693AFFB,10251,11,15,4,35,47,1797
59184,59184,4FA50ACEDD30F1F921CEE6F85693AFFB,42161,18,23,5,36,47,1847
59185,59185,22FF92D5D02FB55EBF848B49B24CF4B1,42151,0,12,12,35,45,1795
59186,59186,22FF92D5D02FB55EBF848B49B24CF4B1,11261,14,15,1,36,46,1846
59187,59187,22FF92D5D02FB55EBF848B49B24CF4B1,42151,15,23,8,35,45,1795
59188,59188,B779BF34EE3D41A706B2440E17B6A093,10841,0,11,11,37,47,1897
59189,59189,B779BF34EE3D41A706B2440E17B6A093,12514,12,18,6,38,47,1947
59190,59190,B779BF34EE3D41A706B2440E17B6A093,11074,18,20,2,37,47,1897
59196,59196,711BE3DC1B779F061511011191B2AC90,11481,0,7,7,41,48,2098
59197,59197,711BE3DC1B779F061511011191B2AC90,13101,8,14,6,40,47,2047
59198,59198,711BE3DC1B779F061511011191B2AC90,40833,15,22,7,41,47,2097
59219,59219,7A3CCBEE1EF7E270B4B301C75856D62F,11861,0,10,10,32,47,1647
59220,59220,7A3CCBEE1EF7E270B4B301C75856D62F,10151,10,12,2,34,47,1747
59221,59221,7A3CCBEE1EF7E270B4B301C75856D62F,11861,13,23,10,32,47,1647
59228,59228,B7783E40C231BF2A915C5200F2E2562A,12031,0,12,12,33,48,1698
59229,59229,B7783E40C231BF2A915C5200F2E2562A,40951,13,16,3,36,49,1849
59230,59230,B7783E40C231BF2A915C5200F2E2562A,10161,17,18,1,35,49,1799
59236,59236,0BA677AEFA1FE879EC9FCA98466C3A1A,11641,0,6,6,22,49,1149
59237,59237,0BA677AEFA1FE879EC9FCA98466C3A1A,42681,8,9,1,24,48,1248
59238,59238,0BA677AEFA1FE879EC9FCA98466C3A1A,11641,14,23,9,22,49,1149
59249,59249,6BF6718FD73B783C78A5632B8793A6F0,42161,0,9,9,36,47,1847
59250,59250,6BF6718FD73B783C78A5632B8793A6F0,10107,12,17,5,38,49,1949
59251,59251,6BF6718FD73B783C78A5632B8793A6F0,10661,21,22,1,37,49,1899
59252,59252,1CD741282378ACECE229BFA3E57C9431,19441,1,14,13,8,46,446
59253,59253,1CD741282378ACECE229BFA3E57C9431,42041,14,16,2,10,47,547
59254,59254,1CD741282378ACECE229BFA3E57C9431,19441,19,20,1,8,46,446
59255,59255,1CD741282378ACECE229BFA3E57C9431,19114,22,23,1,7,43,393
59264,59264,88B9ED484BFC88A3E18D812526B753D0,10811,0,3,3,38,46,1946
59265,59265,88B9ED484BFC88A3E18D812526B753D0,13231,4,6,2,39,46,1996
59266,59266,88B9ED484BFC88A3E18D812526B753D0,42861,6,17,11,37,44,1894
59267,59267,88B9ED484BFC88A3E18D812526B753D0,11261,18,19,1,36,46,1846
59285,59285,27B6DDFE3A356062F221ABD7AD70BB14,11061,0,10,10,29,48,1498
59286,59286,27B6DDFE3A356062F221ABD7AD70BB14,10681,10,12,2,30,48,1548
59287,59287,27B6DDFE3A356062F221ABD7AD70BB14,11061,12,23,11,29,48,1498
59291,59291,E83888D24F9B489390D1BDDD69FB71BE,42861,0,3,3,37,44,1894
59292,59292,E83888D24F9B489390D1BDDD69FB71BE,42864,4,6,2,38,44,1944
59293,59293,E83888D24F9B489390D1BDDD69FB71BE,42861,7,18,11,37,44,1894
59305,59305,1E4ADDBFBD1C3EEA7DB4E1CBF005793C,40445,0,8,8,30,48,1548
59306,59306,1E4ADDBFBD1C3EEA7DB4E1CBF005793C,11111,10,17,7,26,48,1348
59307,59307,1E4ADDBFBD1C3EEA7DB4E1CBF005793C,11061,22,23,1,29,48,1498
59315,59315,BE0962E36708C29E65978ADB79B846A8,12661,0,5,5,32,45,1645
59316,59316,BE0962E36708C29E65978ADB79B846A8,12311,8,9,1,30,44,1544
59317,59317,BE0962E36708C29E65978ADB79B846A8,12661,12,23,11,32,45,1645
59318,59318,93009210860BDDA03DDE81542E8F3857,12514,2,12,10,38,47,1947
59319,59319,93009210860BDDA03DDE81542E8F3857,43481,14,18,4,39,48,1998
59320,59320,93009210860BDDA03DDE81542E8F3857,11771,20,23,3,39,49,1999
59330,59330,1DD1A250791E8DE9D0B949B1DAE230C8,11861,0,4,4,32,47,1647
59331,59331,1DD1A250791E8DE9D0B949B1DAE230C8,10281,5,14,9,33,48,1698
59332,59332,1DD1A250791E8DE9D0B949B1DAE230C8,11861,15,23,8,32,47,1647
59347,59347,B90520ED7BDDE423CEFE3ED6913620C9,10271,0,8,8,37,46,1896
59348,59348,B90520ED7BDDE423CEFE3ED6913620C9,12514,9,14,5,38,47,1947
59349,59349,B90520ED7BDDE423CEFE3ED6913620C9,10841,18,20,2,37,47,1897
59353,59353,035266CFE514B2CE8084B5CCD3E8A0F1,11074,4,17,13,37,47,1897
59354,59354,035266CFE514B2CE8084B5CCD3E8A0F1,10411,18,20,2,36,48,1848
59355,59355,035266CFE514B2CE8084B5CCD3E8A0F1,10841,21,22,1,37,47,1897
59361,59361,B9E52D07F5AA84B0FEC3B2146C780B6A,42471,0,2,2,35,49,1799
59362,59362,B9E52D07F5AA84B0FEC3B2146C780B6A,40637,6,15,9,36,47,1847
59363,59363,B9E52D07F5AA84B0FEC3B2146C780B6A,11231,16,23,7,37,49,1899
59386,59386,2CF73DDA8C5E74B4300779F1FD471C57,11261,3,11,8,36,46,1846
59387,59387,2CF73DDA8C5E74B4300779F1FD471C57,12491,12,16,4,36,43,1843
59388,59388,2CF73DDA8C5E74B4300779F1FD471C57,11261,19,21,2,36,46,1846
59404,59404,6460FC216A34C188FE4998AEEFF35C56,43451,0,6,6,37,40,1890
59405,59405,6460FC216A34C188FE4998AEEFF35C56,12521,8,10,2,35,41,1791
59406,59406,6460FC216A34C188FE4998AEEFF35C56,43451,12,20,8,37,40,1890
59412,59412,BEF31F045A546CF30A63CFBCD60FD3FA,42231,1,3,2,37,46,1896
59413,59413,BEF31F045A546CF30A63CFBCD60FD3FA,13911,6,13,7,39,46,1996
59414,59414,BEF31F045A546CF30A63CFBCD60FD3FA,42231,13,23,10,37,46,1896
59415,59415,1DA7D70236936C90EAC57F810F371773,12131,9,11,2,32,47,1647
59416,59416,1DA7D70236936C90EAC57F810F371773,10281,11,17,6,33,48,1698
59417,59417,1DA7D70236936C90EAC57F810F371773,11861,17,23,6,32,47,1647
59421,59421,CA1E33029DFC1947089ED61DEC78241E,10221,1,7,6,34,49,1749
59422,59422,CA1E33029DFC1947089ED61DEC78241E,12131,9,13,4,32,47,1647
59423,59423,CA1E33029DFC1947089ED61DEC78241E,42921,14,16,2,33,47,1697
59424,59424,CA1E33029DFC1947089ED61DEC78241E,13731,20,22,2,33,49,1699
59425,59425,D6043805E6BE931623FDB9F279CC2598,12641,10,18,8,10,43,543
59426,59426,D6043805E6BE931623FDB9F279CC2598,12921,19,21,2,9,41,491
59427,59427,D6043805E6BE931623FDB9F279CC2598,12641,21,23,2,10,43,543
59428,59428,7D994F51E77AE6D208DE75DD9FDA8CAC,42861,1,6,5,37,44,1894
59429,59429,7D994F51E77AE6D208DE75DD9FDA8CAC,11261,7,9,2,36,46,1846
59430,59430,7D994F51E77AE6D208DE75DD9FDA8CAC,42861,12,13,1,37,44,1894
59431,59431,7D994F51E77AE6D208DE75DD9FDA8CAC,11261,17,18,1,36,46,1846
59444,59444,210582EEAC6D1F2BB5FAA5A446D73BC0,10381,0,6,6,31,49,1599
59445,59445,210582EEAC6D1F2BB5FAA5A446D73BC0,12381,11,19,8,32,48,1648
59446,59446,210582EEAC6D1F2BB5FAA5A446D73BC0,11531,20,22,2,34,49,1749
59447,59447,4EE5C60035D807126AEE0DC0CD563832,42581,0,4,4,38,48,1948
59448,59448,4EE5C60035D807126AEE0DC0CD563832,11914,8,11,3,37,48,1898
59449,59449,4EE5C60035D807126AEE0DC0CD563832,42581,15,20,5,38,48,1948
59450,59450,4EE5C60035D807126AEE0DC0CD563832,11914,20,21,1,37,48,1898
59451,59451,A38841C5C4A883D379ECA50564160D63,10281,0,5,5,33,48,1698
59452,59452,A38841C5C4A883D379ECA50564160D63,11381,7,12,5,30,47,1547
59453,59453,A38841C5C4A883D379ECA50564160D63,10281,12,13,1,33,48,1698
59454,59454,A38841C5C4A883D379ECA50564160D63,11381,14,18,4,30,47,1547
59460,59460,9027D7BCCA8B9488D727103093A0EE77,13341,3,7,4,44,45,2245
59461,59461,9027D7BCCA8B9488D727103093A0EE77,42631,7,13,6,43,45,2195
59462,59462,9027D7BCCA8B9488D727103093A0EE77,13341,13,22,9,44,45,2245
59463,59463,0D581729F61054EABFF48E72F8963AC9,11741,0,14,14,42,49,2149
59464,59464,0D581729F61054EABFF48E72F8963AC9,40302,15,18,3,40,49,2049
59465,59465,0D581729F61054EABFF48E72F8963AC9,11741,18,20,2,42,49,2149
59473,59473,482231C60E75752F61489BAC43B2B02B,10121,0,8,8,36,49,1849
59474,59474,482231C60E75752F61489BAC43B2B02B,10161,9,19,10,35,49,1799
59475,59475,482231C60E75752F61489BAC43B2B02B,10121,20,23,3,36,49,1849
59484,59484,0D3CD827A1181C3C1B665AF25454E6A9,10431,0,17,17,33,49,1699
59485,59485,0D3CD827A1181C3C1B665AF25454E6A9,11211,17,19,2,34,49,1749
59486,59486,0D3CD827A1181C3C1B665AF25454E6A9,40112,19,23,4,32,48,1648
59493,59493,09C2A5500F5ABAEEAC932C07F5628EC4,11021,0,8,8,36,49,1849
59494,59494,09C2A5500F5ABAEEAC932C07F5628EC4,43161,9,11,2,35,47,1797
59495,59495,09C2A5500F5ABAEEAC932C07F5628EC4,11021,12,14,2,36,49,1849
59496,59496,09C2A5500F5ABAEEAC932C07F5628EC4,43161,14,19,5,35,47,1797
59501,59501,BBCB9918D42B41DEDF16DD7F5A9BE26F,11861,0,10,10,32,47,1647
59502,59502,BBCB9918D42B41DEDF16DD7F5A9BE26F,42161,11,17,6,36,47,1847
59503,59503,BBCB9918D42B41DEDF16DD7F5A9BE26F,11861,17,23,6,32,47,1647
59507,59507,5575B73169AFC40160C0FE8905EF95D0,11151,3,8,5,30,48,1548
59508,59508,5575B73169AFC40160C0FE8905EF95D0,11061,11,12,1,29,48,1498
59509,59509,5575B73169AFC40160C0FE8905EF95D0,11151,12,23,11,30,48,1548
59521,59521,E06FC86426E546DF6B8D146F4C749C15,11861,0,7,7,32,47,1647
59522,59522,E06FC86426E546DF6B8D146F4C749C15,10431,8,9,1,33,49,1699
59523,59523,E06FC86426E546DF6B8D146F4C749C15,11861,10,23,13,32,47,1647
59524,59524,696A9A59A99FC4046807849DE62A1492,10491,0,7,7,33,48,1698
59525,59525,696A9A59A99FC4046807849DE62A1492,40925,10,15,5,35,49,1799
59526,59526,696A9A59A99FC4046807849DE62A1492,41591,16,22,6,34,49,1749
59552,59552,5B005239AD91B224060A740123F8C94E,42351,6,8,2,38,45,1945
59553,59553,5B005239AD91B224060A740123F8C94E,42231,9,11,2,37,46,1896
59554,59554,5B005239AD91B224060A740123F8C94E,13911,13,18,5,39,46,1996
59555,59555,5B005239AD91B224060A740123F8C94E,42231,19,20,1,37,46,1896
59568,59568,132BAF41704DD845C2F70543C3732C4E,13711,0,19,19,38,46,1946
59569,59569,132BAF41704DD845C2F70543C3732C4E,42231,19,21,2,37,46,1896
59570,59570,132BAF41704DD845C2F70543C3732C4E,13711,21,23,2,38,46,1946
59574,59574,A280969FD90AA928F73AE4BBEE919365,13101,2,14,12,40,47,2047
59575,59575,A280969FD90AA928F73AE4BBEE919365,40833,14,16,2,41,47,2097
59576,59576,A280969FD90AA928F73AE4BBEE919365,13101,17,23,6,40,47,2047
59577,59577,56BF703F887E17790C3BEE3B65E096E0,42351,0,5,5,38,45,1945
59578,59578,56BF703F887E17790C3BEE3B65E096E0,42231,6,10,4,37,46,1896
59579,59579,56BF703F887E17790C3BEE3B65E096E0,42351,13,23,10,38,45,1945
59580,59580,78B9DCFA4CFE02297486B374939C4654,11261,0,14,14,36,46,1846
59581,59581,78B9DCFA4CFE02297486B374939C4654,13911,15,17,2,39,46,1996
59582,59582,78B9DCFA4CFE02297486B374939C4654,11261,17,23,6,36,46,1846
59583,59583,587D5F224C01DBFA5DAC05C42B3ABD58,42021,0,8,8,33,47,1697
59584,59584,587D5F224C01DBFA5DAC05C42B3ABD58,10251,12,14,2,35,47,1797
59585,59585,587D5F224C01DBFA5DAC05C42B3ABD58,11531,15,17,2,34,49,1749
59586,59586,587D5F224C01DBFA5DAC05C42B3ABD58,11081,17,20,3,35,46,1796
59587,59587,E2FC80C995A3EFA4B2AF01BAD4B24C1C,11074,0,5,5,37,47,1897
59588,59588,E2FC80C995A3EFA4B2AF01BAD4B24C1C,12083,9,17,8,36,49,1849
59589,59589,E2FC80C995A3EFA4B2AF01BAD4B24C1C,11074,18,20,2,37,47,1897
59590,59590,5F72E18AC22CC05F11A96BFBD57885CE,11201,0,10,10,35,49,1799
59591,59591,5F72E18AC22CC05F11A96BFBD57885CE,11074,15,16,1,37,47,1897
59592,59592,5F72E18AC22CC05F11A96BFBD57885CE,10221,16,23,7,34,49,1749
59598,59598,182A42BB7961D14AD940FD065D4EDF33,40637,1,3,2,36,47,1847
59599,59599,182A42BB7961D14AD940FD065D4EDF33,10271,4,6,2,37,46,1896
59600,59600,182A42BB7961D14AD940FD065D4EDF33,13121,9,23,14,38,46,1946
59606,59606,60E47AB33736AC41E2674A67294A03D4,11261,0,1,1,36,46,1846
59607,59607,60E47AB33736AC41E2674A67294A03D4,12491,4,18,14,36,43,1843
59608,59608,60E47AB33736AC41E2674A67294A03D4,11261,19,21,2,36,46,1846
59616,59616,621976A0A40CCCF8810915FF2F37BF47,10544,1,9,8,28,48,1448
59617,59617,621976A0A40CCCF8810915FF2F37BF47,11151,12,14,2,30,48,1548
59618,59618,621976A0A40CCCF8810915FF2F37BF47,43391,15,18,3,29,48,1498
59619,59619,3D2ECC6A4BAE851C87C67624F1270EC4,42351,0,1,1,38,45,1945
59620,59620,3D2ECC6A4BAE851C87C67624F1270EC4,13911,2,15,13,39,46,1996
59621,59621,3D2ECC6A4BAE851C87C67624F1270EC4,42231,19,22,3,37,46,1896
59622,59622,A21C93D72B5558DF6DC8038ACDBFD759,43061,1,6,5,43,46,2196
59623,59623,A21C93D72B5558DF6DC8038ACDBFD759,13341,8,19,11,44,45,2245
59624,59624,A21C93D72B5558DF6DC8038ACDBFD759,43051,21,22,1,46,45,2345
59625,59625,850131E8C9E92CFF67EAC657858E5B85,42351,0,8,8,38,45,1945
59626,59626,850131E8C9E92CFF67EAC657858E5B85,10841,10,14,4,37,47,1897
59627,59627,850131E8C9E92CFF67EAC657858E5B85,12514,15,16,1,38,47,1947
59628,59628,850131E8C9E92CFF67EAC657858E5B85,42231,21,22,1,37,46,1896
59632,59632,FD926C96A4F9758B0E89829758CD18F3,10531,0,7,7,34,46,1746
59633,59633,FD926C96A4F9758B0E89829758CD18F3,40277,7,20,13,35,49,1799
59634,59634,FD926C96A4F9758B0E89829758CD18F3,10151,22,23,1,34,47,1747
59635,59635,34B0487DA91675A6216B605C367EE35D,43761,0,1,1,32,47,1647
59636,59636,34B0487DA91675A6216B605C367EE35D,11061,6,8,2,29,48,1498
59637,59637,34B0487DA91675A6216B605C367EE35D,43581,8,17,9,33,48,1698
59638,59638,34B0487DA91675A6216B605C367EE35D,11061,20,21,1,29,48,1498
59639,59639,9581E2738397A78656E486E508776CFB,42581,1,5,4,38,48,1948
59640,59640,9581E2738397A78656E486E508776CFB,11541,9,19,10,35,49,1799
59641,59641,9581E2738397A78656E486E508776CFB,10121,20,23,3,36,49,1849
59642,59642,2A299573B8ADE5EDDBBA5F82D87A0B34,13601,0,11,11,34,47,1747
59643,59643,2A299573B8ADE5EDDBBA5F82D87A0B34,42921,14,16,2,33,47,1697
59644,59644,2A299573B8ADE5EDDBBA5F82D87A0B34,13601,17,22,5,34,47,1747
59653,59653,1F6BCFEB56D245CBF5160F742055C8A2,11151,0,6,6,30,48,1548
59654,59654,1F6BCFEB56D245CBF5160F742055C8A2,11061,9,10,1,29,48,1498
59655,59655,1F6BCFEB56D245CBF5160F742055C8A2,11151,12,13,1,30,48,1548
59656,59656,1F6BCFEB56D245CBF5160F742055C8A2,11061,13,21,8,29,48,1498
59671,59671,B362B5E77BA1E28CC69DD6493B38125B,13331,0,3,3,38,47,1947
59672,59672,B362B5E77BA1E28CC69DD6493B38125B,42511,3,16,13,37,47,1897
59673,59673,B362B5E77BA1E28CC69DD6493B38125B,13331,16,18,2,38,47,1947
59683,59683,C89DD497B3E25F408D5F4E0FF457EA4C,11914,1,3,2,37,48,1898
59684,59684,C89DD497B3E25F408D5F4E0FF457EA4C,42581,7,12,5,38,48,1948
59685,59685,C89DD497B3E25F408D5F4E0FF457EA4C,11914,16,19,3,37,48,1898
59691,59691,005F29A161E0688A7FD457CFA6CB5E51,13601,0,7,7,34,47,1747
59692,59692,005F29A161E0688A7FD457CFA6CB5E51,10611,9,17,8,32,48,1648
59693,59693,005F29A161E0688A7FD457CFA6CB5E51,10721,18,19,1,31,48,1598
59694,59694,CDD868B7CD2EE63A11365508386D7821,42371,0,14,14,34,46,1746
59695,59695,CDD868B7CD2EE63A11365508386D7821,11261,15,16,1,36,46,1846
59696,59696,CDD868B7CD2EE63A11365508386D7821,42371,19,20,1,34,46,1746
59714,59714,21F337DA0DB026AA1B948DF04FC860E4,10121,2,10,8,36,49,1849
59715,59715,21F337DA0DB026AA1B948DF04FC860E4,11231,12,13,1,37,49,1899
59716,59716,21F337DA0DB026AA1B948DF04FC860E4,11021,16,19,3,36,49,1849
59717,59717,21F337DA0DB026AA1B948DF04FC860E4,11231,19,21,2,37,49,1899
59718,59718,41BEA9D7D7C433E67F41ED8F3F4B85D2,11074,1,6,5,37,47,1897
59719,59719,41BEA9D7D7C433E67F41ED8F3F4B85D2,43171,9,13,4,39,49,1999
59720,59720,41BEA9D7D7C433E67F41ED8F3F4B85D2,10841,14,21,7,37,47,1897
59728,59728,2E5B93B6FE04610C56A0B33EE6E9E88D,11361,0,6,6,22,48,1148
59729,59729,2E5B93B6FE04610C56A0B33EE6E9E88D,42691,11,17,6,24,48,1248
59730,59730,2E5B93B6FE04610C56A0B33EE6E9E88D,42481,18,22,4,22,49,1149
59735,59735,5A8308F9DAAF40265186D4E63F2640C9,12381,0,5,5,32,48,1648
59736,59736,5A8308F9DAAF40265186D4E63F2640C9,10721,6,7,1,31,48,1598
59737,59737,5A8308F9DAAF40265186D4E63F2640C9,13731,9,20,11,33,49,1699
59738,59738,5A8308F9DAAF40265186D4E63F2640C9,12381,22,23,1,32,48,1648
59739,59739,1030D8F4FE8CF10A7F5B83AE8CE6624F,42401,0,9,9,36,47,1847
59740,59740,1030D8F4FE8CF10A7F5B83AE8CE6624F,11331,10,13,3,37,48,1898
59741,59741,1030D8F4FE8CF10A7F5B83AE8CE6624F,42401,13,23,10,36,47,1847
59746,59746,B1CA398CBCC08726B10214389CB30840,42161,1,8,7,36,47,1847
59747,59747,B1CA398CBCC08726B10214389CB30840,40171,10,21,11,38,48,1948
59748,59748,B1CA398CBCC08726B10214389CB30840,42161,22,23,1,36,47,1847
59749,59749,D2988678C555652EDEAB1394D03EFE4C,42191,0,8,8,38,49,1949
59750,59750,D2988678C555652EDEAB1394D03EFE4C,11531,10,11,1,34,49,1749
59751,59751,D2988678C555652EDEAB1394D03EFE4C,42191,14,23,9,38,49,1949
59752,59752,9F99A72527E81B89BEB16DB21B613CC0,10281,0,7,7,33,48,1698
59753,59753,9F99A72527E81B89BEB16DB21B613CC0,11861,8,16,8,32,47,1647
59754,59754,9F99A72527E81B89BEB16DB21B613CC0,10281,17,20,3,33,48,1698
59755,59755,31E3C6E91E6520C2C5D7BFDA47CC8641,11061,0,14,14,29,48,1498
59756,59756,31E3C6E91E6520C2C5D7BFDA47CC8641,11381,19,20,1,30,47,1547
59757,59757,31E3C6E91E6520C2C5D7BFDA47CC8641,11061,21,23,2,29,48,1498
59767,59767,38BAD20AF3F1C2D76FC5AB52738907B1,11861,6,8,2,32,47,1647
59768,59768,38BAD20AF3F1C2D76FC5AB52738907B1,10341,12,14,2,31,47,1597
59769,59769,38BAD20AF3F1C2D76FC5AB52738907B1,42141,14,18,4,32,47,1647
59770,59770,38BAD20AF3F1C2D76FC5AB52738907B1,10341,18,22,4,31,47,1597
59774,59774,ACCC554A67DC8BDBD5254F5A420891E7,10171,0,3,3,26,47,1347
59775,59775,ACCC554A67DC8BDBD5254F5A420891E7,42541,14,15,1,25,47,1297
59776,59776,ACCC554A67DC8BDBD5254F5A420891E7,10171,17,18,1,26,47,1347
59777,59777,ACCC554A67DC8BDBD5254F5A420891E7,42541,20,22,2,25,47,1297
59784,59784,2287B0D379AE62342F9E5A8FE93DC228,13561,2,9,7,37,49,1899
59785,59785,2287B0D379AE62342F9E5A8FE93DC228,11021,11,13,2,36,49,1849
59786,59786,2287B0D379AE62342F9E5A8FE93DC228,10107,13,16,3,38,49,1949
59787,59787,2287B0D379AE62342F9E5A8FE93DC228,10651,17,23,6,36,49,1849
59788,59788,11EAD48A8DBCD5D84EF731E1C3CF71B3,12514,0,15,15,38,47,1947
59789,59789,11EAD48A8DBCD5D84EF731E1C3CF71B3,10841,17,18,1,37,47,1897
59790,59790,11EAD48A8DBCD5D84EF731E1C3CF71B3,12514,21,22,1,38,47,1947
59791,59791,0A501EA010779C8F9EB8C2F8834C3F4F,10351,0,4,4,28,45,1445
59792,59792,0A501EA010779C8F9EB8C2F8834C3F4F,10634,7,8,1,27,45,1395
59793,59793,0A501EA010779C8F9EB8C2F8834C3F4F,10351,9,23,14,28,45,1445
59802,59802,F99A8100651870B148C78FDDEF8AD69E,42351,1,5,4,38,45,1945
59803,59803,F99A8100651870B148C78FDDEF8AD69E,13911,6,9,3,39,46,1996
59804,59804,F99A8100651870B148C78FDDEF8AD69E,42351,9,16,7,38,45,1945
59805,59805,F99A8100651870B148C78FDDEF8AD69E,13911,19,20,1,39,46,1996
59814,59814,6448AD2FDBA33B773228F13A91A3786C,43761,0,7,7,32,47,1647
59815,59815,6448AD2FDBA33B773228F13A91A3786C,10281,10,12,2,33,48,1698
59816,59816,6448AD2FDBA33B773228F13A91A3786C,43761,14,17,3,32,47,1647
59817,59817,6448AD2FDBA33B773228F13A91A3786C,10281,18,19,1,33,48,1698
59827,59827,3C89D3E050BD396C6E176628C3E38174,42161,0,7,7,36,47,1847
59828,59828,3C89D3E050BD396C6E176628C3E38174,43241,12,15,3,36,46,1846
59829,59829,3C89D3E050BD396C6E176628C3E38174,42161,17,23,6,36,47,1847
59836,59836,00C8A801579E6E9A5810DB5A19DD8898,13651,0,2,2,30,47,1547
59837,59837,00C8A801579E6E9A5810DB5A19DD8898,11324,3,4,1,31,46,1596
59838,59838,00C8A801579E6E9A5810DB5A19DD8898,10381,21,22,1,31,49,1599
59846,59846,0A24AC6A2DB2B396939A10A8EFCB227D,43951,7,8,1,49,41,2491
59847,59847,0A24AC6A2DB2B396939A10A8EFCB227D,13411,9,12,3,49,42,2492
59848,59848,0A24AC6A2DB2B396939A10A8EFCB227D,43951,15,20,5,49,41,2491
59849,59849,0A24AC6A2DB2B396939A10A8EFCB227D,13411,20,21,1,49,42,2492
59850,59850,B377B1A009BB64894719A8DF0AC3F76E,11231,0,15,15,37,49,1899
59851,59851,B377B1A009BB64894719A8DF0AC3F76E,12083,16,18,2,36,49,1849
59852,59852,B377B1A009BB64894719A8DF0AC3F76E,11231,19,23,4,37,49,1899
59853,59853,D46D481AE4A1808392E89F68BF1C527D,40441,1,4,3,30,48,1548
59854,59854,D46D481AE4A1808392E89F68BF1C527D,11381,5,7,2,30,47,1547
59855,59855,D46D481AE4A1808392E89F68BF1C527D,11061,7,22,15,29,48,1498
59860,59860,5832F798017EC944959971DE10E6C76B,13911,0,16,16,39,46,1996
59861,59861,5832F798017EC944959971DE10E6C76B,11261,17,19,2,36,46,1846
59862,59862,5832F798017EC944959971DE10E6C76B,13911,22,23,1,39,46,1996
59863,59863,A8DFAF39A5A26AE1BCD9E9DE060BB315,11091,0,6,6,29,47,1497
59864,59864,A8DFAF39A5A26AE1BCD9E9DE060BB315,13651,7,17,10,30,47,1547
59865,59865,A8DFAF39A5A26AE1BCD9E9DE060BB315,11091,18,23,5,29,47,1497
59866,59866,09F64A9A641B3F2B92615DE97B925264,10351,0,4,4,28,45,1445
59867,59867,09F64A9A641B3F2B92615DE97B925264,12661,4,5,1,32,45,1645
59868,59868,09F64A9A641B3F2B92615DE97B925264,10351,7,16,9,28,45,1445
59869,59869,09F64A9A641B3F2B92615DE97B925264,10634,18,21,3,27,45,1395
59873,59873,CB9FC3FE9195AF3F0A6A77B7B82B22F1,11021,0,7,7,36,49,1849
59874,59874,CB9FC3FE9195AF3F0A6A77B7B82B22F1,42471,8,15,7,35,49,1799
59875,59875,CB9FC3FE9195AF3F0A6A77B7B82B22F1,11591,18,20,2,36,49,1849
59876,59876,CB9FC3FE9195AF3F0A6A77B7B82B22F1,42471,20,21,1,35,49,1799
59882,59882,B657ACDCD86797C814A6C376444A2BA6,10811,0,2,2,38,46,1946
59883,59883,B657ACDCD86797C814A6C376444A2BA6,10411,2,6,4,36,48,1848
59884,59884,B657ACDCD86797C814A6C376444A2BA6,10811,7,18,11,38,46,1946
59888,59888,C1896697E8F9082F3C179E6CB902F84B,49181,0,1,1,21,31,1081
59889,59889,C1896697E8F9082F3C179E6CB902F84B,12871,4,5,1,22,33,1133
59890,59890,C1896697E8F9082F3C179E6CB902F84B,49181,6,23,17,21,31,1081
59891,59891,F1089F554EDD989C3763AB8DD5D7CDEF,19114,0,2,2,7,43,393
59892,59892,F1089F554EDD989C3763AB8DD5D7CDEF,12921,4,6,2,9,41,491
59893,59893,F1089F554EDD989C3763AB8DD5D7CDEF,12641,6,19,13,10,43,543
59900,59900,2B75D649D733D42AAC85CA634BF0D07B,11914,0,1,1,37,48,1898
59901,59901,2B75D649D733D42AAC85CA634BF0D07B,42581,1,3,2,38,48,1948
59902,59902,2B75D649D733D42AAC85CA634BF0D07B,11914,3,23,20,37,48,1898
59903,59903,5A0EE807C504E748ADB72D7AA2D1BCFD,43971,0,5,5,30,48,1548
59904,59904,5A0EE807C504E748ADB72D7AA2D1BCFD,11061,6,8,2,29,48,1498
59905,59905,5A0EE807C504E748ADB72D7AA2D1BCFD,43971,8,23,15,30,48,1548
59909,59909,AFF2B1944207762129EB0E25C3502ADB,13711,2,3,1,38,46,1946
59910,59910,AFF2B1944207762129EB0E25C3502ADB,11941,4,5,1,37,46,1896
59911,59911,AFF2B1944207762129EB0E25C3502ADB,13711,5,16,11,38,46,1946
59912,59912,AFF2B1944207762129EB0E25C3502ADB,11941,20,22,2,37,46,1896
59930,59930,C644771D2D9F4182BC18DB70E907DF2B,11914,0,1,1,37,48,1898
59931,59931,C644771D2D9F4182BC18DB70E907DF2B,42581,1,5,4,38,48,1948
59932,59932,C644771D2D9F4182BC18DB70E907DF2B,11914,8,17,9,37,48,1898
59933,59933,C644771D2D9F4182BC18DB70E907DF2B,42581,19,20,1,38,48,1948
59940,59940,E880DD3703242558096D10770FE10A54,11261,8,15,7,36,46,1846
59941,59941,E880DD3703242558096D10770FE10A54,42861,18,20,2,37,44,1894
59942,59942,E880DD3703242558096D10770FE10A54,13231,22,23,1,39,46,1996
59943,59943,7DFCA2932B390D69ABC0E415A2260097,10351,0,4,4,28,45,1445
59944,59944,7DFCA2932B390D69ABC0E415A2260097,42531,4,18,14,31,45,1595
59945,59945,7DFCA2932B390D69ABC0E415A2260097,10351,21,22,1,28,45,1445
59949,59949,2018506FFB1D0F8B32C152861D55E1DF,10544,3,7,4,28,48,1448
59950,59950,2018506FFB1D0F8B32C152861D55E1DF,10381,7,18,11,31,49,1599
59951,59951,2018506FFB1D0F8B32C152861D55E1DF,11381,19,21,2,30,47,1547
59952,59952,1788FF83230593384DFEF88881720D90,13551,0,6,6,45,38,2288
59953,59953,1788FF83230593384DFEF88881720D90,43101,6,20,14,46,40,2340
59954,59954,1788FF83230593384DFEF88881720D90,13551,21,23,2,45,38,2288
59955,59955,D3E46B15B35DC3C198E6EE945D227259,11001,0,5,5,42,47,2147
59956,59956,D3E46B15B35DC3C198E6EE945D227259,13381,6,18,12,39,47,1997
59957,59957,D3E46B15B35DC3C198E6EE945D227259,42271,18,20,2,40,47,2047
59958,59958,D3E46B15B35DC3C198E6EE945D227259,13381,21,23,2,39,47,1997
59959,59959,394B81CC36B31D897120A6153D7C1457,11061,0,3,3,29,48,1498
59960,59960,394B81CC36B31D897120A6153D7C1457,12121,4,15,11,29,47,1497
59961,59961,394B81CC36B31D897120A6153D7C1457,11061,19,23,4,29,48,1498
59965,59965,2873DE93703B028193B7B9719DCFE691,12521,0,7,7,35,41,1791
59966,59966,2873DE93703B028193B7B9719DCFE691,43451,7,17,10,37,40,1890
59967,59967,2873DE93703B028193B7B9719DCFE691,12521,18,23,5,35,41,1791
59975,59975,9AF6F4C6C4937C91C918EC9853CABA28,42861,0,6,6,37,44,1894
59976,59976,9AF6F4C6C4937C91C918EC9853CABA28,11261,7,17,10,36,46,1846
59977,59977,9AF6F4C6C4937C91C918EC9853CABA28,42861,17,21,4,37,44,1894
59978,59978,3AEA3CF422288C2FFB9C65FD7BE694C9,19931,1,3,2,7,43,393
59979,59979,3AEA3CF422288C2FFB9C65FD7BE694C9,12921,4,5,1,9,41,491
59980,59980,3AEA3CF422288C2FFB9C65FD7BE694C9,19931,6,16,10,7,43,393
59981,59981,3AEA3CF422288C2FFB9C65FD7BE694C9,12921,16,22,6,9,41,491
59982,59982,E7730801B6702F8BD36B84F8DA0A17A9,19181,0,15,15,8,40,440
59983,59983,E7730801B6702F8BD36B84F8DA0A17A9,12921,17,18,1,9,41,491
59984,59984,E7730801B6702F8BD36B84F8DA0A17A9,19181,20,23,3,8,40,440
59990,59990,335FD8782D4F531D88DAC06C84870767,13411,0,5,5,49,42,2492
59991,59991,335FD8782D4F531D88DAC06C84870767,43951,7,16,9,49,41,2491
59992,59992,335FD8782D4F531D88DAC06C84870767,13411,20,23,3,49,42,2492
59999,59999,8671664FCEA72D44791A077CF27C82B3,12921,3,4,1,9,41,491
60000,60000,8671664FCEA72D44791A077CF27C82B3,12641,7,15,8,10,43,543
60001,60001,8671664FCEA72D44791A077CF27C82B3,12921,15,17,2,9,41,491
60002,60002,8671664FCEA72D44791A077CF27C82B3,12641,18,19,1,10,43,543
60006,60006,A21BB2A9118C7424A9F0F69D01629303,10251,0,15,15,35,47,1797
60007,60007,A21BB2A9118C7424A9F0F69D01629303,40637,16,18,2,36,47,1847
60008,60008,A21BB2A9118C7424A9F0F69D01629303,10251,20,23,3,35,47,1797
60012,60012,6A22B907A7F1FA4A685D409A00615D34,11261,6,16,10,36,46,1846
60013,60013,6A22B907A7F1FA4A685D409A00615D34,13911,17,18,1,39,46,1996
60014,60014,6A22B907A7F1FA4A685D409A00615D34,11261,19,21,2,36,46,1846
60015,60015,498FA21A928D94A5AF2C1CBF48D37607,10731,3,16,13,33,47,1697
60016,60016,498FA21A928D94A5AF2C1CBF48D37607,11381,18,21,3,30,47,1547
60017,60017,498FA21A928D94A5AF2C1CBF48D37607,10731,21,23,2,33,47,1697
60018,60018,181802B57A29F4FAE1E7EF60B334A9D5,13911,0,6,6,39,46,1996
60019,60019,181802B57A29F4FAE1E7EF60B334A9D5,11261,7,15,8,36,46,1846
60020,60020,181802B57A29F4FAE1E7EF60B334A9D5,42231,16,19,3,37,46,1896
60021,60021,A09953F67FED80A8C2308F84F83FE6DA,43241,0,2,2,36,46,1846
60022,60022,A09953F67FED80A8C2308F84F83FE6DA,13711,2,15,13,38,46,1946
60023,60023,A09953F67FED80A8C2308F84F83FE6DA,42011,15,23,8,36,46,1846
60024,60024,7BD5666208D4C4EF90CAAD8A97E6ED7C,12491,0,5,5,36,43,1843
60025,60025,7BD5666208D4C4EF90CAAD8A97E6ED7C,42861,6,7,1,37,44,1894
60026,60026,7BD5666208D4C4EF90CAAD8A97E6ED7C,42151,7,18,11,35,45,1795
60033,60033,F93D646A1BCE1AFF390EB78A01863C9E,40171,4,5,1,38,48,1948
60034,60034,F93D646A1BCE1AFF390EB78A01863C9E,10471,7,18,11,37,48,1898
60035,60035,F93D646A1BCE1AFF390EB78A01863C9E,40171,20,21,1,38,48,1948
60036,60036,C4892C44EF96187C0233038F8975DE20,11831,1,5,4,32,45,1645
60037,60037,C4892C44EF96187C0233038F8975DE20,12311,7,17,10,30,44,1544
60038,60038,C4892C44EF96187C0233038F8975DE20,42491,22,23,1,32,46,1646
60042,60042,545B57FE377B53DF15322A3E629D81E6,12921,0,16,16,9,41,491
60043,60043,545B57FE377B53DF15322A3E629D81E6,49201,16,18,2,7,41,391
60044,60044,545B57FE377B53DF15322A3E629D81E6,12921,21,22,1,9,41,491
60045,60045,C4CF162A657A7BAE13927070E3B5DFDA,43451,6,17,11,37,40,1890
60046,60046,C4CF162A657A7BAE13927070E3B5DFDA,42381,19,21,2,39,41,1991
60047,60047,C4CF162A657A7BAE13927070E3B5DFDA,43451,22,23,1,37,40,1890
60048,60048,AC0F9A0DA655EB0858F47B6C2577B3DE,11281,0,1,1,27,40,1390
60049,60049,AC0F9A0DA655EB0858F47B6C2577B3DE,13671,3,19,16,27,43,1393
60050,60050,AC0F9A0DA655EB0858F47B6C2577B3DE,11281,20,23,3,27,40,1390
60054,60054,DF460CBD4C09A51D06C2038FDA368680,42041,0,1,1,10,47,547
60055,60055,DF460CBD4C09A51D06C2038FDA368680,19441,5,15,10,8,46,446
60056,60056,DF460CBD4C09A51D06C2038FDA368680,42041,15,23,8,10,47,547
60057,60057,C2DF457F1D0C11A80CBA147D424E3E70,11871,0,8,8,29,46,1496
60058,60058,C2DF457F1D0C11A80CBA147D424E3E70,12311,8,15,7,30,44,1544
60059,60059,C2DF457F1D0C11A80CBA147D424E3E70,11871,15,23,8,29,46,1496
60070,60070,6428FC1D2F17D8BB440D0F9FCA04C935,13911,0,17,17,39,46,1996
60071,60071,6428FC1D2F17D8BB440D0F9FCA04C935,42231,19,21,2,37,46,1896
60072,60072,6428FC1D2F17D8BB440D0F9FCA04C935,13911,21,22,1,39,46,1996
60073,60073,C0EBF471F94BEEDB1281493ACFF571D1,42401,1,15,14,36,47,1847
60074,60074,C0EBF471F94BEEDB1281493ACFF571D1,42021,16,17,1,33,47,1697
60075,60075,C0EBF471F94BEEDB1281493ACFF571D1,42401,19,23,4,36,47,1847
60076,60076,C6869A64CA9EF97A25D7192A00726FC2,42161,0,8,8,36,47,1847
60077,60077,C6869A64CA9EF97A25D7192A00726FC2,10781,8,18,10,35,47,1797
60078,60078,C6869A64CA9EF97A25D7192A00726FC2,42161,19,23,4,36,47,1847
60084,60084,DC9866094212A637CCAC17CF01FE4B5F,42861,0,6,6,37,44,1894
60085,60085,DC9866094212A637CCAC17CF01FE4B5F,11261,6,18,12,36,46,1846
60086,60086,DC9866094212A637CCAC17CF01FE4B5F,42861,19,23,4,37,44,1894
60096,60096,0DD480B5A13E261C7A404CA1C7C938C6,42511,0,16,16,37,47,1897
60097,60097,0DD480B5A13E261C7A404CA1C7C938C6,13121,20,21,1,38,46,1946
60098,60098,0DD480B5A13E261C7A404CA1C7C938C6,42511,22,23,1,37,47,1897
60099,60099,D8963F7C81A647B0DB7A8BBF70036A0B,42221,3,6,3,38,48,1948
60100,60100,D8963F7C81A647B0DB7A8BBF70036A0B,10471,8,17,9,37,48,1898
60101,60101,D8963F7C81A647B0DB7A8BBF70036A0B,12514,20,23,3,38,47,1947
60105,60105,9582B0C41CE65E76B09E8491AC26676B,11875,0,5,5,30,46,1546
60106,60106,9582B0C41CE65E76B09E8491AC26676B,12311,7,16,9,30,44,1544
60107,60107,9582B0C41CE65E76B09E8491AC26676B,11871,19,23,4,29,46,1496
60108,60108,64EA873D359181A561255128009EB239,42581,0,7,7,38,48,1948
60109,60109,64EA873D359181A561255128009EB239,11271,7,15,8,37,48,1898
60110,60110,64EA873D359181A561255128009EB239,42581,20,21,1,38,48,1948
60111,60111,B7832DB383CB1E7DD6C87A81AAE89D66,11074,0,3,3,37,47,1897
60112,60112,B7832DB383CB1E7DD6C87A81AAE89D66,42221,3,4,1,38,48,1948
60113,60113,B7832DB383CB1E7DD6C87A81AAE89D66,11914,5,8,3,37,48,1898
60114,60114,B7832DB383CB1E7DD6C87A81AAE89D66,42221,8,21,13,38,48,1948
60124,60124,441E401293D6FFC8E080552D376784E1,42581,0,5,5,38,48,1948
60125,60125,441E401293D6FFC8E080552D376784E1,11914,6,16,10,37,48,1898
60126,60126,441E401293D6FFC8E080552D376784E1,42581,21,22,1,38,48,1948
60141,60141,2CB6953F391C73F166D02AC31E930A06,11921,0,6,6,38,48,1948
60142,60142,2CB6953F391C73F166D02AC31E930A06,11331,6,21,15,37,48,1898
60143,60143,2CB6953F391C73F166D02AC31E930A06,11921,22,23,1,38,48,1948
60144,60144,D7B4DEFCB86C55D027A1210EEC02063B,11231,0,1,1,37,49,1899
60145,60145,D7B4DEFCB86C55D027A1210EEC02063B,10471,1,4,3,37,48,1898
60146,60146,D7B4DEFCB86C55D027A1210EEC02063B,11021,4,19,15,36,49,1849
60147,60147,D7B4DEFCB86C55D027A1210EEC02063B,11231,20,23,3,37,49,1899
60148,60148,88B9ED484BFC88A3E18D812526B753D0,11261,0,5,5,36,46,1846
60149,60149,88B9ED484BFC88A3E18D812526B753D0,42864,6,15,9,38,44,1944
60150,60150,88B9ED484BFC88A3E18D812526B753D0,11261,17,21,4,36,46,1846
60164,60164,D25B9AC730B657F825EAE4962DB7814E,10351,8,16,8,28,45,1445
60165,60165,D25B9AC730B657F825EAE4962DB7814E,10634,19,20,1,27,45,1395
60166,60166,D25B9AC730B657F825EAE4962DB7814E,10351,22,23,1,28,45,1445
60167,60167,960927B9AFF52BD917B1D09DA4B5E7D1,42491,3,4,1,32,46,1646
60168,60168,960927B9AFF52BD917B1D09DA4B5E7D1,42523,7,8,1,31,47,1597
60169,60169,960927B9AFF52BD917B1D09DA4B5E7D1,11324,8,23,15,31,46,1596
60179,60179,5443876423EFFC85FB222DD27BB73B26,11021,0,16,16,36,49,1849
60180,60180,5443876423EFFC85FB222DD27BB73B26,11331,17,18,1,37,48,1898
60181,60181,5443876423EFFC85FB222DD27BB73B26,11021,21,23,2,36,49,1849
60186,60186,48DCE60D429B0B1E7F2F1B7A462BF9BF,42523,4,5,1,31,47,1597
60187,60187,48DCE60D429B0B1E7F2F1B7A462BF9BF,13651,8,15,7,30,47,1547
60188,60188,48DCE60D429B0B1E7F2F1B7A462BF9BF,42523,17,18,1,31,47,1597
60189,60189,48DCE60D429B0B1E7F2F1B7A462BF9BF,42141,20,23,3,32,47,1647
60190,60190,C3385B266A5088A7FA48BCC62DFDD003,11914,7,15,8,37,48,1898
60191,60191,C3385B266A5088A7FA48BCC62DFDD003,43181,15,16,1,39,48,1998
60192,60192,C3385B266A5088A7FA48BCC62DFDD003,11914,17,20,3,37,48,1898
60193,60193,9BBBC00C93BA6A3176E2B008E6F8A88E,42351,0,5,5,38,45,1945
60194,60194,9BBBC00C93BA6A3176E2B008E6F8A88E,11261,5,20,15,36,46,1846
60195,60195,9BBBC00C93BA6A3176E2B008E6F8A88E,42351,21,23,2,38,45,1945
60196,60196,05C3A7EB5EF4E026B421540B8AC90475,42531,0,2,2,31,45,1595
60197,60197,05C3A7EB5EF4E026B421540B8AC90475,42371,4,6,2,34,46,1746
60198,60198,05C3A7EB5EF4E026B421540B8AC90475,42151,7,19,12,35,45,1795
60199,60199,36E4D456967ADF7C503C23EAE8460AAD,13651,1,4,3,30,47,1547
60200,60200,36E4D456967ADF7C503C23EAE8460AAD,42523,6,19,13,31,47,1597
60201,60201,36E4D456967ADF7C503C23EAE8460AAD,13651,21,23,2,30,47,1547
60217,60217,D14C3775E31C254286856A2CF7979B8E,11021,0,5,5,36,49,1849
60218,60218,D14C3775E31C254286856A2CF7979B8E,42471,17,19,2,35,49,1799
60219,60219,D14C3775E31C254286856A2CF7979B8E,11021,20,23,3,36,49,1849
60220,60220,FF16D1104349162E539969031BE39A02,12511,0,1,1,39,47,1997
60221,60221,FF16D1104349162E539969031BE39A02,43481,4,6,2,39,48,1998
60222,60222,FF16D1104349162E539969031BE39A02,12514,8,19,11,38,47,1947
60229,60229,44B913A66AFA5E271FF541EC61CC9838,10111,0,15,15,37,47,1897
60230,60230,44B913A66AFA5E271FF541EC61CC9838,40421,16,17,1,37,48,1898
60231,60231,44B913A66AFA5E271FF541EC61CC9838,10841,17,19,2,37,47,1897
60237,60237,D0819644627AC00B1760F57708B6F7FF,41393,2,3,1,43,49,2199
60238,60238,D0819644627AC00B1760F57708B6F7FF,42461,4,6,2,45,47,2297
60239,60239,D0819644627AC00B1760F57708B6F7FF,41393,6,15,9,43,49,2199
60240,60240,D0819644627AC00B1760F57708B6F7FF,43621,18,19,1,46,48,2348
60241,60241,F276DA0C0E39AE3BAD5B91AE46CB6EA8,11231,5,15,10,37,49,1899
60242,60242,F276DA0C0E39AE3BAD5B91AE46CB6EA8,10471,15,19,4,37,48,1898
60243,60243,F276DA0C0E39AE3BAD5B91AE46CB6EA8,11231,20,21,1,37,49,1899
60244,60244,A15C0678EF39F4E1D2E8B3E08C176676,42351,0,6,6,38,45,1945
60245,60245,A15C0678EF39F4E1D2E8B3E08C176676,11261,7,15,8,36,46,1846
60246,60246,A15C0678EF39F4E1D2E8B3E08C176676,42231,19,20,1,37,46,1896
60247,60247,A15C0678EF39F4E1D2E8B3E08C176676,40171,21,22,1,38,48,1948
60248,60248,775CA947FF37432092AA3395F5AA137B,42161,0,7,7,36,47,1847
60249,60249,775CA947FF37432092AA3395F5AA137B,43731,8,15,7,34,47,1747
60250,60250,775CA947FF37432092AA3395F5AA137B,10971,16,21,5,35,47,1797
60251,60251,775CA947FF37432092AA3395F5AA137B,11171,22,23,1,33,48,1698
60255,60255,D0C42D3F03FFA9938522D940C8071BF4,11261,0,8,8,36,46,1846
60256,60256,D0C42D3F03FFA9938522D940C8071BF4,13911,8,15,7,39,46,1996
60257,60257,D0C42D3F03FFA9938522D940C8071BF4,42351,18,20,2,38,45,1945
60258,60258,D0C42D3F03FFA9938522D940C8071BF4,11261,20,22,2,36,46,1846
60259,60259,674739CE22833F185CB01F6007DDCCC0,11021,1,3,2,36,49,1849
60260,60260,674739CE22833F185CB01F6007DDCCC0,40271,8,16,8,35,49,1799
60261,60261,674739CE22833F185CB01F6007DDCCC0,11021,18,19,1,36,49,1849
60262,60262,E24AFDE053B6D01DE83CD0A896B93907,42221,0,7,7,38,48,1948
60263,60263,E24AFDE053B6D01DE83CD0A896B93907,11331,7,15,8,37,48,1898
60264,60264,E24AFDE053B6D01DE83CD0A896B93907,11921,17,18,1,38,48,1948
60265,60265,7C04939C394C23491994E5AC7844F392,43391,0,7,7,29,48,1498
60266,60266,7C04939C394C23491994E5AC7844F392,11151,8,15,7,30,48,1548
60267,60267,7C04939C394C23491994E5AC7844F392,43391,19,23,4,29,48,1498
60272,60272,8DE4D252DA36E1365B15A8E9C0F92CC0,10544,1,3,2,28,48,1448
60273,60273,8DE4D252DA36E1365B15A8E9C0F92CC0,11151,7,8,1,30,48,1548
60274,60274,8DE4D252DA36E1365B15A8E9C0F92CC0,10544,8,15,7,28,48,1448
60275,60275,8DE4D252DA36E1365B15A8E9C0F92CC0,11151,18,23,5,30,48,1548
60276,60276,446EC6FA87AAECEACF7165EBCE633713,13651,0,7,7,30,47,1547
60277,60277,446EC6FA87AAECEACF7165EBCE633713,42523,8,17,9,31,47,1597
60278,60278,446EC6FA87AAECEACF7165EBCE633713,11381,21,22,1,30,47,1547
60279,60279,446EC6FA87AAECEACF7165EBCE633713,42523,22,23,1,31,47,1597
60280,60280,52DE1B5B29EB088C4F7CC0D4865B38F5,42861,0,6,6,37,44,1894
60281,60281,52DE1B5B29EB088C4F7CC0D4865B38F5,42151,8,15,7,35,45,1795
60282,60282,52DE1B5B29EB088C4F7CC0D4865B38F5,42861,18,21,3,37,44,1894
60292,60292,44A1A512359C02E9A75BCE907A401EBD,11231,0,18,18,37,49,1899
60293,60293,44A1A512359C02E9A75BCE907A401EBD,10107,19,20,1,38,49,1949
60294,60294,44A1A512359C02E9A75BCE907A401EBD,11231,21,23,2,37,49,1899
60295,60295,C2938F6FA2A943D6DFC754D5D6C219D6,42221,0,16,16,38,48,1948
60296,60296,C2938F6FA2A943D6DFC754D5D6C219D6,11074,18,20,2,37,47,1897
60297,60297,C2938F6FA2A943D6DFC754D5D6C219D6,42221,20,23,3,38,48,1948
60303,60303,3D2ECC6A4BAE851C87C67624F1270EC4,13911,0,6,6,39,46,1996
60304,60304,3D2ECC6A4BAE851C87C67624F1270EC4,42351,7,15,8,38,45,1945
60305,60305,3D2ECC6A4BAE851C87C67624F1270EC4,13911,16,18,2,39,46,1996
60306,60306,3D2ECC6A4BAE851C87C67624F1270EC4,42351,20,21,1,38,45,1945
60316,60316,BD517E29BD7069EA61B2CA0844AA760E,10731,0,6,6,33,47,1697
60317,60317,BD517E29BD7069EA61B2CA0844AA760E,43761,7,15,8,32,47,1647
60318,60318,BD517E29BD7069EA61B2CA0844AA760E,42523,15,18,3,31,47,1597
60319,60319,B362B5E77BA1E28CC69DD6493B38125B,42511,1,3,2,37,47,1897
60320,60320,B362B5E77BA1E28CC69DD6493B38125B,13331,8,15,7,38,47,1947
60321,60321,B362B5E77BA1E28CC69DD6493B38125B,42511,15,17,2,37,47,1897
60322,60322,B362B5E77BA1E28CC69DD6493B38125B,13331,19,20,1,38,47,1947
60326,60326,5DAE8FB10D3FBEF5B02F98DB4BFD46E9,11261,3,4,1,36,46,1846
60327,60327,5DAE8FB10D3FBEF5B02F98DB4BFD46E9,42231,8,17,9,37,46,1896
60328,60328,5DAE8FB10D3FBEF5B02F98DB4BFD46E9,42351,21,23,2,38,45,1945
60329,60329,004156363579A32434DD9F2FE4049F43,11491,0,6,6,36,47,1847
60330,60330,004156363579A32434DD9F2FE4049F43,13711,8,15,7,38,46,1946
60331,60331,004156363579A32434DD9F2FE4049F43,11941,19,21,2,37,46,1896
60332,60332,F29BCCE825D4A9745E2BA78A8E04DFE0,42581,1,3,2,38,48,1948
60333,60333,F29BCCE825D4A9745E2BA78A8E04DFE0,11271,8,20,12,37,48,1898
60334,60334,F29BCCE825D4A9745E2BA78A8E04DFE0,42581,21,22,1,38,48,1948
60335,60335,4A288AD7F7A7553F562F84651A911026,10951,2,16,14,29,48,1498
60336,60336,4A288AD7F7A7553F562F84651A911026,11381,16,17,1,30,47,1547
60337,60337,4A288AD7F7A7553F562F84651A911026,11061,18,21,3,29,48,1498
60338,60338,AC5FFFC9828085332F197D373119C99F,42531,3,8,5,31,45,1595
60339,60339,AC5FFFC9828085332F197D373119C99F,12311,8,15,7,30,44,1544
60340,60340,AC5FFFC9828085332F197D373119C99F,42151,16,17,1,35,45,1795
60341,60341,AC5FFFC9828085332F197D373119C99F,42531,21,23,2,31,45,1595
60345,60345,5084492A6A758A3CF1EF2B8D58F59187,11871,0,6,6,29,46,1496
60346,60346,5084492A6A758A3CF1EF2B8D58F59187,12311,7,17,10,30,44,1544
60347,60347,5084492A6A758A3CF1EF2B8D58F59187,11875,18,23,5,30,46,1546
60348,60348,079E309E76444CFA74DEE7817C8EB0DE,10521,0,15,15,41,47,2097
60349,60349,079E309E76444CFA74DEE7817C8EB0DE,11001,15,16,1,42,47,2147
60350,60350,079E309E76444CFA74DEE7817C8EB0DE,10521,17,19,2,41,47,2097
60351,60351,D429753EEB35077FBB0F7FD7B24671DA,42381,1,6,5,39,41,1991
60352,60352,D429753EEB35077FBB0F7FD7B24671DA,43451,6,15,9,37,40,1890
60353,60353,D429753EEB35077FBB0F7FD7B24671DA,13071,17,18,1,41,41,2091
60354,60354,D429753EEB35077FBB0F7FD7B24671DA,43451,19,20,1,37,40,1890
60355,60355,CC04DF57CD476D56A9C2711AACC54374,11261,0,3,3,36,46,1846
60356,60356,CC04DF57CD476D56A9C2711AACC54374,42861,3,19,16,37,44,1894
60357,60357,CC04DF57CD476D56A9C2711AACC54374,11261,19,21,2,36,46,1846
60368,60368,58FF60972C1637520443DC5766A2AB67,13411,1,5,4,49,42,2492
60369,60369,58FF60972C1637520443DC5766A2AB67,43951,5,17,12,49,41,2491
60370,60370,58FF60972C1637520443DC5766A2AB67,13411,17,23,6,49,42,2492
60371,60371,35316FE348B437315DD3048276353522,40171,8,15,7,38,48,1948
60372,60372,35316FE348B437315DD3048276353522,11271,15,17,2,37,48,1898
60373,60373,35316FE348B437315DD3048276353522,42581,20,22,2,38,48,1948
60374,60374,0277E6ABE6E23FB8B51E9078601CBBC1,42491,0,8,8,32,46,1646
60375,60375,0277E6ABE6E23FB8B51E9078601CBBC1,42523,12,19,7,31,47,1597
60376,60376,0277E6ABE6E23FB8B51E9078601CBBC1,42491,20,22,2,32,46,1646
60401,60401,3C5BF8354C7B22C00BFA5438C070BC0F,13711,0,7,7,38,46,1946
60402,60402,3C5BF8354C7B22C00BFA5438C070BC0F,43241,7,9,2,36,46,1846
60403,60403,3C5BF8354C7B22C00BFA5438C070BC0F,13711,9,21,12,38,46,1946
60413,60413,CEC2557E73B99D59943BE56AF1337C99,13121,0,6,6,38,46,1946
60414,60414,CEC2557E73B99D59943BE56AF1337C99,10271,7,8,1,37,46,1896
60415,60415,CEC2557E73B99D59943BE56AF1337C99,13121,11,12,1,38,46,1946
60416,60416,CEC2557E73B99D59943BE56AF1337C99,10271,16,19,3,37,46,1896
60458,60458,74EBB90FA1C414F58477B49370E7F73F,11861,0,8,8,32,47,1647
60459,60459,74EBB90FA1C414F58477B49370E7F73F,11211,9,10,1,34,49,1749
60460,60460,74EBB90FA1C414F58477B49370E7F73F,11861,11,23,12,32,47,1647
60465,60465,20EBDF07FAB10C468662B7339874EF65,42271,2,3,1,40,47,2047
60466,60466,20EBDF07FAB10C468662B7339874EF65,11806,3,15,12,41,48,2098
60467,60467,20EBDF07FAB10C468662B7339874EF65,42271,18,21,3,40,47,2047
60468,60468,B657ACDCD86797C814A6C376444A2BA6,11914,0,1,1,37,48,1898
60469,60469,B657ACDCD86797C814A6C376444A2BA6,10411,2,5,3,36,48,1848
60470,60470,B657ACDCD86797C814A6C376444A2BA6,11911,9,23,14,37,48,1898
60474,60474,EC6DE3C0E422D06CBA20FC425BEFFD74,12083,2,6,4,36,49,1849
60475,60475,EC6DE3C0E422D06CBA20FC425BEFFD74,10901,6,11,5,35,48,1798
60476,60476,EC6DE3C0E422D06CBA20FC425BEFFD74,11231,13,17,4,37,49,1899
60477,60477,EC6DE3C0E422D06CBA20FC425BEFFD74,10901,21,22,1,35,48,1798
60478,60478,2436A9228D45FC2908C701E0F7243928,42461,2,5,3,45,47,2297
60479,60479,2436A9228D45FC2908C701E0F7243928,42091,8,16,8,43,46,2196
60480,60480,2436A9228D45FC2908C701E0F7243928,43621,16,19,3,46,48,2348
60488,60488,F7D6557362BC78672166A3FDFFE560F4,10381,7,16,9,31,49,1599
60489,60489,F7D6557362BC78672166A3FDFFE560F4,11061,17,19,2,29,48,1498
60490,60490,F7D6557362BC78672166A3FDFFE560F4,42071,21,23,2,31,49,1599
60507,60507,DCCCB5A87EDB009422985F714C0FA27B,11231,0,10,10,37,49,1899
60508,60508,DCCCB5A87EDB009422985F714C0FA27B,10121,10,12,2,36,49,1849
60509,60509,DCCCB5A87EDB009422985F714C0FA27B,11231,12,23,11,37,49,1899
60510,60510,F4C44655D662E7B0953357C6BC0F15C4,12641,7,9,2,10,43,543
60511,60511,F4C44655D662E7B0953357C6BC0F15C4,19114,12,15,3,7,43,393
60512,60512,F4C44655D662E7B0953357C6BC0F15C4,19901,19,21,2,7,44,394
60513,60513,F4C44655D662E7B0953357C6BC0F15C4,19904,21,23,2,9,44,494
60514,60514,964156E683797EC321E31C806CD19178,11914,0,3,3,37,48,1898
60515,60515,964156E683797EC321E31C806CD19178,42581,7,9,2,38,48,1948
60516,60516,964156E683797EC321E31C806CD19178,11331,9,23,14,37,48,1898
60517,60517,53650105F7F25F79263F92D3A7D439AB,42461,4,9,5,45,47,2297
60518,60518,53650105F7F25F79263F92D3A7D439AB,42111,11,12,1,44,46,2246
60519,60519,53650105F7F25F79263F92D3A7D439AB,42461,12,21,9,45,47,2297
60539,60539,0AA5586D6B12F9AD29AA699D8536DBEA,11231,0,3,3,37,49,1899
60540,60540,0AA5586D6B12F9AD29AA699D8536DBEA,41271,8,19,11,38,48,1948
60541,60541,0AA5586D6B12F9AD29AA699D8536DBEA,11231,22,23,1,37,49,1899
60542,60542,CE422328CCAB5428629729C80DEF3748,11791,5,8,3,38,49,1949
60543,60543,CE422328CCAB5428629729C80DEF3748,11021,13,14,1,36,49,1849
60544,60544,CE422328CCAB5428629729C80DEF3748,11011,15,19,4,39,49,1999
60545,60545,EAB7F7FE7C6A5BB1D125060884EA5E78,11381,0,10,10,30,47,1547
60546,60546,EAB7F7FE7C6A5BB1D125060884EA5E78,12121,11,21,10,29,47,1497
60547,60547,EAB7F7FE7C6A5BB1D125060884EA5E78,11381,21,23,2,30,47,1547
60558,60558,8C77E624D8AFCC432BD5DA6A66C68868,10381,0,7,7,31,49,1599
60559,60559,8C77E624D8AFCC432BD5DA6A66C68868,42641,8,18,10,33,49,1699
60560,60560,8C77E624D8AFCC432BD5DA6A66C68868,11201,21,22,1,35,49,1799
60576,60576,3FBA130DE96D19DDB92B7C1710211CF0,10611,0,6,6,32,48,1648
60577,60577,3FBA130DE96D19DDB92B7C1710211CF0,10251,7,15,8,35,47,1797
60578,60578,3FBA130DE96D19DDB92B7C1710211CF0,10611,19,23,4,32,48,1648
60598,60598,19DD9DAA20F169D7FD8EAFAC677B3A46,10681,0,8,8,30,48,1548
60599,60599,19DD9DAA20F169D7FD8EAFAC677B3A46,11061,11,13,2,29,48,1498
60600,60600,19DD9DAA20F169D7FD8EAFAC677B3A46,43971,15,17,2,30,48,1548
60601,60601,19DD9DAA20F169D7FD8EAFAC677B3A46,11061,19,20,1,29,48,1498
60602,60602,10D4ECB5748779C9E514DAF1CC0CDD65,11861,0,3,3,32,47,1647
60603,60603,10D4ECB5748779C9E514DAF1CC0CDD65,10281,4,8,4,33,48,1698
60604,60604,10D4ECB5748779C9E514DAF1CC0CDD65,11861,9,18,9,32,47,1647
60605,60605,10D4ECB5748779C9E514DAF1CC0CDD65,10281,18,20,2,33,48,1698
60606,60606,660D2150C1391153938CD9B90E2CE919,12641,0,4,4,10,43,543
60607,60607,660D2150C1391153938CD9B90E2CE919,19021,4,11,7,10,45,545
60608,60608,660D2150C1391153938CD9B90E2CE919,19901,12,13,1,7,44,394
60609,60609,660D2150C1391153938CD9B90E2CE919,19021,14,23,9,10,45,545
60621,60621,B3D9D8E72FD92A77A76B6490766A3C36,19901,0,3,3,7,44,394
60622,60622,B3D9D8E72FD92A77A76B6490766A3C36,12641,4,8,4,10,43,543
60623,60623,B3D9D8E72FD92A77A76B6490766A3C36,19114,8,20,12,7,43,393
60628,60628,37043F20B053CF5D710D7545F698DBC7,11381,0,12,12,30,47,1547
60629,60629,37043F20B053CF5D710D7545F698DBC7,10951,12,18,6,29,48,1498
60630,60630,37043F20B053CF5D710D7545F698DBC7,11381,19,22,3,30,47,1547
60631,60631,A8491B4932A74BB29E61F0906E6D23DE,42461,0,7,7,45,47,2297
60632,60632,A8491B4932A74BB29E61F0906E6D23DE,42201,11,12,1,43,46,2196
60633,60633,A8491B4932A74BB29E61F0906E6D23DE,42461,12,13,1,45,47,2297
60634,60634,A8491B4932A74BB29E61F0906E6D23DE,42201,17,23,6,43,46,2196
60651,60651,AC598A5FE6399EC753AB160EFE8A6FB9,19621,0,8,8,5,46,296
60652,60652,AC598A5FE6399EC753AB160EFE8A6FB9,19441,10,11,1,8,46,446
60653,60653,AC598A5FE6399EC753AB160EFE8A6FB9,19621,12,20,8,5,46,296
60654,60654,AC598A5FE6399EC753AB160EFE8A6FB9,19441,20,21,1,8,46,446
60655,60655,75B6D91479467607B0BA166BDAF35CA1,10431,0,12,12,33,49,1699
60656,60656,75B6D91479467607B0BA166BDAF35CA1,42141,13,14,1,32,47,1647
60657,60657,75B6D91479467607B0BA166BDAF35CA1,10431,17,23,6,33,49,1699
60661,60661,3C20A4FB5A5B0FD7EA7A50D0F5C8CA66,12641,1,5,4,10,43,543
60662,60662,3C20A4FB5A5B0FD7EA7A50D0F5C8CA66,12921,6,11,5,9,41,491
60663,60663,3C20A4FB5A5B0FD7EA7A50D0F5C8CA66,12641,12,14,2,10,43,543
60664,60664,3C20A4FB5A5B0FD7EA7A50D0F5C8CA66,12921,14,22,8,9,41,491
60672,60672,6DE54F14D44C8B4760F370E4EEF1322C,13111,0,8,8,42,46,2146
60673,60673,6DE54F14D44C8B4760F370E4EEF1322C,40833,12,15,3,41,47,2097
60674,60674,6DE54F14D44C8B4760F370E4EEF1322C,13111,17,23,6,42,46,2146
60675,60675,A0E829F4319BFCF37BA7414AFCB09FF1,42221,6,13,7,38,48,1948
60676,60676,A0E829F4319BFCF37BA7414AFCB09FF1,11074,16,17,1,37,47,1897
60677,60677,A0E829F4319BFCF37BA7414AFCB09FF1,42221,19,21,2,38,48,1948
60678,60678,A0E829F4319BFCF37BA7414AFCB09FF1,41005,22,23,1,38,47,1947
60679,60679,59843945AAE93CCE82D76071D50875F9,10634,0,3,3,27,45,1395
60680,60680,59843945AAE93CCE82D76071D50875F9,10351,6,8,2,28,45,1445
60681,60681,59843945AAE93CCE82D76071D50875F9,10634,11,23,12,27,45,1395
60690,60690,F8CF7EECBE26986A90F0207E24916693,11324,0,9,9,31,46,1596
60691,60691,F8CF7EECBE26986A90F0207E24916693,11861,12,14,2,32,47,1647
60692,60692,F8CF7EECBE26986A90F0207E24916693,11324,14,18,4,31,46,1596
60698,60698,E94CFDD7103C4D389B11C2174CB53F25,43051,0,2,2,46,45,2345
60699,60699,E94CFDD7103C4D389B11C2174CB53F25,42201,3,12,9,43,46,2196
60700,60700,E94CFDD7103C4D389B11C2174CB53F25,43051,12,14,2,46,45,2345
60701,60701,E94CFDD7103C4D389B11C2174CB53F25,42201,17,18,1,43,46,2196
60702,60702,981FF39DB0050476FC5E5BA7D49F90F5,42864,0,7,7,38,44,1944
60703,60703,981FF39DB0050476FC5E5BA7D49F90F5,42861,9,11,2,37,44,1894
60704,60704,981FF39DB0050476FC5E5BA7D49F90F5,11261,12,19,7,36,46,1846
60705,60705,981FF39DB0050476FC5E5BA7D49F90F5,42861,19,23,4,37,44,1894
60706,60706,6506827D8E85555CE6129E35C4361CF6,42871,7,18,11,30,45,1545
60707,60707,6506827D8E85555CE6129E35C4361CF6,11871,18,19,1,29,46,1496
60708,60708,6506827D8E85555CE6129E35C4361CF6,42871,21,23,2,30,45,1545
60722,60722,B0E329B00E3FA297B870177AA9BA63AC,42141,0,8,8,32,47,1647
60723,60723,B0E329B00E3FA297B870177AA9BA63AC,42021,9,10,1,33,47,1697
60724,60724,B0E329B00E3FA297B870177AA9BA63AC,11861,13,23,10,32,47,1647
60725,60725,0AE1F060A9917578AF6CC39BEF4A5FD7,12083,0,3,3,36,49,1849
60726,60726,0AE1F060A9917578AF6CC39BEF4A5FD7,11914,4,5,1,37,48,1898
60727,60727,0AE1F060A9917578AF6CC39BEF4A5FD7,10371,9,18,9,37,49,1899
60737,60737,2BEF2F1DF9F53E26FBA10E115C641BD7,42151,0,6,6,35,45,1795
60738,60738,2BEF2F1DF9F53E26FBA10E115C641BD7,12661,9,10,1,32,45,1645
60739,60739,2BEF2F1DF9F53E26FBA10E115C641BD7,42151,10,12,2,35,45,1795
60740,60740,2BEF2F1DF9F53E26FBA10E115C641BD7,12661,12,20,8,32,45,1645
60748,60748,DA1489BF10C5E54D6333A158A065E13C,42521,0,5,5,31,47,1597
60749,60749,DA1489BF10C5E54D6333A158A065E13C,42141,7,14,7,32,47,1647
60750,60750,DA1489BF10C5E54D6333A158A065E13C,42521,14,15,1,31,47,1597
60751,60751,DA1489BF10C5E54D6333A158A065E13C,43761,17,21,4,32,47,1647
60755,60755,D5E9BDC8FA219234703CDBDA1084CD0E,43581,0,6,6,33,48,1698
60756,60756,D5E9BDC8FA219234703CDBDA1084CD0E,10401,9,10,1,33,49,1699
60757,60757,D5E9BDC8FA219234703CDBDA1084CD0E,11561,15,16,1,32,49,1649
60758,60758,D5E9BDC8FA219234703CDBDA1084CD0E,43581,21,23,2,33,48,1698
60767,60767,9018E334510830C940D94E13413D361F,13371,2,9,7,41,47,2097
60768,60768,9018E334510830C940D94E13413D361F,10787,10,15,5,38,46,1946
60769,60769,9018E334510830C940D94E13413D361F,13941,20,23,3,41,47,2097
60775,60775,09B258FCC1A04CEAAFFB93000EF42A6F,10811,0,6,6,38,46,1946
60776,60776,09B258FCC1A04CEAAFFB93000EF42A6F,11074,6,8,2,37,47,1897
60777,60777,09B258FCC1A04CEAAFFB93000EF42A6F,12514,10,11,1,38,47,1947
60778,60778,09B258FCC1A04CEAAFFB93000EF42A6F,10601,14,18,4,39,47,1997
60779,60779,394B81CC36B31D897120A6153D7C1457,11061,0,5,5,29,48,1498
60780,60780,394B81CC36B31D897120A6153D7C1457,12121,6,14,8,29,47,1497
60781,60781,394B81CC36B31D897120A6153D7C1457,42501,15,17,2,28,47,1447
60782,60782,394B81CC36B31D897120A6153D7C1457,11061,20,23,3,29,48,1498
60783,60783,3F2FE95AB24E5E71D935604E5158C97B,10924,0,8,8,43,49,2199
60784,60784,3F2FE95AB24E5E71D935604E5158C97B,11701,12,16,4,43,48,2198
60785,60785,3F2FE95AB24E5E71D935604E5158C97B,11901,16,19,3,42,49,2149
60786,60786,3F2FE95AB24E5E71D935604E5158C97B,10924,20,23,3,43,49,2199
60787,60787,7D40FDA16D9F775EEBE4F7D8E79E845C,43761,0,5,5,32,47,1647
60788,60788,7D40FDA16D9F775EEBE4F7D8E79E845C,42521,8,9,1,31,47,1597
60789,60789,7D40FDA16D9F775EEBE4F7D8E79E845C,43761,9,18,9,32,47,1647
60802,60802,360F8FF689038AB200FC763E1A6C9243,43761,2,3,1,32,47,1647
60803,60803,360F8FF689038AB200FC763E1A6C9243,42523,3,15,12,31,47,1597
60804,60804,360F8FF689038AB200FC763E1A6C9243,43761,17,18,1,32,47,1647
60805,60805,2DF3C6DC9E553CA01AAB34763FB8D366,13941,0,5,5,41,47,2097
60806,60806,2DF3C6DC9E553CA01AAB34763FB8D366,11001,8,11,3,42,47,2147
60807,60807,2DF3C6DC9E553CA01AAB34763FB8D366,13941,12,13,1,41,47,2097
60808,60808,2DF3C6DC9E553CA01AAB34763FB8D366,11001,17,19,2,42,47,2147
60816,60816,2873DE93703B028193B7B9719DCFE691,12521,0,7,7,35,41,1791
60817,60817,2873DE93703B028193B7B9719DCFE691,43451,7,10,3,37,40,1890
60818,60818,2873DE93703B028193B7B9719DCFE691,12521,11,23,12,35,41,1791
60832,60832,2D473AEE4EAA77528353079765891883,13371,0,14,14,41,47,2097
60833,60833,2D473AEE4EAA77528353079765891883,13121,15,16,1,38,46,1946
60834,60834,2D473AEE4EAA77528353079765891883,13371,20,21,1,41,47,2097
60845,60845,2E8B764495F8C75B1A6E74CD6E6D7095,42921,0,7,7,33,47,1697
60846,60846,2E8B764495F8C75B1A6E74CD6E6D7095,10292,11,15,4,30,47,1547
60847,60847,2E8B764495F8C75B1A6E74CD6E6D7095,42921,18,21,3,33,47,1697
60853,60853,C1639C33F8208BC5ED1B19FF5A6FA4BA,11861,0,12,12,32,47,1647
60854,60854,C1639C33F8208BC5ED1B19FF5A6FA4BA,10971,12,14,2,35,47,1797
60855,60855,C1639C33F8208BC5ED1B19FF5A6FA4BA,11861,15,19,4,32,47,1647
60856,60856,C1639C33F8208BC5ED1B19FF5A6FA4BA,42021,21,23,2,33,47,1697
60857,60857,CA13573EC489EC297A1DB55BF08926BD,42231,0,6,6,37,46,1896
60858,60858,CA13573EC489EC297A1DB55BF08926BD,10811,11,13,2,38,46,1946
60859,60859,CA13573EC489EC297A1DB55BF08926BD,42231,13,23,10,37,46,1896
60867,60867,2C077CC86A9D46DA0D5CE10AC9BD44D7,11061,0,6,6,29,48,1498
60868,60868,2C077CC86A9D46DA0D5CE10AC9BD44D7,42071,7,16,9,31,49,1599
60869,60869,2C077CC86A9D46DA0D5CE10AC9BD44D7,11061,20,23,3,29,48,1498
60879,60879,048181761FA0265EF54A961A32D22478,42521,0,3,3,31,47,1597
60880,60880,048181761FA0265EF54A961A32D22478,43761,4,5,1,32,47,1647
60881,60881,048181761FA0265EF54A961A32D22478,42521,5,17,12,31,47,1597
60882,60882,048181761FA0265EF54A961A32D22478,43761,17,23,6,32,47,1647
60892,60892,DC15358175A492C6F21AAEFAD4CD0BB7,42401,0,11,11,36,47,1847
60893,60893,DC15358175A492C6F21AAEFAD4CD0BB7,10661,12,15,3,37,49,1899
60894,60894,DC15358175A492C6F21AAEFAD4CD0BB7,10121,15,17,2,36,49,1849
60895,60895,DC15358175A492C6F21AAEFAD4CD0BB7,42401,18,23,5,36,47,1847
60899,60899,72EE059838FC074BF0955787969E7967,11231,0,4,4,37,49,1899
60900,60900,72EE059838FC074BF0955787969E7967,11911,5,19,14,37,48,1898
60901,60901,72EE059838FC074BF0955787969E7967,11231,20,23,3,37,49,1899
60909,60909,5C7F8A03755C44742187CEE0EDAF92C8,11571,1,6,5,13,46,696
60910,60910,5C7F8A03755C44742187CEE0EDAF92C8,19021,7,18,11,10,45,545
60911,60911,5C7F8A03755C44742187CEE0EDAF92C8,42041,21,22,1,10,47,547
60915,60915,874A771EE0B6F45D76A7E0A56CE9E147,13371,0,2,2,41,47,2097
60916,60916,874A771EE0B6F45D76A7E0A56CE9E147,43061,3,13,10,43,46,2196
60917,60917,874A771EE0B6F45D76A7E0A56CE9E147,13111,15,16,1,42,46,2146
60918,60918,874A771EE0B6F45D76A7E0A56CE9E147,13791,21,23,2,42,47,2147
60919,60919,924C94FEA337955066B022FCC7607D38,11361,2,5,3,22,48,1148
60920,60920,924C94FEA337955066B022FCC7607D38,12581,6,15,9,24,48,1248
60921,60921,924C94FEA337955066B022FCC7607D38,11361,18,19,1,22,48,1148
60922,60922,924C94FEA337955066B022FCC7607D38,12581,21,22,1,24,48,1248
60923,60923,8E0D20320C5276BDD797BA6D65B9C51D,11074,0,7,7,37,47,1897
60924,60924,8E0D20320C5276BDD797BA6D65B9C51D,11231,8,17,9,37,49,1899
60925,60925,8E0D20320C5276BDD797BA6D65B9C51D,11074,18,23,5,37,47,1897
60931,60931,734AA0FD60664EA09393C156AEAFFF4F,10221,0,11,11,34,49,1749
60932,60932,734AA0FD60664EA09393C156AEAFFF4F,12021,12,13,1,37,49,1899
60933,60933,734AA0FD60664EA09393C156AEAFFF4F,40271,14,19,5,35,49,1799
60934,60934,734AA0FD60664EA09393C156AEAFFF4F,10221,22,23,1,34,49,1749
60939,60939,A6555ADD1FDD22671BB225447AB03AF9,12641,0,1,1,10,43,543
60940,60940,A6555ADD1FDD22671BB225447AB03AF9,19744,1,2,1,6,43,343
60941,60941,A6555ADD1FDD22671BB225447AB03AF9,12641,6,23,17,10,43,543
60947,60947,511248B31413344B77C12D74A5EE7CDF,40872,0,7,7,30,49,1549
60948,60948,511248B31413344B77C12D74A5EE7CDF,11151,10,12,2,30,48,1548
60949,60949,511248B31413344B77C12D74A5EE7CDF,43471,12,13,1,31,49,1599
60950,60950,511248B31413344B77C12D74A5EE7CDF,11151,18,19,1,30,48,1548
60951,60951,325B301C16FB3DB9C4CED544F7B2E787,42191,0,9,9,38,49,1949
60952,60952,325B301C16FB3DB9C4CED544F7B2E787,10471,10,12,2,37,48,1898
60953,60953,325B301C16FB3DB9C4CED544F7B2E787,11781,15,17,2,38,49,1949
60954,60954,325B301C16FB3DB9C4CED544F7B2E787,10471,18,19,1,37,48,1898
60982,60982,8D188B1328CA03E5FCB5F80DC745FFDD,10341,0,14,14,31,47,1597
60983,60983,8D188B1328CA03E5FCB5F80DC745FFDD,10401,14,18,4,33,49,1699
60984,60984,8D188B1328CA03E5FCB5F80DC745FFDD,42523,21,23,2,31,47,1597
60989,60989,4A7E0C26D094908459DFDB4A502F3938,42401,0,15,15,36,47,1847
60990,60990,4A7E0C26D094908459DFDB4A502F3938,10111,16,17,1,37,47,1897
60991,60991,4A7E0C26D094908459DFDB4A502F3938,42401,17,23,6,36,47,1847
61006,61006,C4892C44EF96187C0233038F8975DE20,12161,0,6,6,32,46,1646
61007,61007,C4892C44EF96187C0233038F8975DE20,12311,7,17,10,30,44,1544
61008,61008,C4892C44EF96187C0233038F8975DE20,42491,21,23,2,32,46,1646
61017,61017,F50FC856F863758080A674C7C53C2C16,42221,1,8,7,38,48,1948
61018,61018,F50FC856F863758080A674C7C53C2C16,41021,8,9,1,38,47,1947
61019,61019,F50FC856F863758080A674C7C53C2C16,42221,12,23,11,38,48,1948
61035,61035,7300FFB733BFFEA187DB110E4D4DC3D2,49201,0,1,1,7,41,391
61036,61036,7300FFB733BFFEA187DB110E4D4DC3D2,19181,1,6,5,8,40,440
61037,61037,7300FFB733BFFEA187DB110E4D4DC3D2,49201,9,11,2,7,41,391
61038,61038,7300FFB733BFFEA187DB110E4D4DC3D2,12921,12,23,11,9,41,491
61046,61046,0FFA2B76C33E86D096275A1457C5D54A,10411,0,7,7,36,48,1848
61047,61047,0FFA2B76C33E86D096275A1457C5D54A,42151,8,10,2,35,45,1795
61048,61048,0FFA2B76C33E86D096275A1457C5D54A,10411,22,23,1,36,48,1848
61055,61055,BA6468A84C81B4949B332F392AF7BE2D,13101,0,19,19,40,47,2047
61056,61056,BA6468A84C81B4949B332F392AF7BE2D,11806,19,20,1,41,48,2098
61057,61057,BA6468A84C81B4949B332F392AF7BE2D,13101,20,21,1,40,47,2047
61066,61066,78C0E1E992CFF9ECB9C6D46D3E929FD4,12121,0,8,8,29,47,1497
61067,61067,78C0E1E992CFF9ECB9C6D46D3E929FD4,11381,8,10,2,30,47,1547
61068,61068,78C0E1E992CFF9ECB9C6D46D3E929FD4,12121,14,15,1,29,47,1497
61069,61069,78C0E1E992CFF9ECB9C6D46D3E929FD4,11381,16,18,2,30,47,1547
61091,61091,DDA6B604E3064A212A44C754B2E5E179,11261,1,7,6,36,46,1846
61092,61092,DDA6B604E3064A212A44C754B2E5E179,42151,7,15,8,35,45,1795
61093,61093,DDA6B604E3064A212A44C754B2E5E179,11261,19,23,4,36,46,1846
61094,61094,BE0A979268FF24891DDE75D2D876AB55,42511,0,8,8,37,47,1897
61095,61095,BE0A979268FF24891DDE75D2D876AB55,13681,8,10,2,38,47,1947
61096,61096,BE0A979268FF24891DDE75D2D876AB55,13121,11,12,1,38,46,1946
61097,61097,BE0A979268FF24891DDE75D2D876AB55,13681,12,22,10,38,47,1947
61107,61107,9582B0C41CE65E76B09E8491AC26676B,11871,0,5,5,29,46,1496
61108,61108,9582B0C41CE65E76B09E8491AC26676B,12311,6,16,10,30,44,1544
61109,61109,9582B0C41CE65E76B09E8491AC26676B,11871,19,23,4,29,46,1496
61110,61110,0A1386913DE713CBA72662A5149627A3,13711,0,7,7,38,46,1946
61111,61111,0A1386913DE713CBA72662A5149627A3,11941,10,12,2,37,46,1896
61112,61112,0A1386913DE713CBA72662A5149627A3,13711,12,22,10,38,46,1946
61113,61113,829F3CF969A99106A0CF5C6D0ED0FE14,42161,0,13,13,36,47,1847
61114,61114,829F3CF969A99106A0CF5C6D0ED0FE14,11751,15,22,7,35,48,1798
61115,61115,829F3CF969A99106A0CF5C6D0ED0FE14,42401,22,23,1,36,47,1847
61135,61135,387C2BFABED9CD0C7C45EBAD5F5242F9,10251,0,9,9,35,47,1797
61136,61136,387C2BFABED9CD0C7C45EBAD5F5242F9,43241,10,11,1,36,46,1846
61137,61137,387C2BFABED9CD0C7C45EBAD5F5242F9,10251,12,23,11,35,47,1797
61138,61138,00D7F212BEEBBAAF26C1E8D68E8B416C,13551,8,13,5,45,38,2288
61139,61139,00D7F212BEEBBAAF26C1E8D68E8B416C,43101,14,16,2,46,40,2340
61140,61140,00D7F212BEEBBAAF26C1E8D68E8B416C,13551,19,20,1,45,38,2288
61144,61144,115F54D0202DADE6C23AC2CDA84FCF6D,10801,0,8,8,42,47,2147
61145,61145,115F54D0202DADE6C23AC2CDA84FCF6D,42321,10,11,1,43,47,2197
61146,61146,115F54D0202DADE6C23AC2CDA84FCF6D,10801,11,20,9,42,47,2147
61147,61147,E22A4CD2C9DFED011AA9FE184FF0E695,10251,0,13,13,35,47,1797
61148,61148,E22A4CD2C9DFED011AA9FE184FF0E695,40951,14,15,1,36,49,1849
61149,61149,E22A4CD2C9DFED011AA9FE184FF0E695,42401,17,23,6,36,47,1847
61150,61150,5E269639C787C5D2BDF7F359B5257597,13381,0,7,7,39,47,1997
61151,61151,5E269639C787C5D2BDF7F359B5257597,11481,8,19,11,41,48,2098
61152,61152,5E269639C787C5D2BDF7F359B5257597,13381,20,23,3,39,47,1997
61153,61153,6EE33A4158B91E73941C475D6213D143,43951,0,2,2,49,41,2491
61154,61154,6EE33A4158B91E73941C475D6213D143,43101,9,11,2,46,40,2340
61155,61155,6EE33A4158B91E73941C475D6213D143,43951,12,21,9,49,41,2491
61156,61156,F6D5F0720A4C82E72FD0C591B5570DDC,43471,0,8,8,31,49,1599
61157,61157,F6D5F0720A4C82E72FD0C591B5570DDC,11171,12,14,2,33,48,1698
61158,61158,F6D5F0720A4C82E72FD0C591B5570DDC,10221,15,17,2,34,49,1749
61159,61159,F6D5F0720A4C82E72FD0C591B5570DDC,10691,20,23,3,33,48,1698
61160,61160,46FBB102C6B8DD3727737A749B2D8106,42921,0,6,6,33,47,1697
61161,61161,46FBB102C6B8DD3727737A749B2D8106,12131,6,8,2,32,47,1647
61162,61162,46FBB102C6B8DD3727737A749B2D8106,42371,12,22,10,34,46,1746
61163,61163,CC1D3C2DA42F1EBED6688749C3DA1D87,43971,0,3,3,30,48,1548
61164,61164,CC1D3C2DA42F1EBED6688749C3DA1D87,10731,7,16,9,33,47,1697
61165,61165,CC1D3C2DA42F1EBED6688749C3DA1D87,43971,20,21,1,30,48,1548
61171,61171,D7349708A10855AEF98FEB8D22C33E59,11074,0,7,7,37,47,1897
61172,61172,D7349708A10855AEF98FEB8D22C33E59,11231,8,16,8,37,49,1899
61173,61173,D7349708A10855AEF98FEB8D22C33E59,13271,20,23,3,41,47,2097
61174,61174,2CB6953F391C73F166D02AC31E930A06,40171,0,8,8,38,48,1948
61175,61175,2CB6953F391C73F166D02AC31E930A06,11914,8,17,9,37,48,1898
61176,61176,2CB6953F391C73F166D02AC31E930A06,11921,19,23,4,38,48,1948
61182,61182,E24F34B965BE1054DCE4AF1C1CD48137,43761,2,7,5,32,47,1647
61183,61183,E24F34B965BE1054DCE4AF1C1CD48137,11871,8,19,11,29,46,1496
61184,61184,E24F34B965BE1054DCE4AF1C1CD48137,11861,19,21,2,32,47,1647
61200,61200,1B16AD0182878B49E352925C1FB99700,12514,10,16,6,38,47,1947
61201,61201,1B16AD0182878B49E352925C1FB99700,10591,17,18,1,39,48,1998
61202,61202,1B16AD0182878B49E352925C1FB99700,12514,21,23,2,38,47,1947
61212,61212,D7B4DEFCB86C55D027A1210EEC02063B,11231,0,1,1,37,49,1899
61213,61213,D7B4DEFCB86C55D027A1210EEC02063B,11021,1,20,19,36,49,1849
61214,61214,D7B4DEFCB86C55D027A1210EEC02063B,10107,22,23,1,38,49,1949
61215,61215,558A6887C0D5899B43E75BBD844A7C64,42461,0,6,6,45,47,2297
61216,61216,558A6887C0D5899B43E75BBD844A7C64,42321,6,16,10,43,47,2197
61217,61217,558A6887C0D5899B43E75BBD844A7C64,42461,20,23,3,45,47,2297
61218,61218,BF8A02A995476150EB1C43709C203653,11541,8,9,1,35,49,1799
61219,61219,BF8A02A995476150EB1C43709C203653,11531,9,11,2,34,49,1749
61220,61220,BF8A02A995476150EB1C43709C203653,42961,18,20,2,35,49,1799
61221,61221,E45B0EC44E00842EDD865C65A561543D,11791,0,8,8,38,49,1949
61222,61222,E45B0EC44E00842EDD865C65A561543D,11211,10,11,1,34,49,1749
61223,61223,E45B0EC44E00842EDD865C65A561543D,10471,12,22,10,37,48,1898
61224,61224,B24DFEF6BEA91CB0AE942579D8124FCB,10971,0,7,7,35,47,1797
61225,61225,B24DFEF6BEA91CB0AE942579D8124FCB,40381,8,10,2,32,46,1646
61226,61226,B24DFEF6BEA91CB0AE942579D8124FCB,10971,10,23,13,35,47,1797
61227,61227,D8B46FFCD15B641FB93B8219A29A7205,10111,0,3,3,37,47,1897
61228,61228,D8B46FFCD15B641FB93B8219A29A7205,10251,3,12,9,35,47,1797
61229,61229,D8B46FFCD15B641FB93B8219A29A7205,10111,14,16,2,37,47,1897
61230,61230,D8B46FFCD15B641FB93B8219A29A7205,10251,17,20,3,35,47,1797
61245,61245,BC5F5A048F874E8EDED6AF765E340D8C,11914,5,15,10,37,48,1898
61246,61246,BC5F5A048F874E8EDED6AF765E340D8C,42581,15,17,2,38,48,1948
61247,61247,BC5F5A048F874E8EDED6AF765E340D8C,11914,18,22,4,37,48,1898
61252,61252,83DF2DC67F792D97F66715470F9922B2,43761,0,5,5,32,47,1647
61253,61253,83DF2DC67F792D97F66715470F9922B2,42521,9,15,6,31,47,1597
61254,61254,83DF2DC67F792D97F66715470F9922B2,11061,18,19,1,29,48,1498
61260,61260,0C993A1B5BD23944DD153F92F92FAA1E,10351,0,8,8,28,45,1445
61261,61261,0C993A1B5BD23944DD153F92F92FAA1E,10634,11,17,6,27,45,1395
61262,61262,0C993A1B5BD23944DD153F92F92FAA1E,10351,17,21,4,28,45,1445
61283,61283,90AEF58BB4CABDF543DA1FFF777671DC,11381,5,15,10,30,47,1547
61284,61284,90AEF58BB4CABDF543DA1FFF777671DC,42523,15,17,2,31,47,1597
61285,61285,90AEF58BB4CABDF543DA1FFF777671DC,11381,20,23,3,30,47,1547
61286,61286,364CFB7A1685ACB31A7518A83542E08A,11806,0,6,6,41,48,2098
61287,61287,364CFB7A1685ACB31A7518A83542E08A,42271,10,12,2,40,47,2047
61288,61288,364CFB7A1685ACB31A7518A83542E08A,11806,15,16,1,41,48,2098
61289,61289,364CFB7A1685ACB31A7518A83542E08A,42271,17,19,2,40,47,2047
61315,61315,3D06D75F5CA9AA05A6DD9AB23896E8F1,10251,1,2,1,35,47,1797
61316,61316,3D06D75F5CA9AA05A6DD9AB23896E8F1,42301,4,15,11,36,47,1847
61317,61317,3D06D75F5CA9AA05A6DD9AB23896E8F1,43241,20,22,2,36,46,1846
61325,61325,21BC6BE86FCB8991503DD6600222E887,11161,0,11,11,32,48,1648
61326,61326,21BC6BE86FCB8991503DD6600222E887,43391,14,16,2,29,48,1498
61327,61327,21BC6BE86FCB8991503DD6600222E887,11161,16,23,7,32,48,1648
61337,61337,B4FCDB5AEF312903DA35370D241616C0,12051,0,1,1,20,47,1047
61338,61338,B4FCDB5AEF312903DA35370D241616C0,11361,4,12,8,22,48,1148
61339,61339,B4FCDB5AEF312903DA35370D241616C0,42481,12,19,7,22,49,1149
61350,61350,184C01DF5AF7FEEE2B90AA7395647187,42151,1,9,8,35,45,1795
61351,61351,184C01DF5AF7FEEE2B90AA7395647187,42861,11,12,1,37,44,1894
61352,61352,184C01DF5AF7FEEE2B90AA7395647187,42151,13,23,10,35,45,1795
61353,61353,7D5000772E957DD3A483CE8963A15A13,11381,4,5,1,30,47,1547
61354,61354,7D5000772E957DD3A483CE8963A15A13,42501,6,7,1,28,47,1447
61355,61355,7D5000772E957DD3A483CE8963A15A13,12121,11,21,10,29,47,1497
61367,61367,628C7824651436AFEE1874B5B2874BA1,10634,0,6,6,27,45,1395
61368,61368,628C7824651436AFEE1874B5B2874BA1,10351,7,13,6,28,45,1445
61369,61369,628C7824651436AFEE1874B5B2874BA1,10301,17,18,1,31,45,1595
61380,61380,D9B08428B230A26F9D8108567961B570,11281,0,7,7,27,40,1390
61381,61381,D9B08428B230A26F9D8108567961B570,13671,11,16,5,27,43,1393
61382,61382,D9B08428B230A26F9D8108567961B570,11281,20,23,3,27,40,1390
61383,61383,780CF605B987CE4335E0B64DFA86ACBF,12514,1,2,1,38,47,1947
61384,61384,780CF605B987CE4335E0B64DFA86ACBF,11921,4,5,1,38,48,1948
61385,61385,780CF605B987CE4335E0B64DFA86ACBF,12514,7,20,13,38,47,1947
61403,61403,E23529B03429DBB1B6176FB92FF00108,11021,0,12,12,36,49,1849
61404,61404,E23529B03429DBB1B6176FB92FF00108,41724,13,14,1,38,48,1948
61405,61405,E23529B03429DBB1B6176FB92FF00108,11021,18,23,5,36,49,1849
61410,61410,F2ED260BEE0CFBD7C0D8D1BC36233DE2,12121,0,11,11,29,47,1497
61411,61411,F2ED260BEE0CFBD7C0D8D1BC36233DE2,11381,11,17,6,30,47,1547
61412,61412,F2ED260BEE0CFBD7C0D8D1BC36233DE2,43391,18,20,2,29,48,1498
61413,61413,F2ED260BEE0CFBD7C0D8D1BC36233DE2,11381,20,23,3,30,47,1547
61414,61414,D5746F30DC8775BC56CB551C6292738D,42511,0,7,7,37,47,1897
61415,61415,D5746F30DC8775BC56CB551C6292738D,10161,8,14,6,35,49,1799
61416,61416,D5746F30DC8775BC56CB551C6292738D,11731,14,17,3,36,48,1848
61417,61417,D5746F30DC8775BC56CB551C6292738D,42471,18,21,3,35,49,1799
61418,61418,BFC65A772F56ED7228E9E2AFA9CCDE44,19114,0,6,6,7,43,393
61419,61419,BFC65A772F56ED7228E9E2AFA9CCDE44,12641,7,8,1,10,43,543
61420,61420,BFC65A772F56ED7228E9E2AFA9CCDE44,19114,12,19,7,7,43,393
61421,61421,BFC65A772F56ED7228E9E2AFA9CCDE44,19901,20,23,3,7,44,394
61422,61422,8827A35309A216F0F6E4CBB2FFAC456D,12083,0,1,1,36,49,1849
61423,61423,8827A35309A216F0F6E4CBB2FFAC456D,11954,2,18,16,32,49,1649
61424,61424,8827A35309A216F0F6E4CBB2FFAC456D,11201,20,22,2,35,49,1799
61425,61425,ECEB1342A1EB2D152DA98DC0CA47ED06,10471,0,13,13,37,48,1898
61426,61426,ECEB1342A1EB2D152DA98DC0CA47ED06,42581,14,16,2,38,48,1948
61427,61427,ECEB1342A1EB2D152DA98DC0CA47ED06,11914,16,23,7,37,48,1898
61428,61428,D7EAC5D0A8923EFA7A868664FAB3C316,42231,0,7,7,37,46,1896
61429,61429,D7EAC5D0A8923EFA7A868664FAB3C316,43671,11,12,1,35,48,1798
61430,61430,D7EAC5D0A8923EFA7A868664FAB3C316,42231,14,23,9,37,46,1896
61438,61438,1B3E2B40FE85118B6153584A8B129202,10901,0,2,2,35,48,1798
61439,61439,1B3E2B40FE85118B6153584A8B129202,11231,2,9,7,37,49,1899
61440,61440,1B3E2B40FE85118B6153584A8B129202,43281,13,15,2,37,48,1898
61441,61441,1B3E2B40FE85118B6153584A8B129202,11231,15,20,5,37,49,1899
61442,61442,7875A34DC3B1C1A6D18480769685A825,42231,6,16,10,37,46,1896
61443,61443,7875A34DC3B1C1A6D18480769685A825,13911,18,20,2,39,46,1996
61444,61444,7875A34DC3B1C1A6D18480769685A825,42231,20,22,2,37,46,1896
61445,61445,F2971C3C111263F217176C0D8DBD4C49,40981,0,6,6,34,47,1747
61446,61446,F2971C3C111263F217176C0D8DBD4C49,11914,7,11,4,37,48,1898
61447,61447,F2971C3C111263F217176C0D8DBD4C49,13601,16,23,7,34,47,1747
61451,61451,775CA947FF37432092AA3395F5AA137B,11171,0,7,7,33,48,1698
61452,61452,775CA947FF37432092AA3395F5AA137B,43731,9,11,2,34,47,1747
61453,61453,775CA947FF37432092AA3395F5AA137B,10971,13,14,1,35,47,1797
61454,61454,775CA947FF37432092AA3395F5AA137B,10731,19,22,3,33,47,1697
61455,61455,E6F8B18996A93B41942201687916F106,11231,0,5,5,37,49,1899
61456,61456,E6F8B18996A93B41942201687916F106,10471,10,18,8,37,48,1898
61457,61457,E6F8B18996A93B41942201687916F106,11461,18,23,5,37,49,1899
61483,61483,6F881E54FD8247C10253271465BFC769,10111,0,8,8,37,47,1897
61484,61484,6F881E54FD8247C10253271465BFC769,10107,10,12,2,38,49,1949
61485,61485,6F881E54FD8247C10253271465BFC769,10111,13,22,9,37,47,1897
61492,61492,806223F4E6A75E30DD9FB8BC0E922847,11061,1,3,2,29,48,1498
61493,61493,806223F4E6A75E30DD9FB8BC0E922847,11151,5,6,1,30,48,1548
61494,61494,806223F4E6A75E30DD9FB8BC0E922847,11061,6,22,16,29,48,1498
61495,61495,49494FBB6849DE6DF9F2753503D24C12,11875,3,7,4,30,46,1546
61496,61496,49494FBB6849DE6DF9F2753503D24C12,11324,7,10,3,31,46,1596
61497,61497,49494FBB6849DE6DF9F2753503D24C12,11151,14,18,4,30,48,1548
61528,61528,F97249A6324768A56E44D27A08FDE9D8,11941,0,14,14,37,46,1896
61529,61529,F97249A6324768A56E44D27A08FDE9D8,13711,16,17,1,38,46,1946
61530,61530,F97249A6324768A56E44D27A08FDE9D8,13221,19,21,2,40,47,2047
61531,61531,F97249A6324768A56E44D27A08FDE9D8,11941,21,23,2,37,46,1896
61532,61532,9D2F8B673CF5A851F245B3DD21FD08F4,10251,0,7,7,35,47,1797
61533,61533,9D2F8B673CF5A851F245B3DD21FD08F4,10111,8,10,2,37,47,1897
61534,61534,9D2F8B673CF5A851F245B3DD21FD08F4,42161,13,15,2,36,47,1847
61535,61535,9D2F8B673CF5A851F245B3DD21FD08F4,10111,17,21,4,37,47,1897
61553,61553,B4B9EF8B2509C5B7E6B8F05B2AFC5406,10841,3,11,8,37,47,1897
61554,61554,B4B9EF8B2509C5B7E6B8F05B2AFC5406,11791,15,21,6,38,49,1949
61555,61555,B4B9EF8B2509C5B7E6B8F05B2AFC5406,11074,22,23,1,37,47,1897
61561,61561,D3B7E592123DB083081A1FE3F2020361,19744,2,4,2,6,43,343
61562,61562,D3B7E592123DB083081A1FE3F2020361,49201,8,17,9,7,41,391
61563,61563,D3B7E592123DB083081A1FE3F2020361,19741,21,23,2,5,44,294
61579,61579,8A35309960304DAF98A2649637AD86E1,10634,0,10,10,27,45,1395
61580,61580,8A35309960304DAF98A2649637AD86E1,10351,12,17,5,28,45,1445
61581,61581,8A35309960304DAF98A2649637AD86E1,10634,22,23,1,27,45,1395
61588,61588,B324CCFCD3F5330D2BA1EBE28CA2A657,13101,0,6,6,40,47,2047
61589,61589,B324CCFCD3F5330D2BA1EBE28CA2A657,13271,9,10,1,41,47,2097
61590,61590,B324CCFCD3F5330D2BA1EBE28CA2A657,13101,10,20,10,40,47,2047
61604,61604,B9E127195A4DFA1F988A0F90827556AB,13821,1,8,7,49,45,2495
61605,61605,B9E127195A4DFA1F988A0F90827556AB,13951,12,13,1,47,45,2395
61606,61606,B9E127195A4DFA1F988A0F90827556AB,13821,17,22,5,49,45,2495
61607,61607,AC38F90B82E2DAAA768172BDE9BA8C19,13711,0,7,7,38,46,1946
61608,61608,AC38F90B82E2DAAA768172BDE9BA8C19,10191,8,15,7,40,48,2048
61609,61609,AC38F90B82E2DAAA768172BDE9BA8C19,42511,18,20,2,37,47,1897
61621,61621,FE84C5B6FD29AD1D9C75D32BF19FA780,42861,0,4,4,37,44,1894
61622,61622,FE84C5B6FD29AD1D9C75D32BF19FA780,11261,5,20,15,36,46,1846
61623,61623,FE84C5B6FD29AD1D9C75D32BF19FA780,42861,21,22,1,37,44,1894
61624,61624,BD517E29BD7069EA61B2CA0844AA760E,10731,0,6,6,33,47,1697
61625,61625,BD517E29BD7069EA61B2CA0844AA760E,43761,11,12,1,32,47,1647
61626,61626,BD517E29BD7069EA61B2CA0844AA760E,10731,12,23,11,33,47,1697
61637,61637,358FC998043B5C3A903BCE0066714FE4,43731,0,12,12,34,47,1747
61638,61638,358FC998043B5C3A903BCE0066714FE4,10154,14,22,8,33,47,1697
61639,61639,358FC998043B5C3A903BCE0066714FE4,12514,22,23,1,38,47,1947
61640,61640,D454F61AD8B5A1CBE1E15CE597E2F528,11231,0,2,2,37,49,1899
61641,61641,D454F61AD8B5A1CBE1E15CE597E2F528,42301,2,7,5,36,47,1847
61642,61642,D454F61AD8B5A1CBE1E15CE597E2F528,11231,8,23,15,37,49,1899
61650,61650,8A6733FDC0C9C057F881E617DF5C5C85,12131,0,8,8,32,47,1647
61651,61651,8A6733FDC0C9C057F881E617DF5C5C85,42301,9,18,9,36,47,1847
61652,61652,8A6733FDC0C9C057F881E617DF5C5C85,12131,18,23,5,32,47,1647
61653,61653,11849A0C6E3DBDCA3EC6DC71C5369D13,43451,0,10,10,37,40,1890
61654,61654,11849A0C6E3DBDCA3EC6DC71C5369D13,12521,13,15,2,35,41,1791
61655,61655,11849A0C6E3DBDCA3EC6DC71C5369D13,43451,15,23,8,37,40,1890
61677,61677,4C8E92DBB85921608C1C92929A7A8C92,42521,0,6,6,31,47,1597
61678,61678,4C8E92DBB85921608C1C92929A7A8C92,11384,6,10,4,30,47,1547
61679,61679,4C8E92DBB85921608C1C92929A7A8C92,42521,13,23,10,31,47,1597
61683,61683,7119FA80BA5C294B9E0D9F9B5B795010,11171,1,7,6,33,48,1698
61684,61684,7119FA80BA5C294B9E0D9F9B5B795010,43311,8,9,1,31,48,1598
61685,61685,7119FA80BA5C294B9E0D9F9B5B795010,12131,12,14,2,32,47,1647
61686,61686,7119FA80BA5C294B9E0D9F9B5B795010,11061,18,20,2,29,48,1498
61712,61712,3CA59C7696A3F1D3B3B3AC13E43E394F,13711,0,5,5,38,46,1946
61713,61713,3CA59C7696A3F1D3B3B3AC13E43E394F,42231,9,12,3,37,46,1896
61714,61714,3CA59C7696A3F1D3B3B3AC13E43E394F,13711,17,18,1,38,46,1946
61718,61718,84E49EF54F0220E8EC6260AB7D251510,13941,0,11,11,41,47,2097
61719,61719,84E49EF54F0220E8EC6260AB7D251510,11001,12,13,1,42,47,2147
61720,61720,84E49EF54F0220E8EC6260AB7D251510,13941,14,21,7,41,47,2097
61721,61721,32AC91C579537C342509FFEF215ABF36,13121,0,11,11,38,46,1946
61722,61722,32AC91C579537C342509FFEF215ABF36,42511,12,13,1,37,47,1897
61723,61723,32AC91C579537C342509FFEF215ABF36,43241,15,23,8,36,46,1846
61732,61732,C10EEFAF39D689A1C1E5FEB245DEDC71,40872,0,10,10,30,49,1549
61733,61733,C10EEFAF39D689A1C1E5FEB245DEDC71,11061,11,12,1,29,48,1498
61734,61734,C10EEFAF39D689A1C1E5FEB245DEDC71,10381,18,21,3,31,49,1599
61735,61735,C10EEFAF39D689A1C1E5FEB245DEDC71,11061,21,23,2,29,48,1498
61736,61736,77DE4D89070B9EFEB461D22F72589B88,11381,0,9,9,30,47,1547
61737,61737,77DE4D89070B9EFEB461D22F72589B88,11861,11,17,6,32,47,1647
61738,61738,77DE4D89070B9EFEB461D22F72589B88,11381,20,23,3,30,47,1547
61739,61739,16B390B832AB5B215AEBCE3943DDFC81,11231,0,1,1,37,49,1899
61740,61740,16B390B832AB5B215AEBCE3943DDFC81,10251,2,12,10,35,47,1797
61741,61741,16B390B832AB5B215AEBCE3943DDFC81,42161,14,23,9,36,47,1847
61757,61757,1DD07CF7FD5B3CCCB4E85025836774E4,12841,0,7,7,37,47,1897
61758,61758,1DD07CF7FD5B3CCCB4E85025836774E4,10371,8,18,10,37,49,1899
61759,61759,1DD07CF7FD5B3CCCB4E85025836774E4,12841,19,21,2,37,47,1897
61766,61766,8A2B6A3BBB67F4CA1B157F83176E3E9B,11151,1,2,1,30,48,1548
61767,61767,8A2B6A3BBB67F4CA1B157F83176E3E9B,10381,3,4,1,31,49,1599
61768,61768,8A2B6A3BBB67F4CA1B157F83176E3E9B,11151,8,22,14,30,48,1548
61777,61777,4A7EF801268FA87DD49AA705DCA560E1,11914,2,6,4,37,48,1898
61778,61778,4A7EF801268FA87DD49AA705DCA560E1,42581,8,21,13,38,48,1948
61779,61779,4A7EF801268FA87DD49AA705DCA560E1,10107,21,23,2,38,49,1949
61786,61786,83B65A620AA8887006B94BCE755E769B,10351,1,12,11,28,45,1445
61787,61787,83B65A620AA8887006B94BCE755E769B,10634,12,14,2,27,45,1395
61788,61788,83B65A620AA8887006B94BCE755E769B,10351,17,23,6,28,45,1445
61789,61789,9A519709635398D7673DD5F4D42C6C46,42151,0,6,6,35,45,1795
61790,61790,9A519709635398D7673DD5F4D42C6C46,12491,8,9,1,36,43,1843
61791,61791,9A519709635398D7673DD5F4D42C6C46,42151,13,17,4,35,45,1795
61792,61792,9A519709635398D7673DD5F4D42C6C46,12491,20,21,1,36,43,1843
61793,61793,A573FF285872EC96818445928AD4461A,11281,2,7,5,27,40,1390
61794,61794,A573FF285872EC96818445928AD4461A,13671,8,11,3,27,43,1393
61795,61795,A573FF285872EC96818445928AD4461A,11281,12,13,1,27,40,1390
61796,61796,A573FF285872EC96818445928AD4461A,13671,13,22,9,27,43,1393
61797,61797,2267A6F43D82FD9160A39965307DF9F2,12491,0,6,6,36,43,1843
61798,61798,2267A6F43D82FD9160A39965307DF9F2,42151,8,12,4,35,45,1795
61799,61799,2267A6F43D82FD9160A39965307DF9F2,12491,15,19,4,36,43,1843
61800,61800,2267A6F43D82FD9160A39965307DF9F2,42861,21,22,1,37,44,1894
61806,61806,B377B1A009BB64894719A8DF0AC3F76E,11231,1,15,14,37,49,1899
61807,61807,B377B1A009BB64894719A8DF0AC3F76E,10901,16,17,1,35,48,1798
61808,61808,B377B1A009BB64894719A8DF0AC3F76E,11231,18,23,5,37,49,1899
61809,61809,4F3F717E93BC5AFE00C4421DCBF0AA01,42301,0,10,10,36,47,1847
61810,61810,4F3F717E93BC5AFE00C4421DCBF0AA01,11261,12,20,8,36,46,1846
61811,61811,4F3F717E93BC5AFE00C4421DCBF0AA01,40322,21,22,1,38,46,1946
61817,61817,A0C13743AF441FE8099AA940DA71C612,42581,0,10,10,38,48,1948
61818,61818,A0C13743AF441FE8099AA940DA71C612,11914,10,11,1,37,48,1898
61819,61819,A0C13743AF441FE8099AA940DA71C612,42581,12,22,10,38,48,1948
61826,61826,4FA7E2AF35091649A8D61648BF92F5C0,42581,0,7,7,38,48,1948
61827,61827,4FA7E2AF35091649A8D61648BF92F5C0,10471,7,11,4,37,48,1898
61828,61828,4FA7E2AF35091649A8D61648BF92F5C0,42581,12,13,1,38,48,1948
61829,61829,4FA7E2AF35091649A8D61648BF92F5C0,10471,14,23,9,37,48,1898
61834,61834,FD5EF28EAD4BB7B6215FEE28B08DAD3E,12661,0,14,14,32,45,1645
61835,61835,FD5EF28EAD4BB7B6215FEE28B08DAD3E,12311,15,17,2,30,44,1544
61836,61836,FD5EF28EAD4BB7B6215FEE28B08DAD3E,12661,17,23,6,32,45,1645
61845,61845,4EE03FFA0C4FF49C75D4CC57D6F13E5A,40833,0,15,15,41,47,2097
61846,61846,4EE03FFA0C4FF49C75D4CC57D6F13E5A,11481,17,19,2,41,48,2098
61847,61847,4EE03FFA0C4FF49C75D4CC57D6F13E5A,40833,19,23,4,41,47,2097
61857,61857,5B985E49A96AC1F29BC71E54AB886B64,10351,5,14,9,28,45,1445
61858,61858,5B985E49A96AC1F29BC71E54AB886B64,10634,16,17,1,27,45,1395
61859,61859,5B985E49A96AC1F29BC71E54AB886B64,12121,21,23,2,29,47,1497
61868,61868,FCF6425DA3F542476DF1F93935C075D8,42581,5,8,3,38,48,1948
61869,61869,FCF6425DA3F542476DF1F93935C075D8,11914,8,11,3,37,48,1898
61870,61870,FCF6425DA3F542476DF1F93935C075D8,42581,11,23,12,38,48,1948
61871,61871,515D7C29684A1DFD6F920D5969F70CEE,13411,2,11,9,49,42,2492
61872,61872,515D7C29684A1DFD6F920D5969F70CEE,43951,13,15,2,49,41,2491
61873,61873,515D7C29684A1DFD6F920D5969F70CEE,13411,15,23,8,49,42,2492
61877,61877,D4191700C633456D6E890AE49001CB88,10951,0,15,15,29,48,1498
61878,61878,D4191700C633456D6E890AE49001CB88,11381,15,16,1,30,47,1547
61879,61879,D4191700C633456D6E890AE49001CB88,10951,17,21,4,29,48,1498
61900,61900,1129CFAE9FE6FF8D7F89EAB9AE20D07F,19441,3,6,3,8,46,446
61901,61901,1129CFAE9FE6FF8D7F89EAB9AE20D07F,42041,9,11,2,10,47,547
61902,61902,1129CFAE9FE6FF8D7F89EAB9AE20D07F,19441,13,19,6,8,46,446
61913,61913,CE46A02CA196948C3D07DA5CEEB7BE83,43101,0,6,6,46,40,2340
61914,61914,CE46A02CA196948C3D07DA5CEEB7BE83,13551,6,11,5,45,38,2288
61915,61915,CE46A02CA196948C3D07DA5CEEB7BE83,43101,11,18,7,46,40,2340
61922,61922,2764B8ABB23930F22F4F0762C2A18E7E,13711,0,7,7,38,46,1946
61923,61923,2764B8ABB23930F22F4F0762C2A18E7E,42231,7,17,10,37,46,1896
61924,61924,2764B8ABB23930F22F4F0762C2A18E7E,13711,21,22,1,38,46,1946
61925,61925,A2F45BD656CFFF997F97BA7E53A45E3F,13731,7,8,1,33,49,1699
61926,61926,A2F45BD656CFFF997F97BA7E53A45E3F,11951,9,10,1,31,49,1599
61927,61927,A2F45BD656CFFF997F97BA7E53A45E3F,13731,13,19,6,33,49,1699
61928,61928,46ED4A10E04186902C6EC8351807C818,11231,3,5,2,37,49,1899
61929,61929,46ED4A10E04186902C6EC8351807C818,10471,6,11,5,37,48,1898
61930,61930,46ED4A10E04186902C6EC8351807C818,11231,11,23,12,37,49,1899
61936,61936,7F73A642AA11134206C46BA15C785E40,42491,0,7,7,32,46,1646
61937,61937,7F73A642AA11134206C46BA15C785E40,42521,9,13,4,31,47,1597
61938,61938,7F73A642AA11134206C46BA15C785E40,10295,16,23,7,30,47,1547
61939,61939,4A69CEF881C930B26BF97D2854913ACB,43951,0,15,15,49,41,2491
61940,61940,4A69CEF881C930B26BF97D2854913ACB,43101,18,19,1,46,40,2340
61941,61941,4A69CEF881C930B26BF97D2854913ACB,43951,19,23,4,49,41,2491
61942,61942,256716E7BC700918221B302D675AB769,12381,0,9,9,32,48,1648
61943,61943,256716E7BC700918221B302D675AB769,10721,12,15,3,31,48,1598
61944,61944,256716E7BC700918221B302D675AB769,10681,18,19,1,30,48,1548
61945,61945,256716E7BC700918221B302D675AB769,13651,19,23,4,30,47,1547
61956,61956,22D95CF8B35CF82DEFAFF52E8ADB9EF4,42523,1,10,9,31,47,1597
61957,61957,22D95CF8B35CF82DEFAFF52E8ADB9EF4,10292,10,11,1,30,47,1547
61958,61958,22D95CF8B35CF82DEFAFF52E8ADB9EF4,42523,11,22,11,31,47,1597
61959,61959,FC707C73D6614611D82A13C2F325D332,42511,3,8,5,37,47,1897
61960,61960,FC707C73D6614611D82A13C2F325D332,43731,12,13,1,34,47,1747
61961,61961,FC707C73D6614611D82A13C2F325D332,11021,14,20,6,36,49,1849
61962,61962,C7FA80290FB045053FA2F8726750C68B,13651,2,11,9,30,47,1547
61963,61963,C7FA80290FB045053FA2F8726750C68B,42523,13,16,3,31,47,1597
61964,61964,C7FA80290FB045053FA2F8726750C68B,13651,18,23,5,30,47,1547
61988,61988,DD4D28FDBCFFE930AF28BD3956ED9308,11381,0,6,6,30,47,1547
61989,61989,DD4D28FDBCFFE930AF28BD3956ED9308,11861,7,8,1,32,47,1647
61990,61990,DD4D28FDBCFFE930AF28BD3956ED9308,11381,8,21,13,30,47,1547
62002,62002,A6FB8806348882E3287150AAB70E5425,42141,3,10,7,32,47,1647
62003,62003,A6FB8806348882E3287150AAB70E5425,13601,13,15,2,34,47,1747
62004,62004,A6FB8806348882E3287150AAB70E5425,43761,18,22,4,32,47,1647
62005,62005,A282F8B8C498C4B735512F5B780D9B09,11061,0,8,8,29,48,1498
62006,62006,A282F8B8C498C4B735512F5B780D9B09,10721,11,15,4,31,48,1598
62007,62007,A282F8B8C498C4B735512F5B780D9B09,11061,17,23,6,29,48,1498
62008,62008,302E13281DC08AB4B0CB613D73ADA12A,11381,0,6,6,30,47,1547
62009,62009,302E13281DC08AB4B0CB613D73ADA12A,42501,7,17,10,28,47,1447
62010,62010,302E13281DC08AB4B0CB613D73ADA12A,11381,19,23,4,30,47,1547
62011,62011,98D3E1EE2095643112C3E532CBE55835,43061,7,9,2,43,46,2196
62012,62012,98D3E1EE2095643112C3E532CBE55835,13341,11,13,2,44,45,2245
62013,62013,98D3E1EE2095643112C3E532CBE55835,43061,13,22,9,43,46,2196
62022,62022,A71AF189763CBF3E45D468B893870CE7,10901,0,8,8,35,48,1798
62023,62023,A71AF189763CBF3E45D468B893870CE7,40951,12,15,3,36,49,1849
62024,62024,A71AF189763CBF3E45D468B893870CE7,10901,18,23,5,35,48,1798
62025,62025,53493041487B5321836147FAAD536213,40833,5,6,1,41,47,2097
62026,62026,53493041487B5321836147FAAD536213,11074,10,19,9,37,47,1897
62027,62027,53493041487B5321836147FAAD536213,40833,19,21,2,41,47,2097
62062,62062,F5CAB8F803ECE6BB91E5E9B3677179B2,11781,0,1,1,38,49,1949
62063,62063,F5CAB8F803ECE6BB91E5E9B3677179B2,10111,1,8,7,37,47,1897
62064,62064,F5CAB8F803ECE6BB91E5E9B3677179B2,42231,10,11,1,37,46,1896
62065,62065,F5CAB8F803ECE6BB91E5E9B3677179B2,10111,13,22,9,37,47,1897
62066,62066,6F1358C6526C9CA4FB50AA20B6B16B03,11001,0,7,7,42,47,2147
62067,62067,6F1358C6526C9CA4FB50AA20B6B16B03,13941,7,10,3,41,47,2097
62068,62068,6F1358C6526C9CA4FB50AA20B6B16B03,11001,10,12,2,42,47,2147
62069,62069,6F1358C6526C9CA4FB50AA20B6B16B03,13941,14,21,7,41,47,2097
62070,62070,464DF91C83D752715121CBA55775E029,11381,0,17,17,30,47,1547
62071,62071,464DF91C83D752715121CBA55775E029,10381,18,20,2,31,49,1599
62072,62072,464DF91C83D752715121CBA55775E029,11381,22,23,1,30,47,1547
62079,62079,1E78C6812CC13AC596F7D7BD80A5DD70,11921,0,9,9,38,48,1948
62080,62080,1E78C6812CC13AC596F7D7BD80A5DD70,11074,10,11,1,37,47,1897
62081,62081,1E78C6812CC13AC596F7D7BD80A5DD70,11921,12,23,11,38,48,1948
62082,62082,E880DD3703242558096D10770FE10A54,13231,0,8,8,39,46,1996
62083,62083,E880DD3703242558096D10770FE10A54,11261,12,20,8,36,46,1846
62084,62084,E880DD3703242558096D10770FE10A54,42861,21,22,1,37,44,1894
62085,62085,82C2AAA304DDEBA254F62F054F59E7E2,11061,3,5,2,29,48,1498
62086,62086,82C2AAA304DDEBA254F62F054F59E7E2,10681,9,10,1,30,48,1548
62087,62087,82C2AAA304DDEBA254F62F054F59E7E2,43311,13,21,8,31,48,1598
62088,62088,82C2AAA304DDEBA254F62F054F59E7E2,11061,22,23,1,29,48,1498
62089,62089,4509CA6F4F6AE506CFF527F6805D5251,12921,3,5,2,9,41,491
62090,62090,4509CA6F4F6AE506CFF527F6805D5251,12641,8,10,2,10,43,543
62091,62091,4509CA6F4F6AE506CFF527F6805D5251,12921,11,12,1,9,41,491
62092,62092,4509CA6F4F6AE506CFF527F6805D5251,12641,17,18,1,10,43,543
62105,62105,C7B7BC9315B26F0822B647A376C0B876,43321,0,6,6,36,49,1849
62106,62106,C7B7BC9315B26F0822B647A376C0B876,11531,6,7,1,34,49,1749
62107,62107,C7B7BC9315B26F0822B647A376C0B876,11591,9,23,14,36,49,1849
62108,62108,2EF6C0FB2DECBC4A57AE198EC3FD678A,10971,0,14,14,35,47,1797
62109,62109,2EF6C0FB2DECBC4A57AE198EC3FD678A,42021,16,17,1,33,47,1697
62110,62110,2EF6C0FB2DECBC4A57AE198EC3FD678A,10971,17,22,5,35,47,1797
62111,62111,2FC430E1448F290A8E229F5C2301E320,49201,0,7,7,7,41,391
62112,62112,2FC430E1448F290A8E229F5C2301E320,12921,9,15,6,9,41,491
62113,62113,2FC430E1448F290A8E229F5C2301E320,49201,19,21,2,7,41,391
62129,62129,11C5ACA60B0246DE7069023057E8285F,11381,1,2,1,30,47,1547
62130,62130,11C5ACA60B0246DE7069023057E8285F,11061,3,5,2,29,48,1498
62131,62131,11C5ACA60B0246DE7069023057E8285F,11381,6,21,15,30,47,1547
62132,62132,5674984FCE5B2DA13047CB9492AF31B3,43101,7,11,4,46,40,2340
62133,62133,5674984FCE5B2DA13047CB9492AF31B3,43951,13,14,1,49,41,2491
62134,62134,5674984FCE5B2DA13047CB9492AF31B3,43101,14,16,2,46,40,2340
62135,62135,5674984FCE5B2DA13047CB9492AF31B3,43951,21,23,2,49,41,2491
62154,62154,FD12F0A20C30BFF802527C16390F8DF6,12083,0,10,10,36,49,1849
62155,62155,FD12F0A20C30BFF802527C16390F8DF6,13561,12,13,1,37,49,1899
62156,62156,FD12F0A20C30BFF802527C16390F8DF6,43321,19,23,4,36,49,1849
62157,62157,1A5DEB007188BBCFFE665C75C024CDE9,42531,0,3,3,31,45,1595
62158,62158,1A5DEB007188BBCFFE665C75C024CDE9,12121,4,5,1,29,47,1497
62159,62159,1A5DEB007188BBCFFE665C75C024CDE9,12311,7,8,1,30,44,1544
62160,62160,1A5DEB007188BBCFFE665C75C024CDE9,42531,10,23,13,31,45,1595
62161,62161,88D3AECB79C42D19C5311DB0C1B36772,10271,1,8,7,37,46,1896
62162,62162,88D3AECB79C42D19C5311DB0C1B36772,13711,9,10,1,38,46,1946
62163,62163,88D3AECB79C42D19C5311DB0C1B36772,10271,14,23,9,37,46,1896
62170,62170,30C49EE7A31FEEE7EEC894E81C72E143,11731,2,3,1,36,48,1848
62171,62171,30C49EE7A31FEEE7EEC894E81C72E143,11914,6,16,10,37,48,1898
62172,62172,30C49EE7A31FEEE7EEC894E81C72E143,42581,19,20,1,38,48,1948
62173,62173,30C49EE7A31FEEE7EEC894E81C72E143,11914,20,22,2,37,48,1898
62194,62194,E6AC57452A564977FA8F4CD52CD9B295,10281,1,8,7,33,48,1698
62195,62195,E6AC57452A564977FA8F4CD52CD9B295,11861,9,12,3,32,47,1647
62196,62196,E6AC57452A564977FA8F4CD52CD9B295,11201,14,21,7,35,49,1799
62197,62197,E6AC57452A564977FA8F4CD52CD9B295,11861,22,23,1,32,47,1647
62217,62217,61AF80679359D43A0E6925D92F08EE37,12641,5,6,1,10,43,543
62218,62218,61AF80679359D43A0E6925D92F08EE37,19744,8,18,10,6,43,343
62219,62219,61AF80679359D43A0E6925D92F08EE37,12641,20,22,2,10,43,543
62226,62226,CD8F8ECD6C484214361C94940E3BD476,42581,0,7,7,38,48,1948
62227,62227,CD8F8ECD6C484214361C94940E3BD476,10471,7,18,11,37,48,1898
62228,62228,CD8F8ECD6C484214361C94940E3BD476,42581,20,23,3,38,48,1948
62252,62252,2F1F7798F5E8889B4080CA59D71F0274,10271,0,7,7,37,46,1896
62253,62253,2F1F7798F5E8889B4080CA59D71F0274,11081,8,10,2,35,46,1796
62254,62254,2F1F7798F5E8889B4080CA59D71F0274,10271,11,23,12,37,46,1896
62255,62255,CE2F05770EAE7211AF1856B90409D64B,11074,0,7,7,37,47,1897
62256,62256,CE2F05770EAE7211AF1856B90409D64B,12514,11,16,5,38,47,1947
62257,62257,CE2F05770EAE7211AF1856B90409D64B,11074,16,20,4,37,47,1897
62268,62268,B92E89796812211C5B5F4FA9439F7E3F,43971,7,9,2,30,48,1548
62269,62269,B92E89796812211C5B5F4FA9439F7E3F,11061,13,18,5,29,48,1498
62270,62270,B92E89796812211C5B5F4FA9439F7E3F,43971,19,20,1,30,48,1548
62278,62278,4DA57F9F33C37E2CA21407DE781C18AF,13911,1,17,16,39,46,1996
62279,62279,4DA57F9F33C37E2CA21407DE781C18AF,11261,17,18,1,36,46,1846
62280,62280,4DA57F9F33C37E2CA21407DE781C18AF,42351,20,22,2,38,45,1945
62281,62281,C994B0BB00A5F5442EEA247C000D74C5,42531,0,14,14,31,45,1595
62282,62282,C994B0BB00A5F5442EEA247C000D74C5,10731,15,16,1,33,47,1697
62283,62283,C994B0BB00A5F5442EEA247C000D74C5,12311,17,18,1,30,44,1544
62284,62284,C994B0BB00A5F5442EEA247C000D74C5,42531,18,23,5,31,45,1595
62296,62296,3BE46C14B2CA2CE1D859CAF16A631486,13341,0,6,6,44,45,2245
62297,62297,3BE46C14B2CA2CE1D859CAF16A631486,12561,9,10,1,45,43,2293
62298,62298,3BE46C14B2CA2CE1D859CAF16A631486,13341,11,22,11,44,45,2245
62299,62299,FECE7AC23192530094A0C5004C1733FC,10841,0,12,12,37,47,1897
62300,62300,FECE7AC23192530094A0C5004C1733FC,12514,15,16,1,38,47,1947
62301,62301,FECE7AC23192530094A0C5004C1733FC,10841,18,22,4,37,47,1897
62302,62302,E3F44DE28D6CEC258072EF36DC7621EF,42231,0,2,2,37,46,1896
62303,62303,E3F44DE28D6CEC258072EF36DC7621EF,42331,5,8,3,39,46,1996
62304,62304,E3F44DE28D6CEC258072EF36DC7621EF,42351,13,14,1,38,45,1945
62305,62305,E3F44DE28D6CEC258072EF36DC7621EF,42331,18,21,3,39,46,1996
62313,62313,1E75C00E3AD6CAD770CB267492850EC7,11231,0,7,7,37,49,1899
62314,62314,1E75C00E3AD6CAD770CB267492850EC7,10471,7,12,5,37,48,1898
62315,62315,1E75C00E3AD6CAD770CB267492850EC7,11231,12,13,1,37,49,1899
62316,62316,1E75C00E3AD6CAD770CB267492850EC7,10471,14,23,9,37,48,1898
62322,62322,142E33308FFFBA6139E3C7076898EEEF,11171,1,7,6,33,48,1698
62323,62323,142E33308FFFBA6139E3C7076898EEEF,12381,8,10,2,32,48,1648
62324,62324,142E33308FFFBA6139E3C7076898EEEF,12131,10,14,4,32,47,1647
62325,62325,142E33308FFFBA6139E3C7076898EEEF,10681,19,20,1,30,48,1548
62326,62326,A1E88710F597AD993ACF1C23AEB06926,43481,0,8,8,39,48,1998
62327,62327,A1E88710F597AD993ACF1C23AEB06926,42271,9,18,9,40,47,2047
62328,62328,A1E88710F597AD993ACF1C23AEB06926,11074,18,19,1,37,47,1897
62329,62329,A1E88710F597AD993ACF1C23AEB06926,42271,20,23,3,40,47,2047
62343,62343,7EFF4C1F410EC0093C0E819DD0DC2E31,10471,0,15,15,37,48,1898
62344,62344,7EFF4C1F410EC0093C0E819DD0DC2E31,11811,15,21,6,38,49,1949
62345,62345,7EFF4C1F410EC0093C0E819DD0DC2E31,10471,22,23,1,37,48,1898
62349,62349,826B40817E61853148AFBFECB1C48C70,42861,8,10,2,37,44,1894
62350,62350,826B40817E61853148AFBFECB1C48C70,42864,12,16,4,38,44,1944
62351,62351,826B40817E61853148AFBFECB1C48C70,11261,20,23,3,36,46,1846
62352,62352,C7DA09D84BB6D5A3ABEAD976C8C0731E,42861,0,13,13,37,44,1894
62353,62353,C7DA09D84BB6D5A3ABEAD976C8C0731E,11261,16,18,2,36,46,1846
62354,62354,C7DA09D84BB6D5A3ABEAD976C8C0731E,42861,19,23,4,37,44,1894
62369,62369,2C19FDC386B0B2E924F75B25676D719F,42351,2,8,6,38,45,1945
62370,62370,2C19FDC386B0B2E924F75B25676D719F,42231,13,14,1,37,46,1896
62371,62371,2C19FDC386B0B2E924F75B25676D719F,42351,16,18,2,38,45,1945
62372,62372,2C19FDC386B0B2E924F75B25676D719F,42231,20,21,1,37,46,1896
62377,62377,C54D86E5520DA9763CF81E383AB734CE,11021,2,12,10,36,49,1849
62378,62378,C54D86E5520DA9763CF81E383AB734CE,13561,13,14,1,37,49,1899
62379,62379,C54D86E5520DA9763CF81E383AB734CE,11021,16,23,7,36,49,1849
62388,62388,7E44932A07C7D7264E1C5314212C4AE8,11875,0,13,13,30,46,1546
62389,62389,7E44932A07C7D7264E1C5314212C4AE8,12661,14,15,1,32,45,1645
62390,62390,7E44932A07C7D7264E1C5314212C4AE8,12311,15,17,2,30,44,1544
62391,62391,7E44932A07C7D7264E1C5314212C4AE8,11875,18,22,4,30,46,1546
62403,62403,57068447BEEE4D7969FF166D57966ECA,42541,0,5,5,25,47,1297
62404,62404,57068447BEEE4D7969FF166D57966ECA,11361,6,9,3,22,48,1148
62405,62405,57068447BEEE4D7969FF166D57966ECA,12581,9,11,2,24,48,1248
62406,62406,57068447BEEE4D7969FF166D57966ECA,42541,11,23,12,25,47,1297
62410,62410,C1677062502D8DBDAAAC7171DD4AB835,10471,0,7,7,37,48,1898
62411,62411,C1677062502D8DBDAAAC7171DD4AB835,11461,7,9,2,37,49,1899
62412,62412,C1677062502D8DBDAAAC7171DD4AB835,10471,11,23,12,37,48,1898
62421,62421,FE5EF0C2F4B69A84D6BDB6109B4735F8,42161,0,7,7,36,47,1847
62422,62422,FE5EF0C2F4B69A84D6BDB6109B4735F8,11074,9,19,10,37,47,1897
62423,62423,FE5EF0C2F4B69A84D6BDB6109B4735F8,42161,21,23,2,36,47,1847
62424,62424,4184E3FF971C281C08C6293355FE7F7B,11481,2,5,3,41,48,2098
62425,62425,4184E3FF971C281C08C6293355FE7F7B,13271,5,13,8,41,47,2097
62426,62426,4184E3FF971C281C08C6293355FE7F7B,11481,14,16,2,41,48,2098
62427,62427,4184E3FF971C281C08C6293355FE7F7B,13101,20,22,2,40,47,2047
62433,62433,E1C859FD8CC74565ED07635B54DBAB6A,43761,0,8,8,32,47,1647
62434,62434,E1C859FD8CC74565ED07635B54DBAB6A,12381,11,18,7,32,48,1648
62435,62435,E1C859FD8CC74565ED07635B54DBAB6A,10281,19,21,2,33,48,1698
62436,62436,E1C859FD8CC74565ED07635B54DBAB6A,43761,21,22,1,32,47,1647
62440,62440,D06ED8B4D9FD2B130F1A7C01723935F7,42981,0,13,13,36,49,1849
62441,62441,D06ED8B4D9FD2B130F1A7C01723935F7,13561,15,18,3,37,49,1899
62442,62442,D06ED8B4D9FD2B130F1A7C01723935F7,42981,20,21,1,36,49,1849
62443,62443,8A01C9E16CCB86049D1634AB29476876,13371,0,15,15,41,47,2097
62444,62444,8A01C9E16CCB86049D1634AB29476876,11001,18,20,2,42,47,2147
62445,62445,8A01C9E16CCB86049D1634AB29476876,13371,20,21,1,41,47,2097
62446,62446,DFD8BF631C440547C60772DE9273FCD9,11074,7,8,1,37,47,1897
62447,62447,DFD8BF631C440547C60772DE9273FCD9,42221,12,13,1,38,48,1948
62448,62448,DFD8BF631C440547C60772DE9273FCD9,11074,16,23,7,37,47,1897
62449,62449,8A063C000C18EFD5117E8B73289494F1,40343,0,6,6,24,49,1249
62450,62450,8A063C000C18EFD5117E8B73289494F1,10451,7,16,9,25,48,1298
62451,62451,8A063C000C18EFD5117E8B73289494F1,40343,21,23,2,24,49,1249
62452,62452,F7F55540D1700EB1D67BDB258A5D603C,10111,0,8,8,37,47,1897
62453,62453,F7F55540D1700EB1D67BDB258A5D603C,10107,10,12,2,38,49,1949
62454,62454,F7F55540D1700EB1D67BDB258A5D603C,10111,14,23,9,37,47,1897
62459,62459,83032CC6A0DAD180410F046AB9CA56B4,11381,0,9,9,30,47,1547
62460,62460,83032CC6A0DAD180410F046AB9CA56B4,40872,12,14,2,30,49,1549
62461,62461,83032CC6A0DAD180410F046AB9CA56B4,11381,14,19,5,30,47,1547
62465,62465,F8E5692DC64F594EE622EF21A4844BEB,19114,0,11,11,7,43,393
62466,62466,F8E5692DC64F594EE622EF21A4844BEB,12921,11,14,3,9,41,491
62467,62467,F8E5692DC64F594EE622EF21A4844BEB,49201,17,19,2,7,41,391
62468,62468,F8E5692DC64F594EE622EF21A4844BEB,19931,21,23,2,7,43,393
62474,62474,11D06946081E743464FDA798F610CA68,10491,0,7,7,33,48,1698
62475,62475,11D06946081E743464FDA798F610CA68,42161,10,12,2,36,47,1847
62476,62476,11D06946081E743464FDA798F610CA68,10491,12,23,11,33,48,1698
62490,62490,2C985E374948E01B1511C56B4538B456,42861,0,4,4,37,44,1894
62491,62491,2C985E374948E01B1511C56B4538B456,11261,6,7,1,36,46,1846
62492,62492,2C985E374948E01B1511C56B4538B456,42861,11,23,12,37,44,1894
62496,62496,B43BB970384273260753C70ED63969BC,40411,0,3,3,34,48,1748
62497,62497,B43BB970384273260753C70ED63969BC,13601,3,11,8,34,47,1747
62498,62498,B43BB970384273260753C70ED63969BC,40411,12,13,1,34,48,1748
62499,62499,B43BB970384273260753C70ED63969BC,13601,13,20,7,34,47,1747
62508,62508,8B162D826614AE6B0D3DB5A304485836,11914,8,11,3,37,48,1898
62509,62509,8B162D826614AE6B0D3DB5A304485836,42581,11,16,5,38,48,1948
62510,62510,8B162D826614AE6B0D3DB5A304485836,12401,19,23,4,39,49,1999
62516,62516,3A339A321F91E2B2781A6265774AF07D,42161,0,1,1,36,47,1847
62517,62517,3A339A321F91E2B2781A6265774AF07D,10251,4,9,5,35,47,1797
62518,62518,3A339A321F91E2B2781A6265774AF07D,42401,10,11,1,36,47,1847
62519,62519,3A339A321F91E2B2781A6265774AF07D,11231,13,23,10,37,49,1899
62523,62523,28515D617D35CD595700960864F39AC7,40673,0,1,1,36,48,1848
62524,62524,28515D617D35CD595700960864F39AC7,40637,1,12,11,36,47,1847
62525,62525,28515D617D35CD595700960864F39AC7,10107,16,18,2,38,49,1949
62537,62537,03ED86F5BE3D351350BAE58E2A3698E8,13681,0,5,5,38,47,1947
62538,62538,03ED86F5BE3D351350BAE58E2A3698E8,11231,9,11,2,37,49,1899
62539,62539,03ED86F5BE3D351350BAE58E2A3698E8,10651,12,14,2,36,49,1849
62540,62540,03ED86F5BE3D351350BAE58E2A3698E8,13681,19,23,4,38,47,1947
62541,62541,22FF92D5D02FB55EBF848B49B24CF4B1,42151,0,4,4,35,45,1795
62542,62542,22FF92D5D02FB55EBF848B49B24CF4B1,11261,4,7,3,36,46,1846
62543,62543,22FF92D5D02FB55EBF848B49B24CF4B1,42151,11,12,1,35,45,1795
62544,62544,22FF92D5D02FB55EBF848B49B24CF4B1,11261,16,23,7,36,46,1846
62545,62545,13B5C513A1ACDF6CE2E1EF8CB8D808EC,13381,0,6,6,39,47,1997
62546,62546,13B5C513A1ACDF6CE2E1EF8CB8D808EC,42581,7,9,2,38,48,1948
62547,62547,13B5C513A1ACDF6CE2E1EF8CB8D808EC,11806,9,19,10,41,48,2098
62548,62548,13B5C513A1ACDF6CE2E1EF8CB8D808EC,13101,22,23,1,40,47,2047
62552,62552,03FE0D0BD52A528C1B4DF1F3C44F085B,42231,8,9,1,37,46,1896
62553,62553,03FE0D0BD52A528C1B4DF1F3C44F085B,42351,13,15,2,38,45,1945
62554,62554,03FE0D0BD52A528C1B4DF1F3C44F085B,42231,15,23,8,37,46,1896
62561,62561,C09C0EAB86082A4D7E18052318E53A38,13601,0,4,4,34,47,1747
62562,62562,C09C0EAB86082A4D7E18052318E53A38,11531,5,10,5,34,49,1749
62563,62563,C09C0EAB86082A4D7E18052318E53A38,11753,12,13,1,35,48,1798
62564,62564,C09C0EAB86082A4D7E18052318E53A38,10151,14,19,5,34,47,1747
62573,62573,F270E2429049EC12B817A3B7398AF53A,40981,0,2,2,34,47,1747
62574,62574,F270E2429049EC12B817A3B7398AF53A,11331,2,14,12,37,48,1898
62575,62575,F270E2429049EC12B817A3B7398AF53A,10111,16,21,5,37,47,1897
62576,62576,BAF8CBAEABDF4063FF5ED369E100E588,12083,0,15,15,36,49,1849
62577,62577,BAF8CBAEABDF4063FF5ED369E100E588,11231,15,17,2,37,49,1899
62578,62578,BAF8CBAEABDF4063FF5ED369E100E588,12083,19,23,4,36,49,1849
62594,62594,7A3CCBEE1EF7E270B4B301C75856D62F,10731,6,9,3,33,47,1697
62595,62595,7A3CCBEE1EF7E270B4B301C75856D62F,11861,11,17,6,32,47,1647
62596,62596,7A3CCBEE1EF7E270B4B301C75856D62F,10281,20,21,1,33,48,1698
62597,62597,7A3CCBEE1EF7E270B4B301C75856D62F,42141,22,23,1,32,47,1647
62601,62601,9EF2E337C6D77F71D8F5E64DA4E76CDC,42461,0,6,6,45,47,2297
62602,62602,9EF2E337C6D77F71D8F5E64DA4E76CDC,42321,6,16,10,43,47,2197
62603,62603,9EF2E337C6D77F71D8F5E64DA4E76CDC,42461,22,23,1,45,47,2297
62608,62608,E0F1670DB5561200EEDBAB1833327673,11921,0,9,9,38,48,1948
62609,62609,E0F1670DB5561200EEDBAB1833327673,11074,10,20,10,37,47,1897
62610,62610,E0F1670DB5561200EEDBAB1833327673,11921,20,23,3,38,48,1948
62611,62611,17E142FE089D3E2C5457F1AE8F3FEC75,11551,0,13,13,39,49,1999
62612,62612,17E142FE089D3E2C5457F1AE8F3FEC75,42271,14,17,3,40,47,2047
62613,62613,17E142FE089D3E2C5457F1AE8F3FEC75,11551,21,23,2,39,49,1999
62614,62614,3E17C9F881E8F571652BFE5E841845EF,11861,0,10,10,32,47,1647
62615,62615,3E17C9F881E8F571652BFE5E841845EF,10281,10,17,7,33,48,1698
62616,62616,3E17C9F881E8F571652BFE5E841845EF,11861,17,19,2,32,47,1647
62617,62617,3E17C9F881E8F571652BFE5E841845EF,10491,19,21,2,33,48,1698
62618,62618,2FD89CCA6ACCAD66068A25483F42F123,10901,0,6,6,35,48,1798
62619,62619,2FD89CCA6ACCAD66068A25483F42F123,42981,8,9,1,36,49,1849
62620,62620,2FD89CCA6ACCAD66068A25483F42F123,11231,9,16,7,37,49,1899
62621,62621,2FD89CCA6ACCAD66068A25483F42F123,12083,20,22,2,36,49,1849
62625,62625,9F07E2341EC43516CD02BDC269F3E6AA,11381,6,13,7,30,47,1547
62626,62626,9F07E2341EC43516CD02BDC269F3E6AA,42291,14,15,1,29,48,1498
62627,62627,9F07E2341EC43516CD02BDC269F3E6AA,11381,16,23,7,30,47,1547
62628,62628,56547DCD12E76D718E2E60F15A40B9D5,10111,2,6,4,37,47,1897
62629,62629,56547DCD12E76D718E2E60F15A40B9D5,10781,9,15,6,35,47,1797
62630,62630,56547DCD12E76D718E2E60F15A40B9D5,10111,18,23,5,37,47,1897
62640,62640,E83888D24F9B489390D1BDDD69FB71BE,42861,0,11,11,37,44,1894
62641,62641,E83888D24F9B489390D1BDDD69FB71BE,11261,12,15,3,36,46,1846
62642,62642,E83888D24F9B489390D1BDDD69FB71BE,42861,16,18,2,37,44,1894
62646,62646,94208362745F4CC8136A1624AA480486,10161,0,7,7,35,49,1799
62647,62647,94208362745F4CC8136A1624AA480486,40951,9,13,4,36,49,1849
62648,62648,94208362745F4CC8136A1624AA480486,10901,13,15,2,35,48,1798
62649,62649,94208362745F4CC8136A1624AA480486,10161,16,22,6,35,49,1799
62658,62658,E5C174D2FF195FD116006ADE577A953D,10951,0,6,6,29,48,1498
62659,62659,E5C174D2FF195FD116006ADE577A953D,11151,7,16,9,30,48,1548
62660,62660,E5C174D2FF195FD116006ADE577A953D,11061,19,20,1,29,48,1498
62666,62666,CBC7BFCA8A8C6A27834AC5E27A34598D,10471,3,13,10,37,48,1898
62667,62667,CBC7BFCA8A8C6A27834AC5E27A34598D,42191,13,14,1,38,49,1949
62668,62668,CBC7BFCA8A8C6A27834AC5E27A34598D,10471,16,20,4,37,48,1898
62669,62669,C1D2C2901CF533B6CB18DAF48EC3DD33,10471,6,9,3,37,48,1898
62670,62670,C1D2C2901CF533B6CB18DAF48EC3DD33,11231,9,17,8,37,49,1899
62671,62671,C1D2C2901CF533B6CB18DAF48EC3DD33,10471,17,19,2,37,48,1898
62672,62672,1DD1A250791E8DE9D0B949B1DAE230C8,11861,0,1,1,32,47,1647
62673,62673,1DD1A250791E8DE9D0B949B1DAE230C8,10281,1,17,16,33,48,1698
62674,62674,1DD1A250791E8DE9D0B949B1DAE230C8,11861,18,20,2,32,47,1647
62675,62675,1DD1A250791E8DE9D0B949B1DAE230C8,11651,21,22,1,33,47,1697
62689,62689,48DCE60D429B0B1E7F2F1B7A462BF9BF,42523,2,9,7,31,47,1597
62690,62690,48DCE60D429B0B1E7F2F1B7A462BF9BF,42141,12,18,6,32,47,1647
62691,62691,48DCE60D429B0B1E7F2F1B7A462BF9BF,10281,21,22,1,33,48,1698
62709,62709,F3B16B9F2FE5D66DD896BE8E61C1FA80,10351,0,10,10,28,45,1445
62710,62710,F3B16B9F2FE5D66DD896BE8E61C1FA80,10301,10,11,1,31,45,1595
62711,62711,F3B16B9F2FE5D66DD896BE8E61C1FA80,10351,12,13,1,28,45,1445
62712,62712,F3B16B9F2FE5D66DD896BE8E61C1FA80,10301,17,21,4,31,45,1595
62716,62716,7F39CFD81893EF00CED4C98A6CC13D33,43761,0,2,2,32,47,1647
62717,62717,7F39CFD81893EF00CED4C98A6CC13D33,12121,3,4,1,29,47,1497
62718,62718,7F39CFD81893EF00CED4C98A6CC13D33,11381,7,10,3,30,47,1547
62719,62719,7F39CFD81893EF00CED4C98A6CC13D33,12121,11,23,12,29,47,1497
62720,62720,36E4D456967ADF7C503C23EAE8460AAD,42523,10,11,1,31,47,1597
62721,62721,36E4D456967ADF7C503C23EAE8460AAD,13651,11,13,2,30,47,1547
62722,62722,36E4D456967ADF7C503C23EAE8460AAD,42523,13,19,6,31,47,1597
62732,62732,2608EF09A9453938D173B9C76E555F7D,11201,9,15,6,35,49,1799
62733,62733,2608EF09A9453938D173B9C76E555F7D,11231,16,18,2,37,49,1899
62734,62734,2608EF09A9453938D173B9C76E555F7D,11201,19,22,3,35,49,1799
62735,62735,F18C7871BFB82CA1A349E44A5DE6D0B7,11021,0,18,18,36,49,1849
62736,62736,F18C7871BFB82CA1A349E44A5DE6D0B7,10221,19,21,2,34,49,1749
62737,62737,F18C7871BFB82CA1A349E44A5DE6D0B7,11021,21,23,2,36,49,1849
62738,62738,2F1464FA3DE631911E14FF6E04C24354,10841,0,9,9,37,47,1897
62739,62739,2F1464FA3DE631911E14FF6E04C24354,13711,13,16,3,38,46,1946
62740,62740,2F1464FA3DE631911E14FF6E04C24354,10841,16,23,7,37,47,1897
62754,62754,BEF31F045A546CF30A63CFBCD60FD3FA,13911,1,10,9,39,46,1996
62755,62755,BEF31F045A546CF30A63CFBCD60FD3FA,42231,13,14,1,37,46,1896
62756,62756,BEF31F045A546CF30A63CFBCD60FD3FA,11271,16,17,1,37,48,1898
62757,62757,BEF31F045A546CF30A63CFBCD60FD3FA,42231,17,23,6,37,46,1896
62758,62758,9C18D5F35FED46695B6E8D3FFD04FFAA,42523,8,15,7,31,47,1597
62759,62759,9C18D5F35FED46695B6E8D3FFD04FFAA,10292,16,18,2,30,47,1547
62760,62760,9C18D5F35FED46695B6E8D3FFD04FFAA,42523,18,23,5,31,47,1597
62761,62761,7FC20F0A7A8C59E7754FF95E5BEB796B,42301,0,5,5,36,47,1847
62762,62762,7FC20F0A7A8C59E7754FF95E5BEB796B,11261,5,19,14,36,46,1846
62763,62763,7FC20F0A7A8C59E7754FF95E5BEB796B,42301,21,22,1,36,47,1847
62767,62767,88A603B1BCE42C6F6D13A5849B96B526,42401,0,14,14,36,47,1847
62768,62768,88A603B1BCE42C6F6D13A5849B96B526,10471,16,17,1,37,48,1898
62769,62769,88A603B1BCE42C6F6D13A5849B96B526,42401,18,20,2,36,47,1847
62775,62775,DFA44588B9F7612E59AB24A1351E5F4F,12921,0,7,7,9,41,491
62776,62776,DFA44588B9F7612E59AB24A1351E5F4F,49201,11,17,6,7,41,391
62777,62777,DFA44588B9F7612E59AB24A1351E5F4F,12921,18,19,1,9,41,491
62778,62778,DFA44588B9F7612E59AB24A1351E5F4F,49201,21,22,1,7,41,391
62802,62802,482231C60E75752F61489BAC43B2B02B,10121,0,8,8,36,49,1849
62803,62803,482231C60E75752F61489BAC43B2B02B,11541,8,21,13,35,49,1799
62804,62804,482231C60E75752F61489BAC43B2B02B,10121,21,23,2,36,49,1849
62809,62809,E090AE745FE0157CE235544725EE3E3A,12514,1,6,5,38,47,1947
62810,62810,E090AE745FE0157CE235544725EE3E3A,13561,9,10,1,37,49,1899
62811,62811,E090AE745FE0157CE235544725EE3E3A,11021,12,13,1,36,49,1849
62812,62812,E090AE745FE0157CE235544725EE3E3A,13561,16,18,2,37,49,1899
62827,62827,033D572A71C2A065F335205114BD8E8C,12381,0,10,10,32,48,1648
62828,62828,033D572A71C2A065F335205114BD8E8C,11541,18,21,3,35,49,1799
62829,62829,033D572A71C2A065F335205114BD8E8C,12971,21,23,2,32,48,1648
62830,62830,AD7F7BB46EF09C86333AC9999F5D1555,10271,0,6,6,37,46,1896
62831,62831,AD7F7BB46EF09C86333AC9999F5D1555,10821,7,8,1,40,47,2047
62832,62832,AD7F7BB46EF09C86333AC9999F5D1555,10271,11,23,12,37,46,1896
62841,62841,7555BE56ECBD7A21A433BB338C4AD042,19114,0,11,11,7,43,393
62842,62842,7555BE56ECBD7A21A433BB338C4AD042,12641,14,16,2,10,43,543
62843,62843,7555BE56ECBD7A21A433BB338C4AD042,19114,16,20,4,7,43,393
62848,62848,62FA38A389BABCCC4CC0F0254784FA2D,42491,7,13,6,32,46,1646
62849,62849,62FA38A389BABCCC4CC0F0254784FA2D,42523,13,17,4,31,47,1597
62850,62850,62FA38A389BABCCC4CC0F0254784FA2D,13651,20,21,1,30,47,1547
62854,62854,BC96E9BE9AB8282E9B536BDC3B7082D4,12514,0,12,12,38,47,1947
62855,62855,BC96E9BE9AB8282E9B536BDC3B7082D4,11074,13,16,3,37,47,1897
62856,62856,BC96E9BE9AB8282E9B536BDC3B7082D4,12514,18,19,1,38,47,1947
62857,62857,BC96E9BE9AB8282E9B536BDC3B7082D4,11074,22,23,1,37,47,1897
62858,62858,086873B6FDDAA95F5D97B0E7D1FDE099,12511,1,8,7,39,47,1997
62859,62859,086873B6FDDAA95F5D97B0E7D1FDE099,13711,12,15,3,38,46,1946
62860,62860,086873B6FDDAA95F5D97B0E7D1FDE099,10191,18,22,4,40,48,2048
62861,62861,CFA87476FA1ACEC118AB18DCDD6E5B91,10281,0,6,6,33,48,1698
62862,62862,CFA87476FA1ACEC118AB18DCDD6E5B91,11021,9,16,7,36,49,1849
62863,62863,CFA87476FA1ACEC118AB18DCDD6E5B91,10281,20,23,3,33,48,1698
62864,62864,FC7EB9622F9DA93D9292A2CD4A392CDA,13911,1,4,3,39,46,1996
62865,62865,FC7EB9622F9DA93D9292A2CD4A392CDA,11261,7,8,1,36,46,1846
62866,62866,FC7EB9622F9DA93D9292A2CD4A392CDA,13911,8,9,1,39,46,1996
62867,62867,FC7EB9622F9DA93D9292A2CD4A392CDA,11261,14,22,8,36,46,1846
62873,62873,AD235EE6A83CA7956AB86E8BC887D3C7,11541,0,6,6,35,49,1799
62874,62874,AD235EE6A83CA7956AB86E8BC887D3C7,13561,7,8,1,37,49,1899
62875,62875,AD235EE6A83CA7956AB86E8BC887D3C7,11021,8,16,8,36,49,1849
62876,62876,AD235EE6A83CA7956AB86E8BC887D3C7,11541,19,23,4,35,49,1799
62913,62913,B1886EF8F5487F8E8F1A6E89D17F4DF6,12311,0,5,5,30,44,1544
62914,62914,B1886EF8F5487F8E8F1A6E89D17F4DF6,42531,10,11,1,31,45,1595
62915,62915,B1886EF8F5487F8E8F1A6E89D17F4DF6,12311,12,13,1,30,44,1544
62916,62916,B1886EF8F5487F8E8F1A6E89D17F4DF6,42531,16,19,3,31,45,1595
62917,62917,DAD387A2DCE3783B15A7885935E82E97,11914,10,11,1,37,48,1898
62918,62918,DAD387A2DCE3783B15A7885935E82E97,42581,13,14,1,38,48,1948
62919,62919,DAD387A2DCE3783B15A7885935E82E97,11914,18,20,2,37,48,1898
62920,62920,A280969FD90AA928F73AE4BBEE919365,13101,0,8,8,40,47,2047
62921,62921,A280969FD90AA928F73AE4BBEE919365,11481,10,12,2,41,48,2098
62922,62922,A280969FD90AA928F73AE4BBEE919365,13101,12,22,10,40,47,2047
62932,62932,E2FC80C995A3EFA4B2AF01BAD4B24C1C,11074,7,8,1,37,47,1897
62933,62933,E2FC80C995A3EFA4B2AF01BAD4B24C1C,12083,9,11,2,36,49,1849
62934,62934,E2FC80C995A3EFA4B2AF01BAD4B24C1C,11074,12,14,2,37,47,1897
62935,62935,E2FC80C995A3EFA4B2AF01BAD4B24C1C,12083,18,19,1,36,49,1849
62936,62936,5DF7BADF34FEBA82E61DDC1448DA4B7A,42221,0,5,5,38,48,1948
62937,62937,5DF7BADF34FEBA82E61DDC1448DA4B7A,12514,6,9,3,38,47,1947
62938,62938,5DF7BADF34FEBA82E61DDC1448DA4B7A,42221,12,21,9,38,48,1948
62944,62944,66F421352C22D8571066F0AF8EA7BD0D,10251,1,15,14,35,47,1797
62945,62945,66F421352C22D8571066F0AF8EA7BD0D,42161,18,19,1,36,47,1847
62946,62946,66F421352C22D8571066F0AF8EA7BD0D,11861,20,22,2,32,47,1647
62952,62952,A7B416305440E955A1FE8389FFDA2219,11701,0,6,6,43,48,2198
62953,62953,A7B416305440E955A1FE8389FFDA2219,42321,9,15,6,43,47,2197
62954,62954,A7B416305440E955A1FE8389FFDA2219,11701,17,19,2,43,48,2198
62955,62955,960FD8FAF04E1E447A1CA2BDB9A16E8A,11861,0,6,6,32,47,1647
62956,62956,960FD8FAF04E1E447A1CA2BDB9A16E8A,11531,6,15,9,34,49,1749
62957,62957,960FD8FAF04E1E447A1CA2BDB9A16E8A,11861,17,23,6,32,47,1647
62972,62972,180E59219350A529BF92724D50866108,11074,0,4,4,37,47,1897
62973,62973,180E59219350A529BF92724D50866108,42583,4,5,1,40,48,2048
62974,62974,180E59219350A529BF92724D50866108,11074,7,16,9,37,47,1897
62975,62975,180E59219350A529BF92724D50866108,42221,22,23,1,38,48,1948
62976,62976,D0D24C7F1A65A68DAA38891FB1757B47,19441,0,6,6,8,46,446
62977,62977,D0D24C7F1A65A68DAA38891FB1757B47,42041,9,11,2,10,47,547
62978,62978,D0D24C7F1A65A68DAA38891FB1757B47,19441,15,18,3,8,46,446
62984,62984,C7D8479A948F794DCD982D33EA162F50,43361,0,6,6,38,48,1948
62985,62985,C7D8479A948F794DCD982D33EA162F50,11074,10,15,5,37,47,1897
62986,62986,C7D8479A948F794DCD982D33EA162F50,10107,17,18,1,38,49,1949
62987,62987,C7D8479A948F794DCD982D33EA162F50,43361,21,23,2,38,48,1948
62994,62994,FD926C96A4F9758B0E89829758CD18F3,10151,0,7,7,34,47,1747
62995,62995,FD926C96A4F9758B0E89829758CD18F3,40277,7,10,3,35,49,1799
62996,62996,FD926C96A4F9758B0E89829758CD18F3,42011,11,13,2,36,46,1846
62997,62997,FD926C96A4F9758B0E89829758CD18F3,11074,21,23,2,37,47,1897
63011,63011,EA1B5999CB4B3791BA146422C325007C,10301,0,10,10,31,45,1595
63012,63012,EA1B5999CB4B3791BA146422C325007C,11381,12,14,2,30,47,1547
63013,63013,EA1B5999CB4B3791BA146422C325007C,12661,18,19,1,32,45,1645
63014,63014,81677BBF6981E3D6E202B916ACF354DA,42161,0,6,6,36,47,1847
63015,63015,81677BBF6981E3D6E202B916ACF354DA,10111,10,12,2,37,47,1897
63016,63016,81677BBF6981E3D6E202B916ACF354DA,42301,14,19,5,36,47,1847
63035,63035,23F96418DBDA7106BDBB6C7E2C3432BD,42351,0,13,13,38,45,1945
63036,63036,23F96418DBDA7106BDBB6C7E2C3432BD,42231,16,17,1,37,46,1896
63037,63037,23F96418DBDA7106BDBB6C7E2C3432BD,42351,17,23,6,38,45,1945
63041,63041,74C90A586CDE5D22B85B5C9D6662CF52,19114,0,5,5,7,43,393
63042,63042,74C90A586CDE5D22B85B5C9D6662CF52,12641,6,11,5,10,43,543
63043,63043,74C90A586CDE5D22B85B5C9D6662CF52,19114,12,23,11,7,43,393
63044,63044,58B0725FA25DF85297C8BBDEAA0352D5,12521,0,2,2,35,41,1791
63045,63045,58B0725FA25DF85297C8BBDEAA0352D5,43451,2,4,2,37,40,1890
63046,63046,58B0725FA25DF85297C8BBDEAA0352D5,12521,5,21,16,35,41,1791
63063,63063,E99176074424BF1CA2C083C0DBF3C62C,12514,0,1,1,38,47,1947
63064,63064,E99176074424BF1CA2C083C0DBF3C62C,42221,3,9,6,38,48,1948
63065,63065,E99176074424BF1CA2C083C0DBF3C62C,12841,11,22,11,37,47,1897
63069,63069,A11021665283D6C62A5E3EE561A2FB8C,11261,0,8,8,36,46,1846
63070,63070,A11021665283D6C62A5E3EE561A2FB8C,13911,8,12,4,39,46,1996
63071,63071,A11021665283D6C62A5E3EE561A2FB8C,11261,12,14,2,36,46,1846
63072,63072,A11021665283D6C62A5E3EE561A2FB8C,42351,14,21,7,38,45,1945
63089,63089,758ECA2D694A442FBDD9376D536CAB79,43951,0,1,1,49,41,2491
63090,63090,758ECA2D694A442FBDD9376D536CAB79,13411,1,11,10,49,42,2492
63091,63091,758ECA2D694A442FBDD9376D536CAB79,43951,15,19,4,49,41,2491
63092,63092,5ABFABF55A302AC65CDD1BFE0186727A,11921,0,9,9,38,48,1948
63093,63093,5ABFABF55A302AC65CDD1BFE0186727A,10971,12,19,7,35,47,1797
63094,63094,5ABFABF55A302AC65CDD1BFE0186727A,11074,19,21,2,37,47,1897
63095,63095,5ABFABF55A302AC65CDD1BFE0186727A,11921,22,23,1,38,48,1948
63096,63096,2446E8F15BFC2A49F5E456D12DC187B8,43391,2,9,7,29,48,1498
63097,63097,2446E8F15BFC2A49F5E456D12DC187B8,42071,12,18,6,31,49,1599
63098,63098,2446E8F15BFC2A49F5E456D12DC187B8,43391,18,22,4,29,48,1498
63099,63099,0A3AEB60A6106F02C32A3904CC28A141,43121,0,9,9,25,27,1277
63100,63100,0A3AEB60A6106F02C32A3904CC28A141,15181,12,19,7,26,24,1324
63101,63101,0A3AEB60A6106F02C32A3904CC28A141,43121,21,22,1,25,27,1277
63102,63102,5A8308F9DAAF40265186D4E63F2640C9,10721,0,7,7,31,48,1598
63103,63103,5A8308F9DAAF40265186D4E63F2640C9,13731,10,20,10,33,49,1699
63104,63104,5A8308F9DAAF40265186D4E63F2640C9,12381,21,23,2,32,48,1648
63105,63105,C964AF9AEECDCF8E2D5C259A99901401,10251,0,8,8,35,47,1797
63106,63106,C964AF9AEECDCF8E2D5C259A99901401,41081,10,13,3,36,49,1849
63107,63107,C964AF9AEECDCF8E2D5C259A99901401,10251,14,23,9,35,47,1797
63112,63112,9F99A72527E81B89BEB16DB21B613CC0,10281,0,8,8,33,48,1698
63113,63113,9F99A72527E81B89BEB16DB21B613CC0,11861,8,16,8,32,47,1647
63114,63114,9F99A72527E81B89BEB16DB21B613CC0,10281,16,19,3,33,48,1698
63115,63115,9F99A72527E81B89BEB16DB21B613CC0,11861,20,22,2,32,47,1647
63125,63125,5084492A6A758A3CF1EF2B8D58F59187,11875,0,5,5,30,46,1546
63126,63126,5084492A6A758A3CF1EF2B8D58F59187,12311,8,18,10,30,44,1544
63127,63127,5084492A6A758A3CF1EF2B8D58F59187,11871,19,23,4,29,46,1496
63132,63132,1AA4035AA5CAFF9DEDB0DEF2EBA8DFEF,11914,0,7,7,37,48,1898
63133,63133,1AA4035AA5CAFF9DEDB0DEF2EBA8DFEF,11074,12,13,1,37,47,1897
63134,63134,1AA4035AA5CAFF9DEDB0DEF2EBA8DFEF,11914,14,22,8,37,48,1898
63135,63135,2B796358390FD846EE57DE8924EDBF14,42581,1,3,2,38,48,1948
63136,63136,2B796358390FD846EE57DE8924EDBF14,11914,6,12,6,37,48,1898
63137,63137,2B796358390FD846EE57DE8924EDBF14,42581,14,17,3,38,48,1948
63138,63138,2B796358390FD846EE57DE8924EDBF14,11914,18,20,2,37,48,1898
63139,63139,1E9E1B98E0714C60B9B6C0E5DCC0E407,11941,0,8,8,37,46,1896
63140,63140,1E9E1B98E0714C60B9B6C0E5DCC0E407,10251,10,17,7,35,47,1797
63141,63141,1E9E1B98E0714C60B9B6C0E5DCC0E407,11941,18,23,5,37,46,1896
63151,63151,2287B0D379AE62342F9E5A8FE93DC228,11021,0,7,7,36,49,1849
63152,63152,2287B0D379AE62342F9E5A8FE93DC228,13561,7,9,2,37,49,1899
63153,63153,2287B0D379AE62342F9E5A8FE93DC228,10651,13,22,9,36,49,1849
63154,63154,1513A2898BC89572E43E4D0B5B0440E4,12971,0,1,1,32,48,1648
63155,63155,1513A2898BC89572E43E4D0B5B0440E4,10731,12,13,1,33,47,1697
63156,63156,1513A2898BC89572E43E4D0B5B0440E4,12971,20,23,3,32,48,1648
63157,63157,F3CE6A0617707A9ABD8F0B15EBE138A8,13441,0,8,8,39,39,1989
63158,63158,F3CE6A0617707A9ABD8F0B15EBE138A8,13071,12,13,1,41,41,2091
63159,63159,F3CE6A0617707A9ABD8F0B15EBE138A8,13441,17,18,1,39,39,1989
63160,63160,7A89F90274317B23FC53152227A2C065,49201,1,9,8,7,41,391
63161,63161,7A89F90274317B23FC53152227A2C065,12921,9,10,1,9,41,491
63162,63162,7A89F90274317B23FC53152227A2C065,49201,11,21,10,7,41,391
63166,63166,26E97CCAAB10F50751FB25FC2D6D6457,11261,6,14,8,36,46,1846
63167,63167,26E97CCAAB10F50751FB25FC2D6D6457,42861,14,18,4,37,44,1894
63168,63168,26E97CCAAB10F50751FB25FC2D6D6457,11261,19,23,4,36,46,1846
63179,63179,2EFE2CC5C90B5BAC1EEDBA0A51560C5C,13911,6,16,10,39,46,1996
63180,63180,2EFE2CC5C90B5BAC1EEDBA0A51560C5C,11261,17,19,2,36,46,1846
63181,63181,2EFE2CC5C90B5BAC1EEDBA0A51560C5C,13911,20,22,2,39,46,1996
63195,63195,EA6ABF3B56A799EE15EC9952DF796E8E,11161,1,8,7,32,48,1648
63196,63196,EA6ABF3B56A799EE15EC9952DF796E8E,10721,10,12,2,31,48,1598
63197,63197,EA6ABF3B56A799EE15EC9952DF796E8E,11161,12,13,1,32,48,1648
63198,63198,EA6ABF3B56A799EE15EC9952DF796E8E,43761,15,21,6,32,47,1647
63199,63199,2808B465D0CA5BE626B66BA705E41B68,42351,0,4,4,38,45,1945
63200,63200,2808B465D0CA5BE626B66BA705E41B68,11261,6,12,6,36,46,1846
63201,63201,2808B465D0CA5BE626B66BA705E41B68,42861,17,18,1,37,44,1894
63202,63202,85AD2874D498116E81BFFFA0A5E4F159,42491,9,12,3,32,46,1646
63203,63203,85AD2874D498116E81BFFFA0A5E4F159,42523,14,15,1,31,47,1597
63204,63204,85AD2874D498116E81BFFFA0A5E4F159,42491,15,22,7,32,46,1646
63205,63205,9A1CB6044954B6099E36F60F8EE95A99,11381,0,19,19,30,47,1547
63206,63206,9A1CB6044954B6099E36F60F8EE95A99,10951,19,20,1,29,48,1498
63207,63207,9A1CB6044954B6099E36F60F8EE95A99,11381,21,23,2,30,47,1547
63208,63208,14C205DF57BD0AA586E26BE4ED695846,42581,1,6,5,38,48,1948
63209,63209,14C205DF57BD0AA586E26BE4ED695846,11914,6,7,1,37,48,1898
63210,63210,14C205DF57BD0AA586E26BE4ED695846,42581,11,23,12,38,48,1948
63216,63216,F8EA0C68F3C8266C3E7BA4F2FCE6F8BC,19441,3,7,4,8,46,446
63217,63217,F8EA0C68F3C8266C3E7BA4F2FCE6F8BC,42041,8,10,2,10,47,547
63218,63218,F8EA0C68F3C8266C3E7BA4F2FCE6F8BC,19441,12,23,11,8,46,446
63219,63219,3002B2FED862702A84F174A1C365CE90,42523,1,6,5,31,47,1597
63220,63220,3002B2FED862702A84F174A1C365CE90,43761,6,15,9,32,47,1647
63221,63221,3002B2FED862702A84F174A1C365CE90,42523,15,21,6,31,47,1597
63225,63225,FA05CF18A6BF06D3E5C89C49E2940179,11381,5,7,2,30,47,1547
63226,63226,FA05CF18A6BF06D3E5C89C49E2940179,11061,10,11,1,29,48,1498
63227,63227,FA05CF18A6BF06D3E5C89C49E2940179,11381,15,19,4,30,47,1547
63228,63228,C75781F60799DE2652DF86EC8BB9A296,10251,0,5,5,35,47,1797
63229,63229,C75781F60799DE2652DF86EC8BB9A296,42401,6,8,2,36,47,1847
63230,63230,C75781F60799DE2652DF86EC8BB9A296,10251,12,13,1,35,47,1797
63231,63231,C75781F60799DE2652DF86EC8BB9A296,42401,15,19,4,36,47,1847
63232,63232,B46F7CFBF42B8DF5990A028C3A15EF50,12311,0,2,2,30,44,1544
63233,63233,B46F7CFBF42B8DF5990A028C3A15EF50,42531,3,5,2,31,45,1595
63234,63234,B46F7CFBF42B8DF5990A028C3A15EF50,12311,5,6,1,30,44,1544
63235,63235,B46F7CFBF42B8DF5990A028C3A15EF50,42531,10,21,11,31,45,1595
63239,63239,8B15250505924ED8935A6E2820AF9A14,12921,7,9,2,9,41,491
63240,63240,8B15250505924ED8935A6E2820AF9A14,12641,13,15,2,10,43,543
63241,63241,8B15250505924ED8935A6E2820AF9A14,12921,18,20,2,9,41,491
63242,63242,3C5BF8354C7B22C00BFA5438C070BC0F,13711,0,15,15,38,46,1946
63243,63243,3C5BF8354C7B22C00BFA5438C070BC0F,43241,15,17,2,36,46,1846
63244,63244,3C5BF8354C7B22C00BFA5438C070BC0F,13711,17,19,2,38,46,1946
63245,63245,FC3B8910035FE6AFFCEFAAF1A5BD46D7,10471,0,11,11,37,48,1898
63246,63246,FC3B8910035FE6AFFCEFAAF1A5BD46D7,42191,14,15,1,38,49,1949
63247,63247,FC3B8910035FE6AFFCEFAAF1A5BD46D7,10471,18,23,5,37,48,1898
63248,63248,FF54487E0B5C80FA4088AB1638FB8194,42581,1,8,7,38,48,1948
63249,63249,FF54487E0B5C80FA4088AB1638FB8194,11794,9,10,1,38,49,1949
63250,63250,FF54487E0B5C80FA4088AB1638FB8194,11914,14,15,1,37,48,1898
63251,63251,FF54487E0B5C80FA4088AB1638FB8194,42581,15,23,8,38,48,1948
63255,63255,4B706CBBBDE9BF48F90679E8BB90E0D8,42351,6,7,1,38,45,1945
63256,63256,4B706CBBBDE9BF48F90679E8BB90E0D8,10601,12,14,2,39,47,1997
63257,63257,4B706CBBBDE9BF48F90679E8BB90E0D8,42231,14,21,7,37,46,1896
63258,63258,5832F798017EC944959971DE10E6C76B,13911,10,11,1,39,46,1996
63259,63259,5832F798017EC944959971DE10E6C76B,11261,15,18,3,36,46,1846
63260,63260,5832F798017EC944959971DE10E6C76B,10841,19,21,2,37,47,1897
63261,63261,CC026B1D95E317BEF1558C266B728FC7,42864,0,12,12,38,44,1944
63262,63262,CC026B1D95E317BEF1558C266B728FC7,11261,12,21,9,36,46,1846
63263,63263,CC026B1D95E317BEF1558C266B728FC7,42864,21,23,2,38,44,1944
63264,63264,D75859C5199E26E4E069299921FEC112,42921,0,8,8,33,47,1697
63265,63265,D75859C5199E26E4E069299921FEC112,43761,9,22,13,32,47,1647
63266,63266,D75859C5199E26E4E069299921FEC112,42921,22,23,1,33,47,1697
63273,63273,CEC2557E73B99D59943BE56AF1337C99,13121,0,3,3,38,46,1946
63274,63274,CEC2557E73B99D59943BE56AF1337C99,10271,7,10,3,37,46,1896
63275,63275,CEC2557E73B99D59943BE56AF1337C99,13121,15,21,6,38,46,1946
63276,63276,58160F8286644CCBCCC72FA14DAD9C05,19114,0,5,5,7,43,393
63277,63277,58160F8286644CCBCCC72FA14DAD9C05,12641,8,10,2,10,43,543
63278,63278,58160F8286644CCBCCC72FA14DAD9C05,19114,10,23,13,7,43,393
63284,63284,76780BDA1CE8853E5C6D6B4A56C0AC5B,11381,0,8,8,30,47,1547
63285,63285,76780BDA1CE8853E5C6D6B4A56C0AC5B,10951,9,12,3,29,48,1498
63286,63286,76780BDA1CE8853E5C6D6B4A56C0AC5B,11381,12,21,9,30,47,1547
63290,63290,33E38F12F8713108E12BCC9991D28568,11701,3,4,1,43,48,2198
63291,63291,33E38F12F8713108E12BCC9991D28568,42461,6,10,4,45,47,2297
63292,63292,33E38F12F8713108E12BCC9991D28568,42321,14,20,6,43,47,2197
63293,63293,B0DB1916CBE4951CF5091A191DB66ADA,13961,0,2,2,42,48,2148
63294,63294,B0DB1916CBE4951CF5091A191DB66ADA,13271,3,12,9,41,47,2097
63295,63295,B0DB1916CBE4951CF5091A191DB66ADA,13101,14,15,1,40,47,2047
63296,63296,B0DB1916CBE4951CF5091A191DB66ADA,13271,19,21,2,41,47,2097
63297,63297,09111B635170EC4072310ADB48522169,11021,1,9,8,36,49,1849
63298,63298,09111B635170EC4072310ADB48522169,42471,11,13,2,35,49,1799
63299,63299,09111B635170EC4072310ADB48522169,11021,13,22,9,36,49,1849
63303,63303,9A7DDF7206C87183C5ADD45F01E4890C,13511,0,13,13,34,48,1748
63304,63304,9A7DDF7206C87183C5ADD45F01E4890C,12083,14,15,1,36,49,1849
63305,63305,9A7DDF7206C87183C5ADD45F01E4890C,10111,16,19,3,37,47,1897
63306,63306,9A7DDF7206C87183C5ADD45F01E4890C,40673,19,21,2,36,48,1848
63327,63327,46D492BAB010922B2E00FA587B30756A,43951,0,10,10,49,41,2491
63328,63328,46D492BAB010922B2E00FA587B30756A,13411,10,11,1,49,42,2492
63329,63329,46D492BAB010922B2E00FA587B30756A,43951,12,18,6,49,41,2491
63336,63336,37EA74738D8CEB0116E54F8AF0894FC1,40343,0,12,12,24,49,1249
63337,63337,37EA74738D8CEB0116E54F8AF0894FC1,42261,12,15,3,25,49,1299
63338,63338,37EA74738D8CEB0116E54F8AF0894FC1,40343,18,23,5,24,49,1249
63352,63352,0DC8A33A5C3F9A4A9235A17DE75CFFD0,11021,0,17,17,36,49,1849
63353,63353,0DC8A33A5C3F9A4A9235A17DE75CFFD0,10221,17,20,3,34,49,1749
63354,63354,0DC8A33A5C3F9A4A9235A17DE75CFFD0,11021,22,23,1,36,49,1849
63371,63371,FB5A872D0FAE7AA0035523EB5DBD36C2,43761,7,9,2,32,47,1647
63372,63372,FB5A872D0FAE7AA0035523EB5DBD36C2,10281,9,11,2,33,48,1698
63373,63373,FB5A872D0FAE7AA0035523EB5DBD36C2,43761,11,19,8,32,47,1647
63374,63374,FB5A872D0FAE7AA0035523EB5DBD36C2,11324,21,23,2,31,46,1596
63391,63391,C1896697E8F9082F3C179E6CB902F84B,49181,1,8,7,21,31,1081
63392,63392,C1896697E8F9082F3C179E6CB902F84B,13141,10,17,7,23,30,1180
63393,63393,C1896697E8F9082F3C179E6CB902F84B,12871,19,20,1,22,33,1133
63401,63401,29E682BF994B2ACA314777BEAEB90BB7,13911,1,13,12,39,46,1996
63402,63402,29E682BF994B2ACA314777BEAEB90BB7,42231,14,16,2,37,46,1896
63403,63403,29E682BF994B2ACA314777BEAEB90BB7,42351,18,21,3,38,45,1945
63410,63410,BE3AECD016F8A1FBFAF949C87F9A7762,19441,0,13,13,8,46,446
63411,63411,BE3AECD016F8A1FBFAF949C87F9A7762,42041,13,17,4,10,47,547
63412,63412,BE3AECD016F8A1FBFAF949C87F9A7762,19441,18,19,1,8,46,446
63413,63413,BE3AECD016F8A1FBFAF949C87F9A7762,19024,22,23,1,9,45,495
63417,63417,7BB4139D2092F15150BB630D7EA7D139,11231,0,14,14,37,49,1899
63418,63418,7BB4139D2092F15150BB630D7EA7D139,10121,14,18,4,36,49,1849
63419,63419,7BB4139D2092F15150BB630D7EA7D139,11231,19,23,4,37,49,1899
63420,63420,9D0C016FAC9B03B23F695C0F283D602D,11271,7,10,3,37,48,1898
63421,63421,9D0C016FAC9B03B23F695C0F283D602D,42581,11,12,1,38,48,1948
63422,63422,9D0C016FAC9B03B23F695C0F283D602D,11271,13,18,5,37,48,1898
63427,63427,A5243ABBFA186981E52DDF738187CA7D,19441,0,16,16,8,46,446
63428,63428,A5243ABBFA186981E52DDF738187CA7D,19621,16,17,1,5,46,296
63429,63429,A5243ABBFA186981E52DDF738187CA7D,19441,21,23,2,8,46,446
63438,63438,3F10E999BA2507CB4D38460CF65EBC33,10401,0,8,8,33,49,1699
63439,63439,3F10E999BA2507CB4D38460CF65EBC33,42961,11,13,2,35,49,1799
63440,63440,3F10E999BA2507CB4D38460CF65EBC33,11561,15,18,3,32,49,1649
63446,63446,FA7212404B2A3575C86D1A2235BCB99F,10621,0,2,2,41,49,2099
63447,63447,FA7212404B2A3575C86D1A2235BCB99F,42971,3,4,1,43,49,2199
63448,63448,FA7212404B2A3575C86D1A2235BCB99F,10621,5,6,1,41,49,2099
63449,63449,FA7212404B2A3575C86D1A2235BCB99F,42971,10,21,11,43,49,2199
63450,63450,EA9A666FA0B23AFFCF7291147CEC4E64,10161,0,3,3,35,49,1799
63451,63451,EA9A666FA0B23AFFCF7291147CEC4E64,10841,7,12,5,37,47,1897
63452,63452,EA9A666FA0B23AFFCF7291147CEC4E64,12481,19,21,2,37,49,1899
63453,63453,EA9A666FA0B23AFFCF7291147CEC4E64,11201,21,22,1,35,49,1799
63458,63458,A4B13605C78797589D9B98BC8787EDD0,19931,0,5,5,7,43,393
63459,63459,A4B13605C78797589D9B98BC8787EDD0,12641,6,8,2,10,43,543
63460,63460,A4B13605C78797589D9B98BC8787EDD0,19931,11,23,12,7,43,393
63461,63461,A3D7EA815475216548FFFBE741EBDBE8,42961,10,16,6,35,49,1799
63462,63462,A3D7EA815475216548FFFBE741EBDBE8,12971,19,20,1,32,48,1648
63463,63463,A3D7EA815475216548FFFBE741EBDBE8,11914,21,23,2,37,48,1898
63475,63475,803884DAE228D36B780CDE250AFE5FD1,13711,0,8,8,38,46,1946
63476,63476,803884DAE228D36B780CDE250AFE5FD1,40171,14,16,2,38,48,1948
63477,63477,803884DAE228D36B780CDE250AFE5FD1,13711,21,23,2,38,46,1946
63490,63490,E5C88E85992324AE64DCBD2C4673247A,43061,5,8,3,43,46,2196
63491,63491,E5C88E85992324AE64DCBD2C4673247A,43051,13,16,3,46,45,2345
63492,63492,E5C88E85992324AE64DCBD2C4673247A,10801,19,21,2,42,47,2147
63503,63503,28C93346D3A9FF94865CD4FD2489E292,10191,0,8,8,40,48,2048
63504,63504,28C93346D3A9FF94865CD4FD2489E292,11271,12,13,1,37,48,1898
63505,63505,28C93346D3A9FF94865CD4FD2489E292,11794,16,17,1,38,49,1949
63506,63506,28C93346D3A9FF94865CD4FD2489E292,42511,18,20,2,37,47,1897
63507,63507,895085FE0B62D7BCDF8725B5DB48E546,43971,0,6,6,30,48,1548
63508,63508,895085FE0B62D7BCDF8725B5DB48E546,11061,6,15,9,29,48,1498
63509,63509,895085FE0B62D7BCDF8725B5DB48E546,42521,16,23,7,31,47,1597
63518,63518,8EEF56F5DEC439885C9B0A6B78524D68,42491,7,9,2,32,46,1646
63519,63519,8EEF56F5DEC439885C9B0A6B78524D68,10292,12,20,8,30,47,1547
63520,63520,8EEF56F5DEC439885C9B0A6B78524D68,42523,21,23,2,31,47,1597
63543,63543,37D12B9A785069D9567B986D8917ECC5,10351,3,5,2,28,45,1445
63544,63544,37D12B9A785069D9567B986D8917ECC5,10634,7,12,5,27,45,1395
63545,63545,37D12B9A785069D9567B986D8917ECC5,10351,15,18,3,28,45,1445
63556,63556,4A0972FE30B25DFEF9A6ADA526D0544E,11901,1,8,7,42,49,2149
63557,63557,4A0972FE30B25DFEF9A6ADA526D0544E,10921,14,15,1,43,48,2198
63558,63558,4A0972FE30B25DFEF9A6ADA526D0544E,11901,15,23,8,42,49,2149
63562,63562,75B6D91479467607B0BA166BDAF35CA1,10431,0,12,12,33,49,1699
63563,63563,75B6D91479467607B0BA166BDAF35CA1,43731,15,17,2,34,47,1747
63564,63564,75B6D91479467607B0BA166BDAF35CA1,10431,22,23,1,33,49,1699
63573,63573,D157013D3488A5412F8F2595D1038B6C,12661,1,11,10,32,45,1645
63574,63574,D157013D3488A5412F8F2595D1038B6C,12311,14,17,3,30,44,1544
63575,63575,D157013D3488A5412F8F2595D1038B6C,12661,19,21,2,32,45,1645
63591,63591,83D4CEED38BB3CF6CFCB6A83B566A9F4,43951,8,11,3,49,41,2491
63592,63592,83D4CEED38BB3CF6CFCB6A83B566A9F4,13411,15,17,2,49,42,2492
63593,63593,83D4CEED38BB3CF6CFCB6A83B566A9F4,43951,22,23,1,49,41,2491
63600,63600,C4890C5D3563ACD1E55E3A742594DF7D,10431,0,8,8,33,49,1699
63601,63601,C4890C5D3563ACD1E55E3A742594DF7D,10491,9,20,11,33,48,1698
63602,63602,C4890C5D3563ACD1E55E3A742594DF7D,10431,21,23,2,33,49,1699
63603,63603,37AD847A4A458AD0178486423CEE9EF0,42401,0,4,4,36,47,1847
63604,63604,37AD847A4A458AD0178486423CEE9EF0,42981,4,5,1,36,49,1849
63605,63605,37AD847A4A458AD0178486423CEE9EF0,42161,6,23,17,36,47,1847
63611,63611,BF5242715718EEF665EE93EC69F552EB,13271,1,7,6,41,47,2097
63612,63612,BF5242715718EEF665EE93EC69F552EB,13101,8,9,1,40,47,2047
63613,63613,BF5242715718EEF665EE93EC69F552EB,13271,16,21,5,41,47,2097
63614,63614,9B13D95106A4BC5C142691820306BA23,12514,0,8,8,38,47,1947
63615,63615,9B13D95106A4BC5C142691820306BA23,10841,9,11,2,37,47,1897
63616,63616,9B13D95106A4BC5C142691820306BA23,12514,13,20,7,38,47,1947
63617,63617,9B13D95106A4BC5C142691820306BA23,10841,21,22,1,37,47,1897
63636,63636,E9419CF3CD3CC1EF09B7A7931644F385,13271,2,4,2,41,47,2097
63637,63637,E9419CF3CD3CC1EF09B7A7931644F385,11001,4,7,3,42,47,2147
63638,63638,E9419CF3CD3CC1EF09B7A7931644F385,13271,7,18,11,41,47,2097
63639,63639,E9419CF3CD3CC1EF09B7A7931644F385,11001,19,21,2,42,47,2147
63645,63645,97B6D6D29EC4E9F125FDF48E88E16061,11381,0,7,7,30,47,1547
63646,63646,97B6D6D29EC4E9F125FDF48E88E16061,10681,9,15,6,30,48,1548
63647,63647,97B6D6D29EC4E9F125FDF48E88E16061,11061,19,23,4,29,48,1498
63648,63648,AD3E6481838BF400FA98C1C2BDCD8C19,42681,0,10,10,24,48,1248
63649,63649,AD3E6481838BF400FA98C1C2BDCD8C19,10451,14,16,2,25,48,1298
63650,63650,AD3E6481838BF400FA98C1C2BDCD8C19,11641,19,22,3,22,49,1149
63656,63656,C7E598BFED6FB574843E537970B28C08,11151,0,7,7,30,48,1548
63657,63657,C7E598BFED6FB574843E537970B28C08,11061,8,9,1,29,48,1498
63658,63658,C7E598BFED6FB574843E537970B28C08,11151,9,23,14,30,48,1548
63672,63672,BB0D4D6156EA264C43B2FA6C683FDDA8,11381,2,12,10,30,47,1547
63673,63673,BB0D4D6156EA264C43B2FA6C683FDDA8,12121,12,13,1,29,47,1497
63674,63674,BB0D4D6156EA264C43B2FA6C683FDDA8,11381,14,21,7,30,47,1547
63675,63675,F0D6A0DD95FECBA9B8057DD90C2A5CED,11381,0,2,2,30,47,1547
63676,63676,F0D6A0DD95FECBA9B8057DD90C2A5CED,10681,2,18,16,30,48,1548
63677,63677,F0D6A0DD95FECBA9B8057DD90C2A5CED,10951,19,23,4,29,48,1498
63682,63682,6590E06E6E38F3183C840220D0EC8E0B,13221,0,9,9,40,47,2047
63683,63683,6590E06E6E38F3183C840220D0EC8E0B,12514,12,13,1,38,47,1947
63684,63684,6590E06E6E38F3183C840220D0EC8E0B,13371,16,17,1,41,47,2097
63685,63685,6590E06E6E38F3183C840220D0EC8E0B,12514,18,21,3,38,47,1947
63686,63686,1CE5F4D10EE2FB173CB9F2BC0746661A,42531,4,12,8,31,45,1595
63687,63687,1CE5F4D10EE2FB173CB9F2BC0746661A,12311,14,16,2,30,44,1544
63688,63688,1CE5F4D10EE2FB173CB9F2BC0746661A,42531,16,21,5,31,45,1595
63689,63689,A7B47D86EDC54D750D3985FD16D6CF0C,43951,0,13,13,49,41,2491
63690,63690,A7B47D86EDC54D750D3985FD16D6CF0C,43101,16,18,2,46,40,2340
63691,63691,A7B47D86EDC54D750D3985FD16D6CF0C,12571,20,22,2,48,39,2439
63695,63695,79848FCDEDB38F73B314619050E3843A,42861,0,5,5,37,44,1894
63696,63696,79848FCDEDB38F73B314619050E3843A,42151,5,12,7,35,45,1795
63697,63697,79848FCDEDB38F73B314619050E3843A,42861,13,16,3,37,44,1894
63698,63698,79848FCDEDB38F73B314619050E3843A,12491,18,19,1,36,43,1843
63707,63707,394B81CC36B31D897120A6153D7C1457,11061,0,4,4,29,48,1498
63708,63708,394B81CC36B31D897120A6153D7C1457,12121,6,16,10,29,47,1497
63709,63709,394B81CC36B31D897120A6153D7C1457,11061,18,21,3,29,48,1498
63728,63728,2873DE93703B028193B7B9719DCFE691,12521,0,7,7,35,41,1791
63729,63729,2873DE93703B028193B7B9719DCFE691,43451,7,9,2,37,40,1890
63730,63730,2873DE93703B028193B7B9719DCFE691,12521,12,23,11,35,41,1791
63731,63731,784B731FB48DA266D31BFD4ACBDB8A39,11021,1,16,15,36,49,1849
63732,63732,784B731FB48DA266D31BFD4ACBDB8A39,11011,16,17,1,39,49,1999
63733,63733,784B731FB48DA266D31BFD4ACBDB8A39,11021,18,23,5,36,49,1849
63742,63742,A43D5D4A5B684572DED832EF1C15CC22,11261,0,16,16,36,46,1846
63743,63743,A43D5D4A5B684572DED832EF1C15CC22,13231,16,18,2,39,46,1996
63744,63744,A43D5D4A5B684572DED832EF1C15CC22,11261,18,22,4,36,46,1846
63748,63748,9F541427977446D96030A544BAE61896,10221,3,15,12,34,49,1749
63749,63749,9F541427977446D96030A544BAE61896,13561,15,17,2,37,49,1899
63750,63750,9F541427977446D96030A544BAE61896,10411,19,21,2,36,48,1848
63751,63751,9F541427977446D96030A544BAE61896,10221,21,23,2,34,49,1749
63752,63752,5D713885CC9D7896BCCBC6482BB11B16,11231,0,11,11,37,49,1899
63753,63753,5D713885CC9D7896BCCBC6482BB11B16,13511,11,19,8,34,48,1748
63754,63754,5D713885CC9D7896BCCBC6482BB11B16,11231,20,23,3,37,49,1899
63755,63755,3F271425F5D5BA7FEC9D1C93CCBA4B72,40833,0,13,13,41,47,2097
63756,63756,3F271425F5D5BA7FEC9D1C93CCBA4B72,11001,13,16,3,42,47,2147
63757,63757,3F271425F5D5BA7FEC9D1C93CCBA4B72,13941,19,23,4,41,47,2097
63764,63764,B9B3660EABE6D031242D915A3C01CD0E,42581,0,19,19,38,48,1948
63765,63765,B9B3660EABE6D031242D915A3C01CD0E,11914,19,20,1,37,48,1898
63766,63766,B9B3660EABE6D031242D915A3C01CD0E,42581,20,22,2,38,48,1948
63767,63767,F4C7290798862F6B2ED53B8936E4B945,19021,0,5,5,10,45,545
63768,63768,F4C7290798862F6B2ED53B8936E4B945,12641,7,8,1,10,43,543
63769,63769,F4C7290798862F6B2ED53B8936E4B945,19021,10,23,13,10,45,545
63770,63770,C1639C33F8208BC5ED1B19FF5A6FA4BA,42021,0,10,10,33,47,1697
63771,63771,C1639C33F8208BC5ED1B19FF5A6FA4BA,11861,11,16,5,32,47,1647
63772,63772,C1639C33F8208BC5ED1B19FF5A6FA4BA,42161,17,18,1,36,47,1847
63773,63773,C1639C33F8208BC5ED1B19FF5A6FA4BA,11541,18,21,3,35,49,1799
63774,63774,4E320FE11D52976D6A806D06D2E2F506,42461,0,6,6,45,47,2297
63775,63775,4E320FE11D52976D6A806D06D2E2F506,42201,7,8,1,43,46,2196
63776,63776,4E320FE11D52976D6A806D06D2E2F506,42321,11,18,7,43,47,2197
63777,63777,4E320FE11D52976D6A806D06D2E2F506,42461,20,23,3,45,47,2297
63789,63789,549190A3B2C54A5013EF8B180CB7DAD2,11074,0,1,1,37,47,1897
63790,63790,549190A3B2C54A5013EF8B180CB7DAD2,42231,1,10,9,37,46,1896
63791,63791,549190A3B2C54A5013EF8B180CB7DAD2,11074,11,18,7,37,47,1897
63792,63792,335FD8782D4F531D88DAC06C84870767,43951,8,10,2,49,41,2491
63793,63793,335FD8782D4F531D88DAC06C84870767,13411,12,13,1,49,42,2492
63794,63794,335FD8782D4F531D88DAC06C84870767,43951,14,19,5,49,41,2491
63795,63795,335FD8782D4F531D88DAC06C84870767,13411,19,22,3,49,42,2492
63796,63796,4B4CE8350EE5983D88D79AB387613407,42581,0,5,5,38,48,1948
63797,63797,4B4CE8350EE5983D88D79AB387613407,12514,6,8,2,38,47,1947
63798,63798,4B4CE8350EE5983D88D79AB387613407,42581,10,20,10,38,48,1948
63799,63799,7FD9072832AAE29AE2915CDEF233B942,10801,4,5,1,42,47,2147
63800,63800,7FD9072832AAE29AE2915CDEF233B942,42321,9,12,3,43,47,2197
63801,63801,7FD9072832AAE29AE2915CDEF233B942,13221,16,18,2,40,47,2047
63802,63802,7FD9072832AAE29AE2915CDEF233B942,10801,21,22,1,42,47,2147
63803,63803,DC15358175A492C6F21AAEFAD4CD0BB7,42401,0,13,13,36,47,1847
63804,63804,DC15358175A492C6F21AAEFAD4CD0BB7,10901,14,17,3,35,48,1798
63805,63805,DC15358175A492C6F21AAEFAD4CD0BB7,10111,18,23,5,37,47,1897
63806,63806,72EE059838FC074BF0955787969E7967,11231,0,4,4,37,49,1899
63807,63807,72EE059838FC074BF0955787969E7967,11331,4,13,9,37,48,1898
63808,63808,72EE059838FC074BF0955787969E7967,11231,20,23,3,37,49,1899
63865,63865,5566DF9556BCD612F8500FB496AD53B3,11861,0,9,9,32,47,1647
63866,63866,5566DF9556BCD612F8500FB496AD53B3,10281,12,17,5,33,48,1698
63867,63867,5566DF9556BCD612F8500FB496AD53B3,10731,18,23,5,33,47,1697
63875,63875,8E0D20320C5276BDD797BA6D65B9C51D,11074,0,7,7,37,47,1897
63876,63876,8E0D20320C5276BDD797BA6D65B9C51D,11231,12,18,6,37,49,1899
63877,63877,8E0D20320C5276BDD797BA6D65B9C51D,11074,19,23,4,37,47,1897
63884,63884,AE10E091EA2027CDBE5CBFBC2238F486,12921,2,4,2,9,41,491
63885,63885,AE10E091EA2027CDBE5CBFBC2238F486,19114,8,15,7,7,43,393
63886,63886,AE10E091EA2027CDBE5CBFBC2238F486,12641,20,22,2,10,43,543
63899,63899,C35D795DA33BE0311413852FD4760F3A,11261,0,8,8,36,46,1846
63900,63900,C35D795DA33BE0311413852FD4760F3A,42351,8,10,2,38,45,1945
63901,63901,C35D795DA33BE0311413852FD4760F3A,11261,14,23,9,36,46,1846
63902,63902,DF6451E86EE4B7B98BCA60FC558F51EE,11151,1,8,7,30,48,1548
63903,63903,DF6451E86EE4B7B98BCA60FC558F51EE,11061,8,9,1,29,48,1498
63904,63904,DF6451E86EE4B7B98BCA60FC558F51EE,11151,14,15,1,30,48,1548
63905,63905,DF6451E86EE4B7B98BCA60FC558F51EE,11061,17,21,4,29,48,1498
63906,63906,D59A7D67E6A2D306517724C5A50D5385,10351,0,6,6,28,45,1445
63907,63907,D59A7D67E6A2D306517724C5A50D5385,42531,7,18,11,31,45,1595
63908,63908,D59A7D67E6A2D306517724C5A50D5385,10351,21,23,2,28,45,1445
63922,63922,017E7601FB9C9C3C9E5F1FE87B4C9BCD,42231,0,17,17,37,46,1896
63923,63923,017E7601FB9C9C3C9E5F1FE87B4C9BCD,13911,17,19,2,39,46,1996
63924,63924,017E7601FB9C9C3C9E5F1FE87B4C9BCD,42231,20,23,3,37,46,1896
63942,63942,FD61B790F6EE08CF458251D2FC08953F,42581,1,8,7,38,48,1948
63943,63943,FD61B790F6EE08CF458251D2FC08953F,11271,10,19,9,37,48,1898
63944,63944,FD61B790F6EE08CF458251D2FC08953F,40171,20,21,1,38,48,1948
63945,63945,8D188B1328CA03E5FCB5F80DC745FFDD,42523,2,13,11,31,47,1597
63946,63946,8D188B1328CA03E5FCB5F80DC745FFDD,10721,17,18,1,31,48,1598
63947,63947,8D188B1328CA03E5FCB5F80DC745FFDD,42523,20,23,3,31,47,1597
63948,63948,500E5DCC611990CA6A62F51EB15BFD7C,11021,9,10,1,36,49,1849
63949,63949,500E5DCC611990CA6A62F51EB15BFD7C,13561,14,15,1,37,49,1899
63950,63950,500E5DCC611990CA6A62F51EB15BFD7C,11021,19,20,1,36,49,1849
63956,63956,BB2213F6CD0581F26FA9CDBA17E84BA3,42271,2,11,9,40,47,2047
63957,63957,BB2213F6CD0581F26FA9CDBA17E84BA3,11074,15,16,1,37,47,1897
63958,63958,BB2213F6CD0581F26FA9CDBA17E84BA3,42271,17,19,2,40,47,2047
63971,63971,9E981569C6718F42D2105C2620CE51EF,42461,0,14,14,45,47,2297
63972,63972,9E981569C6718F42D2105C2620CE51EF,42321,14,20,6,43,47,2197
63973,63973,9E981569C6718F42D2105C2620CE51EF,42461,20,22,2,45,47,2297
63983,63983,50897C798DD981F790935635A0EC3137,10501,0,6,6,22,46,1146
63984,63984,50897C798DD981F790935635A0EC3137,12601,6,9,3,25,47,1297
63985,63985,50897C798DD981F790935635A0EC3137,10501,10,22,12,22,46,1146
63986,63986,EF7A20DA8B1B5B9AEB04342FCDE03590,42271,0,17,17,40,47,2047
63987,63987,EF7A20DA8B1B5B9AEB04342FCDE03590,12511,17,18,1,39,47,1997
63988,63988,EF7A20DA8B1B5B9AEB04342FCDE03590,42271,19,23,4,40,47,2047
64003,64003,F5C9AEAED32EEA251C092DD2E10FBAA3,12651,2,3,1,43,47,2197
64004,64004,F5C9AEAED32EEA251C092DD2E10FBAA3,41392,4,6,2,43,48,2198
64005,64005,F5C9AEAED32EEA251C092DD2E10FBAA3,12651,8,22,14,43,47,2197
64006,64006,30F94368F131A73FAC48CF4BAF636AD7,42161,0,7,7,36,47,1847
64007,64007,30F94368F131A73FAC48CF4BAF636AD7,13681,7,18,11,38,47,1947
64008,64008,30F94368F131A73FAC48CF4BAF636AD7,42161,18,23,5,36,47,1847
64012,64012,2FA830A3F4936C72A1774CB1227927A5,42161,0,8,8,36,47,1847
64013,64013,2FA830A3F4936C72A1774CB1227927A5,11861,8,17,9,32,47,1647
64014,64014,2FA830A3F4936C72A1774CB1227927A5,42161,21,23,2,36,47,1847
64034,64034,6EBC343B289E845421579091E3F37018,42091,0,6,6,43,46,2196
64035,64035,6EBC343B289E845421579091E3F37018,13791,10,12,2,42,47,2147
64036,64036,6EBC343B289E845421579091E3F37018,42091,14,23,9,43,46,2196
64037,64037,955EB645F9ABD88EF2F02AE323B04F51,42161,0,10,10,36,47,1847
64038,64038,955EB645F9ABD88EF2F02AE323B04F51,11231,11,12,1,37,49,1899
64039,64039,955EB645F9ABD88EF2F02AE323B04F51,42161,14,22,8,36,47,1847
64044,64044,7300FFB733BFFEA187DB110E4D4DC3D2,49201,0,7,7,7,41,391
64045,64045,7300FFB733BFFEA187DB110E4D4DC3D2,12921,7,16,9,9,41,491
64046,64046,7300FFB733BFFEA187DB110E4D4DC3D2,19181,20,21,1,8,40,440
64047,64047,7300FFB733BFFEA187DB110E4D4DC3D2,49201,21,22,1,7,41,391
64056,64056,8D1B722574924E233258589ADD621382,10471,0,7,7,37,48,1898
64057,64057,8D1B722574924E233258589ADD621382,10841,9,10,1,37,47,1897
64058,64058,8D1B722574924E233258589ADD621382,10471,13,22,9,37,48,1898
64064,64064,D59A2A795558AA457F13EDE8D62837D5,11461,0,12,12,37,49,1899
64065,64065,D59A2A795558AA457F13EDE8D62837D5,12401,14,15,1,39,49,1999
64066,64066,D59A2A795558AA457F13EDE8D62837D5,11231,20,23,3,37,49,1899
64067,64067,504467700DDD1C036193CD82D6D3619F,42491,0,5,5,32,46,1646
64068,64068,504467700DDD1C036193CD82D6D3619F,10341,7,12,5,31,47,1597
64069,64069,504467700DDD1C036193CD82D6D3619F,42491,15,17,2,32,46,1646
64070,64070,504467700DDD1C036193CD82D6D3619F,10971,19,20,1,35,47,1797
64071,64071,11FECEE7865049CDA55CAB34FACD3089,42871,0,6,6,30,45,1545
64072,64072,11FECEE7865049CDA55CAB34FACD3089,11871,9,13,4,29,46,1496
64073,64073,11FECEE7865049CDA55CAB34FACD3089,11061,15,17,2,29,48,1498
64074,64074,11FECEE7865049CDA55CAB34FACD3089,42871,18,20,2,30,45,1545
64075,64075,C6CE1BC9B69267948B78869F2B1A69E1,10731,3,6,3,33,47,1697
64076,64076,C6CE1BC9B69267948B78869F2B1A69E1,11831,8,9,1,32,45,1645
64077,64077,C6CE1BC9B69267948B78869F2B1A69E1,10731,12,23,11,33,47,1697
64078,64078,BB84F849A5F794F98ED9E8F635142ED5,11914,3,5,2,37,48,1898
64079,64079,BB84F849A5F794F98ED9E8F635142ED5,40171,7,8,1,38,48,1948
64080,64080,BB84F849A5F794F98ED9E8F635142ED5,10471,9,18,9,37,48,1898
64081,64081,D0389CAF7DC087283E228A5DB38A0418,11871,0,5,5,29,46,1496
64082,64082,D0389CAF7DC087283E228A5DB38A0418,13651,6,7,1,30,47,1547
64083,64083,D0389CAF7DC087283E228A5DB38A0418,11861,11,19,8,32,47,1647
64089,64089,6E2BA115423AC3F2E82B833C4FF61B7A,42221,7,9,2,38,48,1948
64090,64090,6E2BA115423AC3F2E82B833C4FF61B7A,11331,12,13,1,37,48,1898
64091,64091,6E2BA115423AC3F2E82B833C4FF61B7A,43481,15,17,2,39,48,1998
64092,64092,6E2BA115423AC3F2E82B833C4FF61B7A,11331,17,19,2,37,48,1898
64096,64096,C7C2B835B3989AD3964515AD81B4C955,10511,1,14,13,35,46,1796
64097,64097,C7C2B835B3989AD3964515AD81B4C955,10881,14,15,1,34,48,1748
64098,64098,C7C2B835B3989AD3964515AD81B4C955,10511,22,23,1,35,46,1796
64099,64099,17EAFB658061AC7292F875FDBCEE6890,11491,0,7,7,36,47,1847
64100,64100,17EAFB658061AC7292F875FDBCEE6890,43281,11,14,3,37,48,1898
64101,64101,17EAFB658061AC7292F875FDBCEE6890,11231,15,18,3,37,49,1899
64102,64102,17EAFB658061AC7292F875FDBCEE6890,11491,19,21,2,36,47,1847
64106,64106,6428FC1D2F17D8BB440D0F9FCA04C935,13911,0,5,5,39,46,1996
64107,64107,6428FC1D2F17D8BB440D0F9FCA04C935,42231,8,10,2,37,46,1896
64108,64108,6428FC1D2F17D8BB440D0F9FCA04C935,13911,10,21,11,39,46,1996
64130,64130,0045D13BE8E4DDAB53C0085B23256BBF,10171,0,17,17,26,47,1347
64131,64131,0045D13BE8E4DDAB53C0085B23256BBF,12601,17,20,3,25,47,1297
64132,64132,0045D13BE8E4DDAB53C0085B23256BBF,10171,20,22,2,26,47,1347
64133,64133,6F62C2F9A0A4591A6C468F0673F366B6,11491,9,10,1,36,47,1847
64134,64134,6F62C2F9A0A4591A6C468F0673F366B6,41007,12,13,1,37,47,1897
64135,64135,6F62C2F9A0A4591A6C468F0673F366B6,11491,16,19,3,36,47,1847
64136,64136,DC9866094212A637CCAC17CF01FE4B5F,42861,0,5,5,37,44,1894
64137,64137,DC9866094212A637CCAC17CF01FE4B5F,11261,7,18,11,36,46,1846
64138,64138,DC9866094212A637CCAC17CF01FE4B5F,42861,20,23,3,37,44,1894
64139,64139,DDC9326A6FAC62E165227AA5AC2BB968,13371,0,9,9,41,47,2097
64140,64140,DDC9326A6FAC62E165227AA5AC2BB968,10821,11,18,7,40,47,2047
64141,64141,DDC9326A6FAC62E165227AA5AC2BB968,13371,18,22,4,41,47,2097
64145,64145,0BC1BC9FA127A76D4558FF0A0EC8FEFB,42021,0,4,4,33,47,1697
64146,64146,0BC1BC9FA127A76D4558FF0A0EC8FEFB,10281,8,10,2,33,48,1698
64147,64147,0BC1BC9FA127A76D4558FF0A0EC8FEFB,42021,12,23,11,33,47,1697
64152,64152,D9FB9F3F4820A4EF951566780A770C45,11261,4,19,15,36,46,1846
64153,64153,D9FB9F3F4820A4EF951566780A770C45,42351,19,20,1,38,45,1945
64154,64154,D9FB9F3F4820A4EF951566780A770C45,11261,21,23,2,36,46,1846
64164,64164,E4755D4D74782995B4916D6EFE1998EB,19111,0,8,8,9,45,495
64165,64165,E4755D4D74782995B4916D6EFE1998EB,19021,10,18,8,10,45,545
64166,64166,E4755D4D74782995B4916D6EFE1998EB,19111,20,22,2,9,45,495
64167,64167,DD46E5AD4820E4A22AD7AF18B04EF382,42141,0,14,14,32,47,1647
64168,64168,DD46E5AD4820E4A22AD7AF18B04EF382,11531,17,19,2,34,49,1749
64169,64169,DD46E5AD4820E4A22AD7AF18B04EF382,11861,22,23,1,32,47,1647
64170,64170,77A12BAF1AD9D6E59DDB61BDD23EAAC0,49201,0,8,8,7,41,391
64171,64171,77A12BAF1AD9D6E59DDB61BDD23EAAC0,12921,8,10,2,9,41,491
64172,64172,77A12BAF1AD9D6E59DDB61BDD23EAAC0,49201,15,22,7,7,41,391
64173,64173,BE0A979268FF24891DDE75D2D876AB55,13331,0,16,16,38,47,1947
64174,64174,BE0A979268FF24891DDE75D2D876AB55,13121,16,19,3,38,46,1946
64175,64175,BE0A979268FF24891DDE75D2D876AB55,13681,19,22,3,38,47,1947
64182,64182,0A1386913DE713CBA72662A5149627A3,13711,0,7,7,38,46,1946
64183,64183,0A1386913DE713CBA72662A5149627A3,42011,8,9,1,36,46,1846
64184,64184,0A1386913DE713CBA72662A5149627A3,13711,13,23,10,38,46,1946
64189,64189,C8D89F699172ABABF4DD3B2925BC4A8C,42071,6,8,2,31,49,1599
64190,64190,C8D89F699172ABABF4DD3B2925BC4A8C,11061,8,9,1,29,48,1498
64191,64191,C8D89F699172ABABF4DD3B2925BC4A8C,42071,9,23,14,31,49,1599
64192,64192,0FF23BFDB55A76F1FEA2FEA8A42CA80D,11061,0,3,3,29,48,1498
64193,64193,0FF23BFDB55A76F1FEA2FEA8A42CA80D,11381,4,17,13,30,47,1547
64194,64194,0FF23BFDB55A76F1FEA2FEA8A42CA80D,11061,21,22,1,29,48,1498
64195,64195,0FF23BFDB55A76F1FEA2FEA8A42CA80D,11381,22,23,1,30,47,1547
64196,64196,DC0BB9353438EF73E027E505129705B2,43761,0,4,4,32,47,1647
64197,64197,DC0BB9353438EF73E027E505129705B2,42021,5,6,1,33,47,1697
64198,64198,DC0BB9353438EF73E027E505129705B2,43761,7,18,11,32,47,1647
64210,64210,E95F165D16579FC368229CB18D709B87,10841,5,9,4,37,47,1897
64211,64211,E95F165D16579FC368229CB18D709B87,40833,10,11,1,41,47,2097
64212,64212,E95F165D16579FC368229CB18D709B87,10841,13,23,10,37,47,1897
64216,64216,DE2B1A6AE0578852E29B994288D090A5,19441,0,13,13,8,46,446
64217,64217,DE2B1A6AE0578852E29B994288D090A5,42041,14,17,3,10,47,547
64218,64218,DE2B1A6AE0578852E29B994288D090A5,19441,18,20,2,8,46,446
64219,64219,00ED2280FB2BEC22D8FB36F8A7AFB1A5,42791,0,7,7,35,45,1795
64220,64220,00ED2280FB2BEC22D8FB36F8A7AFB1A5,10271,10,11,1,37,46,1896
64221,64221,00ED2280FB2BEC22D8FB36F8A7AFB1A5,13121,14,15,1,38,46,1946
64222,64222,00ED2280FB2BEC22D8FB36F8A7AFB1A5,10271,16,18,2,37,46,1896
64226,64226,90B09B02D0DADF8E3A894A5D3E9F4905,11541,0,8,8,35,49,1799
64227,64227,90B09B02D0DADF8E3A894A5D3E9F4905,11231,12,15,3,37,49,1899
64228,64228,90B09B02D0DADF8E3A894A5D3E9F4905,42961,19,23,4,35,49,1799
64233,64233,3D6FB8ACAE3C00D22E5F6B7D23E98057,13651,2,6,4,30,47,1547
64234,64234,3D6FB8ACAE3C00D22E5F6B7D23E98057,42141,7,9,2,32,47,1647
64235,64235,3D6FB8ACAE3C00D22E5F6B7D23E98057,13651,9,15,6,30,47,1547
64236,64236,3D6FB8ACAE3C00D22E5F6B7D23E98057,42141,15,20,5,32,47,1647
64241,64241,215C2968B2146DB0591170CF91F3A17C,10471,0,12,12,37,48,1898
64242,64242,215C2968B2146DB0591170CF91F3A17C,11811,13,14,1,38,49,1949
64243,64243,215C2968B2146DB0591170CF91F3A17C,10471,14,23,9,37,48,1898
64244,64244,DC0553AF584A738E8CE795D3C9015203,11171,0,14,14,33,48,1698
64245,64245,DC0553AF584A738E8CE795D3C9015203,43761,18,19,1,32,47,1647
64246,64246,DC0553AF584A738E8CE795D3C9015203,11171,20,23,3,33,48,1698
64250,64250,DC70E8915CDDA8DB67457FF156BF8AB3,42071,7,11,4,31,49,1599
64251,64251,DC70E8915CDDA8DB67457FF156BF8AB3,11061,15,17,2,29,48,1498
64252,64252,DC70E8915CDDA8DB67457FF156BF8AB3,11151,17,19,2,30,48,1548
64253,64253,5E269639C787C5D2BDF7F359B5257597,13381,0,7,7,39,47,1997
64254,64254,5E269639C787C5D2BDF7F359B5257597,42271,9,11,2,40,47,2047
64255,64255,5E269639C787C5D2BDF7F359B5257597,11481,13,23,10,41,48,2098
64256,64256,A922D7161F816C1FD25F52BCCB616DFE,43731,0,3,3,34,47,1747
64257,64257,A922D7161F816C1FD25F52BCCB616DFE,40673,3,5,2,36,48,1848
64258,64258,A922D7161F816C1FD25F52BCCB616DFE,10251,6,22,16,35,47,1797
64259,64259,2A3AD4959395DC229612EE5FA4ACEA58,10681,0,8,8,30,48,1548
64260,64260,2A3AD4959395DC229612EE5FA4ACEA58,11061,9,13,4,29,48,1498
64261,64261,2A3AD4959395DC229612EE5FA4ACEA58,10681,13,15,2,30,48,1548
64262,64262,2A3AD4959395DC229612EE5FA4ACEA58,11061,19,23,4,29,48,1498
64268,64268,5D8FA5419FA0CA7A8C3CA55000085D74,11021,1,15,14,36,49,1849
64269,64269,5D8FA5419FA0CA7A8C3CA55000085D74,10107,16,20,4,38,49,1949
64270,64270,5D8FA5419FA0CA7A8C3CA55000085D74,11021,20,23,3,36,49,1849
64282,64282,08B8CB3410391A409AD6F561C9C850B1,42341,8,9,1,43,49,2199
64283,64283,08B8CB3410391A409AD6F561C9C850B1,11741,11,12,1,42,49,2149
64284,64284,08B8CB3410391A409AD6F561C9C850B1,42341,14,19,5,43,49,2199
64299,64299,AD00213C3B59D2AB9F04638676B1CD2C,10491,0,16,16,33,48,1698
64300,64300,AD00213C3B59D2AB9F04638676B1CD2C,11861,16,21,5,32,47,1647
64301,64301,AD00213C3B59D2AB9F04638676B1CD2C,10491,22,23,1,33,48,1698
64302,64302,372A21350F3884793152DCFF165CE566,13341,1,6,5,44,45,2245
64303,64303,372A21350F3884793152DCFF165CE566,12561,6,7,1,45,43,2293
64304,64304,372A21350F3884793152DCFF165CE566,13111,7,9,2,42,46,2146
64305,64305,372A21350F3884793152DCFF165CE566,13341,12,23,11,44,45,2245
64306,64306,3D4D278B3D58167073B4ACCB11432DB2,13094,0,1,1,21,42,1092
64307,64307,3D4D278B3D58167073B4ACCB11432DB2,13091,3,5,2,20,42,1042
64308,64308,3D4D278B3D58167073B4ACCB11432DB2,12671,6,19,13,21,43,1093
64309,64309,3D4D278B3D58167073B4ACCB11432DB2,13091,22,23,1,20,42,1042
64310,64310,50CCE1C8743D579E901C16AE5F92AA42,11074,9,14,5,37,47,1897
64311,64311,50CCE1C8743D579E901C16AE5F92AA42,12514,15,20,5,38,47,1947
64312,64312,50CCE1C8743D579E901C16AE5F92AA42,11074,21,23,2,37,47,1897
64349,64349,558A6887C0D5899B43E75BBD844A7C64,42321,0,2,2,43,47,2197
64350,64350,558A6887C0D5899B43E75BBD844A7C64,42461,2,5,3,45,47,2297
64351,64351,558A6887C0D5899B43E75BBD844A7C64,42321,5,19,14,43,47,2197
64352,64352,558A6887C0D5899B43E75BBD844A7C64,42461,20,23,3,45,47,2297
64357,64357,91FB7E11CCB9539E71578F3DFA4AFBA7,19181,0,3,3,8,40,440
64358,64358,91FB7E11CCB9539E71578F3DFA4AFBA7,12921,4,7,3,9,41,491
64359,64359,91FB7E11CCB9539E71578F3DFA4AFBA7,19181,11,22,11,8,40,440
64363,64363,D8B46FFCD15B641FB93B8219A29A7205,10251,7,9,2,35,47,1797
64364,64364,D8B46FFCD15B641FB93B8219A29A7205,42161,10,17,7,36,47,1847
64365,64365,D8B46FFCD15B641FB93B8219A29A7205,10251,22,23,1,35,47,1797
64366,64366,4C996E34DF0F27DD1CD5B8A4F7C9079D,10341,0,13,13,31,47,1597
64367,64367,4C996E34DF0F27DD1CD5B8A4F7C9079D,10292,13,16,3,30,47,1547
64368,64368,4C996E34DF0F27DD1CD5B8A4F7C9079D,10341,16,23,7,31,47,1597
64372,64372,10998AC050402D0103054DA8672DA230,19441,0,13,13,8,46,446
64373,64373,10998AC050402D0103054DA8672DA230,42041,13,15,2,10,47,547
64374,64374,10998AC050402D0103054DA8672DA230,19441,18,22,4,8,46,446
64383,64383,2C5E611DC234F9DADA554C468882F30D,13601,0,4,4,34,47,1747
64384,64384,2C5E611DC234F9DADA554C468882F30D,43161,5,17,12,35,47,1797
64385,64385,2C5E611DC234F9DADA554C468882F30D,42921,18,20,2,33,47,1697
64386,64386,5A1A08328877B4C3DF369AF5CBDE2906,13941,0,7,7,41,47,2097
64387,64387,5A1A08328877B4C3DF369AF5CBDE2906,11001,8,9,1,42,47,2147
64388,64388,5A1A08328877B4C3DF369AF5CBDE2906,13941,9,22,13,41,47,2097
64392,64392,D3F18133881188A01FA675132E824AEA,42481,0,16,16,22,49,1149
64393,64393,D3F18133881188A01FA675132E824AEA,42681,17,18,1,24,48,1248
64394,64394,D3F18133881188A01FA675132E824AEA,42481,20,21,1,22,49,1149
64408,64408,B6EDE923BA421C490CFB0E81830396F2,11271,0,7,7,37,48,1898
64409,64409,B6EDE923BA421C490CFB0E81830396F2,11231,7,18,11,37,49,1899
64410,64410,B6EDE923BA421C490CFB0E81830396F2,43671,18,23,5,35,48,1798
64422,64422,BC5F5A048F874E8EDED6AF765E340D8C,11914,5,11,6,37,48,1898
64423,64423,BC5F5A048F874E8EDED6AF765E340D8C,42581,11,13,2,38,48,1948
64424,64424,BC5F5A048F874E8EDED6AF765E340D8C,11914,14,20,6,37,48,1898
64425,64425,BC5F5A048F874E8EDED6AF765E340D8C,42581,20,22,2,38,48,1948
64429,64429,A1BDF95E9D3FC1D1F9602700F7A63FC0,42461,0,7,7,45,47,2297
64430,64430,A1BDF95E9D3FC1D1F9602700F7A63FC0,11701,8,9,1,43,48,2198
64431,64431,A1BDF95E9D3FC1D1F9602700F7A63FC0,42461,9,23,14,45,47,2297
64440,64440,0C993A1B5BD23944DD153F92F92FAA1E,10351,9,14,5,28,45,1445
64441,64441,0C993A1B5BD23944DD153F92F92FAA1E,10634,14,15,1,27,45,1395
64442,64442,0C993A1B5BD23944DD153F92F92FAA1E,10351,15,23,8,28,45,1445
64443,64443,4C479F308A99C28A9312A97B8F351EC7,10161,0,10,10,35,49,1799
64444,64444,4C479F308A99C28A9312A97B8F351EC7,10221,12,13,1,34,49,1749
64445,64445,4C479F308A99C28A9312A97B8F351EC7,13511,14,15,1,34,48,1748
64446,64446,4C479F308A99C28A9312A97B8F351EC7,11201,15,22,7,35,49,1799
64447,64447,B93C16A242FE2C6BDA83A87AD4FAA434,10501,1,9,8,22,46,1146
64448,64448,B93C16A242FE2C6BDA83A87AD4FAA434,12601,12,20,8,25,47,1297
64449,64449,B93C16A242FE2C6BDA83A87AD4FAA434,10501,20,22,2,22,46,1146
64454,64454,2919AE6D084A224DBE478EC407590B76,43241,0,8,8,36,46,1846
64455,64455,2919AE6D084A224DBE478EC407590B76,13121,9,10,1,38,46,1946
64456,64456,2919AE6D084A224DBE478EC407590B76,10271,15,16,1,37,46,1896
64457,64457,2919AE6D084A224DBE478EC407590B76,43241,18,23,5,36,46,1846
64473,64473,C3385B266A5088A7FA48BCC62DFDD003,11914,0,5,5,37,48,1898
64474,64474,C3385B266A5088A7FA48BCC62DFDD003,43181,9,10,1,39,48,1998
64475,64475,C3385B266A5088A7FA48BCC62DFDD003,11914,12,21,9,37,48,1898
64476,64476,29D9341B608455DE9B9E73F11B263135,43761,0,15,15,32,47,1647
64477,64477,29D9341B608455DE9B9E73F11B263135,42521,18,19,1,31,47,1597
64478,64478,29D9341B608455DE9B9E73F11B263135,11381,21,22,1,30,47,1547
64479,64479,9641FF809BC99375A7EB0913A38DD4C9,11151,0,2,2,30,48,1548
64480,64480,9641FF809BC99375A7EB0913A38DD4C9,11061,2,6,4,29,48,1498
64481,64481,9641FF809BC99375A7EB0913A38DD4C9,11151,8,9,1,30,48,1548
64482,64482,9641FF809BC99375A7EB0913A38DD4C9,11061,16,21,5,29,48,1498
64483,64483,9C853A4D5C7B5210EB733E5032A36376,11021,0,9,9,36,49,1849
64484,64484,9C853A4D5C7B5210EB733E5032A36376,11781,13,14,1,38,49,1949
64485,64485,9C853A4D5C7B5210EB733E5032A36376,11021,18,23,5,36,49,1849
64486,64486,60DB2F1E5C63BE640D47B87EE3CFB05B,42461,0,6,6,45,47,2297
64487,64487,60DB2F1E5C63BE640D47B87EE3CFB05B,42321,6,15,9,43,47,2197
64488,64488,60DB2F1E5C63BE640D47B87EE3CFB05B,42461,20,22,2,45,47,2297
64519,64519,28CE914B24B7AF729F0EB5908B413DD4,43391,9,10,1,29,48,1498
64520,64520,28CE914B24B7AF729F0EB5908B413DD4,10381,10,11,1,31,49,1599
64521,64521,28CE914B24B7AF729F0EB5908B413DD4,43391,15,16,1,29,48,1498
64522,64522,28CE914B24B7AF729F0EB5908B413DD4,11151,16,19,3,30,48,1548
64526,64526,0AC9ACC82EDADEC2B3583D25F9FB3BD5,19441,2,8,6,8,46,446
64527,64527,0AC9ACC82EDADEC2B3583D25F9FB3BD5,42041,11,13,2,10,47,547
64528,64528,0AC9ACC82EDADEC2B3583D25F9FB3BD5,19441,13,17,4,8,46,446
64529,64529,0AC9ACC82EDADEC2B3583D25F9FB3BD5,42041,19,21,2,10,47,547
64538,64538,649CA0B4C9C73F10630BCAC6C100E533,42151,1,14,13,35,45,1795
64539,64539,649CA0B4C9C73F10630BCAC6C100E533,42371,14,17,3,34,46,1746
64540,64540,649CA0B4C9C73F10630BCAC6C100E533,42151,18,22,4,35,45,1795
64541,64541,D1E2F2E8D2DE84152E674ADBABC1BCA8,11261,6,7,1,36,46,1846
64542,64542,D1E2F2E8D2DE84152E674ADBABC1BCA8,42231,10,11,1,37,46,1896
64543,64543,D1E2F2E8D2DE84152E674ADBABC1BCA8,11261,14,18,4,36,46,1846
64544,64544,D1E2F2E8D2DE84152E674ADBABC1BCA8,42231,18,21,3,37,46,1896
64552,64552,E08A998E96875BC2FB605F71696F898C,11061,0,7,7,29,48,1498
64553,64553,E08A998E96875BC2FB605F71696F898C,11381,8,12,4,30,47,1547
64554,64554,E08A998E96875BC2FB605F71696F898C,11061,19,21,2,29,48,1498
64560,64560,1613EDCCB37A92602BD5AFC072B28494,11531,0,12,12,34,49,1749
64561,64561,1613EDCCB37A92602BD5AFC072B28494,42471,19,21,2,35,49,1799
64562,64562,1613EDCCB37A92602BD5AFC072B28494,11531,21,23,2,34,49,1749
64568,64568,D9B08428B230A26F9D8108567961B570,11281,0,9,9,27,40,1390
64569,64569,D9B08428B230A26F9D8108567961B570,13671,11,13,2,27,43,1393
64570,64570,D9B08428B230A26F9D8108567961B570,11281,13,22,9,27,40,1390
64571,64571,DEAED68AE3C073AACA878B29D6C9BBC2,42351,0,1,1,38,45,1945
64572,64572,DEAED68AE3C073AACA878B29D6C9BBC2,42231,1,18,17,37,46,1896
64573,64573,DEAED68AE3C073AACA878B29D6C9BBC2,42351,19,21,2,38,45,1945
64579,64579,FF16D1104349162E539969031BE39A02,43481,0,7,7,39,48,1998
64580,64580,FF16D1104349162E539969031BE39A02,12514,9,12,3,38,47,1947
64581,64581,FF16D1104349162E539969031BE39A02,12511,13,18,5,39,47,1997
64587,64587,A6B405B99179077A3D8295B0BAB76366,10431,0,12,12,33,49,1699
64588,64588,A6B405B99179077A3D8295B0BAB76366,42491,13,15,2,32,46,1646
64589,64589,A6B405B99179077A3D8295B0BAB76366,10431,18,22,4,33,49,1699
64593,64593,21214DF25ABBFE57C13DD19922691751,13911,0,8,8,39,46,1996
64594,64594,21214DF25ABBFE57C13DD19922691751,11261,10,17,7,36,46,1846
64595,64595,21214DF25ABBFE57C13DD19922691751,13911,21,22,1,39,46,1996
64625,64625,8827A35309A216F0F6E4CBB2FFAC456D,11954,3,14,11,32,49,1649
64626,64626,8827A35309A216F0F6E4CBB2FFAC456D,11531,18,20,2,34,49,1749
64627,64627,8827A35309A216F0F6E4CBB2FFAC456D,40951,21,22,1,36,49,1849
64641,64641,84C94B2F533ED609B0C2666E73EA3142,40833,0,9,9,41,47,2097
64642,64642,84C94B2F533ED609B0C2666E73EA3142,11481,10,11,1,41,48,2098
64643,64643,84C94B2F533ED609B0C2666E73EA3142,40833,12,13,1,41,47,2097
64644,64644,84C94B2F533ED609B0C2666E73EA3142,13101,17,19,2,40,47,2047
64645,64645,07E8F527E3C22F701EF1E12272A919B5,11074,0,3,3,37,47,1897
64646,64646,07E8F527E3C22F701EF1E12272A919B5,12514,3,5,2,38,47,1947
64647,64647,07E8F527E3C22F701EF1E12272A919B5,11074,5,23,18,37,47,1897
64670,64670,7875A34DC3B1C1A6D18480769685A825,42231,8,13,5,37,46,1896
64671,64671,7875A34DC3B1C1A6D18480769685A825,12491,16,19,3,36,43,1843
64672,64672,7875A34DC3B1C1A6D18480769685A825,42231,20,22,2,37,46,1896
64678,64678,39E9477CFB7A739ED25E5621F7D2A965,10821,0,9,9,40,47,2047
64679,64679,39E9477CFB7A739ED25E5621F7D2A965,42301,12,15,3,36,47,1847
64680,64680,39E9477CFB7A739ED25E5621F7D2A965,10107,16,18,2,38,49,1949
64681,64681,39E9477CFB7A739ED25E5621F7D2A965,12651,22,23,1,43,47,2197
64682,64682,422DDC348F4AAA002A648FA0F6118A74,43761,1,11,10,32,47,1647
64683,64683,422DDC348F4AAA002A648FA0F6118A74,43311,12,16,4,31,48,1598
64684,64684,422DDC348F4AAA002A648FA0F6118A74,11161,18,19,1,32,48,1648
64685,64685,422DDC348F4AAA002A648FA0F6118A74,42141,20,21,1,32,47,1647
64695,64695,669789A85CB5E3EBAD88766E3FDF6C3D,13651,3,4,1,30,47,1547
64696,64696,669789A85CB5E3EBAD88766E3FDF6C3D,42491,4,6,2,32,46,1646
64697,64697,669789A85CB5E3EBAD88766E3FDF6C3D,11321,10,19,9,31,46,1596
64698,64698,669789A85CB5E3EBAD88766E3FDF6C3D,11151,20,21,1,30,48,1548
64707,64707,B4EDE126A695D34A3C3A9CBF3520ED2C,19441,9,11,2,8,46,446
64708,64708,B4EDE126A695D34A3C3A9CBF3520ED2C,19111,14,17,3,9,45,495
64709,64709,B4EDE126A695D34A3C3A9CBF3520ED2C,19441,19,20,1,8,46,446
64713,64713,6F881E54FD8247C10253271465BFC769,10111,0,12,12,37,47,1897
64714,64714,6F881E54FD8247C10253271465BFC769,42161,13,14,1,36,47,1847
64715,64715,6F881E54FD8247C10253271465BFC769,10111,14,23,9,37,47,1897
64716,64716,0E91A13D0E931F32EE1FFD96FA252798,42381,0,4,4,39,41,1991
64717,64717,0E91A13D0E931F32EE1FFD96FA252798,43451,9,10,1,37,40,1890
64718,64718,0E91A13D0E931F32EE1FFD96FA252798,42381,11,23,12,39,41,1991
64738,64738,F05227F02F151B3FD493DA51DCCF1644,42691,0,1,1,24,48,1248
64739,64739,F05227F02F151B3FD493DA51DCCF1644,42481,6,8,2,22,49,1149
64740,64740,F05227F02F151B3FD493DA51DCCF1644,10451,8,10,2,25,48,1298
64741,64741,F05227F02F151B3FD493DA51DCCF1644,42481,12,19,7,22,49,1149
64749,64749,83605D331BD58EAF678A915FCE0FA0A7,11641,8,9,1,22,49,1149
64750,64750,83605D331BD58EAF678A915FCE0FA0A7,42081,12,13,1,24,49,1249
64751,64751,83605D331BD58EAF678A915FCE0FA0A7,11641,15,18,3,22,49,1149
64757,64757,06724C888D13FBA3C30984CA3D9C3C3A,43391,0,7,7,29,48,1498
64758,64758,06724C888D13FBA3C30984CA3D9C3C3A,11151,8,13,5,30,48,1548
64759,64759,06724C888D13FBA3C30984CA3D9C3C3A,42291,14,22,8,29,48,1498
64775,64775,7ED1E3820048F22BCFB7CD6147C03E7F,19441,0,16,16,8,46,446
64776,64776,7ED1E3820048F22BCFB7CD6147C03E7F,42041,16,18,2,10,47,547
64777,64777,7ED1E3820048F22BCFB7CD6147C03E7F,19441,18,23,5,8,46,446
64799,64799,DB5C0024A3C9A77900C99EA6DCF506D1,11941,0,7,7,37,46,1896
64800,64800,DB5C0024A3C9A77900C99EA6DCF506D1,11261,7,9,2,36,46,1846
64801,64801,DB5C0024A3C9A77900C99EA6DCF506D1,11941,12,20,8,37,46,1896
64809,64809,FEBBC1AF29ABDF81F3A68ADD448B81C3,10381,5,13,8,31,49,1599
64810,64810,FEBBC1AF29ABDF81F3A68ADD448B81C3,11151,16,21,5,30,48,1548
64811,64811,FEBBC1AF29ABDF81F3A68ADD448B81C3,10951,22,23,1,29,48,1498
64812,64812,A0E96E8A9AD818FBF087A431E03695B8,11914,0,2,2,37,48,1898
64813,64813,A0E96E8A9AD818FBF087A431E03695B8,40171,3,6,3,38,48,1948
64814,64814,A0E96E8A9AD818FBF087A431E03695B8,11021,9,20,11,36,49,1849
64815,64815,A0E96E8A9AD818FBF087A431E03695B8,40171,21,23,2,38,48,1948
64816,64816,AEB67BDC79FE6552942E6F2DEC149F32,11551,0,10,10,39,49,1999
64817,64817,AEB67BDC79FE6552942E6F2DEC149F32,42801,11,12,1,40,49,2049
64818,64818,AEB67BDC79FE6552942E6F2DEC149F32,11551,12,23,11,39,49,1999
64819,64819,E3B088F7DEFCCE4BD4EB6ADB8F0E5950,10841,3,4,1,37,47,1897
64820,64820,E3B088F7DEFCCE4BD4EB6ADB8F0E5950,12514,7,9,2,38,47,1947
64821,64821,E3B088F7DEFCCE4BD4EB6ADB8F0E5950,10591,10,12,2,39,48,1998
64822,64822,E3B088F7DEFCCE4BD4EB6ADB8F0E5950,43171,16,18,2,39,49,1999
64830,64830,95A50FC77E468146BAD45CC8BD317370,42921,0,1,1,33,47,1697
64831,64831,95A50FC77E468146BAD45CC8BD317370,43731,3,7,4,34,47,1747
64832,64832,95A50FC77E468146BAD45CC8BD317370,11861,8,9,1,32,47,1647
64833,64833,95A50FC77E468146BAD45CC8BD317370,43731,14,21,7,34,47,1747
64834,64834,21BFC9B680F0329C7CDCB5AE45B398FD,42161,0,2,2,36,47,1847
64835,64835,21BFC9B680F0329C7CDCB5AE45B398FD,10111,4,8,4,37,47,1897
64836,64836,21BFC9B680F0329C7CDCB5AE45B398FD,42161,9,13,4,36,47,1847
64837,64837,21BFC9B680F0329C7CDCB5AE45B398FD,10111,17,23,6,37,47,1897
64842,64842,14D802A3B202443F8B89CB3561B9B173,12311,0,2,2,30,44,1544
64843,64843,14D802A3B202443F8B89CB3561B9B173,42531,4,6,2,31,45,1595
64844,64844,14D802A3B202443F8B89CB3561B9B173,10351,9,18,9,28,45,1445
64845,64845,14D802A3B202443F8B89CB3561B9B173,12311,22,23,1,30,44,1544
64846,64846,D44EDEFE20C6E53FAD2290D9CECCD593,19441,0,11,11,8,46,446
64847,64847,D44EDEFE20C6E53FAD2290D9CECCD593,42041,11,12,1,10,47,547
64848,64848,D44EDEFE20C6E53FAD2290D9CECCD593,19441,14,22,8,8,46,446
64854,64854,8A35309960304DAF98A2649637AD86E1,10634,0,10,10,27,45,1395
64855,64855,8A35309960304DAF98A2649637AD86E1,10351,10,12,2,28,45,1445
64856,64856,8A35309960304DAF98A2649637AD86E1,10634,12,14,2,27,45,1395
64857,64857,8A35309960304DAF98A2649637AD86E1,10351,14,23,9,28,45,1445
64867,64867,EB7EB6074C1F2A07A41462E31EDA6629,42161,0,15,15,36,47,1847
64868,64868,EB7EB6074C1F2A07A41462E31EDA6629,11074,17,18,1,37,47,1897
64869,64869,EB7EB6074C1F2A07A41462E31EDA6629,42401,21,23,2,36,47,1847
64870,64870,478F01BCCD8ECC2639B5EA3CD060CD5E,11751,0,11,11,35,48,1798
64871,64871,478F01BCCD8ECC2639B5EA3CD060CD5E,10221,11,12,1,34,49,1749
64872,64872,478F01BCCD8ECC2639B5EA3CD060CD5E,11201,14,20,6,35,49,1799
64873,64873,BBDE1AA3571200B55E5831C210829032,19441,0,11,11,8,46,446
64874,64874,BBDE1AA3571200B55E5831C210829032,42041,11,15,4,10,47,547
64875,64875,BBDE1AA3571200B55E5831C210829032,19441,15,23,8,8,46,446
64876,64876,F6A3D1082E42D82C396119448410DF96,19441,0,11,11,8,46,446
64877,64877,F6A3D1082E42D82C396119448410DF96,42041,11,18,7,10,47,547
64878,64878,F6A3D1082E42D82C396119448410DF96,19441,19,22,3,8,46,446
64879,64879,52B2B9C6CF5A0CA4BA30FD801DDC9C78,11381,0,20,20,30,47,1547
64880,64880,52B2B9C6CF5A0CA4BA30FD801DDC9C78,43761,20,21,1,32,47,1647
64881,64881,52B2B9C6CF5A0CA4BA30FD801DDC9C78,11381,21,23,2,30,47,1547
64901,64901,28C2D2FE4D28624F13409918B749F4EA,42231,0,5,5,37,46,1896
64902,64902,28C2D2FE4D28624F13409918B749F4EA,13711,7,11,4,38,46,1946
64903,64903,28C2D2FE4D28624F13409918B749F4EA,11941,11,18,7,37,46,1896
64904,64904,72CCFF68A8139FE3616EAEC5752357DB,10251,0,7,7,35,47,1797
64905,64905,72CCFF68A8139FE3616EAEC5752357DB,40637,8,12,4,36,47,1847
64906,64906,72CCFF68A8139FE3616EAEC5752357DB,10251,12,23,11,35,47,1797
64907,64907,EDBE9058BB0B28E0915A84395E9226D9,11261,0,5,5,36,46,1846
64908,64908,EDBE9058BB0B28E0915A84395E9226D9,42861,6,15,9,37,44,1894
64909,64909,EDBE9058BB0B28E0915A84395E9226D9,11261,18,20,2,36,46,1846
64910,64910,CDA1FDA113CF86D9856D8BDD0697EB90,10471,0,18,18,37,48,1898
64911,64911,CDA1FDA113CF86D9856D8BDD0697EB90,10107,19,20,1,38,49,1949
64912,64912,CDA1FDA113CF86D9856D8BDD0697EB90,10471,20,23,3,37,48,1898
64916,64916,004156363579A32434DD9F2FE4049F43,10971,0,8,8,35,47,1797
64917,64917,004156363579A32434DD9F2FE4049F43,12021,12,13,1,37,49,1899
64918,64918,004156363579A32434DD9F2FE4049F43,10971,14,18,4,35,47,1797
64933,64933,16B2F0D78BEB849442A93B3F29FB7F4E,11806,0,2,2,41,48,2098
64934,64934,16B2F0D78BEB849442A93B3F29FB7F4E,42271,6,11,5,40,47,2047
64935,64935,16B2F0D78BEB849442A93B3F29FB7F4E,11806,16,23,7,41,48,2098
64941,64941,4C8E92DBB85921608C1C92929A7A8C92,42521,0,6,6,31,47,1597
64942,64942,4C8E92DBB85921608C1C92929A7A8C92,13651,7,11,4,30,47,1547
64943,64943,4C8E92DBB85921608C1C92929A7A8C92,42521,11,19,8,31,47,1597
64944,64944,4C8E92DBB85921608C1C92929A7A8C92,13651,20,23,3,30,47,1547
64953,64953,2E539AC6B5EE453A303FF282CE24EA33,19931,0,6,6,7,43,393
64954,64954,2E539AC6B5EE453A303FF282CE24EA33,12641,9,10,1,10,43,543
64955,64955,2E539AC6B5EE453A303FF282CE24EA33,19931,12,23,11,7,43,393
64983,64983,9637A49CA49F0EFD37F0D0143383C518,13911,2,3,1,39,46,1996
64984,64984,9637A49CA49F0EFD37F0D0143383C518,42231,6,20,14,37,46,1896
64985,64985,9637A49CA49F0EFD37F0D0143383C518,42351,22,23,1,38,45,1945
64986,64986,3CA59C7696A3F1D3B3B3AC13E43E394F,13711,0,2,2,38,46,1946
64987,64987,3CA59C7696A3F1D3B3B3AC13E43E394F,42231,4,5,1,37,46,1896
64988,64988,3CA59C7696A3F1D3B3B3AC13E43E394F,13711,6,23,17,38,46,1946
64989,64989,CC04DF57CD476D56A9C2711AACC54374,42861,4,5,1,37,44,1894
64990,64990,CC04DF57CD476D56A9C2711AACC54374,11261,10,11,1,36,46,1846
64991,64991,CC04DF57CD476D56A9C2711AACC54374,42861,14,18,4,37,44,1894
64992,64992,B70267EAE88B62F9B87C2FB6E0BEE8BF,43621,0,4,4,46,48,2348
64993,64993,B70267EAE88B62F9B87C2FB6E0BEE8BF,11701,4,7,3,43,48,2198
64994,64994,B70267EAE88B62F9B87C2FB6E0BEE8BF,43621,9,20,11,46,48,2348
65002,65002,ABD22C6B706374CD02FE8C4840AA3EA1,19441,1,7,6,8,46,446
65003,65003,ABD22C6B706374CD02FE8C4840AA3EA1,42041,9,10,1,10,47,547
65004,65004,ABD22C6B706374CD02FE8C4840AA3EA1,19441,12,17,5,8,46,446
65005,65005,ABD22C6B706374CD02FE8C4840AA3EA1,19021,20,23,3,10,45,545
65006,65006,039720C5318D39E34BBB18DF8027F133,42581,0,4,4,38,48,1948
65007,65007,039720C5318D39E34BBB18DF8027F133,11914,6,20,14,37,48,1898
65008,65008,039720C5318D39E34BBB18DF8027F133,40171,21,22,1,38,48,1948
65009,65009,CD5F8D7604C7020A19DDE3C48998E9F5,12831,0,4,4,34,38,1738
65010,65010,CD5F8D7604C7020A19DDE3C48998E9F5,12521,6,20,14,35,41,1791
65011,65011,CD5F8D7604C7020A19DDE3C48998E9F5,13314,21,23,2,31,39,1589
65015,65015,7E532B9EFC51FFCEA44643EB36206A13,13681,0,8,8,38,47,1947
65016,65016,7E532B9EFC51FFCEA44643EB36206A13,13011,8,10,2,39,47,1997
65017,65017,7E532B9EFC51FFCEA44643EB36206A13,13681,10,23,13,38,47,1947
65018,65018,333863A2CE0A7D471D7CF76BFFDAB0D7,12641,0,14,14,10,43,543
65019,65019,333863A2CE0A7D471D7CF76BFFDAB0D7,19744,17,18,1,6,43,343
65020,65020,333863A2CE0A7D471D7CF76BFFDAB0D7,12641,22,23,1,10,43,543
65021,65021,8D4B76C00151174BC318A19D72794912,12661,0,5,5,32,45,1645
65022,65022,8D4B76C00151174BC318A19D72794912,12311,8,10,2,30,44,1544
65023,65023,8D4B76C00151174BC318A19D72794912,12661,11,20,9,32,45,1645
65024,65024,8D4B76C00151174BC318A19D72794912,12311,20,22,2,30,44,1544
65025,65025,A249659AA4285866F354A5650B26A07F,10111,0,5,5,37,47,1897
65026,65026,A249659AA4285866F354A5650B26A07F,42161,9,13,4,36,47,1847
65027,65027,A249659AA4285866F354A5650B26A07F,10111,16,19,3,37,47,1897
65028,65028,A249659AA4285866F354A5650B26A07F,42161,20,22,2,36,47,1847
65029,65029,9B373D18DF465A949571C2DC4D46B6D8,10292,1,10,9,30,47,1547
65030,65030,9B373D18DF465A949571C2DC4D46B6D8,42523,10,11,1,31,47,1597
65031,65031,9B373D18DF465A949571C2DC4D46B6D8,10292,16,23,7,30,47,1547
65032,65032,77DE4D89070B9EFEB461D22F72589B88,11381,0,12,12,30,47,1547
65033,65033,77DE4D89070B9EFEB461D22F72589B88,11861,13,17,4,32,47,1647
65034,65034,77DE4D89070B9EFEB461D22F72589B88,11381,19,23,4,30,47,1547
65042,65042,17BFCEDD973B29E8302E2E7670AFE303,10471,7,10,3,37,48,1898
65043,65043,17BFCEDD973B29E8302E2E7670AFE303,11481,12,13,1,41,48,2098
65044,65044,17BFCEDD973B29E8302E2E7670AFE303,10471,15,23,8,37,48,1898
65049,65049,B377B1A009BB64894719A8DF0AC3F76E,12083,0,2,2,36,49,1849
65050,65050,B377B1A009BB64894719A8DF0AC3F76E,10901,2,7,5,35,48,1798
65051,65051,B377B1A009BB64894719A8DF0AC3F76E,12083,10,17,7,36,49,1849
65052,65052,B377B1A009BB64894719A8DF0AC3F76E,11231,20,23,3,37,49,1899
65053,65053,214B9A514ECE2B2C8A8458625A9B5245,42031,3,13,10,40,46,2046
65054,65054,214B9A514ECE2B2C8A8458625A9B5245,10911,16,17,1,39,46,1996
65055,65055,214B9A514ECE2B2C8A8458625A9B5245,13011,17,19,2,39,47,1997
65056,65056,214B9A514ECE2B2C8A8458625A9B5245,10911,21,22,1,39,46,1996
65060,65060,751B7CB9C035034746EB082217066F97,10351,5,9,4,28,45,1445
65061,65061,751B7CB9C035034746EB082217066F97,10711,13,15,2,29,46,1496
65062,65062,751B7CB9C035034746EB082217066F97,10351,16,18,2,28,45,1445
65063,65063,4F3F717E93BC5AFE00C4421DCBF0AA01,42301,0,8,8,36,47,1847
65064,65064,4F3F717E93BC5AFE00C4421DCBF0AA01,11261,9,11,2,36,46,1846
65065,65065,4F3F717E93BC5AFE00C4421DCBF0AA01,12514,13,17,4,38,47,1947
65066,65066,4F3F717E93BC5AFE00C4421DCBF0AA01,40322,21,23,2,38,46,1946
65070,65070,F30D3BA7D26F42A80441359D7B36D2F8,19441,0,16,16,8,46,446
65071,65071,F30D3BA7D26F42A80441359D7B36D2F8,19114,18,19,1,7,43,393
65072,65072,F30D3BA7D26F42A80441359D7B36D2F8,19441,19,23,4,8,46,446
65081,65081,31D5CE7052017F3D40BAADA2281164E1,11381,0,10,10,30,47,1547
65082,65082,31D5CE7052017F3D40BAADA2281164E1,11061,11,12,1,29,48,1498
65083,65083,31D5CE7052017F3D40BAADA2281164E1,10381,12,18,6,31,49,1599
65098,65098,A6F4E0A14DDF72AB1602B3834CD2AC43,11914,0,4,4,37,48,1898
65099,65099,A6F4E0A14DDF72AB1602B3834CD2AC43,43361,5,8,3,38,48,1948
65100,65100,A6F4E0A14DDF72AB1602B3834CD2AC43,11914,10,22,12,37,48,1898
65101,65101,46D6DC31E7F2EF1526660BA0F2594CCA,10431,0,7,7,33,49,1699
65102,65102,46D6DC31E7F2EF1526660BA0F2594CCA,10491,8,13,5,33,48,1698
65103,65103,46D6DC31E7F2EF1526660BA0F2594CCA,10431,21,23,2,33,49,1699
65104,65104,5A3DFD82E1FA00FA267419BADF9C897C,12311,1,8,7,30,44,1544
65105,65105,5A3DFD82E1FA00FA267419BADF9C897C,12661,13,17,4,32,45,1645
65106,65106,5A3DFD82E1FA00FA267419BADF9C897C,12311,18,21,3,30,44,1544
65107,65107,B570A71613653BD3890D6EDB8B29EBC3,11261,0,5,5,36,46,1846
65108,65108,B570A71613653BD3890D6EDB8B29EBC3,42861,8,17,9,37,44,1894
65109,65109,B570A71613653BD3890D6EDB8B29EBC3,11261,19,22,3,36,46,1846
65110,65110,CF6A7AF612D2CFA2B8383868CF93735B,42921,0,7,7,33,47,1697
65111,65111,CF6A7AF612D2CFA2B8383868CF93735B,42523,8,10,2,31,47,1597
65112,65112,CF6A7AF612D2CFA2B8383868CF93735B,42921,11,23,12,33,47,1697
65122,65122,BB272A37143F27FF71ADC6EC8425DD40,11001,0,3,3,42,47,2147
65123,65123,BB272A37143F27FF71ADC6EC8425DD40,42321,4,6,2,43,47,2197
65124,65124,BB272A37143F27FF71ADC6EC8425DD40,10801,10,22,12,42,47,2147
65125,65125,AA0772F0E3C8039BBC68A73D41F406C4,10661,0,9,9,37,49,1899
65126,65126,AA0772F0E3C8039BBC68A73D41F406C4,10221,14,21,7,34,49,1749
65127,65127,AA0772F0E3C8039BBC68A73D41F406C4,13121,22,23,1,38,46,1946
65133,65133,FCF6425DA3F542476DF1F93935C075D8,42581,0,8,8,38,48,1948
65134,65134,FCF6425DA3F542476DF1F93935C075D8,11914,8,11,3,37,48,1898
65135,65135,FCF6425DA3F542476DF1F93935C075D8,42581,11,23,12,38,48,1948
65136,65136,F3DCE8C3C3FF003CDF3D27C94852CCE1,11951,2,3,1,31,49,1599
65137,65137,F3DCE8C3C3FF003CDF3D27C94852CCE1,13731,15,17,2,33,49,1699
65138,65138,F3DCE8C3C3FF003CDF3D27C94852CCE1,11951,20,21,1,31,49,1599
65139,65139,A02E7FCD783D3B9FF6BA938561F51C11,42161,0,14,14,36,47,1847
65140,65140,A02E7FCD783D3B9FF6BA938561F51C11,10107,15,17,2,38,49,1949
65141,65141,A02E7FCD783D3B9FF6BA938561F51C11,10661,19,21,2,37,49,1899
65142,65142,D4191700C633456D6E890AE49001CB88,11381,0,9,9,30,47,1547
65143,65143,D4191700C633456D6E890AE49001CB88,10951,9,20,11,29,48,1498
65144,65144,D4191700C633456D6E890AE49001CB88,42501,21,22,1,28,47,1447
65148,65148,9BFAC605539D316372225D788773DC0B,43481,0,6,6,39,48,1998
65149,65149,9BFAC605539D316372225D788773DC0B,10841,7,12,5,37,47,1897
65150,65150,9BFAC605539D316372225D788773DC0B,12514,12,21,9,38,47,1947
65156,65156,C11958CA68DCC24D143388B1E6ECEAA7,11151,9,11,2,30,48,1548
65157,65157,C11958CA68DCC24D143388B1E6ECEAA7,10381,11,13,2,31,49,1599
65158,65158,C11958CA68DCC24D143388B1E6ECEAA7,11151,13,22,9,30,48,1548
65163,65163,C09518D6980FEF58716702B0765595A3,19441,0,15,15,8,46,446
65164,65164,C09518D6980FEF58716702B0765595A3,42041,15,18,3,10,47,547
65165,65165,C09518D6980FEF58716702B0765595A3,19441,18,22,4,8,46,446
65189,65189,B45CB2E1B244B3B7583778DACAAA9799,11074,0,15,15,37,47,1897
65190,65190,B45CB2E1B244B3B7583778DACAAA9799,12514,15,18,3,38,47,1947
65191,65191,B45CB2E1B244B3B7583778DACAAA9799,11074,19,21,2,37,47,1897
65207,65207,B0EA338E7DC6DCA36F1815FAB86B9F0C,42021,0,10,10,33,47,1697
65208,65208,B0EA338E7DC6DCA36F1815FAB86B9F0C,11861,13,14,1,32,47,1647
65209,65209,B0EA338E7DC6DCA36F1815FAB86B9F0C,10731,16,19,3,33,47,1697
65217,65217,2B75D649D733D42AAC85CA634BF0D07B,11914,1,3,2,37,48,1898
65218,65218,2B75D649D733D42AAC85CA634BF0D07B,42581,3,7,4,38,48,1948
65219,65219,2B75D649D733D42AAC85CA634BF0D07B,11914,7,17,10,37,48,1898
65220,65220,2B75D649D733D42AAC85CA634BF0D07B,10661,20,21,1,37,49,1899
65221,65221,46ED4A10E04186902C6EC8351807C818,11231,0,6,6,37,49,1899
65222,65222,46ED4A10E04186902C6EC8351807C818,10471,6,12,6,37,48,1898
65223,65223,46ED4A10E04186902C6EC8351807C818,11231,12,23,11,37,49,1899
65224,65224,13E7DB2A8792678EF526CBD80A3FC081,42864,0,1,1,38,44,1944
65225,65225,13E7DB2A8792678EF526CBD80A3FC081,11261,2,3,1,36,46,1846
65226,65226,13E7DB2A8792678EF526CBD80A3FC081,42861,5,19,14,37,44,1894
65230,65230,4C238BB7C5832FF7221019CFAA6E94A4,19024,0,14,14,9,45,495
65231,65231,4C238BB7C5832FF7221019CFAA6E94A4,42041,14,17,3,10,47,547
65232,65232,4C238BB7C5832FF7221019CFAA6E94A4,19024,18,23,5,9,45,495
65233,65233,7E334EEF4AA6AF36D53827B3C1D2ABFE,10471,0,10,10,37,48,1898
65234,65234,7E334EEF4AA6AF36D53827B3C1D2ABFE,11074,14,17,3,37,47,1897
65235,65235,7E334EEF4AA6AF36D53827B3C1D2ABFE,11231,17,21,4,37,49,1899
65249,65249,4816BD058D7E8FE1C2189282274CB8E1,42461,0,14,14,45,47,2297
65250,65250,4816BD058D7E8FE1C2189282274CB8E1,42321,15,18,3,43,47,2197
65251,65251,4816BD058D7E8FE1C2189282274CB8E1,42461,21,23,2,45,47,2297
65255,65255,6D67BF24EDB47D98B85D085819B0AFFA,10471,0,14,14,37,48,1898
65256,65256,6D67BF24EDB47D98B85D085819B0AFFA,10107,15,17,2,38,49,1949
65257,65257,6D67BF24EDB47D98B85D085819B0AFFA,10471,20,23,3,37,48,1898
65258,65258,302E13281DC08AB4B0CB613D73ADA12A,11381,0,6,6,30,47,1547
65259,65259,302E13281DC08AB4B0CB613D73ADA12A,42501,7,17,10,28,47,1447
65260,65260,302E13281DC08AB4B0CB613D73ADA12A,11061,20,21,1,29,48,1498
65261,65261,302E13281DC08AB4B0CB613D73ADA12A,11381,22,23,1,30,47,1547
65262,65262,9BCD563089A1D0EF43A278605DE25081,42231,3,16,13,37,46,1896
65263,65263,9BCD563089A1D0EF43A278605DE25081,42351,17,18,1,38,45,1945
65264,65264,9BCD563089A1D0EF43A278605DE25081,13911,18,19,1,39,46,1996
65265,65265,B9CF251ED2FE5E6F5770C342296FA9B0,10107,10,11,1,38,49,1949
65266,65266,B9CF251ED2FE5E6F5770C342296FA9B0,12391,12,13,1,36,49,1849
65267,65267,B9CF251ED2FE5E6F5770C342296FA9B0,42961,15,22,7,35,49,1799
65271,65271,C69B67354C52D88CB8543131D66A9B89,42231,0,14,14,37,46,1896
65272,65272,C69B67354C52D88CB8543131D66A9B89,42161,14,16,2,36,47,1847
65273,65273,C69B67354C52D88CB8543131D66A9B89,42231,19,23,4,37,46,1896
65274,65274,BB44A13BCAB0B022B18D7F4EDDEC4037,11231,0,2,2,37,49,1899
65275,65275,BB44A13BCAB0B022B18D7F4EDDEC4037,42301,2,14,12,36,47,1847
65276,65276,BB44A13BCAB0B022B18D7F4EDDEC4037,42511,15,19,4,37,47,1897
65277,65277,BB44A13BCAB0B022B18D7F4EDDEC4037,11231,19,23,4,37,49,1899
65278,65278,53493041487B5321836147FAAD536213,13941,1,9,8,41,47,2097
65279,65279,53493041487B5321836147FAAD536213,11074,10,17,7,37,47,1897
65280,65280,53493041487B5321836147FAAD536213,13101,20,23,3,40,47,2047
65281,65281,B304D2AD98C7DE24CAE6DD0DA65095F0,10431,0,6,6,33,49,1699
65282,65282,B304D2AD98C7DE24CAE6DD0DA65095F0,43581,7,18,11,33,48,1698
65283,65283,B304D2AD98C7DE24CAE6DD0DA65095F0,10431,18,23,5,33,49,1699
65284,65284,7DABAD30E6A4BC5095A72748E7C44D21,11491,0,10,10,36,47,1847
65285,65285,7DABAD30E6A4BC5095A72748E7C44D21,42351,14,15,1,38,45,1945
65286,65286,7DABAD30E6A4BC5095A72748E7C44D21,10111,18,20,2,37,47,1897
65287,65287,7DABAD30E6A4BC5095A72748E7C44D21,11491,22,23,1,36,47,1847
65288,65288,E368078C59121EE7A89865E85A806516,11541,0,7,7,35,49,1799
65289,65289,E368078C59121EE7A89865E85A806516,11531,8,12,4,34,49,1749
65290,65290,E368078C59121EE7A89865E85A806516,11541,18,23,5,35,49,1799
65291,65291,CC115E075627F49AC17F5D9D869D1EC5,19441,10,12,2,8,46,446
65292,65292,CC115E075627F49AC17F5D9D869D1EC5,42041,12,13,1,10,47,547
65293,65293,CC115E075627F49AC17F5D9D869D1EC5,19441,13,22,9,8,46,446
65308,65308,C644771D2D9F4182BC18DB70E907DF2B,42581,0,5,5,38,48,1948
65309,65309,C644771D2D9F4182BC18DB70E907DF2B,11914,6,11,5,37,48,1898
65310,65310,C644771D2D9F4182BC18DB70E907DF2B,42581,11,20,9,38,48,1948
65311,65311,942686BB7E240ABF213951E6A6F158DF,11061,9,14,5,29,48,1498
65312,65312,942686BB7E240ABF213951E6A6F158DF,11151,14,18,4,30,48,1548
65313,65313,942686BB7E240ABF213951E6A6F158DF,40094,18,19,1,29,48,1498
65325,65325,662AC36BC3766094B8DAE2C19CF05D74,11061,9,13,4,29,48,1498
65326,65326,662AC36BC3766094B8DAE2C19CF05D74,40445,13,14,1,30,48,1548
65327,65327,662AC36BC3766094B8DAE2C19CF05D74,10381,16,18,2,31,49,1599
65339,65339,8A9C8CCB7A1E04F4CF87205870574AD2,42161,0,10,10,36,47,1847
65340,65340,8A9C8CCB7A1E04F4CF87205870574AD2,42021,11,12,1,33,47,1697
65341,65341,8A9C8CCB7A1E04F4CF87205870574AD2,10251,12,17,5,35,47,1797
65342,65342,8A9C8CCB7A1E04F4CF87205870574AD2,42161,18,23,5,36,47,1847
65343,65343,C7B7BC9315B26F0822B647A376C0B876,11591,0,5,5,36,49,1849
65344,65344,C7B7BC9315B26F0822B647A376C0B876,11531,6,8,2,34,49,1749
65345,65345,C7B7BC9315B26F0822B647A376C0B876,43321,8,23,15,36,49,1849
65349,65349,84DA01F112661472BCB344139BA68924,43061,0,13,13,43,46,2196
65350,65350,84DA01F112661472BCB344139BA68924,13341,14,18,4,44,45,2245
65351,65351,84DA01F112661472BCB344139BA68924,43061,21,23,2,43,46,2196
65352,65352,27278737D09D5670A3F233313E8FF2D1,10341,1,13,12,31,47,1597
65353,65353,27278737D09D5670A3F233313E8FF2D1,11861,13,18,5,32,47,1647
65354,65354,27278737D09D5670A3F233313E8FF2D1,10341,20,23,3,31,47,1597
65367,65367,6674D07D10608B5E348782D3250F103A,11381,0,11,11,30,47,1547
65368,65368,6674D07D10608B5E348782D3250F103A,11831,11,17,6,32,45,1645
65369,65369,6674D07D10608B5E348782D3250F103A,11381,17,23,6,30,47,1547
65370,65370,7CDA82E0D77A9610B3A7CAD35C74C33A,11491,0,13,13,36,47,1847
65371,65371,7CDA82E0D77A9610B3A7CAD35C74C33A,42151,16,18,2,35,45,1795
65372,65372,7CDA82E0D77A9610B3A7CAD35C74C33A,11261,19,20,1,36,46,1846
65373,65373,7CDA82E0D77A9610B3A7CAD35C74C33A,11491,22,23,1,36,47,1847
65374,65374,9B0A889ECA58DF7D794EAD4D202CEB4E,43581,0,6,6,33,48,1698
65375,65375,9B0A889ECA58DF7D794EAD4D202CEB4E,10401,9,10,1,33,49,1699
65376,65376,9B0A889ECA58DF7D794EAD4D202CEB4E,43581,12,23,11,33,48,1698
65380,65380,EB3F1E97C488E972B65B1AF3C2A86B31,13331,0,1,1,38,47,1947
65381,65381,EB3F1E97C488E972B65B1AF3C2A86B31,42331,2,12,10,39,46,1996
65382,65382,EB3F1E97C488E972B65B1AF3C2A86B31,40123,13,23,10,38,47,1947
65383,65383,1788FF83230593384DFEF88881720D90,13551,0,7,7,45,38,2288
65384,65384,1788FF83230593384DFEF88881720D90,43101,9,17,8,46,40,2340
65385,65385,1788FF83230593384DFEF88881720D90,13551,18,23,5,45,38,2288
65386,65386,F7F6E311089E545E2ADE21E1CFF4D206,40636,0,2,2,35,48,1798
65387,65387,F7F6E311089E545E2ADE21E1CFF4D206,43761,4,18,14,32,47,1647
65388,65388,F7F6E311089E545E2ADE21E1CFF4D206,40636,20,23,3,35,48,1798
65394,65394,145E734E186950C5FCF9FF61BBA7968A,42371,0,1,1,34,46,1746
65395,65395,145E734E186950C5FCF9FF61BBA7968A,12161,2,8,6,32,46,1646
65396,65396,145E734E186950C5FCF9FF61BBA7968A,42161,9,23,14,36,47,1847
65397,65397,1658E318B68367B87E9D322B1062FD51,11021,0,17,17,36,49,1849
65398,65398,1658E318B68367B87E9D322B1062FD51,10107,19,20,1,38,49,1949
65399,65399,1658E318B68367B87E9D322B1062FD51,11021,21,23,2,36,49,1849
65400,65400,5674984FCE5B2DA13047CB9492AF31B3,43951,6,8,2,49,41,2491
65401,65401,5674984FCE5B2DA13047CB9492AF31B3,43101,11,13,2,46,40,2340
65402,65402,5674984FCE5B2DA13047CB9492AF31B3,43951,14,23,9,49,41,2491
65420,65420,0DFD98C5BF618352145AEF64606DF221,10251,1,4,3,35,47,1797
65421,65421,0DFD98C5BF618352145AEF64606DF221,40673,6,19,13,36,48,1848
65422,65422,0DFD98C5BF618352145AEF64606DF221,42401,21,23,2,36,47,1847
65428,65428,31100BE8BDE5B74B2D64B60F8888BAE5,10111,0,7,7,37,47,1897
65429,65429,31100BE8BDE5B74B2D64B60F8888BAE5,40637,8,9,1,36,47,1847
65430,65430,31100BE8BDE5B74B2D64B60F8888BAE5,10111,12,23,11,37,47,1897
65434,65434,F9BFC425350DF15984429AB66FE10A91,42021,0,1,1,33,47,1697
65435,65435,F9BFC425350DF15984429AB66FE10A91,43161,1,5,4,35,47,1797
65436,65436,F9BFC425350DF15984429AB66FE10A91,42021,6,23,17,33,47,1697
65437,65437,47C1473BA4462B22BD05E79B53CFA190,42041,6,7,1,10,47,547
65438,65438,47C1473BA4462B22BD05E79B53CFA190,19441,9,10,1,8,46,446
65439,65439,47C1473BA4462B22BD05E79B53CFA190,42041,12,17,5,10,47,547
65440,65440,47C1473BA4462B22BD05E79B53CFA190,12641,21,23,2,10,43,543
65450,65450,E7730801B6702F8BD36B84F8DA0A17A9,19181,0,4,4,8,40,440
65451,65451,E7730801B6702F8BD36B84F8DA0A17A9,12921,4,5,1,9,41,491
65452,65452,E7730801B6702F8BD36B84F8DA0A17A9,19181,6,23,17,8,40,440
65453,65453,99EE4A73E608F7C26ACE18786D34F32E,19441,5,7,2,8,46,446
65454,65454,99EE4A73E608F7C26ACE18786D34F32E,19021,8,21,13,10,45,545
65455,65455,99EE4A73E608F7C26ACE18786D34F32E,19441,21,22,1,8,46,446
65456,65456,B09144E053E0EC9288D632948891CAF2,13911,0,6,6,39,46,1996
65457,65457,B09144E053E0EC9288D632948891CAF2,11261,8,9,1,36,46,1846
65458,65458,B09144E053E0EC9288D632948891CAF2,13911,12,14,2,39,46,1996
65459,65459,B09144E053E0EC9288D632948891CAF2,42231,18,19,1,37,46,1896
65467,65467,F776CF5BFCBAFE40EFE079BFD8CF34A4,19901,0,5,5,7,44,394
65468,65468,F776CF5BFCBAFE40EFE079BFD8CF34A4,19111,7,11,4,9,45,495
65469,65469,F776CF5BFCBAFE40EFE079BFD8CF34A4,12641,13,19,6,10,43,543
65470,65470,7B599A17DB57B9B309E1D14701ECD704,19441,0,13,13,8,46,446
65471,65471,7B599A17DB57B9B309E1D14701ECD704,42041,14,18,4,10,47,547
65472,65472,7B599A17DB57B9B309E1D14701ECD704,19441,18,23,5,8,46,446
65476,65476,FFC82A5377A1B8878F0174F77D838706,10841,8,12,4,37,47,1897
65477,65477,FFC82A5377A1B8878F0174F77D838706,10154,13,14,1,33,47,1697
65478,65478,FFC82A5377A1B8878F0174F77D838706,10191,21,23,2,40,48,2048
65487,65487,CD8F8ECD6C484214361C94940E3BD476,42581,0,5,5,38,48,1948
65488,65488,CD8F8ECD6C484214361C94940E3BD476,10471,7,16,9,37,48,1898
65489,65489,CD8F8ECD6C484214361C94940E3BD476,42581,18,19,1,38,48,1948
65490,65490,CD8F8ECD6C484214361C94940E3BD476,10471,19,22,3,37,48,1898
65497,65497,0B2A92CB01E0E95C741AFADF50C7B551,10121,0,6,6,36,49,1849
65498,65498,0B2A92CB01E0E95C741AFADF50C7B551,11231,8,9,1,37,49,1899
65499,65499,0B2A92CB01E0E95C741AFADF50C7B551,10121,17,18,1,36,49,1849
65508,65508,081C42D8164EA39CD76978886CD1161E,12514,0,2,2,38,47,1947
65509,65509,081C42D8164EA39CD76978886CD1161E,42331,2,7,5,39,46,1996
65510,65510,081C42D8164EA39CD76978886CD1161E,13331,7,23,16,38,47,1947
65511,65511,C9FF8A5216EA719617BFA5E0EC5EC68F,19441,1,13,12,8,46,446
65512,65512,C9FF8A5216EA719617BFA5E0EC5EC68F,42041,14,17,3,10,47,547
65513,65513,C9FF8A5216EA719617BFA5E0EC5EC68F,19441,17,18,1,8,46,446
65525,65525,C426791FBB51630EB1F377A479E530AA,13651,4,8,4,30,47,1547
65526,65526,C426791FBB51630EB1F377A479E530AA,42291,13,14,1,29,48,1498
65527,65527,C426791FBB51630EB1F377A479E530AA,13651,14,23,9,30,47,1547
65528,65528,A0E63C19881C3EAB783B3E1E3BB95F15,13381,0,7,7,39,47,1997
65529,65529,A0E63C19881C3EAB783B3E1E3BB95F15,42161,12,20,8,36,47,1847
65530,65530,A0E63C19881C3EAB783B3E1E3BB95F15,13381,21,23,2,39,47,1997
65531,65531,4DA57F9F33C37E2CA21407DE781C18AF,13911,0,4,4,39,46,1996
65532,65532,4DA57F9F33C37E2CA21407DE781C18AF,11261,5,6,1,36,46,1846
65533,65533,4DA57F9F33C37E2CA21407DE781C18AF,13911,6,17,11,39,46,1996
65534,65534,4DA57F9F33C37E2CA21407DE781C18AF,11261,18,20,2,36,46,1846
65541,65541,B855E84BF722A366F6E79AEB62045285,10271,0,6,6,37,46,1896
65542,65542,B855E84BF722A366F6E79AEB62045285,13121,9,10,1,38,46,1946
65543,65543,B855E84BF722A366F6E79AEB62045285,10271,14,23,9,37,46,1896
65561,65561,2BD50A9E2F6694399923348F8D889562,13651,1,12,11,30,47,1547
65562,65562,2BD50A9E2F6694399923348F8D889562,11861,13,18,5,32,47,1647
65563,65563,2BD50A9E2F6694399923348F8D889562,13651,18,20,2,30,47,1547
65564,65564,2BD50A9E2F6694399923348F8D889562,12121,21,22,1,29,47,1497
65574,65574,69EAF8E4E5F831CE44362C43E1F3AA99,43051,1,6,5,46,45,2345
65575,65575,69EAF8E4E5F831CE44362C43E1F3AA99,10751,12,13,1,47,43,2393
65576,65576,69EAF8E4E5F831CE44362C43E1F3AA99,43051,21,23,2,46,45,2345
65585,65585,8C06039C1C226EB3CE6948CCB9366F64,13101,0,7,7,40,47,2047
65586,65586,8C06039C1C226EB3CE6948CCB9366F64,13271,11,12,1,41,47,2097
65587,65587,8C06039C1C226EB3CE6948CCB9366F64,13101,16,21,5,40,47,2047
65588,65588,4A04EF62C1EDB06A3C08C9EBC37E91F2,19441,0,12,12,8,46,446
65589,65589,4A04EF62C1EDB06A3C08C9EBC37E91F2,42041,12,18,6,10,47,547
65590,65590,4A04EF62C1EDB06A3C08C9EBC37E91F2,19441,18,23,5,8,46,446
65591,65591,692AC6DE13BF1FE0F43D1EA4E139D774,10841,0,10,10,37,47,1897
65592,65592,692AC6DE13BF1FE0F43D1EA4E139D774,13331,11,12,1,38,47,1947
65593,65593,692AC6DE13BF1FE0F43D1EA4E139D774,10841,13,15,2,37,47,1897
65594,65594,692AC6DE13BF1FE0F43D1EA4E139D774,12514,16,18,2,38,47,1947
65595,65595,0C9ED0C47607BCA4D106D92E34AC5771,11351,0,8,8,36,48,1848
65596,65596,0C9ED0C47607BCA4D106D92E34AC5771,12083,12,14,2,36,49,1849
65597,65597,0C9ED0C47607BCA4D106D92E34AC5771,12514,15,18,3,38,47,1947
65598,65598,0C9ED0C47607BCA4D106D92E34AC5771,11731,19,23,4,36,48,1848
65599,65599,78B2E7B8831263CC9BC81F6451782DFC,42351,2,6,4,38,45,1945
65600,65600,78B2E7B8831263CC9BC81F6451782DFC,42231,9,11,2,37,46,1896
65601,65601,78B2E7B8831263CC9BC81F6451782DFC,42351,15,17,2,38,45,1945
65602,65602,78B2E7B8831263CC9BC81F6451782DFC,42231,17,21,4,37,46,1896
65609,65609,B8C6398EF763EBDD609DCCA75A70C5F8,11324,0,8,8,31,46,1596
65610,65610,B8C6398EF763EBDD609DCCA75A70C5F8,11061,8,18,10,29,48,1498
65611,65611,B8C6398EF763EBDD609DCCA75A70C5F8,10381,19,23,4,31,49,1599
65612,65612,ACF091EB1E15063CE70493C1F0B4FB69,19441,0,6,6,8,46,446
65613,65613,ACF091EB1E15063CE70493C1F0B4FB69,19024,9,10,1,9,45,495
65614,65614,ACF091EB1E15063CE70493C1F0B4FB69,19441,13,22,9,8,46,446
65621,65621,CF80F31EBF67073D10E7C3F7B94057C0,11074,0,7,7,37,47,1897
65622,65622,CF80F31EBF67073D10E7C3F7B94057C0,41005,8,9,1,38,47,1947
65623,65623,CF80F31EBF67073D10E7C3F7B94057C0,11074,10,14,4,37,47,1897
65624,65624,CF80F31EBF67073D10E7C3F7B94057C0,40491,15,19,4,39,49,1999
65630,65630,DFC4DD539A0AC8E0A8DC86137C9DCBA9,19441,0,15,15,8,46,446
65631,65631,DFC4DD539A0AC8E0A8DC86137C9DCBA9,42041,15,16,1,10,47,547
65632,65632,DFC4DD539A0AC8E0A8DC86137C9DCBA9,19441,18,23,5,8,46,446
65649,65649,C7DA09D84BB6D5A3ABEAD976C8C0731E,42861,0,5,5,37,44,1894
65650,65650,C7DA09D84BB6D5A3ABEAD976C8C0731E,11261,6,7,1,36,46,1846
65651,65651,C7DA09D84BB6D5A3ABEAD976C8C0731E,42861,12,23,11,37,44,1894
65674,65674,F2229754FABF7F398D6839D6208AC86F,10544,0,8,8,28,48,1448
65675,65675,F2229754FABF7F398D6839D6208AC86F,10381,8,14,6,31,49,1599
65676,65676,F2229754FABF7F398D6839D6208AC86F,10544,14,22,8,28,48,1448
65687,65687,6FF0FFC6286BA2367A45E8654F4EAA2F,42581,0,5,5,38,48,1948
65688,65688,6FF0FFC6286BA2367A45E8654F4EAA2F,11914,8,16,8,37,48,1898
65689,65689,6FF0FFC6286BA2367A45E8654F4EAA2F,42581,20,22,2,38,48,1948
65703,65703,92C298774EE2079F8846BCF9DC40CF98,10691,0,13,13,33,48,1698
65704,65704,92C298774EE2079F8846BCF9DC40CF98,42021,14,15,1,33,47,1697
65705,65705,92C298774EE2079F8846BCF9DC40CF98,10691,18,23,5,33,48,1698
65706,65706,E2C4795BF86D8DDF54D3618A77485523,10111,0,17,17,37,47,1897
65707,65707,E2C4795BF86D8DDF54D3618A77485523,42161,17,18,1,36,47,1847
65708,65708,E2C4795BF86D8DDF54D3618A77485523,42511,19,22,3,37,47,1897
65719,65719,57068447BEEE4D7969FF166D57966ECA,42541,0,6,6,25,47,1297
65720,65720,57068447BEEE4D7969FF166D57966ECA,11361,6,17,11,22,48,1148
65721,65721,57068447BEEE4D7969FF166D57966ECA,42541,21,23,2,25,47,1297
65722,65722,078D744FD5840DE4508E7DD5C66617FF,42351,8,10,2,38,45,1945
65723,65723,078D744FD5840DE4508E7DD5C66617FF,11261,10,11,1,36,46,1846
65724,65724,078D744FD5840DE4508E7DD5C66617FF,42351,12,14,2,38,45,1945
65725,65725,078D744FD5840DE4508E7DD5C66617FF,11261,15,22,7,36,46,1846
65726,65726,D97D0DE3B0A1EE9C464420BCF156A512,13651,1,3,2,30,47,1547
65727,65727,D97D0DE3B0A1EE9C464420BCF156A512,12121,6,10,4,29,47,1497
65728,65728,D97D0DE3B0A1EE9C464420BCF156A512,13651,10,23,13,30,47,1547
65729,65729,4184E3FF971C281C08C6293355FE7F7B,11481,0,12,12,41,48,2098
65730,65730,4184E3FF971C281C08C6293355FE7F7B,42281,12,13,1,40,48,2048
65731,65731,4184E3FF971C281C08C6293355FE7F7B,11481,13,18,5,41,48,2098
65745,65745,0DD480B5A13E261C7A404CA1C7C938C6,13121,0,11,11,38,46,1946
65746,65746,0DD480B5A13E261C7A404CA1C7C938C6,42511,15,17,2,37,47,1897
65747,65747,0DD480B5A13E261C7A404CA1C7C938C6,13121,19,23,4,38,46,1946
65751,65751,047314A2DE7ABD5E7894179964BD4305,19441,0,11,11,8,46,446
65752,65752,047314A2DE7ABD5E7894179964BD4305,42041,12,13,1,10,47,547
65753,65753,047314A2DE7ABD5E7894179964BD4305,19441,13,17,4,8,46,446
65754,65754,047314A2DE7ABD5E7894179964BD4305,42041,20,21,1,10,47,547
65761,65761,CA3B25ECD9821EFD5808E8E7EB918834,19441,1,15,14,8,46,446
65762,65762,CA3B25ECD9821EFD5808E8E7EB918834,42041,15,17,2,10,47,547
65763,65763,CA3B25ECD9821EFD5808E8E7EB918834,19441,19,23,4,8,46,446
65764,65764,EC57E33248ACEF6B14CA4470A7B4BE9F,12083,0,2,2,36,49,1849
65765,65765,EC57E33248ACEF6B14CA4470A7B4BE9F,10281,2,10,8,33,48,1698
65766,65766,EC57E33248ACEF6B14CA4470A7B4BE9F,13331,14,21,7,38,47,1947
65767,65767,4BE03AB7B88CA8091DBCEF6257C15779,43761,0,3,3,32,47,1647
65768,65768,4BE03AB7B88CA8091DBCEF6257C15779,42371,3,4,1,34,46,1746
65769,65769,4BE03AB7B88CA8091DBCEF6257C15779,43761,7,22,15,32,47,1647
65777,65777,C1BC146C1B557BAE93465B186B08C3FA,12311,0,10,10,30,44,1544
65778,65778,C1BC146C1B557BAE93465B186B08C3FA,12661,14,18,4,32,45,1645
65779,65779,C1BC146C1B557BAE93465B186B08C3FA,12311,18,22,4,30,44,1544
65780,65780,D2E6AB586A09EFBBD099D10181890291,11061,0,8,8,29,48,1498
65781,65781,D2E6AB586A09EFBBD099D10181890291,42501,12,16,4,28,47,1447
65782,65782,D2E6AB586A09EFBBD099D10181890291,12121,19,22,3,29,47,1497
65798,65798,4B1A96E6E53566DE6CD1B08886777B4D,43731,0,6,6,34,47,1747
65799,65799,4B1A96E6E53566DE6CD1B08886777B4D,42921,8,13,5,33,47,1697
65800,65800,4B1A96E6E53566DE6CD1B08886777B4D,43731,13,23,10,34,47,1747
65801,65801,F725A3F859B25741A70E1B3AC0517A8A,10111,0,11,11,37,47,1897
65802,65802,F725A3F859B25741A70E1B3AC0517A8A,42301,12,13,1,36,47,1847
65803,65803,F725A3F859B25741A70E1B3AC0517A8A,10111,13,19,6,37,47,1897
65804,65804,B9929F40763CB94008FFAA3535991880,42301,2,3,1,36,47,1847
65805,65805,B9929F40763CB94008FFAA3535991880,13121,5,6,1,38,46,1946
65806,65806,B9929F40763CB94008FFAA3535991880,42301,6,8,2,36,47,1847
65807,65807,B9929F40763CB94008FFAA3535991880,13121,8,22,14,38,46,1946
65808,65808,F8E5692DC64F594EE622EF21A4844BEB,19114,0,6,6,7,43,393
65809,65809,F8E5692DC64F594EE622EF21A4844BEB,12641,6,7,1,10,43,543
65810,65810,F8E5692DC64F594EE622EF21A4844BEB,12921,9,11,2,9,41,491
65811,65811,F8E5692DC64F594EE622EF21A4844BEB,19114,11,22,11,7,43,393
65812,65812,BA15DC6C0ABD3A777DEBA47239AE9A3B,11151,0,5,5,30,48,1548
65813,65813,BA15DC6C0ABD3A777DEBA47239AE9A3B,10381,10,12,2,31,49,1599
65814,65814,BA15DC6C0ABD3A777DEBA47239AE9A3B,11061,16,17,1,29,48,1498
65815,65815,BA15DC6C0ABD3A777DEBA47239AE9A3B,10681,18,19,1,30,48,1548
65822,65822,F82B0744060E830A6F1F73EAFE27E504,43621,0,6,6,46,48,2348
65823,65823,F82B0744060E830A6F1F73EAFE27E504,13471,7,11,4,47,49,2399
65824,65824,F82B0744060E830A6F1F73EAFE27E504,42321,13,18,5,43,47,2197
65831,65831,AE4A6270CFE8D53376809A1F5BCB61EF,40421,0,5,5,37,48,1898
65832,65832,AE4A6270CFE8D53376809A1F5BCB61EF,11074,7,16,9,37,47,1897
65833,65833,AE4A6270CFE8D53376809A1F5BCB61EF,40421,18,19,1,37,48,1898
65834,65834,AE4A6270CFE8D53376809A1F5BCB61EF,11074,19,21,2,37,47,1897
65835,65835,A67556B4B8FB75D5E258CF8F82E11551,10111,1,9,8,37,47,1897
65836,65836,A67556B4B8FB75D5E258CF8F82E11551,11331,12,13,1,37,48,1898
65837,65837,A67556B4B8FB75D5E258CF8F82E11551,10111,14,23,9,37,47,1897
65838,65838,1846E44CCA2E3A6B814B078932AB4837,43671,0,8,8,35,48,1798
65839,65839,1846E44CCA2E3A6B814B078932AB4837,11201,10,16,6,35,49,1799
65840,65840,1846E44CCA2E3A6B814B078932AB4837,40951,19,22,3,36,49,1849
65862,65862,1B83FAC3F59813014CE45FBC6E21E9E8,12514,6,7,1,38,47,1947
65863,65863,1B83FAC3F59813014CE45FBC6E21E9E8,10841,7,14,7,37,47,1897
65864,65864,1B83FAC3F59813014CE45FBC6E21E9E8,12514,16,18,2,38,47,1947
65865,65865,6C7DE4B4696563CBDA9D3C6E4FCAB652,10341,0,9,9,31,47,1597
65866,65866,6C7DE4B4696563CBDA9D3C6E4FCAB652,10292,13,15,2,30,47,1547
65867,65867,6C7DE4B4696563CBDA9D3C6E4FCAB652,10341,17,23,6,31,47,1597
65871,65871,07371D92249265FE55F9673D8539D18E,42301,1,10,9,36,47,1847
65872,65872,07371D92249265FE55F9673D8539D18E,11074,12,14,2,37,47,1897
65873,65873,07371D92249265FE55F9673D8539D18E,42301,14,22,8,36,47,1847
65878,65878,47BD90FF18C5C6120B29A51C7AAA3770,11261,10,12,2,36,46,1846
65879,65879,47BD90FF18C5C6120B29A51C7AAA3770,42351,12,13,1,38,45,1945
65880,65880,47BD90FF18C5C6120B29A51C7AAA3770,11261,17,23,6,36,46,1846
65881,65881,A99DE7D86F2D30649282D24CB5ECED25,42301,0,10,10,36,47,1847
65882,65882,A99DE7D86F2D30649282D24CB5ECED25,42941,12,13,1,37,47,1897
65883,65883,A99DE7D86F2D30649282D24CB5ECED25,42301,18,23,5,36,47,1847
65884,65884,441E401293D6FFC8E080552D376784E1,42581,0,6,6,38,48,1948
65885,65885,441E401293D6FFC8E080552D376784E1,11914,6,12,6,37,48,1898
65886,65886,441E401293D6FFC8E080552D376784E1,42581,12,22,10,38,48,1948
65899,65899,03ED86F5BE3D351350BAE58E2A3698E8,13681,2,8,6,38,47,1947
65900,65900,03ED86F5BE3D351350BAE58E2A3698E8,13941,12,13,1,41,47,2097
65901,65901,03ED86F5BE3D351350BAE58E2A3698E8,13561,15,19,4,37,49,1899
65902,65902,EAB1206E637968E97F3FFF57BD5C26A6,11521,1,11,10,41,48,2098
65903,65903,EAB1206E637968E97F3FFF57BD5C26A6,13961,11,13,2,42,48,2148
65904,65904,EAB1206E637968E97F3FFF57BD5C26A6,10771,17,19,2,41,46,2096
65905,65905,EAB1206E637968E97F3FFF57BD5C26A6,13961,20,23,3,42,48,2148
65912,65912,6F64E5A949361CF5AB286EBB3093F0D5,19441,0,6,6,8,46,446
65913,65913,6F64E5A949361CF5AB286EBB3093F0D5,19621,6,13,7,5,46,296
65914,65914,6F64E5A949361CF5AB286EBB3093F0D5,19441,14,16,2,8,46,446
65915,65915,6F64E5A949361CF5AB286EBB3093F0D5,19621,17,23,6,5,46,296
65921,65921,6D62BE8B751688E1124EF442CD693D0D,12641,0,6,6,10,43,543
65922,65922,6D62BE8B751688E1124EF442CD693D0D,19114,8,9,1,7,43,393
65923,65923,6D62BE8B751688E1124EF442CD693D0D,12641,14,20,6,10,43,543
65924,65924,F270E2429049EC12B817A3B7398AF53A,10111,3,10,7,37,47,1897
65925,65925,F270E2429049EC12B817A3B7398AF53A,42301,11,12,1,36,47,1847
65926,65926,F270E2429049EC12B817A3B7398AF53A,42151,15,18,3,35,45,1795
65927,65927,F270E2429049EC12B817A3B7398AF53A,10111,21,22,1,37,47,1897
65935,65935,EF7EE9F0825E500C83748044E0BD2521,13651,0,8,8,30,47,1547
65936,65936,EF7EE9F0825E500C83748044E0BD2521,10351,12,16,4,28,45,1445
65937,65937,EF7EE9F0825E500C83748044E0BD2521,13651,20,23,3,30,47,1547
65941,65941,D500A33E5EBF4610FFE1DAD30674EBEB,42281,0,7,7,40,48,2048
65942,65942,D500A33E5EBF4610FFE1DAD30674EBEB,10801,8,9,1,42,47,2147
65943,65943,D500A33E5EBF4610FFE1DAD30674EBEB,12514,10,12,2,38,47,1947
65944,65944,D500A33E5EBF4610FFE1DAD30674EBEB,42281,12,23,11,40,48,2048
65945,65945,B896148F02B54F70CF09F4303DF87A20,19741,0,7,7,5,44,294
65946,65946,B896148F02B54F70CF09F4303DF87A20,19061,10,12,2,3,43,193
65947,65947,B896148F02B54F70CF09F4303DF87A20,19621,18,20,2,5,46,296
65948,65948,B896148F02B54F70CF09F4303DF87A20,19931,21,23,2,7,43,393
65949,65949,79180DDD86B22B2BAEB51E3552560D4E,11381,0,13,13,30,47,1547
65950,65950,79180DDD86B22B2BAEB51E3552560D4E,10341,13,14,1,31,47,1597
65951,65951,79180DDD86B22B2BAEB51E3552560D4E,11381,16,20,4,30,47,1547
65952,65952,79180DDD86B22B2BAEB51E3552560D4E,42523,21,22,1,31,47,1597
65953,65953,B330B6F87FA34F7466DC67C7BC5F8853,11921,0,17,17,38,48,1948
65954,65954,B330B6F87FA34F7466DC67C7BC5F8853,12514,18,21,3,38,47,1947
65955,65955,B330B6F87FA34F7466DC67C7BC5F8853,11921,22,23,1,38,48,1948
65956,65956,E0F1670DB5561200EEDBAB1833327673,11921,0,9,9,38,48,1948
65957,65957,E0F1670DB5561200EEDBAB1833327673,10111,10,20,10,37,47,1897
65958,65958,E0F1670DB5561200EEDBAB1833327673,11921,20,23,3,38,48,1948
65959,65959,B7783E40C231BF2A915C5200F2E2562A,12031,0,8,8,33,48,1698
65960,65960,B7783E40C231BF2A915C5200F2E2562A,40951,12,18,6,36,49,1849
65961,65961,B7783E40C231BF2A915C5200F2E2562A,12031,19,21,2,33,48,1698
65965,65965,8F8152ABCDBBD4CE857B1EFCB582F5D2,11074,0,15,15,37,47,1897
65966,65966,8F8152ABCDBBD4CE857B1EFCB582F5D2,11751,17,18,1,35,48,1798
65967,65967,8F8152ABCDBBD4CE857B1EFCB582F5D2,10161,19,20,1,35,49,1799
65968,65968,6F6F174BF3BBBF4A283E7794B5A58265,11914,0,12,12,37,48,1898
65969,65969,6F6F174BF3BBBF4A283E7794B5A58265,42581,13,14,1,38,48,1948
65970,65970,6F6F174BF3BBBF4A283E7794B5A58265,11914,16,23,7,37,48,1898
65979,65979,88182B8F0A08A7B6CD3790FE87C79F47,42231,0,13,13,37,46,1896
65980,65980,88182B8F0A08A7B6CD3790FE87C79F47,42351,14,16,2,38,45,1945
65981,65981,88182B8F0A08A7B6CD3790FE87C79F47,42231,16,22,6,37,46,1896
65982,65982,88182B8F0A08A7B6CD3790FE87C79F47,42351,22,23,1,38,45,1945
65988,65988,3E17C9F881E8F571652BFE5E841845EF,11861,0,2,2,32,47,1647
65989,65989,3E17C9F881E8F571652BFE5E841845EF,10281,3,5,2,33,48,1698
65990,65990,3E17C9F881E8F571652BFE5E841845EF,11861,5,23,18,32,47,1647
65991,65991,1CD741282378ACECE229BFA3E57C9431,19441,0,14,14,8,46,446
65992,65992,1CD741282378ACECE229BFA3E57C9431,42041,14,15,1,10,47,547
65993,65993,1CD741282378ACECE229BFA3E57C9431,19441,15,21,6,8,46,446
65997,65997,878DD44EE8FA6A43A619DDA4A892D760,11806,0,8,8,41,48,2098
65998,65998,878DD44EE8FA6A43A619DDA4A892D760,42271,8,10,2,40,47,2047
65999,65999,878DD44EE8FA6A43A619DDA4A892D760,11806,12,19,7,41,48,2098
66004,66004,2FD89CCA6ACCAD66068A25483F42F123,11231,0,17,17,37,49,1899
66005,66005,2FD89CCA6ACCAD66068A25483F42F123,42161,18,19,1,36,47,1847
66006,66006,2FD89CCA6ACCAD66068A25483F42F123,11231,19,23,4,37,49,1899
66010,66010,EB723F2604EF7AE7C37A9459E67C1BA0,13911,2,8,6,39,46,1996
66011,66011,EB723F2604EF7AE7C37A9459E67C1BA0,11261,8,17,9,36,46,1846
66012,66012,EB723F2604EF7AE7C37A9459E67C1BA0,42231,18,20,2,37,46,1896
66013,66013,EB723F2604EF7AE7C37A9459E67C1BA0,13911,21,23,2,39,46,1996
66024,66024,A2299A3E28F50E01E4420CAF53515EB0,11021,0,2,2,36,49,1849
66025,66025,A2299A3E28F50E01E4420CAF53515EB0,11351,5,10,5,36,48,1848
66026,66026,A2299A3E28F50E01E4420CAF53515EB0,11201,11,12,1,35,49,1799
66027,66027,A2299A3E28F50E01E4420CAF53515EB0,11351,13,19,6,36,48,1848
66031,66031,DC9D8459A1C91A7E063D2DC1FB280BD0,40637,0,2,2,36,47,1847
66032,66032,DC9D8459A1C91A7E063D2DC1FB280BD0,11261,3,8,5,36,46,1846
66033,66033,DC9D8459A1C91A7E063D2DC1FB280BD0,10841,8,17,9,37,47,1897
66034,66034,DC9D8459A1C91A7E063D2DC1FB280BD0,11491,17,20,3,36,47,1847
66054,66054,93009210860BDDA03DDE81542E8F3857,10107,0,1,1,38,49,1949
66055,66055,93009210860BDDA03DDE81542E8F3857,42941,1,12,11,37,47,1897
66056,66056,93009210860BDDA03DDE81542E8F3857,42301,16,19,3,36,47,1847
66057,66057,93009210860BDDA03DDE81542E8F3857,42941,21,23,2,37,47,1897
66058,66058,CB6CE8B284764CB65EC4187E6FE5A3FF,11571,0,1,1,13,46,696
66059,66059,CB6CE8B284764CB65EC4187E6FE5A3FF,19021,1,11,10,10,45,545
66060,66060,CB6CE8B284764CB65EC4187E6FE5A3FF,11571,13,22,9,13,46,696
66067,66067,1A9DAEEEE45E6D6064E98B4F317D57C3,42271,0,13,13,40,47,2047
66068,66068,1A9DAEEEE45E6D6064E98B4F317D57C3,43481,15,16,1,39,48,1998
66069,66069,1A9DAEEEE45E6D6064E98B4F317D57C3,42271,16,18,2,40,47,2047
66070,66070,1A9DAEEEE45E6D6064E98B4F317D57C3,43481,20,21,1,39,48,1998
66071,66071,BB6408B6449FE57F7E33631A828BC98E,11521,1,2,1,41,48,2098
66072,66072,BB6408B6449FE57F7E33631A828BC98E,42201,3,13,10,43,46,2196
66073,66073,BB6408B6449FE57F7E33631A828BC98E,11701,13,15,2,43,48,2198
66074,66074,BB6408B6449FE57F7E33631A828BC98E,10421,20,21,1,41,48,2098
66075,66075,C1D2C2901CF533B6CB18DAF48EC3DD33,11231,6,13,7,37,49,1899
66076,66076,C1D2C2901CF533B6CB18DAF48EC3DD33,10471,14,17,3,37,48,1898
66077,66077,C1D2C2901CF533B6CB18DAF48EC3DD33,11231,18,19,1,37,49,1899
66078,66078,1DD1A250791E8DE9D0B949B1DAE230C8,11861,0,15,15,32,47,1647
66079,66079,1DD1A250791E8DE9D0B949B1DAE230C8,10281,16,17,1,33,48,1698
66080,66080,1DD1A250791E8DE9D0B949B1DAE230C8,11861,18,22,4,32,47,1647
66081,66081,0CEDFC599FE515911C8AF1ADD0F867C7,10841,0,13,13,37,47,1897
66082,66082,0CEDFC599FE515911C8AF1ADD0F867C7,42301,14,16,2,36,47,1847
66083,66083,0CEDFC599FE515911C8AF1ADD0F867C7,42511,18,23,5,37,47,1897
66087,66087,93CFE6F92CFCB7F9001F363C57FDDBCE,42071,6,8,2,31,49,1599
66088,66088,93CFE6F92CFCB7F9001F363C57FDDBCE,11381,11,13,2,30,47,1547
66089,66089,93CFE6F92CFCB7F9001F363C57FDDBCE,42071,14,22,8,31,49,1599
66090,66090,ACFFCEADC3F589A8F690FE2669E3730D,19441,1,6,5,8,46,446
66091,66091,ACFFCEADC3F589A8F690FE2669E3730D,42041,8,17,9,10,47,547
66092,66092,ACFFCEADC3F589A8F690FE2669E3730D,19441,21,23,2,8,46,446
66093,66093,6166F4BC9B2530F6FDAD5A0233FBAAD6,11914,6,8,2,37,48,1898
66094,66094,6166F4BC9B2530F6FDAD5A0233FBAAD6,40171,9,18,9,38,48,1948
66095,66095,6166F4BC9B2530F6FDAD5A0233FBAAD6,11914,20,21,1,37,48,1898
66101,66101,B90520ED7BDDE423CEFE3ED6913620C9,10271,1,10,9,37,46,1896
66102,66102,B90520ED7BDDE423CEFE3ED6913620C9,12514,12,17,5,38,47,1947
66103,66103,B90520ED7BDDE423CEFE3ED6913620C9,10271,17,18,1,37,46,1896
66117,66117,48DCE60D429B0B1E7F2F1B7A462BF9BF,42523,4,9,5,31,47,1597
66118,66118,48DCE60D429B0B1E7F2F1B7A462BF9BF,11861,12,17,5,32,47,1647
66119,66119,48DCE60D429B0B1E7F2F1B7A462BF9BF,42523,19,20,1,31,47,1597
66120,66120,48DCE60D429B0B1E7F2F1B7A462BF9BF,11861,20,23,3,32,47,1647
66127,66127,8B7D63C5EBF2F6E2C97BF1B06BF39487,12311,0,12,12,30,44,1544
66128,66128,8B7D63C5EBF2F6E2C97BF1B06BF39487,10301,16,19,3,31,45,1595
66129,66129,8B7D63C5EBF2F6E2C97BF1B06BF39487,12311,22,23,1,30,44,1544
66135,66135,2C9F9127F2AECFBA8069624790D23C60,10471,0,7,7,37,48,1898
66136,66136,2C9F9127F2AECFBA8069624790D23C60,40171,7,10,3,38,48,1948
66137,66137,2C9F9127F2AECFBA8069624790D23C60,11271,10,22,12,37,48,1898
66145,66145,8002880BE094022EF2013995FF6D9E8E,43761,9,10,1,32,47,1647
66146,66146,8002880BE094022EF2013995FF6D9E8E,11161,12,14,2,32,48,1648
66147,66147,8002880BE094022EF2013995FF6D9E8E,43761,14,16,2,32,47,1647
66148,66148,8002880BE094022EF2013995FF6D9E8E,11161,19,23,4,32,48,1648
66149,66149,09803726F3C2A40BEF93389F75159E93,10281,0,11,11,33,48,1698
66150,66150,09803726F3C2A40BEF93389F75159E93,42161,14,16,2,36,47,1847
66151,66151,09803726F3C2A40BEF93389F75159E93,10281,18,22,4,33,48,1698
66168,66168,7FC20F0A7A8C59E7754FF95E5BEB796B,42301,0,5,5,36,47,1847
66169,66169,7FC20F0A7A8C59E7754FF95E5BEB796B,11261,6,17,11,36,46,1846
66170,66170,7FC20F0A7A8C59E7754FF95E5BEB796B,42231,17,18,1,37,46,1896
66171,66171,7FC20F0A7A8C59E7754FF95E5BEB796B,42301,20,23,3,36,47,1847
66177,66177,F284433312BF32177275D1EBBDCED548,10231,0,9,9,39,49,1999
66178,66178,F284433312BF32177275D1EBBDCED548,11301,12,14,2,41,49,2099
66179,66179,F284433312BF32177275D1EBBDCED548,40302,19,21,2,40,49,2049
66187,66187,3202A7F9C47E4AF3E4587FA7438FD62F,10811,0,13,13,38,46,1946
66188,66188,3202A7F9C47E4AF3E4587FA7438FD62F,42221,14,15,1,38,48,1948
66189,66189,3202A7F9C47E4AF3E4587FA7438FD62F,10811,16,21,5,38,46,1946
66201,66201,210582EEAC6D1F2BB5FAA5A446D73BC0,10381,0,6,6,31,49,1599
66202,66202,210582EEAC6D1F2BB5FAA5A446D73BC0,10431,10,18,8,33,49,1699
66203,66203,210582EEAC6D1F2BB5FAA5A446D73BC0,11531,19,21,2,34,49,1749
66209,66209,9027D7BCCA8B9488D727103093A0EE77,13341,0,12,12,44,45,2245
66210,66210,9027D7BCCA8B9488D727103093A0EE77,42631,12,17,5,43,45,2195
66211,66211,9027D7BCCA8B9488D727103093A0EE77,13341,21,22,1,44,45,2245
66212,66212,EC4080CB03D6FA6D28191A6C9C2A8F65,11331,0,14,14,37,48,1898
66213,66213,EC4080CB03D6FA6D28191A6C9C2A8F65,12841,17,18,1,37,47,1897
66214,66214,EC4080CB03D6FA6D28191A6C9C2A8F65,10411,22,23,1,36,48,1848
66215,66215,482231C60E75752F61489BAC43B2B02B,10121,0,19,19,36,49,1849
66216,66216,482231C60E75752F61489BAC43B2B02B,11541,20,21,1,35,49,1799
66217,66217,482231C60E75752F61489BAC43B2B02B,10121,21,23,2,36,49,1849
66218,66218,F7BBCD27D7CF79502A92D14CC67D7943,11231,0,14,14,37,49,1899
66219,66219,F7BBCD27D7CF79502A92D14CC67D7943,11351,15,17,2,36,48,1848
66220,66220,F7BBCD27D7CF79502A92D14CC67D7943,11231,18,23,5,37,49,1899
66228,66228,93C8A9BFC982F63705EDC3214DA05AC8,40673,0,6,6,36,48,1848
66229,66229,93C8A9BFC982F63705EDC3214DA05AC8,12841,9,10,1,37,47,1897
66230,66230,93C8A9BFC982F63705EDC3214DA05AC8,10781,16,18,2,35,47,1797
66286,66286,424595F1C8846A1CBAEDBFB8FB93F25B,11061,1,4,3,29,48,1498
66287,66287,424595F1C8846A1CBAEDBFB8FB93F25B,12121,6,16,10,29,47,1497
66288,66288,424595F1C8846A1CBAEDBFB8FB93F25B,11061,18,23,5,29,48,1498
66293,66293,FC7EB9622F9DA93D9292A2CD4A392CDA,13911,0,2,2,39,46,1996
66294,66294,FC7EB9622F9DA93D9292A2CD4A392CDA,11261,5,18,13,36,46,1846
66295,66295,FC7EB9622F9DA93D9292A2CD4A392CDA,13911,19,23,4,39,46,1996
66306,66306,AD235EE6A83CA7956AB86E8BC887D3C7,11541,0,5,5,35,49,1799
66307,66307,AD235EE6A83CA7956AB86E8BC887D3C7,11021,6,16,10,36,49,1849
66308,66308,AD235EE6A83CA7956AB86E8BC887D3C7,13561,16,18,2,37,49,1899
66309,66309,AD235EE6A83CA7956AB86E8BC887D3C7,11541,19,23,4,35,49,1799
66336,66336,52DE1B5B29EB088C4F7CC0D4865B38F5,42861,1,5,4,37,44,1894
66337,66337,52DE1B5B29EB088C4F7CC0D4865B38F5,42151,8,10,2,35,45,1795
66338,66338,52DE1B5B29EB088C4F7CC0D4865B38F5,42861,13,14,1,37,44,1894
66339,66339,52DE1B5B29EB088C4F7CC0D4865B38F5,42151,18,23,5,35,45,1795
66358,66358,48F1F123A51974E2C229EEC94D9BE56C,42271,0,13,13,40,47,2047
66359,66359,48F1F123A51974E2C229EEC94D9BE56C,11806,16,17,1,41,48,2098
66360,66360,48F1F123A51974E2C229EEC94D9BE56C,42271,17,18,1,40,47,2047
66371,66371,78B9DCFA4CFE02297486B374939C4654,11261,0,13,13,36,46,1846
66372,66372,78B9DCFA4CFE02297486B374939C4654,42151,14,17,3,35,45,1795
66373,66373,78B9DCFA4CFE02297486B374939C4654,11261,18,23,5,36,46,1846
66378,66378,68A24D68E1EE6F85D7484BA18462FF82,12971,2,11,9,32,48,1648
66379,66379,68A24D68E1EE6F85D7484BA18462FF82,10292,11,12,1,30,47,1547
66380,66380,68A24D68E1EE6F85D7484BA18462FF82,42523,13,15,2,31,47,1597
66381,66381,68A24D68E1EE6F85D7484BA18462FF82,10292,17,18,1,30,47,1547
66382,66382,E2FC80C995A3EFA4B2AF01BAD4B24C1C,11074,0,5,5,37,47,1897
66383,66383,E2FC80C995A3EFA4B2AF01BAD4B24C1C,12083,6,16,10,36,49,1849
66384,66384,E2FC80C995A3EFA4B2AF01BAD4B24C1C,11751,19,20,1,35,48,1798
66385,66385,E2FC80C995A3EFA4B2AF01BAD4B24C1C,12083,20,23,3,36,49,1849
66386,66386,907D9C07105AF9242C4278C0160DDD57,13711,0,17,17,38,46,1946
66387,66387,907D9C07105AF9242C4278C0160DDD57,42011,20,21,1,36,46,1846
66388,66388,907D9C07105AF9242C4278C0160DDD57,13711,21,23,2,38,46,1946
66412,66412,7B8A98208ED34D33A0C57EFE510DEA5B,11491,0,5,5,36,47,1847
66413,66413,7B8A98208ED34D33A0C57EFE510DEA5B,13711,6,9,3,38,46,1946
66414,66414,7B8A98208ED34D33A0C57EFE510DEA5B,11941,13,18,5,37,46,1896
66415,66415,7B8A98208ED34D33A0C57EFE510DEA5B,13711,19,21,2,38,46,1946
66421,66421,E7A499EFF2705CCA8F4C4AD8B684EDF4,11201,0,9,9,35,49,1799
66422,66422,E7A499EFF2705CCA8F4C4AD8B684EDF4,10221,12,15,3,34,49,1749
66423,66423,E7A499EFF2705CCA8F4C4AD8B684EDF4,11951,16,18,2,31,49,1599
66429,66429,6B9FDBAAD19DC3CF76E1F01F4E6AA1D3,13711,1,2,1,38,46,1946
66430,66430,6B9FDBAAD19DC3CF76E1F01F4E6AA1D3,10271,2,4,2,37,46,1896
66431,66431,6B9FDBAAD19DC3CF76E1F01F4E6AA1D3,13711,5,6,1,38,46,1946
66432,66432,6B9FDBAAD19DC3CF76E1F01F4E6AA1D3,10785,8,18,10,35,47,1797
66440,66440,F00AF03D04E1327575ED0877523C5052,40171,1,5,4,38,48,1948
66441,66441,F00AF03D04E1327575ED0877523C5052,10191,5,18,13,40,48,2048
66442,66442,F00AF03D04E1327575ED0877523C5052,10471,19,23,4,37,48,1898
66443,66443,0E7262AB05FEE95538206F690BF1ED85,11381,0,12,12,30,47,1547
66444,66444,0E7262AB05FEE95538206F690BF1ED85,10951,15,18,3,29,48,1498
66445,66445,0E7262AB05FEE95538206F690BF1ED85,11381,21,23,2,30,47,1547
66446,66446,D9B289BC0D00D6D44EAB5DD6F9D24F2D,10771,0,10,10,41,46,2096
66447,66447,D9B289BC0D00D6D44EAB5DD6F9D24F2D,11481,11,13,2,41,48,2098
66448,66448,D9B289BC0D00D6D44EAB5DD6F9D24F2D,43041,18,23,5,41,46,2096
66449,66449,ADA26EADD558EB8837881D74EA80D1FF,12971,0,8,8,32,48,1648
66450,66450,ADA26EADD558EB8837881D74EA80D1FF,10221,8,11,3,34,49,1749
66451,66451,ADA26EADD558EB8837881D74EA80D1FF,12971,11,23,12,32,48,1648
66462,66462,F36A9C530F88290C9D611D428C0B8F3A,11021,0,14,14,36,49,1849
66463,66463,F36A9C530F88290C9D611D428C0B8F3A,40261,16,18,2,35,49,1799
66464,66464,F36A9C530F88290C9D611D428C0B8F3A,11021,18,23,5,36,49,1849
66465,66465,37BA34BEA77527704C48255F83C87B37,42581,1,10,9,38,48,1948
66466,66466,37BA34BEA77527704C48255F83C87B37,12514,14,19,5,38,47,1947
66467,66467,37BA34BEA77527704C48255F83C87B37,10821,19,22,3,40,47,2047
66468,66468,1D2C42504060298C354A97579B2F0A92,43951,0,13,13,49,41,2491
66469,66469,1D2C42504060298C354A97579B2F0A92,13821,14,18,4,49,45,2495
66470,66470,1D2C42504060298C354A97579B2F0A92,43951,21,23,2,49,41,2491
66471,66471,81677BBF6981E3D6E202B916ACF354DA,42301,0,5,5,36,47,1847
66472,66472,81677BBF6981E3D6E202B916ACF354DA,10111,5,10,5,37,47,1897
66473,66473,81677BBF6981E3D6E202B916ACF354DA,42301,14,23,9,36,47,1847
66480,66480,27407CE091F4D7648C38A320769B3349,11231,0,1,1,37,49,1899
66481,66481,27407CE091F4D7648C38A320769B3349,12083,3,8,5,36,49,1849
66482,66482,27407CE091F4D7648C38A320769B3349,11231,10,11,1,37,49,1899
66483,66483,27407CE091F4D7648C38A320769B3349,40171,12,23,11,38,48,1948
66484,66484,72B28316E77049B3B3D9EC9BDF710CF6,42523,0,5,5,31,47,1597
66485,66485,72B28316E77049B3B3D9EC9BDF710CF6,43761,6,18,12,32,47,1647
66486,66486,72B28316E77049B3B3D9EC9BDF710CF6,42523,19,20,1,31,47,1597
66491,66491,23F96418DBDA7106BDBB6C7E2C3432BD,42351,0,8,8,38,45,1945
66492,66492,23F96418DBDA7106BDBB6C7E2C3432BD,42231,9,12,3,37,46,1896
66493,66493,23F96418DBDA7106BDBB6C7E2C3432BD,42351,12,22,10,38,45,1945
66498,66498,5A1924C2DB4C234FA4E5C5A73C9CFFCF,11061,0,17,17,29,48,1498
66499,66499,5A1924C2DB4C234FA4E5C5A73C9CFFCF,10681,18,19,1,30,48,1548
66500,66500,5A1924C2DB4C234FA4E5C5A73C9CFFCF,11061,19,20,1,29,48,1498
66505,66505,25F4CEC81BA444B06FD2F2182E64503F,15311,5,15,10,43,25,2175
66506,66506,25F4CEC81BA444B06FD2F2182E64503F,12781,15,18,3,46,24,2324
66507,66507,25F4CEC81BA444B06FD2F2182E64503F,15311,21,23,2,43,25,2175
66508,66508,7E03092DEE367172A9BC29A7D77B903A,10611,1,9,8,32,48,1648
66509,66509,7E03092DEE367172A9BC29A7D77B903A,11954,9,10,1,32,49,1649
66510,66510,7E03092DEE367172A9BC29A7D77B903A,42921,12,18,6,33,47,1697
66511,66511,7E03092DEE367172A9BC29A7D77B903A,10251,18,23,5,35,47,1797
66512,66512,E99176074424BF1CA2C083C0DBF3C62C,42221,2,4,2,38,48,1948
66513,66513,E99176074424BF1CA2C083C0DBF3C62C,12514,6,8,2,38,47,1947
66514,66514,E99176074424BF1CA2C083C0DBF3C62C,12841,11,21,10,37,47,1897
66515,66515,B362B5E77BA1E28CC69DD6493B38125B,13331,0,1,1,38,47,1947
66516,66516,B362B5E77BA1E28CC69DD6493B38125B,42511,4,11,7,37,47,1897
66517,66517,B362B5E77BA1E28CC69DD6493B38125B,13331,11,13,2,38,47,1947
66518,66518,B362B5E77BA1E28CC69DD6493B38125B,42511,17,19,2,37,47,1897
66523,66523,A11021665283D6C62A5E3EE561A2FB8C,11261,0,8,8,36,46,1846
66524,66524,A11021665283D6C62A5E3EE561A2FB8C,42351,9,11,2,38,45,1945
66525,66525,A11021665283D6C62A5E3EE561A2FB8C,11261,12,13,1,36,46,1846
66526,66526,A11021665283D6C62A5E3EE561A2FB8C,42351,13,19,6,38,45,1945
66527,66527,4DC69DC53F9E9426DABBBEF7E74B0B08,42301,0,14,14,36,47,1847
66528,66528,4DC69DC53F9E9426DABBBEF7E74B0B08,43161,15,16,1,35,47,1797
66529,66529,4DC69DC53F9E9426DABBBEF7E74B0B08,11074,16,21,5,37,47,1897
66530,66530,4DC69DC53F9E9426DABBBEF7E74B0B08,42301,21,23,2,36,47,1847
66534,66534,7BF5D6B213EC26DBF78A9C6D569D9202,13121,0,8,8,38,46,1946
66535,66535,7BF5D6B213EC26DBF78A9C6D569D9202,11271,12,13,1,37,48,1898
66536,66536,7BF5D6B213EC26DBF78A9C6D569D9202,13121,17,23,6,38,46,1946
66565,66565,BF4FDDCD481CA927405B56D9236C724E,11381,0,10,10,30,47,1547
66566,66566,BF4FDDCD481CA927405B56D9236C724E,10951,10,19,9,29,48,1498
66567,66567,BF4FDDCD481CA927405B56D9236C724E,11381,21,23,2,30,47,1547
66576,66576,9775FF0B3B234FDE646604F5CAA50355,11161,0,7,7,32,48,1648
66577,66577,9775FF0B3B234FDE646604F5CAA50355,42141,7,18,11,32,47,1647
66578,66578,9775FF0B3B234FDE646604F5CAA50355,10281,20,23,3,33,48,1698
66579,66579,0A3AEB60A6106F02C32A3904CC28A141,15181,0,7,7,26,24,1324
66580,66580,0A3AEB60A6106F02C32A3904CC28A141,43121,7,8,1,25,27,1277
66581,66581,0A3AEB60A6106F02C32A3904CC28A141,15181,12,23,11,26,24,1324
66586,66586,29A4DCF52DC2F3624D699E5BA6DF8CE9,11231,9,15,6,37,49,1899
66587,66587,29A4DCF52DC2F3624D699E5BA6DF8CE9,11751,15,17,2,35,48,1798
66588,66588,29A4DCF52DC2F3624D699E5BA6DF8CE9,11231,18,22,4,37,49,1899
66598,66598,9F99A72527E81B89BEB16DB21B613CC0,10281,0,7,7,33,48,1698
66599,66599,9F99A72527E81B89BEB16DB21B613CC0,11861,8,12,4,32,47,1647
66600,66600,9F99A72527E81B89BEB16DB21B613CC0,42021,12,16,4,33,47,1697
66601,66601,9F99A72527E81B89BEB16DB21B613CC0,10281,17,23,6,33,48,1698
66602,66602,8FB2C78EB46FD562E8BB57D1602CC08C,11491,0,5,5,36,47,1847
66603,66603,8FB2C78EB46FD562E8BB57D1602CC08C,10161,7,18,11,35,49,1799
66604,66604,8FB2C78EB46FD562E8BB57D1602CC08C,11491,19,23,4,36,47,1847
66605,66605,80DFFB63DC49A57473E5B8802778E56B,13101,0,12,12,40,47,2047
66606,66606,80DFFB63DC49A57473E5B8802778E56B,13271,16,20,4,41,47,2097
66607,66607,80DFFB63DC49A57473E5B8802778E56B,13101,20,21,1,40,47,2047
66608,66608,5084492A6A758A3CF1EF2B8D58F59187,11871,0,11,11,29,46,1496
66609,66609,5084492A6A758A3CF1EF2B8D58F59187,12311,12,15,3,30,44,1544
66610,66610,5084492A6A758A3CF1EF2B8D58F59187,11875,19,23,4,30,46,1546
66623,66623,0FA8C8AAB4B26075FA3507BDC0BDD0C7,11861,10,12,2,32,47,1647
66624,66624,0FA8C8AAB4B26075FA3507BDC0BDD0C7,11211,12,15,3,34,49,1749
66625,66625,0FA8C8AAB4B26075FA3507BDC0BDD0C7,10281,16,19,3,33,48,1698
66626,66626,0FA8C8AAB4B26075FA3507BDC0BDD0C7,11861,21,23,2,32,47,1647
66627,66627,ACCC554A67DC8BDBD5254F5A420891E7,42501,0,3,3,28,47,1447
66628,66628,ACCC554A67DC8BDBD5254F5A420891E7,11111,15,16,1,26,48,1348
66629,66629,ACCC554A67DC8BDBD5254F5A420891E7,42541,16,18,2,25,47,1297
66630,66630,ACCC554A67DC8BDBD5254F5A420891E7,42501,21,23,2,28,47,1447
66631,66631,0ABF15EDFCAA333ABA775777DB9BDACA,11954,1,10,9,32,49,1649
66632,66632,0ABF15EDFCAA333ABA775777DB9BDACA,12971,14,18,4,32,48,1648
66633,66633,0ABF15EDFCAA333ABA775777DB9BDACA,40925,19,21,2,35,49,1799
66644,66644,EAEFCB977DEDF23C1346736B36A6F67B,13911,1,6,5,39,46,1996
66645,66645,EAEFCB977DEDF23C1346736B36A6F67B,11261,6,8,2,36,46,1846
66646,66646,EAEFCB977DEDF23C1346736B36A6F67B,42231,11,13,2,37,46,1896
66647,66647,EAEFCB977DEDF23C1346736B36A6F67B,11261,16,19,3,36,46,1846
66648,66648,DEF2119ECB90D4385AD1A45A0B2C7A35,42521,1,5,4,31,47,1597
66649,66649,DEF2119ECB90D4385AD1A45A0B2C7A35,43761,9,10,1,32,47,1647
66650,66650,DEF2119ECB90D4385AD1A45A0B2C7A35,10341,13,18,5,31,47,1597
66651,66651,DEF2119ECB90D4385AD1A45A0B2C7A35,43761,20,22,2,32,47,1647
66652,66652,F3CE6A0617707A9ABD8F0B15EBE138A8,13441,0,7,7,39,39,1989
66653,66653,F3CE6A0617707A9ABD8F0B15EBE138A8,13071,11,12,1,41,41,2091
66654,66654,F3CE6A0617707A9ABD8F0B15EBE138A8,13441,17,21,4,39,39,1989
66658,66658,D92E0354220FC50EEC1FD87010105B23,11381,0,8,8,30,47,1547
66659,66659,D92E0354220FC50EEC1FD87010105B23,42501,8,18,10,28,47,1447
66660,66660,D92E0354220FC50EEC1FD87010105B23,10951,19,23,4,29,48,1498
66665,66665,59BD035622C1D294E1790B16458D6881,19441,0,17,17,8,46,446
66666,66666,59BD035622C1D294E1790B16458D6881,42041,17,18,1,10,47,547
66667,66667,59BD035622C1D294E1790B16458D6881,19441,20,21,1,8,46,446
66668,66668,59BD035622C1D294E1790B16458D6881,42041,21,23,2,10,47,547
66677,66677,F99A8100651870B148C78FDDEF8AD69E,13911,3,6,3,39,46,1996
66678,66678,F99A8100651870B148C78FDDEF8AD69E,42231,10,22,12,37,46,1896
66679,66679,F99A8100651870B148C78FDDEF8AD69E,42351,22,23,1,38,45,1945
66716,66716,A266B45677C0A1829225C0896CE9C2C1,11074,0,15,15,37,47,1897
66717,66717,A266B45677C0A1829225C0896CE9C2C1,42221,16,18,2,38,48,1948
66718,66718,A266B45677C0A1829225C0896CE9C2C1,11074,18,23,5,37,47,1897
66733,66733,31D18CBCEB156EA3C300BAA3932855BA,19441,0,7,7,8,46,446
66734,66734,31D18CBCEB156EA3C300BAA3932855BA,19821,7,9,2,4,46,246
66735,66735,31D18CBCEB156EA3C300BAA3932855BA,19441,12,13,1,8,46,446
66736,66736,31D18CBCEB156EA3C300BAA3932855BA,19024,14,18,4,9,45,495
66737,66737,D746519213A28242D49759FCE6B0BCB4,19441,0,15,15,8,46,446
66738,66738,D746519213A28242D49759FCE6B0BCB4,42041,15,17,2,10,47,547
66739,66739,D746519213A28242D49759FCE6B0BCB4,19441,17,22,5,8,46,446
66740,66740,A584DB5FF6EE02AE16BAE873BBEDDAA1,12921,0,12,12,9,41,491
66741,66741,A584DB5FF6EE02AE16BAE873BBEDDAA1,12641,12,13,1,10,43,543
66742,66742,A584DB5FF6EE02AE16BAE873BBEDDAA1,12921,15,20,5,9,41,491
66743,66743,0277E6ABE6E23FB8B51E9078601CBBC1,42491,0,8,8,32,46,1646
66744,66744,0277E6ABE6E23FB8B51E9078601CBBC1,42523,9,21,12,31,47,1597
66745,66745,0277E6ABE6E23FB8B51E9078601CBBC1,42491,22,23,1,32,46,1646
66761,66761,9A1CB6044954B6099E36F60F8EE95A99,11381,0,6,6,30,47,1547
66762,66762,9A1CB6044954B6099E36F60F8EE95A99,10951,8,9,1,29,48,1498
66763,66763,9A1CB6044954B6099E36F60F8EE95A99,11381,10,23,13,30,47,1547
66764,66764,14C205DF57BD0AA586E26BE4ED695846,42581,0,14,14,38,48,1948
66765,66765,14C205DF57BD0AA586E26BE4ED695846,11914,14,17,3,37,48,1898
66766,66766,14C205DF57BD0AA586E26BE4ED695846,42581,17,20,3,38,48,1948
66767,66767,14C205DF57BD0AA586E26BE4ED695846,11914,20,22,2,37,48,1898
66775,66775,FC3B8910035FE6AFFCEFAAF1A5BD46D7,11271,0,11,11,37,48,1898
66776,66776,FC3B8910035FE6AFFCEFAAF1A5BD46D7,42191,12,17,5,38,49,1949
66777,66777,FC3B8910035FE6AFFCEFAAF1A5BD46D7,40171,18,19,1,38,48,1948
66778,66778,FC3B8910035FE6AFFCEFAAF1A5BD46D7,10471,19,23,4,37,48,1898
66779,66779,3C5BF8354C7B22C00BFA5438C070BC0F,13711,0,17,17,38,46,1946
66780,66780,3C5BF8354C7B22C00BFA5438C070BC0F,43241,17,19,2,36,46,1846
66781,66781,3C5BF8354C7B22C00BFA5438C070BC0F,10271,21,23,2,37,46,1896
66787,66787,4B706CBBBDE9BF48F90679E8BB90E0D8,42231,6,8,2,37,46,1896
66788,66788,4B706CBBBDE9BF48F90679E8BB90E0D8,10821,9,12,3,40,47,2047
66789,66789,4B706CBBBDE9BF48F90679E8BB90E0D8,42231,12,22,10,37,46,1896
66790,66790,5832F798017EC944959971DE10E6C76B,13911,2,14,12,39,46,1996
66791,66791,5832F798017EC944959971DE10E6C76B,12211,14,17,3,41,44,2094
66792,66792,5832F798017EC944959971DE10E6C76B,13911,18,20,2,39,46,1996
66793,66793,5832F798017EC944959971DE10E6C76B,11261,22,23,1,36,46,1846
66794,66794,CC026B1D95E317BEF1558C266B728FC7,42864,0,14,14,38,44,1944
66795,66795,CC026B1D95E317BEF1558C266B728FC7,11261,15,22,7,36,46,1846
66796,66796,CC026B1D95E317BEF1558C266B728FC7,42864,22,23,1,38,44,1944
66825,66825,8E56A2D7B8313A9FB3CAF238A13A9C29,11541,0,1,1,35,49,1799
66826,66826,8E56A2D7B8313A9FB3CAF238A13A9C29,11021,3,13,10,36,49,1849
66827,66827,8E56A2D7B8313A9FB3CAF238A13A9C29,40271,13,23,10,35,49,1799
66837,66837,988754F4ACB1FFB14F8ADCC3660BA4EF,11261,0,2,2,36,46,1846
66838,66838,988754F4ACB1FFB14F8ADCC3660BA4EF,13911,4,6,2,39,46,1996
66839,66839,988754F4ACB1FFB14F8ADCC3660BA4EF,11261,10,19,9,36,46,1846
66852,66852,CA71A71EA0377655AD0BF39650AE9B43,11381,0,7,7,30,47,1547
66853,66853,CA71A71EA0377655AD0BF39650AE9B43,11061,9,10,1,29,48,1498
66854,66854,CA71A71EA0377655AD0BF39650AE9B43,11381,11,19,8,30,47,1547
66883,66883,FB5A872D0FAE7AA0035523EB5DBD36C2,11324,0,7,7,31,46,1596
66884,66884,FB5A872D0FAE7AA0035523EB5DBD36C2,43761,7,12,5,32,47,1647
66885,66885,FB5A872D0FAE7AA0035523EB5DBD36C2,11324,13,23,10,31,46,1596
66886,66886,2A6FF9E66581C840E4D6297C81915275,11324,0,19,19,31,46,1596
66887,66887,2A6FF9E66581C840E4D6297C81915275,11381,19,20,1,30,47,1547
66888,66888,2A6FF9E66581C840E4D6297C81915275,11875,21,22,1,30,46,1546
66889,66889,5A42B801B95BDD55ADE863E86C2FD0C5,42151,0,2,2,35,45,1795
66890,66890,5A42B801B95BDD55ADE863E86C2FD0C5,42861,3,4,1,37,44,1894
66891,66891,5A42B801B95BDD55ADE863E86C2FD0C5,12491,5,16,11,36,43,1843
66892,66892,5A42B801B95BDD55ADE863E86C2FD0C5,10811,16,23,7,38,46,1946
66903,66903,2F57AF45FF7C3D7310AEA860A5A34AF4,12971,0,1,1,32,48,1648
66904,66904,2F57AF45FF7C3D7310AEA860A5A34AF4,10381,2,14,12,31,49,1599
66905,66905,2F57AF45FF7C3D7310AEA860A5A34AF4,11531,18,22,4,34,49,1749
66906,66906,292AD485DA7AE4FB3CFCA1190DC036DF,42151,0,14,14,35,45,1795
66907,66907,292AD485DA7AE4FB3CFCA1190DC036DF,10811,15,17,2,38,46,1946
66908,66908,292AD485DA7AE4FB3CFCA1190DC036DF,42351,19,21,2,38,45,1945
66909,66909,292AD485DA7AE4FB3CFCA1190DC036DF,42151,21,23,2,35,45,1795
66910,66910,FC0936587C74EF8144A5D7B54D78302D,19021,0,13,13,10,45,545
66911,66911,FC0936587C74EF8144A5D7B54D78302D,11571,15,17,2,13,46,696
66912,66912,FC0936587C74EF8144A5D7B54D78302D,19021,17,20,3,10,45,545
66913,66913,FC0936587C74EF8144A5D7B54D78302D,19441,22,23,1,8,46,446
66921,66921,3B9989389C2FB72384F3330F9A990AB0,13911,2,6,4,39,46,1996
66922,66922,3B9989389C2FB72384F3330F9A990AB0,42231,7,18,11,37,46,1896
66923,66923,3B9989389C2FB72384F3330F9A990AB0,13911,18,20,2,39,46,1996
66924,66924,E16566CAC1D2263C830A92E3D7A4B3A9,42351,0,8,8,38,45,1945
66925,66925,E16566CAC1D2263C830A92E3D7A4B3A9,42231,10,19,9,37,46,1896
66926,66926,E16566CAC1D2263C830A92E3D7A4B3A9,13911,22,23,1,39,46,1996
66932,66932,751637010376FF10A15374FA98F99F38,13601,0,5,5,34,47,1747
66933,66933,751637010376FF10A15374FA98F99F38,11861,5,7,2,32,47,1647
66934,66934,751637010376FF10A15374FA98F99F38,10281,11,15,4,33,48,1698
66935,66935,751637010376FF10A15374FA98F99F38,11861,18,23,5,32,47,1647
66936,66936,ACB823DB33D22CC4344D979C1DDF92F4,11261,1,13,12,36,46,1846
66937,66937,ACB823DB33D22CC4344D979C1DDF92F4,42861,14,17,3,37,44,1894
66938,66938,ACB823DB33D22CC4344D979C1DDF92F4,11261,21,23,2,36,46,1846
66959,66959,A4B13605C78797589D9B98BC8787EDD0,19114,0,6,6,7,43,393
66960,66960,A4B13605C78797589D9B98BC8787EDD0,12641,7,9,2,10,43,543
66961,66961,A4B13605C78797589D9B98BC8787EDD0,19114,18,23,5,7,43,393
66962,66962,3BA5FA710EA7575C057415E520D57C01,10111,0,1,1,37,47,1897
66963,66963,3BA5FA710EA7575C057415E520D57C01,11351,1,3,2,36,48,1848
66964,66964,3BA5FA710EA7575C057415E520D57C01,11074,3,23,20,37,47,1897
66968,66968,7B87C4A37285C5F4BE47C14DD0F73CEF,42231,0,10,10,37,46,1896
66969,66969,7B87C4A37285C5F4BE47C14DD0F73CEF,11261,11,12,1,36,46,1846
66970,66970,7B87C4A37285C5F4BE47C14DD0F73CEF,42231,17,19,2,37,46,1896
66971,66971,F74E1805BD471CD67AFEC7E33078A7FE,11914,1,4,3,37,48,1898
66972,66972,F74E1805BD471CD67AFEC7E33078A7FE,43361,6,10,4,38,48,1948
66973,66973,F74E1805BD471CD67AFEC7E33078A7FE,11914,11,21,10,37,48,1898
66980,66980,B8BEE4316240369D7D9EFEDD287F001E,42021,0,7,7,33,47,1697
66981,66981,B8BEE4316240369D7D9EFEDD287F001E,43761,11,12,1,32,47,1647
66982,66982,B8BEE4316240369D7D9EFEDD287F001E,10731,12,15,3,33,47,1697
66983,66983,B8BEE4316240369D7D9EFEDD287F001E,43761,17,20,3,32,47,1647
66987,66987,895085FE0B62D7BCDF8725B5DB48E546,43971,0,6,6,30,48,1548
66988,66988,895085FE0B62D7BCDF8725B5DB48E546,11061,6,14,8,29,48,1498
66989,66989,895085FE0B62D7BCDF8725B5DB48E546,42521,15,22,7,31,47,1597
66999,66999,C9F84D3604FFDDEC89D1908F58D5CF7B,11901,0,9,9,42,49,2149
67000,67000,C9F84D3604FFDDEC89D1908F58D5CF7B,11301,13,17,4,41,49,2099
67001,67001,C9F84D3604FFDDEC89D1908F58D5CF7B,11901,21,23,2,42,49,2149
67028,67028,B549D23A0F904453400A8024B50725A9,11921,1,15,14,38,48,1948
67029,67029,B549D23A0F904453400A8024B50725A9,40833,16,17,1,41,47,2097
67030,67030,B549D23A0F904453400A8024B50725A9,11074,21,22,1,37,47,1897
67031,67031,ECBD279EF5BA4D092C581E2ACE03D9D5,40242,0,13,13,36,49,1849
67032,67032,ECBD279EF5BA4D092C581E2ACE03D9D5,11541,14,17,3,35,49,1799
67033,67033,ECBD279EF5BA4D092C581E2ACE03D9D5,40242,22,23,1,36,49,1849
67088,67088,59843945AAE93CCE82D76071D50875F9,10634,0,9,9,27,45,1395
67089,67089,59843945AAE93CCE82D76071D50875F9,10351,9,11,2,28,45,1445
67090,67090,59843945AAE93CCE82D76071D50875F9,10634,12,23,11,27,45,1395
67111,67111,981FF39DB0050476FC5E5BA7D49F90F5,11261,0,6,6,36,46,1846
67112,67112,981FF39DB0050476FC5E5BA7D49F90F5,42864,10,17,7,38,44,1944
67113,67113,981FF39DB0050476FC5E5BA7D49F90F5,11261,18,23,5,36,46,1846
67125,67125,0AE1F060A9917578AF6CC39BEF4A5FD7,11074,3,6,3,37,47,1897
67126,67126,0AE1F060A9917578AF6CC39BEF4A5FD7,10371,8,18,10,37,49,1899
67127,67127,0AE1F060A9917578AF6CC39BEF4A5FD7,11074,20,21,1,37,47,1897
67128,67128,7DFCA2932B390D69ABC0E415A2260097,10351,9,14,5,28,45,1445
67129,67129,7DFCA2932B390D69ABC0E415A2260097,42531,16,18,2,31,45,1595
67130,67130,7DFCA2932B390D69ABC0E415A2260097,10351,21,22,1,28,45,1445
67144,67144,AD3E6481838BF400FA98C1C2BDCD8C19,42681,1,7,6,24,48,1248
67145,67145,AD3E6481838BF400FA98C1C2BDCD8C19,10451,7,17,10,25,48,1298
67146,67146,AD3E6481838BF400FA98C1C2BDCD8C19,40343,20,22,2,24,49,1249
67147,67147,C7E598BFED6FB574843E537970B28C08,11151,0,4,4,30,48,1548
67148,67148,C7E598BFED6FB574843E537970B28C08,43391,8,9,1,29,48,1498
67149,67149,C7E598BFED6FB574843E537970B28C08,11151,13,23,10,30,48,1548
67153,67153,D570DB7C7486FBBF5A2B4FBCFDB6D24F,43981,0,10,10,36,49,1849
67154,67154,D570DB7C7486FBBF5A2B4FBCFDB6D24F,13561,12,14,2,37,49,1899
67155,67155,D570DB7C7486FBBF5A2B4FBCFDB6D24F,43981,17,23,6,36,49,1849
67156,67156,59BD966FE7595E6B73F7A7CC1B56DA5C,12514,0,6,6,38,47,1947
67157,67157,59BD966FE7595E6B73F7A7CC1B56DA5C,11074,7,8,1,37,47,1897
67158,67158,59BD966FE7595E6B73F7A7CC1B56DA5C,12514,10,13,3,38,47,1947
67159,67159,59BD966FE7595E6B73F7A7CC1B56DA5C,11074,17,20,3,37,47,1897
67180,67180,394B81CC36B31D897120A6153D7C1457,11061,2,4,2,29,48,1498
67181,67181,394B81CC36B31D897120A6153D7C1457,12121,9,18,9,29,47,1497
67182,67182,394B81CC36B31D897120A6153D7C1457,11061,19,23,4,29,48,1498
67183,67183,896E2BF669390AF05B41235AFE89A2E1,40124,0,1,1,38,47,1947
67184,67184,896E2BF669390AF05B41235AFE89A2E1,10271,2,11,9,37,46,1896
67185,67185,896E2BF669390AF05B41235AFE89A2E1,40124,14,15,1,38,47,1947
67186,67186,896E2BF669390AF05B41235AFE89A2E1,10271,17,18,1,37,46,1896
67187,67187,B411CA40C62639B41FB1F1B86351EA24,11021,0,13,13,36,49,1849
67188,67188,B411CA40C62639B41FB1F1B86351EA24,12021,13,17,4,37,49,1899
67189,67189,B411CA40C62639B41FB1F1B86351EA24,11021,17,23,6,36,49,1849
67196,67196,185D56D388FE8A96E07F52D610C68C9B,12514,0,5,5,38,47,1947
67197,67197,185D56D388FE8A96E07F52D610C68C9B,11074,9,11,2,37,47,1897
67198,67198,185D56D388FE8A96E07F52D610C68C9B,12514,13,23,10,38,47,1947
67202,67202,80D61A8862AE6C2B33986072BBFE37A1,42771,0,10,10,36,47,1847
67203,67203,80D61A8862AE6C2B33986072BBFE37A1,41007,11,13,2,37,47,1897
67204,67204,80D61A8862AE6C2B33986072BBFE37A1,42771,14,15,1,36,47,1847
67205,67205,80D61A8862AE6C2B33986072BBFE37A1,11074,19,23,4,37,47,1897
67206,67206,C567BA758C03AD1D2310F8B57DE3E1B4,11261,0,3,3,36,46,1846
67207,67207,C567BA758C03AD1D2310F8B57DE3E1B4,42864,4,7,3,38,44,1944
67208,67208,C567BA758C03AD1D2310F8B57DE3E1B4,11261,10,23,13,36,46,1846
67216,67216,87795098DB965FB56379FD05F0A23798,10471,0,10,10,37,48,1898
67217,67217,87795098DB965FB56379FD05F0A23798,40081,15,16,1,40,49,2049
67218,67218,87795098DB965FB56379FD05F0A23798,10471,17,19,2,37,48,1898
67224,67224,E51EE41655D386174398555E16D6604B,12381,1,12,11,32,48,1648
67225,67225,E51EE41655D386174398555E16D6604B,11841,13,14,1,33,46,1696
67226,67226,E51EE41655D386174398555E16D6604B,12381,17,23,6,32,48,1648
67243,67243,5D713885CC9D7896BCCBC6482BB11B16,11231,0,12,12,37,49,1899
67244,67244,5D713885CC9D7896BCCBC6482BB11B16,13511,12,21,9,34,48,1748
67245,67245,5D713885CC9D7896BCCBC6482BB11B16,11231,21,23,2,37,49,1899
67253,67253,7F84DA9A23F01D104EB1833586DAA0D6,13601,0,17,17,34,47,1747
67254,67254,7F84DA9A23F01D104EB1833586DAA0D6,42021,19,20,1,33,47,1697
67255,67255,7F84DA9A23F01D104EB1833586DAA0D6,13601,21,23,2,34,47,1747
67256,67256,8F0DB5319866C8E59D99F7AC9A3D3B2B,10661,0,14,14,37,49,1899
67257,67257,8F0DB5319866C8E59D99F7AC9A3D3B2B,10221,15,17,2,34,49,1749
67258,67258,8F0DB5319866C8E59D99F7AC9A3D3B2B,10661,20,23,3,37,49,1899
67269,67269,EAE4E66BB81F5154EE30C4404213C429,13911,0,5,5,39,46,1996
67270,67270,EAE4E66BB81F5154EE30C4404213C429,12211,7,8,1,41,44,2094
67271,67271,EAE4E66BB81F5154EE30C4404213C429,13911,10,16,6,39,46,1996
67272,67272,EAE4E66BB81F5154EE30C4404213C429,11261,20,21,1,36,46,1846
67281,67281,048181761FA0265EF54A961A32D22478,42521,0,8,8,31,47,1597
67282,67282,048181761FA0265EF54A961A32D22478,43761,10,11,1,32,47,1647
67283,67283,048181761FA0265EF54A961A32D22478,42521,13,23,10,31,47,1597
67284,67284,549190A3B2C54A5013EF8B180CB7DAD2,11231,0,2,2,37,49,1899
67285,67285,549190A3B2C54A5013EF8B180CB7DAD2,11074,2,11,9,37,47,1897
67286,67286,549190A3B2C54A5013EF8B180CB7DAD2,11731,13,23,10,36,48,1848
67287,67287,608281F49B8743773A88333F4755F6E4,42231,0,8,8,37,46,1896
67288,67288,608281F49B8743773A88333F4755F6E4,42351,8,11,3,38,45,1945
67289,67289,608281F49B8743773A88333F4755F6E4,42231,12,23,11,37,46,1896
67290,67290,7F683BD350227B09C7ECC1328A0C4739,42011,0,14,14,36,46,1846
67291,67291,7F683BD350227B09C7ECC1328A0C4739,13711,14,16,2,38,46,1946
67292,67292,7F683BD350227B09C7ECC1328A0C4739,10271,16,19,3,37,46,1896
67293,67293,7F683BD350227B09C7ECC1328A0C4739,42011,20,23,3,36,46,1846
67297,67297,024F9F62F1C04FD1A8C6CB30DC9B500D,11231,0,6,6,37,49,1899
67298,67298,024F9F62F1C04FD1A8C6CB30DC9B500D,42981,7,18,11,36,49,1849
67299,67299,024F9F62F1C04FD1A8C6CB30DC9B500D,11231,18,23,5,37,49,1899
67300,67300,72EE059838FC074BF0955787969E7967,11231,0,4,4,37,49,1899
67301,67301,72EE059838FC074BF0955787969E7967,11911,5,19,14,37,48,1898
67302,67302,72EE059838FC074BF0955787969E7967,11231,20,23,3,37,49,1899
67317,67317,A6FD529C3EA66C1845775EA07FC46A8F,12601,0,6,6,25,47,1297
67318,67318,A6FD529C3EA66C1845775EA07FC46A8F,12584,11,13,2,24,48,1248
67319,67319,A6FD529C3EA66C1845775EA07FC46A8F,12601,17,19,2,25,47,1297
67320,67320,8167EF05D15F996A6B93D96BD3E78468,11001,4,9,5,42,47,2147
67321,67321,8167EF05D15F996A6B93D96BD3E78468,10771,9,12,3,41,46,2096
67322,67322,8167EF05D15F996A6B93D96BD3E78468,43481,13,14,1,39,48,1998
67323,67323,8167EF05D15F996A6B93D96BD3E78468,12511,14,22,8,39,47,1997
67332,67332,5566DF9556BCD612F8500FB496AD53B3,11861,0,9,9,32,47,1647
67333,67333,5566DF9556BCD612F8500FB496AD53B3,42021,11,16,5,33,47,1697
67334,67334,5566DF9556BCD612F8500FB496AD53B3,11861,18,22,4,32,47,1647
67335,67335,24F2A352225621D0B0829DDA5AA34835,10841,0,17,17,37,47,1897
67336,67336,24F2A352225621D0B0829DDA5AA34835,11541,17,19,2,35,49,1799
67337,67337,24F2A352225621D0B0829DDA5AA34835,11074,20,21,1,37,47,1897
67343,67343,71406CAB7DAA1D3016D1EDF130C6F573,10491,0,6,6,33,48,1698
67344,67344,71406CAB7DAA1D3016D1EDF130C6F573,42021,8,14,6,33,47,1697
67345,67345,71406CAB7DAA1D3016D1EDF130C6F573,10491,18,23,5,33,48,1698
67346,67346,DF6451E86EE4B7B98BCA60FC558F51EE,11151,0,8,8,30,48,1548
67347,67347,DF6451E86EE4B7B98BCA60FC558F51EE,11061,9,11,2,29,48,1498
67348,67348,DF6451E86EE4B7B98BCA60FC558F51EE,11151,12,17,5,30,48,1548
67349,67349,DF6451E86EE4B7B98BCA60FC558F51EE,11061,19,21,2,29,48,1498
67350,67350,511248B31413344B77C12D74A5EE7CDF,43471,0,8,8,31,49,1599
67351,67351,511248B31413344B77C12D74A5EE7CDF,11061,8,9,1,29,48,1498
67352,67352,511248B31413344B77C12D74A5EE7CDF,11151,10,17,7,30,48,1548
67353,67353,511248B31413344B77C12D74A5EE7CDF,40872,21,23,2,30,49,1549
67357,67357,B9F4C9D18F82BAF4FF50860E0E28B6F2,42401,0,15,15,36,47,1847
67358,67358,B9F4C9D18F82BAF4FF50860E0E28B6F2,10251,15,17,2,35,47,1797
67359,67359,B9F4C9D18F82BAF4FF50860E0E28B6F2,42401,19,23,4,36,47,1847
67360,67360,325B301C16FB3DB9C4CED544F7B2E787,42191,0,1,1,38,49,1949
67361,67361,325B301C16FB3DB9C4CED544F7B2E787,10471,1,12,11,37,48,1898
67362,67362,325B301C16FB3DB9C4CED544F7B2E787,42191,14,19,5,38,49,1949
67363,67363,325B301C16FB3DB9C4CED544F7B2E787,10471,20,21,1,37,48,1898
67377,67377,19A75CB3B950C38F8CC8C73DB8B5804C,11431,7,10,3,29,47,1497
67378,67378,19A75CB3B950C38F8CC8C73DB8B5804C,10721,14,15,1,31,48,1598
67379,67379,19A75CB3B950C38F8CC8C73DB8B5804C,11431,19,20,1,29,47,1497
67386,67386,A09953F67FED80A8C2308F84F83FE6DA,13711,4,12,8,38,46,1946
67387,67387,A09953F67FED80A8C2308F84F83FE6DA,43241,12,13,1,36,46,1846
67388,67388,A09953F67FED80A8C2308F84F83FE6DA,13711,15,16,1,38,46,1946
67389,67389,A09953F67FED80A8C2308F84F83FE6DA,43241,16,22,6,36,46,1846
67390,67390,ED329B71006D1766A598ADE6F5BD2F71,11321,0,6,6,31,46,1596
67391,67391,ED329B71006D1766A598ADE6F5BD2F71,12311,7,9,2,30,44,1544
67392,67392,ED329B71006D1766A598ADE6F5BD2F71,11321,12,22,10,31,46,1596
67393,67393,0933B06061F8F3536F06AEF0D300106F,11941,0,6,6,37,46,1896
67394,67394,0933B06061F8F3536F06AEF0D300106F,13711,6,8,2,38,46,1946
67395,67395,0933B06061F8F3536F06AEF0D300106F,11941,8,9,1,37,46,1896
67396,67396,0933B06061F8F3536F06AEF0D300106F,13711,10,19,9,38,46,1946
67401,67401,DE735024253C8C734B51C6AEBDF59E03,10491,2,12,10,33,48,1698
67402,67402,DE735024253C8C734B51C6AEBDF59E03,11911,18,20,2,37,48,1898
67403,67403,DE735024253C8C734B51C6AEBDF59E03,10491,22,23,1,33,48,1698
67404,67404,2BD9C8DB34D7B29DADD7D19EE0279CB5,10661,0,8,8,37,49,1899
67405,67405,2BD9C8DB34D7B29DADD7D19EE0279CB5,11541,11,12,1,35,49,1799
67406,67406,2BD9C8DB34D7B29DADD7D19EE0279CB5,10661,16,19,3,37,49,1899
67407,67407,48A980CCF2A198BF882581E8F9F510C5,42771,0,8,8,36,47,1847
67408,67408,48A980CCF2A198BF882581E8F9F510C5,10111,10,19,9,37,47,1897
67409,67409,48A980CCF2A198BF882581E8F9F510C5,42301,21,23,2,36,47,1847
67413,67413,7BD5666208D4C4EF90CAAD8A97E6ED7C,42151,1,7,6,35,45,1795
67414,67414,7BD5666208D4C4EF90CAAD8A97E6ED7C,42864,8,11,3,38,44,1944
67415,67415,7BD5666208D4C4EF90CAAD8A97E6ED7C,42351,16,18,2,38,45,1945
67416,67416,7BD5666208D4C4EF90CAAD8A97E6ED7C,42151,22,23,1,35,45,1795
67417,67417,7779D5C4E5073D864A9050EB76A5AC64,42351,1,5,4,38,45,1945
67418,67418,7779D5C4E5073D864A9050EB76A5AC64,11261,7,20,13,36,46,1846
67419,67419,7779D5C4E5073D864A9050EB76A5AC64,43341,20,22,2,41,46,2096
67425,67425,F5A735EBF4AB186058B27B4D9005E6B0,13601,1,13,12,34,47,1747
67426,67426,F5A735EBF4AB186058B27B4D9005E6B0,13511,18,19,1,34,48,1748
67427,67427,F5A735EBF4AB186058B27B4D9005E6B0,13601,21,23,2,34,47,1747
67428,67428,8CB3A4565E05AB1CAC2CF4D313BBEE95,42521,0,15,15,31,47,1597
67429,67429,8CB3A4565E05AB1CAC2CF4D313BBEE95,11381,16,17,1,30,47,1547
67430,67430,8CB3A4565E05AB1CAC2CF4D313BBEE95,11861,21,22,1,32,47,1647
67431,67431,EA58C87CB2005675859CA29FF6C3C184,40636,0,1,1,35,48,1798
67432,67432,EA58C87CB2005675859CA29FF6C3C184,42921,3,16,13,33,47,1697
67433,67433,EA58C87CB2005675859CA29FF6C3C184,40636,21,23,2,35,48,1798
67439,67439,445A90121514A82FCCD431DD3088A581,40637,1,7,6,36,47,1847
67440,67440,445A90121514A82FCCD431DD3088A581,43731,7,9,2,34,47,1747
67441,67441,445A90121514A82FCCD431DD3088A581,11861,13,23,10,32,47,1647
67442,67442,30F94368F131A73FAC48CF4BAF636AD7,42161,0,7,7,36,47,1847
67443,67443,30F94368F131A73FAC48CF4BAF636AD7,13681,7,17,10,38,47,1947
67444,67444,30F94368F131A73FAC48CF4BAF636AD7,42161,18,22,4,36,47,1847
67449,67449,649968536480AD141F8BBEBDA8AEED67,42981,0,8,8,36,49,1849
67450,67450,649968536480AD141F8BBEBDA8AEED67,11231,8,13,5,37,49,1899
67451,67451,649968536480AD141F8BBEBDA8AEED67,41601,14,15,1,39,49,1999
67452,67452,649968536480AD141F8BBEBDA8AEED67,11021,16,23,7,36,49,1849
67458,67458,1B963B1C6FCFA0D8416B4DA4107D787E,12671,2,4,2,21,43,1093
67459,67459,1B963B1C6FCFA0D8416B4DA4107D787E,13091,7,18,11,20,42,1042
67460,67460,1B963B1C6FCFA0D8416B4DA4107D787E,12671,18,22,4,21,43,1093
67470,67470,11FECEE7865049CDA55CAB34FACD3089,12311,2,4,2,30,44,1544
67471,67471,11FECEE7865049CDA55CAB34FACD3089,11875,5,9,4,30,46,1546
67472,67472,11FECEE7865049CDA55CAB34FACD3089,11871,10,23,13,29,46,1496
67480,67480,6AE2FA19F90C6BBDAB69E2E1C7BD408D,11914,0,7,7,37,48,1898
67481,67481,6AE2FA19F90C6BBDAB69E2E1C7BD408D,11921,9,13,4,38,48,1948
67482,67482,6AE2FA19F90C6BBDAB69E2E1C7BD408D,11074,14,15,1,37,47,1897
67483,67483,6AE2FA19F90C6BBDAB69E2E1C7BD408D,11921,16,22,6,38,48,1948
67492,67492,82B017C22AFAA9D0B70A0FF9525560A9,13381,4,6,2,39,47,1997
67493,67493,82B017C22AFAA9D0B70A0FF9525560A9,11074,8,9,1,37,47,1897
67494,67494,82B017C22AFAA9D0B70A0FF9525560A9,12511,9,11,2,39,47,1997
67495,67495,82B017C22AFAA9D0B70A0FF9525560A9,11074,11,22,11,37,47,1897
67509,67509,21A180321800B594D0DD89707450AB6F,42583,0,9,9,40,48,2048
67510,67510,21A180321800B594D0DD89707450AB6F,11291,16,17,1,40,49,2049
67511,67511,21A180321800B594D0DD89707450AB6F,42583,20,23,3,40,48,2048
67527,67527,CE155B610E3EDB8ECA1DCB73ED422C8D,12571,0,7,7,48,39,2439
67528,67528,CE155B610E3EDB8ECA1DCB73ED422C8D,43101,8,10,2,46,40,2340
67529,67529,CE155B610E3EDB8ECA1DCB73ED422C8D,12571,10,22,12,48,39,2439
67530,67530,AD22EC299874F8BC256C15F14ACCC85A,12561,0,12,12,45,43,2293
67531,67531,AD22EC299874F8BC256C15F14ACCC85A,12221,14,15,1,43,44,2194
67532,67532,AD22EC299874F8BC256C15F14ACCC85A,12561,16,19,3,45,43,2293
67533,67533,AD22EC299874F8BC256C15F14ACCC85A,12221,20,22,2,43,44,2194
67534,67534,235893151C59DE9F774E604730D96DBF,43731,9,11,2,34,47,1747
67535,67535,235893151C59DE9F774E604730D96DBF,42161,14,16,2,36,47,1847
67536,67536,235893151C59DE9F774E604730D96DBF,43731,16,20,4,34,47,1747
67537,67537,F704EE174E631472B2FE0F2D6719182A,42941,0,7,7,37,47,1897
67538,67538,F704EE174E631472B2FE0F2D6719182A,12021,9,11,2,37,49,1899
67539,67539,F704EE174E631472B2FE0F2D6719182A,42511,15,19,4,37,47,1897
67545,67545,0F926807C2172A873ADDB6848A592A36,11161,0,1,1,32,48,1648
67546,67546,0F926807C2172A873ADDB6848A592A36,42521,2,10,8,31,47,1597
67547,67547,0F926807C2172A873ADDB6848A592A36,43761,14,15,1,32,47,1647
67548,67548,0F926807C2172A873ADDB6848A592A36,42521,16,18,2,31,47,1597
67558,67558,0BC1BC9FA127A76D4558FF0A0EC8FEFB,42921,0,7,7,33,47,1697
67559,67559,0BC1BC9FA127A76D4558FF0A0EC8FEFB,10281,7,10,3,33,48,1698
67560,67560,0BC1BC9FA127A76D4558FF0A0EC8FEFB,42921,13,20,7,33,47,1697
67565,67565,A3ADBB5CF993E063166A231D722F8FC9,10111,0,14,14,37,47,1897
67566,67566,A3ADBB5CF993E063166A231D722F8FC9,40637,14,17,3,36,47,1847
67567,67567,A3ADBB5CF993E063166A231D722F8FC9,10111,21,23,2,37,47,1897
67571,67571,BEDA3F53DF178AFD4DE2A3B4D3458FDF,12514,0,5,5,38,47,1947
67572,67572,BEDA3F53DF178AFD4DE2A3B4D3458FDF,43481,6,18,12,39,48,1998
67573,67573,BEDA3F53DF178AFD4DE2A3B4D3458FDF,12514,22,23,1,38,47,1947
67583,67583,7681E0D68D024C184A5D43D46389C591,43761,0,1,1,32,47,1647
67584,67584,7681E0D68D024C184A5D43D46389C591,42921,2,13,11,33,47,1697
67585,67585,7681E0D68D024C184A5D43D46389C591,43761,13,20,7,32,47,1647
67586,67586,9B42EAB884E9A185F8907A30EF0D4816,43361,0,7,7,38,48,1948
67587,67587,9B42EAB884E9A185F8907A30EF0D4816,10107,8,12,4,38,49,1949
67588,67588,9B42EAB884E9A185F8907A30EF0D4816,11491,13,15,2,36,47,1847
67589,67589,9B42EAB884E9A185F8907A30EF0D4816,40691,17,18,1,42,48,2148
67590,67590,030037DAC82649BA9E94F5BAD7819523,11331,0,2,2,37,48,1898
67591,67591,030037DAC82649BA9E94F5BAD7819523,10841,3,9,6,37,47,1897
67592,67592,030037DAC82649BA9E94F5BAD7819523,42401,12,16,4,36,47,1847
67593,67593,030037DAC82649BA9E94F5BAD7819523,10841,19,23,4,37,47,1897
67601,67601,00D7F212BEEBBAAF26C1E8D68E8B416C,43101,5,10,5,46,40,2340
67602,67602,00D7F212BEEBBAAF26C1E8D68E8B416C,13551,10,16,6,45,38,2288
67603,67603,00D7F212BEEBBAAF26C1E8D68E8B416C,43101,16,18,2,46,40,2340
67628,67628,55B62CF97C3AEC62D987D2F1F6626FBA,10771,0,7,7,41,46,2096
67629,67629,55B62CF97C3AEC62D987D2F1F6626FBA,13711,7,17,10,38,46,1946
67630,67630,55B62CF97C3AEC62D987D2F1F6626FBA,42311,19,22,3,41,46,2096
67631,67631,215C2968B2146DB0591170CF91F3A17C,10471,0,17,17,37,48,1898
67632,67632,215C2968B2146DB0591170CF91F3A17C,12083,17,19,2,36,49,1849
67633,67633,215C2968B2146DB0591170CF91F3A17C,10471,19,23,4,37,48,1898
67646,67646,8CD5156CF883DA15618BAFE58DDCF2A7,42581,0,5,5,38,48,1948
67647,67647,8CD5156CF883DA15618BAFE58DDCF2A7,11914,6,12,6,37,48,1898
67648,67648,8CD5156CF883DA15618BAFE58DDCF2A7,42581,13,17,4,38,48,1948
67649,67649,8CD5156CF883DA15618BAFE58DDCF2A7,11914,18,20,2,37,48,1898
67650,67650,AD00213C3B59D2AB9F04638676B1CD2C,10491,0,16,16,33,48,1698
67651,67651,AD00213C3B59D2AB9F04638676B1CD2C,11861,16,21,5,32,47,1647
67652,67652,AD00213C3B59D2AB9F04638676B1CD2C,10491,22,23,1,33,48,1698
67653,67653,2CB6953F391C73F166D02AC31E930A06,11914,0,10,10,37,48,1898
67654,67654,2CB6953F391C73F166D02AC31E930A06,11921,13,15,2,38,48,1948
67655,67655,2CB6953F391C73F166D02AC31E930A06,11914,15,18,3,37,48,1898
67656,67656,2CB6953F391C73F166D02AC31E930A06,11921,22,23,1,38,48,1948
67657,67657,372A21350F3884793152DCFF165CE566,13341,0,5,5,44,45,2245
67658,67658,372A21350F3884793152DCFF165CE566,12211,6,11,5,41,44,2094
67659,67659,372A21350F3884793152DCFF165CE566,13341,15,19,4,44,45,2245
67660,67660,372A21350F3884793152DCFF165CE566,12561,20,21,1,45,43,2293
67661,67661,CDB099B491677D869C1DFE34BF030C9E,42351,0,3,3,38,45,1945
67662,67662,CDB099B491677D869C1DFE34BF030C9E,42231,3,14,11,37,46,1896
67663,67663,CDB099B491677D869C1DFE34BF030C9E,42351,18,19,1,38,45,1945
67664,67664,CDB099B491677D869C1DFE34BF030C9E,11261,19,23,4,36,46,1846
67665,67665,3F610288646E91F0293396CEFA65A672,11921,0,1,1,38,48,1948
67666,67666,3F610288646E91F0293396CEFA65A672,13511,3,8,5,34,48,1748
67667,67667,3F610288646E91F0293396CEFA65A672,11914,12,19,7,37,48,1898
67674,67674,1B16AD0182878B49E352925C1FB99700,12514,0,15,15,38,47,1947
67675,67675,1B16AD0182878B49E352925C1FB99700,10591,15,16,1,39,48,1998
67676,67676,1B16AD0182878B49E352925C1FB99700,10841,18,19,1,37,47,1897
67677,67677,558A6887C0D5899B43E75BBD844A7C64,42461,0,5,5,45,47,2297
67678,67678,558A6887C0D5899B43E75BBD844A7C64,42321,7,16,9,43,47,2197
67679,67679,558A6887C0D5899B43E75BBD844A7C64,42461,20,23,3,45,47,2297
67685,67685,9D25C8999E418D8C72AB77E479B8A009,11321,0,6,6,31,46,1596
67686,67686,9D25C8999E418D8C72AB77E479B8A009,10301,7,9,2,31,45,1595
67687,67687,9D25C8999E418D8C72AB77E479B8A009,11321,12,23,11,31,46,1596
67691,67691,F87C006906FC5F5270405EDAA1B0E6A3,12514,5,10,5,38,47,1947
67692,67692,F87C006906FC5F5270405EDAA1B0E6A3,10841,12,14,2,37,47,1897
67693,67693,F87C006906FC5F5270405EDAA1B0E6A3,12514,14,18,4,38,47,1947
67703,67703,10998AC050402D0103054DA8672DA230,19441,0,13,13,8,46,446
67704,67704,10998AC050402D0103054DA8672DA230,42041,15,16,1,10,47,547
67705,67705,10998AC050402D0103054DA8672DA230,19441,18,22,4,8,46,446
67706,67706,F004825C5EEC7F8B7A184D4985895C55,13341,0,7,7,44,45,2245
67707,67707,F004825C5EEC7F8B7A184D4985895C55,42631,7,8,1,43,45,2195
67708,67708,F004825C5EEC7F8B7A184D4985895C55,13341,8,10,2,44,45,2245
67709,67709,F004825C5EEC7F8B7A184D4985895C55,42631,10,22,12,43,45,2195
67713,67713,11D0C3BFA1EEA48E71CAB72BD84A5D2F,13671,0,7,7,27,43,1393
67714,67714,11D0C3BFA1EEA48E71CAB72BD84A5D2F,10351,9,10,1,28,45,1445
67715,67715,11D0C3BFA1EEA48E71CAB72BD84A5D2F,10634,10,22,12,27,45,1395
67716,67716,03807BDFECD796862E0B81DEAB9E0723,11131,6,7,1,33,48,1698
67717,67717,03807BDFECD796862E0B81DEAB9E0723,42161,9,10,1,36,47,1847
67718,67718,03807BDFECD796862E0B81DEAB9E0723,11131,14,21,7,33,48,1698
67719,67719,03807BDFECD796862E0B81DEAB9E0723,40637,21,23,2,36,47,1847
67720,67720,2DF528642956EE7F281EE1C987DEF31F,10271,0,14,14,37,46,1896
67721,67721,2DF528642956EE7F281EE1C987DEF31F,13711,15,18,3,38,46,1946
67722,67722,2DF528642956EE7F281EE1C987DEF31F,43241,21,23,2,36,46,1846
67723,67723,0C2B805EE888E91F034AB21F925F07C4,19901,0,7,7,7,44,394
67724,67724,0C2B805EE888E91F034AB21F925F07C4,12641,8,9,1,10,43,543
67725,67725,0C2B805EE888E91F034AB21F925F07C4,19114,11,12,1,7,43,393
67726,67726,0C2B805EE888E91F034AB21F925F07C4,12641,12,22,10,10,43,543
67727,67727,1EB8BF3A5209A99EB5F8CDA45162250D,12311,0,8,8,30,44,1544
67728,67728,1EB8BF3A5209A99EB5F8CDA45162250D,42531,11,12,1,31,45,1595
67729,67729,1EB8BF3A5209A99EB5F8CDA45162250D,12311,16,18,2,30,44,1544
67730,67730,5A45F00505D10CE6F80144DAC647FEEE,19904,7,8,1,9,44,494
67731,67731,5A45F00505D10CE6F80144DAC647FEEE,12641,9,17,8,10,43,543
67732,67732,5A45F00505D10CE6F80144DAC647FEEE,19024,21,23,2,9,45,495
67764,67764,A33DC21DB912CB2F7571EAE4CD987B40,42121,1,7,6,26,49,1349
67765,67765,A33DC21DB912CB2F7571EAE4CD987B40,40343,11,14,3,24,49,1249
67766,67766,A33DC21DB912CB2F7571EAE4CD987B40,43391,15,16,1,29,48,1498
67767,67767,A33DC21DB912CB2F7571EAE4CD987B40,42121,17,22,5,26,49,1349
67776,67776,18D411488A51B9B5C9FDB16761B10892,42141,0,5,5,32,47,1647
67777,67777,18D411488A51B9B5C9FDB16761B10892,10281,7,10,3,33,48,1698
67778,67778,18D411488A51B9B5C9FDB16761B10892,42141,11,19,8,32,47,1647
67786,67786,C3385B266A5088A7FA48BCC62DFDD003,11914,0,13,13,37,48,1898
67787,67787,C3385B266A5088A7FA48BCC62DFDD003,40171,13,14,1,38,48,1948
67788,67788,C3385B266A5088A7FA48BCC62DFDD003,11914,17,19,2,37,48,1898
67789,67789,C3385B266A5088A7FA48BCC62DFDD003,40171,19,23,4,38,48,1948
67790,67790,0ACD42FBA28A767F44D73783967C8C23,10731,1,5,4,33,47,1697
67791,67791,0ACD42FBA28A767F44D73783967C8C23,12381,9,12,3,32,48,1648
67792,67792,0ACD42FBA28A767F44D73783967C8C23,10731,13,14,1,33,47,1697
67793,67793,0ACD42FBA28A767F44D73783967C8C23,10281,17,23,6,33,48,1698
67813,67813,D8AE02857BA77543AC93BD79AFFC45E0,11801,0,16,16,42,48,2148
67814,67814,D8AE02857BA77543AC93BD79AFFC45E0,40833,16,18,2,41,47,2097
67815,67815,D8AE02857BA77543AC93BD79AFFC45E0,11801,18,23,5,42,48,2148
67819,67819,B027DD9031E1E1739F7E1EACB1690085,12311,0,3,3,30,44,1544
67820,67820,B027DD9031E1E1739F7E1EACB1690085,10711,4,5,1,29,46,1496
67821,67821,B027DD9031E1E1739F7E1EACB1690085,12311,5,21,16,30,44,1544
67826,67826,EE107F15123C6DB132974358298F51B4,11914,0,3,3,37,48,1898
67827,67827,EE107F15123C6DB132974358298F51B4,43181,6,18,12,39,48,1998
67828,67828,EE107F15123C6DB132974358298F51B4,11914,20,23,3,37,48,1898
67832,67832,868D62D07021FFB7BE9F078FE4596C54,40505,0,4,4,36,48,1848
67833,67833,868D62D07021FFB7BE9F078FE4596C54,11271,5,10,5,37,48,1898
67834,67834,868D62D07021FFB7BE9F078FE4596C54,40505,17,23,6,36,48,1848
67835,67835,A1B1493AD1E4959D25E397CB780FB65E,42531,5,7,2,31,45,1595
67836,67836,A1B1493AD1E4959D25E397CB780FB65E,12311,7,9,2,30,44,1544
67837,67837,A1B1493AD1E4959D25E397CB780FB65E,42531,11,23,12,31,45,1595
67848,67848,3F0EDFFC6E18B4A03094543F5DAD11AE,42521,0,10,10,31,47,1597
67849,67849,3F0EDFFC6E18B4A03094543F5DAD11AE,43761,12,18,6,32,47,1647
67850,67850,3F0EDFFC6E18B4A03094543F5DAD11AE,42521,19,21,2,31,47,1597
67854,67854,449E7811DCD6E8CD500501049B5A906E,13911,7,10,3,39,46,1996
67855,67855,449E7811DCD6E8CD500501049B5A906E,11261,11,12,1,36,46,1846
67856,67856,449E7811DCD6E8CD500501049B5A906E,13911,13,18,5,39,46,1996
67864,67864,9174106625D3239DC850CA622055B684,42301,0,6,6,36,47,1847
67865,67865,9174106625D3239DC850CA622055B684,42941,11,13,2,37,47,1897
67866,67866,9174106625D3239DC850CA622055B684,42301,15,17,2,36,47,1847
67867,67867,9174106625D3239DC850CA622055B684,42941,18,23,5,37,47,1897
67868,67868,0268036C4FD9D5BA53B2829295230187,10911,0,11,11,39,46,1996
67869,67869,0268036C4FD9D5BA53B2829295230187,11074,14,16,2,37,47,1897
67870,67870,0268036C4FD9D5BA53B2829295230187,10601,16,18,2,39,47,1997
67871,67871,458EBC255B183BF22B23CE89879E2CC9,41393,3,4,1,43,49,2199
67872,67872,458EBC255B183BF22B23CE89879E2CC9,42321,12,13,1,43,47,2197
67873,67873,458EBC255B183BF22B23CE89879E2CC9,42601,15,21,6,44,48,2248
67874,67874,458EBC255B183BF22B23CE89879E2CC9,13471,21,23,2,47,49,2399
67875,67875,9DB2D1D0B4A24CCB14E8E155246D6FB0,42941,0,10,10,37,47,1897
67876,67876,9DB2D1D0B4A24CCB14E8E155246D6FB0,40637,11,12,1,36,47,1847
67877,67877,9DB2D1D0B4A24CCB14E8E155246D6FB0,42941,13,22,9,37,47,1897
67878,67878,1613EDCCB37A92602BD5AFC072B28494,11531,4,5,1,34,49,1749
67879,67879,1613EDCCB37A92602BD5AFC072B28494,11591,9,11,2,36,49,1849
67880,67880,1613EDCCB37A92602BD5AFC072B28494,11531,17,23,6,34,49,1749
67890,67890,D9B08428B230A26F9D8108567961B570,13671,4,13,9,27,43,1393
67891,67891,D9B08428B230A26F9D8108567961B570,11281,14,17,3,27,40,1390
67892,67892,D9B08428B230A26F9D8108567961B570,13671,19,20,1,27,43,1393
67909,67909,6B5F89BF09EA72A624639E30B47831CE,11381,3,5,2,30,47,1547
67910,67910,6B5F89BF09EA72A624639E30B47831CE,10951,6,11,5,29,48,1498
67911,67911,6B5F89BF09EA72A624639E30B47831CE,11381,12,20,8,30,47,1547
67912,67912,6B5F89BF09EA72A624639E30B47831CE,10951,20,21,1,29,48,1498
67916,67916,E08A998E96875BC2FB605F71696F898C,11061,0,13,13,29,48,1498
67917,67917,E08A998E96875BC2FB605F71696F898C,11381,14,18,4,30,47,1547
67918,67918,E08A998E96875BC2FB605F71696F898C,11061,20,22,2,29,48,1498
67925,67925,22300DEAB3F7A20A2F8DD7892A11C5B7,13271,0,1,1,41,47,2097
67926,67926,22300DEAB3F7A20A2F8DD7892A11C5B7,13101,1,10,9,40,47,2047
67927,67927,22300DEAB3F7A20A2F8DD7892A11C5B7,13271,12,14,2,41,47,2097
67928,67928,22300DEAB3F7A20A2F8DD7892A11C5B7,40691,19,20,1,42,48,2148
67929,67929,57D557704F5D84FB21FA65D6A5819E5D,11491,0,7,7,36,47,1847
67930,67930,57D557704F5D84FB21FA65D6A5819E5D,11074,10,13,3,37,47,1897
67931,67931,57D557704F5D84FB21FA65D6A5819E5D,11491,13,16,3,36,47,1847
67932,67932,57D557704F5D84FB21FA65D6A5819E5D,12514,18,20,2,38,47,1947
67933,67933,331C93B6083F5634586EEDFC958D0A76,42351,0,20,20,38,45,1945
67934,67934,331C93B6083F5634586EEDFC958D0A76,42231,20,21,1,37,46,1896
67935,67935,331C93B6083F5634586EEDFC958D0A76,42351,21,23,2,38,45,1945
67947,67947,CC7496BDC75891A464D44322CA00AA04,10634,0,20,20,27,45,1395
67948,67948,CC7496BDC75891A464D44322CA00AA04,10351,20,21,1,28,45,1445
67949,67949,CC7496BDC75891A464D44322CA00AA04,10634,22,23,1,27,45,1395
67963,67963,562D97C98CF16FD617F7630D33583D34,10841,4,5,1,37,47,1897
67964,67964,562D97C98CF16FD617F7630D33583D34,42221,7,12,5,38,48,1948
67965,67965,562D97C98CF16FD617F7630D33583D34,40463,13,17,4,38,49,1949
67966,67966,562D97C98CF16FD617F7630D33583D34,11021,21,23,2,36,49,1849
67967,67967,84C94B2F533ED609B0C2666E73EA3142,13271,0,13,13,41,47,2097
67968,67968,84C94B2F533ED609B0C2666E73EA3142,11806,15,16,1,41,48,2098
67969,67969,84C94B2F533ED609B0C2666E73EA3142,13271,21,22,1,41,47,2097
67979,67979,1B1AA14FCBEAAD141CA6FAC7B338917E,42864,0,10,10,38,44,1944
67980,67980,1B1AA14FCBEAAD141CA6FAC7B338917E,42861,13,18,5,37,44,1894
67981,67981,1B1AA14FCBEAAD141CA6FAC7B338917E,11261,18,23,5,36,46,1846
67985,67985,2F8FBE6FB38F00CB192B148FD4827906,40697,0,7,7,43,48,2198
67986,67986,2F8FBE6FB38F00CB192B148FD4827906,42321,8,14,6,43,47,2197
67987,67987,2F8FBE6FB38F00CB192B148FD4827906,40697,17,23,6,43,48,2198
67996,67996,D4DF109767784E6C02E5D356B9A25CE7,11021,0,13,13,36,49,1849
67997,67997,D4DF109767784E6C02E5D356B9A25CE7,11211,16,17,1,34,49,1749
67998,67998,D4DF109767784E6C02E5D356B9A25CE7,10901,20,21,1,35,48,1798
68007,68007,D5C29F54FD64D9CE1AEFE2D9CA4F33A5,13101,2,14,12,40,47,2047
68008,68008,D5C29F54FD64D9CE1AEFE2D9CA4F33A5,42801,16,19,3,40,49,2049
68009,68009,D5C29F54FD64D9CE1AEFE2D9CA4F33A5,13101,20,22,2,40,47,2047
68010,68010,170A0AC014DC9BA930EAA0E56A2C9D03,42321,0,6,6,43,47,2197
68011,68011,170A0AC014DC9BA930EAA0E56A2C9D03,11701,10,13,3,43,48,2198
68012,68012,170A0AC014DC9BA930EAA0E56A2C9D03,42091,17,20,3,43,46,2196
68013,68013,170A0AC014DC9BA930EAA0E56A2C9D03,42321,21,23,2,43,47,2197
68024,68024,6057D50D8B28C6C1315019AA61B1AA72,11351,2,3,1,36,48,1848
68025,68025,6057D50D8B28C6C1315019AA61B1AA72,10901,5,12,7,35,48,1798
68026,68026,6057D50D8B28C6C1315019AA61B1AA72,11231,13,17,4,37,49,1899
68027,68027,6057D50D8B28C6C1315019AA61B1AA72,40925,20,23,3,35,49,1799
68028,68028,9ECA5557B94DDF8D494B58216329A377,42864,2,6,4,38,44,1944
68029,68029,9ECA5557B94DDF8D494B58216329A377,11261,6,12,6,36,46,1846
68030,68030,9ECA5557B94DDF8D494B58216329A377,42861,15,16,1,37,44,1894
68031,68031,9ECA5557B94DDF8D494B58216329A377,11261,18,23,5,36,46,1846
68032,68032,19B7F0CF3E3FD886B38254D17C1F93A2,10351,7,8,1,28,45,1445
68033,68033,19B7F0CF3E3FD886B38254D17C1F93A2,10301,8,10,2,31,45,1595
68034,68034,19B7F0CF3E3FD886B38254D17C1F93A2,12311,12,13,1,30,44,1544
68035,68035,19B7F0CF3E3FD886B38254D17C1F93A2,10301,14,19,5,31,45,1595
68039,68039,57A8147635AC74A3CB1F1010520DC82A,13961,0,11,11,42,48,2148
68040,68040,57A8147635AC74A3CB1F1010520DC82A,11901,11,16,5,42,49,2149
68041,68041,57A8147635AC74A3CB1F1010520DC82A,40691,17,18,1,42,48,2148
68049,68049,06CD0D9A51BF6B03AA66A2A0C792CAB3,11861,7,9,2,32,47,1647
68050,68050,06CD0D9A51BF6B03AA66A2A0C792CAB3,10731,10,17,7,33,47,1697
68051,68051,06CD0D9A51BF6B03AA66A2A0C792CAB3,12971,18,19,1,32,48,1648
68052,68052,06CD0D9A51BF6B03AA66A2A0C792CAB3,10731,20,23,3,33,47,1697
68053,68053,F6C54C668FECD237DA87E4FC2243153A,42321,0,6,6,43,47,2197
68054,68054,F6C54C668FECD237DA87E4FC2243153A,13101,11,17,6,40,47,2047
68055,68055,F6C54C668FECD237DA87E4FC2243153A,42321,18,22,4,43,47,2197
68056,68056,824CB1B1B23572593ECC1D95EF328196,42321,0,13,13,43,47,2197
68057,68057,824CB1B1B23572593ECC1D95EF328196,13371,15,18,3,41,47,2097
68058,68058,824CB1B1B23572593ECC1D95EF328196,42321,20,22,2,43,47,2197
68063,68063,40710D5347D404323484FF5ED1F29D66,13341,1,15,14,44,45,2245
68064,68064,40710D5347D404323484FF5ED1F29D66,42631,16,17,1,43,45,2195
68065,68065,40710D5347D404323484FF5ED1F29D66,13341,19,22,3,44,45,2245
68070,68070,932D308A47BD924E11B570EA7CB7901D,42531,1,6,5,31,45,1595
68071,68071,932D308A47BD924E11B570EA7CB7901D,12311,6,7,1,30,44,1544
68072,68072,932D308A47BD924E11B570EA7CB7901D,11834,8,23,15,32,45,1645
68073,68073,94092014F9DD3213271810B8D19555BE,49201,0,6,6,7,41,391
68074,68074,94092014F9DD3213271810B8D19555BE,12921,7,13,6,9,41,491
68075,68075,94092014F9DD3213271810B8D19555BE,49201,13,23,10,7,41,391
68076,68076,3DC1AA77D11276A1E03704D4A3F68520,42301,1,8,7,36,47,1847
68077,68077,3DC1AA77D11276A1E03704D4A3F68520,10111,8,14,6,37,47,1897
68078,68078,3DC1AA77D11276A1E03704D4A3F68520,11911,19,23,4,37,48,1898
68095,68095,831CEF471029417D091D2BE9F78234DD,10801,4,7,3,42,47,2147
68096,68096,831CEF471029417D091D2BE9F78234DD,42321,9,10,1,43,47,2197
68097,68097,831CEF471029417D091D2BE9F78234DD,10801,13,14,1,42,47,2147
68098,68098,831CEF471029417D091D2BE9F78234DD,43341,15,18,3,41,46,2096
68131,68131,72482737B3B33C4285AB6DC6B624919B,42301,0,1,1,36,47,1847
68132,68132,72482737B3B33C4285AB6DC6B624919B,42941,1,3,2,37,47,1897
68133,68133,72482737B3B33C4285AB6DC6B624919B,42161,7,20,13,36,47,1847
68134,68134,656752102BA99654C7060CE5B2133D72,49201,0,6,6,7,41,391
68135,68135,656752102BA99654C7060CE5B2133D72,12921,7,18,11,9,41,491
68136,68136,656752102BA99654C7060CE5B2133D72,19114,20,21,1,7,43,393
68141,68141,0CE1530259EA66797A9FEEF237D2664E,42861,0,5,5,37,44,1894
68142,68142,0CE1530259EA66797A9FEEF237D2664E,11261,7,8,1,36,46,1846
68143,68143,0CE1530259EA66797A9FEEF237D2664E,42861,11,13,2,37,44,1894
68144,68144,0CE1530259EA66797A9FEEF237D2664E,11261,14,19,5,36,46,1846
68178,68178,1F306D7FEEB372BC1B8C94A1E73123B0,11231,0,8,8,37,49,1899
68179,68179,1F306D7FEEB372BC1B8C94A1E73123B0,43281,9,11,2,37,48,1898
68180,68180,1F306D7FEEB372BC1B8C94A1E73123B0,11541,12,13,1,35,49,1799
68181,68181,1F306D7FEEB372BC1B8C94A1E73123B0,11231,18,21,3,37,49,1899
68199,68199,83953915152640EF3FD3F006516EAC9F,12641,0,12,12,10,43,543
68200,68200,83953915152640EF3FD3F006516EAC9F,19114,13,15,2,7,43,393
68201,68201,83953915152640EF3FD3F006516EAC9F,12641,15,23,8,10,43,543
68202,68202,CC3FA096FA296BC301B8FB82BD507846,11021,2,9,7,36,49,1849
68203,68203,CC3FA096FA296BC301B8FB82BD507846,42471,10,15,5,35,49,1799
68204,68204,CC3FA096FA296BC301B8FB82BD507846,11021,17,21,4,36,49,1849
68209,68209,BD517E29BD7069EA61B2CA0844AA760E,10731,0,6,6,33,47,1697
68210,68210,BD517E29BD7069EA61B2CA0844AA760E,42523,9,15,6,31,47,1597
68211,68211,BD517E29BD7069EA61B2CA0844AA760E,43761,15,17,2,32,47,1647
68212,68212,BD517E29BD7069EA61B2CA0844AA760E,10731,20,23,3,33,47,1697
68213,68213,0315D3CC734BD5BC114B05B446E8CCD4,13941,0,1,1,41,47,2097
68214,68214,0315D3CC734BD5BC114B05B446E8CCD4,43481,2,3,1,39,48,1998
68215,68215,0315D3CC734BD5BC114B05B446E8CCD4,43361,3,14,11,38,48,1948
68216,68216,0315D3CC734BD5BC114B05B446E8CCD4,13371,17,23,6,41,47,2097
68220,68220,2037976F03472170FD25B1B08877DABB,11001,0,8,8,42,47,2147
68221,68221,2037976F03472170FD25B1B08877DABB,13941,9,11,2,41,47,2097
68222,68222,2037976F03472170FD25B1B08877DABB,11701,12,14,2,43,48,2198
68223,68223,2037976F03472170FD25B1B08877DABB,11001,17,23,6,42,47,2147
68229,68229,B669243E54B52E3D637E736D2859715A,43731,0,6,6,34,47,1747
68230,68230,B669243E54B52E3D637E736D2859715A,42021,9,10,1,33,47,1697
68231,68231,B669243E54B52E3D637E736D2859715A,43731,12,22,10,34,47,1747
68232,68232,BD23B8F4441754E97EF9F4DBDD6CCEC2,13561,0,14,14,37,49,1899
68233,68233,BD23B8F4441754E97EF9F4DBDD6CCEC2,11021,16,18,2,36,49,1849
68234,68234,BD23B8F4441754E97EF9F4DBDD6CCEC2,13561,21,23,2,37,49,1899
68235,68235,5D20910F370368DA9B7807A8789204C0,19901,0,6,6,7,44,394
68236,68236,5D20910F370368DA9B7807A8789204C0,12641,10,18,8,10,43,543
68237,68237,5D20910F370368DA9B7807A8789204C0,19901,19,23,4,7,44,394
68246,68246,16B2F0D78BEB849442A93B3F29FB7F4E,11806,0,1,1,41,48,2098
68247,68247,16B2F0D78BEB849442A93B3F29FB7F4E,42271,4,8,4,40,47,2047
68248,68248,16B2F0D78BEB849442A93B3F29FB7F4E,11806,13,23,10,41,48,2098
68252,68252,4C8E92DBB85921608C1C92929A7A8C92,42521,0,14,14,31,47,1597
68253,68253,4C8E92DBB85921608C1C92929A7A8C92,13651,17,18,1,30,47,1547
68254,68254,4C8E92DBB85921608C1C92929A7A8C92,42521,18,23,5,31,47,1597
68263,68263,8C6728922EF1CCC03B1E56C8334750DD,11641,0,8,8,22,49,1149
68264,68264,8C6728922EF1CCC03B1E56C8334750DD,42681,10,20,10,24,48,1248
68265,68265,8C6728922EF1CCC03B1E56C8334750DD,42481,21,22,1,22,49,1149
68266,68266,8712D19D9570F02D77C8116E21842E46,11461,0,15,15,37,49,1899
68267,68267,8712D19D9570F02D77C8116E21842E46,40951,19,20,1,36,49,1849
68268,68268,8712D19D9570F02D77C8116E21842E46,11231,21,23,2,37,49,1899
68280,68280,AAF4696620C6353C66227214077A10B8,10971,0,6,6,35,47,1797
68281,68281,AAF4696620C6353C66227214077A10B8,40637,14,16,2,36,47,1847
68282,68282,AAF4696620C6353C66227214077A10B8,11261,21,23,2,36,46,1846
68297,68297,5FE1FAD559F6843700A0AA1D01D08561,13441,3,7,4,39,39,1989
68298,68298,5FE1FAD559F6843700A0AA1D01D08561,13071,7,9,2,41,41,2091
68299,68299,5FE1FAD559F6843700A0AA1D01D08561,13441,9,11,2,39,39,1989
68300,68300,5FE1FAD559F6843700A0AA1D01D08561,13071,12,22,10,41,41,2091
68317,68317,F41A8974955ECE62F73018566CCACF3F,11021,0,1,1,36,49,1849
68318,68318,F41A8974955ECE62F73018566CCACF3F,13561,3,6,3,37,49,1899
68319,68319,F41A8974955ECE62F73018566CCACF3F,11021,6,23,17,36,49,1849
68325,68325,D8FB972AAAC5DB0F06EEBA221E7E96BB,13951,0,8,8,47,45,2395
68326,68326,D8FB972AAAC5DB0F06EEBA221E7E96BB,13821,10,12,2,49,45,2495
68327,68327,D8FB972AAAC5DB0F06EEBA221E7E96BB,13951,15,23,8,47,45,2395
68328,68328,18A60EA405644C1B7180EDC607B9B9FF,43061,8,9,1,43,46,2196
68329,68329,18A60EA405644C1B7180EDC607B9B9FF,13111,11,13,2,42,46,2146
68330,68330,18A60EA405644C1B7180EDC607B9B9FF,43061,19,20,1,43,46,2196
68331,68331,18A60EA405644C1B7180EDC607B9B9FF,13111,21,23,2,42,46,2146
68332,68332,77DE4D89070B9EFEB461D22F72589B88,11381,7,13,6,30,47,1547
68333,68333,77DE4D89070B9EFEB461D22F72589B88,11861,13,17,4,32,47,1647
68334,68334,77DE4D89070B9EFEB461D22F72589B88,11381,18,23,5,30,47,1547
68343,68343,6AE77A399A63A8DDF88CC6FDD4441AB8,19441,9,14,5,8,46,446
68344,68344,6AE77A399A63A8DDF88CC6FDD4441AB8,42041,18,19,1,10,47,547
68345,68345,6AE77A399A63A8DDF88CC6FDD4441AB8,19441,21,23,2,8,46,446
68350,68350,05286C4B5017A260B39768783F7D4555,42581,0,6,6,38,48,1948
68351,68351,05286C4B5017A260B39768783F7D4555,10471,6,15,9,37,48,1898
68352,68352,05286C4B5017A260B39768783F7D4555,42581,18,23,5,38,48,1948
68364,68364,5EA25703CDE822C29391E7CDA7A37011,10151,0,10,10,34,47,1747
68365,68365,5EA25703CDE822C29391E7CDA7A37011,43761,12,13,1,32,47,1647
68366,68366,5EA25703CDE822C29391E7CDA7A37011,10731,17,20,3,33,47,1697
68367,68367,F44A21181A01CB6C5509F7EF8FD935A1,11331,0,12,12,37,48,1898
68368,68368,F44A21181A01CB6C5509F7EF8FD935A1,11021,13,14,1,36,49,1849
68369,68369,F44A21181A01CB6C5509F7EF8FD935A1,11331,18,19,1,37,48,1898
68370,68370,F44A21181A01CB6C5509F7EF8FD935A1,11021,20,22,2,36,49,1849
68402,68402,EE4B1F6FA31F6EC3CF34CDE4DFC6A84E,10111,0,7,7,37,47,1897
68403,68403,EE4B1F6FA31F6EC3CF34CDE4DFC6A84E,43731,12,13,1,34,47,1747
68404,68404,EE4B1F6FA31F6EC3CF34CDE4DFC6A84E,10111,22,23,1,37,47,1897
68405,68405,5F011E03EB30D52AF7652FE981140B35,42221,0,11,11,38,48,1948
68406,68406,5F011E03EB30D52AF7652FE981140B35,11074,14,20,6,37,47,1897
68407,68407,5F011E03EB30D52AF7652FE981140B35,42221,21,22,1,38,48,1948
68408,68408,A249659AA4285866F354A5650B26A07F,42941,1,6,5,37,47,1897
68409,68409,A249659AA4285866F354A5650B26A07F,42161,8,12,4,36,47,1847
68410,68410,A249659AA4285866F354A5650B26A07F,10111,13,23,10,37,47,1897
68411,68411,25F3AABD0C0D4BC9F28DBCCBFB68DB4D,10731,3,11,8,33,47,1697
68412,68412,25F3AABD0C0D4BC9F28DBCCBFB68DB4D,10431,15,20,5,33,49,1699
68413,68413,25F3AABD0C0D4BC9F28DBCCBFB68DB4D,42021,21,23,2,33,47,1697
68419,68419,6951E3E0460AAC87BD288EE04AEB76EC,10121,0,1,1,36,49,1849
68420,68420,6951E3E0460AAC87BD288EE04AEB76EC,11231,2,6,4,37,49,1899
68421,68421,6951E3E0460AAC87BD288EE04AEB76EC,10121,7,23,16,36,49,1849
68434,68434,A0E2144826C9388BBB096748F80D8289,13121,3,7,4,38,46,1946
68435,68435,A0E2144826C9388BBB096748F80D8289,42511,8,11,3,37,47,1897
68436,68436,A0E2144826C9388BBB096748F80D8289,40124,15,18,3,38,47,1947
68437,68437,4F3F717E93BC5AFE00C4421DCBF0AA01,40322,0,9,9,38,46,1946
68438,68438,4F3F717E93BC5AFE00C4421DCBF0AA01,11261,11,20,9,36,46,1846
68439,68439,4F3F717E93BC5AFE00C4421DCBF0AA01,40322,20,21,1,38,46,1946
68471,68471,94A66B099C3B286235DEE73BAE7FEB6C,11861,3,7,4,32,47,1647
68472,68472,94A66B099C3B286235DEE73BAE7FEB6C,11324,7,8,1,31,46,1596
68473,68473,94A66B099C3B286235DEE73BAE7FEB6C,11861,9,18,9,32,47,1647
68474,68474,94A66B099C3B286235DEE73BAE7FEB6C,10281,18,22,4,33,48,1698
68475,68475,A6F4E0A14DDF72AB1602B3834CD2AC43,11914,0,5,5,37,48,1898
68476,68476,A6F4E0A14DDF72AB1602B3834CD2AC43,43361,7,8,1,38,48,1948
68477,68477,A6F4E0A14DDF72AB1602B3834CD2AC43,11914,12,21,9,37,48,1898
68482,68482,C54B7E894D1C5CD6E84B2182058F9208,42861,1,5,4,37,44,1894
68483,68483,C54B7E894D1C5CD6E84B2182058F9208,43451,7,15,8,37,40,1890
68484,68484,C54B7E894D1C5CD6E84B2182058F9208,11261,19,20,1,36,46,1846
68490,68490,CF6A7AF612D2CFA2B8383868CF93735B,11861,0,7,7,32,47,1647
68491,68491,CF6A7AF612D2CFA2B8383868CF93735B,42921,10,14,4,33,47,1697
68492,68492,CF6A7AF612D2CFA2B8383868CF93735B,42523,14,17,3,31,47,1597
68493,68493,CF6A7AF612D2CFA2B8383868CF93735B,42921,18,20,2,33,47,1697
68494,68494,43BF896D3B851119060F11E58E6A9940,11324,0,7,7,31,46,1596
68495,68495,43BF896D3B851119060F11E58E6A9940,11871,10,14,4,29,46,1496
68496,68496,43BF896D3B851119060F11E58E6A9940,11321,18,23,5,31,46,1596
68497,68497,33EC6862A4D3A83DD8E8B00DCA26EE3C,43241,0,12,12,36,46,1846
68498,68498,33EC6862A4D3A83DD8E8B00DCA26EE3C,42864,14,15,1,38,44,1944
68499,68499,33EC6862A4D3A83DD8E8B00DCA26EE3C,43241,19,20,1,36,46,1846
68500,68500,5B7D20533455968081F1917AE3C512DE,13711,6,16,10,38,46,1946
68501,68501,5B7D20533455968081F1917AE3C512DE,11074,17,18,1,37,47,1897
68502,68502,5B7D20533455968081F1917AE3C512DE,13121,21,22,1,38,46,1946
68507,68507,FCF6425DA3F542476DF1F93935C075D8,42581,2,8,6,38,48,1948
68508,68508,FCF6425DA3F542476DF1F93935C075D8,11914,8,10,2,37,48,1898
68509,68509,FCF6425DA3F542476DF1F93935C075D8,42581,10,23,13,38,48,1948
68510,68510,F3DCE8C3C3FF003CDF3D27C94852CCE1,11951,1,6,5,31,49,1599
68511,68511,F3DCE8C3C3FF003CDF3D27C94852CCE1,13731,10,11,1,33,49,1699
68512,68512,F3DCE8C3C3FF003CDF3D27C94852CCE1,11954,18,19,1,32,49,1649
68513,68513,515D7C29684A1DFD6F920D5969F70CEE,13411,0,8,8,49,42,2492
68514,68514,515D7C29684A1DFD6F920D5969F70CEE,43951,12,13,1,49,41,2491
68515,68515,515D7C29684A1DFD6F920D5969F70CEE,13411,14,19,5,49,42,2492
68527,68527,3544B9900CDDC16C4606729762F4FE67,11151,0,7,7,30,48,1548
68528,68528,3544B9900CDDC16C4606729762F4FE67,11061,7,12,5,29,48,1498
68529,68529,3544B9900CDDC16C4606729762F4FE67,11151,14,20,6,30,48,1548
68535,68535,E8AB791B2EAE820D3450191B660F49B8,11074,0,12,12,37,47,1897
68536,68536,E8AB791B2EAE820D3450191B660F49B8,12514,14,16,2,38,47,1947
68537,68537,E8AB791B2EAE820D3450191B660F49B8,11921,19,20,1,38,48,1948
68538,68538,E8AB791B2EAE820D3450191B660F49B8,12514,21,23,2,38,47,1947
68539,68539,D4DD28DEB8C1EAB5E8CB11DCF963516A,10721,0,5,5,31,48,1598
68540,68540,D4DD28DEB8C1EAB5E8CB11DCF963516A,42021,9,11,2,33,47,1697
68541,68541,D4DD28DEB8C1EAB5E8CB11DCF963516A,43581,13,14,1,33,48,1698
68542,68542,D4DD28DEB8C1EAB5E8CB11DCF963516A,10721,16,18,2,31,48,1598
68543,68543,99090679888D7F5C536F089A4B9CEA7D,13911,1,5,4,39,46,1996
68544,68544,99090679888D7F5C536F089A4B9CEA7D,42231,6,8,2,37,46,1896
68545,68545,99090679888D7F5C536F089A4B9CEA7D,13911,9,15,6,39,46,1996
68546,68546,99090679888D7F5C536F089A4B9CEA7D,42231,19,23,4,37,46,1896
68547,68547,49C79AB3305EA0BDD0BE79CDFA7582CD,11074,0,6,6,37,47,1897
68548,68548,49C79AB3305EA0BDD0BE79CDFA7582CD,42221,7,9,2,38,48,1948
68549,68549,49C79AB3305EA0BDD0BE79CDFA7582CD,11074,10,21,11,37,47,1897
68569,68569,B45CB2E1B244B3B7583778DACAAA9799,11074,0,7,7,37,47,1897
68570,68570,B45CB2E1B244B3B7583778DACAAA9799,12514,9,10,1,38,47,1947
68571,68571,B45CB2E1B244B3B7583778DACAAA9799,11074,14,23,9,37,47,1897
68572,68572,6E802E6EED0751631BE3E26AAC23D1D7,19114,0,6,6,7,43,393
68573,68573,6E802E6EED0751631BE3E26AAC23D1D7,12921,9,11,2,9,41,491
68574,68574,6E802E6EED0751631BE3E26AAC23D1D7,19114,13,20,7,7,43,393
68580,68580,CE46A02CA196948C3D07DA5CEEB7BE83,43101,0,13,13,46,40,2340
68581,68581,CE46A02CA196948C3D07DA5CEEB7BE83,13551,14,15,1,45,38,2288
68582,68582,CE46A02CA196948C3D07DA5CEEB7BE83,43101,18,23,5,46,40,2340
68601,68601,22D95CF8B35CF82DEFAFF52E8ADB9EF4,42523,1,7,6,31,47,1597
68602,68602,22D95CF8B35CF82DEFAFF52E8ADB9EF4,10292,7,9,2,30,47,1547
68603,68603,22D95CF8B35CF82DEFAFF52E8ADB9EF4,42523,9,23,14,31,47,1597
68604,68604,88BD05605A9A7AEE925115A05AB374F3,10491,0,12,12,33,48,1698
68605,68605,88BD05605A9A7AEE925115A05AB374F3,11911,20,21,1,37,48,1898
68606,68606,88BD05605A9A7AEE925115A05AB374F3,10491,22,23,1,33,48,1698
68616,68616,44EC582B28018C3983EF942DE7D91534,10471,0,15,15,37,48,1898
68617,68617,44EC582B28018C3983EF942DE7D91534,41601,15,17,2,39,49,1999
68618,68618,44EC582B28018C3983EF942DE7D91534,10471,19,22,3,37,48,1898
68619,68619,A0CD1BD52DD40E3FE73C8383B3202D97,42151,0,10,10,35,45,1795
68620,68620,A0CD1BD52DD40E3FE73C8383B3202D97,11074,11,12,1,37,47,1897
68621,68621,A0CD1BD52DD40E3FE73C8383B3202D97,42301,14,20,6,36,47,1847
68622,68622,A0CD1BD52DD40E3FE73C8383B3202D97,42151,21,23,2,35,45,1795
68627,68627,8808564BFB5194979B3F25BB1A9057CB,43161,0,10,10,35,47,1797
68628,68628,8808564BFB5194979B3F25BB1A9057CB,11861,13,17,4,32,47,1647
68629,68629,8808564BFB5194979B3F25BB1A9057CB,43161,21,23,2,35,47,1797
68636,68636,C242C65CF9A572E377FACD3AB751859C,42971,0,6,6,43,49,2199
68637,68637,C242C65CF9A572E377FACD3AB751859C,40691,10,11,1,42,48,2148
68638,68638,C242C65CF9A572E377FACD3AB751859C,42971,12,22,10,43,49,2199
68642,68642,54E9147B0F88496112EA8083546467E6,12311,2,9,7,30,44,1544
68643,68643,54E9147B0F88496112EA8083546467E6,12661,9,18,9,32,45,1645
68644,68644,54E9147B0F88496112EA8083546467E6,12311,19,21,2,30,44,1544
68645,68645,61D4369B95803102112EEFE32BD36465,42141,6,12,6,32,47,1647
68646,68646,61D4369B95803102112EEFE32BD36465,10295,12,13,1,30,47,1547
68647,68647,61D4369B95803102112EEFE32BD36465,43761,13,19,6,32,47,1647
68648,68648,3DBAFDEA494877045EB98704E3E793DC,13911,0,12,12,39,46,1996
68649,68649,3DBAFDEA494877045EB98704E3E793DC,42231,14,16,2,37,46,1896
68650,68650,3DBAFDEA494877045EB98704E3E793DC,13911,20,23,3,39,46,1996
68657,68657,1940CC384468326D0591B825867214FA,10271,0,8,8,37,46,1896
68658,68658,1940CC384468326D0591B825867214FA,42511,9,10,1,37,47,1897
68659,68659,1940CC384468326D0591B825867214FA,10271,10,22,12,37,46,1896
68660,68660,B407E10E40F14F417BB48241B7C62C97,13271,0,17,17,41,47,2097
68661,68661,B407E10E40F14F417BB48241B7C62C97,11701,17,19,2,43,48,2198
68662,68662,B407E10E40F14F417BB48241B7C62C97,40833,21,22,1,41,47,2097
68674,68674,B304D2AD98C7DE24CAE6DD0DA65095F0,10431,0,6,6,33,49,1699
68675,68675,B304D2AD98C7DE24CAE6DD0DA65095F0,43581,7,17,10,33,48,1698
68676,68676,B304D2AD98C7DE24CAE6DD0DA65095F0,10431,22,23,1,33,49,1699
68680,68680,0CEC3D7EB4E938500D3BE15F068C3654,13121,0,9,9,38,46,1946
68681,68681,0CEC3D7EB4E938500D3BE15F068C3654,10271,10,11,1,37,46,1896
68682,68682,0CEC3D7EB4E938500D3BE15F068C3654,13121,11,17,6,38,46,1946
68683,68683,0CEC3D7EB4E938500D3BE15F068C3654,42511,19,22,3,37,47,1897
68696,68696,7555C7D56C0A52217E91484DDE32D6BD,42161,0,16,16,36,47,1847
68697,68697,7555C7D56C0A52217E91484DDE32D6BD,10691,18,19,1,33,48,1698
68698,68698,7555C7D56C0A52217E91484DDE32D6BD,42161,20,23,3,36,47,1847
68699,68699,6F1358C6526C9CA4FB50AA20B6B16B03,11001,0,7,7,42,47,2147
68700,68700,6F1358C6526C9CA4FB50AA20B6B16B03,13941,10,22,12,41,47,2097
68701,68701,6F1358C6526C9CA4FB50AA20B6B16B03,11001,22,23,1,42,47,2147
68710,68710,464DF91C83D752715121CBA55775E029,11381,0,11,11,30,47,1547
68711,68711,464DF91C83D752715121CBA55775E029,12121,14,16,2,29,47,1497
68712,68712,464DF91C83D752715121CBA55775E029,11381,17,22,5,30,47,1547
68725,68725,3E3DE9642E08925C9D8E6B4E15617412,11231,0,18,18,37,49,1899
68726,68726,3E3DE9642E08925C9D8E6B4E15617412,13731,19,20,1,33,49,1699
68727,68727,3E3DE9642E08925C9D8E6B4E15617412,11231,20,23,3,37,49,1899
68739,68739,86877F32D6D32D1728C272FD8E7855F4,11861,0,11,11,32,47,1647
68740,68740,86877F32D6D32D1728C272FD8E7855F4,10281,12,17,5,33,48,1698
68741,68741,86877F32D6D32D1728C272FD8E7855F4,11861,19,23,4,32,47,1647
68751,68751,F4C8F856DD638BBA75F52C720E10C05D,12921,10,12,2,9,41,491
68752,68752,F4C8F856DD638BBA75F52C720E10C05D,12641,12,15,3,10,43,543
68753,68753,F4C8F856DD638BBA75F52C720E10C05D,12921,18,20,2,9,41,491
68754,68754,84DA01F112661472BCB344139BA68924,43061,0,13,13,43,46,2196
68755,68755,84DA01F112661472BCB344139BA68924,13341,13,19,6,44,45,2245
68756,68756,84DA01F112661472BCB344139BA68924,43061,20,21,1,43,46,2196
68763,68763,2FC430E1448F290A8E229F5C2301E320,49201,1,4,3,7,41,391
68764,68764,2FC430E1448F290A8E229F5C2301E320,12921,5,8,3,9,41,491
68765,68765,2FC430E1448F290A8E229F5C2301E320,49201,12,15,3,7,41,391
68766,68766,2FC430E1448F290A8E229F5C2301E320,12921,16,23,7,9,41,491
68767,68767,094D262C3AAA514231DBB14DAD7630D3,11074,0,1,1,37,47,1897
68768,68768,094D262C3AAA514231DBB14DAD7630D3,11921,2,14,12,38,48,1948
68769,68769,094D262C3AAA514231DBB14DAD7630D3,10841,18,22,4,37,47,1897
68770,68770,1788FF83230593384DFEF88881720D90,13551,0,7,7,45,38,2288
68771,68771,1788FF83230593384DFEF88881720D90,43101,7,9,2,46,40,2340
68772,68772,1788FF83230593384DFEF88881720D90,13551,9,14,5,45,38,2288
68773,68773,1788FF83230593384DFEF88881720D90,43101,16,18,2,46,40,2340
68774,68774,BD7F8AE2121E328FD649FC14D4784D1F,11281,7,15,8,27,40,1390
68775,68775,BD7F8AE2121E328FD649FC14D4784D1F,13671,18,19,1,27,43,1393
68776,68776,BD7F8AE2121E328FD649FC14D4784D1F,11281,20,21,1,27,40,1390
68777,68777,EB3F1E97C488E972B65B1AF3C2A86B31,13331,0,1,1,38,47,1947
68778,68778,EB3F1E97C488E972B65B1AF3C2A86B31,10841,1,2,1,37,47,1897
68779,68779,EB3F1E97C488E972B65B1AF3C2A86B31,13331,3,20,17,38,47,1947
68780,68780,EB3F1E97C488E972B65B1AF3C2A86B31,11331,21,23,2,37,48,1898
68793,68793,36391605FB1091601145BE09BDC65544,11461,2,4,2,37,49,1899
68794,68794,36391605FB1091601145BE09BDC65544,42581,6,8,2,38,48,1948
68795,68795,36391605FB1091601145BE09BDC65544,11271,11,12,1,37,48,1898
68796,68796,36391605FB1091601145BE09BDC65544,11231,17,23,6,37,49,1899
68809,68809,172F302F5199600F927C0E74978E3B3A,10111,0,15,15,37,47,1897
68810,68810,172F302F5199600F927C0E74978E3B3A,11781,16,17,1,38,49,1949
68811,68811,172F302F5199600F927C0E74978E3B3A,42401,18,19,1,36,47,1847
68816,68816,0DFD98C5BF618352145AEF64606DF221,42401,0,2,2,36,47,1847
68817,68817,0DFD98C5BF618352145AEF64606DF221,40673,6,16,10,36,48,1848
68818,68818,0DFD98C5BF618352145AEF64606DF221,10251,19,23,4,35,47,1797
68819,68819,443F5091A2E4F1E9E888C9A4448AFB0B,10411,0,7,7,36,48,1848
68820,68820,443F5091A2E4F1E9E888C9A4448AFB0B,10271,12,13,1,37,46,1896
68821,68821,443F5091A2E4F1E9E888C9A4448AFB0B,10411,16,21,5,36,48,1848
68828,68828,D60685B98D8546585712AA6524505875,12121,0,3,3,29,47,1497
68829,68829,D60685B98D8546585712AA6524505875,11381,3,17,14,30,47,1547
68830,68830,D60685B98D8546585712AA6524505875,12121,18,19,1,29,47,1497
68831,68831,31100BE8BDE5B74B2D64B60F8888BAE5,10111,0,16,16,37,47,1897
68832,68832,31100BE8BDE5B74B2D64B60F8888BAE5,42161,16,17,1,36,47,1847
68833,68833,31100BE8BDE5B74B2D64B60F8888BAE5,10111,18,22,4,37,47,1897
68837,68837,F9BFC425350DF15984429AB66FE10A91,42021,0,16,16,33,47,1697
68838,68838,F9BFC425350DF15984429AB66FE10A91,11201,18,19,1,35,49,1799
68839,68839,F9BFC425350DF15984429AB66FE10A91,42021,21,22,1,33,47,1697
68845,68845,3AEA3CF422288C2FFB9C65FD7BE694C9,19931,0,5,5,7,43,393
68846,68846,3AEA3CF422288C2FFB9C65FD7BE694C9,12921,5,18,13,9,41,491
68847,68847,3AEA3CF422288C2FFB9C65FD7BE694C9,19901,21,22,1,7,44,394
68848,68848,CFD70B56FA65C02C4B76645FBAC9B18F,40431,0,6,6,36,47,1847
68849,68849,CFD70B56FA65C02C4B76645FBAC9B18F,41007,9,10,1,37,47,1897
68850,68850,CFD70B56FA65C02C4B76645FBAC9B18F,40431,11,23,12,36,47,1847
68851,68851,5589E896F9D9C08B6F07B51E2D632AF8,11381,6,16,10,30,47,1547
68852,68852,5589E896F9D9C08B6F07B51E2D632AF8,10951,17,19,2,29,48,1498
68853,68853,5589E896F9D9C08B6F07B51E2D632AF8,11381,20,23,3,30,47,1547
68854,68854,21709F7FFA433548AE3C0AA8A76FE0E7,11151,0,14,14,30,48,1548
68855,68855,21709F7FFA433548AE3C0AA8A76FE0E7,10381,14,15,1,31,49,1599
68856,68856,21709F7FFA433548AE3C0AA8A76FE0E7,11151,16,23,7,30,48,1548
68857,68857,C173E680DFAEC165B5B7AE7346539D93,42931,1,9,8,41,49,2099
68858,68858,C173E680DFAEC165B5B7AE7346539D93,11901,10,12,2,42,49,2149
68859,68859,C173E680DFAEC165B5B7AE7346539D93,11301,16,18,2,41,49,2099
68860,68860,C173E680DFAEC165B5B7AE7346539D93,11031,22,23,1,42,49,2149
68875,68875,61AF80679359D43A0E6925D92F08EE37,19931,6,7,1,7,43,393
68876,68876,61AF80679359D43A0E6925D92F08EE37,19744,7,16,9,6,43,343
68877,68877,61AF80679359D43A0E6925D92F08EE37,19931,18,20,2,7,43,393
68899,68899,A0FD925DFBC284575E97AC68CE1013AA,11271,0,7,7,37,48,1898
68900,68900,A0FD925DFBC284575E97AC68CE1013AA,10107,7,12,5,38,49,1949
68901,68901,A0FD925DFBC284575E97AC68CE1013AA,43361,19,21,2,38,48,1948
68908,68908,4A1082E29116D07A4EA830C32D0BE5ED,12221,1,9,8,43,44,2194
68909,68909,4A1082E29116D07A4EA830C32D0BE5ED,13341,12,18,6,44,45,2245
68910,68910,4A1082E29116D07A4EA830C32D0BE5ED,42631,19,20,1,43,45,2195
68911,68911,4A1082E29116D07A4EA830C32D0BE5ED,12221,21,22,1,43,44,2194
68922,68922,B45EBCB4BC75C6E8F280E8288A368DBC,11521,0,9,9,41,48,2098
68923,68923,B45EBCB4BC75C6E8F280E8288A368DBC,42601,12,14,2,44,48,2248
68924,68924,B45EBCB4BC75C6E8F280E8288A368DBC,11521,14,23,9,41,48,2098
68934,68934,10D100E56D8E505C358E7A0F36D0F9CD,10691,0,6,6,33,48,1698
68935,68935,10D100E56D8E505C358E7A0F36D0F9CD,10401,10,11,1,33,49,1699
68936,68936,10D100E56D8E505C358E7A0F36D0F9CD,10681,14,15,1,30,48,1548
68937,68937,10D100E56D8E505C358E7A0F36D0F9CD,10691,18,23,5,33,48,1698
68950,68950,672E46CD1A2289C6109AAA4160C503F8,11261,7,8,1,36,46,1846
68951,68951,672E46CD1A2289C6109AAA4160C503F8,13911,9,11,2,39,46,1996
68952,68952,672E46CD1A2289C6109AAA4160C503F8,42301,15,16,1,36,47,1847
68953,68953,672E46CD1A2289C6109AAA4160C503F8,11261,20,21,1,36,46,1846
68969,68969,181802B57A29F4FAE1E7EF60B334A9D5,13911,0,14,14,39,46,1996
68970,68970,181802B57A29F4FAE1E7EF60B334A9D5,42351,17,18,1,38,45,1945
68971,68971,181802B57A29F4FAE1E7EF60B334A9D5,13911,21,22,1,39,46,1996
68979,68979,D9026A3CE10A3841EFEE0C49DAE389C6,19114,6,10,4,7,43,393
68980,68980,D9026A3CE10A3841EFEE0C49DAE389C6,12641,11,12,1,10,43,543
68981,68981,D9026A3CE10A3841EFEE0C49DAE389C6,19114,13,18,5,7,43,393
68982,68982,D9026A3CE10A3841EFEE0C49DAE389C6,12641,19,23,4,10,43,543
68986,68986,44B392D88AA7F1B21F1FF6A57BADBD84,42231,9,11,2,37,46,1896
68987,68987,44B392D88AA7F1B21F1FF6A57BADBD84,13711,12,15,3,38,46,1946
68988,68988,44B392D88AA7F1B21F1FF6A57BADBD84,42231,15,18,3,37,46,1896
69017,69017,FC386E5EE84DD966E138539871A3312A,42161,0,1,1,36,47,1847
69018,69018,FC386E5EE84DD966E138539871A3312A,10251,3,10,7,35,47,1797
69019,69019,FC386E5EE84DD966E138539871A3312A,42161,11,21,10,36,47,1847
69020,69020,FC386E5EE84DD966E138539871A3312A,10471,21,23,2,37,48,1898
69021,69021,52EE55529201B8D9E8876F60459336C7,42511,0,13,13,37,47,1897
69022,69022,52EE55529201B8D9E8876F60459336C7,13121,13,15,2,38,46,1946
69023,69023,52EE55529201B8D9E8876F60459336C7,42511,18,21,3,37,47,1897
69029,69029,7BBD15EB45C3F1BA6E572F56B02ABEDA,12514,0,8,8,38,47,1947
69030,69030,7BBD15EB45C3F1BA6E572F56B02ABEDA,10841,9,16,7,37,47,1897
69031,69031,7BBD15EB45C3F1BA6E572F56B02ABEDA,12514,16,18,2,38,47,1947
69032,69032,7BBD15EB45C3F1BA6E572F56B02ABEDA,10841,19,22,3,37,47,1897
69037,69037,C7DA09D84BB6D5A3ABEAD976C8C0731E,42861,0,5,5,37,44,1894
69038,69038,C7DA09D84BB6D5A3ABEAD976C8C0731E,11261,7,9,2,36,46,1846
69039,69039,C7DA09D84BB6D5A3ABEAD976C8C0731E,42861,11,23,12,37,44,1894
69040,69040,E9A997EAD20100BC8DA950F1F1E8DDFE,11074,0,11,11,37,47,1897
69041,69041,E9A997EAD20100BC8DA950F1F1E8DDFE,12514,13,14,1,38,47,1947
69042,69042,E9A997EAD20100BC8DA950F1F1E8DDFE,11074,15,23,8,37,47,1897
69043,69043,B586EAB297E83D0A90DD54A60924E8FC,10111,0,10,10,37,47,1897
69044,69044,B586EAB297E83D0A90DD54A60924E8FC,10107,11,14,3,38,49,1949
69045,69045,B586EAB297E83D0A90DD54A60924E8FC,10111,15,23,8,37,47,1897
69049,69049,02016BAA6957D0C9575DCDC98D9579C2,11491,0,9,9,36,47,1847
69050,69050,02016BAA6957D0C9575DCDC98D9579C2,10971,13,18,5,35,47,1797
69051,69051,02016BAA6957D0C9575DCDC98D9579C2,42161,19,22,3,36,47,1847
69061,69061,5E6AB6B686A00A7ED3B8EAE75C21937D,42864,0,5,5,38,44,1944
69062,69062,5E6AB6B686A00A7ED3B8EAE75C21937D,11261,9,11,2,36,46,1846
69063,69063,5E6AB6B686A00A7ED3B8EAE75C21937D,42864,12,23,11,38,44,1944
69064,69064,B4D705B6FACBCC009AB169FE5F38F21F,42041,0,3,3,10,47,547
69065,69065,B4D705B6FACBCC009AB169FE5F38F21F,19441,3,4,1,8,46,446
69066,69066,B4D705B6FACBCC009AB169FE5F38F21F,42041,5,23,18,10,47,547
69067,69067,B1D714EAA88F4188BDEB8AEAFDE91C5B,42461,0,10,10,45,47,2297
69068,69068,B1D714EAA88F4188BDEB8AEAFDE91C5B,42111,11,12,1,44,46,2246
69069,69069,B1D714EAA88F4188BDEB8AEAFDE91C5B,42461,14,21,7,45,47,2297
69079,69079,C6869A64CA9EF97A25D7192A00726FC2,42401,0,7,7,36,47,1847
69080,69080,C6869A64CA9EF97A25D7192A00726FC2,10111,8,9,1,37,47,1897
69081,69081,C6869A64CA9EF97A25D7192A00726FC2,42401,11,23,12,36,47,1847
69088,69088,078D744FD5840DE4508E7DD5C66617FF,11261,0,4,4,36,46,1846
69089,69089,078D744FD5840DE4508E7DD5C66617FF,42351,9,10,1,38,45,1945
69090,69090,078D744FD5840DE4508E7DD5C66617FF,11261,11,18,7,36,46,1846
69091,69091,9B5ADF4AF9BB47E55F66068AB9CEF81F,10491,0,7,7,33,48,1698
69092,69092,9B5ADF4AF9BB47E55F66068AB9CEF81F,42071,15,17,2,31,49,1599
69093,69093,9B5ADF4AF9BB47E55F66068AB9CEF81F,10491,20,22,2,33,48,1698
69094,69094,1EB1C74741BE7C0B5E86F19E48D30409,12311,2,7,5,30,44,1544
69095,69095,1EB1C74741BE7C0B5E86F19E48D30409,42531,10,11,1,31,45,1595
69096,69096,1EB1C74741BE7C0B5E86F19E48D30409,12311,12,17,5,30,44,1544
69097,69097,1EB1C74741BE7C0B5E86F19E48D30409,42531,19,20,1,31,45,1595
69098,69098,C1677062502D8DBDAAAC7171DD4AB835,10471,1,16,15,37,48,1898
69099,69099,C1677062502D8DBDAAAC7171DD4AB835,11231,18,19,1,37,49,1899
69100,69100,C1677062502D8DBDAAAC7171DD4AB835,10471,19,23,4,37,48,1898
69101,69101,3FD7F5032276FA1C9FD7501948B6166F,11861,0,12,12,32,47,1647
69102,69102,3FD7F5032276FA1C9FD7501948B6166F,10292,12,13,1,30,47,1547
69103,69103,3FD7F5032276FA1C9FD7501948B6166F,11861,15,23,8,32,47,1647
69107,69107,FE5EF0C2F4B69A84D6BDB6109B4735F8,42301,1,3,2,36,47,1847
69108,69108,FE5EF0C2F4B69A84D6BDB6109B4735F8,10111,4,16,12,37,47,1897
69109,69109,FE5EF0C2F4B69A84D6BDB6109B4735F8,42161,19,20,1,36,47,1847
69113,69113,21D34D9AB698D190C3E7AC562954219B,12311,0,6,6,30,44,1544
69114,69114,21D34D9AB698D190C3E7AC562954219B,42531,8,9,1,31,45,1595
69115,69115,21D34D9AB698D190C3E7AC562954219B,12311,12,23,11,30,44,1544
69116,69116,17B467982DBE02EE2EDDF7462F3AE5CF,11351,1,18,17,36,48,1848
69117,69117,17B467982DBE02EE2EDDF7462F3AE5CF,11231,18,19,1,37,49,1899
69118,69118,17B467982DBE02EE2EDDF7462F3AE5CF,40925,20,23,3,35,49,1799
69119,69119,E1C859FD8CC74565ED07635B54DBAB6A,43761,0,6,6,32,47,1647
69120,69120,E1C859FD8CC74565ED07635B54DBAB6A,11061,7,17,10,29,48,1498
69121,69121,E1C859FD8CC74565ED07635B54DBAB6A,43761,21,23,2,32,47,1647
69122,69122,70E7EA9862CE7C9D4FA1C73735060256,11951,0,7,7,31,49,1599
69123,69123,70E7EA9862CE7C9D4FA1C73735060256,13731,9,17,8,33,49,1699
69124,69124,70E7EA9862CE7C9D4FA1C73735060256,11951,19,21,2,31,49,1599
69125,69125,E25E47AB022C606F7CB99E3DAFA11216,13121,0,2,2,38,46,1946
69126,69126,E25E47AB022C606F7CB99E3DAFA11216,42941,2,12,10,37,47,1897
69127,69127,E25E47AB022C606F7CB99E3DAFA11216,40124,12,13,1,38,47,1947
69128,69128,E25E47AB022C606F7CB99E3DAFA11216,13121,18,23,5,38,46,1946
69132,69132,C1BC146C1B557BAE93465B186B08C3FA,12311,0,11,11,30,44,1544
69133,69133,C1BC146C1B557BAE93465B186B08C3FA,12661,11,14,3,32,45,1645
69134,69134,C1BC146C1B557BAE93465B186B08C3FA,12311,14,16,2,30,44,1544
69135,69135,C1BC146C1B557BAE93465B186B08C3FA,12661,18,19,1,32,45,1645
69147,69147,F8E5692DC64F594EE622EF21A4844BEB,19114,0,5,5,7,43,393
69148,69148,F8E5692DC64F594EE622EF21A4844BEB,12921,5,7,2,9,41,491
69149,69149,F8E5692DC64F594EE622EF21A4844BEB,49201,7,19,12,7,41,391
69150,69150,F8E5692DC64F594EE622EF21A4844BEB,19114,19,22,3,7,43,393
69165,69165,ED14F75680A1780D0C6AF7290516296F,43661,0,7,7,33,47,1697
69166,69166,ED14F75680A1780D0C6AF7290516296F,43731,9,16,7,34,47,1747
69167,69167,ED14F75680A1780D0C6AF7290516296F,43661,18,23,5,33,47,1697
69172,69172,8B98AD14780EFE4A809080D8E1142428,42511,0,13,13,37,47,1897
69173,69173,8B98AD14780EFE4A809080D8E1142428,12514,16,17,1,38,47,1947
69174,69174,8B98AD14780EFE4A809080D8E1142428,10841,19,23,4,37,47,1897
69175,69175,F714E7BCDABF2B2F99991B80BC6098B2,19904,0,13,13,9,44,494
69176,69176,F714E7BCDABF2B2F99991B80BC6098B2,12921,14,16,2,9,41,491
69177,69177,F714E7BCDABF2B2F99991B80BC6098B2,19021,16,17,1,10,45,545
69178,69178,F714E7BCDABF2B2F99991B80BC6098B2,19904,20,21,1,9,44,494
69187,69187,990529BE48C6A8DFFA6A404F72B17A5A,11261,9,11,2,36,46,1846
69188,69188,990529BE48C6A8DFFA6A404F72B17A5A,42861,11,12,1,37,44,1894
69189,69189,990529BE48C6A8DFFA6A404F72B17A5A,11261,16,19,3,36,46,1846
69190,69190,A99DE7D86F2D30649282D24CB5ECED25,42941,0,6,6,37,47,1897
69191,69191,A99DE7D86F2D30649282D24CB5ECED25,42161,9,10,1,36,47,1847
69192,69192,A99DE7D86F2D30649282D24CB5ECED25,42941,11,13,2,37,47,1897
69193,69193,A99DE7D86F2D30649282D24CB5ECED25,42301,18,23,5,36,47,1847
69194,69194,441E401293D6FFC8E080552D376784E1,42581,1,3,2,38,48,1948
69195,69195,441E401293D6FFC8E080552D376784E1,10107,6,7,1,38,49,1949
69196,69196,441E401293D6FFC8E080552D376784E1,42581,10,16,6,38,48,1948
69197,69197,441E401293D6FFC8E080552D376784E1,11914,17,19,2,37,48,1898
69204,69204,98CB7996043B460F0A30F9E32DD4D2A7,41382,0,11,11,38,49,1949
69205,69205,98CB7996043B460F0A30F9E32DD4D2A7,10471,12,16,4,37,48,1898
69206,69206,98CB7996043B460F0A30F9E32DD4D2A7,11794,16,18,2,38,49,1949
69207,69207,F43B2A2358E587AF66EA3352466CD4F0,11074,1,11,10,37,47,1897
69208,69208,F43B2A2358E587AF66EA3352466CD4F0,10371,12,20,8,37,49,1899
69209,69209,F43B2A2358E587AF66EA3352466CD4F0,42301,20,22,2,36,47,1847
69210,69210,9F4FE5C66D1FE88FA924255DF3CD2B31,40171,0,8,8,38,48,1948
69211,69211,9F4FE5C66D1FE88FA924255DF3CD2B31,11911,13,16,3,37,48,1898
69212,69212,9F4FE5C66D1FE88FA924255DF3CD2B31,10411,18,23,5,36,48,1848
69216,69216,1482B7A55B8E55DF5157551064F6B705,13471,0,13,13,47,49,2399
69217,69217,1482B7A55B8E55DF5157551064F6B705,42461,14,15,1,45,47,2297
69218,69218,1482B7A55B8E55DF5157551064F6B705,13471,19,23,4,47,49,2399
69219,69219,EFBC3970A8D85E468BA1CD392CC84245,10381,0,10,10,31,49,1599
69220,69220,EFBC3970A8D85E468BA1CD392CC84245,10681,10,13,3,30,48,1548
69221,69221,EFBC3970A8D85E468BA1CD392CC84245,10381,15,20,5,31,49,1599
69259,69259,BA1815D91435C4EA59ECC3893D390CD9,10811,0,13,13,38,46,1946
69260,69260,BA1815D91435C4EA59ECC3893D390CD9,10971,18,20,2,35,47,1797
69261,69261,BA1815D91435C4EA59ECC3893D390CD9,10811,20,23,3,38,46,1946
69262,69262,6F6F174BF3BBBF4A283E7794B5A58265,42581,1,6,5,38,48,1948
69263,69263,6F6F174BF3BBBF4A283E7794B5A58265,11914,8,19,11,37,48,1898
69264,69264,6F6F174BF3BBBF4A283E7794B5A58265,42581,19,21,2,38,48,1948
69265,69265,B969FE7CA88FA294C8201CFC44CC669E,12121,0,7,7,29,47,1497
69266,69266,B969FE7CA88FA294C8201CFC44CC669E,12601,9,16,7,25,47,1297
69267,69267,B969FE7CA88FA294C8201CFC44CC669E,12121,17,23,6,29,47,1497
69268,69268,88182B8F0A08A7B6CD3790FE87C79F47,42231,0,2,2,37,46,1896
69269,69269,88182B8F0A08A7B6CD3790FE87C79F47,42351,3,7,4,38,45,1945
69270,69270,88182B8F0A08A7B6CD3790FE87C79F47,42231,8,10,2,37,46,1896
69271,69271,88182B8F0A08A7B6CD3790FE87C79F47,42351,13,21,8,38,45,1945
69272,69272,FC6A327AF4D88F99F15C3F090B3C9103,13341,0,3,3,44,45,2245
69273,69273,FC6A327AF4D88F99F15C3F090B3C9103,43051,3,6,3,46,45,2345
69274,69274,FC6A327AF4D88F99F15C3F090B3C9103,13341,20,23,3,44,45,2245
69275,69275,88B9ED484BFC88A3E18D812526B753D0,42351,0,5,5,38,45,1945
69276,69276,88B9ED484BFC88A3E18D812526B753D0,42861,7,8,1,37,44,1894
69277,69277,88B9ED484BFC88A3E18D812526B753D0,11261,9,19,10,36,46,1846
69278,69278,88B9ED484BFC88A3E18D812526B753D0,42351,19,20,1,38,45,1945
69279,69279,3785AE7850A3464F98BAA053E2179E6F,43761,0,6,6,32,47,1647
69280,69280,3785AE7850A3464F98BAA053E2179E6F,11381,9,14,5,30,47,1547
69281,69281,3785AE7850A3464F98BAA053E2179E6F,43761,16,23,7,32,47,1647
69297,69297,8B6448FD7DB9F8E2F8F73AFDDD5BFD38,10634,5,13,8,27,45,1395
69298,69298,8B6448FD7DB9F8E2F8F73AFDDD5BFD38,11871,15,16,1,29,46,1496
69299,69299,8B6448FD7DB9F8E2F8F73AFDDD5BFD38,10634,17,21,4,27,45,1395
69300,69300,56547DCD12E76D718E2E60F15A40B9D5,42401,2,7,5,36,47,1847
69301,69301,56547DCD12E76D718E2E60F15A40B9D5,10251,8,9,1,35,47,1797
69302,69302,56547DCD12E76D718E2E60F15A40B9D5,10111,11,19,8,37,47,1897
69303,69303,56547DCD12E76D718E2E60F15A40B9D5,40637,19,20,1,36,47,1847
69304,69304,27B6DDFE3A356062F221ABD7AD70BB14,11061,0,12,12,29,48,1498
69305,69305,27B6DDFE3A356062F221ABD7AD70BB14,10681,14,16,2,30,48,1548
69306,69306,27B6DDFE3A356062F221ABD7AD70BB14,11061,18,23,5,29,48,1498
69312,69312,94208362745F4CC8136A1624AA480486,10161,0,8,8,35,49,1799
69313,69313,94208362745F4CC8136A1624AA480486,10901,9,15,6,35,48,1798
69314,69314,94208362745F4CC8136A1624AA480486,40951,15,16,1,36,49,1849
69315,69315,94208362745F4CC8136A1624AA480486,10161,19,21,2,35,49,1799
69320,69320,DD2776738383CBF6281F190C1D1B13EA,11231,0,12,12,37,49,1899
69321,69321,DD2776738383CBF6281F190C1D1B13EA,10251,13,18,5,35,47,1797
69322,69322,DD2776738383CBF6281F190C1D1B13EA,42301,19,20,1,36,47,1847
69323,69323,0A7642F6BA4AB6F9DC5903DCFF858742,11771,2,10,8,39,49,1999
69324,69324,0A7642F6BA4AB6F9DC5903DCFF858742,10471,10,19,9,37,48,1898
69325,69325,0A7642F6BA4AB6F9DC5903DCFF858742,11771,21,23,2,39,49,1999
69329,69329,8BB25F3EED8F2EF343FD30AD9192A8D8,10041,0,2,2,39,49,1999
69330,69330,8BB25F3EED8F2EF343FD30AD9192A8D8,41382,2,5,3,38,49,1949
69331,69331,8BB25F3EED8F2EF343FD30AD9192A8D8,10787,6,7,1,38,46,1946
69332,69332,8BB25F3EED8F2EF343FD30AD9192A8D8,11781,22,23,1,38,49,1949
69337,69337,BB6408B6449FE57F7E33631A828BC98E,13961,2,9,7,42,48,2148
69338,69338,BB6408B6449FE57F7E33631A828BC98E,11701,11,15,4,43,48,2198
69339,69339,BB6408B6449FE57F7E33631A828BC98E,10421,19,23,4,41,48,2098
69357,69357,F375472DEA772AB5B5D461F4E41453CE,11531,10,13,3,34,49,1749
69358,69358,F375472DEA772AB5B5D461F4E41453CE,40112,16,17,1,32,48,1648
69359,69359,F375472DEA772AB5B5D461F4E41453CE,11531,18,21,3,34,49,1749
69360,69360,6166F4BC9B2530F6FDAD5A0233FBAAD6,42581,3,9,6,38,48,1948
69361,69361,6166F4BC9B2530F6FDAD5A0233FBAAD6,11914,10,12,2,37,48,1898
69362,69362,6166F4BC9B2530F6FDAD5A0233FBAAD6,42581,14,18,4,38,48,1948
69363,69363,2DC192DC303083B8FEFB2CD2D1161047,42461,0,9,9,45,47,2297
69364,69364,2DC192DC303083B8FEFB2CD2D1161047,42201,12,13,1,43,46,2196
69365,69365,2DC192DC303083B8FEFB2CD2D1161047,42461,13,22,9,45,47,2297
69371,69371,B9E3EF4A9008C51B663F167BE68EF8BE,10681,0,7,7,30,48,1548
69372,69372,B9E3EF4A9008C51B663F167BE68EF8BE,11061,7,9,2,29,48,1498
69373,69373,B9E3EF4A9008C51B663F167BE68EF8BE,10681,11,18,7,30,48,1548
69381,69381,859846C23309918FCF7E37DF9FD45D9F,13911,0,8,8,39,46,1996
69382,69382,859846C23309918FCF7E37DF9FD45D9F,11261,8,11,3,36,46,1846
69383,69383,859846C23309918FCF7E37DF9FD45D9F,13911,13,23,10,39,46,1996
69384,69384,4556C24C01E60F4DA7FE0405D662DAB2,11771,1,9,8,39,49,1999
69385,69385,4556C24C01E60F4DA7FE0405D662DAB2,10471,10,19,9,37,48,1898
69386,69386,4556C24C01E60F4DA7FE0405D662DAB2,11771,20,22,2,39,49,1999
69387,69387,035266CFE514B2CE8084B5CCD3E8A0F1,10841,1,10,9,37,47,1897
69388,69388,035266CFE514B2CE8084B5CCD3E8A0F1,11331,15,20,5,37,48,1898
69389,69389,035266CFE514B2CE8084B5CCD3E8A0F1,11074,21,23,2,37,47,1897
69390,69390,6F36CD3F83F4DBF6455003B4F4746D73,11201,0,8,8,35,49,1799
69391,69391,6F36CD3F83F4DBF6455003B4F4746D73,40951,12,14,2,36,49,1849
69392,69392,6F36CD3F83F4DBF6455003B4F4746D73,10471,14,23,9,37,48,1898
69410,69410,FB884068BD7DD556B3824535D710DF2C,13911,0,6,6,39,46,1996
69411,69411,FB884068BD7DD556B3824535D710DF2C,11261,7,8,1,36,46,1846
69412,69412,FB884068BD7DD556B3824535D710DF2C,13911,10,18,8,39,46,1996
69413,69413,FB884068BD7DD556B3824535D710DF2C,42351,21,23,2,38,45,1945
69419,69419,BED5D070D3C452868EB1FAF79F3ADB38,10901,9,10,1,35,48,1798
69420,69420,BED5D070D3C452868EB1FAF79F3ADB38,11021,12,17,5,36,49,1849
69421,69421,BED5D070D3C452868EB1FAF79F3ADB38,43161,18,19,1,35,47,1797
69431,69431,01B7A3B2C26FB99C1C09CE1411B2C84C,13911,0,13,13,39,46,1996
69432,69432,01B7A3B2C26FB99C1C09CE1411B2C84C,42351,14,16,2,38,45,1945
69433,69433,01B7A3B2C26FB99C1C09CE1411B2C84C,13911,18,23,5,39,46,1996
69434,69434,6460FC216A34C188FE4998AEEFF35C56,43451,0,12,12,37,40,1890
69435,69435,6460FC216A34C188FE4998AEEFF35C56,12521,12,14,2,35,41,1791
69436,69436,6460FC216A34C188FE4998AEEFF35C56,43451,15,22,7,37,40,1890
69437,69437,D049151AA3A3F2786A77273D813485C6,40833,0,4,4,41,47,2097
69438,69438,D049151AA3A3F2786A77273D813485C6,13101,4,13,9,40,47,2047
69439,69439,D049151AA3A3F2786A77273D813485C6,11481,14,19,5,41,48,2098
69440,69440,D049151AA3A3F2786A77273D813485C6,40833,19,21,2,41,47,2097
69441,69441,4D239E998445105BB1DB28C4CB8040D2,42581,0,8,8,38,48,1948
69442,69442,4D239E998445105BB1DB28C4CB8040D2,11914,9,10,1,37,48,1898
69443,69443,4D239E998445105BB1DB28C4CB8040D2,42581,11,21,10,38,48,1948
69452,69452,B8AADB6FF102771D74EF7F7A32317AB0,10401,1,9,8,33,49,1699
69453,69453,B8AADB6FF102771D74EF7F7A32317AB0,11861,13,15,2,32,47,1647
69454,69454,B8AADB6FF102771D74EF7F7A32317AB0,10401,18,23,5,33,49,1699
69455,69455,BEF31F045A546CF30A63CFBCD60FD3FA,13911,8,9,1,39,46,1996
69456,69456,BEF31F045A546CF30A63CFBCD60FD3FA,42231,11,15,4,37,46,1896
69457,69457,BEF31F045A546CF30A63CFBCD60FD3FA,42351,20,21,1,38,45,1945
69458,69458,ACD7D06D699A88B2E7BB7970CE635C80,11381,1,16,15,30,47,1547
69459,69459,ACD7D06D699A88B2E7BB7970CE635C80,10951,19,20,1,29,48,1498
69460,69460,ACD7D06D699A88B2E7BB7970CE635C80,11381,22,23,1,30,47,1547
69465,69465,859E260722255F7F45E0FFF12EE36117,11461,1,12,11,37,49,1899
69466,69466,859E260722255F7F45E0FFF12EE36117,13711,14,16,2,38,46,1946
69467,69467,859E260722255F7F45E0FFF12EE36117,12511,17,19,2,39,47,1997
69468,69468,DFA44588B9F7612E59AB24A1351E5F4F,12921,0,17,17,9,41,491
69469,69469,DFA44588B9F7612E59AB24A1351E5F4F,49201,20,21,1,7,41,391
69470,69470,DFA44588B9F7612E59AB24A1351E5F4F,12921,21,23,2,9,41,491
69484,69484,675039FAA090CCBF91EDA5EAFBE6A7DD,43041,0,10,10,41,46,2096
69485,69485,675039FAA090CCBF91EDA5EAFBE6A7DD,13121,12,14,2,38,46,1946
69486,69486,675039FAA090CCBF91EDA5EAFBE6A7DD,43041,19,23,4,41,46,2096
69487,69487,4FEDDE4724DDA61E19979F6B8E0B84B5,42511,0,1,1,37,47,1897
69488,69488,4FEDDE4724DDA61E19979F6B8E0B84B5,42301,1,7,6,36,47,1847
69489,69489,4FEDDE4724DDA61E19979F6B8E0B84B5,10271,8,19,11,37,46,1896
69490,69490,4FEDDE4724DDA61E19979F6B8E0B84B5,42511,20,23,3,37,47,1897
69495,69495,482231C60E75752F61489BAC43B2B02B,10121,0,10,10,36,49,1849
69496,69496,482231C60E75752F61489BAC43B2B02B,11541,10,18,8,35,49,1799
69497,69497,482231C60E75752F61489BAC43B2B02B,10121,21,23,2,36,49,1849
69498,69498,002C6A1ACEAD393A6D0C02F2F2D84028,11541,0,2,2,35,49,1799
69499,69499,002C6A1ACEAD393A6D0C02F2F2D84028,11211,3,8,5,34,49,1749
69500,69500,002C6A1ACEAD393A6D0C02F2F2D84028,11541,17,23,6,35,49,1799
69507,69507,2E67572E54BDF1C3F90C9EE2574A117B,42623,2,13,11,22,49,1149
69508,69508,2E67572E54BDF1C3F90C9EE2574A117B,40341,18,19,1,23,49,1199
69509,69509,2E67572E54BDF1C3F90C9EE2574A117B,42623,20,23,3,22,49,1149
69517,69517,AD7F7BB46EF09C86333AC9999F5D1555,10271,0,13,13,37,46,1896
69518,69518,AD7F7BB46EF09C86333AC9999F5D1555,13121,17,19,2,38,46,1946
69519,69519,AD7F7BB46EF09C86333AC9999F5D1555,10271,20,22,2,37,46,1896
69526,69526,BBCB9918D42B41DEDF16DD7F5A9BE26F,11861,0,9,9,32,47,1647
69527,69527,BBCB9918D42B41DEDF16DD7F5A9BE26F,42161,9,17,8,36,47,1847
69528,69528,BBCB9918D42B41DEDF16DD7F5A9BE26F,11861,17,23,6,32,47,1647
69535,69535,60B3904EE9AFD7C630994F95D4C927AC,11231,0,2,2,37,49,1899
69536,69536,60B3904EE9AFD7C630994F95D4C927AC,11271,3,4,1,37,48,1898
69537,69537,60B3904EE9AFD7C630994F95D4C927AC,13561,5,23,18,37,49,1899
69549,69549,FC7EB9622F9DA93D9292A2CD4A392CDA,12491,1,4,3,36,43,1843
69550,69550,FC7EB9622F9DA93D9292A2CD4A392CDA,11261,6,7,1,36,46,1846
69551,69551,FC7EB9622F9DA93D9292A2CD4A392CDA,12491,10,11,1,36,43,1843
69552,69552,FC7EB9622F9DA93D9292A2CD4A392CDA,11261,13,21,8,36,46,1846
69553,69553,FB8D61C5B787C9BFA24064ED9A74F466,13271,0,2,2,41,47,2097
69554,69554,FB8D61C5B787C9BFA24064ED9A74F466,11481,7,11,4,41,48,2098
69555,69555,FB8D61C5B787C9BFA24064ED9A74F466,13101,12,17,5,40,47,2047
69556,69556,FB8D61C5B787C9BFA24064ED9A74F466,13271,21,23,2,41,47,2097
69566,69566,B0FF888F2A2CE698F2B8641BCE4B074A,11875,2,7,5,30,46,1546
69567,69567,B0FF888F2A2CE698F2B8641BCE4B074A,11381,10,11,1,30,47,1547
69568,69568,B0FF888F2A2CE698F2B8641BCE4B074A,10634,14,20,6,27,45,1395
69572,69572,EE6B8585E25BB845D2DA0A95F88FAB79,42011,10,11,1,36,46,1846
69573,69573,EE6B8585E25BB845D2DA0A95F88FAB79,42231,11,12,1,37,46,1896
69574,69574,EE6B8585E25BB845D2DA0A95F88FAB79,42351,13,14,1,38,45,1945
69575,69575,EE6B8585E25BB845D2DA0A95F88FAB79,11261,16,18,2,36,46,1846
69584,69584,40A368CA34750DF505DA57A322872C86,12611,0,14,14,41,29,2079
69585,69585,40A368CA34750DF505DA57A322872C86,13361,17,18,1,42,31,2131
69586,69586,40A368CA34750DF505DA57A322872C86,12611,20,23,3,41,29,2079
69593,69593,DA61182B1E585FBAFEE35AEAB2142F2D,11921,0,7,7,38,48,1948
69594,69594,DA61182B1E585FBAFEE35AEAB2142F2D,10901,11,19,8,35,48,1798
69595,69595,DA61182B1E585FBAFEE35AEAB2142F2D,11921,19,23,4,38,48,1948
69600,69600,C5C2D05B8E1790DD767564DE3329EF28,10221,0,8,8,34,49,1749
69601,69601,C5C2D05B8E1790DD767564DE3329EF28,42161,12,14,2,36,47,1847
69602,69602,C5C2D05B8E1790DD767564DE3329EF28,43731,19,20,1,34,47,1747
69618,69618,78B9DCFA4CFE02297486B374939C4654,11261,0,7,7,36,46,1846
69619,69619,78B9DCFA4CFE02297486B374939C4654,42151,7,10,3,35,45,1795
69620,69620,78B9DCFA4CFE02297486B374939C4654,11261,10,23,13,36,46,1846
69626,69626,57F0D993E6866EF1281F0131EAEA267C,10716,9,11,2,30,46,1546
69627,69627,57F0D993E6866EF1281F0131EAEA267C,11324,11,13,2,31,46,1596
69628,69628,57F0D993E6866EF1281F0131EAEA267C,10295,18,23,5,30,47,1547
69629,69629,F3EBB57DA3A54FEC2068629888C9AD19,11941,0,7,7,37,46,1896
69630,69630,F3EBB57DA3A54FEC2068629888C9AD19,12514,8,17,9,38,47,1947
69631,69631,F3EBB57DA3A54FEC2068629888C9AD19,11941,19,23,4,37,46,1896
69632,69632,79F5F6FF92A1AB4EFE8FBCDCDB3E722F,42141,0,13,13,32,47,1647
69633,69633,79F5F6FF92A1AB4EFE8FBCDCDB3E722F,42921,13,17,4,33,47,1697
69634,69634,79F5F6FF92A1AB4EFE8FBCDCDB3E722F,11861,18,21,3,32,47,1647
69635,69635,79F5F6FF92A1AB4EFE8FBCDCDB3E722F,11161,22,23,1,32,48,1648
69644,69644,1C4D9C3B4ACCE12D2B04BB20561492BF,10821,5,7,2,40,47,2047
69645,69645,1C4D9C3B4ACCE12D2B04BB20561492BF,13941,11,14,3,41,47,2097
69646,69646,1C4D9C3B4ACCE12D2B04BB20561492BF,13221,15,18,3,40,47,2047
69647,69647,1C4D9C3B4ACCE12D2B04BB20561492BF,13271,22,23,1,41,47,2097
69648,69648,21E7E3CBBE4DC92A478F3B72E14E1D90,10111,0,10,10,37,47,1897
69649,69649,21E7E3CBBE4DC92A478F3B72E14E1D90,42301,14,15,1,36,47,1847
69650,69650,21E7E3CBBE4DC92A478F3B72E14E1D90,10111,16,22,6,37,47,1897
69670,69670,F587555054424F7ED0D63829AAEB0C06,11806,0,8,8,41,48,2098
69671,69671,F587555054424F7ED0D63829AAEB0C06,42271,8,16,8,40,47,2047
69672,69672,F587555054424F7ED0D63829AAEB0C06,11806,19,20,1,41,48,2098
69673,69673,E46BDE628A41D420CD9BF3D35A126ACD,10841,0,9,9,37,47,1897
69674,69674,E46BDE628A41D420CD9BF3D35A126ACD,12514,11,18,7,38,47,1947
69675,69675,E46BDE628A41D420CD9BF3D35A126ACD,10841,18,21,3,37,47,1897
69676,69676,E46BDE628A41D420CD9BF3D35A126ACD,13331,21,23,2,38,47,1947
69690,69690,FD926C96A4F9758B0E89829758CD18F3,11074,0,12,12,37,47,1897
69691,69691,FD926C96A4F9758B0E89829758CD18F3,11271,15,17,2,37,48,1898
69692,69692,FD926C96A4F9758B0E89829758CD18F3,10151,21,22,1,34,47,1747
69693,69693,34B0487DA91675A6216B605C367EE35D,43761,4,10,6,32,47,1647
69694,69694,34B0487DA91675A6216B605C367EE35D,11061,10,14,4,29,48,1498
69695,69695,34B0487DA91675A6216B605C367EE35D,10221,17,20,3,34,49,1749
69712,69712,72B28316E77049B3B3D9EC9BDF710CF6,42523,0,3,3,31,47,1597
69713,69713,72B28316E77049B3B3D9EC9BDF710CF6,43761,6,18,12,32,47,1647
69714,69714,72B28316E77049B3B3D9EC9BDF710CF6,42523,19,23,4,31,47,1597
69720,69720,78EF43D1D89054E0B172A8E48923FED9,12083,10,12,2,36,49,1849
69721,69721,78EF43D1D89054E0B172A8E48923FED9,10661,15,18,3,37,49,1899
69722,69722,78EF43D1D89054E0B172A8E48923FED9,11271,18,19,1,37,48,1898
69723,69723,78EF43D1D89054E0B172A8E48923FED9,12083,20,21,1,36,49,1849
69741,69741,74C90A586CDE5D22B85B5C9D6662CF52,19114,0,6,6,7,43,393
69742,69742,74C90A586CDE5D22B85B5C9D6662CF52,12641,6,8,2,10,43,543
69743,69743,74C90A586CDE5D22B85B5C9D6662CF52,19114,9,22,13,7,43,393
69744,69744,58B0725FA25DF85297C8BBDEAA0352D5,12521,0,8,8,35,41,1791
69745,69745,58B0725FA25DF85297C8BBDEAA0352D5,43451,10,11,1,37,40,1890
69746,69746,58B0725FA25DF85297C8BBDEAA0352D5,12521,11,18,7,35,41,1791
69751,69751,19058A886495CC5FD14FC3AD8393ADEE,10111,0,6,6,37,47,1897
69752,69752,19058A886495CC5FD14FC3AD8393ADEE,42301,9,10,1,36,47,1847
69753,69753,19058A886495CC5FD14FC3AD8393ADEE,11781,12,15,3,38,49,1949
69754,69754,19058A886495CC5FD14FC3AD8393ADEE,10111,16,23,7,37,47,1897
69758,69758,F599BD40004701EFC1748D458DE1C7F2,10731,4,12,8,33,47,1697
69759,69759,F599BD40004701EFC1748D458DE1C7F2,11201,16,19,3,35,49,1799
69760,69760,F599BD40004701EFC1748D458DE1C7F2,11861,20,23,3,32,47,1647
69761,69761,04C024AD6716C59AEF71765CE69E1D56,10781,0,14,14,35,47,1797
69762,69762,04C024AD6716C59AEF71765CE69E1D56,43731,15,17,2,34,47,1747
69763,69763,04C024AD6716C59AEF71765CE69E1D56,10781,19,23,4,35,47,1797
69764,69764,482E04AEF72505D2582FA7E53C21A341,10841,0,9,9,37,47,1897
69765,69765,482E04AEF72505D2582FA7E53C21A341,40951,13,14,1,36,49,1849
69766,69766,482E04AEF72505D2582FA7E53C21A341,10841,17,23,6,37,47,1897
69771,69771,356F6E1578C98AB3F5661AE6A4886228,42071,1,14,13,31,49,1599
69772,69772,356F6E1578C98AB3F5661AE6A4886228,11381,14,16,2,30,47,1547
69773,69773,356F6E1578C98AB3F5661AE6A4886228,42071,18,22,4,31,49,1599
69774,69774,FF0C11254BA355CCA708C36EE5C4353D,11381,0,14,14,30,47,1547
69775,69775,FF0C11254BA355CCA708C36EE5C4353D,11061,14,18,4,29,48,1498
69776,69776,FF0C11254BA355CCA708C36EE5C4353D,11381,18,22,4,30,47,1547
69777,69777,138FF279D92615D61A668B43E45A706D,42221,0,8,8,38,48,1948
69778,69778,138FF279D92615D61A668B43E45A706D,13121,10,12,2,38,46,1946
69779,69779,138FF279D92615D61A668B43E45A706D,11201,15,17,2,35,49,1799
69780,69780,138FF279D92615D61A668B43E45A706D,42221,18,23,5,38,48,1948
69784,69784,005F29A161E0688A7FD457CFA6CB5E51,42021,1,7,6,33,47,1697
69785,69785,005F29A161E0688A7FD457CFA6CB5E51,13601,7,13,6,34,47,1747
69786,69786,005F29A161E0688A7FD457CFA6CB5E51,43311,14,16,2,31,48,1598
69787,69787,005F29A161E0688A7FD457CFA6CB5E51,13601,16,22,6,34,47,1747
69802,69802,E528C1BCF7730647027A4A7EFB058975,13341,0,14,14,44,45,2245
69803,69803,E528C1BCF7730647027A4A7EFB058975,43061,15,16,1,43,46,2196
69804,69804,E528C1BCF7730647027A4A7EFB058975,13341,17,22,5,44,45,2245
69805,69805,A3A77D2599A2BF9F99F7B68059141180,12221,0,7,7,43,44,2194
69806,69806,A3A77D2599A2BF9F99F7B68059141180,12211,8,9,1,41,44,2094
69807,69807,A3A77D2599A2BF9F99F7B68059141180,12221,10,11,1,43,44,2194
69808,69808,A3A77D2599A2BF9F99F7B68059141180,12211,12,23,11,41,44,2094
69809,69809,B4484BE9156766AA51CC15872D68808F,42581,5,16,11,38,48,1948
69810,69810,B4484BE9156766AA51CC15872D68808F,43181,20,21,1,39,48,1998
69811,69811,B4484BE9156766AA51CC15872D68808F,42581,21,23,2,38,48,1948
69812,69812,BF4FDDCD481CA927405B56D9236C724E,11381,0,2,2,30,47,1547
69813,69813,BF4FDDCD481CA927405B56D9236C724E,43971,2,7,5,30,48,1548
69814,69814,BF4FDDCD481CA927405B56D9236C724E,10951,7,9,2,29,48,1498
69815,69815,BF4FDDCD481CA927405B56D9236C724E,11381,12,21,9,30,47,1547
69822,69822,0A3AEB60A6106F02C32A3904CC28A141,15181,0,8,8,26,24,1324
69823,69823,0A3AEB60A6106F02C32A3904CC28A141,43121,12,13,1,25,27,1277
69824,69824,0A3AEB60A6106F02C32A3904CC28A141,15181,14,17,3,26,24,1324
69825,69825,0A3AEB60A6106F02C32A3904CC28A141,43121,17,19,2,25,27,1277
69831,69831,4512C33A5D25C12FE88068CD1CBDBC46,11921,3,7,4,38,48,1948
69832,69832,4512C33A5D25C12FE88068CD1CBDBC46,10841,9,18,9,37,47,1897
69833,69833,4512C33A5D25C12FE88068CD1CBDBC46,11914,19,23,4,37,48,1898
69842,69842,29A4DCF52DC2F3624D699E5BA6DF8CE9,11231,4,14,10,37,49,1899
69843,69843,29A4DCF52DC2F3624D699E5BA6DF8CE9,11211,14,17,3,34,49,1749
69844,69844,29A4DCF52DC2F3624D699E5BA6DF8CE9,11231,18,20,2,37,49,1899
69856,69856,9F99A72527E81B89BEB16DB21B613CC0,10281,0,7,7,33,48,1698
69857,69857,9F99A72527E81B89BEB16DB21B613CC0,11861,7,12,5,32,47,1647
69858,69858,9F99A72527E81B89BEB16DB21B613CC0,10281,12,23,11,33,48,1698
69875,69875,38BAD20AF3F1C2D76FC5AB52738907B1,10341,10,13,3,31,47,1597
69876,69876,38BAD20AF3F1C2D76FC5AB52738907B1,11861,14,18,4,32,47,1647
69877,69877,38BAD20AF3F1C2D76FC5AB52738907B1,10341,18,22,4,31,47,1597
69878,69878,EF70B819C0B2D97BD4189E099D0FE5A9,11861,0,15,15,32,47,1647
69879,69879,EF70B819C0B2D97BD4189E099D0FE5A9,10281,15,16,1,33,48,1698
69880,69880,EF70B819C0B2D97BD4189E099D0FE5A9,11861,17,23,6,32,47,1647
69884,69884,1A4EF26B716866CB6EB54F5ABE3DDC74,13651,0,17,17,30,47,1547
69885,69885,1A4EF26B716866CB6EB54F5ABE3DDC74,42521,19,20,1,31,47,1597
69886,69886,1A4EF26B716866CB6EB54F5ABE3DDC74,13651,20,23,3,30,47,1547
69897,69897,F3CE6A0617707A9ABD8F0B15EBE138A8,13441,0,14,14,39,39,1989
69898,69898,F3CE6A0617707A9ABD8F0B15EBE138A8,13071,17,18,1,41,41,2091
69899,69899,F3CE6A0617707A9ABD8F0B15EBE138A8,43841,19,23,4,40,37,2037
69927,69927,2EFE2CC5C90B5BAC1EEDBA0A51560C5C,13911,0,6,6,39,46,1996
69928,69928,2EFE2CC5C90B5BAC1EEDBA0A51560C5C,11261,7,10,3,36,46,1846
69929,69929,2EFE2CC5C90B5BAC1EEDBA0A51560C5C,13911,12,17,5,39,46,1996
69930,69930,2EFE2CC5C90B5BAC1EEDBA0A51560C5C,42231,18,20,2,37,46,1896
69931,69931,59462C07A8E74ECD5E413125FEE703DF,11914,0,7,7,37,48,1898
69932,69932,59462C07A8E74ECD5E413125FEE703DF,41005,8,17,9,38,47,1947
69933,69933,59462C07A8E74ECD5E413125FEE703DF,11914,20,21,1,37,48,1898
69934,69934,BF9CF6077EC46F21B32EDA8DA552120B,11381,3,6,3,30,47,1547
69935,69935,BF9CF6077EC46F21B32EDA8DA552120B,11061,8,9,1,29,48,1498
69936,69936,BF9CF6077EC46F21B32EDA8DA552120B,11381,13,22,9,30,47,1547
69942,69942,C614ED68E8E88AC7D7918B9074DB2C33,43281,3,4,1,37,48,1898
69943,69943,C614ED68E8E88AC7D7918B9074DB2C33,10901,4,9,5,35,48,1798
69944,69944,C614ED68E8E88AC7D7918B9074DB2C33,40951,11,19,8,36,49,1849
69945,69945,C614ED68E8E88AC7D7918B9074DB2C33,10901,19,21,2,35,48,1798
69946,69946,3DA0BCC83518894F0CE5D638362ECC1B,43731,0,13,13,34,47,1747
69947,69947,3DA0BCC83518894F0CE5D638362ECC1B,42921,13,15,2,33,47,1697
69948,69948,3DA0BCC83518894F0CE5D638362ECC1B,10971,19,20,1,35,47,1797
69949,69949,99B16FDA7D58F6103FE34C1602E3BC68,11381,9,16,7,30,47,1547
69950,69950,99B16FDA7D58F6103FE34C1602E3BC68,42521,16,19,3,31,47,1597
69951,69951,99B16FDA7D58F6103FE34C1602E3BC68,13651,20,23,3,30,47,1547
69952,69952,FA05CF18A6BF06D3E5C89C49E2940179,11381,0,1,1,30,47,1547
69953,69953,FA05CF18A6BF06D3E5C89C49E2940179,11061,3,5,2,29,48,1498
69954,69954,FA05CF18A6BF06D3E5C89C49E2940179,11381,8,21,13,30,47,1547
69955,69955,E70BC232E8B1A5A1F2185A70B4D8F157,40242,0,8,8,36,49,1849
69956,69956,E70BC232E8B1A5A1F2185A70B4D8F157,10901,11,16,5,35,48,1798
69957,69957,E70BC232E8B1A5A1F2185A70B4D8F157,11954,17,20,3,32,49,1649
69958,69958,E70BC232E8B1A5A1F2185A70B4D8F157,40242,21,23,2,36,49,1849
69964,69964,DDD9E251C642BC497500777F72F3D3BA,42501,0,6,6,28,47,1447
69965,69965,DDD9E251C642BC497500777F72F3D3BA,10951,18,19,1,29,48,1498
69966,69966,DDD9E251C642BC497500777F72F3D3BA,42501,21,22,1,28,47,1447
69967,69967,FC3B8910035FE6AFFCEFAAF1A5BD46D7,10471,0,10,10,37,48,1898
69968,69968,FC3B8910035FE6AFFCEFAAF1A5BD46D7,42191,11,14,3,38,49,1949
69969,69969,FC3B8910035FE6AFFCEFAAF1A5BD46D7,10471,15,22,7,37,48,1898
69970,69970,3C5BF8354C7B22C00BFA5438C070BC0F,13711,0,8,8,38,46,1946
69971,69971,3C5BF8354C7B22C00BFA5438C070BC0F,43241,9,11,2,36,46,1846
69972,69972,3C5BF8354C7B22C00BFA5438C070BC0F,13711,12,22,10,38,46,1946
69973,69973,FF54487E0B5C80FA4088AB1638FB8194,42581,0,14,14,38,48,1948
69974,69974,FF54487E0B5C80FA4088AB1638FB8194,11914,15,19,4,37,48,1898
69975,69975,FF54487E0B5C80FA4088AB1638FB8194,42581,20,22,2,38,48,1948
69983,69983,C1FC141B35A6FDF2FC8F85E0E1339544,10251,0,17,17,35,47,1797
69984,69984,C1FC141B35A6FDF2FC8F85E0E1339544,11201,17,18,1,35,49,1799
69985,69985,C1FC141B35A6FDF2FC8F85E0E1339544,42161,19,23,4,36,47,1847
69986,69986,A635B3240AC7E811CFE6DB14281105C2,42981,9,11,2,36,49,1849
69987,69987,A635B3240AC7E811CFE6DB14281105C2,12481,14,15,1,37,49,1899
69988,69988,A635B3240AC7E811CFE6DB14281105C2,12401,18,19,1,39,49,1999
69989,69989,A635B3240AC7E811CFE6DB14281105C2,42981,22,23,1,36,49,1849
69990,69990,CEC2557E73B99D59943BE56AF1337C99,10271,0,11,11,37,46,1896
69991,69991,CEC2557E73B99D59943BE56AF1337C99,13121,14,15,1,38,46,1946
69992,69992,CEC2557E73B99D59943BE56AF1337C99,10271,16,17,1,37,46,1896
69993,69993,CEC2557E73B99D59943BE56AF1337C99,13121,18,19,1,38,46,1946
70002,70002,3C02B5838EDEAB0B15A337805B269A42,42321,6,10,4,43,47,2197
70003,70003,3C02B5838EDEAB0B15A337805B269A42,42601,10,11,1,44,48,2248
70004,70004,3C02B5838EDEAB0B15A337805B269A42,42321,12,18,6,43,47,2197
70005,70005,3C02B5838EDEAB0B15A337805B269A42,10601,19,22,3,39,47,1997
70009,70009,7B63B781AF1E5C1909C9ECFED6946980,42523,0,4,4,31,47,1597
70010,70010,7B63B781AF1E5C1909C9ECFED6946980,43761,5,7,2,32,47,1647
70011,70011,7B63B781AF1E5C1909C9ECFED6946980,42523,7,11,4,31,47,1597
70012,70012,7B63B781AF1E5C1909C9ECFED6946980,43761,11,21,10,32,47,1647
70013,70013,988754F4ACB1FFB14F8ADCC3660BA4EF,11261,6,13,7,36,46,1846
70014,70014,988754F4ACB1FFB14F8ADCC3660BA4EF,13911,14,17,3,39,46,1996
70015,70015,988754F4ACB1FFB14F8ADCC3660BA4EF,11261,18,22,4,36,46,1846
70016,70016,09F64A9A641B3F2B92615DE97B925264,12311,0,1,1,30,44,1544
70017,70017,09F64A9A641B3F2B92615DE97B925264,10634,6,7,1,27,45,1395
70018,70018,09F64A9A641B3F2B92615DE97B925264,10351,9,22,13,28,45,1445
70022,70022,B8DCAC0FC6FA981D871032E55C240C8E,42581,1,4,3,38,48,1948
70023,70023,B8DCAC0FC6FA981D871032E55C240C8E,11914,7,20,13,37,48,1898
70024,70024,B8DCAC0FC6FA981D871032E55C240C8E,42581,21,22,1,38,48,1948
70025,70025,DC736499F15CC90E33F3F344F148EB89,40833,2,10,8,41,47,2097
70026,70026,DC736499F15CC90E33F3F344F148EB89,10191,12,15,3,40,48,2048
70027,70027,DC736499F15CC90E33F3F344F148EB89,40833,16,23,7,41,47,2097
70028,70028,EA7259828C59286A0C8476F89AAE54B8,11261,6,13,7,36,46,1846
70029,70029,EA7259828C59286A0C8476F89AAE54B8,11731,14,16,2,36,48,1848
70030,70030,EA7259828C59286A0C8476F89AAE54B8,11261,17,18,1,36,46,1846
70035,70035,1DC3A3A4FE9D63C37AD1D2C313E3354F,42191,0,6,6,38,49,1949
70036,70036,1DC3A3A4FE9D63C37AD1D2C313E3354F,10471,8,18,10,37,48,1898
70037,70037,1DC3A3A4FE9D63C37AD1D2C313E3354F,13221,20,21,1,40,47,2047
70041,70041,20EBDF07FAB10C468662B7339874EF65,42271,1,2,1,40,47,2047
70042,70042,20EBDF07FAB10C468662B7339874EF65,11806,3,14,11,41,48,2098
70043,70043,20EBDF07FAB10C468662B7339874EF65,42271,16,20,4,40,47,2047
70051,70051,A22DFBA5E4832FBB5F7DAB44716A87D9,42491,0,7,7,32,46,1646
70052,70052,A22DFBA5E4832FBB5F7DAB44716A87D9,11324,8,9,1,31,46,1596
70053,70053,A22DFBA5E4832FBB5F7DAB44716A87D9,10251,11,23,12,35,47,1797
70061,70061,46D492BAB010922B2E00FA587B30756A,43951,0,15,15,49,41,2491
70062,70062,46D492BAB010922B2E00FA587B30756A,13411,18,20,2,49,42,2492
70063,70063,46D492BAB010922B2E00FA587B30756A,43951,20,22,2,49,41,2491
70064,70064,309C2EBD6881FB9505C9BCE9119A811B,11951,1,12,11,31,49,1599
70065,70065,309C2EBD6881FB9505C9BCE9119A811B,13731,15,17,2,33,49,1699
70066,70066,309C2EBD6881FB9505C9BCE9119A811B,11954,19,23,4,32,49,1649
70067,70067,C619BC39ADD64D285F289B032026DA59,11074,0,7,7,37,47,1897
70068,70068,C619BC39ADD64D285F289B032026DA59,10411,9,10,1,36,48,1848
70069,70069,C619BC39ADD64D285F289B032026DA59,11941,13,17,4,37,46,1896
70070,70070,C619BC39ADD64D285F289B032026DA59,11074,19,21,2,37,47,1897
70075,70075,9F2BAB521AAFFBE7CC97AED22DC2FAF1,11261,0,7,7,36,46,1846
70076,70076,9F2BAB521AAFFBE7CC97AED22DC2FAF1,42864,7,8,1,38,44,1944
70077,70077,9F2BAB521AAFFBE7CC97AED22DC2FAF1,11261,8,18,10,36,46,1846
70082,70082,1B79EB886A5576DB94A20A87F2358771,43751,0,13,13,19,48,998
70083,70083,1B79EB886A5576DB94A20A87F2358771,42481,14,16,2,22,49,1149
70084,70084,1B79EB886A5576DB94A20A87F2358771,43751,18,22,4,19,48,998
70085,70085,964156E683797EC321E31C806CD19178,11331,2,13,11,37,48,1898
70086,70086,964156E683797EC321E31C806CD19178,42581,14,17,3,38,48,1948
70087,70087,964156E683797EC321E31C806CD19178,11914,18,23,5,37,48,1898
70088,70088,E716DFCB27D2E8BF3D416B3DA1D9C640,10451,1,3,2,25,48,1298
70089,70089,E716DFCB27D2E8BF3D416B3DA1D9C640,12581,5,7,2,24,48,1248
70090,70090,E716DFCB27D2E8BF3D416B3DA1D9C640,11361,12,13,1,22,48,1148
70091,70091,E716DFCB27D2E8BF3D416B3DA1D9C640,10451,15,23,8,25,48,1298
70111,70111,7158BB5FE54F024DF86B9682428D7D80,42581,1,13,12,38,48,1948
70112,70112,7158BB5FE54F024DF86B9682428D7D80,10471,15,17,2,37,48,1898
70113,70113,7158BB5FE54F024DF86B9682428D7D80,42581,19,21,2,38,48,1948
70114,70114,B0895CC09AF6DDBFD1DAF6810DC05EB1,11491,2,7,5,36,47,1847
70115,70115,B0895CC09AF6DDBFD1DAF6810DC05EB1,10841,11,21,10,37,47,1897
70116,70116,B0895CC09AF6DDBFD1DAF6810DC05EB1,42301,22,23,1,36,47,1847
70135,70135,44A1B2095028F2B1D6198AB3D390B206,11061,0,9,9,29,48,1498
70136,70136,44A1B2095028F2B1D6198AB3D390B206,10681,10,14,4,30,48,1548
70137,70137,44A1B2095028F2B1D6198AB3D390B206,11061,18,22,4,29,48,1498
70150,70150,8901C834A10BBD863479FEA29CB07080,13911,0,5,5,39,46,1996
70151,70151,8901C834A10BBD863479FEA29CB07080,42351,9,11,2,38,45,1945
70152,70152,8901C834A10BBD863479FEA29CB07080,13911,14,16,2,39,46,1996
70153,70153,8901C834A10BBD863479FEA29CB07080,42351,20,23,3,38,45,1945
70171,70171,B8BEE4316240369D7D9EFEDD287F001E,43761,0,7,7,32,47,1647
70172,70172,B8BEE4316240369D7D9EFEDD287F001E,42021,8,10,2,33,47,1697
70173,70173,B8BEE4316240369D7D9EFEDD287F001E,11861,12,16,4,32,47,1647
70174,70174,B8BEE4316240369D7D9EFEDD287F001E,42921,18,23,5,33,47,1697
70187,70187,C9F84D3604FFDDEC89D1908F58D5CF7B,11901,0,8,8,42,49,2149
70188,70188,C9F84D3604FFDDEC89D1908F58D5CF7B,11301,12,13,1,41,49,2099
70189,70189,C9F84D3604FFDDEC89D1908F58D5CF7B,11521,18,19,1,41,48,2098
70190,70190,C9F84D3604FFDDEC89D1908F58D5CF7B,11901,19,21,2,42,49,2149
70202,70202,F62E406B53C8CDF6E3B5DA3DFCCC4ADB,10281,0,11,11,33,48,1698
70203,70203,F62E406B53C8CDF6E3B5DA3DFCCC4ADB,11861,11,17,6,32,47,1647
70204,70204,F62E406B53C8CDF6E3B5DA3DFCCC4ADB,42021,20,22,2,33,47,1697
70205,70205,75B6D91479467607B0BA166BDAF35CA1,10431,0,19,19,33,49,1699
70206,70206,75B6D91479467607B0BA166BDAF35CA1,11211,20,21,1,34,49,1749
70207,70207,75B6D91479467607B0BA166BDAF35CA1,10431,21,23,2,33,49,1699
70230,70230,245DE714507382DDB0203A65927397CC,40124,0,10,10,38,47,1947
70231,70231,245DE714507382DDB0203A65927397CC,13121,10,11,1,38,46,1946
70232,70232,245DE714507382DDB0203A65927397CC,13681,13,19,6,38,47,1947
70233,70233,59843945AAE93CCE82D76071D50875F9,10634,1,16,15,27,45,1395
70234,70234,59843945AAE93CCE82D76071D50875F9,10351,18,20,2,28,45,1445
70235,70235,59843945AAE93CCE82D76071D50875F9,10634,21,23,2,27,45,1395
70249,70249,2F3FBE39EE4E3AB748593134D6A2A772,42231,0,14,14,37,46,1896
70250,70250,2F3FBE39EE4E3AB748593134D6A2A772,42351,15,17,2,38,45,1945
70251,70251,2F3FBE39EE4E3AB748593134D6A2A772,42231,20,23,3,37,46,1896
70257,70257,C7E598BFED6FB574843E537970B28C08,11151,0,12,12,30,48,1548
70258,70258,C7E598BFED6FB574843E537970B28C08,43391,15,19,4,29,48,1498
70259,70259,C7E598BFED6FB574843E537970B28C08,11151,21,23,2,30,48,1548
70266,70266,B1891B03CB53C325B13F0CF9131A1E17,12921,3,10,7,9,41,491
70267,70267,B1891B03CB53C325B13F0CF9131A1E17,12641,11,16,5,10,43,543
70268,70268,B1891B03CB53C325B13F0CF9131A1E17,12921,20,21,1,9,41,491
70269,70269,DFFD8263F8D171E98D9F6788AFF5A2A7,42271,0,1,1,40,47,2047
70270,70270,DFFD8263F8D171E98D9F6788AFF5A2A7,42221,1,9,8,38,48,1948
70271,70271,DFFD8263F8D171E98D9F6788AFF5A2A7,42271,9,14,5,40,47,2047
70272,70272,DFFD8263F8D171E98D9F6788AFF5A2A7,13381,21,23,2,39,47,1997
70280,70280,EB24244BB73BD551F4B0247AA2F1F50A,12381,0,8,8,32,48,1648
70281,70281,EB24244BB73BD551F4B0247AA2F1F50A,10221,8,17,9,34,49,1749
70282,70282,EB24244BB73BD551F4B0247AA2F1F50A,12381,21,23,2,32,48,1648
70306,70306,50AA1262E2A8C18D2F0FC1A87B60622A,40637,1,11,10,36,47,1847
70307,70307,50AA1262E2A8C18D2F0FC1A87B60622A,10251,14,17,3,35,47,1797
70308,70308,50AA1262E2A8C18D2F0FC1A87B60622A,10491,17,19,2,33,48,1698
70309,70309,50AA1262E2A8C18D2F0FC1A87B60622A,11731,20,21,1,36,48,1848
70310,70310,7DFA80A640E4E70D2A652D6744180BCD,13711,0,8,8,38,46,1946
70311,70311,7DFA80A640E4E70D2A652D6744180BCD,11941,8,10,2,37,46,1896
70312,70312,7DFA80A640E4E70D2A652D6744180BCD,13711,14,18,4,38,46,1946
70313,70313,7DFA80A640E4E70D2A652D6744180BCD,42011,20,23,3,36,46,1846
70314,70314,642C5FCC730BC5A54E2036C81E432BC6,19114,2,9,7,7,43,393
70315,70315,642C5FCC730BC5A54E2036C81E432BC6,12641,14,16,2,10,43,543
70316,70316,642C5FCC730BC5A54E2036C81E432BC6,19114,17,23,6,7,43,393
70317,70317,E05F67959FE0060F5DAD596617CE48BB,12921,1,6,5,9,41,491
70318,70318,E05F67959FE0060F5DAD596617CE48BB,49201,7,9,2,7,41,391
70319,70319,E05F67959FE0060F5DAD596617CE48BB,12921,9,10,1,9,41,491
70320,70320,E05F67959FE0060F5DAD596617CE48BB,49201,11,20,9,7,41,391
70321,70321,03222274E26820FAE1292162805A3E4D,10841,1,3,2,37,47,1897
70322,70322,03222274E26820FAE1292162805A3E4D,12514,4,6,2,38,47,1947
70323,70323,03222274E26820FAE1292162805A3E4D,10841,6,23,17,37,47,1897
70329,70329,186C53DFEB9AF6842333AF2D842F95B0,10471,1,12,11,37,48,1898
70330,70330,186C53DFEB9AF6842333AF2D842F95B0,13511,12,13,1,34,48,1748
70331,70331,186C53DFEB9AF6842333AF2D842F95B0,10471,13,23,10,37,48,1898
70332,70332,2873DE93703B028193B7B9719DCFE691,12521,0,7,7,35,41,1791
70333,70333,2873DE93703B028193B7B9719DCFE691,43451,7,11,4,37,40,1890
70334,70334,2873DE93703B028193B7B9719DCFE691,12521,11,23,12,35,41,1791
70351,70351,75D26EF2979B76AF3B88B994D0C67B7D,10811,0,8,8,38,46,1946
70352,70352,75D26EF2979B76AF3B88B994D0C67B7D,42231,12,14,2,37,46,1896
70353,70353,75D26EF2979B76AF3B88B994D0C67B7D,11261,14,18,4,36,46,1846
70354,70354,F4C7290798862F6B2ED53B8936E4B945,19021,0,15,15,10,45,545
70355,70355,F4C7290798862F6B2ED53B8936E4B945,12641,18,20,2,10,43,543
70356,70356,F4C7290798862F6B2ED53B8936E4B945,19021,20,23,3,10,45,545
70365,70365,7FD9072832AAE29AE2915CDEF233B942,42321,0,6,6,43,47,2197
70366,70366,7FD9072832AAE29AE2915CDEF233B942,10801,6,15,9,42,47,2147
70367,70367,7FD9072832AAE29AE2915CDEF233B942,42321,18,19,1,43,47,2197
70368,70368,7FD9072832AAE29AE2915CDEF233B942,10801,22,23,1,42,47,2147
70369,70369,C58858487A094FE533AB3B2C1388EAF8,11131,0,9,9,33,48,1698
70370,70370,C58858487A094FE533AB3B2C1388EAF8,42161,11,12,1,36,47,1847
70371,70371,C58858487A094FE533AB3B2C1388EAF8,43731,14,16,2,34,47,1747
70372,70372,C58858487A094FE533AB3B2C1388EAF8,11131,19,20,1,33,48,1698
70373,70373,72EE059838FC074BF0955787969E7967,11231,0,3,3,37,49,1899
70374,70374,72EE059838FC074BF0955787969E7967,11911,4,19,15,37,48,1898
70375,70375,72EE059838FC074BF0955787969E7967,11231,20,23,3,37,49,1899
70385,70385,8167EF05D15F996A6B93D96BD3E78468,11001,3,12,9,42,47,2147
70386,70386,8167EF05D15F996A6B93D96BD3E78468,43481,12,13,1,39,48,1998
70387,70387,8167EF05D15F996A6B93D96BD3E78468,12514,13,21,8,38,47,1947
70388,70388,91284BBE72A4661BF1E53E3FAFD2E3D8,10292,0,17,17,30,47,1547
70389,70389,91284BBE72A4661BF1E53E3FAFD2E3D8,42523,18,19,1,31,47,1597
70390,70390,91284BBE72A4661BF1E53E3FAFD2E3D8,13651,20,22,2,30,47,1547
70394,70394,DD7D3569C4BD229FB79C93D9EAD10504,43311,0,8,8,31,48,1598
70395,70395,DD7D3569C4BD229FB79C93D9EAD10504,12381,9,11,2,32,48,1648
70396,70396,DD7D3569C4BD229FB79C93D9EAD10504,43311,13,23,10,31,48,1598
70397,70397,F626495227975BB47CEFB095B49D9899,42191,0,3,3,38,49,1949
70398,70398,F626495227975BB47CEFB095B49D9899,42583,4,15,11,40,48,2048
70399,70399,F626495227975BB47CEFB095B49D9899,43281,17,23,6,37,48,1898
70416,70416,5566DF9556BCD612F8500FB496AD53B3,11861,6,7,1,32,47,1647
70417,70417,5566DF9556BCD612F8500FB496AD53B3,11384,10,11,1,30,47,1547
70418,70418,5566DF9556BCD612F8500FB496AD53B3,11861,11,23,12,32,47,1647
70419,70419,CA97860E169EF6BD9C09A713FA0CC7D2,42161,0,2,2,36,47,1847
70420,70420,CA97860E169EF6BD9C09A713FA0CC7D2,13221,2,14,12,40,47,2047
70421,70421,CA97860E169EF6BD9C09A713FA0CC7D2,12514,14,19,5,38,47,1947
70422,70422,CA97860E169EF6BD9C09A713FA0CC7D2,13221,19,23,4,40,47,2047
70423,70423,8E0D20320C5276BDD797BA6D65B9C51D,11074,0,7,7,37,47,1897
70424,70424,8E0D20320C5276BDD797BA6D65B9C51D,11231,10,15,5,37,49,1899
70425,70425,8E0D20320C5276BDD797BA6D65B9C51D,12083,16,17,1,36,49,1849
70426,70426,8E0D20320C5276BDD797BA6D65B9C51D,11074,19,23,4,37,47,1897
70447,70447,5D3AB87CDE152EA5E956E4DDC06AC59B,10471,2,10,8,37,48,1898
70448,70448,5D3AB87CDE152EA5E956E4DDC06AC59B,42581,10,13,3,38,48,1948
70449,70449,5D3AB87CDE152EA5E956E4DDC06AC59B,10471,15,23,8,37,48,1898
70450,70450,865E5CB1456F308CBB7E1E02D160E493,12491,0,5,5,36,43,1843
70451,70451,865E5CB1456F308CBB7E1E02D160E493,42861,6,8,2,37,44,1894
70452,70452,865E5CB1456F308CBB7E1E02D160E493,11261,11,12,1,36,46,1846
70453,70453,865E5CB1456F308CBB7E1E02D160E493,42861,13,18,5,37,44,1894
70457,70457,C35D795DA33BE0311413852FD4760F3A,11261,0,6,6,36,46,1846
70458,70458,C35D795DA33BE0311413852FD4760F3A,42151,8,9,1,35,45,1795
70459,70459,C35D795DA33BE0311413852FD4760F3A,11261,11,18,7,36,46,1846
70460,70460,C35D795DA33BE0311413852FD4760F3A,13711,20,21,1,38,46,1946
70466,70466,DA48F6EEC4784B4505CA1BBB58EA121A,10341,0,2,2,31,47,1597
70467,70467,DA48F6EEC4784B4505CA1BBB58EA121A,10292,3,18,15,30,47,1547
70468,70468,DA48F6EEC4784B4505CA1BBB58EA121A,10341,18,21,3,31,47,1597
70469,70469,325B301C16FB3DB9C4CED544F7B2E787,10471,9,14,5,37,48,1898
70470,70470,325B301C16FB3DB9C4CED544F7B2E787,11811,15,16,1,38,49,1949
70471,70471,325B301C16FB3DB9C4CED544F7B2E787,10471,18,19,1,37,48,1898
70472,70472,325B301C16FB3DB9C4CED544F7B2E787,10661,22,23,1,37,49,1899
70483,70483,71CDB42BF8ABF4C8B89BDC81F92C39B7,10634,0,14,14,27,45,1395
70484,70484,71CDB42BF8ABF4C8B89BDC81F92C39B7,12601,15,17,2,25,47,1297
70485,70485,71CDB42BF8ABF4C8B89BDC81F92C39B7,10634,21,23,2,27,45,1395
70493,70493,97E4702F624CE098E267C7767A3602E0,12131,3,8,5,32,47,1647
70494,70494,97E4702F624CE098E267C7767A3602E0,11061,13,14,1,29,48,1498
70495,70495,97E4702F624CE098E267C7767A3602E0,12131,16,17,1,32,47,1647
70496,70496,97E4702F624CE098E267C7767A3602E0,11061,18,19,1,29,48,1498
70497,70497,25DF23F398DD0B4C6CED78808A57A933,11091,0,8,8,29,47,1497
70498,70498,25DF23F398DD0B4C6CED78808A57A933,10292,9,17,8,30,47,1547
70499,70499,25DF23F398DD0B4C6CED78808A57A933,11091,19,23,4,29,47,1497
70503,70503,ED329B71006D1766A598ADE6F5BD2F71,11321,0,13,13,31,46,1596
70504,70504,ED329B71006D1766A598ADE6F5BD2F71,12311,14,15,1,30,44,1544
70505,70505,ED329B71006D1766A598ADE6F5BD2F71,11321,19,23,4,31,46,1596
70506,70506,4A7DB4C98C495CBE39929E4AF5856114,11521,0,1,1,41,48,2098
70507,70507,4A7DB4C98C495CBE39929E4AF5856114,11271,1,15,14,37,48,1898
70508,70508,4A7DB4C98C495CBE39929E4AF5856114,11521,19,23,4,41,48,2098
70521,70521,30F94368F131A73FAC48CF4BAF636AD7,42161,0,7,7,36,47,1847
70522,70522,30F94368F131A73FAC48CF4BAF636AD7,13681,7,18,11,38,47,1947
70523,70523,30F94368F131A73FAC48CF4BAF636AD7,42161,18,23,5,36,47,1847
70529,70529,5D0D5B789243C6ED439BA2D47BED37ED,11081,0,16,16,35,46,1796
70530,70530,5D0D5B789243C6ED439BA2D47BED37ED,10731,16,17,1,33,47,1697
70531,70531,5D0D5B789243C6ED439BA2D47BED37ED,10841,20,22,2,37,47,1897
70532,70532,7AEC96944ABDE836F2A5F23132A96D0B,42511,0,7,7,37,47,1897
70533,70533,7AEC96944ABDE836F2A5F23132A96D0B,42301,9,10,1,36,47,1847
70534,70534,7AEC96944ABDE836F2A5F23132A96D0B,10841,12,23,11,37,47,1897
70535,70535,12CD49247659842CCDEA8C017DBD960B,42461,3,4,1,45,47,2297
70536,70536,12CD49247659842CCDEA8C017DBD960B,13471,6,16,10,47,49,2399
70537,70537,12CD49247659842CCDEA8C017DBD960B,11701,20,23,3,43,48,2198
70548,70548,0369BFD5F10C91495A6A2CBDCDE954D4,12311,1,6,5,30,44,1544
70549,70549,0369BFD5F10C91495A6A2CBDCDE954D4,42531,10,20,10,31,45,1595
70550,70550,0369BFD5F10C91495A6A2CBDCDE954D4,12311,20,22,2,30,44,1544
70555,70555,582FCEF67ED9C80E5B2E8667690F61FB,42221,0,7,7,38,48,1948
70556,70556,582FCEF67ED9C80E5B2E8667690F61FB,42401,8,13,5,36,47,1847
70557,70557,582FCEF67ED9C80E5B2E8667690F61FB,42221,13,15,2,38,48,1948
70558,70558,582FCEF67ED9C80E5B2E8667690F61FB,42401,16,22,6,36,47,1847
70559,70559,2AF43C5AD18802056DDB97F11B48E696,13681,3,4,1,38,47,1947
70560,70560,2AF43C5AD18802056DDB97F11B48E696,42511,5,8,3,37,47,1897
70561,70561,2AF43C5AD18802056DDB97F11B48E696,13331,9,13,4,38,47,1947
70562,70562,2AF43C5AD18802056DDB97F11B48E696,42511,13,18,5,37,47,1897
70574,70574,886E2D7F4784182ED324B3C76B8399C9,11361,1,2,1,22,48,1148
70575,70575,886E2D7F4784182ED324B3C76B8399C9,12051,4,5,1,20,47,1047
70576,70576,886E2D7F4784182ED324B3C76B8399C9,42681,5,21,16,24,48,1248
70594,70594,78C0E1E992CFF9ECB9C6D46D3E929FD4,12121,0,6,6,29,47,1497
70595,70595,78C0E1E992CFF9ECB9C6D46D3E929FD4,10951,9,11,2,29,48,1498
70596,70596,78C0E1E992CFF9ECB9C6D46D3E929FD4,11381,12,15,3,30,47,1547
70597,70597,78C0E1E992CFF9ECB9C6D46D3E929FD4,12121,16,19,3,29,47,1497
70602,70602,535378523E09141D94880FBA59BB7297,42941,0,8,8,37,47,1897
70603,70603,535378523E09141D94880FBA59BB7297,42301,9,18,9,36,47,1847
70604,70604,535378523E09141D94880FBA59BB7297,10111,21,23,2,37,47,1897
70616,70616,7C5210855A5DFB6ACF7A087ADA0E2F3D,13911,1,2,1,39,46,1996
70617,70617,7C5210855A5DFB6ACF7A087ADA0E2F3D,42231,5,7,2,37,46,1896
70618,70618,7C5210855A5DFB6ACF7A087ADA0E2F3D,13911,12,13,1,39,46,1996
70619,70619,7C5210855A5DFB6ACF7A087ADA0E2F3D,42231,14,20,6,37,46,1896
70620,70620,6D32D294FD3EFA3EA9B83766794547B4,42523,2,3,1,31,47,1597
70621,70621,6D32D294FD3EFA3EA9B83766794547B4,43761,5,7,2,32,47,1647
70622,70622,6D32D294FD3EFA3EA9B83766794547B4,42523,7,19,12,31,47,1597
70623,70623,6D32D294FD3EFA3EA9B83766794547B4,43761,19,22,3,32,47,1647
70632,70632,4E4FA3262DF5F7B6F1852C92067A0539,11875,0,13,13,30,46,1546
70633,70633,4E4FA3262DF5F7B6F1852C92067A0539,42871,14,15,1,30,45,1545
70634,70634,4E4FA3262DF5F7B6F1852C92067A0539,11875,19,23,4,30,46,1546
70640,70640,5C96E9B05EB3EFE9DE3B43368A9F3BB9,42401,0,8,8,36,47,1847
70641,70641,5C96E9B05EB3EFE9DE3B43368A9F3BB9,10161,9,16,7,35,49,1799
70642,70642,5C96E9B05EB3EFE9DE3B43368A9F3BB9,10251,20,23,3,35,47,1797
70643,70643,829F3CF969A99106A0CF5C6D0ED0FE14,42401,0,8,8,36,47,1847
70644,70644,829F3CF969A99106A0CF5C6D0ED0FE14,11751,10,16,6,35,48,1798
70645,70645,829F3CF969A99106A0CF5C6D0ED0FE14,42401,16,23,7,36,47,1847
70654,70654,EBE74CAA370851CCC599E73574A1082B,11074,4,5,1,37,47,1897
70655,70655,EBE74CAA370851CCC599E73574A1082B,42221,6,7,1,38,48,1948
70656,70656,EBE74CAA370851CCC599E73574A1082B,11074,8,11,3,37,47,1897
70657,70657,EBE74CAA370851CCC599E73574A1082B,42221,15,23,8,38,48,1948
70671,70671,4AEBF51A81E0ED548D9C5ED105DCD62A,10471,0,16,16,37,48,1898
70672,70672,4AEBF51A81E0ED548D9C5ED105DCD62A,10107,17,18,1,38,49,1949
70673,70673,4AEBF51A81E0ED548D9C5ED105DCD62A,10471,19,22,3,37,48,1898
70687,70687,5AF85D9ED958D0E5348613692DAC5B4D,43581,1,3,2,33,48,1698
70688,70688,5AF85D9ED958D0E5348613692DAC5B4D,12083,3,14,11,36,49,1849
70689,70689,5AF85D9ED958D0E5348613692DAC5B4D,40571,16,20,4,35,48,1798
70694,70694,E24F34B965BE1054DCE4AF1C1CD48137,42921,3,8,5,33,47,1697
70695,70695,E24F34B965BE1054DCE4AF1C1CD48137,11875,9,20,11,30,46,1546
70696,70696,E24F34B965BE1054DCE4AF1C1CD48137,42021,20,23,3,33,47,1697
70705,70705,64812FF1B8835C5669BB93C0D5307414,11231,0,8,8,37,49,1899
70706,70706,64812FF1B8835C5669BB93C0D5307414,40203,9,11,2,33,49,1699
70707,70707,64812FF1B8835C5669BB93C0D5307414,11231,12,23,11,37,49,1899
70708,70708,558A6887C0D5899B43E75BBD844A7C64,42461,0,5,5,45,47,2297
70709,70709,558A6887C0D5899B43E75BBD844A7C64,42321,6,15,9,43,47,2197
70710,70710,558A6887C0D5899B43E75BBD844A7C64,11701,16,17,1,43,48,2198
70711,70711,558A6887C0D5899B43E75BBD844A7C64,42321,21,22,1,43,47,2197
70731,70731,FB55907415A7C0538398712A9BE0B78E,42151,9,10,1,35,45,1795
70732,70732,FB55907415A7C0538398712A9BE0B78E,12661,12,13,1,32,45,1645
70733,70733,FB55907415A7C0538398712A9BE0B78E,42861,15,18,3,37,44,1894
70770,70770,BD8CAD24421DB26887D85E96D51CCDAC,42511,1,16,15,37,47,1897
70771,70771,BD8CAD24421DB26887D85E96D51CCDAC,12514,16,17,1,38,47,1947
70772,70772,BD8CAD24421DB26887D85E96D51CCDAC,12511,17,19,2,39,47,1997
70773,70773,BD8CAD24421DB26887D85E96D51CCDAC,12514,20,21,1,38,47,1947
70779,70779,B93C16A242FE2C6BDA83A87AD4FAA434,10501,0,1,1,22,46,1146
70780,70780,B93C16A242FE2C6BDA83A87AD4FAA434,12601,1,20,19,25,47,1297
70781,70781,B93C16A242FE2C6BDA83A87AD4FAA434,10501,20,22,2,22,46,1146
70782,70782,B93C16A242FE2C6BDA83A87AD4FAA434,12601,22,23,1,25,47,1297
70789,70789,90AEF58BB4CABDF543DA1FFF777671DC,11381,0,15,15,30,47,1547
70790,70790,90AEF58BB4CABDF543DA1FFF777671DC,42521,18,19,1,31,47,1597
70791,70791,90AEF58BB4CABDF543DA1FFF777671DC,13651,21,23,2,30,47,1547
70802,70802,C3385B266A5088A7FA48BCC62DFDD003,11914,2,11,9,37,48,1898
70803,70803,C3385B266A5088A7FA48BCC62DFDD003,43181,13,14,1,39,48,1998
70804,70804,C3385B266A5088A7FA48BCC62DFDD003,11914,16,23,7,37,48,1898
70805,70805,066E3B290AAC556F650E56DD0F693AB2,10191,0,8,8,40,48,2048
70806,70806,066E3B290AAC556F650E56DD0F693AB2,12841,9,11,2,37,47,1897
70807,70807,066E3B290AAC556F650E56DD0F693AB2,11331,13,15,2,37,48,1898
70808,70808,066E3B290AAC556F650E56DD0F693AB2,10191,22,23,1,40,48,2048
70813,70813,BD1184AE2BD3FECE6F11C86B57441048,10881,0,9,9,34,48,1748
70814,70814,BD1184AE2BD3FECE6F11C86B57441048,40961,11,13,2,35,47,1797
70815,70815,BD1184AE2BD3FECE6F11C86B57441048,10881,13,23,10,34,48,1748
70821,70821,8884870431ED537B3D06301C04C58F0C,11061,0,6,6,29,48,1498
70822,70822,8884870431ED537B3D06301C04C58F0C,11381,8,15,7,30,47,1547
70823,70823,8884870431ED537B3D06301C04C58F0C,11061,16,22,6,29,48,1498
70846,70846,868D62D07021FFB7BE9F078FE4596C54,11731,0,14,14,36,48,1848
70847,70847,868D62D07021FFB7BE9F078FE4596C54,42151,17,18,1,35,45,1795
70848,70848,868D62D07021FFB7BE9F078FE4596C54,12083,19,23,4,36,49,1849
70854,70854,5DC656AE1F755A21D4CE0049D29039D4,12491,0,6,6,36,43,1843
70855,70855,5DC656AE1F755A21D4CE0049D29039D4,11261,7,18,11,36,46,1846
70856,70856,5DC656AE1F755A21D4CE0049D29039D4,43451,19,21,2,37,40,1890
70862,70862,AD80504C582924B0A41D23D61B63A4C4,12391,0,7,7,36,49,1849
70863,70863,AD80504C582924B0A41D23D61B63A4C4,10221,7,14,7,34,49,1749
70864,70864,AD80504C582924B0A41D23D61B63A4C4,12083,15,16,1,36,49,1849
70865,70865,AD80504C582924B0A41D23D61B63A4C4,10221,16,20,4,34,49,1749
70866,70866,7E6ABF38A691D9304A64197B5968007E,42461,0,5,5,45,47,2297
70867,70867,7E6ABF38A691D9304A64197B5968007E,42321,7,16,9,43,47,2197
70868,70868,7E6ABF38A691D9304A64197B5968007E,42461,19,20,1,45,47,2297
70869,70869,7D5000772E957DD3A483CE8963A15A13,12121,0,11,11,29,47,1497
70870,70870,7D5000772E957DD3A483CE8963A15A13,11381,11,16,5,30,47,1547
70871,70871,7D5000772E957DD3A483CE8963A15A13,12121,17,23,6,29,47,1497
70898,70898,9DB2D1D0B4A24CCB14E8E155246D6FB0,42941,3,5,2,37,47,1897
70899,70899,9DB2D1D0B4A24CCB14E8E155246D6FB0,11261,9,20,11,36,46,1846
70900,70900,9DB2D1D0B4A24CCB14E8E155246D6FB0,10111,20,21,1,37,47,1897
70912,70912,4E3465C68A2108EC91D70A46342271D7,42271,5,8,3,40,47,2047
70913,70913,4E3465C68A2108EC91D70A46342271D7,12401,12,14,2,39,49,1999
70914,70914,4E3465C68A2108EC91D70A46342271D7,42271,17,18,1,40,47,2047
70915,70915,780CF605B987CE4335E0B64DFA86ACBF,12514,0,13,13,38,47,1947
70916,70916,780CF605B987CE4335E0B64DFA86ACBF,11921,15,16,1,38,48,1948
70917,70917,780CF605B987CE4335E0B64DFA86ACBF,12514,19,23,4,38,47,1947
70921,70921,1C752316BF3BA3B641D891EF9B0BCA45,43241,1,2,1,36,46,1846
70922,70922,1C752316BF3BA3B641D891EF9B0BCA45,10271,5,15,10,37,46,1896
70923,70923,1C752316BF3BA3B641D891EF9B0BCA45,13711,16,21,5,38,46,1946
70924,70924,8D86E284D185DE22084CD86C6BFE1A08,11875,0,13,13,30,46,1546
70925,70925,8D86E284D185DE22084CD86C6BFE1A08,12311,14,16,2,30,44,1544
70926,70926,8D86E284D185DE22084CD86C6BFE1A08,11875,18,23,5,30,46,1546
70936,70936,8827A35309A216F0F6E4CBB2FFAC456D,11954,0,13,13,32,49,1649
70937,70937,8827A35309A216F0F6E4CBB2FFAC456D,11021,16,19,3,36,49,1849
70938,70938,8827A35309A216F0F6E4CBB2FFAC456D,11751,19,23,4,35,48,1798
70939,70939,BA6B53E72E1DFE416976DEB6D96DF135,13101,0,12,12,40,47,2047
70940,70940,BA6B53E72E1DFE416976DEB6D96DF135,11481,16,18,2,41,48,2098
70941,70941,BA6B53E72E1DFE416976DEB6D96DF135,40833,20,22,2,41,47,2097
70964,70964,E5F35E9A8E7D375E3C2447F3147B8E3F,42523,0,17,17,31,47,1597
70965,70965,E5F35E9A8E7D375E3C2447F3147B8E3F,10292,18,19,1,30,47,1547
70966,70966,E5F35E9A8E7D375E3C2447F3147B8E3F,42523,20,21,1,31,47,1597
70970,70970,422DDC348F4AAA002A648FA0F6118A74,43761,3,11,8,32,47,1647
70971,70971,422DDC348F4AAA002A648FA0F6118A74,11161,11,13,2,32,48,1648
70972,70972,422DDC348F4AAA002A648FA0F6118A74,43311,15,16,1,31,48,1598
70973,70973,422DDC348F4AAA002A648FA0F6118A74,43761,17,19,2,32,47,1647
70974,70974,FCA3C665B5BF337F331669EDB597A6AC,42791,0,7,7,35,45,1795
70975,70975,FCA3C665B5BF337F331669EDB597A6AC,10271,8,15,7,37,46,1896
70976,70976,FCA3C665B5BF337F331669EDB597A6AC,13121,15,18,3,38,46,1946
70977,70977,D5C29F54FD64D9CE1AEFE2D9CA4F33A5,13101,0,8,8,40,47,2047
70978,70978,D5C29F54FD64D9CE1AEFE2D9CA4F33A5,40833,10,14,4,41,47,2097
70979,70979,D5C29F54FD64D9CE1AEFE2D9CA4F33A5,13101,15,18,3,40,47,2047
70983,70983,170A0AC014DC9BA930EAA0E56A2C9D03,42321,0,6,6,43,47,2197
70984,70984,170A0AC014DC9BA930EAA0E56A2C9D03,42601,8,12,4,44,48,2248
70985,70985,170A0AC014DC9BA930EAA0E56A2C9D03,11701,16,19,3,43,48,2198
70999,70999,806223F4E6A75E30DD9FB8BC0E922847,11061,0,5,5,29,48,1498
71000,71000,806223F4E6A75E30DD9FB8BC0E922847,11151,5,10,5,30,48,1548
71001,71001,806223F4E6A75E30DD9FB8BC0E922847,11061,14,22,8,29,48,1498
71015,71015,FB78BA035409FF816D7E7985C2AAAB1F,11541,0,9,9,35,49,1799
71016,71016,FB78BA035409FF816D7E7985C2AAAB1F,11531,13,16,3,34,49,1749
71017,71017,FB78BA035409FF816D7E7985C2AAAB1F,10491,18,22,4,33,48,1698
71025,71025,466C8E68F8DF7A16167889D27D9ECD99,11541,0,6,6,35,49,1799
71026,71026,466C8E68F8DF7A16167889D27D9ECD99,11021,10,12,2,36,49,1849
71027,71027,466C8E68F8DF7A16167889D27D9ECD99,11541,19,23,4,35,49,1799
71049,71049,AFE3E13A262FF0C971D22242D6F234F0,42141,0,13,13,32,47,1647
71050,71050,AFE3E13A262FF0C971D22242D6F234F0,12161,14,17,3,32,46,1646
71051,71051,AFE3E13A262FF0C971D22242D6F234F0,11861,19,23,4,32,47,1647
71062,71062,50CCE154C32A1BD191B98F8DDB956DFF,19051,0,7,7,16,23,823
71063,71063,50CCE154C32A1BD191B98F8DDB956DFF,15371,10,13,3,15,22,772
71064,71064,50CCE154C32A1BD191B98F8DDB956DFF,19051,17,23,6,16,23,823
71077,71077,0CE1530259EA66797A9FEEF237D2664E,42861,0,3,3,37,44,1894
71078,71078,0CE1530259EA66797A9FEEF237D2664E,11261,5,8,3,36,46,1846
71079,71079,0CE1530259EA66797A9FEEF237D2664E,42861,12,21,9,37,44,1894
71080,71080,99165E654E4A5840EA37FC83361CE61B,42581,0,13,13,38,48,1948
71081,71081,99165E654E4A5840EA37FC83361CE61B,11914,14,16,2,37,48,1898
71082,71082,99165E654E4A5840EA37FC83361CE61B,42581,21,22,1,38,48,1948
71086,71086,C8EB41C6B7152CD714709DA811B3B245,10681,0,8,8,30,48,1548
71087,71087,C8EB41C6B7152CD714709DA811B3B245,11061,8,21,13,29,48,1498
71088,71088,C8EB41C6B7152CD714709DA811B3B245,10681,21,23,2,30,48,1548
71095,71095,3CF7B0916CDE9473EE3871FE908999F3,19901,3,5,2,7,44,394
71096,71096,3CF7B0916CDE9473EE3871FE908999F3,19114,8,18,10,7,43,393
71097,71097,3CF7B0916CDE9473EE3871FE908999F3,19901,19,20,1,7,44,394
71108,71108,7ACF5BE37950C437957C71F0618967B5,10111,0,9,9,37,47,1897
71109,71109,7ACF5BE37950C437957C71F0618967B5,42401,10,11,1,36,47,1847
71110,71110,7ACF5BE37950C437957C71F0618967B5,10111,11,23,12,37,47,1897
71119,71119,F1AA6F3E940CBB9FB719C98F8431D25C,19901,0,6,6,7,44,394
71120,71120,F1AA6F3E940CBB9FB719C98F8431D25C,12641,8,10,2,10,43,543
71121,71121,F1AA6F3E940CBB9FB719C98F8431D25C,19901,12,23,11,7,44,394
71122,71122,B3E3F7F4BB39DF4D783E592F9F0BB965,11861,0,3,3,32,47,1647
71123,71123,B3E3F7F4BB39DF4D783E592F9F0BB965,10281,3,7,4,33,48,1698
71124,71124,B3E3F7F4BB39DF4D783E592F9F0BB965,43731,10,11,1,34,47,1747
71125,71125,B3E3F7F4BB39DF4D783E592F9F0BB965,10281,18,23,5,33,48,1698
71126,71126,4EABE655BE26B3EDCCD7B6B2C89F187F,10161,0,6,6,35,49,1799
71127,71127,4EABE655BE26B3EDCCD7B6B2C89F187F,11021,7,13,6,36,49,1849
71128,71128,4EABE655BE26B3EDCCD7B6B2C89F187F,10161,17,23,6,35,49,1799
71137,71137,27E5652E2BA40D37FBD9A0AA720456AC,43241,8,9,1,36,46,1846
71138,71138,27E5652E2BA40D37FBD9A0AA720456AC,13121,10,17,7,38,46,1946
71139,71139,27E5652E2BA40D37FBD9A0AA720456AC,43241,19,22,3,36,46,1846
71140,71140,C8AE21C26108F7AFBD515ED916A6E09A,42511,0,2,2,37,47,1897
71141,71141,C8AE21C26108F7AFBD515ED916A6E09A,12514,2,5,3,38,47,1947
71142,71142,C8AE21C26108F7AFBD515ED916A6E09A,10841,8,22,14,37,47,1897
71143,71143,DE3E54BB176520C8599DB39C6B8B34A3,13491,0,12,12,48,39,2439
71144,71144,DE3E54BB176520C8599DB39C6B8B34A3,43101,13,15,2,46,40,2340
71145,71145,DE3E54BB176520C8599DB39C6B8B34A3,13491,16,22,6,48,39,2439
71146,71146,1BE4AA4992469C65F84E3B75B4A845BE,11381,0,8,8,30,47,1547
71147,71147,1BE4AA4992469C65F84E3B75B4A845BE,11061,8,11,3,29,48,1498
71148,71148,1BE4AA4992469C65F84E3B75B4A845BE,13651,11,22,11,30,47,1547
71155,71155,5D20910F370368DA9B7807A8789204C0,19901,0,6,6,7,44,394
71156,71156,5D20910F370368DA9B7807A8789204C0,12641,7,17,10,10,43,543
71157,71157,5D20910F370368DA9B7807A8789204C0,19901,19,23,4,7,44,394
71164,71164,2B0CA41A785055CFB020D209DB1F6390,42161,0,10,10,36,47,1847
71165,71165,2B0CA41A785055CFB020D209DB1F6390,42221,12,15,3,38,48,1948
71166,71166,2B0CA41A785055CFB020D209DB1F6390,10111,20,21,1,37,47,1897
71167,71167,4C8E92DBB85921608C1C92929A7A8C92,42521,0,13,13,31,47,1597
71168,71168,4C8E92DBB85921608C1C92929A7A8C92,13651,14,17,3,30,47,1547
71169,71169,4C8E92DBB85921608C1C92929A7A8C92,42521,18,23,5,31,47,1597
71173,71173,9BA8F34DC6EC4E603089680B8D663972,11861,0,8,8,32,47,1647
71174,71174,9BA8F34DC6EC4E603089680B8D663972,10731,10,13,3,33,47,1697
71175,71175,9BA8F34DC6EC4E603089680B8D663972,11861,13,15,2,32,47,1647
71176,71176,9BA8F34DC6EC4E603089680B8D663972,10281,19,21,2,33,48,1698
71180,71180,569FE1B0CCF701005479FDA64CAA96A2,11074,0,6,6,37,47,1897
71181,71181,569FE1B0CCF701005479FDA64CAA96A2,11231,7,12,5,37,49,1899
71182,71182,569FE1B0CCF701005479FDA64CAA96A2,11074,12,13,1,37,47,1897
71183,71183,569FE1B0CCF701005479FDA64CAA96A2,11231,14,21,7,37,49,1899
71187,71187,CC63EA7467D4A1FC7EF1BC76C9DAF092,11261,0,5,5,36,46,1846
71188,71188,CC63EA7467D4A1FC7EF1BC76C9DAF092,42861,5,6,1,37,44,1894
71189,71189,CC63EA7467D4A1FC7EF1BC76C9DAF092,11261,6,23,17,36,46,1846
71190,71190,CC04DF57CD476D56A9C2711AACC54374,11261,1,2,1,36,46,1846
71191,71191,CC04DF57CD476D56A9C2711AACC54374,42861,4,19,15,37,44,1894
71192,71192,CC04DF57CD476D56A9C2711AACC54374,11261,20,23,3,36,46,1846
71198,71198,3624837A8CEE8FA380EBBA166C2E7021,42091,0,16,16,43,46,2196
71199,71199,3624837A8CEE8FA380EBBA166C2E7021,42461,18,19,1,45,47,2297
71200,71200,3624837A8CEE8FA380EBBA166C2E7021,42091,19,23,4,43,46,2196
71201,71201,179C9FE89AB1A0E7249FE171F554F068,42523,6,7,1,31,47,1597
71202,71202,179C9FE89AB1A0E7249FE171F554F068,12121,8,9,1,29,47,1497
71203,71203,179C9FE89AB1A0E7249FE171F554F068,42523,9,23,14,31,47,1597
71204,71204,DB3E632F42868AC534528673590A51E5,43391,0,18,18,29,48,1498
71205,71205,DB3E632F42868AC534528673590A51E5,10544,19,20,1,28,48,1448
71206,71206,DB3E632F42868AC534528673590A51E5,43391,21,23,2,29,48,1498
71213,71213,1432315E02B72C61B42AD2B5294AED3D,10251,0,17,17,35,47,1797
71214,71214,1432315E02B72C61B42AD2B5294AED3D,42401,17,19,2,36,47,1847
71215,71215,1432315E02B72C61B42AD2B5294AED3D,10251,19,23,4,35,47,1797
71216,71216,1C18101ADA4B02F048DFDA93997493B8,42491,0,8,8,32,46,1646
71217,71217,1C18101ADA4B02F048DFDA93997493B8,42523,9,11,2,31,47,1597
71218,71218,1C18101ADA4B02F048DFDA93997493B8,42491,12,16,4,32,46,1646
71219,71219,1C18101ADA4B02F048DFDA93997493B8,42523,19,22,3,31,47,1597
71220,71220,58FF60972C1637520443DC5766A2AB67,13411,0,5,5,49,42,2492
71221,71221,58FF60972C1637520443DC5766A2AB67,43951,6,18,12,49,41,2491
71222,71222,58FF60972C1637520443DC5766A2AB67,13411,20,23,3,49,42,2492
71223,71223,2B18BEA2FBBC80F82CFB75E581EF2F20,42021,0,2,2,33,47,1697
71224,71224,2B18BEA2FBBC80F82CFB75E581EF2F20,11861,2,8,6,32,47,1647
71225,71225,2B18BEA2FBBC80F82CFB75E581EF2F20,10731,9,16,7,33,47,1697
71226,71226,2B18BEA2FBBC80F82CFB75E581EF2F20,11861,19,23,4,32,47,1647
71227,71227,926A453A59B998DC477472FE2F40B59A,42631,1,3,2,43,45,2195
71228,71228,926A453A59B998DC477472FE2F40B59A,42633,6,13,7,42,46,2146
71229,71229,926A453A59B998DC477472FE2F40B59A,42631,20,21,1,43,45,2195
71230,71230,A249659AA4285866F354A5650B26A07F,10111,0,14,14,37,47,1897
71231,71231,A249659AA4285866F354A5650B26A07F,42401,17,19,2,36,47,1847
71232,71232,A249659AA4285866F354A5650B26A07F,10111,20,23,3,37,47,1897
71238,71238,8E1DB9D4ECEC1F108A151A8D21BA1A04,42231,0,6,6,37,46,1896
71239,71239,8E1DB9D4ECEC1F108A151A8D21BA1A04,13911,6,8,2,39,46,1996
71240,71240,8E1DB9D4ECEC1F108A151A8D21BA1A04,42231,8,23,15,37,46,1896
71241,71241,17BFCEDD973B29E8302E2E7670AFE303,10471,6,17,11,37,48,1898
71242,71242,17BFCEDD973B29E8302E2E7670AFE303,11921,18,20,2,38,48,1948
71243,71243,17BFCEDD973B29E8302E2E7670AFE303,10471,21,23,2,37,48,1898
71271,71271,4FA7E2AF35091649A8D61648BF92F5C0,42581,1,8,7,38,48,1948
71272,71272,4FA7E2AF35091649A8D61648BF92F5C0,10471,8,10,2,37,48,1898
71273,71273,4FA7E2AF35091649A8D61648BF92F5C0,42581,12,13,1,38,48,1948
71274,71274,4FA7E2AF35091649A8D61648BF92F5C0,10471,14,22,8,37,48,1898
71284,71284,94A66B099C3B286235DEE73BAE7FEB6C,10281,0,4,4,33,48,1698
71285,71285,94A66B099C3B286235DEE73BAE7FEB6C,11861,4,9,5,32,47,1647
71286,71286,94A66B099C3B286235DEE73BAE7FEB6C,10281,12,20,8,33,48,1698
71287,71287,94A66B099C3B286235DEE73BAE7FEB6C,11861,21,23,2,32,47,1647
71296,71296,24517D61FB768E2EEA9476C907365BA4,11801,0,9,9,42,48,2148
71297,71297,24517D61FB768E2EEA9476C907365BA4,10421,12,16,4,41,48,2098
71298,71298,24517D61FB768E2EEA9476C907365BA4,11801,18,23,5,42,48,2148
71299,71299,790CA71BBC53353AABCB9BB22BDF58BD,11021,0,10,10,36,49,1849
71300,71300,790CA71BBC53353AABCB9BB22BDF58BD,42471,12,13,1,35,49,1799
71301,71301,790CA71BBC53353AABCB9BB22BDF58BD,10491,17,18,1,33,48,1698
71302,71302,790CA71BBC53353AABCB9BB22BDF58BD,11021,20,23,3,36,49,1849
71303,71303,549B8A34E419FBD57213E9641A5E14A7,10681,0,1,1,30,48,1548
71304,71304,549B8A34E419FBD57213E9641A5E14A7,11061,3,5,2,29,48,1498
71305,71305,549B8A34E419FBD57213E9641A5E14A7,10681,5,22,17,30,48,1548
71306,71306,549B8A34E419FBD57213E9641A5E14A7,11061,22,23,1,29,48,1498
71307,71307,F840A9907CA895CBF9E085175B717C5C,10121,0,8,8,36,49,1849
71308,71308,F840A9907CA895CBF9E085175B717C5C,10661,10,12,2,37,49,1899
71309,71309,F840A9907CA895CBF9E085175B717C5C,10121,12,23,11,36,49,1849
71310,71310,09E76C7E5F88F1AE9CA216C706232DAD,43761,2,10,8,32,47,1647
71311,71311,09E76C7E5F88F1AE9CA216C706232DAD,11324,11,12,1,31,46,1596
71312,71312,09E76C7E5F88F1AE9CA216C706232DAD,43761,13,22,9,32,47,1647
71313,71313,774D58D54FF2438AE9FE14077D32EF74,11951,1,6,5,31,49,1599
71314,71314,774D58D54FF2438AE9FE14077D32EF74,13731,7,11,4,33,49,1699
71315,71315,774D58D54FF2438AE9FE14077D32EF74,11954,18,21,3,32,49,1649
71316,71316,5B985E49A96AC1F29BC71E54AB886B64,10634,10,11,1,27,45,1395
71317,71317,5B985E49A96AC1F29BC71E54AB886B64,10351,16,17,1,28,45,1445
71318,71318,5B985E49A96AC1F29BC71E54AB886B64,10634,17,23,6,27,45,1395
71319,71319,357405D7AE35EA097AB37ACFD068BAD8,10281,0,17,17,33,48,1698
71320,71320,357405D7AE35EA097AB37ACFD068BAD8,11161,17,18,1,32,48,1648
71321,71321,357405D7AE35EA097AB37ACFD068BAD8,11201,19,22,3,35,49,1799
71326,71326,FCF6425DA3F542476DF1F93935C075D8,42581,0,17,17,38,48,1948
71327,71327,FCF6425DA3F542476DF1F93935C075D8,11914,18,19,1,37,48,1898
71328,71328,FCF6425DA3F542476DF1F93935C075D8,42581,21,22,1,38,48,1948
71329,71329,F3DCE8C3C3FF003CDF3D27C94852CCE1,11951,2,6,4,31,49,1599
71330,71330,F3DCE8C3C3FF003CDF3D27C94852CCE1,13731,16,17,1,33,49,1699
71331,71331,F3DCE8C3C3FF003CDF3D27C94852CCE1,11951,18,23,5,31,49,1599
71335,71335,3544B9900CDDC16C4606729762F4FE67,11151,0,8,8,30,48,1548
71336,71336,3544B9900CDDC16C4606729762F4FE67,11061,8,10,2,29,48,1498
71337,71337,3544B9900CDDC16C4606729762F4FE67,11151,11,22,11,30,48,1548
71345,71345,B0CA59461CE535DA6C80DC6682EBEAFB,42271,1,9,8,40,47,2047
71346,71346,B0CA59461CE535DA6C80DC6682EBEAFB,11806,10,12,2,41,48,2098
71347,71347,B0CA59461CE535DA6C80DC6682EBEAFB,42271,13,20,7,40,47,2047
71354,71354,99090679888D7F5C536F089A4B9CEA7D,42231,0,1,1,37,46,1896
71355,71355,99090679888D7F5C536F089A4B9CEA7D,13911,2,21,19,39,46,1996
71356,71356,99090679888D7F5C536F089A4B9CEA7D,42351,21,22,1,38,45,1945
71357,71357,444E69732216376CD03B9C2CCF18ACBE,11231,0,16,16,37,49,1899
71358,71358,444E69732216376CD03B9C2CCF18ACBE,42981,17,18,1,36,49,1849
71359,71359,444E69732216376CD03B9C2CCF18ACBE,11231,18,21,3,37,49,1899
71378,71378,787E2D15898542A785C91CF72E674285,42231,8,9,1,37,46,1896
71379,71379,787E2D15898542A785C91CF72E674285,13911,11,12,1,39,46,1996
71380,71380,787E2D15898542A785C91CF72E674285,11261,14,17,3,36,46,1846
71381,71381,787E2D15898542A785C91CF72E674285,42231,18,21,3,37,46,1896
71382,71382,07BDD3FC9C0370EC0810F6F38EA5874D,42871,0,9,9,30,45,1545
71383,71383,07BDD3FC9C0370EC0810F6F38EA5874D,11875,10,11,1,30,46,1546
71384,71384,07BDD3FC9C0370EC0810F6F38EA5874D,10301,11,13,2,31,45,1595
71385,71385,07BDD3FC9C0370EC0810F6F38EA5874D,11875,14,20,6,30,46,1546
71391,71391,2B75D649D733D42AAC85CA634BF0D07B,11914,0,4,4,37,48,1898
71392,71392,2B75D649D733D42AAC85CA634BF0D07B,42581,5,6,1,38,48,1948
71393,71393,2B75D649D733D42AAC85CA634BF0D07B,11914,11,23,12,37,48,1898
71405,71405,9E8454E3BE651FEBAAD2CFCFB76D7A82,42921,0,6,6,33,47,1697
71406,71406,9E8454E3BE651FEBAAD2CFCFB76D7A82,10221,8,10,2,34,49,1749
71407,71407,9E8454E3BE651FEBAAD2CFCFB76D7A82,43731,11,13,2,34,47,1747
71408,71408,9E8454E3BE651FEBAAD2CFCFB76D7A82,42021,16,23,7,33,47,1697
71415,71415,7E334EEF4AA6AF36D53827B3C1D2ABFE,11461,0,13,13,37,49,1899
71416,71416,7E334EEF4AA6AF36D53827B3C1D2ABFE,43281,15,16,1,37,48,1898
71417,71417,7E334EEF4AA6AF36D53827B3C1D2ABFE,11461,17,22,5,37,49,1899
71430,71430,61D4369B95803102112EEFE32BD36465,42141,0,1,1,32,47,1647
71431,71431,61D4369B95803102112EEFE32BD36465,10295,3,4,1,30,47,1547
71432,71432,61D4369B95803102112EEFE32BD36465,42141,6,20,14,32,47,1647
71433,71433,F7BA1E9C235C1D8A36FA4FE83DC9EFDD,10161,0,6,6,35,49,1799
71434,71434,F7BA1E9C235C1D8A36FA4FE83DC9EFDD,11731,7,8,1,36,48,1848
71435,71435,F7BA1E9C235C1D8A36FA4FE83DC9EFDD,11541,10,21,11,35,49,1799
71444,71444,BB44A13BCAB0B022B18D7F4EDDEC4037,11231,0,1,1,37,49,1899
71445,71445,BB44A13BCAB0B022B18D7F4EDDEC4037,42301,1,18,17,36,47,1847
71446,71446,BB44A13BCAB0B022B18D7F4EDDEC4037,11231,20,23,3,37,49,1899
71458,71458,65F728ACB010BFAB42CA8AF85ABE5116,12491,0,10,10,36,43,1843
71459,71459,65F728ACB010BFAB42CA8AF85ABE5116,42864,13,18,5,38,44,1944
71460,71460,65F728ACB010BFAB42CA8AF85ABE5116,42861,20,23,3,37,44,1894
71461,71461,CC115E075627F49AC17F5D9D869D1EC5,19441,2,10,8,8,46,446
71462,71462,CC115E075627F49AC17F5D9D869D1EC5,19021,11,16,5,10,45,545
71463,71463,CC115E075627F49AC17F5D9D869D1EC5,19441,17,20,3,8,46,446
71464,71464,CC115E075627F49AC17F5D9D869D1EC5,19021,21,23,2,10,45,545
71469,71469,33B427A287EC6223ED12DF4C96ADCB55,42491,1,12,11,32,46,1646
71470,71470,33B427A287EC6223ED12DF4C96ADCB55,42523,14,15,1,31,47,1597
71471,71471,33B427A287EC6223ED12DF4C96ADCB55,42491,19,20,1,32,46,1646
71487,71487,835E4AB3BB8C4699720E70AB108BA996,12491,0,5,5,36,43,1843
71488,71488,835E4AB3BB8C4699720E70AB108BA996,43451,6,8,2,37,40,1890
71489,71489,835E4AB3BB8C4699720E70AB108BA996,12491,11,13,2,36,43,1843
71490,71490,835E4AB3BB8C4699720E70AB108BA996,42864,15,18,3,38,44,1944
71491,71491,BAF87A0BC01C594FFAC1B35DD77FCF62,10471,0,18,18,37,48,1898
71492,71492,BAF87A0BC01C594FFAC1B35DD77FCF62,10107,19,20,1,38,49,1949
71493,71493,BAF87A0BC01C594FFAC1B35DD77FCF62,10471,21,23,2,37,48,1898
71500,71500,1E78C6812CC13AC596F7D7BD80A5DD70,11921,0,17,17,38,48,1948
71501,71501,1E78C6812CC13AC596F7D7BD80A5DD70,11074,18,19,1,37,47,1897
71502,71502,1E78C6812CC13AC596F7D7BD80A5DD70,11914,21,23,2,37,48,1898
71503,71503,73AC3CBDB2A277CF5F45112FEF564EF8,13121,0,8,8,38,46,1946
71504,71504,73AC3CBDB2A277CF5F45112FEF564EF8,42511,12,13,1,37,47,1897
71505,71505,73AC3CBDB2A277CF5F45112FEF564EF8,13121,13,23,10,38,46,1946
71518,71518,2EF6C0FB2DECBC4A57AE198EC3FD678A,10971,0,13,13,35,47,1797
71519,71519,2EF6C0FB2DECBC4A57AE198EC3FD678A,42021,15,17,2,33,47,1697
71520,71520,2EF6C0FB2DECBC4A57AE198EC3FD678A,10971,18,23,5,35,47,1797
71521,71521,2FC430E1448F290A8E229F5C2301E320,49201,1,7,6,7,41,391
71522,71522,2FC430E1448F290A8E229F5C2301E320,12921,7,9,2,9,41,491
71523,71523,2FC430E1448F290A8E229F5C2301E320,49201,11,21,10,7,41,391
71524,71524,1788FF83230593384DFEF88881720D90,13551,0,7,7,45,38,2288
71525,71525,1788FF83230593384DFEF88881720D90,43101,8,12,4,46,40,2340
71526,71526,1788FF83230593384DFEF88881720D90,13551,13,21,8,45,38,2288
71527,71527,F7F6E311089E545E2ADE21E1CFF4D206,40636,0,2,2,35,48,1798
71528,71528,F7F6E311089E545E2ADE21E1CFF4D206,12481,4,13,9,37,49,1899
71529,71529,F7F6E311089E545E2ADE21E1CFF4D206,42921,18,23,5,33,47,1697
71533,71533,FC3FF2A4A79867965BF8FB27343C354A,11361,0,5,5,22,48,1148
71534,71534,FC3FF2A4A79867965BF8FB27343C354A,42681,6,11,5,24,48,1248
71535,71535,FC3FF2A4A79867965BF8FB27343C354A,11641,15,17,2,22,49,1149
71536,71536,FC3FF2A4A79867965BF8FB27343C354A,42681,19,20,1,24,48,1248
71546,71546,405D0397A0039CC27D91E15C636835F3,10121,1,12,11,36,49,1849
71547,71547,405D0397A0039CC27D91E15C636835F3,10161,13,18,5,35,49,1799
71548,71548,405D0397A0039CC27D91E15C636835F3,10901,19,22,3,35,48,1798
71549,71549,3BD30092E78F928C91E4887B7831932C,42401,0,4,4,36,47,1847
71550,71550,3BD30092E78F928C91E4887B7831932C,10111,7,9,2,37,47,1897
71551,71551,3BD30092E78F928C91E4887B7831932C,42401,13,18,5,36,47,1847
71552,71552,3BD30092E78F928C91E4887B7831932C,11331,20,23,3,37,48,1898
71553,71553,0DFD98C5BF618352145AEF64606DF221,42401,0,2,2,36,47,1847
71554,71554,0DFD98C5BF618352145AEF64606DF221,40673,6,12,6,36,48,1848
71555,71555,0DFD98C5BF618352145AEF64606DF221,42401,14,20,6,36,47,1847
71559,71559,1A5DEB007188BBCFFE665C75C024CDE9,42531,0,3,3,31,45,1595
71560,71560,1A5DEB007188BBCFFE665C75C024CDE9,12121,4,5,1,29,47,1497
71561,71561,1A5DEB007188BBCFFE665C75C024CDE9,42531,10,15,5,31,45,1595
71562,71562,1A5DEB007188BBCFFE665C75C024CDE9,12311,19,22,3,30,44,1544
71563,71563,DF9AD5AC0E4BE326A72BA327D1A40B9F,42401,0,18,18,36,47,1847
71564,71564,DF9AD5AC0E4BE326A72BA327D1A40B9F,43161,19,20,1,35,47,1797
71565,71565,DF9AD5AC0E4BE326A72BA327D1A40B9F,42161,20,23,3,36,47,1847
71571,71571,2937B23EEDB796179FFFF39113F778F2,42221,0,13,13,38,48,1948
71572,71572,2937B23EEDB796179FFFF39113F778F2,11791,17,19,2,38,49,1949
71573,71573,2937B23EEDB796179FFFF39113F778F2,42221,19,23,4,38,48,1948
71585,71585,9AF6F4C6C4937C91C918EC9853CABA28,11261,1,3,2,36,46,1846
71586,71586,9AF6F4C6C4937C91C918EC9853CABA28,42861,3,18,15,37,44,1894
71587,71587,9AF6F4C6C4937C91C918EC9853CABA28,10811,20,23,3,38,46,1946
71588,71588,93C87ADE4FBD02048670A9DCD4C6ECEA,42861,7,9,2,37,44,1894
71589,71589,93C87ADE4FBD02048670A9DCD4C6ECEA,42864,11,13,2,38,44,1944
71590,71590,93C87ADE4FBD02048670A9DCD4C6ECEA,42861,14,16,2,37,44,1894
71591,71591,93C87ADE4FBD02048670A9DCD4C6ECEA,11261,17,19,2,36,46,1846
71592,71592,8879DF6A5F82577E1752858832950F5C,10971,6,7,1,35,47,1797
71593,71593,8879DF6A5F82577E1752858832950F5C,11081,9,10,1,35,46,1796
71594,71594,8879DF6A5F82577E1752858832950F5C,42523,11,21,10,31,47,1597
71595,71595,3820125CF30C88F1E7BDAB914B9F270F,42191,9,10,1,38,49,1949
71596,71596,3820125CF30C88F1E7BDAB914B9F270F,11491,14,16,2,36,47,1847
71597,71597,3820125CF30C88F1E7BDAB914B9F270F,11271,18,23,5,37,48,1898
71598,71598,3717F18D88C40095DBADE8C95C390E6F,42861,10,12,2,37,44,1894
71599,71599,3717F18D88C40095DBADE8C95C390E6F,42151,13,17,4,35,45,1795
71600,71600,3717F18D88C40095DBADE8C95C390E6F,42861,17,19,2,37,44,1894
71601,71601,3717F18D88C40095DBADE8C95C390E6F,42151,20,22,2,35,45,1795
71602,71602,E6AC57452A564977FA8F4CD52CD9B295,10281,1,6,5,33,48,1698
71603,71603,E6AC57452A564977FA8F4CD52CD9B295,11861,6,8,2,32,47,1647
71604,71604,E6AC57452A564977FA8F4CD52CD9B295,10281,8,11,3,33,48,1698
71605,71605,E6AC57452A564977FA8F4CD52CD9B295,11861,11,22,11,32,47,1647
71606,71606,EF27C7353BC1F4204B56E285F3CF4AB6,43761,0,17,17,32,47,1647
71607,71607,EF27C7353BC1F4204B56E285F3CF4AB6,42523,17,18,1,31,47,1597
71608,71608,EF27C7353BC1F4204B56E285F3CF4AB6,43761,20,23,3,32,47,1647
71609,71609,1678CB8E12733A7CC4242255823809E8,42071,0,7,7,31,49,1599
71610,71610,1678CB8E12733A7CC4242255823809E8,11201,9,12,3,35,49,1799
71611,71611,1678CB8E12733A7CC4242255823809E8,42071,12,19,7,31,49,1599
71617,71617,1D9B3BEAA73444A543D0673D1FBABCFF,10251,0,8,8,35,47,1797
71618,71618,1D9B3BEAA73444A543D0673D1FBABCFF,42511,8,11,3,37,47,1897
71619,71619,1D9B3BEAA73444A543D0673D1FBABCFF,42161,12,23,11,36,47,1847
71624,71624,BFB5F99311B260572E316DE64B3EB913,10491,0,8,8,33,48,1698
71625,71625,BFB5F99311B260572E316DE64B3EB913,10901,9,18,9,35,48,1798
71626,71626,BFB5F99311B260572E316DE64B3EB913,10491,19,20,1,33,48,1698
71644,71644,0C04F09AFDB231CF30C74F04B45FF1DB,43731,1,13,12,34,47,1747
71645,71645,0C04F09AFDB231CF30C74F04B45FF1DB,42921,13,15,2,33,47,1697
71646,71646,0C04F09AFDB231CF30C74F04B45FF1DB,43731,15,19,4,34,47,1747
71647,71647,0C04F09AFDB231CF30C74F04B45FF1DB,42161,20,23,3,36,47,1847
71656,71656,1F953F5DDA94789CC05A9CC3A1537BDC,42581,1,4,3,38,48,1948
71657,71657,1F953F5DDA94789CC05A9CC3A1537BDC,43181,4,5,1,39,48,1998
71658,71658,1F953F5DDA94789CC05A9CC3A1537BDC,42581,6,17,11,38,48,1948
71659,71659,1F953F5DDA94789CC05A9CC3A1537BDC,10471,21,23,2,37,48,1898
71660,71660,4A1082E29116D07A4EA830C32D0BE5ED,12221,1,6,5,43,44,2194
71661,71661,4A1082E29116D07A4EA830C32D0BE5ED,13341,8,16,8,44,45,2245
71662,71662,4A1082E29116D07A4EA830C32D0BE5ED,12221,18,20,2,43,44,2194
71667,71667,487315C9A10EA017D67B443311820F7A,12401,0,6,6,39,49,1999
71668,71668,487315C9A10EA017D67B443311820F7A,11914,7,17,10,37,48,1898
71669,71669,487315C9A10EA017D67B443311820F7A,11771,19,23,4,39,49,1999
71673,71673,69601DFFFCF880DD8BF9BB911205AC6A,11861,4,6,2,32,47,1647
71674,71674,69601DFFFCF880DD8BF9BB911205AC6A,13651,7,9,2,30,47,1547
71675,71675,69601DFFFCF880DD8BF9BB911205AC6A,11861,9,12,3,32,47,1647
71676,71676,69601DFFFCF880DD8BF9BB911205AC6A,13651,13,23,10,30,47,1547
71681,71681,2592B8DAD6166EC274668822A952FE1A,11831,7,12,5,32,45,1645
71682,71682,2592B8DAD6166EC274668822A952FE1A,43731,13,14,1,34,47,1747
71683,71683,2592B8DAD6166EC274668822A952FE1A,40381,16,19,3,32,46,1646
71684,71684,831704567A0B8CDF382FA5741F6A7093,11321,0,6,6,31,46,1596
71685,71685,831704567A0B8CDF382FA5741F6A7093,10301,7,8,1,31,45,1595
71686,71686,831704567A0B8CDF382FA5741F6A7093,11321,12,23,11,31,46,1596
71697,71697,7EBD3BA762C40F1F8A712F803B7D8FD3,12491,2,5,3,36,43,1843
71698,71698,7EBD3BA762C40F1F8A712F803B7D8FD3,42151,5,6,1,35,45,1795
71699,71699,7EBD3BA762C40F1F8A712F803B7D8FD3,12491,6,10,4,36,43,1843
71700,71700,7EBD3BA762C40F1F8A712F803B7D8FD3,42151,14,21,7,35,45,1795
71701,71701,5E3291503FC27DAA0248AA453FC4D60A,19441,0,8,8,8,46,446
71702,71702,5E3291503FC27DAA0248AA453FC4D60A,42041,9,10,1,10,47,547
71703,71703,5E3291503FC27DAA0248AA453FC4D60A,19441,14,20,6,8,46,446
71704,71704,5E3291503FC27DAA0248AA453FC4D60A,19114,20,22,2,7,43,393
71746,71746,826B40817E61853148AFBFECB1C48C70,11261,0,5,5,36,46,1846
71747,71747,826B40817E61853148AFBFECB1C48C70,42861,7,11,4,37,44,1894
71748,71748,826B40817E61853148AFBFECB1C48C70,11261,12,16,4,36,46,1846
71749,71749,826B40817E61853148AFBFECB1C48C70,42864,17,18,1,38,44,1944
71754,71754,C7DA09D84BB6D5A3ABEAD976C8C0731E,42861,0,13,13,37,44,1894
71755,71755,C7DA09D84BB6D5A3ABEAD976C8C0731E,11261,14,17,3,36,46,1846
71756,71756,C7DA09D84BB6D5A3ABEAD976C8C0731E,42861,19,23,4,37,44,1894
71766,71766,3D97CD40EAC505910D95CCB4A74CAE65,42864,2,4,2,38,44,1944
71767,71767,3D97CD40EAC505910D95CCB4A74CAE65,42861,6,15,9,37,44,1894
71768,71768,3D97CD40EAC505910D95CCB4A74CAE65,11261,16,21,5,36,46,1846
71779,71779,6FF0FFC6286BA2367A45E8654F4EAA2F,11061,9,16,7,29,48,1498
71780,71780,6FF0FFC6286BA2367A45E8654F4EAA2F,11381,17,18,1,30,47,1547
71781,71781,6FF0FFC6286BA2367A45E8654F4EAA2F,11061,19,23,4,29,48,1498
71782,71782,DE227031758DC696B2CE253FE68A9BD4,13561,0,6,6,37,49,1899
71783,71783,DE227031758DC696B2CE253FE68A9BD4,11531,9,10,1,34,49,1749
71784,71784,DE227031758DC696B2CE253FE68A9BD4,13561,14,15,1,37,49,1899
71785,71785,DE227031758DC696B2CE253FE68A9BD4,40261,16,18,2,35,49,1799
71792,71792,C6869A64CA9EF97A25D7192A00726FC2,10111,0,9,9,37,47,1897
71793,71793,C6869A64CA9EF97A25D7192A00726FC2,10781,12,18,6,35,47,1797
71794,71794,C6869A64CA9EF97A25D7192A00726FC2,42401,19,23,4,36,47,1847
71795,71795,ADB0249500DF973E64AC42ADAF413490,13371,0,9,9,41,47,2097
71796,71796,ADB0249500DF973E64AC42ADAF413490,13221,9,10,1,40,47,2047
71797,71797,ADB0249500DF973E64AC42ADAF413490,13371,13,23,10,41,47,2097
71814,71814,21D34D9AB698D190C3E7AC562954219B,12311,0,15,15,30,44,1544
71815,71815,21D34D9AB698D190C3E7AC562954219B,42531,19,20,1,31,45,1595
71816,71816,21D34D9AB698D190C3E7AC562954219B,12311,20,21,1,30,44,1544
71817,71817,E1C859FD8CC74565ED07635B54DBAB6A,43761,1,6,5,32,47,1647
71818,71818,E1C859FD8CC74565ED07635B54DBAB6A,11061,9,17,8,29,48,1498
71819,71819,E1C859FD8CC74565ED07635B54DBAB6A,43761,21,23,2,32,47,1647
71823,71823,D8963F7C81A647B0DB7A8BBF70036A0B,12514,4,5,1,38,47,1947
71824,71824,D8963F7C81A647B0DB7A8BBF70036A0B,10471,8,17,9,37,48,1898
71825,71825,D8963F7C81A647B0DB7A8BBF70036A0B,13331,19,21,2,38,47,1947
71835,71835,E311A49FD79CE1E67702DBA9B7887B92,12641,3,4,1,10,43,543
71836,71836,E311A49FD79CE1E67702DBA9B7887B92,19021,6,10,4,10,45,545
71837,71837,E311A49FD79CE1E67702DBA9B7887B92,12641,14,17,3,10,43,543
71838,71838,E311A49FD79CE1E67702DBA9B7887B92,19021,20,23,3,10,45,545
71839,71839,0A0BBB63629E3A59CB256306E3BEA0A4,42371,0,5,5,34,46,1746
71840,71840,0A0BBB63629E3A59CB256306E3BEA0A4,42141,6,9,3,32,47,1647
71841,71841,0A0BBB63629E3A59CB256306E3BEA0A4,42371,13,14,1,34,46,1746
71842,71842,0A0BBB63629E3A59CB256306E3BEA0A4,42141,15,22,7,32,47,1647
71843,71843,55533B9612A041F560AB09E0A0C2A735,10251,0,20,20,35,47,1797
71844,71844,55533B9612A041F560AB09E0A0C2A735,43731,20,21,1,34,47,1747
71845,71845,55533B9612A041F560AB09E0A0C2A735,10251,22,23,1,35,47,1797
71861,71861,439EDB210DCD98F31D5DCFCE0CF2729B,40833,0,2,2,41,47,2097
71862,71862,439EDB210DCD98F31D5DCFCE0CF2729B,13101,2,10,8,40,47,2047
71863,71863,439EDB210DCD98F31D5DCFCE0CF2729B,40833,12,20,8,41,47,2097
71864,71864,F725A3F859B25741A70E1B3AC0517A8A,10111,2,11,9,37,47,1897
71865,71865,F725A3F859B25741A70E1B3AC0517A8A,42301,12,15,3,36,47,1847
71866,71866,F725A3F859B25741A70E1B3AC0517A8A,10971,20,22,2,35,47,1797
71878,71878,1A0878520FAE4F4D6242A93DFE7340E0,10811,0,6,6,38,46,1946
71879,71879,1A0878520FAE4F4D6242A93DFE7340E0,42271,6,16,10,40,47,2047
71880,71880,1A0878520FAE4F4D6242A93DFE7340E0,10811,20,22,2,38,46,1946
71881,71881,F82B0744060E830A6F1F73EAFE27E504,42461,2,13,11,45,47,2297
71882,71882,F82B0744060E830A6F1F73EAFE27E504,42321,14,15,1,43,47,2197
71883,71883,F82B0744060E830A6F1F73EAFE27E504,13471,16,17,1,47,49,2399
71884,71884,F82B0744060E830A6F1F73EAFE27E504,42461,20,21,1,45,47,2297
71891,71891,9F99D3E8103CACE67B801529A26DE8DF,42301,0,14,14,36,47,1847
71892,71892,9F99D3E8103CACE67B801529A26DE8DF,12131,14,17,3,32,47,1647
71893,71893,9F99D3E8103CACE67B801529A26DE8DF,10531,19,21,2,34,46,1746
71902,71902,FCC89D0F72B0B6BEC68E599778108B84,10111,0,13,13,37,47,1897
71903,71903,FCC89D0F72B0B6BEC68E599778108B84,11331,13,16,3,37,48,1898
71904,71904,FCC89D0F72B0B6BEC68E599778108B84,10111,17,23,6,37,47,1897
71912,71912,F66D7CA3D190DB256B66CDB9FF422557,11021,10,13,3,36,49,1849
71913,71913,F66D7CA3D190DB256B66CDB9FF422557,11211,14,15,1,34,49,1749
71914,71914,F66D7CA3D190DB256B66CDB9FF422557,10121,20,21,1,36,49,1849
71915,71915,03FE0D0BD52A528C1B4DF1F3C44F085B,11941,4,10,6,37,46,1896
71916,71916,03FE0D0BD52A528C1B4DF1F3C44F085B,43241,12,19,7,36,46,1846
71917,71917,03FE0D0BD52A528C1B4DF1F3C44F085B,42351,20,21,1,38,45,1945
71944,71944,559E48D9BCBF38B1AE94C6F9C414A4F8,11151,0,9,9,30,48,1548
71945,71945,559E48D9BCBF38B1AE94C6F9C414A4F8,11061,10,11,1,29,48,1498
71946,71946,559E48D9BCBF38B1AE94C6F9C414A4F8,11151,11,23,12,30,48,1548
71947,71947,E908468A4151400394D5313058C7E35A,12601,3,11,8,25,47,1297
71948,71948,E908468A4151400394D5313058C7E35A,12121,13,14,1,29,47,1497
71949,71949,E908468A4151400394D5313058C7E35A,10501,17,18,1,22,46,1146
71962,71962,E0F1670DB5561200EEDBAB1833327673,11921,0,5,5,38,48,1948
71963,71963,E0F1670DB5561200EEDBAB1833327673,11231,5,11,6,37,49,1899
71964,71964,E0F1670DB5561200EEDBAB1833327673,10111,12,22,10,37,47,1897
71965,71965,B7783E40C231BF2A915C5200F2E2562A,12031,3,12,9,33,48,1698
71966,71966,B7783E40C231BF2A915C5200F2E2562A,10901,15,17,2,35,48,1798
71967,71967,B7783E40C231BF2A915C5200F2E2562A,10161,19,20,1,35,49,1799
71968,71968,3E17C9F881E8F571652BFE5E841845EF,11861,0,2,2,32,47,1647
71969,71969,3E17C9F881E8F571652BFE5E841845EF,10281,3,18,15,33,48,1698
71970,71970,3E17C9F881E8F571652BFE5E841845EF,11861,18,23,5,32,47,1647
71971,71971,1CD741282378ACECE229BFA3E57C9431,19441,0,9,9,8,46,446
71972,71972,1CD741282378ACECE229BFA3E57C9431,42041,9,11,2,10,47,547
71973,71973,1CD741282378ACECE229BFA3E57C9431,19441,11,22,11,8,46,446
71977,71977,6AF9BC3BC00A2DB4E93E7EFAFF6696BB,43761,1,14,13,32,47,1647
71978,71978,6AF9BC3BC00A2DB4E93E7EFAFF6696BB,40203,16,17,1,33,49,1699
71979,71979,6AF9BC3BC00A2DB4E93E7EFAFF6696BB,11171,18,20,2,33,48,1698
71980,71980,0B01795734CA986B36F023360E2D7588,11231,0,2,2,37,49,1899
71981,71981,0B01795734CA986B36F023360E2D7588,42961,2,7,5,35,49,1799
71982,71982,0B01795734CA986B36F023360E2D7588,11231,8,23,15,37,49,1899
71994,71994,8B6448FD7DB9F8E2F8F73AFDDD5BFD38,10634,0,7,7,27,45,1395
71995,71995,8B6448FD7DB9F8E2F8F73AFDDD5BFD38,10351,8,9,1,28,45,1445
71996,71996,8B6448FD7DB9F8E2F8F73AFDDD5BFD38,10634,10,19,9,27,45,1395
71997,71997,64C897065E9EDCA8A69F38A94EFB9055,10151,0,8,8,34,47,1747
71998,71998,64C897065E9EDCA8A69F38A94EFB9055,11021,10,11,1,36,49,1849
71999,71999,64C897065E9EDCA8A69F38A94EFB9055,10151,13,23,10,34,47,1747
72009,72009,94208362745F4CC8136A1624AA480486,10161,0,11,11,35,49,1799
72010,72010,94208362745F4CC8136A1624AA480486,40951,13,17,4,36,49,1849
72011,72011,94208362745F4CC8136A1624AA480486,10901,19,23,4,35,48,1798
72012,72012,8B7C73BA6B2D95910FBCFDF137038C2A,19114,0,6,6,7,43,393
72013,72013,8B7C73BA6B2D95910FBCFDF137038C2A,12641,9,15,6,10,43,543
72014,72014,8B7C73BA6B2D95910FBCFDF137038C2A,19114,18,23,5,7,43,393
72024,72024,5443876423EFFC85FB222DD27BB73B26,11021,0,9,9,36,49,1849
72025,72025,5443876423EFFC85FB222DD27BB73B26,11074,10,12,2,37,47,1897
72026,72026,5443876423EFFC85FB222DD27BB73B26,11021,15,23,8,36,49,1849
72035,72035,B90520ED7BDDE423CEFE3ED6913620C9,10841,1,2,1,37,47,1897
72036,72036,B90520ED7BDDE423CEFE3ED6913620C9,10271,7,15,8,37,46,1896
72037,72037,B90520ED7BDDE423CEFE3ED6913620C9,10841,16,19,3,37,47,1897
72042,72042,48DCE60D429B0B1E7F2F1B7A462BF9BF,42523,4,11,7,31,47,1597
72043,72043,48DCE60D429B0B1E7F2F1B7A462BF9BF,11861,13,18,5,32,47,1647
72044,72044,48DCE60D429B0B1E7F2F1B7A462BF9BF,42523,18,20,2,31,47,1597
72045,72045,48DCE60D429B0B1E7F2F1B7A462BF9BF,11861,21,23,2,32,47,1647
72046,72046,D19CCADD05AE7D38BD327DD3B3A1E602,42351,0,6,6,38,45,1945
72047,72047,D19CCADD05AE7D38BD327DD3B3A1E602,42231,9,10,1,37,46,1896
72048,72048,D19CCADD05AE7D38BD327DD3B3A1E602,13911,12,13,1,39,46,1996
72049,72049,D19CCADD05AE7D38BD327DD3B3A1E602,42231,14,18,4,37,46,1896
72050,72050,859846C23309918FCF7E37DF9FD45D9F,13911,0,8,8,39,46,1996
72051,72051,859846C23309918FCF7E37DF9FD45D9F,11261,10,11,1,36,46,1846
72052,72052,859846C23309918FCF7E37DF9FD45D9F,13911,12,23,11,39,46,1996
72053,72053,36E4D456967ADF7C503C23EAE8460AAD,13651,2,6,4,30,47,1547
72054,72054,36E4D456967ADF7C503C23EAE8460AAD,42523,8,13,5,31,47,1597
72055,72055,36E4D456967ADF7C503C23EAE8460AAD,13651,16,18,2,30,47,1547
72056,72056,813B4C3C53551E7273AA100F1B3AE00E,10634,9,10,1,27,45,1395
72057,72057,813B4C3C53551E7273AA100F1B3AE00E,42531,13,15,2,31,45,1595
72058,72058,813B4C3C53551E7273AA100F1B3AE00E,12311,19,21,2,30,44,1544
72074,72074,C01A93985B97A4FC98ABAA26FE7C5264,10251,0,10,10,35,47,1797
72075,72075,C01A93985B97A4FC98ABAA26FE7C5264,40637,11,12,1,36,47,1847
72076,72076,C01A93985B97A4FC98ABAA26FE7C5264,10251,17,23,6,35,47,1797
72077,72077,09803726F3C2A40BEF93389F75159E93,10281,0,7,7,33,48,1698
72078,72078,09803726F3C2A40BEF93389F75159E93,10251,9,10,1,35,47,1797
72079,72079,09803726F3C2A40BEF93389F75159E93,10281,12,23,11,33,48,1698
72093,72093,84D5DD5743261CBA6220A6F1E627F47F,11151,0,8,8,30,48,1548
72094,72094,84D5DD5743261CBA6220A6F1E627F47F,11061,8,19,11,29,48,1498
72095,72095,84D5DD5743261CBA6220A6F1E627F47F,12971,19,22,3,32,48,1648
72096,72096,4EE5C60035D807126AEE0DC0CD563832,12514,4,6,2,38,47,1947
72097,72097,4EE5C60035D807126AEE0DC0CD563832,42581,9,12,3,38,48,1948
72098,72098,4EE5C60035D807126AEE0DC0CD563832,11914,13,19,6,37,48,1898
72099,72099,4EE5C60035D807126AEE0DC0CD563832,42581,20,21,1,38,48,1948
72100,72100,DFA44588B9F7612E59AB24A1351E5F4F,12921,0,7,7,9,41,491
72101,72101,DFA44588B9F7612E59AB24A1351E5F4F,49201,15,18,3,7,41,391
72102,72102,DFA44588B9F7612E59AB24A1351E5F4F,12921,18,20,2,9,41,491
72128,72128,09C2A5500F5ABAEEAC932C07F5628EC4,42161,9,11,2,36,47,1847
72129,72129,09C2A5500F5ABAEEAC932C07F5628EC4,11021,12,14,2,36,49,1849
72130,72130,09C2A5500F5ABAEEAC932C07F5628EC4,42161,14,20,6,36,47,1847
72131,72131,09C2A5500F5ABAEEAC932C07F5628EC4,11021,21,22,1,36,49,1849
72132,72132,F276DA0C0E39AE3BAD5B91AE46CB6EA8,10471,7,14,7,37,48,1898
72133,72133,F276DA0C0E39AE3BAD5B91AE46CB6EA8,11231,14,19,5,37,49,1899
72134,72134,F276DA0C0E39AE3BAD5B91AE46CB6EA8,10471,19,20,1,37,48,1898
72146,72146,983842B60AEE8AF2D9A0F2BA47994634,11381,0,6,6,30,47,1547
72147,72147,983842B60AEE8AF2D9A0F2BA47994634,10951,6,7,1,29,48,1498
72148,72148,983842B60AEE8AF2D9A0F2BA47994634,11381,12,23,11,30,47,1547
72149,72149,9E8C2E79AD9DE30BB9C49EEA0FA745C5,13381,2,6,4,39,47,1997
72150,72150,9E8C2E79AD9DE30BB9C49EEA0FA745C5,11074,6,8,2,37,47,1897
72151,72151,9E8C2E79AD9DE30BB9C49EEA0FA745C5,13381,11,23,12,39,47,1997
72152,72152,FC7EB9622F9DA93D9292A2CD4A392CDA,13911,0,8,8,39,46,1996
72153,72153,FC7EB9622F9DA93D9292A2CD4A392CDA,11261,8,10,2,36,46,1846
72154,72154,FC7EB9622F9DA93D9292A2CD4A392CDA,13911,12,18,6,39,46,1996
72155,72155,FC7EB9622F9DA93D9292A2CD4A392CDA,11261,18,19,1,36,46,1846
72162,72162,AD235EE6A83CA7956AB86E8BC887D3C7,11541,0,6,6,35,49,1799
72163,72163,AD235EE6A83CA7956AB86E8BC887D3C7,11021,10,15,5,36,49,1849
72164,72164,AD235EE6A83CA7956AB86E8BC887D3C7,13561,17,18,1,37,49,1899
72165,72165,AD235EE6A83CA7956AB86E8BC887D3C7,11541,19,23,4,35,49,1799
72169,72169,EE6B8585E25BB845D2DA0A95F88FAB79,11261,7,9,2,36,46,1846
72170,72170,EE6B8585E25BB845D2DA0A95F88FAB79,42231,12,13,1,37,46,1896
72171,72171,EE6B8585E25BB845D2DA0A95F88FAB79,13911,16,19,3,39,46,1996
72176,72176,CABDD8B2A8DF9C3C6F2F674E6DD5C884,11381,2,7,5,30,47,1547
72177,72177,CABDD8B2A8DF9C3C6F2F674E6DD5C884,42291,7,9,2,29,48,1498
72178,72178,CABDD8B2A8DF9C3C6F2F674E6DD5C884,11381,12,13,1,30,47,1547
72179,72179,CABDD8B2A8DF9C3C6F2F674E6DD5C884,43971,16,18,2,30,48,1548
72180,72180,5B005239AD91B224060A740123F8C94E,13231,0,1,1,39,46,1996
72181,72181,5B005239AD91B224060A740123F8C94E,42231,1,21,20,37,46,1896
72182,72182,5B005239AD91B224060A740123F8C94E,13231,22,23,1,39,46,1996
72183,72183,52DE1B5B29EB088C4F7CC0D4865B38F5,42861,0,2,2,37,44,1894
72184,72184,52DE1B5B29EB088C4F7CC0D4865B38F5,42151,5,6,1,35,45,1795
72185,72185,52DE1B5B29EB088C4F7CC0D4865B38F5,42861,8,23,15,37,44,1894
72189,72189,D48C648C1D8E99D79DDC90BDE949351A,13231,5,7,2,39,46,1996
72190,72190,D48C648C1D8E99D79DDC90BDE949351A,11261,8,9,1,36,46,1846
72191,72191,D48C648C1D8E99D79DDC90BDE949351A,42351,20,21,1,38,45,1945
72197,72197,81C7B7CEB06954770CA2C889DCC58FC5,10295,5,13,8,30,47,1547
72198,72198,81C7B7CEB06954770CA2C889DCC58FC5,43761,16,18,2,32,47,1647
72199,72199,81C7B7CEB06954770CA2C889DCC58FC5,11161,20,22,2,32,48,1648
72204,72204,082808D93E8688E9598DE50927F17FC1,10111,0,8,8,37,47,1897
72205,72205,082808D93E8688E9598DE50927F17FC1,43234,13,17,4,37,49,1899
72206,72206,082808D93E8688E9598DE50927F17FC1,42401,19,23,4,36,47,1847
72207,72207,10CBCD08F0B06B3479DA3562D07A1BB8,42531,2,9,7,31,45,1595
72208,72208,10CBCD08F0B06B3479DA3562D07A1BB8,12311,11,13,2,30,44,1544
72209,72209,10CBCD08F0B06B3479DA3562D07A1BB8,11324,18,19,1,31,46,1596
72215,72215,66F421352C22D8571066F0AF8EA7BD0D,10251,1,4,3,35,47,1797
72216,72216,66F421352C22D8571066F0AF8EA7BD0D,42161,6,11,5,36,47,1847
72217,72217,66F421352C22D8571066F0AF8EA7BD0D,10251,11,17,6,35,47,1797
72218,72218,66F421352C22D8571066F0AF8EA7BD0D,10491,21,23,2,33,48,1698
72219,72219,1C4D9C3B4ACCE12D2B04BB20561492BF,13271,0,13,13,41,47,2097
72220,72220,1C4D9C3B4ACCE12D2B04BB20561492BF,43041,18,19,1,41,46,2096
72221,72221,1C4D9C3B4ACCE12D2B04BB20561492BF,13221,20,23,3,40,47,2047
72222,72222,A7B416305440E955A1FE8389FFDA2219,12651,0,8,8,43,47,2197
72223,72223,A7B416305440E955A1FE8389FFDA2219,41392,11,14,3,43,48,2198
72224,72224,A7B416305440E955A1FE8389FFDA2219,42321,18,20,2,43,47,2197
72225,72225,D97F93CB7946C1399F01BAA588B11A0C,13911,0,8,8,39,46,1996
72226,72226,D97F93CB7946C1399F01BAA588B11A0C,11261,8,18,10,36,46,1846
72227,72227,D97F93CB7946C1399F01BAA588B11A0C,42351,19,23,4,38,45,1945
72231,72231,F587555054424F7ED0D63829AAEB0C06,11806,0,17,17,41,48,2098
72232,72232,F587555054424F7ED0D63829AAEB0C06,42271,18,20,2,40,47,2047
72233,72233,F587555054424F7ED0D63829AAEB0C06,11806,21,23,2,41,48,2098
72237,72237,7AEC9C7CCBAB2805F6D8B21C69CF29C4,10681,0,5,5,30,48,1548
72238,72238,7AEC9C7CCBAB2805F6D8B21C69CF29C4,10381,6,15,9,31,49,1599
72239,72239,7AEC9C7CCBAB2805F6D8B21C69CF29C4,10681,19,23,4,30,48,1548
72258,72258,2A299573B8ADE5EDDBBA5F82D87A0B34,42921,0,8,8,33,47,1697
72259,72259,2A299573B8ADE5EDDBBA5F82D87A0B34,13601,9,13,4,34,47,1747
72260,72260,2A299573B8ADE5EDDBBA5F82D87A0B34,42921,15,16,1,33,47,1697
72261,72261,2A299573B8ADE5EDDBBA5F82D87A0B34,13601,16,19,3,34,47,1747
72262,72262,72B28316E77049B3B3D9EC9BDF710CF6,42523,0,6,6,31,47,1597
72263,72263,72B28316E77049B3B3D9EC9BDF710CF6,43761,10,15,5,32,47,1647
72264,72264,72B28316E77049B3B3D9EC9BDF710CF6,10341,17,20,3,31,47,1597
72273,72273,23F96418DBDA7106BDBB6C7E2C3432BD,42351,0,8,8,38,45,1945
72274,72274,23F96418DBDA7106BDBB6C7E2C3432BD,42231,9,10,1,37,46,1896
72275,72275,23F96418DBDA7106BDBB6C7E2C3432BD,42351,11,23,12,38,45,1945
72276,72276,E99176074424BF1CA2C083C0DBF3C62C,42221,7,8,1,38,48,1948
72277,72277,E99176074424BF1CA2C083C0DBF3C62C,10111,10,22,12,37,47,1897
72278,72278,E99176074424BF1CA2C083C0DBF3C62C,12514,22,23,1,38,47,1947
72279,72279,FF0C11254BA355CCA708C36EE5C4353D,11381,1,14,13,30,47,1547
72280,72280,FF0C11254BA355CCA708C36EE5C4353D,11061,14,17,3,29,48,1498
72281,72281,FF0C11254BA355CCA708C36EE5C4353D,11381,18,23,5,30,47,1547
72282,72282,A11021665283D6C62A5E3EE561A2FB8C,11261,0,7,7,36,46,1846
72283,72283,A11021665283D6C62A5E3EE561A2FB8C,42351,8,12,4,38,45,1945
72284,72284,A11021665283D6C62A5E3EE561A2FB8C,13911,13,19,6,39,46,1996
72285,72285,A11021665283D6C62A5E3EE561A2FB8C,12511,20,21,1,39,47,1997
72318,72318,61CC7CB5EA609C6320BD2A3529DD90CF,11911,0,5,5,37,48,1898
72319,72319,61CC7CB5EA609C6320BD2A3529DD90CF,10271,7,14,7,37,46,1896
72320,72320,61CC7CB5EA609C6320BD2A3529DD90CF,11911,18,23,5,37,48,1898
72321,72321,758ECA2D694A442FBDD9376D536CAB79,13411,5,6,1,49,42,2492
72322,72322,758ECA2D694A442FBDD9376D536CAB79,43951,8,10,2,49,41,2491
72323,72323,758ECA2D694A442FBDD9376D536CAB79,13411,11,21,10,49,42,2492
72332,72332,9A46CF7192115A07E973A201EDCECB42,11261,0,6,6,36,46,1846
72333,72333,9A46CF7192115A07E973A201EDCECB42,42864,6,11,5,38,44,1944
72334,72334,9A46CF7192115A07E973A201EDCECB42,11261,11,23,12,36,46,1846
72335,72335,31E3C6E91E6520C2C5D7BFDA47CC8641,11061,0,6,6,29,48,1498
72336,72336,31E3C6E91E6520C2C5D7BFDA47CC8641,11381,7,9,2,30,47,1547
72337,72337,31E3C6E91E6520C2C5D7BFDA47CC8641,11061,12,21,9,29,48,1498
72345,72345,4D2A8147712F007D0B336DD71AB7DB54,42161,0,8,8,36,47,1847
72346,72346,4D2A8147712F007D0B336DD71AB7DB54,11531,9,13,4,34,49,1749
72347,72347,4D2A8147712F007D0B336DD71AB7DB54,42161,18,23,5,36,47,1847
72358,72358,DEF2119ECB90D4385AD1A45A0B2C7A35,43761,5,6,1,32,47,1647
72359,72359,DEF2119ECB90D4385AD1A45A0B2C7A35,42523,7,8,1,31,47,1597
72360,72360,DEF2119ECB90D4385AD1A45A0B2C7A35,43761,11,20,9,32,47,1647
72361,72361,1D20B498D42204F7DA0BA75047AF3620,11271,0,12,12,37,48,1898
72362,72362,1D20B498D42204F7DA0BA75047AF3620,10411,15,16,1,36,48,1848
72363,72363,1D20B498D42204F7DA0BA75047AF3620,11271,18,19,1,37,48,1898
72364,72364,1D20B498D42204F7DA0BA75047AF3620,10251,21,23,2,35,47,1797
72376,72376,1BB3CED84B332CED9892B03101C72BBA,12641,8,11,3,10,43,543
72377,72377,1BB3CED84B332CED9892B03101C72BBA,19021,14,15,1,10,45,545
72378,72378,1BB3CED84B332CED9892B03101C72BBA,12641,15,18,3,10,43,543
72419,72419,A584DB5FF6EE02AE16BAE873BBEDDAA1,12921,0,7,7,9,41,491
72420,72420,A584DB5FF6EE02AE16BAE873BBEDDAA1,19181,9,11,2,8,40,440
72421,72421,A584DB5FF6EE02AE16BAE873BBEDDAA1,12921,13,18,5,9,41,491
72422,72422,0277E6ABE6E23FB8B51E9078601CBBC1,42491,0,7,7,32,46,1646
72423,72423,0277E6ABE6E23FB8B51E9078601CBBC1,42523,8,16,8,31,47,1597
72424,72424,0277E6ABE6E23FB8B51E9078601CBBC1,42491,20,23,3,32,46,1646
72430,72430,3DA0BCC83518894F0CE5D638362ECC1B,43731,1,13,12,34,47,1747
72431,72431,3DA0BCC83518894F0CE5D638362ECC1B,10971,14,16,2,35,47,1797
72432,72432,3DA0BCC83518894F0CE5D638362ECC1B,43731,20,23,3,34,47,1747
72433,72433,E1ADA5D6F54060F04D34C1A2CB8FE108,13381,5,6,1,39,47,1997
72434,72434,E1ADA5D6F54060F04D34C1A2CB8FE108,42221,7,8,1,38,48,1948
72435,72435,E1ADA5D6F54060F04D34C1A2CB8FE108,10601,12,21,9,39,47,1997
72441,72441,4B706CBBBDE9BF48F90679E8BB90E0D8,42231,0,14,14,37,46,1896
72442,72442,4B706CBBBDE9BF48F90679E8BB90E0D8,13911,15,17,2,39,46,1996
72443,72443,4B706CBBBDE9BF48F90679E8BB90E0D8,42231,17,23,6,37,46,1896
72466,72466,8E56A2D7B8313A9FB3CAF238A13A9C29,11541,0,13,13,35,49,1799
72467,72467,8E56A2D7B8313A9FB3CAF238A13A9C29,11021,16,21,5,36,49,1849
72468,72468,8E56A2D7B8313A9FB3CAF238A13A9C29,42471,22,23,1,35,49,1799
72469,72469,7B63B781AF1E5C1909C9ECFED6946980,43761,4,12,8,32,47,1647
72470,72470,7B63B781AF1E5C1909C9ECFED6946980,42523,14,16,2,31,47,1597
72471,72471,7B63B781AF1E5C1909C9ECFED6946980,43761,19,23,4,32,47,1647
72477,72477,EA7259828C59286A0C8476F89AAE54B8,11261,0,8,8,36,46,1846
72478,72478,EA7259828C59286A0C8476F89AAE54B8,42351,9,10,1,38,45,1945
72479,72479,EA7259828C59286A0C8476F89AAE54B8,11261,11,23,12,36,46,1846
72480,72480,EDBEDCDD3729803D79956D4495DD48D8,42864,0,4,4,38,44,1944
72481,72481,EDBEDCDD3729803D79956D4495DD48D8,11261,5,6,1,36,46,1846
72482,72482,EDBEDCDD3729803D79956D4495DD48D8,42864,6,7,1,38,44,1944
72483,72483,EDBEDCDD3729803D79956D4495DD48D8,11261,12,21,9,36,46,1846
72484,72484,9732AAAE01C1D221A25A4D45059565D7,41393,2,13,11,43,49,2199
72485,72485,9732AAAE01C1D221A25A4D45059565D7,11011,17,19,2,39,49,1999
72486,72486,9732AAAE01C1D221A25A4D45059565D7,41393,20,23,3,43,49,2199
72510,72510,46D492BAB010922B2E00FA587B30756A,43951,0,14,14,49,41,2491
72511,72511,46D492BAB010922B2E00FA587B30756A,13411,19,21,2,49,42,2492
72512,72512,46D492BAB010922B2E00FA587B30756A,43951,21,23,2,49,41,2491
72520,72520,246B9DA3EFDA0E64D291387D5A19302A,12641,2,5,3,10,43,543
72521,72521,246B9DA3EFDA0E64D291387D5A19302A,19114,8,18,10,7,43,393
72522,72522,246B9DA3EFDA0E64D291387D5A19302A,12641,19,20,1,10,43,543
72527,72527,E89F56AD5A93714B53D26D204A21FEB5,11151,0,8,8,30,48,1548
72528,72528,E89F56AD5A93714B53D26D204A21FEB5,42521,8,9,1,31,47,1597
72529,72529,E89F56AD5A93714B53D26D204A21FEB5,11151,11,23,12,30,48,1548
72530,72530,377BD5B9C037AF000CC29F45169CD1E4,11231,0,8,8,37,49,1899
72531,72531,377BD5B9C037AF000CC29F45169CD1E4,11201,9,12,3,35,49,1799
72532,72532,377BD5B9C037AF000CC29F45169CD1E4,11231,20,21,1,37,49,1899
72540,72540,E1DD7EC86E7282DDD85335B7F6FA4A39,10841,4,7,3,37,47,1897
72541,72541,E1DD7EC86E7282DDD85335B7F6FA4A39,12514,7,14,7,38,47,1947
72542,72542,E1DD7EC86E7282DDD85335B7F6FA4A39,42511,15,23,8,37,47,1897
72563,72563,3F8AA029A47237358846BFDE26AA62B2,11021,0,9,9,36,49,1849
72564,72564,3F8AA029A47237358846BFDE26AA62B2,11751,16,17,1,35,48,1798
72565,72565,3F8AA029A47237358846BFDE26AA62B2,11021,21,23,2,36,49,1849
72566,72566,7158BB5FE54F024DF86B9682428D7D80,43181,0,4,4,39,48,1998
72567,72567,7158BB5FE54F024DF86B9682428D7D80,42581,4,5,1,38,48,1948
72568,72568,7158BB5FE54F024DF86B9682428D7D80,10471,6,17,11,37,48,1898
72569,72569,7158BB5FE54F024DF86B9682428D7D80,42581,21,23,2,38,48,1948
72570,72570,6BA615ABDB457D99CABF3A037F4BEFF7,42301,0,9,9,36,47,1847
72571,72571,6BA615ABDB457D99CABF3A037F4BEFF7,11074,10,14,4,37,47,1897
72572,72572,6BA615ABDB457D99CABF3A037F4BEFF7,42301,16,18,2,36,47,1847
72573,72573,A910A64B88EF93AE4B4F67D39EA167CE,40171,0,16,16,38,48,1948
72574,72574,A910A64B88EF93AE4B4F67D39EA167CE,10471,18,19,1,37,48,1898
72575,72575,A910A64B88EF93AE4B4F67D39EA167CE,40171,21,23,2,38,48,1948
72576,72576,B0895CC09AF6DDBFD1DAF6810DC05EB1,42161,0,8,8,36,47,1847
72577,72577,B0895CC09AF6DDBFD1DAF6810DC05EB1,10841,10,17,7,37,47,1897
72578,72578,B0895CC09AF6DDBFD1DAF6810DC05EB1,42161,18,20,2,36,47,1847
72582,72582,12E15491A96520D831ED1137C9550B9E,11641,0,8,8,22,49,1149
72583,72583,12E15491A96520D831ED1137C9550B9E,42681,8,10,2,24,48,1248
72584,72584,12E15491A96520D831ED1137C9550B9E,11641,15,23,8,22,49,1149
72588,72588,1217F53A8996F8B9AC1C89745896C7AE,12083,0,13,13,36,49,1849
72589,72589,1217F53A8996F8B9AC1C89745896C7AE,11231,13,14,1,37,49,1899
72590,72590,1217F53A8996F8B9AC1C89745896C7AE,10121,19,23,4,36,49,1849
72591,72591,EA9A666FA0B23AFFCF7291147CEC4E64,11231,6,14,8,37,49,1899
72592,72592,EA9A666FA0B23AFFCF7291147CEC4E64,11291,15,17,2,40,49,2049
72593,72593,EA9A666FA0B23AFFCF7291147CEC4E64,11551,19,20,1,39,49,1999
72594,72594,EA9A666FA0B23AFFCF7291147CEC4E64,12083,21,23,2,36,49,1849
72595,72595,A30C3A4D08AE45D5E2F0083CE1F142DF,13111,0,8,8,42,46,2146
72596,72596,A30C3A4D08AE45D5E2F0083CE1F142DF,43061,8,9,1,43,46,2196
72597,72597,A30C3A4D08AE45D5E2F0083CE1F142DF,13111,10,17,7,42,46,2146
72598,72598,A30C3A4D08AE45D5E2F0083CE1F142DF,42204,18,19,1,43,46,2196
72614,72614,6E198FFF8A0EEA3FE2F6EEE55F7012CE,19114,0,5,5,7,43,393
72615,72615,6E198FFF8A0EEA3FE2F6EEE55F7012CE,12641,6,18,12,10,43,543
72616,72616,6E198FFF8A0EEA3FE2F6EEE55F7012CE,19114,19,23,4,7,43,393
72617,72617,895085FE0B62D7BCDF8725B5DB48E546,43971,0,6,6,30,48,1548
72618,72618,895085FE0B62D7BCDF8725B5DB48E546,11061,6,14,8,29,48,1498
72619,72619,895085FE0B62D7BCDF8725B5DB48E546,42521,16,23,7,31,47,1597
72624,72624,AA8CC60B06B8E7A334E7FA04353D8EED,42351,4,5,1,38,45,1945
72625,72625,AA8CC60B06B8E7A334E7FA04353D8EED,42864,6,7,1,38,44,1944
72626,72626,AA8CC60B06B8E7A334E7FA04353D8EED,11261,12,23,11,36,46,1846
72627,72627,519CE2AE351197FBF1FF46D5A72F3CE5,11921,1,8,7,38,48,1948
72628,72628,519CE2AE351197FBF1FF46D5A72F3CE5,10901,19,20,1,35,48,1798
72629,72629,519CE2AE351197FBF1FF46D5A72F3CE5,12514,22,23,1,38,47,1947
72635,72635,87BB4E432E6149A907C48490D8A54E8A,43061,0,7,7,43,46,2196
72636,72636,87BB4E432E6149A907C48490D8A54E8A,40697,12,14,2,43,48,2198
72637,72637,87BB4E432E6149A907C48490D8A54E8A,13111,14,17,3,42,46,2146
72638,72638,87BB4E432E6149A907C48490D8A54E8A,42204,19,22,3,43,46,2196
72639,72639,F62E406B53C8CDF6E3B5DA3DFCCC4ADB,10731,0,9,9,33,47,1697
72640,72640,F62E406B53C8CDF6E3B5DA3DFCCC4ADB,11861,9,17,8,32,47,1647
72641,72641,F62E406B53C8CDF6E3B5DA3DFCCC4ADB,42161,17,23,6,36,47,1847
72642,72642,D5B8C5235ADB84B7998BAE6507D2CE64,10544,2,5,3,28,48,1448
72643,72643,D5B8C5235ADB84B7998BAE6507D2CE64,11061,10,11,1,29,48,1498
72644,72644,D5B8C5235ADB84B7998BAE6507D2CE64,42071,13,20,7,31,49,1599
72645,72645,D5B8C5235ADB84B7998BAE6507D2CE64,43391,20,21,1,29,48,1498
72651,72651,A2437A4AEC8E22627D9794D535E77C0B,12641,3,6,3,10,43,543
72652,72652,A2437A4AEC8E22627D9794D535E77C0B,12921,7,9,2,9,41,491
72653,72653,A2437A4AEC8E22627D9794D535E77C0B,12641,13,16,3,10,43,543
72654,72654,A2437A4AEC8E22627D9794D535E77C0B,12921,17,21,4,9,41,491
72655,72655,101C59298FB3AA270CFCA21777934F37,10381,9,10,1,31,49,1599
72656,72656,101C59298FB3AA270CFCA21777934F37,11381,14,16,2,30,47,1547
72657,72657,101C59298FB3AA270CFCA21777934F37,10381,18,20,2,31,49,1599
72685,72685,700A8469B8648E235281334EF5CC8DA1,11231,0,11,11,37,49,1899
72686,72686,700A8469B8648E235281334EF5CC8DA1,10471,11,14,3,37,48,1898
72687,72687,700A8469B8648E235281334EF5CC8DA1,11231,15,23,8,37,49,1899
72688,72688,981FF39DB0050476FC5E5BA7D49F90F5,11261,0,6,6,36,46,1846
72689,72689,981FF39DB0050476FC5E5BA7D49F90F5,42864,6,7,1,38,44,1944
72690,72690,981FF39DB0050476FC5E5BA7D49F90F5,11261,10,21,11,36,46,1846
72691,72691,981FF39DB0050476FC5E5BA7D49F90F5,42864,22,23,1,38,44,1944
72692,72692,83A6D1034BB6F8EEBB6CDEC1E66034B0,10634,0,3,3,27,45,1395
72693,72693,83A6D1034BB6F8EEBB6CDEC1E66034B0,10351,3,4,1,28,45,1445
72694,72694,83A6D1034BB6F8EEBB6CDEC1E66034B0,10634,4,5,1,27,45,1395
72695,72695,83A6D1034BB6F8EEBB6CDEC1E66034B0,10351,10,19,9,28,45,1445
72696,72696,0AE1F060A9917578AF6CC39BEF4A5FD7,42221,0,5,5,38,48,1948
72697,72697,0AE1F060A9917578AF6CC39BEF4A5FD7,10371,8,18,10,37,49,1899
72698,72698,0AE1F060A9917578AF6CC39BEF4A5FD7,13221,21,22,1,40,47,2047
72699,72699,508DF001F529FBF83DF8D4A342350BFA,11261,2,3,1,36,46,1846
72700,72700,508DF001F529FBF83DF8D4A342350BFA,42861,6,9,3,37,44,1894
72701,72701,508DF001F529FBF83DF8D4A342350BFA,11261,14,17,3,36,46,1846
72702,72702,508DF001F529FBF83DF8D4A342350BFA,42861,18,22,4,37,44,1894
72703,72703,AC44646418C98ED88B49CF71AB62D672,42861,3,4,1,37,44,1894
72704,72704,AC44646418C98ED88B49CF71AB62D672,11261,4,6,2,36,46,1846
72705,72705,AC44646418C98ED88B49CF71AB62D672,42861,8,22,14,37,44,1894
72720,72720,668B25EA27DB62433F6B97341A2F29D6,10251,0,15,15,35,47,1797
72721,72721,668B25EA27DB62433F6B97341A2F29D6,43731,17,20,3,34,47,1747
72722,72722,668B25EA27DB62433F6B97341A2F29D6,10251,21,23,2,35,47,1797
72737,72737,BBB180103068E98D503C4D3D2B6186F0,40302,0,7,7,40,49,2049
72738,72738,BBB180103068E98D503C4D3D2B6186F0,43041,20,21,1,41,46,2096
72739,72739,BBB180103068E98D503C4D3D2B6186F0,40302,22,23,1,40,49,2049
72746,72746,CD55B44A3FD4B718A673CC03711FD344,12921,1,16,15,9,41,491
72747,72747,CD55B44A3FD4B718A673CC03711FD344,12641,19,20,1,10,43,543
72748,72748,CD55B44A3FD4B718A673CC03711FD344,12921,21,23,2,9,41,491
72749,72749,CAF83309DC5164BDCFC4AF3B395E1D5C,10841,0,8,8,37,47,1897
72750,72750,CAF83309DC5164BDCFC4AF3B395E1D5C,10471,10,12,2,37,48,1898
72751,72751,CAF83309DC5164BDCFC4AF3B395E1D5C,11231,16,23,7,37,49,1899
72752,72752,394B81CC36B31D897120A6153D7C1457,11061,0,4,4,29,48,1498
72753,72753,394B81CC36B31D897120A6153D7C1457,12121,6,17,11,29,47,1497
72754,72754,394B81CC36B31D897120A6153D7C1457,11061,18,19,1,29,48,1498
72763,72763,C567BA758C03AD1D2310F8B57DE3E1B4,11261,1,3,2,36,46,1846
72764,72764,C567BA758C03AD1D2310F8B57DE3E1B4,42864,4,15,11,38,44,1944
72765,72765,C567BA758C03AD1D2310F8B57DE3E1B4,11261,17,19,2,36,46,1846
72766,72766,112D73984BEFF27B4D8267205C95643D,13121,1,7,6,38,46,1946
72767,72767,112D73984BEFF27B4D8267205C95643D,42633,12,14,2,42,46,2146
72768,72768,112D73984BEFF27B4D8267205C95643D,13121,20,23,3,38,46,1946
72769,72769,9E3E758D6B4A550CE6D4227B72B6F4A8,11861,1,16,15,32,47,1647
72770,72770,9E3E758D6B4A550CE6D4227B72B6F4A8,11651,17,18,1,33,47,1697
72771,72771,9E3E758D6B4A550CE6D4227B72B6F4A8,11861,18,23,5,32,47,1647
72775,72775,642C5FCC730BC5A54E2036C81E432BC6,19114,0,11,11,7,43,393
72776,72776,642C5FCC730BC5A54E2036C81E432BC6,12641,15,19,4,10,43,543
72777,72777,642C5FCC730BC5A54E2036C81E432BC6,19114,20,23,3,7,43,393
72783,72783,BDC7340C36162ED34895F60F58C9CF3D,11231,0,5,5,37,49,1899
72784,72784,BDC7340C36162ED34895F60F58C9CF3D,12083,6,7,1,36,49,1849
72785,72785,BDC7340C36162ED34895F60F58C9CF3D,11231,7,15,8,37,49,1899
72786,72786,BDC7340C36162ED34895F60F58C9CF3D,10901,18,19,1,35,48,1798
72787,72787,43AA632E12ABCA3F01D2033AFFAEDEF3,10151,0,8,8,34,47,1747
72788,72788,43AA632E12ABCA3F01D2033AFFAEDEF3,11841,13,14,1,33,46,1696
72789,72789,43AA632E12ABCA3F01D2033AFFAEDEF3,10151,16,23,7,34,47,1747
72796,72796,99215A6EE9EE45501EC0F8414BE04C65,42041,1,2,1,10,47,547
72797,72797,99215A6EE9EE45501EC0F8414BE04C65,19441,7,12,5,8,46,446
72798,72798,99215A6EE9EE45501EC0F8414BE04C65,42041,14,16,2,10,47,547
72799,72799,99215A6EE9EE45501EC0F8414BE04C65,19441,17,22,5,8,46,446
72800,72800,2E8B764495F8C75B1A6E74CD6E6D7095,42921,0,6,6,33,47,1697
72801,72801,2E8B764495F8C75B1A6E74CD6E6D7095,10292,10,17,7,30,47,1547
72802,72802,2E8B764495F8C75B1A6E74CD6E6D7095,10731,19,21,2,33,47,1697
72814,72814,6EA4CCEDBFDE801AE8D11614A06A0C5C,11281,0,4,4,27,40,1390
72815,72815,6EA4CCEDBFDE801AE8D11614A06A0C5C,13671,9,14,5,27,43,1393
72816,72816,6EA4CCEDBFDE801AE8D11614A06A0C5C,11281,14,23,9,27,40,1390
72822,72822,72EE059838FC074BF0955787969E7967,12083,0,4,4,36,49,1849
72823,72823,72EE059838FC074BF0955787969E7967,11911,5,13,8,37,48,1898
72824,72824,72EE059838FC074BF0955787969E7967,11231,19,23,4,37,49,1899
72832,72832,91284BBE72A4661BF1E53E3FAFD2E3D8,13651,0,14,14,30,47,1547
72833,72833,91284BBE72A4661BF1E53E3FAFD2E3D8,42523,17,19,2,31,47,1597
72834,72834,91284BBE72A4661BF1E53E3FAFD2E3D8,13651,20,23,3,30,47,1547
72835,72835,DDF363C64B8F6ACF3450F0B1AA087EA1,19441,0,10,10,8,46,446
72836,72836,DDF363C64B8F6ACF3450F0B1AA087EA1,42041,11,12,1,10,47,547
72837,72837,DDF363C64B8F6ACF3450F0B1AA087EA1,19441,16,22,6,8,46,446
72848,72848,9F7BD4B191C6CDB262073FE9BC5F12C5,11381,0,4,4,30,47,1547
72849,72849,9F7BD4B191C6CDB262073FE9BC5F12C5,11061,4,5,1,29,48,1498
72850,72850,9F7BD4B191C6CDB262073FE9BC5F12C5,11381,7,21,14,30,47,1547
72851,72851,9B8E3A84EF821A3E9564A6D6EAEA0FE5,11914,1,7,6,37,48,1898
72852,72852,9B8E3A84EF821A3E9564A6D6EAEA0FE5,42581,7,9,2,38,48,1948
72853,72853,9B8E3A84EF821A3E9564A6D6EAEA0FE5,11914,14,23,9,37,48,1898
72854,72854,8E0D20320C5276BDD797BA6D65B9C51D,11074,0,7,7,37,47,1897
72855,72855,8E0D20320C5276BDD797BA6D65B9C51D,11231,8,17,9,37,49,1899
72856,72856,8E0D20320C5276BDD797BA6D65B9C51D,11074,19,23,4,37,47,1897
72876,72876,DF6451E86EE4B7B98BCA60FC558F51EE,11061,0,1,1,29,48,1498
72877,72877,DF6451E86EE4B7B98BCA60FC558F51EE,11151,2,8,6,30,48,1548
72878,72878,DF6451E86EE4B7B98BCA60FC558F51EE,12121,10,17,7,29,47,1497
72879,72879,DF6451E86EE4B7B98BCA60FC558F51EE,11061,17,19,2,29,48,1498
72890,72890,511248B31413344B77C12D74A5EE7CDF,43471,0,6,6,31,49,1599
72891,72891,511248B31413344B77C12D74A5EE7CDF,11151,7,12,5,30,48,1548
72892,72892,511248B31413344B77C12D74A5EE7CDF,11061,12,19,7,29,48,1498
72893,72893,511248B31413344B77C12D74A5EE7CDF,43471,20,23,3,31,49,1599
72894,72894,DA48F6EEC4784B4505CA1BBB58EA121A,10341,0,8,8,31,47,1597
72895,72895,DA48F6EEC4784B4505CA1BBB58EA121A,10292,8,12,4,30,47,1547
72896,72896,DA48F6EEC4784B4505CA1BBB58EA121A,10341,12,16,4,31,47,1597
72897,72897,DA48F6EEC4784B4505CA1BBB58EA121A,10292,18,23,5,30,47,1547
72898,72898,821AF5EB52A2D1F024AF220A9E4C3FF0,10634,0,12,12,27,45,1395
72899,72899,821AF5EB52A2D1F024AF220A9E4C3FF0,11871,13,14,1,29,46,1496
72900,72900,821AF5EB52A2D1F024AF220A9E4C3FF0,10634,17,23,6,27,45,1395
72901,72901,19F35C7E03D2EBAE8BD31B0C4B1200F3,41021,0,12,12,38,47,1947
72902,72902,19F35C7E03D2EBAE8BD31B0C4B1200F3,11074,13,15,2,37,47,1897
72903,72903,19F35C7E03D2EBAE8BD31B0C4B1200F3,41021,19,23,4,38,47,1947
72910,72910,647D85F41DB91010F5EBA85FDA450BC1,42351,2,3,1,38,45,1945
72911,72911,647D85F41DB91010F5EBA85FDA450BC1,11261,5,15,10,36,46,1846
72912,72912,647D85F41DB91010F5EBA85FDA450BC1,13911,16,17,1,39,46,1996
72913,72913,647D85F41DB91010F5EBA85FDA450BC1,11261,18,22,4,36,46,1846
72914,72914,B52DA5CE394FCCA44C8B27B2E95043CF,11541,4,8,4,35,49,1799
72915,72915,B52DA5CE394FCCA44C8B27B2E95043CF,43671,9,18,9,35,48,1798
72916,72916,B52DA5CE394FCCA44C8B27B2E95043CF,11791,20,23,3,38,49,1949
72932,72932,0933B06061F8F3536F06AEF0D300106F,13711,0,6,6,38,46,1946
72933,72933,0933B06061F8F3536F06AEF0D300106F,11941,9,11,2,37,46,1896
72934,72934,0933B06061F8F3536F06AEF0D300106F,13711,11,13,2,38,46,1946
72935,72935,0933B06061F8F3536F06AEF0D300106F,11941,17,18,1,37,46,1896
72948,72948,7779D5C4E5073D864A9050EB76A5AC64,11261,0,12,12,36,46,1846
72949,72949,7779D5C4E5073D864A9050EB76A5AC64,42351,16,17,1,38,45,1945
72950,72950,7779D5C4E5073D864A9050EB76A5AC64,11261,18,22,4,36,46,1846
72951,72951,4728D5A73A2EFDE289935E01180F11D6,42523,8,12,4,31,47,1597
72952,72952,4728D5A73A2EFDE289935E01180F11D6,43761,14,16,2,32,47,1647
72953,72953,4728D5A73A2EFDE289935E01180F11D6,42523,19,21,2,31,47,1597
72957,72957,30F94368F131A73FAC48CF4BAF636AD7,42161,0,7,7,36,47,1847
72958,72958,30F94368F131A73FAC48CF4BAF636AD7,13681,7,18,11,38,47,1947
72959,72959,30F94368F131A73FAC48CF4BAF636AD7,42161,20,23,3,36,47,1847
72960,72960,2FA830A3F4936C72A1774CB1227927A5,42161,0,7,7,36,47,1847
72961,72961,2FA830A3F4936C72A1774CB1227927A5,12131,11,17,6,32,47,1647
72962,72962,2FA830A3F4936C72A1774CB1227927A5,42161,18,23,5,36,47,1847
72963,72963,2EFEA3D9E50D1587D2C8297E61F47270,11091,0,4,4,29,47,1497
72964,72964,2EFEA3D9E50D1587D2C8297E61F47270,42523,4,6,2,31,47,1597
72965,72965,2EFEA3D9E50D1587D2C8297E61F47270,10711,8,9,1,29,46,1496
72966,72966,2EFEA3D9E50D1587D2C8297E61F47270,11091,12,22,10,29,47,1497
72967,72967,69E543DFF7ABD4903EB302CAAC6962DA,42221,2,8,6,38,48,1948
72968,72968,69E543DFF7ABD4903EB302CAAC6962DA,42471,13,16,3,35,49,1799
72969,72969,69E543DFF7ABD4903EB302CAAC6962DA,11591,16,18,2,36,49,1849
72970,72970,1C1BDEE72C59AB3D15F95F838C21E5AB,19441,0,5,5,8,46,446
72971,72971,1C1BDEE72C59AB3D15F95F838C21E5AB,19821,7,9,2,4,46,246
72972,72972,1C1BDEE72C59AB3D15F95F838C21E5AB,12621,9,11,2,10,48,548
72973,72973,1C1BDEE72C59AB3D15F95F838C21E5AB,19441,12,23,11,8,46,446
72987,72987,5C633B6A90713EC538BFB33DCFC3172F,13911,0,2,2,39,46,1996
72988,72988,5C633B6A90713EC538BFB33DCFC3172F,42351,2,3,1,38,45,1945
72989,72989,5C633B6A90713EC538BFB33DCFC3172F,13911,5,23,18,39,46,1996
72995,72995,0369BFD5F10C91495A6A2CBDCDE954D4,12311,2,12,10,30,44,1544
72996,72996,0369BFD5F10C91495A6A2CBDCDE954D4,42531,15,19,4,31,45,1595
72997,72997,0369BFD5F10C91495A6A2CBDCDE954D4,12311,20,21,1,30,44,1544
73006,73006,E131C5415CA4464B2E2B8BBC4B15D17C,10221,10,14,4,34,49,1749
73007,73007,E131C5415CA4464B2E2B8BBC4B15D17C,11541,19,20,1,35,49,1799
73008,73008,E131C5415CA4464B2E2B8BBC4B15D17C,11211,21,22,1,34,49,1749
73015,73015,1444CF26498FCF95995CE1D21CF4BAA6,11381,1,5,4,30,47,1547
73016,73016,1444CF26498FCF95995CE1D21CF4BAA6,42871,7,17,10,30,45,1545
73017,73017,1444CF26498FCF95995CE1D21CF4BAA6,10951,20,21,1,29,48,1498
73018,73018,6FD90BBCA41A13F318953E2375C6300B,42231,5,8,3,37,46,1896
73019,73019,6FD90BBCA41A13F318953E2375C6300B,13911,11,19,8,39,46,1996
73020,73020,6FD90BBCA41A13F318953E2375C6300B,11261,19,23,4,36,46,1846
73024,73024,DDC9326A6FAC62E165227AA5AC2BB968,13371,0,4,4,41,47,2097
73025,73025,DDC9326A6FAC62E165227AA5AC2BB968,10821,5,12,7,40,47,2047
73026,73026,DDC9326A6FAC62E165227AA5AC2BB968,13371,12,23,11,41,47,2097
73032,73032,0BC1BC9FA127A76D4558FF0A0EC8FEFB,42921,0,6,6,33,47,1697
73033,73033,0BC1BC9FA127A76D4558FF0A0EC8FEFB,10281,8,10,2,33,48,1698
73034,73034,0BC1BC9FA127A76D4558FF0A0EC8FEFB,42921,13,22,9,33,47,1697
73035,73035,2FD1A56633A66A4012C7EE1123A29268,12921,0,19,19,9,41,491
73036,73036,2FD1A56633A66A4012C7EE1123A29268,19181,19,21,2,8,40,440
73037,73037,2FD1A56633A66A4012C7EE1123A29268,12921,21,23,2,9,41,491
73038,73038,D9FB9F3F4820A4EF951566780A770C45,11261,1,7,6,36,46,1846
73039,73039,D9FB9F3F4820A4EF951566780A770C45,13911,7,10,3,39,46,1996
73040,73040,D9FB9F3F4820A4EF951566780A770C45,11261,13,22,9,36,46,1846
73041,73041,BE0A979268FF24891DDE75D2D876AB55,13331,0,8,8,38,47,1947
73042,73042,BE0A979268FF24891DDE75D2D876AB55,13121,10,11,1,38,46,1946
73043,73043,BE0A979268FF24891DDE75D2D876AB55,13681,11,22,11,38,47,1947
73044,73044,BE0A979268FF24891DDE75D2D876AB55,13121,22,23,1,38,46,1946
73067,73067,7C98BDF484E2B085C51A4945E804FC0C,42151,1,14,13,35,45,1795
73068,73068,7C98BDF484E2B085C51A4945E804FC0C,12491,14,16,2,36,43,1843
73069,73069,7C98BDF484E2B085C51A4945E804FC0C,42151,17,19,2,35,45,1795
73076,73076,B7832DB383CB1E7DD6C87A81AAE89D66,11914,1,2,1,37,48,1898
73077,73077,B7832DB383CB1E7DD6C87A81AAE89D66,11074,3,5,2,37,47,1897
73078,73078,B7832DB383CB1E7DD6C87A81AAE89D66,42221,6,19,13,38,48,1948
73079,73079,B7832DB383CB1E7DD6C87A81AAE89D66,11914,22,23,1,37,48,1898
73092,73092,55B62CF97C3AEC62D987D2F1F6626FBA,10771,0,6,6,41,46,2096
73093,73093,55B62CF97C3AEC62D987D2F1F6626FBA,13711,7,14,7,38,46,1946
73094,73094,55B62CF97C3AEC62D987D2F1F6626FBA,42311,19,23,4,41,46,2096
73102,73102,A922D7161F816C1FD25F52BCCB616DFE,40673,0,4,4,36,48,1848
73103,73103,A922D7161F816C1FD25F52BCCB616DFE,42401,5,6,1,36,47,1847
73104,73104,A922D7161F816C1FD25F52BCCB616DFE,10251,8,22,14,35,47,1797
73105,73105,CD5264FA94F0D7079560625C6CCF7D91,13711,4,17,13,38,46,1946
73106,73106,CD5264FA94F0D7079560625C6CCF7D91,10271,18,19,1,37,46,1896
73107,73107,CD5264FA94F0D7079560625C6CCF7D91,13711,20,21,1,38,46,1946
73112,73112,F6D5F0720A4C82E72FD0C591B5570DDC,10381,0,9,9,31,49,1599
73113,73113,F6D5F0720A4C82E72FD0C591B5570DDC,10431,9,14,5,33,49,1699
73114,73114,F6D5F0720A4C82E72FD0C591B5570DDC,10381,21,23,2,31,49,1599
73115,73115,CC1D3C2DA42F1EBED6688749C3DA1D87,11381,2,11,9,30,47,1547
73116,73116,CC1D3C2DA42F1EBED6688749C3DA1D87,43971,12,13,1,30,48,1548
73117,73117,CC1D3C2DA42F1EBED6688749C3DA1D87,11381,14,23,9,30,47,1547
73122,73122,6A72A6369674993FC322A428033222FA,42321,2,14,12,43,47,2197
73123,73123,6A72A6369674993FC322A428033222FA,11001,14,16,2,42,47,2147
73124,73124,6A72A6369674993FC322A428033222FA,42321,18,20,2,43,47,2197
73125,73125,8CD5156CF883DA15618BAFE58DDCF2A7,42581,0,3,3,38,48,1948
73126,73126,8CD5156CF883DA15618BAFE58DDCF2A7,11914,7,11,4,37,48,1898
73127,73127,8CD5156CF883DA15618BAFE58DDCF2A7,42581,12,23,11,38,48,1948
73140,73140,3D4D278B3D58167073B4ACCB11432DB2,13094,0,5,5,21,42,1092
73141,73141,3D4D278B3D58167073B4ACCB11432DB2,12671,6,19,13,21,43,1093
73142,73142,3D4D278B3D58167073B4ACCB11432DB2,13091,21,22,1,20,42,1042
73143,73143,D9B0439F3B0C81F4C0A4571FAB2A3A71,42021,0,2,2,33,47,1697
73144,73144,D9B0439F3B0C81F4C0A4571FAB2A3A71,11861,6,13,7,32,47,1647
73145,73145,D9B0439F3B0C81F4C0A4571FAB2A3A71,10731,18,22,4,33,47,1697
73146,73146,CC7E7DF0F02E94D2EADBA1C641E823D8,11861,10,18,8,32,47,1647
73147,73147,CC7E7DF0F02E94D2EADBA1C641E823D8,10491,19,20,1,33,48,1698
73148,73148,CC7E7DF0F02E94D2EADBA1C641E823D8,11861,21,23,2,32,47,1647
73149,73149,4B5C492CF16B079882322240829D6566,11231,6,7,1,37,49,1899
73150,73150,4B5C492CF16B079882322240829D6566,43281,11,13,2,37,48,1898
73151,73151,4B5C492CF16B079882322240829D6566,11231,17,23,6,37,49,1899
73152,73152,31C99BE35DAA7CC1D9A6D662CA3683F3,41021,10,14,4,38,47,1947
73153,73153,31C99BE35DAA7CC1D9A6D662CA3683F3,42331,16,17,1,39,46,1996
73154,73154,31C99BE35DAA7CC1D9A6D662CA3683F3,42511,17,18,1,37,47,1897
73164,73164,E45B0EC44E00842EDD865C65A561543D,11791,0,8,8,38,49,1949
73165,73165,E45B0EC44E00842EDD865C65A561543D,11231,9,10,1,37,49,1899
73166,73166,E45B0EC44E00842EDD865C65A561543D,43281,11,20,9,37,48,1898
73183,73183,FEEC51D3E0174A44828BCD70E82C0CC7,11551,0,8,8,39,49,1999
73184,73184,FEEC51D3E0174A44828BCD70E82C0CC7,13121,13,14,1,38,46,1946
73185,73185,FEEC51D3E0174A44828BCD70E82C0CC7,10821,18,21,3,40,47,2047
73190,73190,8D75EC7608DEEC520A412E824B107B5A,43761,0,7,7,32,47,1647
73191,73191,8D75EC7608DEEC520A412E824B107B5A,42521,8,20,12,31,47,1597
73192,73192,8D75EC7608DEEC520A412E824B107B5A,43761,21,23,2,32,47,1647
73222,73222,392F2B932A839BB0C6F602E5FA556570,11074,0,6,6,37,47,1897
73223,73223,392F2B932A839BB0C6F602E5FA556570,10601,9,12,3,39,47,1997
73224,73224,392F2B932A839BB0C6F602E5FA556570,11074,12,23,11,37,47,1897
73225,73225,BF11F158BB981034C1A44258D3F4A9AC,11381,0,2,2,30,47,1547
73226,73226,BF11F158BB981034C1A44258D3F4A9AC,42523,2,19,17,31,47,1597
73227,73227,BF11F158BB981034C1A44258D3F4A9AC,11061,19,23,4,29,48,1498
73231,73231,47E88EEB0ACD8A050A018340BD482B6B,42583,0,2,2,40,48,2048
73232,73232,47E88EEB0ACD8A050A018340BD482B6B,13381,3,6,3,39,47,1997
73233,73233,47E88EEB0ACD8A050A018340BD482B6B,11074,9,22,13,37,47,1897
73253,73253,14A1D28CFB86846C191D32B8CA935119,13511,0,1,1,34,48,1748
73254,73254,14A1D28CFB86846C191D32B8CA935119,10681,3,13,10,30,48,1548
73255,73255,14A1D28CFB86846C191D32B8CA935119,42521,14,17,3,31,47,1597
73256,73256,14A1D28CFB86846C191D32B8CA935119,40445,18,23,5,30,48,1548
73266,73266,69402671B7928290476FCE1242C8E0A9,11061,0,10,10,29,48,1498
73267,73267,69402671B7928290476FCE1242C8E0A9,11381,12,14,2,30,47,1547
73268,73268,69402671B7928290476FCE1242C8E0A9,11061,18,23,5,29,48,1498
73288,73288,34742BC5A2A667B03D313FF35D998A11,42161,0,13,13,36,47,1847
73289,73289,34742BC5A2A667B03D313FF35D998A11,11074,15,16,1,37,47,1897
73290,73290,34742BC5A2A667B03D313FF35D998A11,13121,21,22,1,38,46,1946
73307,73307,449E7811DCD6E8CD500501049B5A906E,13911,3,16,13,39,46,1996
73308,73308,449E7811DCD6E8CD500501049B5A906E,11261,16,18,2,36,46,1846
73309,73309,449E7811DCD6E8CD500501049B5A906E,13911,19,20,1,39,46,1996
73347,73347,CF7DA1891D00F069E0E0214450037183,11061,0,1,1,29,48,1498
73348,73348,CF7DA1891D00F069E0E0214450037183,11381,1,7,6,30,47,1547
73349,73349,CF7DA1891D00F069E0E0214450037183,11061,7,23,16,29,48,1498
73365,73365,ECEB1342A1EB2D152DA98DC0CA47ED06,42581,1,10,9,38,48,1948
73366,73366,ECEB1342A1EB2D152DA98DC0CA47ED06,10471,11,13,2,37,48,1898
73367,73367,ECEB1342A1EB2D152DA98DC0CA47ED06,42581,13,15,2,38,48,1948
73368,73368,ECEB1342A1EB2D152DA98DC0CA47ED06,10471,18,23,5,37,48,1898
73369,73369,D7EAC5D0A8923EFA7A868664FAB3C316,42231,0,13,13,37,46,1896
73370,73370,D7EAC5D0A8923EFA7A868664FAB3C316,13911,14,16,2,39,46,1996
73371,73371,D7EAC5D0A8923EFA7A868664FAB3C316,42231,17,23,6,37,46,1896
73372,73372,2F8FBE6FB38F00CB192B148FD4827906,42321,0,1,1,43,47,2197
73373,73373,2F8FBE6FB38F00CB192B148FD4827906,11701,1,12,11,43,48,2198
73374,73374,2F8FBE6FB38F00CB192B148FD4827906,42321,12,14,2,43,47,2197
73375,73375,2F8FBE6FB38F00CB192B148FD4827906,11701,15,22,7,43,48,2198
73376,73376,F5E1FADD1A2B73E311D54EEEF39B7046,42601,1,2,1,44,48,2248
73377,73377,F5E1FADD1A2B73E311D54EEEF39B7046,43621,2,5,3,46,48,2348
73378,73378,F5E1FADD1A2B73E311D54EEEF39B7046,11701,7,13,6,43,48,2198
73379,73379,F5E1FADD1A2B73E311D54EEEF39B7046,43621,13,21,8,46,48,2348
73380,73380,FCA3C665B5BF337F331669EDB597A6AC,42791,0,8,8,35,45,1795
73381,73381,FCA3C665B5BF337F331669EDB597A6AC,13121,10,15,5,38,46,1946
73382,73382,FCA3C665B5BF337F331669EDB597A6AC,10271,17,18,1,37,46,1896
73383,73383,FCA3C665B5BF337F331669EDB597A6AC,42791,21,22,1,35,45,1795
73384,73384,01766EF3CBCA4165E365CA6048DDBCDC,43731,2,6,4,34,47,1747
73385,73385,01766EF3CBCA4165E365CA6048DDBCDC,42921,10,15,5,33,47,1697
73386,73386,01766EF3CBCA4165E365CA6048DDBCDC,43731,15,17,2,34,47,1747
73387,73387,01766EF3CBCA4165E365CA6048DDBCDC,42021,21,23,2,33,47,1697
73388,73388,43D5A4B21D49F330FF46E8A3E900BDBD,42961,0,7,7,35,49,1799
73389,73389,43D5A4B21D49F330FF46E8A3E900BDBD,11231,12,17,5,37,49,1899
73390,73390,43D5A4B21D49F330FF46E8A3E900BDBD,10901,18,23,5,35,48,1798
73391,73391,D5C29F54FD64D9CE1AEFE2D9CA4F33A5,13271,1,7,6,41,47,2097
73392,73392,D5C29F54FD64D9CE1AEFE2D9CA4F33A5,13101,11,13,2,40,47,2047
73393,73393,D5C29F54FD64D9CE1AEFE2D9CA4F33A5,13271,13,15,2,41,47,2097
73394,73394,D5C29F54FD64D9CE1AEFE2D9CA4F33A5,13101,18,21,3,40,47,2047
73401,73401,8FFDEB2573593D2EBFD07303D94AB87F,42321,0,9,9,43,47,2197
73402,73402,8FFDEB2573593D2EBFD07303D94AB87F,10801,10,11,1,42,47,2147
73403,73403,8FFDEB2573593D2EBFD07303D94AB87F,42321,12,23,11,43,47,2197
73404,73404,5AE01E0855C376D332DFE198AAE26723,42871,0,7,7,30,45,1545
73405,73405,5AE01E0855C376D332DFE198AAE26723,10716,8,19,11,30,46,1546
73406,73406,5AE01E0855C376D332DFE198AAE26723,11871,19,20,1,29,46,1496
73431,73431,1F5F12E31F77D0569EB02D1A77314801,10681,0,2,2,30,48,1548
73432,73432,1F5F12E31F77D0569EB02D1A77314801,11061,2,10,8,29,48,1498
73433,73433,1F5F12E31F77D0569EB02D1A77314801,40331,12,19,7,30,47,1547
73438,73438,F97249A6324768A56E44D27A08FDE9D8,11941,0,10,10,37,46,1896
73439,73439,F97249A6324768A56E44D27A08FDE9D8,40951,13,15,2,36,49,1849
73440,73440,F97249A6324768A56E44D27A08FDE9D8,11941,18,23,5,37,46,1896
73445,73445,63237B200FFEDBAC566B983F8F861D76,10661,0,7,7,37,49,1899
73446,73446,63237B200FFEDBAC566B983F8F861D76,11531,14,17,3,34,49,1749
73447,73447,63237B200FFEDBAC566B983F8F861D76,10661,19,22,3,37,49,1899
73454,73454,B2012EE6BD195EC80673B0F2B5EC1C5E,12921,0,9,9,9,41,491
73455,73455,B2012EE6BD195EC80673B0F2B5EC1C5E,49201,11,13,2,7,41,391
73456,73456,B2012EE6BD195EC80673B0F2B5EC1C5E,12641,16,22,6,10,43,543
73467,73467,21BFC9B680F0329C7CDCB5AE45B398FD,10111,0,11,11,37,47,1897
73468,73468,21BFC9B680F0329C7CDCB5AE45B398FD,40637,12,21,9,36,47,1847
73469,73469,21BFC9B680F0329C7CDCB5AE45B398FD,10111,21,22,1,37,47,1897
73470,73470,99165E654E4A5840EA37FC83361CE61B,42581,3,11,8,38,48,1948
73471,73471,99165E654E4A5840EA37FC83361CE61B,11914,14,20,6,37,48,1898
73472,73472,99165E654E4A5840EA37FC83361CE61B,42581,20,23,3,38,48,1948
73473,73473,2E7CC4EF44F5328D020B21B2138E3C1D,11061,1,13,12,29,48,1498
73474,73474,2E7CC4EF44F5328D020B21B2138E3C1D,12381,16,18,2,32,48,1648
73475,73475,2E7CC4EF44F5328D020B21B2138E3C1D,11061,18,20,2,29,48,1498
73490,73490,588E15A77FCC47ACFBD5B3F12EED10C8,13111,0,7,7,42,46,2146
73491,73491,588E15A77FCC47ACFBD5B3F12EED10C8,10771,8,11,3,41,46,2096
73492,73492,588E15A77FCC47ACFBD5B3F12EED10C8,13111,12,23,11,42,46,2146
73493,73493,7A6C1F91C08B692A643E0B4791AE2CE6,12521,0,7,7,35,41,1791
73494,73494,7A6C1F91C08B692A643E0B4791AE2CE6,43451,8,9,1,37,40,1890
73495,73495,7A6C1F91C08B692A643E0B4791AE2CE6,12521,12,23,11,35,41,1791
73503,73503,4EABE655BE26B3EDCCD7B6B2C89F187F,10161,0,7,7,35,49,1799
73504,73504,4EABE655BE26B3EDCCD7B6B2C89F187F,11231,8,15,7,37,49,1899
73505,73505,4EABE655BE26B3EDCCD7B6B2C89F187F,10161,16,23,7,35,49,1799
73512,73512,267A36CBF6FADE60E151261B3CF154A0,10411,0,8,8,36,48,1848
73513,73513,267A36CBF6FADE60E151261B3CF154A0,11271,13,17,4,37,48,1898
73514,73514,267A36CBF6FADE60E151261B3CF154A0,11231,20,23,3,37,49,1899
73515,73515,FE84C5B6FD29AD1D9C75D32BF19FA780,42861,0,7,7,37,44,1894
73516,73516,FE84C5B6FD29AD1D9C75D32BF19FA780,11261,9,18,9,36,46,1846
73517,73517,FE84C5B6FD29AD1D9C75D32BF19FA780,42861,19,21,2,37,44,1894
73525,73525,BC3507BB18C0A44FC993D8B041281F6D,43731,0,13,13,34,47,1747
73526,73526,BC3507BB18C0A44FC993D8B041281F6D,10731,18,22,4,33,47,1697
73527,73527,BC3507BB18C0A44FC993D8B041281F6D,10971,22,23,1,35,47,1797
73554,73554,1E2BDCE897234CB8450E391543ADF518,42351,7,9,2,38,45,1945
73555,73555,1E2BDCE897234CB8450E391543ADF518,11261,9,11,2,36,46,1846
73556,73556,1E2BDCE897234CB8450E391543ADF518,42351,11,13,2,38,45,1945
73557,73557,1E2BDCE897234CB8450E391543ADF518,11261,17,18,1,36,46,1846
73558,73558,F41A8974955ECE62F73018566CCACF3F,11591,0,1,1,36,49,1849
73559,73559,F41A8974955ECE62F73018566CCACF3F,42471,2,3,1,35,49,1799
73560,73560,F41A8974955ECE62F73018566CCACF3F,10121,3,13,10,36,49,1849
73561,73561,F41A8974955ECE62F73018566CCACF3F,42471,17,18,1,35,49,1799
73567,73567,7C66DF9B4CFCFA1F927E3E567C62A056,10911,0,6,6,39,46,1996
73568,73568,7C66DF9B4CFCFA1F927E3E567C62A056,13711,7,9,2,38,46,1946
73569,73569,7C66DF9B4CFCFA1F927E3E567C62A056,10911,12,23,11,39,46,1996
73610,73610,333863A2CE0A7D471D7CF76BFFDAB0D7,19744,3,5,2,6,43,343
73611,73611,333863A2CE0A7D471D7CF76BFFDAB0D7,12641,6,8,2,10,43,543
73612,73612,333863A2CE0A7D471D7CF76BFFDAB0D7,19744,9,11,2,6,43,343
73613,73613,333863A2CE0A7D471D7CF76BFFDAB0D7,12641,13,19,6,10,43,543
73619,73619,17BFCEDD973B29E8302E2E7670AFE303,10471,0,8,8,37,48,1898
73620,73620,17BFCEDD973B29E8302E2E7670AFE303,40171,12,14,2,38,48,1948
73621,73621,17BFCEDD973B29E8302E2E7670AFE303,10471,15,22,7,37,48,1898
73622,73622,D21AD56E1413F233CB19B53125C6F06A,11591,2,16,14,36,49,1849
73623,73623,D21AD56E1413F233CB19B53125C6F06A,11231,18,19,1,37,49,1899
73624,73624,D21AD56E1413F233CB19B53125C6F06A,40277,20,22,2,35,49,1799
73625,73625,47E9EF56D8CE8DCA9D41DC376D04BFD1,13381,0,12,12,39,47,1997
73626,73626,47E9EF56D8CE8DCA9D41DC376D04BFD1,13331,14,16,2,38,47,1947
73627,73627,47E9EF56D8CE8DCA9D41DC376D04BFD1,12511,19,20,1,39,47,1997
73628,73628,47E9EF56D8CE8DCA9D41DC376D04BFD1,11074,22,23,1,37,47,1897
73637,73637,F0BADC1DB10F78BE87B4AA8A7F62B3BC,12921,1,18,17,9,41,491
73638,73638,F0BADC1DB10F78BE87B4AA8A7F62B3BC,12641,18,20,2,10,43,543
73639,73639,F0BADC1DB10F78BE87B4AA8A7F62B3BC,12921,20,21,1,9,41,491
73645,73645,744AB7DADF8BF013AE569AC359219521,11541,0,7,7,35,49,1799
73646,73646,744AB7DADF8BF013AE569AC359219521,11211,10,12,2,34,49,1749
73647,73647,744AB7DADF8BF013AE569AC359219521,13561,14,16,2,37,49,1899
73648,73648,744AB7DADF8BF013AE569AC359219521,11541,18,19,1,35,49,1799
73652,73652,94A66B099C3B286235DEE73BAE7FEB6C,11861,2,9,7,32,47,1647
73653,73653,94A66B099C3B286235DEE73BAE7FEB6C,10281,10,19,9,33,48,1698
73654,73654,94A66B099C3B286235DEE73BAE7FEB6C,11861,20,22,2,32,47,1647
73658,73658,A6F4E0A14DDF72AB1602B3834CD2AC43,11914,0,13,13,37,48,1898
73659,73659,A6F4E0A14DDF72AB1602B3834CD2AC43,43361,14,18,4,38,48,1948
73660,73660,A6F4E0A14DDF72AB1602B3834CD2AC43,11914,19,21,2,37,48,1898
73661,73661,774D58D54FF2438AE9FE14077D32EF74,11951,0,6,6,31,49,1599
73662,73662,774D58D54FF2438AE9FE14077D32EF74,13731,16,17,1,33,49,1699
73663,73663,774D58D54FF2438AE9FE14077D32EF74,11954,19,23,4,32,49,1649
73664,73664,BB272A37143F27FF71ADC6EC8425DD40,42321,6,7,1,43,47,2197
73665,73665,BB272A37143F27FF71ADC6EC8425DD40,11001,11,19,8,42,47,2147
73666,73666,BB272A37143F27FF71ADC6EC8425DD40,42321,20,21,1,43,47,2197
73687,73687,D4B4B4E3A7A4BCB80292B7DC4CB75F9E,11351,0,3,3,36,48,1848
73688,73688,D4B4B4E3A7A4BCB80292B7DC4CB75F9E,10251,4,5,1,35,47,1797
73689,73689,D4B4B4E3A7A4BCB80292B7DC4CB75F9E,42161,5,17,12,36,47,1847
73690,73690,D4B4B4E3A7A4BCB80292B7DC4CB75F9E,11794,18,20,2,38,49,1949
73691,73691,0188E94C8AB9597E389E28C926D2E4FA,11021,0,2,2,36,49,1849
73692,73692,0188E94C8AB9597E389E28C926D2E4FA,11541,4,10,6,35,49,1799
73693,73693,0188E94C8AB9597E389E28C926D2E4FA,42231,14,19,5,37,46,1896
73694,73694,0188E94C8AB9597E389E28C926D2E4FA,11541,20,22,2,35,49,1799
73695,73695,BA68D19087DD7682E8C396165511A278,11061,0,14,14,29,48,1498
73696,73696,BA68D19087DD7682E8C396165511A278,11161,16,18,2,32,48,1648
73697,73697,BA68D19087DD7682E8C396165511A278,11151,19,20,1,30,48,1548
73698,73698,99090679888D7F5C536F089A4B9CEA7D,13911,1,12,11,39,46,1996
73699,73699,99090679888D7F5C536F089A4B9CEA7D,42351,12,14,2,38,45,1945
73700,73700,99090679888D7F5C536F089A4B9CEA7D,13911,17,21,4,39,46,1996
73701,73701,1129CFAE9FE6FF8D7F89EAB9AE20D07F,42041,2,5,3,10,47,547
73702,73702,1129CFAE9FE6FF8D7F89EAB9AE20D07F,19441,5,7,2,8,46,446
73703,73703,1129CFAE9FE6FF8D7F89EAB9AE20D07F,42041,12,16,4,10,47,547
73704,73704,1129CFAE9FE6FF8D7F89EAB9AE20D07F,19441,21,23,2,8,46,446
73714,73714,9CE340199F60473ABF4B42B3208B3EA2,42401,0,11,11,36,47,1847
73715,73715,9CE340199F60473ABF4B42B3208B3EA2,10111,11,19,8,37,47,1897
73716,73716,9CE340199F60473ABF4B42B3208B3EA2,42401,21,23,2,36,47,1847
73724,73724,6E802E6EED0751631BE3E26AAC23D1D7,19114,0,6,6,7,43,393
73725,73725,6E802E6EED0751631BE3E26AAC23D1D7,12921,7,10,3,9,41,491
73726,73726,6E802E6EED0751631BE3E26AAC23D1D7,19744,12,16,4,6,43,343
73727,73727,6E802E6EED0751631BE3E26AAC23D1D7,12921,17,18,1,9,41,491
73732,73732,787E2D15898542A785C91CF72E674285,13911,1,4,3,39,46,1996
73733,73733,787E2D15898542A785C91CF72E674285,11261,6,18,12,36,46,1846
73734,73734,787E2D15898542A785C91CF72E674285,42231,18,20,2,37,46,1896
73735,73735,2B75D649D733D42AAC85CA634BF0D07B,11914,0,6,6,37,48,1898
73736,73736,2B75D649D733D42AAC85CA634BF0D07B,42581,6,7,1,38,48,1948
73737,73737,2B75D649D733D42AAC85CA634BF0D07B,11914,16,18,2,37,48,1898
73741,73741,6E64C26C5363EDB29F730DE539E98745,12131,0,6,6,32,47,1647
73742,73742,6E64C26C5363EDB29F730DE539E98745,42491,7,9,2,32,46,1646
73743,73743,6E64C26C5363EDB29F730DE539E98745,42523,9,10,1,31,47,1597
73744,73744,6E64C26C5363EDB29F730DE539E98745,12131,11,23,12,32,47,1647
73764,73764,9BCD563089A1D0EF43A278605DE25081,42351,0,1,1,38,45,1945
73765,73765,9BCD563089A1D0EF43A278605DE25081,13911,4,5,1,39,46,1996
73766,73766,9BCD563089A1D0EF43A278605DE25081,42231,8,11,3,37,46,1896
73767,73767,9BCD563089A1D0EF43A278605DE25081,13911,12,23,11,39,46,1996
73773,73773,1BCA8F195CED1A69C9ABE190E0303E0A,12641,0,1,1,10,43,543
73774,73774,1BCA8F195CED1A69C9ABE190E0303E0A,19114,2,18,16,7,43,393
73775,73775,1BCA8F195CED1A69C9ABE190E0303E0A,12641,20,21,1,10,43,543
73776,73776,0AD8838435D12A1009D3BADE4EAE690D,11381,0,9,9,30,47,1547
73777,73777,0AD8838435D12A1009D3BADE4EAE690D,11061,9,10,1,29,48,1498
73778,73778,0AD8838435D12A1009D3BADE4EAE690D,11381,10,23,13,30,47,1547
73788,73788,53493041487B5321836147FAAD536213,13101,0,1,1,40,47,2047
73789,73789,53493041487B5321836147FAAD536213,13941,3,8,5,41,47,2097
73790,73790,53493041487B5321836147FAAD536213,13101,10,22,12,40,47,2047
73791,73791,55536669E97AF41ACDE427113BB85731,10691,0,6,6,33,48,1698
73792,73792,55536669E97AF41ACDE427113BB85731,11861,7,17,10,32,47,1647
73793,73793,55536669E97AF41ACDE427113BB85731,42021,17,18,1,33,47,1697
73794,73794,55536669E97AF41ACDE427113BB85731,10691,19,23,4,33,48,1698
73802,73802,5A5B2CBA296E90D3798147AFE5312824,13561,0,8,8,37,49,1899
73803,73803,5A5B2CBA296E90D3798147AFE5312824,10107,12,14,2,38,49,1949
73804,73804,5A5B2CBA296E90D3798147AFE5312824,13741,22,23,1,37,49,1899
73811,73811,9409A6C419ABED0218FC9499A2046865,11324,0,9,9,31,46,1596
73812,73812,9409A6C419ABED0218FC9499A2046865,42523,13,14,1,31,47,1597
73813,73813,9409A6C419ABED0218FC9499A2046865,11324,19,20,1,31,46,1596
73814,73814,9409A6C419ABED0218FC9499A2046865,42523,20,21,1,31,47,1597
73820,73820,C644771D2D9F4182BC18DB70E907DF2B,42581,0,5,5,38,48,1948
73821,73821,C644771D2D9F4182BC18DB70E907DF2B,10471,7,9,2,37,48,1898
73822,73822,C644771D2D9F4182BC18DB70E907DF2B,42581,11,13,2,38,48,1948
73823,73823,C644771D2D9F4182BC18DB70E907DF2B,11914,14,19,5,37,48,1898
73838,73838,1788FF83230593384DFEF88881720D90,13551,1,9,8,45,38,2288
73839,73839,1788FF83230593384DFEF88881720D90,43101,9,11,2,46,40,2340
73840,73840,1788FF83230593384DFEF88881720D90,13551,13,15,2,45,38,2288
73841,73841,1788FF83230593384DFEF88881720D90,43101,18,20,2,46,40,2340
73845,73845,0BA46FDA9249D0CBD4270BB3134EDFE1,10431,0,12,12,33,49,1699
73846,73846,0BA46FDA9249D0CBD4270BB3134EDFE1,42491,13,14,1,32,46,1646
73847,73847,0BA46FDA9249D0CBD4270BB3134EDFE1,10431,17,23,6,33,49,1699
73858,73858,0CEB068CD8F6DE0F248818A089746305,42961,0,7,7,35,49,1799
73859,73859,0CEB068CD8F6DE0F248818A089746305,11021,9,18,9,36,49,1849
73860,73860,0CEB068CD8F6DE0F248818A089746305,42961,19,23,4,35,49,1799
73864,73864,67BCB76F611F63115F44CBB7619B7D68,43161,0,13,13,35,47,1797
73865,73865,67BCB76F611F63115F44CBB7619B7D68,42161,13,15,2,36,47,1847
73866,73866,67BCB76F611F63115F44CBB7619B7D68,43161,17,19,2,35,47,1797
73867,73867,67BCB76F611F63115F44CBB7619B7D68,42161,19,20,1,36,47,1847
73872,73872,57C16FC7FD122F7979F6D505350315B6,42021,0,9,9,33,47,1697
73873,73873,57C16FC7FD122F7979F6D505350315B6,13601,11,17,6,34,47,1747
73874,73874,57C16FC7FD122F7979F6D505350315B6,42021,18,19,1,33,47,1697
73875,73875,0A8AE3881F70E69B30592EBEF611BA81,11271,0,7,7,37,48,1898
73876,73876,0A8AE3881F70E69B30592EBEF611BA81,11731,10,11,1,36,48,1848
73877,73877,0A8AE3881F70E69B30592EBEF611BA81,11271,13,22,9,37,48,1898
73886,73886,47C1473BA4462B22BD05E79B53CFA190,42041,9,11,2,10,47,547
73887,73887,47C1473BA4462B22BD05E79B53CFA190,19441,11,12,1,8,46,446
73888,73888,47C1473BA4462B22BD05E79B53CFA190,42041,13,20,7,10,47,547
73889,73889,3AEA3CF422288C2FFB9C65FD7BE694C9,12921,3,15,12,9,41,491
73890,73890,3AEA3CF422288C2FFB9C65FD7BE694C9,12641,16,18,2,10,43,543
73891,73891,3AEA3CF422288C2FFB9C65FD7BE694C9,19931,18,20,2,7,43,393
73892,73892,3AEA3CF422288C2FFB9C65FD7BE694C9,12921,21,22,1,9,41,491
73893,73893,586F3AD64B483C4FDBF6963F85B66D9A,13271,1,6,5,41,47,2097
73894,73894,586F3AD64B483C4FDBF6963F85B66D9A,43361,19,21,2,38,48,1948
73895,73895,586F3AD64B483C4FDBF6963F85B66D9A,11481,22,23,1,41,48,2098
73931,73931,CD8F8ECD6C484214361C94940E3BD476,42581,0,7,7,38,48,1948
73932,73932,CD8F8ECD6C484214361C94940E3BD476,10471,7,21,14,37,48,1898
73933,73933,CD8F8ECD6C484214361C94940E3BD476,42581,22,23,1,38,48,1948
73940,73940,31D4ECBF6E20300058A6DBF4B1DCA2FB,42491,4,7,3,32,46,1646
73941,73941,31D4ECBF6E20300058A6DBF4B1DCA2FB,42523,8,11,3,31,47,1597
73942,73942,31D4ECBF6E20300058A6DBF4B1DCA2FB,13651,12,14,2,30,47,1547
73943,73943,31D4ECBF6E20300058A6DBF4B1DCA2FB,42523,14,20,6,31,47,1597
73949,73949,CE2F05770EAE7211AF1856B90409D64B,11074,0,17,17,37,47,1897
73950,73950,CE2F05770EAE7211AF1856B90409D64B,42221,18,20,2,38,48,1948
73951,73951,CE2F05770EAE7211AF1856B90409D64B,11074,21,22,1,37,47,1897
73952,73952,70884D19952CA4B432FAA84B8636A296,13351,7,11,4,48,48,2448
73953,73953,70884D19952CA4B432FAA84B8636A296,42461,13,14,1,45,47,2297
73954,73954,70884D19952CA4B432FAA84B8636A296,13351,14,18,4,48,48,2448
73955,73955,70884D19952CA4B432FAA84B8636A296,42461,20,22,2,45,47,2297
73970,73970,B768DBD477008511AD969C6F4C6366B9,43241,0,7,7,36,46,1846
73971,73971,B768DBD477008511AD969C6F4C6366B9,13711,8,10,2,38,46,1946
73972,73972,B768DBD477008511AD969C6F4C6366B9,11081,11,23,12,35,46,1796
73973,73973,BFA4D55996D01609B657759A62C08A2F,12514,1,7,6,38,47,1947
73974,73974,BFA4D55996D01609B657759A62C08A2F,11074,8,11,3,37,47,1897
73975,73975,BFA4D55996D01609B657759A62C08A2F,12514,12,23,11,38,47,1947
73990,73990,8256CFF09C49A6D8D8C0F3E2DE8CF256,10111,9,18,9,37,47,1897
73991,73991,8256CFF09C49A6D8D8C0F3E2DE8CF256,43731,18,20,2,34,47,1747
73992,73992,8256CFF09C49A6D8D8C0F3E2DE8CF256,42301,21,23,2,36,47,1847
73999,73999,7EBD3BA762C40F1F8A712F803B7D8FD3,12491,1,4,3,36,43,1843
74000,74000,7EBD3BA762C40F1F8A712F803B7D8FD3,42151,7,8,1,35,45,1795
74001,74001,7EBD3BA762C40F1F8A712F803B7D8FD3,12491,8,23,15,36,43,1843
74002,74002,181802B57A29F4FAE1E7EF60B334A9D5,13911,1,6,5,39,46,1996
74003,74003,181802B57A29F4FAE1E7EF60B334A9D5,11261,8,10,2,36,46,1846
74004,74004,181802B57A29F4FAE1E7EF60B334A9D5,42231,10,11,1,37,46,1896
74005,74005,181802B57A29F4FAE1E7EF60B334A9D5,13911,14,23,9,39,46,1996
74006,74006,70C592A8E191F8F749D5852D53604778,11091,0,16,16,29,47,1497
74007,74007,70C592A8E191F8F749D5852D53604778,43391,19,20,1,29,48,1498
74008,74008,70C592A8E191F8F749D5852D53604778,11431,21,23,2,29,47,1497
74009,74009,D9026A3CE10A3841EFEE0C49DAE389C6,12641,1,2,1,10,43,543
74010,74010,D9026A3CE10A3841EFEE0C49DAE389C6,19114,6,18,12,7,43,393
74011,74011,D9026A3CE10A3841EFEE0C49DAE389C6,12641,21,22,1,10,43,543
74012,74012,75524962F97D2921D4300F16BC969FA9,10271,0,5,5,37,46,1896
74013,74013,75524962F97D2921D4300F16BC969FA9,13121,6,8,2,38,46,1946
74014,74014,75524962F97D2921D4300F16BC969FA9,10271,9,23,14,37,46,1896
74019,74019,18CC713B80CCF9AB1A7B146FB6B3AAAC,10271,0,11,11,37,46,1896
74020,74020,18CC713B80CCF9AB1A7B146FB6B3AAAC,13711,13,16,3,38,46,1946
74021,74021,18CC713B80CCF9AB1A7B146FB6B3AAAC,10271,16,18,2,37,46,1896
74033,74033,F93D646A1BCE1AFF390EB78A01863C9E,10471,0,1,1,37,48,1898
74034,74034,F93D646A1BCE1AFF390EB78A01863C9E,40171,2,3,1,38,48,1948
74035,74035,F93D646A1BCE1AFF390EB78A01863C9E,10471,6,21,15,37,48,1898
74036,74036,F93D646A1BCE1AFF390EB78A01863C9E,40171,22,23,1,38,48,1948
74043,74043,138A1521C6403794A5D32D9328BA49B5,12921,7,9,2,9,41,491
74044,74044,138A1521C6403794A5D32D9328BA49B5,49201,9,12,3,7,41,391
74045,74045,138A1521C6403794A5D32D9328BA49B5,12921,12,22,10,9,41,491
74051,74051,826B40817E61853148AFBFECB1C48C70,11261,0,3,3,36,46,1846
74052,74052,826B40817E61853148AFBFECB1C48C70,42861,7,14,7,37,44,1894
74053,74053,826B40817E61853148AFBFECB1C48C70,11261,17,23,6,36,46,1846
74054,74054,C7DA09D84BB6D5A3ABEAD976C8C0731E,42861,0,13,13,37,44,1894
74055,74055,C7DA09D84BB6D5A3ABEAD976C8C0731E,11261,14,16,2,36,46,1846
74056,74056,C7DA09D84BB6D5A3ABEAD976C8C0731E,42861,18,23,5,37,44,1894
74062,74062,92E340B82C56A45F91D53CD2B709557E,42581,2,4,2,38,48,1948
74063,74063,92E340B82C56A45F91D53CD2B709557E,11914,7,19,12,37,48,1898
74064,74064,92E340B82C56A45F91D53CD2B709557E,42581,21,22,1,38,48,1948
74068,74068,17A0B3FB3065726B16826025ECADE143,42623,0,7,7,22,49,1149
74069,74069,17A0B3FB3065726B16826025ECADE143,42081,10,11,1,24,49,1249
74070,74070,17A0B3FB3065726B16826025ECADE143,42623,12,18,6,22,49,1149
74071,74071,CB569F11653BED8355DBB1B17AC5F222,40171,0,11,11,38,48,1948
74072,74072,CB569F11653BED8355DBB1B17AC5F222,11914,12,14,2,37,48,1898
74073,74073,CB569F11653BED8355DBB1B17AC5F222,40171,19,22,3,38,48,1948
74074,74074,6C96EE989846ABECA961FEB7DAD4E3B3,43361,0,7,7,38,48,1948
74075,74075,6C96EE989846ABECA961FEB7DAD4E3B3,10471,7,18,11,37,48,1898
74076,74076,6C96EE989846ABECA961FEB7DAD4E3B3,43361,19,23,4,38,48,1948
74080,74080,C6869A64CA9EF97A25D7192A00726FC2,10111,0,2,2,37,47,1897
74081,74081,C6869A64CA9EF97A25D7192A00726FC2,42401,3,9,6,36,47,1847
74082,74082,C6869A64CA9EF97A25D7192A00726FC2,10781,13,18,5,35,47,1797
74083,74083,C6869A64CA9EF97A25D7192A00726FC2,42401,18,23,5,36,47,1847
74101,74101,D8963F7C81A647B0DB7A8BBF70036A0B,12514,0,7,7,38,47,1947
74102,74102,D8963F7C81A647B0DB7A8BBF70036A0B,10471,8,17,9,37,48,1898
74103,74103,D8963F7C81A647B0DB7A8BBF70036A0B,12514,19,23,4,38,47,1947
74104,74104,0A0BBB63629E3A59CB256306E3BEA0A4,42371,5,7,2,34,46,1746
74105,74105,0A0BBB63629E3A59CB256306E3BEA0A4,42641,11,13,2,33,49,1699
74106,74106,0A0BBB63629E3A59CB256306E3BEA0A4,42231,16,18,2,37,46,1896
74107,74107,0A0BBB63629E3A59CB256306E3BEA0A4,43761,20,22,2,32,47,1647
74108,74108,8A063C000C18EFD5117E8B73289494F1,10451,0,4,4,25,48,1298
74109,74109,8A063C000C18EFD5117E8B73289494F1,40343,5,18,13,24,49,1249
74110,74110,8A063C000C18EFD5117E8B73289494F1,40341,19,23,4,23,49,1199
74111,74111,5AF26FD3EDD59D73F20E2AE7E3BEDAFF,49201,3,5,2,7,41,391
74112,74112,5AF26FD3EDD59D73F20E2AE7E3BEDAFF,19181,5,7,2,8,40,440
74113,74113,5AF26FD3EDD59D73F20E2AE7E3BEDAFF,49201,8,21,13,7,41,391
74119,74119,60F7F4881031002766F8A8E2FAB27EDD,10041,0,14,14,39,49,1999
74120,74120,60F7F4881031002766F8A8E2FAB27EDD,43321,14,16,2,36,49,1849
74121,74121,60F7F4881031002766F8A8E2FAB27EDD,10041,17,23,6,39,49,1999
74136,74136,194BE7C669F8B10039EECF2EE1F7AB5A,10292,5,12,7,30,47,1547
74137,74137,194BE7C669F8B10039EECF2EE1F7AB5A,10681,15,19,4,30,48,1548
74138,74138,194BE7C669F8B10039EECF2EE1F7AB5A,10292,21,22,1,30,47,1547
74139,74139,03FE0D0BD52A528C1B4DF1F3C44F085B,11941,0,13,13,37,46,1896
74140,74140,03FE0D0BD52A528C1B4DF1F3C44F085B,11261,13,15,2,36,46,1846
74141,74141,03FE0D0BD52A528C1B4DF1F3C44F085B,42351,16,17,1,38,45,1945
74142,74142,03FE0D0BD52A528C1B4DF1F3C44F085B,41551,19,23,4,37,46,1896
74148,74148,20538B8C1777892DA77867D1D04B5D49,43761,0,3,3,32,47,1647
74149,74149,20538B8C1777892DA77867D1D04B5D49,11161,3,8,5,32,48,1648
74150,74150,20538B8C1777892DA77867D1D04B5D49,43761,9,23,14,32,47,1647
74151,74151,251A51021E3A0FF45CE6215A1E1C87D8,13101,2,7,5,40,47,2047
74152,74152,251A51021E3A0FF45CE6215A1E1C87D8,11806,9,11,2,41,48,2098
74153,74153,251A51021E3A0FF45CE6215A1E1C87D8,13101,13,14,1,40,47,2047
74154,74154,251A51021E3A0FF45CE6215A1E1C87D8,11806,19,20,1,41,48,2098
74155,74155,617CDCBB763C8E42460705E2218A65BF,43761,1,3,2,32,47,1647
74156,74156,617CDCBB763C8E42460705E2218A65BF,42523,7,10,3,31,47,1597
74157,74157,617CDCBB763C8E42460705E2218A65BF,43761,10,21,11,32,47,1647
74158,74158,EC971BEA56DBA93E199ED44EE6EDF346,12971,10,12,2,32,48,1648
74159,74159,EC971BEA56DBA93E199ED44EE6EDF346,10721,14,16,2,31,48,1598
74160,74160,EC971BEA56DBA93E199ED44EE6EDF346,11861,20,23,3,32,47,1647
74170,74170,7A3CCBEE1EF7E270B4B301C75856D62F,10281,0,1,1,33,48,1698
74171,74171,7A3CCBEE1EF7E270B4B301C75856D62F,11861,6,11,5,32,47,1647
74172,74172,7A3CCBEE1EF7E270B4B301C75856D62F,43161,12,13,1,35,47,1797
74173,74173,7A3CCBEE1EF7E270B4B301C75856D62F,11861,14,23,9,32,47,1647
74174,74174,5E2B08CF84B7CE18B53CCFA48145A884,11231,0,8,8,37,49,1899
74175,74175,5E2B08CF84B7CE18B53CCFA48145A884,11661,9,10,1,40,49,2049
74176,74176,5E2B08CF84B7CE18B53CCFA48145A884,11231,13,23,10,37,49,1899
74177,74177,EF7EE9F0825E500C83748044E0BD2521,13651,0,9,9,30,47,1547
74178,74178,EF7EE9F0825E500C83748044E0BD2521,10351,14,15,1,28,45,1445
74179,74179,EF7EE9F0825E500C83748044E0BD2521,13651,19,23,4,30,47,1547
74184,74184,D500A33E5EBF4610FFE1DAD30674EBEB,42281,0,13,13,40,48,2048
74185,74185,D500A33E5EBF4610FFE1DAD30674EBEB,42031,15,16,1,40,46,2046
74186,74186,D500A33E5EBF4610FFE1DAD30674EBEB,42281,19,23,4,40,48,2048
74187,74187,9C47145209ECFC40DF20CE0BFE35E37E,43761,0,14,14,32,47,1647
74188,74188,9C47145209ECFC40DF20CE0BFE35E37E,10341,16,17,1,31,47,1597
74189,74189,9C47145209ECFC40DF20CE0BFE35E37E,43761,19,23,4,32,47,1647
74211,74211,95471D684DB585D0049B7AB0C8B83123,11061,6,9,3,29,48,1498
74212,74212,95471D684DB585D0049B7AB0C8B83123,40445,10,13,3,30,48,1548
74213,74213,95471D684DB585D0049B7AB0C8B83123,11061,14,23,9,29,48,1498
74218,74218,56547DCD12E76D718E2E60F15A40B9D5,42401,0,8,8,36,47,1847
74219,74219,56547DCD12E76D718E2E60F15A40B9D5,43581,12,16,4,33,48,1698
74220,74220,56547DCD12E76D718E2E60F15A40B9D5,42401,17,23,6,36,47,1847
74235,74235,1E4ADDBFBD1C3EEA7DB4E1CBF005793C,11061,0,6,6,29,48,1498
74236,74236,1E4ADDBFBD1C3EEA7DB4E1CBF005793C,12587,8,14,6,25,48,1298
74237,74237,1E4ADDBFBD1C3EEA7DB4E1CBF005793C,42521,15,16,1,31,47,1597
74238,74238,1E4ADDBFBD1C3EEA7DB4E1CBF005793C,11061,20,23,3,29,48,1498
74248,74248,BB6408B6449FE57F7E33631A828BC98E,11701,0,7,7,43,48,2198
74249,74249,BB6408B6449FE57F7E33631A828BC98E,11521,7,12,5,41,48,2098
74250,74250,BB6408B6449FE57F7E33631A828BC98E,11701,16,18,2,43,48,2198
74251,74251,BB6408B6449FE57F7E33631A828BC98E,10421,21,23,2,41,48,2098
74257,74257,93CFE6F92CFCB7F9001F363C57FDDBCE,42071,0,13,13,31,49,1599
74258,74258,93CFE6F92CFCB7F9001F363C57FDDBCE,42291,17,18,1,29,48,1498
74259,74259,93CFE6F92CFCB7F9001F363C57FDDBCE,42071,20,22,2,31,49,1599
74260,74260,B90520ED7BDDE423CEFE3ED6913620C9,12514,0,6,6,38,47,1947
74261,74261,B90520ED7BDDE423CEFE3ED6913620C9,10271,6,13,7,37,46,1896
74262,74262,B90520ED7BDDE423CEFE3ED6913620C9,12514,14,19,5,38,47,1947
74263,74263,B90520ED7BDDE423CEFE3ED6913620C9,10841,20,21,1,37,47,1897
74274,74274,8B7D63C5EBF2F6E2C97BF1B06BF39487,42871,1,2,1,30,45,1545
74275,74275,8B7D63C5EBF2F6E2C97BF1B06BF39487,10301,2,3,1,31,45,1595
74276,74276,8B7D63C5EBF2F6E2C97BF1B06BF39487,12311,7,16,9,30,44,1544
74277,74277,8B7D63C5EBF2F6E2C97BF1B06BF39487,10301,20,23,3,31,45,1595
74281,74281,7F39CFD81893EF00CED4C98A6CC13D33,11381,0,10,10,30,47,1547
74282,74282,7F39CFD81893EF00CED4C98A6CC13D33,12121,11,14,3,29,47,1497
74283,74283,7F39CFD81893EF00CED4C98A6CC13D33,43761,16,19,3,32,47,1647
74284,74284,7F39CFD81893EF00CED4C98A6CC13D33,11381,20,22,2,30,47,1547
74289,74289,B4E2FABCAA416E19EA188BB6246C7FEB,10301,0,3,3,31,45,1595
74290,74290,B4E2FABCAA416E19EA188BB6246C7FEB,12661,3,13,10,32,45,1645
74291,74291,B4E2FABCAA416E19EA188BB6246C7FEB,12311,18,20,2,30,44,1544
74292,74292,B4E2FABCAA416E19EA188BB6246C7FEB,10301,21,23,2,31,45,1595
74293,74293,ED7D6E0D6245554973BF1FC4EA5C6C28,11151,0,6,6,30,48,1548
74294,74294,ED7D6E0D6245554973BF1FC4EA5C6C28,11061,9,14,5,29,48,1498
74295,74295,ED7D6E0D6245554973BF1FC4EA5C6C28,11151,14,21,7,30,48,1548
74316,74316,18795395C853CBDF0640E06A471FA19D,11861,0,7,7,32,47,1647
74317,74317,18795395C853CBDF0640E06A471FA19D,42523,8,9,1,31,47,1597
74318,74318,18795395C853CBDF0640E06A471FA19D,11861,10,22,12,32,47,1647
74319,74319,4EE5C60035D807126AEE0DC0CD563832,42581,3,6,3,38,48,1948
74320,74320,4EE5C60035D807126AEE0DC0CD563832,11914,7,20,13,37,48,1898
74321,74321,4EE5C60035D807126AEE0DC0CD563832,42581,21,23,2,38,48,1948
74322,74322,2B174A2FF1063311A281D3E6DB697BD8,11231,0,8,8,37,49,1899
74323,74323,2B174A2FF1063311A281D3E6DB697BD8,43181,11,13,2,39,48,1998
74324,74324,2B174A2FF1063311A281D3E6DB697BD8,11331,17,19,2,37,48,1898
74325,74325,2B174A2FF1063311A281D3E6DB697BD8,11231,19,22,3,37,49,1899
74326,74326,482231C60E75752F61489BAC43B2B02B,10121,0,9,9,36,49,1849
74327,74327,482231C60E75752F61489BAC43B2B02B,11541,11,22,11,35,49,1799
74328,74328,482231C60E75752F61489BAC43B2B02B,10121,22,23,1,36,49,1849
74329,74329,E090AE745FE0157CE235544725EE3E3A,12514,3,5,2,38,47,1947
74330,74330,E090AE745FE0157CE235544725EE3E3A,13561,9,10,1,37,49,1899
74331,74331,E090AE745FE0157CE235544725EE3E3A,11021,12,18,6,36,49,1849
74332,74332,E090AE745FE0157CE235544725EE3E3A,12514,19,21,2,38,47,1947
74338,74338,F276DA0C0E39AE3BAD5B91AE46CB6EA8,11231,1,6,5,37,49,1899
74339,74339,F276DA0C0E39AE3BAD5B91AE46CB6EA8,10471,7,12,5,37,48,1898
74340,74340,F276DA0C0E39AE3BAD5B91AE46CB6EA8,11231,13,18,5,37,49,1899
74357,74357,983842B60AEE8AF2D9A0F2BA47994634,11381,0,14,14,30,47,1547
74358,74358,983842B60AEE8AF2D9A0F2BA47994634,12121,14,18,4,29,47,1497
74359,74359,983842B60AEE8AF2D9A0F2BA47994634,11381,18,23,5,30,47,1547
74360,74360,424595F1C8846A1CBAEDBFB8FB93F25B,11061,0,4,4,29,48,1498
74361,74361,424595F1C8846A1CBAEDBFB8FB93F25B,11151,7,8,1,30,48,1548
74362,74362,424595F1C8846A1CBAEDBFB8FB93F25B,12121,9,16,7,29,47,1497
74363,74363,424595F1C8846A1CBAEDBFB8FB93F25B,11061,18,20,2,29,48,1498
74370,74370,AD235EE6A83CA7956AB86E8BC887D3C7,11541,0,6,6,35,49,1799
74371,74371,AD235EE6A83CA7956AB86E8BC887D3C7,11021,7,17,10,36,49,1849
74372,74372,AD235EE6A83CA7956AB86E8BC887D3C7,11541,19,22,3,35,49,1799
74376,74376,EE6B8585E25BB845D2DA0A95F88FAB79,42231,10,14,4,37,46,1896
74377,74377,EE6B8585E25BB845D2DA0A95F88FAB79,11261,14,16,2,36,46,1846
74378,74378,EE6B8585E25BB845D2DA0A95F88FAB79,42231,18,20,2,37,46,1896
74379,74379,3802CED853645D33939F622875BEB6EB,10471,0,19,19,37,48,1898
74380,74380,3802CED853645D33939F622875BEB6EB,10107,19,22,3,38,49,1949
74381,74381,3802CED853645D33939F622875BEB6EB,10471,22,23,1,37,48,1898
74389,74389,D48C648C1D8E99D79DDC90BDE949351A,13231,3,4,1,39,46,1996
74390,74390,D48C648C1D8E99D79DDC90BDE949351A,11261,8,19,11,36,46,1846
74391,74391,D48C648C1D8E99D79DDC90BDE949351A,10841,22,23,1,37,47,1897
74395,74395,147320C3133F09A06423F79D22663CE8,12521,0,17,17,35,41,1791
74396,74396,147320C3133F09A06423F79D22663CE8,43451,18,19,1,37,40,1890
74397,74397,147320C3133F09A06423F79D22663CE8,12521,20,23,3,35,41,1791
74398,74398,B7D6EFF1A712C97E66620534B8D3DEAE,10471,1,15,14,37,48,1898
74399,74399,B7D6EFF1A712C97E66620534B8D3DEAE,41271,17,21,4,38,48,1948
74400,74400,B7D6EFF1A712C97E66620534B8D3DEAE,10471,22,23,1,37,48,1898
74401,74401,10C025DE83AEC63388DB13DE6128ADC8,12121,0,6,6,29,47,1497
74402,74402,10C025DE83AEC63388DB13DE6128ADC8,11381,7,16,9,30,47,1547
74403,74403,10C025DE83AEC63388DB13DE6128ADC8,10951,17,18,1,29,48,1498
74404,74404,10C025DE83AEC63388DB13DE6128ADC8,11381,18,22,4,30,47,1547
74415,74415,5DF7BADF34FEBA82E61DDC1448DA4B7A,42221,0,9,9,38,48,1948
74416,74416,5DF7BADF34FEBA82E61DDC1448DA4B7A,11074,9,10,1,37,47,1897
74417,74417,5DF7BADF34FEBA82E61DDC1448DA4B7A,42221,12,22,10,38,48,1948
74418,74418,907D9C07105AF9242C4278C0160DDD57,13711,0,13,13,38,46,1946
74419,74419,907D9C07105AF9242C4278C0160DDD57,10271,16,19,3,37,46,1896
74420,74420,907D9C07105AF9242C4278C0160DDD57,13711,22,23,1,38,46,1946
74424,74424,9398C8C66FCD9C9C571837501897C592,11381,3,9,6,30,47,1547
74425,74425,9398C8C66FCD9C9C571837501897C592,10951,10,11,1,29,48,1498
74426,74426,9398C8C66FCD9C9C571837501897C592,11381,13,14,1,30,47,1547
74427,74427,9398C8C66FCD9C9C571837501897C592,10951,17,18,1,29,48,1498
74428,74428,850131E8C9E92CFF67EAC657858E5B85,42351,0,8,8,38,45,1945
74429,74429,850131E8C9E92CFF67EAC657858E5B85,12511,11,14,3,39,47,1997
74430,74430,850131E8C9E92CFF67EAC657858E5B85,42351,14,17,3,38,45,1945
74431,74431,850131E8C9E92CFF67EAC657858E5B85,12514,20,23,3,38,47,1947
74435,74435,085A54B112E93B58F53705ABE7F444E7,13471,0,14,14,47,49,2399
74436,74436,085A54B112E93B58F53705ABE7F444E7,42601,14,16,2,44,48,2248
74437,74437,085A54B112E93B58F53705ABE7F444E7,43621,16,18,2,46,48,2348
74438,74438,085A54B112E93B58F53705ABE7F444E7,13471,21,23,2,47,49,2399
74439,74439,3BB34174639CFACBA924E1D5FF8062A5,42531,0,5,5,31,45,1595
74440,74440,3BB34174639CFACBA924E1D5FF8062A5,12661,7,16,9,32,45,1645
74441,74441,3BB34174639CFACBA924E1D5FF8062A5,42531,17,23,6,31,45,1595
74442,74442,72B28316E77049B3B3D9EC9BDF710CF6,42523,0,6,6,31,47,1597
74443,74443,72B28316E77049B3B3D9EC9BDF710CF6,43761,6,16,10,32,47,1647
74444,74444,72B28316E77049B3B3D9EC9BDF710CF6,10341,18,21,3,31,47,1597
74456,74456,C89DD497B3E25F408D5F4E0FF457EA4C,11914,2,3,1,37,48,1898
74457,74457,C89DD497B3E25F408D5F4E0FF457EA4C,42581,6,16,10,38,48,1948
74458,74458,C89DD497B3E25F408D5F4E0FF457EA4C,11914,19,20,1,37,48,1898
74459,74459,B2C146BE7E2B98821BDB0E11A4AFFE8A,11541,0,6,6,35,49,1799
74460,74460,B2C146BE7E2B98821BDB0E11A4AFFE8A,11021,8,10,2,36,49,1849
74461,74461,B2C146BE7E2B98821BDB0E11A4AFFE8A,11541,11,23,12,35,49,1799
74462,74462,02BE3BEF99A1994D3C568E0B4314FEEC,13651,0,6,6,30,47,1547
74463,74463,02BE3BEF99A1994D3C568E0B4314FEEC,10301,7,18,11,31,45,1595
74464,74464,02BE3BEF99A1994D3C568E0B4314FEEC,13651,19,22,3,30,47,1547
74465,74465,080DB1741ABE41AF13DEB5E9F4C7A2DE,42321,0,6,6,43,47,2197
74466,74466,080DB1741ABE41AF13DEB5E9F4C7A2DE,10801,7,8,1,42,47,2147
74467,74467,080DB1741ABE41AF13DEB5E9F4C7A2DE,42321,8,23,15,43,47,2197
74468,74468,9BAE48FA2AAB8072FAE7756482A9D25C,11074,0,4,4,37,47,1897
74469,74469,9BAE48FA2AAB8072FAE7756482A9D25C,10511,8,17,9,35,46,1796
74470,74470,9BAE48FA2AAB8072FAE7756482A9D25C,11074,19,20,1,37,47,1897
74471,74471,9BAE48FA2AAB8072FAE7756482A9D25C,12514,20,22,2,38,47,1947
74472,74472,C81FC2E9808AA726781F412721963B0B,43761,0,5,5,32,47,1647
74473,74473,C81FC2E9808AA726781F412721963B0B,10295,7,18,11,30,47,1547
74474,74474,C81FC2E9808AA726781F412721963B0B,43761,19,21,2,32,47,1647
74475,74475,E528C1BCF7730647027A4A7EFB058975,42631,0,7,7,43,45,2195
74476,74476,E528C1BCF7730647027A4A7EFB058975,43061,8,14,6,43,46,2196
74477,74477,E528C1BCF7730647027A4A7EFB058975,13341,16,18,2,44,45,2245
74478,74478,E528C1BCF7730647027A4A7EFB058975,42631,21,23,2,43,45,2195
74479,74479,61CC7CB5EA609C6320BD2A3529DD90CF,11911,0,6,6,37,48,1898
74480,74480,61CC7CB5EA609C6320BD2A3529DD90CF,10271,7,14,7,37,46,1896
74481,74481,61CC7CB5EA609C6320BD2A3529DD90CF,11911,18,23,5,37,48,1898
74482,74482,436F88284FF83569377FEFB7C251D9CB,13121,0,8,8,38,46,1946
74483,74483,436F88284FF83569377FEFB7C251D9CB,11074,8,9,1,37,47,1897
74484,74484,436F88284FF83569377FEFB7C251D9CB,13121,11,23,12,38,46,1946
74485,74485,1277ACA424D6A91D4C363B632562549C,10501,9,10,1,22,46,1146
74486,74486,1277ACA424D6A91D4C363B632562549C,12601,11,17,6,25,47,1297
74487,74487,1277ACA424D6A91D4C363B632562549C,10501,21,23,2,22,46,1146
74488,74488,F49F5A0F1C44EBAB5BE16379854ACBEE,11061,0,9,9,29,48,1498
74489,74489,F49F5A0F1C44EBAB5BE16379854ACBEE,11381,13,16,3,30,47,1547
74490,74490,F49F5A0F1C44EBAB5BE16379854ACBEE,10951,19,20,1,29,48,1498
74491,74491,53FC206721A8C3624806821733B57282,42621,0,1,1,24,49,1249
74492,74492,53FC206721A8C3624806821733B57282,11641,2,6,4,22,49,1149
74493,74493,53FC206721A8C3624806821733B57282,42081,8,16,8,24,49,1249
74494,74494,53FC206721A8C3624806821733B57282,42481,21,23,2,22,49,1149
74498,74498,9F99A72527E81B89BEB16DB21B613CC0,10281,0,6,6,33,48,1698
74499,74499,9F99A72527E81B89BEB16DB21B613CC0,11861,7,16,9,32,47,1647
74500,74500,9F99A72527E81B89BEB16DB21B613CC0,10281,17,23,6,33,48,1698
74501,74501,5084492A6A758A3CF1EF2B8D58F59187,11875,0,6,6,30,46,1546
74502,74502,5084492A6A758A3CF1EF2B8D58F59187,12311,8,17,9,30,44,1544
74503,74503,5084492A6A758A3CF1EF2B8D58F59187,11871,18,23,5,29,46,1496
74512,74512,2E7B2253AC418B1A43B0E145571CC5CD,42511,0,7,7,37,47,1897
74513,74513,2E7B2253AC418B1A43B0E145571CC5CD,10511,8,13,5,35,46,1796
74514,74514,2E7B2253AC418B1A43B0E145571CC5CD,10531,16,17,1,34,46,1746
74515,74515,2E7B2253AC418B1A43B0E145571CC5CD,10841,18,23,5,37,47,1897
74524,74524,A0A00D4FFCF39B121347488247DF3626,12311,4,5,1,30,44,1544
74525,74525,A0A00D4FFCF39B121347488247DF3626,11875,6,12,6,30,46,1546
74526,74526,A0A00D4FFCF39B121347488247DF3626,42871,16,19,3,30,45,1545
74527,74527,A0A00D4FFCF39B121347488247DF3626,12311,21,23,2,30,44,1544
74534,74534,6448AD2FDBA33B773228F13A91A3786C,42141,3,17,14,32,47,1647
74535,74535,6448AD2FDBA33B773228F13A91A3786C,10281,17,20,3,33,48,1698
74536,74536,6448AD2FDBA33B773228F13A91A3786C,43761,22,23,1,32,47,1647
74552,74552,966EF37DD81DE2F009202B5BDDCFCE29,11261,1,2,1,36,46,1846
74553,74553,966EF37DD81DE2F009202B5BDDCFCE29,13911,3,10,7,39,46,1996
74554,74554,966EF37DD81DE2F009202B5BDDCFCE29,42351,14,16,2,38,45,1945
74555,74555,966EF37DD81DE2F009202B5BDDCFCE29,42231,21,22,1,37,46,1896
74556,74556,4171D29F4A369590D36B7538E184D0E0,10471,0,19,19,37,48,1898
74557,74557,4171D29F4A369590D36B7538E184D0E0,10107,20,21,1,38,49,1949
74558,74558,4171D29F4A369590D36B7538E184D0E0,10471,22,23,1,37,48,1898
74568,74568,E603C5CE99E3FE3BB5D201DC1F4B77FD,13111,1,17,16,42,46,2146
74569,74569,E603C5CE99E3FE3BB5D201DC1F4B77FD,13791,17,19,2,42,47,2147
74570,74570,E603C5CE99E3FE3BB5D201DC1F4B77FD,42204,19,22,3,43,46,2196
74571,74571,F8EA0C68F3C8266C3E7BA4F2FCE6F8BC,19441,1,6,5,8,46,446
74572,74572,F8EA0C68F3C8266C3E7BA4F2FCE6F8BC,42041,9,10,1,10,47,547
74573,74573,F8EA0C68F3C8266C3E7BA4F2FCE6F8BC,19441,11,23,12,8,46,446
74579,74579,3C5BF8354C7B22C00BFA5438C070BC0F,13711,1,10,9,38,46,1946
74580,74580,3C5BF8354C7B22C00BFA5438C070BC0F,43241,10,12,2,36,46,1846
74581,74581,3C5BF8354C7B22C00BFA5438C070BC0F,13711,12,22,10,38,46,1946
74582,74582,3C5BF8354C7B22C00BFA5438C070BC0F,10271,22,23,1,37,46,1896
74583,74583,4B706CBBBDE9BF48F90679E8BB90E0D8,42231,1,12,11,37,46,1896
74584,74584,4B706CBBBDE9BF48F90679E8BB90E0D8,13221,13,18,5,40,47,2047
74585,74585,4B706CBBBDE9BF48F90679E8BB90E0D8,42231,20,22,2,37,46,1896
74596,74596,121C674E105FB71B18C3C013C0218FFA,42791,0,15,15,35,45,1795
74597,74597,121C674E105FB71B18C3C013C0218FFA,11941,16,18,2,37,46,1896
74598,74598,121C674E105FB71B18C3C013C0218FFA,42151,19,23,4,35,45,1795
74602,74602,4A97E701DB890F0A36533DCC33203AA3,42221,1,7,6,38,48,1948
74603,74603,4A97E701DB890F0A36533DCC33203AA3,11074,8,21,13,37,47,1897
74604,74604,4A97E701DB890F0A36533DCC33203AA3,42221,21,23,2,38,48,1948
74608,74608,E40FF661B4F3DA89AB28D734DF463F41,19111,0,6,6,9,45,495
74609,74609,E40FF661B4F3DA89AB28D734DF463F41,12921,8,16,8,9,41,491
74610,74610,E40FF661B4F3DA89AB28D734DF463F41,19114,19,20,1,7,43,393
74611,74611,58160F8286644CCBCCC72FA14DAD9C05,19114,0,11,11,7,43,393
74612,74612,58160F8286644CCBCCC72FA14DAD9C05,12641,11,15,4,10,43,543
74613,74613,58160F8286644CCBCCC72FA14DAD9C05,19114,19,23,4,7,43,393
74618,74618,76780BDA1CE8853E5C6D6B4A56C0AC5B,11381,6,16,10,30,47,1547
74619,74619,76780BDA1CE8853E5C6D6B4A56C0AC5B,12121,16,18,2,29,47,1497
74620,74620,76780BDA1CE8853E5C6D6B4A56C0AC5B,11381,18,22,4,30,47,1547
74630,74630,988754F4ACB1FFB14F8ADCC3660BA4EF,11261,3,15,12,36,46,1846
74631,74631,988754F4ACB1FFB14F8ADCC3660BA4EF,13911,15,18,3,39,46,1996
74632,74632,988754F4ACB1FFB14F8ADCC3660BA4EF,11261,18,22,4,36,46,1846
74633,74633,0E5E4E8962E3175603891C7AA3427763,43391,2,4,2,29,48,1498
74634,74634,0E5E4E8962E3175603891C7AA3427763,10381,6,10,4,31,49,1599
74635,74635,0E5E4E8962E3175603891C7AA3427763,10951,11,12,1,29,48,1498
74636,74636,0E5E4E8962E3175603891C7AA3427763,10381,15,21,6,31,49,1599
74637,74637,B4D70E7CDFA879C6A4BAE698CD44BB37,10271,0,9,9,37,46,1896
74638,74638,B4D70E7CDFA879C6A4BAE698CD44BB37,13711,11,12,1,38,46,1946
74639,74639,B4D70E7CDFA879C6A4BAE698CD44BB37,10271,14,22,8,37,46,1896
74643,74643,0A4DEAAE87BBCD0C04DEB057F69A322D,11381,0,9,9,30,47,1547
74644,74644,0A4DEAAE87BBCD0C04DEB057F69A322D,11875,11,12,1,30,46,1546
74645,74645,0A4DEAAE87BBCD0C04DEB057F69A322D,11381,15,19,4,30,47,1547
74646,74646,946768BFA72752D5660750415178C67F,42161,0,1,1,36,47,1847
74647,74647,946768BFA72752D5660750415178C67F,43731,1,5,4,34,47,1747
74648,74648,946768BFA72752D5660750415178C67F,10511,8,18,10,35,46,1796
74649,74649,946768BFA72752D5660750415178C67F,10731,18,19,1,33,47,1697
74677,74677,309C2EBD6881FB9505C9BCE9119A811B,11951,9,11,2,31,49,1599
74678,74678,309C2EBD6881FB9505C9BCE9119A811B,11954,12,14,2,32,49,1649
74679,74679,309C2EBD6881FB9505C9BCE9119A811B,42071,18,23,5,31,49,1599
74684,74684,A8D6EA87C0BC63208FB058AFC990DEB0,42921,0,9,9,33,47,1697
74685,74685,A8D6EA87C0BC63208FB058AFC990DEB0,42941,9,10,1,37,47,1897
74686,74686,A8D6EA87C0BC63208FB058AFC990DEB0,11211,15,16,1,34,49,1749
74687,74687,A8D6EA87C0BC63208FB058AFC990DEB0,42921,18,23,5,33,47,1697
74691,74691,58DF107986367FA88C1D627635A20D98,11861,1,2,1,32,47,1647
74692,74692,58DF107986367FA88C1D627635A20D98,40331,3,5,2,30,47,1547
74693,74693,58DF107986367FA88C1D627635A20D98,11861,7,23,16,32,47,1647
74703,74703,A18BBFB8111CE9788BEEE3B918FD7EDC,42941,0,7,7,37,47,1897
74704,74704,A18BBFB8111CE9788BEEE3B918FD7EDC,10411,8,11,3,36,48,1848
74705,74705,A18BBFB8111CE9788BEEE3B918FD7EDC,42941,12,23,11,37,47,1897
74709,74709,C68CEDA8DBBACF2C00D3641E403F56CE,40171,8,10,2,38,48,1948
74710,74710,C68CEDA8DBBACF2C00D3641E403F56CE,10421,14,18,4,41,48,2098
74711,74711,C68CEDA8DBBACF2C00D3641E403F56CE,10781,20,22,2,35,47,1797
74721,74721,0AA5586D6B12F9AD29AA699D8536DBEA,11231,0,7,7,37,49,1899
74722,74722,0AA5586D6B12F9AD29AA699D8536DBEA,42581,8,11,3,38,48,1948
74723,74723,0AA5586D6B12F9AD29AA699D8536DBEA,11231,14,18,4,37,49,1899
74724,74724,C8E87AF8532CEAD2E0037D4C1FBEDF52,13911,0,7,7,39,46,1996
74725,74725,C8E87AF8532CEAD2E0037D4C1FBEDF52,10841,10,11,1,37,47,1897
74726,74726,C8E87AF8532CEAD2E0037D4C1FBEDF52,42351,14,15,1,38,45,1945
74727,74727,C8E87AF8532CEAD2E0037D4C1FBEDF52,42231,19,21,2,37,46,1896
74740,74740,ACB823DB33D22CC4344D979C1DDF92F4,11261,0,6,6,36,46,1846
74741,74741,ACB823DB33D22CC4344D979C1DDF92F4,42861,6,12,6,37,44,1894
74742,74742,ACB823DB33D22CC4344D979C1DDF92F4,11261,12,20,8,36,46,1846
74743,74743,ACB823DB33D22CC4344D979C1DDF92F4,10601,20,22,2,39,47,1997
74749,74749,A30C3A4D08AE45D5E2F0083CE1F142DF,13111,10,12,2,42,46,2146
74750,74750,A30C3A4D08AE45D5E2F0083CE1F142DF,42204,13,15,2,43,46,2196
74751,74751,A30C3A4D08AE45D5E2F0083CE1F142DF,13111,16,20,4,42,46,2146
74752,74752,44A1B2095028F2B1D6198AB3D390B206,11061,0,14,14,29,48,1498
74753,74753,44A1B2095028F2B1D6198AB3D390B206,43971,15,17,2,30,48,1548
74754,74754,44A1B2095028F2B1D6198AB3D390B206,11061,18,23,5,29,48,1498
74755,74755,87563B55F2C858B1A30D9ECB8EED9C7F,42961,0,8,8,35,49,1799
74756,74756,87563B55F2C858B1A30D9ECB8EED9C7F,43581,8,11,3,33,48,1698
74757,74757,87563B55F2C858B1A30D9ECB8EED9C7F,42961,13,23,10,35,49,1799
74758,74758,3FBA130DE96D19DDB92B7C1710211CF0,10611,0,6,6,32,48,1648
74759,74759,3FBA130DE96D19DDB92B7C1710211CF0,10251,7,12,5,35,47,1797
74760,74760,3FBA130DE96D19DDB92B7C1710211CF0,10611,13,23,10,32,48,1648
74775,74775,AA51DE94270AE4663B2578A38D4EECC9,13961,0,13,13,42,48,2148
74776,74776,AA51DE94270AE4663B2578A38D4EECC9,42581,14,16,2,38,48,1948
74777,74777,AA51DE94270AE4663B2578A38D4EECC9,13961,19,22,3,42,48,2148
74778,74778,346DC897D88CC642E017EB94EE877709,42161,2,13,11,36,47,1847
74779,74779,346DC897D88CC642E017EB94EE877709,42471,14,16,2,35,49,1799
74780,74780,346DC897D88CC642E017EB94EE877709,42161,21,23,2,36,47,1847
74781,74781,B3D9D8E72FD92A77A76B6490766A3C36,19901,1,4,3,7,44,394
74782,74782,B3D9D8E72FD92A77A76B6490766A3C36,12641,7,8,1,10,43,543
74783,74783,B3D9D8E72FD92A77A76B6490766A3C36,19114,10,21,11,7,43,393
74789,74789,2D7ACF8AD7E4B49F2A7FD23DB75DC6F1,42971,0,6,6,43,49,2199
74790,74790,2D7ACF8AD7E4B49F2A7FD23DB75DC6F1,10921,8,14,6,43,48,2198
74791,74791,2D7ACF8AD7E4B49F2A7FD23DB75DC6F1,11741,15,16,1,42,49,2149
74792,74792,2D7ACF8AD7E4B49F2A7FD23DB75DC6F1,42971,17,23,6,43,49,2199
74798,74798,460F97EBC86F8CBF93D1A8D6309E0ED8,10901,0,3,3,35,48,1798
74799,74799,460F97EBC86F8CBF93D1A8D6309E0ED8,12381,3,13,10,32,48,1648
74800,74800,460F97EBC86F8CBF93D1A8D6309E0ED8,43311,21,23,2,31,48,1598
74810,74810,37D12B9A785069D9567B986D8917ECC5,10634,8,10,2,27,45,1395
74811,74811,37D12B9A785069D9567B986D8917ECC5,10631,14,16,2,28,46,1446
74812,74812,37D12B9A785069D9567B986D8917ECC5,10351,16,21,5,28,45,1445
74813,74813,A2437A4AEC8E22627D9794D535E77C0B,12641,0,4,4,10,43,543
74814,74814,A2437A4AEC8E22627D9794D535E77C0B,12921,4,6,2,9,41,491
74815,74815,A2437A4AEC8E22627D9794D535E77C0B,12641,8,10,2,10,43,543
74816,74816,A2437A4AEC8E22627D9794D535E77C0B,12921,11,22,11,9,41,491
74817,74817,ECD1768E70E5706355D045A9A7240640,42141,0,6,6,32,47,1647
74818,74818,ECD1768E70E5706355D045A9A7240640,11131,7,9,2,33,48,1698
74819,74819,ECD1768E70E5706355D045A9A7240640,42141,12,22,10,32,47,1647
74831,74831,5FB7FCDE8733B3DE0082FB61D42FC13D,13941,3,4,1,41,47,2097
74832,74832,5FB7FCDE8733B3DE0082FB61D42FC13D,42321,6,14,8,43,47,2197
74833,74833,5FB7FCDE8733B3DE0082FB61D42FC13D,10841,17,18,1,37,47,1897
74839,74839,669C34237215178780FBCDB7F5444D7E,43971,1,3,2,30,48,1548
74840,74840,669C34237215178780FBCDB7F5444D7E,43311,3,9,6,31,48,1598
74841,74841,669C34237215178780FBCDB7F5444D7E,10681,13,17,4,30,48,1548
74842,74842,669C34237215178780FBCDB7F5444D7E,40861,20,22,2,34,48,1748
74848,74848,BF5242715718EEF665EE93EC69F552EB,13271,0,7,7,41,47,2097
74849,74849,BF5242715718EEF665EE93EC69F552EB,13101,10,11,1,40,47,2047
74850,74850,BF5242715718EEF665EE93EC69F552EB,40833,12,14,2,41,47,2097
74851,74851,BF5242715718EEF665EE93EC69F552EB,11481,15,18,3,41,48,2098
74852,74852,ED1B197D1A6AAA8BFAE9A2A66FB2A911,19181,2,5,3,8,40,440
74853,74853,ED1B197D1A6AAA8BFAE9A2A66FB2A911,12921,7,8,1,9,41,491
74854,74854,ED1B197D1A6AAA8BFAE9A2A66FB2A911,49201,9,10,1,7,41,391
74855,74855,ED1B197D1A6AAA8BFAE9A2A66FB2A911,12921,14,23,9,9,41,491
74874,74874,0A61C8BC2E2F3B8A439DFBB7542FD5B0,13371,0,10,10,41,47,2097
74875,74875,0A61C8BC2E2F3B8A439DFBB7542FD5B0,10331,13,14,1,39,46,1996
74876,74876,0A61C8BC2E2F3B8A439DFBB7542FD5B0,13331,15,17,2,38,47,1947
74877,74877,0A61C8BC2E2F3B8A439DFBB7542FD5B0,13371,18,23,5,41,47,2097
74883,74883,700A8469B8648E235281334EF5CC8DA1,10371,0,18,18,37,49,1899
74884,74884,700A8469B8648E235281334EF5CC8DA1,10471,18,20,2,37,48,1898
74885,74885,700A8469B8648E235281334EF5CC8DA1,10371,20,23,3,37,49,1899
74902,74902,0AE1F060A9917578AF6CC39BEF4A5FD7,11914,0,6,6,37,48,1898
74903,74903,0AE1F060A9917578AF6CC39BEF4A5FD7,10371,9,18,9,37,49,1899
74904,74904,0AE1F060A9917578AF6CC39BEF4A5FD7,13101,18,20,2,40,47,2047
74905,74905,23F8F9B0AC0C62AC07DD5CA5BCEDE820,43101,0,5,5,46,40,2340
74906,74906,23F8F9B0AC0C62AC07DD5CA5BCEDE820,13551,7,10,3,45,38,2288
74907,74907,23F8F9B0AC0C62AC07DD5CA5BCEDE820,43101,12,21,9,46,40,2340
74911,74911,508DF001F529FBF83DF8D4A342350BFA,11261,0,7,7,36,46,1846
74912,74912,508DF001F529FBF83DF8D4A342350BFA,42861,7,14,7,37,44,1894
74913,74913,508DF001F529FBF83DF8D4A342350BFA,11261,16,19,3,36,46,1846
74914,74914,508DF001F529FBF83DF8D4A342350BFA,42861,21,22,1,37,44,1894
74915,74915,AC44646418C98ED88B49CF71AB62D672,42861,0,5,5,37,44,1894
74916,74916,AC44646418C98ED88B49CF71AB62D672,43451,8,18,10,37,40,1890
74917,74917,AC44646418C98ED88B49CF71AB62D672,42861,19,20,1,37,44,1894
74923,74923,350909571DAF40BC1326F0871B6F4AC2,42371,0,6,6,34,46,1746
74924,74924,350909571DAF40BC1326F0871B6F4AC2,43761,9,11,2,32,47,1647
74925,74925,350909571DAF40BC1326F0871B6F4AC2,42523,14,17,3,31,47,1597
74926,74926,350909571DAF40BC1326F0871B6F4AC2,10531,18,23,5,34,46,1746
74941,74941,32809330ABBE3BDC7EDF41259F0307C9,10651,1,6,5,36,49,1849
74942,74942,32809330ABBE3BDC7EDF41259F0307C9,11231,8,16,8,37,49,1899
74943,74943,32809330ABBE3BDC7EDF41259F0307C9,11021,16,23,7,36,49,1849
74948,74948,5B606639B0DDA81D89C67819EC5B7D64,13271,6,9,3,41,47,2097
74949,74949,5B606639B0DDA81D89C67819EC5B7D64,11001,11,12,1,42,47,2147
74950,74950,5B606639B0DDA81D89C67819EC5B7D64,13271,20,22,2,41,47,2097
74951,74951,CD55B44A3FD4B718A673CC03711FD344,12921,10,13,3,9,41,491
74952,74952,CD55B44A3FD4B718A673CC03711FD344,12641,16,17,1,10,43,543
74953,74953,CD55B44A3FD4B718A673CC03711FD344,12921,19,21,2,9,41,491
74976,74976,0E44B8203565C08C4FE28AB9B72AEA81,10251,0,7,7,35,47,1797
74977,74977,0E44B8203565C08C4FE28AB9B72AEA81,11351,9,19,10,36,48,1848
74978,74978,0E44B8203565C08C4FE28AB9B72AEA81,40637,21,23,2,36,47,1847
74979,74979,EF24F74DDF741D0DEC0CB3B2510AE4FC,10301,0,5,5,31,45,1595
74980,74980,EF24F74DDF741D0DEC0CB3B2510AE4FC,10351,7,8,1,28,45,1445
74981,74981,EF24F74DDF741D0DEC0CB3B2510AE4FC,10301,10,20,10,31,45,1595
74982,74982,EF24F74DDF741D0DEC0CB3B2510AE4FC,10351,22,23,1,28,45,1445
74988,74988,F0325CEF852754DCE2C27B3EFD10E96B,12221,3,7,4,43,44,2194
74989,74989,F0325CEF852754DCE2C27B3EFD10E96B,13341,11,12,1,44,45,2245
74990,74990,F0325CEF852754DCE2C27B3EFD10E96B,42631,12,22,10,43,45,2195
74994,74994,2873DE93703B028193B7B9719DCFE691,12521,0,7,7,35,41,1791
74995,74995,2873DE93703B028193B7B9719DCFE691,43451,7,8,1,37,40,1890
74996,74996,2873DE93703B028193B7B9719DCFE691,12521,11,23,12,35,41,1791
75008,75008,784B731FB48DA266D31BFD4ACBDB8A39,11021,0,14,14,36,49,1849
75009,75009,784B731FB48DA266D31BFD4ACBDB8A39,12021,15,18,3,37,49,1899
75010,75010,784B731FB48DA266D31BFD4ACBDB8A39,11021,18,23,5,36,49,1849
75011,75011,B9B3660EABE6D031242D915A3C01CD0E,42581,0,14,14,38,48,1948
75012,75012,B9B3660EABE6D031242D915A3C01CD0E,11914,15,21,6,37,48,1898
75013,75013,B9B3660EABE6D031242D915A3C01CD0E,42581,22,23,1,38,48,1948
75022,75022,EDAB0C0B8195ECBA5ACF0AFE7CCDE2D3,11261,5,7,2,36,46,1846
75023,75023,EDAB0C0B8195ECBA5ACF0AFE7CCDE2D3,10811,8,14,6,38,46,1946
75024,75024,EDAB0C0B8195ECBA5ACF0AFE7CCDE2D3,13231,15,19,4,39,46,1996
75025,75025,EDAB0C0B8195ECBA5ACF0AFE7CCDE2D3,11261,20,22,2,36,46,1846
75033,75033,8860F485E5911A51D7DB4B8D2B543310,42301,7,8,1,36,47,1847
75034,75034,8860F485E5911A51D7DB4B8D2B543310,42511,8,9,1,37,47,1897
75035,75035,8860F485E5911A51D7DB4B8D2B543310,42301,12,19,7,36,47,1847
75043,75043,B730A33E99587C5901F2126A9B1336FE,11261,0,12,12,36,46,1846
75044,75044,B730A33E99587C5901F2126A9B1336FE,42861,15,16,1,37,44,1894
75045,75045,B730A33E99587C5901F2126A9B1336FE,11261,16,22,6,36,46,1846
75049,75049,1412AB8F73A5DF3DD4E19FD5B213A64B,13711,0,16,16,38,46,1946
75050,75050,1412AB8F73A5DF3DD4E19FD5B213A64B,42231,16,18,2,37,46,1896
75051,75051,1412AB8F73A5DF3DD4E19FD5B213A64B,13711,21,23,2,38,46,1946
75052,75052,608281F49B8743773A88333F4755F6E4,42231,0,8,8,37,46,1896
75053,75053,608281F49B8743773A88333F4755F6E4,41027,9,11,2,38,47,1947
75054,75054,608281F49B8743773A88333F4755F6E4,42231,12,23,11,37,46,1896
75055,75055,72EE059838FC074BF0955787969E7967,11231,0,4,4,37,49,1899
75056,75056,72EE059838FC074BF0955787969E7967,11911,4,13,9,37,48,1898
75057,75057,72EE059838FC074BF0955787969E7967,11531,17,18,1,34,49,1749
75058,75058,72EE059838FC074BF0955787969E7967,11231,20,23,3,37,49,1899
75062,75062,91284BBE72A4661BF1E53E3FAFD2E3D8,10292,1,13,12,30,47,1547
75063,75063,91284BBE72A4661BF1E53E3FAFD2E3D8,42523,14,16,2,31,47,1597
75064,75064,91284BBE72A4661BF1E53E3FAFD2E3D8,10295,18,23,5,30,47,1547
75078,75078,5566DF9556BCD612F8500FB496AD53B3,11861,0,7,7,32,47,1647
75079,75079,5566DF9556BCD612F8500FB496AD53B3,13651,7,11,4,30,47,1547
75080,75080,5566DF9556BCD612F8500FB496AD53B3,11861,12,22,10,32,47,1647
75086,75086,8E0D20320C5276BDD797BA6D65B9C51D,11074,0,7,7,37,47,1897
75087,75087,8E0D20320C5276BDD797BA6D65B9C51D,11231,10,18,8,37,49,1899
75088,75088,8E0D20320C5276BDD797BA6D65B9C51D,11074,18,23,5,37,47,1897
75117,75117,C35D795DA33BE0311413852FD4760F3A,11261,0,6,6,36,46,1846
75118,75118,C35D795DA33BE0311413852FD4760F3A,42151,7,9,2,35,45,1795
75119,75119,C35D795DA33BE0311413852FD4760F3A,11261,11,22,11,36,46,1846
75120,75120,F1E96F9E4E441923B019E444D21D015B,10121,0,18,18,36,49,1849
75121,75121,F1E96F9E4E441923B019E444D21D015B,11231,18,19,1,37,49,1899
75122,75122,F1E96F9E4E441923B019E444D21D015B,10121,19,23,4,36,49,1849
75123,75123,3F92550AE7FA536C6ED9DF3D484ADD7A,13711,0,13,13,38,46,1946
75124,75124,3F92550AE7FA536C6ED9DF3D484ADD7A,11261,14,16,2,36,46,1846
75125,75125,3F92550AE7FA536C6ED9DF3D484ADD7A,10811,19,21,2,38,46,1946
75126,75126,DA48F6EEC4784B4505CA1BBB58EA121A,10341,0,7,7,31,47,1597
75127,75127,DA48F6EEC4784B4505CA1BBB58EA121A,10292,8,17,9,30,47,1547
75128,75128,DA48F6EEC4784B4505CA1BBB58EA121A,10341,17,23,6,31,47,1597
75129,75129,32EC0F36441544FE0077B62E357B89B9,12921,7,10,3,9,41,491
75130,75130,32EC0F36441544FE0077B62E357B89B9,12641,14,15,1,10,43,543
75131,75131,32EC0F36441544FE0077B62E357B89B9,12921,15,23,8,9,41,491
75149,75149,F94E5CCB50337D3F418291F67EA7B8C3,42071,0,12,12,31,49,1599
75150,75150,F94E5CCB50337D3F418291F67EA7B8C3,11151,13,16,3,30,48,1548
75151,75151,F94E5CCB50337D3F418291F67EA7B8C3,42071,16,18,2,31,49,1599
75152,75152,857A8E0D6DC1B408B8273E584D9A8FC4,13371,0,12,12,41,47,2097
75153,75153,857A8E0D6DC1B408B8273E584D9A8FC4,13221,14,17,3,40,47,2047
75154,75154,857A8E0D6DC1B408B8273E584D9A8FC4,13371,17,19,2,41,47,2097
75155,75155,857A8E0D6DC1B408B8273E584D9A8FC4,11806,22,23,1,41,48,2098
75156,75156,4A7E0C26D094908459DFDB4A502F3938,42161,0,8,8,36,47,1847
75157,75157,4A7E0C26D094908459DFDB4A502F3938,10591,8,10,2,39,48,1998
75158,75158,4A7E0C26D094908459DFDB4A502F3938,41612,10,23,13,36,47,1847
75166,75166,2EFEA3D9E50D1587D2C8297E61F47270,11091,0,13,13,29,47,1497
75167,75167,2EFEA3D9E50D1587D2C8297E61F47270,42523,14,16,2,31,47,1597
75168,75168,2EFEA3D9E50D1587D2C8297E61F47270,11091,19,23,4,29,47,1497
75169,75169,1C1BDEE72C59AB3D15F95F838C21E5AB,19441,0,14,14,8,46,446
75170,75170,1C1BDEE72C59AB3D15F95F838C21E5AB,12621,14,19,5,10,48,548
75171,75171,1C1BDEE72C59AB3D15F95F838C21E5AB,19441,20,23,3,8,46,446
75177,75177,05A4FED2A1FD7CF9F91F3FB2FB819541,42491,2,10,8,32,46,1646
75178,75178,05A4FED2A1FD7CF9F91F3FB2FB819541,12311,13,17,4,30,44,1544
75179,75179,05A4FED2A1FD7CF9F91F3FB2FB819541,42531,20,22,2,31,45,1595
75180,75180,05A4FED2A1FD7CF9F91F3FB2FB819541,12311,22,23,1,30,44,1544
75181,75181,6EBC343B289E845421579091E3F37018,42091,0,5,5,43,46,2196
75182,75182,6EBC343B289E845421579091E3F37018,13791,7,8,1,42,47,2147
75183,75183,6EBC343B289E845421579091E3F37018,42321,10,14,4,43,47,2197
75184,75184,6EBC343B289E845421579091E3F37018,42204,18,23,5,43,46,2196
75185,75185,5C633B6A90713EC538BFB33DCFC3172F,13911,0,6,6,39,46,1996
75186,75186,5C633B6A90713EC538BFB33DCFC3172F,42231,6,7,1,37,46,1896
75187,75187,5C633B6A90713EC538BFB33DCFC3172F,13911,10,15,5,39,46,1996
75188,75188,5C633B6A90713EC538BFB33DCFC3172F,42231,17,21,4,37,46,1896
75192,75192,24CACD73BA8D75767DDD668E5EA165E2,40171,0,6,6,38,48,1948
75193,75193,24CACD73BA8D75767DDD668E5EA165E2,11914,8,10,2,37,48,1898
75194,75194,24CACD73BA8D75767DDD668E5EA165E2,42191,12,14,2,38,49,1949
75195,75195,24CACD73BA8D75767DDD668E5EA165E2,11914,14,20,6,37,48,1898
75196,75196,51E79D88F03D2AA1A256DD1FA70D766A,13271,0,10,10,41,47,2097
75197,75197,51E79D88F03D2AA1A256DD1FA70D766A,13101,10,11,1,40,47,2047
75198,75198,51E79D88F03D2AA1A256DD1FA70D766A,40833,12,23,11,41,47,2097
75199,75199,582FCEF67ED9C80E5B2E8667690F61FB,42221,0,6,6,38,48,1948
75200,75200,582FCEF67ED9C80E5B2E8667690F61FB,10251,7,9,2,35,47,1797
75201,75201,582FCEF67ED9C80E5B2E8667690F61FB,42221,12,16,4,38,48,1948
75202,75202,582FCEF67ED9C80E5B2E8667690F61FB,42401,18,22,4,36,47,1847
75231,75231,A349D8C83E1914464A7CDA23A563E70B,42523,0,14,14,31,47,1597
75232,75232,A349D8C83E1914464A7CDA23A563E70B,43761,18,20,2,32,47,1647
75233,75233,A349D8C83E1914464A7CDA23A563E70B,42523,22,23,1,31,47,1597
75234,75234,853A16C8E6E154D13F9864F752CCB2E5,13101,2,5,3,40,47,2047
75235,75235,853A16C8E6E154D13F9864F752CCB2E5,11481,6,18,12,41,48,2098
75236,75236,853A16C8E6E154D13F9864F752CCB2E5,13101,20,21,1,40,47,2047
75241,75241,D604CE1D6F1A7F1409A082A5844B835D,10292,0,14,14,30,47,1547
75242,75242,D604CE1D6F1A7F1409A082A5844B835D,10351,16,17,1,28,45,1445
75243,75243,D604CE1D6F1A7F1409A082A5844B835D,10292,20,23,3,30,47,1547
75244,75244,963A0F348590A4DAF35C4B4A22C7CAB8,10151,0,7,7,34,47,1747
75245,75245,963A0F348590A4DAF35C4B4A22C7CAB8,12514,8,9,1,38,47,1947
75246,75246,963A0F348590A4DAF35C4B4A22C7CAB8,10151,14,15,1,34,47,1747
75247,75247,963A0F348590A4DAF35C4B4A22C7CAB8,12514,18,20,2,38,47,1947
75251,75251,3637B25998C44A6FD1B066A0EE49BC38,11861,0,11,11,32,47,1647
75252,75252,3637B25998C44A6FD1B066A0EE49BC38,11161,13,14,1,32,48,1648
75253,75253,3637B25998C44A6FD1B066A0EE49BC38,10281,15,20,5,33,48,1698
75254,75254,3637B25998C44A6FD1B066A0EE49BC38,11861,21,23,2,32,47,1647
75262,75262,5D467CB7C3D63DF2F50205BF5091A01C,11151,2,6,4,30,48,1548
75263,75263,5D467CB7C3D63DF2F50205BF5091A01C,11061,9,12,3,29,48,1498
75264,75264,5D467CB7C3D63DF2F50205BF5091A01C,11151,14,16,2,30,48,1548
75265,75265,5D467CB7C3D63DF2F50205BF5091A01C,11061,18,21,3,29,48,1498
75275,75275,DC9866094212A637CCAC17CF01FE4B5F,42861,0,5,5,37,44,1894
75276,75276,DC9866094212A637CCAC17CF01FE4B5F,11261,8,18,10,36,46,1846
75277,75277,DC9866094212A637CCAC17CF01FE4B5F,42861,19,23,4,37,44,1894
75278,75278,2BC714C204CBBFEE616B46CC493E087B,12641,0,3,3,10,43,543
75279,75279,2BC714C204CBBFEE616B46CC493E087B,19901,7,8,1,7,44,394
75280,75280,2BC714C204CBBFEE616B46CC493E087B,12921,12,17,5,9,41,491
75281,75281,2BC714C204CBBFEE616B46CC493E087B,12641,18,23,5,10,43,543
75282,75282,A80E0E559C72C300E854E814CFE7ADD2,10661,0,8,8,37,49,1899
75283,75283,A80E0E559C72C300E854E814CFE7ADD2,41271,9,10,1,38,48,1948
75284,75284,A80E0E559C72C300E854E814CFE7ADD2,11231,12,23,11,37,49,1899
75290,75290,7C5210855A5DFB6ACF7A087ADA0E2F3D,13911,3,9,6,39,46,1996
75291,75291,7C5210855A5DFB6ACF7A087ADA0E2F3D,42231,9,17,8,37,46,1896
75292,75292,7C5210855A5DFB6ACF7A087ADA0E2F3D,13911,17,18,1,39,46,1996
75293,75293,7C5210855A5DFB6ACF7A087ADA0E2F3D,42231,19,22,3,37,46,1896
75299,75299,446AC7E279C6659F3E40FC9C0B9B7F45,13341,0,6,6,44,45,2245
75300,75300,446AC7E279C6659F3E40FC9C0B9B7F45,43061,6,7,1,43,46,2196
75301,75301,446AC7E279C6659F3E40FC9C0B9B7F45,13341,7,19,12,44,45,2245
75302,75302,446AC7E279C6659F3E40FC9C0B9B7F45,43061,22,23,1,43,46,2196
75307,75307,88E11D7A9C00B2BC0AF1511EBFFBF09D,10271,0,9,9,37,46,1896
75308,75308,88E11D7A9C00B2BC0AF1511EBFFBF09D,13711,12,19,7,38,46,1946
75309,75309,88E11D7A9C00B2BC0AF1511EBFFBF09D,10271,20,22,2,37,46,1896
75310,75310,D9FB9F3F4820A4EF951566780A770C45,13911,5,6,1,39,46,1996
75311,75311,D9FB9F3F4820A4EF951566780A770C45,11261,6,15,9,36,46,1846
75312,75312,D9FB9F3F4820A4EF951566780A770C45,13911,15,16,1,39,46,1996
75313,75313,D9FB9F3F4820A4EF951566780A770C45,11261,16,22,6,36,46,1846
75320,75320,746607B162E7EB25AA57FCC2A7B9163E,11861,0,8,8,32,47,1647
75321,75321,746607B162E7EB25AA57FCC2A7B9163E,43671,17,18,1,35,48,1798
75322,75322,746607B162E7EB25AA57FCC2A7B9163E,11861,19,23,4,32,47,1647
75323,75323,9582B0C41CE65E76B09E8491AC26676B,11875,0,5,5,30,46,1546
75324,75324,9582B0C41CE65E76B09E8491AC26676B,12311,8,17,9,30,44,1544
75325,75325,9582B0C41CE65E76B09E8491AC26676B,11871,19,23,4,29,46,1496
75338,75338,7681E0D68D024C184A5D43D46389C591,43761,0,2,2,32,47,1647
75339,75339,7681E0D68D024C184A5D43D46389C591,42921,3,11,8,33,47,1697
75340,75340,7681E0D68D024C184A5D43D46389C591,43761,12,23,11,32,47,1647
75346,75346,829F3CF969A99106A0CF5C6D0ED0FE14,42401,0,8,8,36,47,1847
75347,75347,829F3CF969A99106A0CF5C6D0ED0FE14,11751,9,15,6,35,48,1798
75348,75348,829F3CF969A99106A0CF5C6D0ED0FE14,42161,16,23,7,36,47,1847
75369,75369,81A0A832750D87F13BE469519DF7D944,12311,3,13,10,30,44,1544
75370,75370,81A0A832750D87F13BE469519DF7D944,10301,17,19,2,31,45,1595
75371,75371,81A0A832750D87F13BE469519DF7D944,12311,20,23,3,30,44,1544
75377,75377,8343E7E93A34C93DB26D9CD9CDF592E5,43581,0,7,7,33,48,1698
75378,75378,8343E7E93A34C93DB26D9CD9CDF592E5,10251,9,18,9,35,47,1797
75379,75379,8343E7E93A34C93DB26D9CD9CDF592E5,43581,19,23,4,33,48,1698
75385,75385,61A1DA344C3BE9986C1C76744B99863C,42201,1,7,6,43,46,2196
75386,75386,61A1DA344C3BE9986C1C76744B99863C,13111,8,10,2,42,46,2146
75387,75387,61A1DA344C3BE9986C1C76744B99863C,42201,12,13,1,43,46,2196
75388,75388,61A1DA344C3BE9986C1C76744B99863C,13111,14,23,9,42,46,2146
75389,75389,5E9662A656E5A4C6BC4104240F4E1743,42204,0,1,1,43,46,2196
75390,75390,5E9662A656E5A4C6BC4104240F4E1743,13791,2,6,4,42,47,2147
75391,75391,5E9662A656E5A4C6BC4104240F4E1743,42204,7,9,2,43,46,2196
75392,75392,5E9662A656E5A4C6BC4104240F4E1743,13111,11,21,10,42,46,2146
75393,75393,863093DB11F1063670E11FFAF49890AF,42631,0,5,5,43,45,2195
75394,75394,863093DB11F1063670E11FFAF49890AF,13341,7,16,9,44,45,2245
75395,75395,863093DB11F1063670E11FFAF49890AF,42631,16,17,1,43,45,2195
75396,75396,863093DB11F1063670E11FFAF49890AF,43061,18,23,5,43,46,2196
75400,75400,991C231435E2475229D5984B24FCA64E,40891,1,10,9,37,47,1897
75401,75401,991C231435E2475229D5984B24FCA64E,13101,12,14,2,40,47,2047
75402,75402,991C231435E2475229D5984B24FCA64E,40891,16,18,2,37,47,1897
75406,75406,5AF85D9ED958D0E5348613692DAC5B4D,10901,0,2,2,35,48,1798
75407,75407,5AF85D9ED958D0E5348613692DAC5B4D,11231,2,14,12,37,49,1899
75408,75408,5AF85D9ED958D0E5348613692DAC5B4D,10731,17,18,1,33,47,1697
75409,75409,5AF85D9ED958D0E5348613692DAC5B4D,11541,20,23,3,35,49,1799
75410,75410,E24F34B965BE1054DCE4AF1C1CD48137,42021,1,2,1,33,47,1697
75411,75411,E24F34B965BE1054DCE4AF1C1CD48137,13601,2,4,2,34,47,1747
75412,75412,E24F34B965BE1054DCE4AF1C1CD48137,43761,4,6,2,32,47,1647
75413,75413,E24F34B965BE1054DCE4AF1C1CD48137,11875,11,21,10,30,46,1546
75414,75414,6C5686894FB32FFE8BBC9C074B78072A,10471,0,11,11,37,48,1898
75415,75415,6C5686894FB32FFE8BBC9C074B78072A,42981,12,13,1,36,49,1849
75416,75416,6C5686894FB32FFE8BBC9C074B78072A,11914,15,18,3,37,48,1898
75426,75426,BF1C25FEA2CAF96E8C013A91242C0773,11531,0,1,1,34,49,1749
75427,75427,BF1C25FEA2CAF96E8C013A91242C0773,11591,5,7,2,36,49,1849
75428,75428,BF1C25FEA2CAF96E8C013A91242C0773,11531,11,22,11,34,49,1749
75429,75429,4B5C492CF16B079882322240829D6566,11231,0,14,14,37,49,1899
75430,75430,4B5C492CF16B079882322240829D6566,10471,16,19,3,37,48,1898
75431,75431,4B5C492CF16B079882322240829D6566,11231,20,22,2,37,49,1899
75435,75435,64812FF1B8835C5669BB93C0D5307414,11231,0,13,13,37,49,1899
75436,75436,64812FF1B8835C5669BB93C0D5307414,41271,14,15,1,38,48,1948
75437,75437,64812FF1B8835C5669BB93C0D5307414,11231,20,23,3,37,49,1899
75438,75438,7A3B81BDAFB4DD2FC896155A8BEFF9BB,11521,0,9,9,41,48,2098
75439,75439,7A3B81BDAFB4DD2FC896155A8BEFF9BB,11001,12,16,4,42,47,2147
75440,75440,7A3B81BDAFB4DD2FC896155A8BEFF9BB,13941,17,18,1,41,47,2097
75441,75441,7A3B81BDAFB4DD2FC896155A8BEFF9BB,11521,18,23,5,41,48,2098
75442,75442,11D0C3BFA1EEA48E71CAB72BD84A5D2F,13671,1,4,3,27,43,1393
75443,75443,11D0C3BFA1EEA48E71CAB72BD84A5D2F,10351,6,8,2,28,45,1445
75444,75444,11D0C3BFA1EEA48E71CAB72BD84A5D2F,10634,11,23,12,27,45,1395
75445,75445,E45B0EC44E00842EDD865C65A561543D,11791,0,7,7,38,49,1949
75446,75446,E45B0EC44E00842EDD865C65A561543D,10471,10,13,3,37,48,1898
75447,75447,E45B0EC44E00842EDD865C65A561543D,11231,13,14,1,37,49,1899
75448,75448,E45B0EC44E00842EDD865C65A561543D,10221,18,20,2,34,49,1749
75449,75449,D54F9F7B5ACE26D54228A669C839B9DF,42231,0,5,5,37,46,1896
75450,75450,D54F9F7B5ACE26D54228A669C839B9DF,42351,6,9,3,38,45,1945
75451,75451,D54F9F7B5ACE26D54228A669C839B9DF,42231,9,23,14,37,46,1896
75452,75452,56E206F1CDD0789AFDBC5B3F197C6FFD,43731,0,15,15,34,47,1747
75453,75453,56E206F1CDD0789AFDBC5B3F197C6FFD,11541,16,19,3,35,49,1799
75454,75454,56E206F1CDD0789AFDBC5B3F197C6FFD,11751,20,21,1,35,48,1798
75455,75455,56E206F1CDD0789AFDBC5B3F197C6FFD,43731,22,23,1,34,47,1747
75456,75456,3B86E1CB99F9A063FEA255A004EE193F,13341,0,4,4,44,45,2245
75457,75457,3B86E1CB99F9A063FEA255A004EE193F,12211,8,9,1,41,44,2094
75458,75458,3B86E1CB99F9A063FEA255A004EE193F,13341,12,20,8,44,45,2245
75467,75467,830067E97972F27E1AE4923131398E88,42491,2,3,1,32,46,1646
75468,75468,830067E97972F27E1AE4923131398E88,13651,3,8,5,30,47,1547
75469,75469,830067E97972F27E1AE4923131398E88,42523,9,19,10,31,47,1597
75476,75476,DFD67893B33D33FDAA92DC71D5732DAF,42161,0,4,4,36,47,1847
75477,75477,DFD67893B33D33FDAA92DC71D5732DAF,10111,5,6,1,37,47,1897
75478,75478,DFD67893B33D33FDAA92DC71D5732DAF,42161,8,23,15,36,47,1847
75479,75479,BF11F158BB981034C1A44258D3F4A9AC,42523,2,14,12,31,47,1597
75480,75480,BF11F158BB981034C1A44258D3F4A9AC,11061,19,21,2,29,48,1498
75481,75481,BF11F158BB981034C1A44258D3F4A9AC,11381,22,23,1,30,47,1547
75487,75487,0C993A1B5BD23944DD153F92F92FAA1E,10634,0,1,1,27,45,1395
75488,75488,0C993A1B5BD23944DD153F92F92FAA1E,10351,2,21,19,28,45,1445
75489,75489,0C993A1B5BD23944DD153F92F92FAA1E,10634,22,23,1,27,45,1395
75505,75505,9C686B624E1F19B96755FA9920EEF4B6,42301,0,1,1,36,47,1847
75506,75506,9C686B624E1F19B96755FA9920EEF4B6,42921,1,7,6,33,47,1697
75507,75507,9C686B624E1F19B96755FA9920EEF4B6,13911,8,9,1,39,46,1996
75508,75508,9C686B624E1F19B96755FA9920EEF4B6,42921,11,23,12,33,47,1697
75521,75521,2950F1088A03A09C07AF5353742B9FD8,11161,1,14,13,32,48,1648
75522,75522,2950F1088A03A09C07AF5353742B9FD8,10681,18,19,1,30,48,1548
75523,75523,2950F1088A03A09C07AF5353742B9FD8,11161,19,22,3,32,48,1648
75524,75524,642CD1BCB1D6034CF33B22265CC8DC30,42501,2,3,1,28,47,1447
75525,75525,642CD1BCB1D6034CF33B22265CC8DC30,42541,4,8,4,25,47,1297
75526,75526,642CD1BCB1D6034CF33B22265CC8DC30,11061,13,14,1,29,48,1498
75527,75527,642CD1BCB1D6034CF33B22265CC8DC30,12121,19,21,2,29,47,1497
75528,75528,4C277ABE9AAFFACC84B539B0700C1F48,10221,1,18,17,34,49,1749
75529,75529,4C277ABE9AAFFACC84B539B0700C1F48,10161,20,21,1,35,49,1799
75530,75530,4C277ABE9AAFFACC84B539B0700C1F48,11531,22,23,1,34,49,1749
75538,75538,D8AE02857BA77543AC93BD79AFFC45E0,11801,0,14,14,42,48,2148
75539,75539,D8AE02857BA77543AC93BD79AFFC45E0,42583,15,17,2,40,48,2048
75540,75540,D8AE02857BA77543AC93BD79AFFC45E0,11801,21,23,2,42,48,2148
75541,75541,9BBBC00C93BA6A3176E2B008E6F8A88E,42351,0,4,4,38,45,1945
75542,75542,9BBBC00C93BA6A3176E2B008E6F8A88E,11261,5,17,12,36,46,1846
75543,75543,9BBBC00C93BA6A3176E2B008E6F8A88E,11941,18,20,2,37,46,1896
75544,75544,9BBBC00C93BA6A3176E2B008E6F8A88E,13911,22,23,1,39,46,1996
75554,75554,01067BD464140B42D6F1D4D82F8B8EE7,43481,0,8,8,39,48,1998
75555,75555,01067BD464140B42D6F1D4D82F8B8EE7,11231,9,15,6,37,49,1899
75556,75556,01067BD464140B42D6F1D4D82F8B8EE7,11301,16,17,1,41,49,2099
75557,75557,01067BD464140B42D6F1D4D82F8B8EE7,13941,20,21,1,41,47,2097
75576,75576,0D947EBDA1250C07F4411B7BDAEBFDBC,10631,0,6,6,28,46,1446
75577,75577,0D947EBDA1250C07F4411B7BDAEBFDBC,10634,6,7,1,27,45,1395
75578,75578,0D947EBDA1250C07F4411B7BDAEBFDBC,10631,8,19,11,28,46,1446
75579,75579,0D947EBDA1250C07F4411B7BDAEBFDBC,42531,20,21,1,31,45,1595
75580,75580,9508FAE0B774FCD97D7CFB3C4BD72215,42401,0,8,8,36,47,1847
75581,75581,9508FAE0B774FCD97D7CFB3C4BD72215,42351,8,9,1,38,45,1945
75582,75582,9508FAE0B774FCD97D7CFB3C4BD72215,10111,12,21,9,37,47,1897
75583,75583,9508FAE0B774FCD97D7CFB3C4BD72215,10251,22,23,1,35,47,1797
75587,75587,E08A998E96875BC2FB605F71696F898C,11061,1,5,4,29,48,1498
75588,75588,E08A998E96875BC2FB605F71696F898C,11381,6,12,6,30,47,1547
75589,75589,E08A998E96875BC2FB605F71696F898C,11061,12,14,2,29,48,1498
75590,75590,E08A998E96875BC2FB605F71696F898C,11381,14,19,5,30,47,1547
75596,75596,D9B08428B230A26F9D8108567961B570,11281,0,4,4,27,40,1390
75597,75597,D9B08428B230A26F9D8108567961B570,13671,5,10,5,27,43,1393
75598,75598,D9B08428B230A26F9D8108567961B570,11281,14,15,1,27,40,1390
75599,75599,D9B08428B230A26F9D8108567961B570,13671,19,23,4,27,43,1393
75605,75605,FF16D1104349162E539969031BE39A02,12514,3,5,2,38,47,1947
75606,75606,FF16D1104349162E539969031BE39A02,12511,6,18,12,39,47,1997
75607,75607,FF16D1104349162E539969031BE39A02,12514,21,23,2,38,47,1947
75608,75608,780CF605B987CE4335E0B64DFA86ACBF,11921,0,2,2,38,48,1948
75609,75609,780CF605B987CE4335E0B64DFA86ACBF,12514,7,9,2,38,47,1947
75610,75610,780CF605B987CE4335E0B64DFA86ACBF,11921,13,14,1,38,48,1948
75611,75611,780CF605B987CE4335E0B64DFA86ACBF,12514,17,22,5,38,47,1947
75612,75612,21214DF25ABBFE57C13DD19922691751,13911,0,8,8,39,46,1996
75613,75613,21214DF25ABBFE57C13DD19922691751,11261,12,18,6,36,46,1846
75614,75614,21214DF25ABBFE57C13DD19922691751,13911,21,22,1,39,46,1996
75615,75615,CF7DA1891D00F069E0E0214450037183,11381,2,11,9,30,47,1547
75616,75616,CF7DA1891D00F069E0E0214450037183,11061,13,14,1,29,48,1498
75617,75617,CF7DA1891D00F069E0E0214450037183,12121,17,18,1,29,47,1497
75618,75618,CF7DA1891D00F069E0E0214450037183,11061,21,22,1,29,48,1498
75624,75624,A800B85E69AEF40DD30E7A0CD7B3E8FA,42864,0,5,5,38,44,1944
75625,75625,A800B85E69AEF40DD30E7A0CD7B3E8FA,11261,10,11,1,36,46,1846
75626,75626,A800B85E69AEF40DD30E7A0CD7B3E8FA,42864,14,23,9,38,44,1944
75635,75635,07E8F527E3C22F701EF1E12272A919B5,12514,0,6,6,38,47,1947
75636,75636,07E8F527E3C22F701EF1E12272A919B5,11074,7,11,4,37,47,1897
75637,75637,07E8F527E3C22F701EF1E12272A919B5,12514,14,19,5,38,47,1947
75653,75653,50CCAF8374278F69B5D27E6BC1773F79,43471,0,8,8,31,49,1599
75654,75654,50CCAF8374278F69B5D27E6BC1773F79,10881,9,12,3,34,48,1748
75655,75655,50CCAF8374278F69B5D27E6BC1773F79,10401,16,19,3,33,49,1699
75656,75656,7875A34DC3B1C1A6D18480769685A825,42231,0,1,1,37,46,1896
75657,75657,7875A34DC3B1C1A6D18480769685A825,13911,1,6,5,39,46,1996
75658,75658,7875A34DC3B1C1A6D18480769685A825,42231,6,15,9,37,46,1896
75659,75659,7875A34DC3B1C1A6D18480769685A825,13911,17,18,1,39,46,1996
75668,75668,FCA3C665B5BF337F331669EDB597A6AC,42791,0,7,7,35,45,1795
75669,75669,FCA3C665B5BF337F331669EDB597A6AC,13121,10,12,2,38,46,1946
75670,75670,FCA3C665B5BF337F331669EDB597A6AC,10271,13,14,1,37,46,1896
75671,75671,FCA3C665B5BF337F331669EDB597A6AC,13121,16,18,2,38,46,1946
75672,75672,43D5A4B21D49F330FF46E8A3E900BDBD,10901,0,8,8,35,48,1798
75673,75673,43D5A4B21D49F330FF46E8A3E900BDBD,11231,8,15,7,37,49,1899
75674,75674,43D5A4B21D49F330FF46E8A3E900BDBD,10901,18,23,5,35,48,1798
75686,75686,806223F4E6A75E30DD9FB8BC0E922847,11061,0,16,16,29,48,1498
75687,75687,806223F4E6A75E30DD9FB8BC0E922847,11151,16,17,1,30,48,1548
75688,75688,806223F4E6A75E30DD9FB8BC0E922847,11061,17,23,6,29,48,1498
75692,75692,699FC37C4A3C1BE0E52FD4FA41152EDE,11321,0,6,6,31,46,1596
75693,75693,699FC37C4A3C1BE0E52FD4FA41152EDE,12311,6,7,1,30,44,1544
75694,75694,699FC37C4A3C1BE0E52FD4FA41152EDE,11061,8,15,7,29,48,1498
75695,75695,699FC37C4A3C1BE0E52FD4FA41152EDE,11321,20,23,3,31,46,1596
75696,75696,7891B7CAFE636F79B910CD86C28C9F07,11651,0,10,10,33,47,1697
75697,75697,7891B7CAFE636F79B910CD86C28C9F07,10971,11,12,1,35,47,1797
75698,75698,7891B7CAFE636F79B910CD86C28C9F07,10731,15,17,2,33,47,1697
75699,75699,7891B7CAFE636F79B910CD86C28C9F07,43731,22,23,1,34,47,1747
75700,75700,F60275774A8E100C709A8CD8761F5FF3,13111,0,10,10,42,46,2146
75701,75701,F60275774A8E100C709A8CD8761F5FF3,13221,12,16,4,40,47,2047
75702,75702,F60275774A8E100C709A8CD8761F5FF3,13111,17,21,4,42,46,2146
75703,75703,F60275774A8E100C709A8CD8761F5FF3,10771,21,22,1,41,46,2096
75704,75704,8D2C2C42E63FD22BFD992889F79D269F,43761,0,5,5,32,47,1647
75705,75705,8D2C2C42E63FD22BFD992889F79D269F,42523,6,7,1,31,47,1597
75706,75706,8D2C2C42E63FD22BFD992889F79D269F,11061,8,23,15,29,48,1498
75707,75707,1F5F12E31F77D0569EB02D1A77314801,11061,1,13,12,29,48,1498
75708,75708,1F5F12E31F77D0569EB02D1A77314801,11381,15,18,3,30,47,1547
75709,75709,1F5F12E31F77D0569EB02D1A77314801,11061,18,23,5,29,48,1498
75710,75710,3CFF352FC0F760E9B7CC6021501C3AD4,11061,0,16,16,29,48,1498
75711,75711,3CFF352FC0F760E9B7CC6021501C3AD4,11151,17,21,4,30,48,1548
75712,75712,3CFF352FC0F760E9B7CC6021501C3AD4,11061,21,23,2,29,48,1498
75739,75739,AEB67BDC79FE6552942E6F2DEC149F32,11551,3,15,12,39,49,1999
75740,75740,AEB67BDC79FE6552942E6F2DEC149F32,40302,19,21,2,40,49,2049
75741,75741,AEB67BDC79FE6552942E6F2DEC149F32,11551,21,23,2,39,49,1999
75742,75742,B4B9EF8B2509C5B7E6B8F05B2AFC5406,13101,0,1,1,40,47,2047
75743,75743,B4B9EF8B2509C5B7E6B8F05B2AFC5406,11074,1,7,6,37,47,1897
75744,75744,B4B9EF8B2509C5B7E6B8F05B2AFC5406,11811,9,13,4,38,49,1949
75745,75745,B4B9EF8B2509C5B7E6B8F05B2AFC5406,11074,15,22,7,37,47,1897
75746,75746,21BFC9B680F0329C7CDCB5AE45B398FD,42161,0,7,7,36,47,1847
75747,75747,21BFC9B680F0329C7CDCB5AE45B398FD,10111,8,11,3,37,47,1897
75748,75748,21BFC9B680F0329C7CDCB5AE45B398FD,42161,11,18,7,36,47,1847
75749,75749,21BFC9B680F0329C7CDCB5AE45B398FD,10251,18,22,4,35,47,1797
75750,75750,C2938F6FA2A943D6DFC754D5D6C219D6,12514,0,8,8,38,47,1947
75751,75751,C2938F6FA2A943D6DFC754D5D6C219D6,42221,12,13,1,38,48,1948
75752,75752,C2938F6FA2A943D6DFC754D5D6C219D6,11074,15,17,2,37,47,1897
75753,75753,C2938F6FA2A943D6DFC754D5D6C219D6,42221,19,20,1,38,48,1948
75754,75754,2E7CC4EF44F5328D020B21B2138E3C1D,11061,2,10,8,29,48,1498
75755,75755,2E7CC4EF44F5328D020B21B2138E3C1D,10711,10,14,4,29,46,1496
75756,75756,2E7CC4EF44F5328D020B21B2138E3C1D,11061,17,22,5,29,48,1498
75796,75796,588E15A77FCC47ACFBD5B3F12EED10C8,13111,0,9,9,42,46,2146
75797,75797,588E15A77FCC47ACFBD5B3F12EED10C8,13791,9,10,1,42,47,2147
75798,75798,588E15A77FCC47ACFBD5B3F12EED10C8,13111,11,23,12,42,46,2146
75799,75799,7A6C1F91C08B692A643E0B4791AE2CE6,12521,0,14,14,35,41,1791
75800,75800,7A6C1F91C08B692A643E0B4791AE2CE6,43451,14,17,3,37,40,1890
75801,75801,7A6C1F91C08B692A643E0B4791AE2CE6,12521,18,23,5,35,41,1791
75809,75809,45E2591DDB181830E886EA4FBDDB1E4F,42371,0,5,5,34,46,1746
75810,75810,45E2591DDB181830E886EA4FBDDB1E4F,42021,6,8,2,33,47,1697
75811,75811,45E2591DDB181830E886EA4FBDDB1E4F,10151,9,19,10,34,47,1747
75812,75812,45E2591DDB181830E886EA4FBDDB1E4F,42021,20,21,1,33,47,1697
75813,75813,FB473FBE3EAFD3A14A7452241F377171,19441,1,3,2,8,46,446
75814,75814,FB473FBE3EAFD3A14A7452241F377171,42041,3,5,2,10,47,547
75815,75815,FB473FBE3EAFD3A14A7452241F377171,19441,6,23,17,8,46,446
75819,75819,4EABE655BE26B3EDCCD7B6B2C89F187F,10161,0,7,7,35,49,1799
75820,75820,4EABE655BE26B3EDCCD7B6B2C89F187F,42981,7,12,5,36,49,1849
75821,75821,4EABE655BE26B3EDCCD7B6B2C89F187F,11231,12,14,2,37,49,1899
75822,75822,4EABE655BE26B3EDCCD7B6B2C89F187F,10161,15,22,7,35,49,1799
75834,75834,25CC66D599A64006DB1C07E7C87CDB76,12921,0,5,5,9,41,491
75835,75835,25CC66D599A64006DB1C07E7C87CDB76,12641,7,9,2,10,43,543
75836,75836,25CC66D599A64006DB1C07E7C87CDB76,12921,12,23,11,9,41,491
75842,75842,28BD69FEDCB135AF0C9358D5472F1773,10221,0,10,10,34,49,1749
75843,75843,28BD69FEDCB135AF0C9358D5472F1773,13511,13,16,3,34,48,1748
75844,75844,28BD69FEDCB135AF0C9358D5472F1773,40951,19,21,2,36,49,1849
75845,75845,DE3E54BB176520C8599DB39C6B8B34A3,13411,0,6,6,49,42,2492
75846,75846,DE3E54BB176520C8599DB39C6B8B34A3,43951,11,14,3,49,41,2491
75847,75847,DE3E54BB176520C8599DB39C6B8B34A3,13491,18,23,5,48,39,2439
75851,75851,212059BC74DD94CD57B576E2C33EB651,11324,0,13,13,31,46,1596
75852,75852,212059BC74DD94CD57B576E2C33EB651,42523,14,16,2,31,47,1597
75853,75853,212059BC74DD94CD57B576E2C33EB651,42491,18,19,1,32,46,1646
75854,75854,212059BC74DD94CD57B576E2C33EB651,11324,21,22,1,31,46,1596
75866,75866,BD23B8F4441754E97EF9F4DBDD6CCEC2,13561,0,14,14,37,49,1899
75867,75867,BD23B8F4441754E97EF9F4DBDD6CCEC2,10161,15,17,2,35,49,1799
75868,75868,BD23B8F4441754E97EF9F4DBDD6CCEC2,11021,20,21,1,36,49,1849
75873,75873,6811195FA9B7C2E6B8306338FC0A8641,11861,0,9,9,32,47,1647
75874,75874,6811195FA9B7C2E6B8306338FC0A8641,11751,11,15,4,35,48,1798
75875,75875,6811195FA9B7C2E6B8306338FC0A8641,43761,19,23,4,32,47,1647
75886,75886,7A784F63DA542325785D1949B0ED9A3A,12311,0,5,5,30,44,1544
75887,75887,7A784F63DA542325785D1949B0ED9A3A,10301,7,18,11,31,45,1595
75888,75888,7A784F63DA542325785D1949B0ED9A3A,12311,21,23,2,30,44,1544
75933,75933,80138FAE3CC4EDD6A1DF29A745B18CFD,11061,0,8,8,29,48,1498
75934,75934,80138FAE3CC4EDD6A1DF29A745B18CFD,43971,8,14,6,30,48,1548
75935,75935,80138FAE3CC4EDD6A1DF29A745B18CFD,11061,14,22,8,29,48,1498
75939,75939,54C28B082733E33A64393D2DD39B9D4C,12514,0,2,2,38,47,1947
75940,75940,54C28B082733E33A64393D2DD39B9D4C,11331,4,15,11,37,48,1898
75941,75941,54C28B082733E33A64393D2DD39B9D4C,11074,18,22,4,37,47,1897
75949,75949,7C66DF9B4CFCFA1F927E3E567C62A056,10911,0,6,6,39,46,1996
75950,75950,7C66DF9B4CFCFA1F927E3E567C62A056,13711,7,11,4,38,46,1946
75951,75951,7C66DF9B4CFCFA1F927E3E567C62A056,10911,13,23,10,39,46,1996
75965,75965,3624837A8CEE8FA380EBBA166C2E7021,42091,0,11,11,43,46,2196
75966,75966,3624837A8CEE8FA380EBBA166C2E7021,13341,11,12,1,44,45,2245
75967,75967,3624837A8CEE8FA380EBBA166C2E7021,42201,13,16,3,43,46,2196
75968,75968,3624837A8CEE8FA380EBBA166C2E7021,13791,19,20,1,42,47,2147
75987,75987,039720C5318D39E34BBB18DF8027F133,11914,6,17,11,37,48,1898
75988,75988,039720C5318D39E34BBB18DF8027F133,42581,18,20,2,38,48,1948
75989,75989,039720C5318D39E34BBB18DF8027F133,11811,20,21,1,38,49,1949
75990,75990,05286C4B5017A260B39768783F7D4555,11914,6,8,2,37,48,1898
75991,75991,05286C4B5017A260B39768783F7D4555,40171,9,10,1,38,48,1948
75992,75992,05286C4B5017A260B39768783F7D4555,11914,11,18,7,37,48,1898
75993,75993,05286C4B5017A260B39768783F7D4555,42581,20,22,2,38,48,1948
75994,75994,8A2B6A3BBB67F4CA1B157F83176E3E9B,11151,3,9,6,30,48,1548
75995,75995,8A2B6A3BBB67F4CA1B157F83176E3E9B,42831,9,18,9,27,48,1398
75996,75996,8A2B6A3BBB67F4CA1B157F83176E3E9B,11151,20,23,3,30,48,1548
76000,76000,99B3AC71EBDFEF963525FD23270BF9C3,11231,0,18,18,37,49,1899
76001,76001,99B3AC71EBDFEF963525FD23270BF9C3,10841,18,20,2,37,47,1897
76002,76002,99B3AC71EBDFEF963525FD23270BF9C3,11231,20,23,3,37,49,1899
76007,76007,4A7EF801268FA87DD49AA705DCA560E1,42581,0,16,16,38,48,1948
76008,76008,4A7EF801268FA87DD49AA705DCA560E1,11914,16,18,2,37,48,1898
76009,76009,4A7EF801268FA87DD49AA705DCA560E1,42581,20,23,3,38,48,1948
76023,76023,DF14480A6015B88701F985EC5C862602,43731,2,6,4,34,47,1747
76024,76024,DF14480A6015B88701F985EC5C862602,10781,9,10,1,35,47,1797
76025,76025,DF14480A6015B88701F985EC5C862602,42021,13,16,3,33,47,1697
76026,76026,DF14480A6015B88701F985EC5C862602,13601,18,23,5,34,47,1747
76032,76032,28AE6FF44E8686DC354D2E3DF7700FCC,42461,0,14,14,45,47,2297
76033,76033,28AE6FF44E8686DC354D2E3DF7700FCC,42321,14,18,4,43,47,2197
76034,76034,28AE6FF44E8686DC354D2E3DF7700FCC,42461,19,21,2,45,47,2297
76035,76035,28AE6FF44E8686DC354D2E3DF7700FCC,43001,21,23,2,47,47,2397
76036,76036,D21AD56E1413F233CB19B53125C6F06A,11591,4,11,7,36,49,1849
76037,76037,D21AD56E1413F233CB19B53125C6F06A,40171,12,16,4,38,48,1948
76038,76038,D21AD56E1413F233CB19B53125C6F06A,11591,20,21,1,36,49,1849
76039,76039,4F3F717E93BC5AFE00C4421DCBF0AA01,42301,2,8,6,36,47,1847
76040,76040,4F3F717E93BC5AFE00C4421DCBF0AA01,11261,11,20,9,36,46,1846
76041,76041,4F3F717E93BC5AFE00C4421DCBF0AA01,40322,20,22,2,38,46,1946
76042,76042,CE0F4FC68550DEE321FE07F3AC44A77A,10251,8,12,4,35,47,1797
76043,76043,CE0F4FC68550DEE321FE07F3AC44A77A,43731,12,13,1,34,47,1747
76044,76044,CE0F4FC68550DEE321FE07F3AC44A77A,10251,13,19,6,35,47,1797
76045,76045,E478E2D9BCF7A4F7B498F875A46F0A1D,42321,2,3,1,43,47,2197
76046,76046,E478E2D9BCF7A4F7B498F875A46F0A1D,10801,4,5,1,42,47,2147
76047,76047,E478E2D9BCF7A4F7B498F875A46F0A1D,43621,8,21,13,46,48,2348
76051,76051,A0C13743AF441FE8099AA940DA71C612,42581,0,8,8,38,48,1948
76052,76052,A0C13743AF441FE8099AA940DA71C612,11914,10,17,7,37,48,1898
76053,76053,A0C13743AF441FE8099AA940DA71C612,42581,19,23,4,38,48,1948
76068,76068,744AB7DADF8BF013AE569AC359219521,11541,0,19,19,35,49,1799
76069,76069,744AB7DADF8BF013AE569AC359219521,11211,19,21,2,34,49,1749
76070,76070,744AB7DADF8BF013AE569AC359219521,11541,21,22,1,35,49,1799
76071,76071,29EECA43EEFE59ADAFABFF01A5C4E8B8,42041,8,12,4,10,47,547
76072,76072,29EECA43EEFE59ADAFABFF01A5C4E8B8,19441,12,14,2,8,46,446
76073,76073,29EECA43EEFE59ADAFABFF01A5C4E8B8,42041,17,18,1,10,47,547
76074,76074,94A66B099C3B286235DEE73BAE7FEB6C,11861,1,19,18,32,47,1647
76075,76075,94A66B099C3B286235DEE73BAE7FEB6C,10281,20,21,1,33,48,1698
76076,76076,94A66B099C3B286235DEE73BAE7FEB6C,11861,21,23,2,32,47,1647
76077,76077,6EAB0BAC66AA45D41BB631DA8C9C8DA3,42521,0,6,6,31,47,1597
76078,76078,6EAB0BAC66AA45D41BB631DA8C9C8DA3,11151,11,14,3,30,48,1548
76079,76079,6EAB0BAC66AA45D41BB631DA8C9C8DA3,11061,16,17,1,29,48,1498
76080,76080,6EAB0BAC66AA45D41BB631DA8C9C8DA3,42521,21,23,2,31,47,1597
76089,76089,B1EFC7BEC8E60D7AC31C53A47A209953,10111,1,8,7,37,47,1897
76090,76090,B1EFC7BEC8E60D7AC31C53A47A209953,11331,8,9,1,37,48,1898
76091,76091,B1EFC7BEC8E60D7AC31C53A47A209953,42161,15,16,1,36,47,1847
76092,76092,B1EFC7BEC8E60D7AC31C53A47A209953,10111,18,22,4,37,47,1897
76108,76108,76A84ED3D9838C789BD1A23EFB9BEE14,13111,1,12,11,42,46,2146
76109,76109,76A84ED3D9838C789BD1A23EFB9BEE14,42204,15,19,4,43,46,2196
76110,76110,76A84ED3D9838C789BD1A23EFB9BEE14,10421,19,21,2,41,48,2098
76111,76111,76A84ED3D9838C789BD1A23EFB9BEE14,11701,21,23,2,43,48,2198
76120,76120,09E76C7E5F88F1AE9CA216C706232DAD,43761,0,8,8,32,47,1647
76121,76121,09E76C7E5F88F1AE9CA216C706232DAD,42491,11,17,6,32,46,1646
76122,76122,09E76C7E5F88F1AE9CA216C706232DAD,43761,18,23,5,32,47,1647
76123,76123,49661A890E6705F107790609D1AD5741,42121,8,11,3,26,49,1349
76124,76124,49661A890E6705F107790609D1AD5741,42261,13,18,5,25,49,1299
76125,76125,49661A890E6705F107790609D1AD5741,10951,21,22,1,29,48,1498
76138,76138,F918E466A782C1E37D4CAE1EA64CE5CD,42961,0,13,13,35,49,1799
76139,76139,F918E466A782C1E37D4CAE1EA64CE5CD,13561,15,16,1,37,49,1899
76140,76140,F918E466A782C1E37D4CAE1EA64CE5CD,13511,20,21,1,34,48,1748
76141,76141,FCF6425DA3F542476DF1F93935C075D8,42581,0,12,12,38,48,1948
76142,76142,FCF6425DA3F542476DF1F93935C075D8,11914,13,17,4,37,48,1898
76143,76143,FCF6425DA3F542476DF1F93935C075D8,42191,21,23,2,38,49,1949
76144,76144,F3DCE8C3C3FF003CDF3D27C94852CCE1,11954,0,2,2,32,49,1649
76145,76145,F3DCE8C3C3FF003CDF3D27C94852CCE1,11951,3,6,3,31,49,1599
76146,76146,F3DCE8C3C3FF003CDF3D27C94852CCE1,13731,6,21,15,33,49,1699
76147,76147,D4191700C633456D6E890AE49001CB88,10951,0,15,15,29,48,1498
76148,76148,D4191700C633456D6E890AE49001CB88,11381,15,20,5,30,47,1547
76149,76149,D4191700C633456D6E890AE49001CB88,12121,21,23,2,29,47,1497
76150,76150,64125BF70ADD2A9D2C91BE766AA2E78E,13911,5,6,1,39,46,1996
76151,76151,64125BF70ADD2A9D2C91BE766AA2E78E,11261,9,12,3,36,46,1846
76152,76152,64125BF70ADD2A9D2C91BE766AA2E78E,13911,12,15,3,39,46,1996
76153,76153,64125BF70ADD2A9D2C91BE766AA2E78E,11261,15,22,7,36,46,1846
76166,76166,B0CA59461CE535DA6C80DC6682EBEAFB,42271,0,10,10,40,47,2047
76167,76167,B0CA59461CE535DA6C80DC6682EBEAFB,11074,11,12,1,37,47,1897
76168,76168,B0CA59461CE535DA6C80DC6682EBEAFB,42271,15,18,3,40,47,2047
76169,76169,B0CA59461CE535DA6C80DC6682EBEAFB,11806,18,20,2,41,48,2098
76177,76177,63A1194DA67A916294F825B4249AD293,12514,1,5,4,38,47,1947
76178,76178,63A1194DA67A916294F825B4249AD293,11261,10,16,6,36,46,1846
76179,76179,63A1194DA67A916294F825B4249AD293,43361,19,20,1,38,48,1948
76191,76191,82FC52EE0064301BB5255C3B5ED793DB,42341,0,19,19,43,49,2199
76192,76192,82FC52EE0064301BB5255C3B5ED793DB,42931,19,21,2,41,49,2099
76193,76193,82FC52EE0064301BB5255C3B5ED793DB,42341,22,23,1,43,49,2199
76194,76194,ABA31A886DA5135F00BAFC3DAD048D98,11231,0,7,7,37,49,1899
76195,76195,ABA31A886DA5135F00BAFC3DAD048D98,12391,8,18,10,36,49,1849
76196,76196,ABA31A886DA5135F00BAFC3DAD048D98,41551,19,22,3,37,46,1896
76197,76197,6C2244D79333FB126D7C044044FC52BA,12491,0,13,13,36,43,1843
76198,76198,6C2244D79333FB126D7C044044FC52BA,43451,13,15,2,37,40,1890
76199,76199,6C2244D79333FB126D7C044044FC52BA,12491,18,23,5,36,43,1843
76200,76200,2B75D649D733D42AAC85CA634BF0D07B,42581,0,7,7,38,48,1948
76201,76201,2B75D649D733D42AAC85CA634BF0D07B,11914,7,17,10,37,48,1898
76202,76202,2B75D649D733D42AAC85CA634BF0D07B,42581,18,20,2,38,48,1948
76214,76214,77EA23FEBF1AF98A4F6293E826F27BD4,42271,0,6,6,40,47,2047
76215,76215,77EA23FEBF1AF98A4F6293E826F27BD4,11806,9,11,2,41,48,2098
76216,76216,77EA23FEBF1AF98A4F6293E826F27BD4,13381,13,16,3,39,47,1997
76217,76217,77EA23FEBF1AF98A4F6293E826F27BD4,11806,19,21,2,41,48,2098
76218,76218,7F73A642AA11134206C46BA15C785E40,42491,0,7,7,32,46,1646
76219,76219,7F73A642AA11134206C46BA15C785E40,42521,11,14,3,31,47,1597
76220,76220,7F73A642AA11134206C46BA15C785E40,13651,17,23,6,30,47,1547
76221,76221,4D9F6C967A63BBAA334580F76632F3DE,40697,0,1,1,43,48,2198
76222,76222,4D9F6C967A63BBAA334580F76632F3DE,10924,1,19,18,43,49,2199
76223,76223,4D9F6C967A63BBAA334580F76632F3DE,42271,20,23,3,40,47,2047
76224,76224,F3D69D17D900427D0A05FF399134E46B,42071,0,8,8,31,49,1599
76225,76225,F3D69D17D900427D0A05FF399134E46B,11151,9,17,8,30,48,1548
76226,76226,F3D69D17D900427D0A05FF399134E46B,42071,18,20,2,31,49,1599
76242,76242,C7FA80290FB045053FA2F8726750C68B,13651,1,11,10,30,47,1547
76243,76243,C7FA80290FB045053FA2F8726750C68B,10951,15,16,1,29,48,1498
76244,76244,C7FA80290FB045053FA2F8726750C68B,13651,20,21,1,30,47,1547
76261,76261,9BCD563089A1D0EF43A278605DE25081,13911,1,15,14,39,46,1996
76262,76262,9BCD563089A1D0EF43A278605DE25081,42231,17,19,2,37,46,1896
76263,76263,9BCD563089A1D0EF43A278605DE25081,13231,20,22,2,39,46,1996
76273,76273,F7BA1E9C235C1D8A36FA4FE83DC9EFDD,42161,0,2,2,36,47,1847
76274,76274,F7BA1E9C235C1D8A36FA4FE83DC9EFDD,13561,4,6,2,37,49,1899
76275,76275,F7BA1E9C235C1D8A36FA4FE83DC9EFDD,10161,6,21,15,35,49,1799
76276,76276,F7BA1E9C235C1D8A36FA4FE83DC9EFDD,40571,22,23,1,35,48,1798
76285,76285,382F73C796C98C44F5BB402C8CDCC061,42071,4,12,8,31,49,1599
76286,76286,382F73C796C98C44F5BB402C8CDCC061,11151,13,14,1,30,48,1548
76287,76287,382F73C796C98C44F5BB402C8CDCC061,42071,19,23,4,31,49,1599
76288,76288,55536669E97AF41ACDE427113BB85731,10691,0,6,6,33,48,1698
76289,76289,55536669E97AF41ACDE427113BB85731,11861,7,18,11,32,47,1647
76290,76290,55536669E97AF41ACDE427113BB85731,10691,18,23,5,33,48,1698
76299,76299,B304D2AD98C7DE24CAE6DD0DA65095F0,10431,0,6,6,33,49,1699
76300,76300,B304D2AD98C7DE24CAE6DD0DA65095F0,43581,7,15,8,33,48,1698
76301,76301,B304D2AD98C7DE24CAE6DD0DA65095F0,42141,16,17,1,32,47,1647
76302,76302,B304D2AD98C7DE24CAE6DD0DA65095F0,10431,18,23,5,33,49,1699
76303,76303,609CDA1462D91B0ED44D95249146762F,10841,0,1,1,37,47,1897
76304,76304,609CDA1462D91B0ED44D95249146762F,12514,1,6,5,38,47,1947
76305,76305,609CDA1462D91B0ED44D95249146762F,11201,10,13,3,35,49,1799
76306,76306,609CDA1462D91B0ED44D95249146762F,10841,17,22,5,37,47,1897
76351,76351,835E4AB3BB8C4699720E70AB108BA996,42041,4,6,2,10,47,547
76352,76352,835E4AB3BB8C4699720E70AB108BA996,19441,7,19,12,8,46,446
76353,76353,835E4AB3BB8C4699720E70AB108BA996,42041,19,20,1,10,47,547
76357,76357,BAF87A0BC01C594FFAC1B35DD77FCF62,10471,1,15,14,37,48,1898
76358,76358,BAF87A0BC01C594FFAC1B35DD77FCF62,11231,15,18,3,37,49,1899
76359,76359,BAF87A0BC01C594FFAC1B35DD77FCF62,10471,20,23,3,37,48,1898
76360,76360,924978441EAAD49A48A5DE926BCAE096,10271,0,10,10,37,46,1896
76361,76361,924978441EAAD49A48A5DE926BCAE096,13121,15,16,1,38,46,1946
76362,76362,924978441EAAD49A48A5DE926BCAE096,10271,19,23,4,37,46,1896
76373,76373,97CABD5CA4B44BD80C3C863536728BE4,11321,2,5,3,31,46,1596
76374,76374,97CABD5CA4B44BD80C3C863536728BE4,11871,6,16,10,29,46,1496
76375,76375,97CABD5CA4B44BD80C3C863536728BE4,11151,19,20,1,30,48,1548
76376,76376,97CABD5CA4B44BD80C3C863536728BE4,11061,21,22,1,29,48,1498
76394,76394,86877F32D6D32D1728C272FD8E7855F4,11861,0,10,10,32,47,1647
76395,76395,86877F32D6D32D1728C272FD8E7855F4,42021,10,12,2,33,47,1697
76396,76396,86877F32D6D32D1728C272FD8E7855F4,11861,12,23,11,32,47,1647
76405,76405,7EB52D21C036F1A3BC4284F5F5F5A5EF,10681,0,14,14,30,48,1548
76406,76406,7EB52D21C036F1A3BC4284F5F5F5A5EF,10721,16,17,1,31,48,1598
76407,76407,7EB52D21C036F1A3BC4284F5F5F5A5EF,42831,19,20,1,27,48,1398
76408,76408,7EB52D21C036F1A3BC4284F5F5F5A5EF,11151,21,22,1,30,48,1548
76409,76409,2EF6C0FB2DECBC4A57AE198EC3FD678A,10971,0,8,8,35,47,1797
76410,76410,2EF6C0FB2DECBC4A57AE198EC3FD678A,42021,9,11,2,33,47,1697
76411,76411,2EF6C0FB2DECBC4A57AE198EC3FD678A,10781,12,23,11,35,47,1797
76421,76421,1788FF83230593384DFEF88881720D90,13551,0,15,15,45,38,2288
76422,76422,1788FF83230593384DFEF88881720D90,43101,17,19,2,46,40,2340
76423,76423,1788FF83230593384DFEF88881720D90,13551,19,21,2,45,38,2288
76432,76432,11C5ACA60B0246DE7069023057E8285F,11381,0,2,2,30,47,1547
76433,76433,11C5ACA60B0246DE7069023057E8285F,11061,2,13,11,29,48,1498
76434,76434,11C5ACA60B0246DE7069023057E8285F,11381,14,21,7,30,47,1547
76440,76440,5674984FCE5B2DA13047CB9492AF31B3,43951,1,8,7,49,41,2491
76441,76441,5674984FCE5B2DA13047CB9492AF31B3,43101,12,16,4,46,40,2340
76442,76442,5674984FCE5B2DA13047CB9492AF31B3,43951,17,23,6,49,41,2491
76443,76443,8986876350592DFC0A404B6D7E8EA4AC,40242,0,15,15,36,49,1849
76444,76444,8986876350592DFC0A404B6D7E8EA4AC,10151,16,17,1,34,47,1747
76445,76445,8986876350592DFC0A404B6D7E8EA4AC,10901,20,23,3,35,48,1798
76457,76457,F933276E840F8E84214D3C6BDA6A4447,11061,0,5,5,29,48,1498
76458,76458,F933276E840F8E84214D3C6BDA6A4447,11151,8,9,1,30,48,1548
76459,76459,F933276E840F8E84214D3C6BDA6A4447,11061,10,21,11,29,48,1498
76460,76460,227CF90E190A804F43263E2E6F09CFEC,10681,0,6,6,30,48,1548
76461,76461,227CF90E190A804F43263E2E6F09CFEC,11381,8,10,2,30,47,1547
76462,76462,227CF90E190A804F43263E2E6F09CFEC,10681,11,22,11,30,48,1548
76463,76463,0DFD98C5BF618352145AEF64606DF221,42401,1,13,12,36,47,1847
76464,76464,0DFD98C5BF618352145AEF64606DF221,40673,14,15,1,36,48,1848
76465,76465,0DFD98C5BF618352145AEF64606DF221,42401,17,19,2,36,47,1847
76476,76476,522EF83A0BB6C187BC51EA021D98EB82,40611,0,9,9,35,47,1797
76477,76477,522EF83A0BB6C187BC51EA021D98EB82,11021,13,18,5,36,49,1849
76478,76478,522EF83A0BB6C187BC51EA021D98EB82,11491,20,21,1,36,47,1847
76483,76483,94659C4C1B1A469E566B81B441E10C1D,11074,0,9,9,37,47,1897
76484,76484,94659C4C1B1A469E566B81B441E10C1D,42301,12,13,1,36,47,1847
76485,76485,94659C4C1B1A469E566B81B441E10C1D,11074,14,19,5,37,47,1897
76486,76486,586F3AD64B483C4FDBF6963F85B66D9A,13271,0,7,7,41,47,2097
76487,76487,586F3AD64B483C4FDBF6963F85B66D9A,11301,9,16,7,41,49,2099
76488,76488,586F3AD64B483C4FDBF6963F85B66D9A,43361,19,20,1,38,48,1948
76501,76501,3717F18D88C40095DBADE8C95C390E6F,42861,7,8,1,37,44,1894
76502,76502,3717F18D88C40095DBADE8C95C390E6F,42151,8,17,9,35,45,1795
76503,76503,3717F18D88C40095DBADE8C95C390E6F,42861,18,19,1,37,44,1894
76504,76504,3717F18D88C40095DBADE8C95C390E6F,42151,22,23,1,35,45,1795
76515,76515,4B51883F8D3BDAE9528DE7CF8D0F3245,42021,0,14,14,33,47,1697
76516,76516,4B51883F8D3BDAE9528DE7CF8D0F3245,13601,14,18,4,34,47,1747
76517,76517,4B51883F8D3BDAE9528DE7CF8D0F3245,42021,18,23,5,33,47,1697
76518,76518,F776CF5BFCBAFE40EFE079BFD8CF34A4,19901,0,14,14,7,44,394
76519,76519,F776CF5BFCBAFE40EFE079BFD8CF34A4,19111,16,18,2,9,45,495
76520,76520,F776CF5BFCBAFE40EFE079BFD8CF34A4,19901,21,22,1,7,44,394
76521,76521,5767DCB7927C2A22DA225038742C1BCE,13561,0,14,14,37,49,1899
76522,76522,5767DCB7927C2A22DA225038742C1BCE,11021,15,16,1,36,49,1849
76523,76523,5767DCB7927C2A22DA225038742C1BCE,13561,20,22,2,37,49,1899
76532,76532,1D9B3BEAA73444A543D0673D1FBABCFF,10251,0,8,8,35,47,1797
76533,76533,1D9B3BEAA73444A543D0673D1FBABCFF,42511,8,19,11,37,47,1897
76534,76534,1D9B3BEAA73444A543D0673D1FBABCFF,42161,20,23,3,36,47,1847
76544,76544,BFB5F99311B260572E316DE64B3EB913,10491,0,8,8,33,48,1698
76545,76545,BFB5F99311B260572E316DE64B3EB913,10901,8,18,10,35,48,1798
76546,76546,BFB5F99311B260572E316DE64B3EB913,11131,18,23,5,33,48,1698
76557,76557,252F5474EB4D177E10B6FFBBE472E0CE,42491,0,13,13,32,46,1646
76558,76558,252F5474EB4D177E10B6FFBBE472E0CE,11861,13,19,6,32,47,1647
76559,76559,252F5474EB4D177E10B6FFBBE472E0CE,42523,19,21,2,31,47,1597
76560,76560,A61D0F5D6E4730E77483BB5A83F54B2C,42771,0,8,8,36,47,1847
76561,76561,A61D0F5D6E4730E77483BB5A83F54B2C,42511,8,16,8,37,47,1897
76562,76562,A61D0F5D6E4730E77483BB5A83F54B2C,10107,19,21,2,38,49,1949
76574,76574,9918FEABB0433C4402810CC88ACF5496,12311,0,14,14,30,44,1544
76575,76575,9918FEABB0433C4402810CC88ACF5496,11834,15,16,1,32,45,1645
76576,76576,9918FEABB0433C4402810CC88ACF5496,12311,18,23,5,30,44,1544
76577,76577,3683BCD5E2A83D301E5101A2DD111033,43481,0,7,7,39,48,1998
76578,76578,3683BCD5E2A83D301E5101A2DD111033,11811,8,17,9,38,49,1949
76579,76579,3683BCD5E2A83D301E5101A2DD111033,43181,21,22,1,39,48,1998
76580,76580,73118727834AEF72D14D5BE83EC91BD1,13941,2,6,4,41,47,2097
76581,76581,73118727834AEF72D14D5BE83EC91BD1,11074,9,16,7,37,47,1897
76582,76582,73118727834AEF72D14D5BE83EC91BD1,11001,20,21,1,42,47,2147
76583,76583,73118727834AEF72D14D5BE83EC91BD1,13941,21,23,2,41,47,2097
76584,76584,70884D19952CA4B432FAA84B8636A296,42461,0,1,1,45,47,2297
76585,76585,70884D19952CA4B432FAA84B8636A296,42321,2,7,5,43,47,2197
76586,76586,70884D19952CA4B432FAA84B8636A296,13351,7,11,4,48,48,2448
76587,76587,70884D19952CA4B432FAA84B8636A296,42461,12,23,11,45,47,2297
76594,76594,FEA371B99B04FC8CCEB8F07D4D5C7BA2,12161,8,10,2,32,46,1646
76595,76595,FEA371B99B04FC8CCEB8F07D4D5C7BA2,13601,12,17,5,34,47,1747
76596,76596,FEA371B99B04FC8CCEB8F07D4D5C7BA2,10292,18,20,2,30,47,1547
76597,76597,831704567A0B8CDF382FA5741F6A7093,11321,0,6,6,31,46,1596
76598,76598,831704567A0B8CDF382FA5741F6A7093,10301,8,9,1,31,45,1595
76599,76599,831704567A0B8CDF382FA5741F6A7093,10351,13,15,2,28,45,1445
76600,76600,831704567A0B8CDF382FA5741F6A7093,11321,19,23,4,31,46,1596
76604,76604,96B398BCE821D0E1508347A9D7207669,12641,0,18,18,10,43,543
76605,76605,96B398BCE821D0E1508347A9D7207669,19931,18,19,1,7,43,393
76606,76606,96B398BCE821D0E1508347A9D7207669,12641,21,22,1,10,43,543
76607,76607,9B49BEB65E16F10DE8E30D5D01D652E3,10811,0,8,8,38,46,1946
76608,76608,9B49BEB65E16F10DE8E30D5D01D652E3,13911,11,12,1,39,46,1996
76609,76609,9B49BEB65E16F10DE8E30D5D01D652E3,42231,16,18,2,37,46,1896
76610,76610,91BDEDAC648767D3A83A88B3F0D48C25,13911,1,10,9,39,46,1996
76611,76611,91BDEDAC648767D3A83A88B3F0D48C25,42231,14,17,3,37,46,1896
76612,76612,91BDEDAC648767D3A83A88B3F0D48C25,10811,18,20,2,38,46,1946
76613,76613,91BDEDAC648767D3A83A88B3F0D48C25,13911,21,22,1,39,46,1996
76622,76622,9E8EE07F66DC384D0D337FC7444ADEE9,11921,0,16,16,38,48,1948
76623,76623,9E8EE07F66DC384D0D337FC7444ADEE9,43671,17,18,1,35,48,1798
76624,76624,9E8EE07F66DC384D0D337FC7444ADEE9,11921,19,23,4,38,48,1948
76625,76625,D9026A3CE10A3841EFEE0C49DAE389C6,19901,0,1,1,7,44,394
76626,76626,D9026A3CE10A3841EFEE0C49DAE389C6,19114,1,19,18,7,43,393
76627,76627,D9026A3CE10A3841EFEE0C49DAE389C6,12641,22,23,1,10,43,543
76640,76640,53B9F7992DB29A9E3000FDBC39A3F0DF,11914,2,3,1,37,48,1898
76641,76641,53B9F7992DB29A9E3000FDBC39A3F0DF,11074,7,20,13,37,47,1897
76642,76642,53B9F7992DB29A9E3000FDBC39A3F0DF,10591,21,22,1,39,48,1998
76646,76646,80CE272820836DB5E94265F1766FEAE8,11271,1,8,7,37,48,1898
76647,76647,80CE272820836DB5E94265F1766FEAE8,11811,11,14,3,38,49,1949
76648,76648,80CE272820836DB5E94265F1766FEAE8,10841,15,16,1,37,47,1897
76649,76649,80CE272820836DB5E94265F1766FEAE8,11811,18,20,2,38,49,1949
76655,76655,138A1521C6403794A5D32D9328BA49B5,12921,3,9,6,9,41,491
76656,76656,138A1521C6403794A5D32D9328BA49B5,49201,9,10,1,7,41,391
76657,76657,138A1521C6403794A5D32D9328BA49B5,12921,12,21,9,9,41,491
76658,76658,138A1521C6403794A5D32D9328BA49B5,49201,21,23,2,7,41,391
76667,76667,5BFD1EDC6450AB3E044885145D481D1A,42321,0,7,7,43,47,2197
76668,76668,5BFD1EDC6450AB3E044885145D481D1A,42204,8,9,1,43,46,2196
76669,76669,5BFD1EDC6450AB3E044885145D481D1A,42321,12,23,11,43,47,2197
76670,76670,AC0F9A0DA655EB0858F47B6C2577B3DE,11281,0,1,1,27,40,1390
76671,76671,AC0F9A0DA655EB0858F47B6C2577B3DE,13671,3,9,6,27,43,1393
76672,76672,AC0F9A0DA655EB0858F47B6C2577B3DE,11281,9,20,11,27,40,1390
76694,76694,276A22157030DC2E164186E0D315BAD4,13111,0,6,6,42,46,2146
76695,76695,276A22157030DC2E164186E0D315BAD4,43061,7,8,1,43,46,2196
76696,76696,276A22157030DC2E164186E0D315BAD4,13111,9,23,14,42,46,2146
76703,76703,2C19FDC386B0B2E924F75B25676D719F,42231,0,4,4,37,46,1896
76704,76704,2C19FDC386B0B2E924F75B25676D719F,42351,4,12,8,38,45,1945
76705,76705,2C19FDC386B0B2E924F75B25676D719F,42231,12,14,2,37,46,1896
76706,76706,2C19FDC386B0B2E924F75B25676D719F,10901,17,19,2,35,48,1798
76721,76721,8C29E031FB5956E038F5FE7083F4864A,42861,0,9,9,37,44,1894
76722,76722,8C29E031FB5956E038F5FE7083F4864A,11261,11,12,1,36,46,1846
76723,76723,8C29E031FB5956E038F5FE7083F4864A,42861,14,18,4,37,44,1894
76741,76741,8D6D823064688A853913E29A2D4620F5,13331,0,4,4,38,47,1947
76742,76742,8D6D823064688A853913E29A2D4620F5,10841,9,11,2,37,47,1897
76743,76743,8D6D823064688A853913E29A2D4620F5,13121,12,22,10,38,46,1946
76744,76744,0AEB26EA4C3A49ED2345DE1540F9E35F,12021,0,8,8,37,49,1899
76745,76745,0AEB26EA4C3A49ED2345DE1540F9E35F,11074,8,11,3,37,47,1897
76746,76746,0AEB26EA4C3A49ED2345DE1540F9E35F,11331,14,15,1,37,48,1898
76747,76747,0AEB26EA4C3A49ED2345DE1540F9E35F,12021,18,23,5,37,49,1899
76748,76748,6504F1F0C122D0816D84E7F4E32ECF8A,13651,4,6,2,30,47,1547
76749,76749,6504F1F0C122D0816D84E7F4E32ECF8A,42523,7,11,4,31,47,1597
76750,76750,6504F1F0C122D0816D84E7F4E32ECF8A,13651,12,23,11,30,47,1547
76751,76751,5156CFDCDD6D06B9C439BBE6A3CABC0D,10251,0,2,2,35,47,1797
76752,76752,5156CFDCDD6D06B9C439BBE6A3CABC0D,10111,2,14,12,37,47,1897
76753,76753,5156CFDCDD6D06B9C439BBE6A3CABC0D,42161,14,23,9,36,47,1847
76754,76754,D8963F7C81A647B0DB7A8BBF70036A0B,12514,0,2,2,38,47,1947
76755,76755,D8963F7C81A647B0DB7A8BBF70036A0B,42221,5,7,2,38,48,1948
76756,76756,D8963F7C81A647B0DB7A8BBF70036A0B,10471,8,17,9,37,48,1898
76757,76757,D8963F7C81A647B0DB7A8BBF70036A0B,12514,18,22,4,38,47,1947
76758,76758,DFD8BF631C440547C60772DE9273FCD9,42221,1,6,5,38,48,1948
76759,76759,DFD8BF631C440547C60772DE9273FCD9,11231,7,9,2,37,49,1899
76760,76760,DFD8BF631C440547C60772DE9273FCD9,42221,14,15,1,38,48,1948
76761,76761,DFD8BF631C440547C60772DE9273FCD9,11074,17,22,5,37,47,1897
76762,76762,3EC7FB892EF37BDA18F1A611BBBFB58E,10292,1,10,9,30,47,1547
76763,76763,3EC7FB892EF37BDA18F1A611BBBFB58E,42521,11,15,4,31,47,1597
76764,76764,3EC7FB892EF37BDA18F1A611BBBFB58E,11381,18,20,2,30,47,1547
76768,76768,E311A49FD79CE1E67702DBA9B7887B92,12641,0,6,6,10,43,543
76769,76769,E311A49FD79CE1E67702DBA9B7887B92,19021,6,20,14,10,45,545
76770,76770,E311A49FD79CE1E67702DBA9B7887B92,12641,21,22,1,10,43,543
76771,76771,0A0BBB63629E3A59CB256306E3BEA0A4,43761,1,17,16,32,47,1647
76772,76772,0A0BBB63629E3A59CB256306E3BEA0A4,42371,19,21,2,34,46,1746
76773,76773,0A0BBB63629E3A59CB256306E3BEA0A4,11861,21,22,1,32,47,1647
76786,76786,E0A82639DC4D3A667AC6D4FF23D5E358,43761,0,6,6,32,47,1647
76787,76787,E0A82639DC4D3A667AC6D4FF23D5E358,11061,9,18,9,29,48,1498
76788,76788,E0A82639DC4D3A667AC6D4FF23D5E358,43761,20,23,3,32,47,1647
76824,76824,441E401293D6FFC8E080552D376784E1,40171,6,9,3,38,48,1948
76825,76825,441E401293D6FFC8E080552D376784E1,11914,9,17,8,37,48,1898
76826,76826,441E401293D6FFC8E080552D376784E1,42581,18,21,3,38,48,1948
76836,76836,465F3F33695B045A4D5264F2EED2A7ED,43041,0,9,9,41,46,2096
76837,76837,465F3F33695B045A4D5264F2EED2A7ED,13111,10,11,1,42,46,2146
76838,76838,465F3F33695B045A4D5264F2EED2A7ED,43341,12,21,9,41,46,2096
76852,76852,20538B8C1777892DA77867D1D04B5D49,43761,0,2,2,32,47,1647
76853,76853,20538B8C1777892DA77867D1D04B5D49,11161,3,8,5,32,48,1648
76854,76854,20538B8C1777892DA77867D1D04B5D49,43761,9,23,14,32,47,1647
76878,76878,D500A33E5EBF4610FFE1DAD30674EBEB,42281,0,7,7,40,48,2048
76879,76879,D500A33E5EBF4610FFE1DAD30674EBEB,42311,10,11,1,41,46,2096
76880,76880,D500A33E5EBF4610FFE1DAD30674EBEB,13271,12,14,2,41,47,2097
76881,76881,D500A33E5EBF4610FFE1DAD30674EBEB,42281,18,22,4,40,48,2048
76882,76882,9EF2E337C6D77F71D8F5E64DA4E76CDC,42461,0,1,1,45,47,2297
76883,76883,9EF2E337C6D77F71D8F5E64DA4E76CDC,13941,2,4,2,41,47,2097
76884,76884,9EF2E337C6D77F71D8F5E64DA4E76CDC,42321,7,18,11,43,47,2197
76885,76885,06D551A8B84FE30AD5961028E6C3C756,19441,1,17,16,8,46,446
76886,76886,06D551A8B84FE30AD5961028E6C3C756,42041,18,19,1,10,47,547
76887,76887,06D551A8B84FE30AD5961028E6C3C756,19441,20,23,3,8,46,446
76893,76893,6F6F174BF3BBBF4A283E7794B5A58265,11914,3,4,1,37,48,1898
76894,76894,6F6F174BF3BBBF4A283E7794B5A58265,42581,4,7,3,38,48,1948
76895,76895,6F6F174BF3BBBF4A283E7794B5A58265,11914,7,16,9,37,48,1898
76896,76896,6F6F174BF3BBBF4A283E7794B5A58265,42581,16,22,6,38,48,1948
76897,76897,95426015650BC53898B8F1908C1F7E01,42501,0,7,7,28,47,1447
76898,76898,95426015650BC53898B8F1908C1F7E01,11111,11,16,5,26,48,1348
76899,76899,95426015650BC53898B8F1908C1F7E01,12601,18,21,3,25,47,1297
76900,76900,1CD741282378ACECE229BFA3E57C9431,19441,0,14,14,8,46,446
76901,76901,1CD741282378ACECE229BFA3E57C9431,42041,14,15,1,10,47,547
76902,76902,1CD741282378ACECE229BFA3E57C9431,19441,18,19,1,8,46,446
76903,76903,AE5EC73B53E9C3CD1EC48FB8238BD121,10221,0,8,8,34,49,1749
76904,76904,AE5EC73B53E9C3CD1EC48FB8238BD121,11201,11,12,1,35,49,1799
76905,76905,AE5EC73B53E9C3CD1EC48FB8238BD121,10901,18,20,2,35,48,1798
76906,76906,AE5EC73B53E9C3CD1EC48FB8238BD121,10221,20,23,3,34,49,1749
76907,76907,88B9ED484BFC88A3E18D812526B753D0,42351,2,13,11,38,45,1945
76908,76908,88B9ED484BFC88A3E18D812526B753D0,42864,14,17,3,38,44,1944
76909,76909,88B9ED484BFC88A3E18D812526B753D0,13231,22,23,1,39,46,1996
76913,76913,0B01795734CA986B36F023360E2D7588,12083,0,4,4,36,49,1849
76914,76914,0B01795734CA986B36F023360E2D7588,42961,4,8,4,35,49,1799
76915,76915,0B01795734CA986B36F023360E2D7588,11231,8,23,15,37,49,1899
76921,76921,0722208BA05F2FA64560C4BADA491D8E,11381,0,8,8,30,47,1547
76922,76922,0722208BA05F2FA64560C4BADA491D8E,10151,9,16,7,34,47,1747
76923,76923,0722208BA05F2FA64560C4BADA491D8E,11381,18,23,5,30,47,1547
76924,76924,B25C1AE1FA9C41BCED04F20481B5B4EC,42161,0,3,3,36,47,1847
76925,76925,B25C1AE1FA9C41BCED04F20481B5B4EC,43731,7,14,7,34,47,1747
76926,76926,B25C1AE1FA9C41BCED04F20481B5B4EC,42161,17,23,6,36,47,1847
76927,76927,27B6DDFE3A356062F221ABD7AD70BB14,11061,0,6,6,29,48,1498
76928,76928,27B6DDFE3A356062F221ABD7AD70BB14,10681,8,10,2,30,48,1548
76929,76929,27B6DDFE3A356062F221ABD7AD70BB14,11061,10,23,13,29,48,1498
76945,76945,4FCDABC610742EB61D313FDD101D8C81,42091,0,7,7,43,46,2196
76946,76946,4FCDABC610742EB61D313FDD101D8C81,11701,11,18,7,43,48,2198
76947,76947,4FCDABC610742EB61D313FDD101D8C81,42091,18,19,1,43,46,2196
76948,76948,5E3A7142BBDC1E249B155588A0E138DD,19114,0,6,6,7,43,393
76949,76949,5E3A7142BBDC1E249B155588A0E138DD,12641,7,21,14,10,43,543
76950,76950,5E3A7142BBDC1E249B155588A0E138DD,19114,22,23,1,7,43,393
76951,76951,9E9BFCE7D4032996263B32ED77F8BBA1,42981,2,5,3,36,49,1849
76952,76952,9E9BFCE7D4032996263B32ED77F8BBA1,11231,7,8,1,37,49,1899
76953,76953,9E9BFCE7D4032996263B32ED77F8BBA1,40234,12,13,1,35,49,1799
76954,76954,9E9BFCE7D4032996263B32ED77F8BBA1,11231,13,23,10,37,49,1899
76955,76955,1A9DAEEEE45E6D6064E98B4F317D57C3,42271,1,13,12,40,47,2047
76956,76956,1A9DAEEEE45E6D6064E98B4F317D57C3,12514,14,15,1,38,47,1947
76957,76957,1A9DAEEEE45E6D6064E98B4F317D57C3,42271,17,22,5,40,47,2047
76958,76958,99A95A6FE4AFA5491C71C9FC293E58BB,11591,1,4,3,36,49,1849
76959,76959,99A95A6FE4AFA5491C71C9FC293E58BB,11531,11,16,5,34,49,1749
76960,76960,99A95A6FE4AFA5491C71C9FC293E58BB,11591,19,22,3,36,49,1849
76967,76967,584BB052D22F4A26964D82AE9216D70B,43161,0,9,9,35,47,1797
76968,76968,584BB052D22F4A26964D82AE9216D70B,43241,9,12,3,36,46,1846
76969,76969,584BB052D22F4A26964D82AE9216D70B,42161,21,22,1,36,47,1847
76970,76970,6166F4BC9B2530F6FDAD5A0233FBAAD6,11914,2,3,1,37,48,1898
76971,76971,6166F4BC9B2530F6FDAD5A0233FBAAD6,42581,7,13,6,38,48,1948
76972,76972,6166F4BC9B2530F6FDAD5A0233FBAAD6,11914,13,23,10,37,48,1898
76977,76977,3A4CC68123E663653A6D77E0002B4B97,10634,1,12,11,27,45,1395
76978,76978,3A4CC68123E663653A6D77E0002B4B97,10351,12,14,2,28,45,1445
76979,76979,3A4CC68123E663653A6D77E0002B4B97,10634,14,17,3,27,45,1395
76980,76980,3A4CC68123E663653A6D77E0002B4B97,11871,19,20,1,29,46,1496
76981,76981,859846C23309918FCF7E37DF9FD45D9F,13911,0,9,9,39,46,1996
76982,76982,859846C23309918FCF7E37DF9FD45D9F,11261,9,11,2,36,46,1846
76983,76983,859846C23309918FCF7E37DF9FD45D9F,13911,12,21,9,39,46,1996
76984,76984,D19CCADD05AE7D38BD327DD3B3A1E602,42861,4,5,1,37,44,1894
76985,76985,D19CCADD05AE7D38BD327DD3B3A1E602,42351,6,7,1,38,45,1945
76986,76986,D19CCADD05AE7D38BD327DD3B3A1E602,42231,9,10,1,37,46,1896
76987,76987,D19CCADD05AE7D38BD327DD3B3A1E602,42351,12,22,10,38,45,1945
76988,76988,BA7FC35F37DD297974FD39853B2DA488,11231,2,4,2,37,49,1899
76989,76989,BA7FC35F37DD297974FD39853B2DA488,11021,8,10,2,36,49,1849
76990,76990,BA7FC35F37DD297974FD39853B2DA488,40302,12,19,7,40,49,2049
76994,76994,4CEF2D9D71549E955305B2DC8309A78D,12641,0,5,5,10,43,543
76995,76995,4CEF2D9D71549E955305B2DC8309A78D,12921,5,10,5,9,41,491
76996,76996,4CEF2D9D71549E955305B2DC8309A78D,12641,12,13,1,10,43,543
76997,76997,4CEF2D9D71549E955305B2DC8309A78D,12921,13,22,9,9,41,491
76998,76998,8FFFB1045B67B7DEF96CD971C93188B0,42071,0,13,13,31,49,1599
76999,76999,8FFFB1045B67B7DEF96CD971C93188B0,11954,14,15,1,32,49,1649
77000,77000,8FFFB1045B67B7DEF96CD971C93188B0,13731,21,22,1,33,49,1699
77004,77004,2C9F9127F2AECFBA8069624790D23C60,10471,0,8,8,37,48,1898
77005,77005,2C9F9127F2AECFBA8069624790D23C60,40302,9,13,4,40,49,2049
77006,77006,2C9F9127F2AECFBA8069624790D23C60,10471,13,23,10,37,48,1898
77019,77019,3DABBE7AD4BBA6D6461EC91F04F7CCEC,42461,0,6,6,45,47,2297
77020,77020,3DABBE7AD4BBA6D6461EC91F04F7CCEC,43621,7,10,3,46,48,2348
77021,77021,3DABBE7AD4BBA6D6461EC91F04F7CCEC,42461,12,18,6,45,47,2297
77022,77022,3DABBE7AD4BBA6D6461EC91F04F7CCEC,11701,20,23,3,43,48,2198
77027,77027,6D9B191036D25EF15FC371A87A4278C4,42971,0,6,6,43,49,2199
77028,77028,6D9B191036D25EF15FC371A87A4278C4,42931,20,21,1,41,49,2099
77029,77029,6D9B191036D25EF15FC371A87A4278C4,42971,22,23,1,43,49,2199
77030,77030,CA0B3175FBB1341C491260F631101B36,11074,2,10,8,37,47,1897
77031,77031,CA0B3175FBB1341C491260F631101B36,42221,12,16,4,38,48,1948
77032,77032,CA0B3175FBB1341C491260F631101B36,11074,17,22,5,37,47,1897
77040,77040,09803726F3C2A40BEF93389F75159E93,10281,0,7,7,33,48,1698
77041,77041,09803726F3C2A40BEF93389F75159E93,10251,11,18,7,35,47,1797
77042,77042,09803726F3C2A40BEF93389F75159E93,10281,19,23,4,33,48,1698
77043,77043,ED7D6E0D6245554973BF1FC4EA5C6C28,11151,0,5,5,30,48,1548
77044,77044,ED7D6E0D6245554973BF1FC4EA5C6C28,11061,7,13,6,29,48,1498
77045,77045,ED7D6E0D6245554973BF1FC4EA5C6C28,11151,13,18,5,30,48,1548
77046,77046,C9255107859C2FB6A49577C5ACBDC9FD,11061,0,7,7,29,48,1498
77047,77047,C9255107859C2FB6A49577C5ACBDC9FD,43971,9,13,4,30,48,1548
77048,77048,C9255107859C2FB6A49577C5ACBDC9FD,11061,17,18,1,29,48,1498
77049,77049,C9255107859C2FB6A49577C5ACBDC9FD,43971,19,21,2,30,48,1548
77050,77050,5232A1F9DD43FADD1ACE9CE9BD82FED1,40277,0,7,7,35,49,1799
77051,77051,5232A1F9DD43FADD1ACE9CE9BD82FED1,11021,9,15,6,36,49,1849
77052,77052,5232A1F9DD43FADD1ACE9CE9BD82FED1,11751,19,20,1,35,48,1798
77053,77053,BF0C4F2E83EC507E1BA76AF77AC7F1B3,43581,0,7,7,33,48,1698
77054,77054,BF0C4F2E83EC507E1BA76AF77AC7F1B3,10431,8,11,3,33,49,1699
77055,77055,BF0C4F2E83EC507E1BA76AF77AC7F1B3,11861,12,14,2,32,47,1647
77056,77056,BF0C4F2E83EC507E1BA76AF77AC7F1B3,43581,19,23,4,33,48,1698
77073,77073,775D2A8F104041B3D53BA2721A326EFF,42151,4,11,7,35,45,1795
77074,77074,775D2A8F104041B3D53BA2721A326EFF,42861,13,19,6,37,44,1894
77075,77075,775D2A8F104041B3D53BA2721A326EFF,42151,22,23,1,35,45,1795
77076,77076,3E7942CC71D03F103F23ED151D419DA7,12921,3,4,1,9,41,491
77077,77077,3E7942CC71D03F103F23ED151D419DA7,49201,9,18,9,7,41,391
77078,77078,3E7942CC71D03F103F23ED151D419DA7,19114,20,22,2,7,43,393
77079,77079,27A0DD6A965A1FEA8EED4D0E73345414,12921,1,6,5,9,41,491
77080,77080,27A0DD6A965A1FEA8EED4D0E73345414,12641,7,8,1,10,43,543
77081,77081,27A0DD6A965A1FEA8EED4D0E73345414,12921,13,18,5,9,41,491
77082,77082,27A0DD6A965A1FEA8EED4D0E73345414,19181,21,23,2,8,40,440
77083,77083,FFD84391FCD810EDFCF9E1B100BB0A91,10161,0,11,11,35,49,1799
77084,77084,FFD84391FCD810EDFCF9E1B100BB0A91,11751,12,15,3,35,48,1798
77085,77085,FFD84391FCD810EDFCF9E1B100BB0A91,40951,16,18,2,36,49,1849
77093,77093,54869B905D9FE5BDC4D6EE5F69644AAC,42461,3,5,2,45,47,2297
77094,77094,54869B905D9FE5BDC4D6EE5F69644AAC,43621,7,8,1,46,48,2348
77095,77095,54869B905D9FE5BDC4D6EE5F69644AAC,42321,8,18,10,43,47,2197
77096,77096,54869B905D9FE5BDC4D6EE5F69644AAC,40833,19,20,1,41,47,2097
77097,77097,597064D826C3E01F204980F028CA1A17,42861,0,14,14,37,44,1894
77098,77098,597064D826C3E01F204980F028CA1A17,11261,17,18,1,36,46,1846
77099,77099,597064D826C3E01F204980F028CA1A17,42861,21,22,1,37,44,1894
77108,77108,E08AC9B457E66B22ECC7A9B4AF1AFDCE,42321,0,8,8,43,47,2197
77109,77109,E08AC9B457E66B22ECC7A9B4AF1AFDCE,13111,9,10,1,42,46,2146
77110,77110,E08AC9B457E66B22ECC7A9B4AF1AFDCE,42321,14,19,5,43,47,2197
77118,77118,EF693F97F8D10C2E8DC4485A82F6B374,13561,3,5,2,37,49,1899
77119,77119,EF693F97F8D10C2E8DC4485A82F6B374,10901,5,6,1,35,48,1798
77120,77120,EF693F97F8D10C2E8DC4485A82F6B374,40242,7,9,2,36,49,1849
77121,77121,EF693F97F8D10C2E8DC4485A82F6B374,10841,15,19,4,37,47,1897
77134,77134,5C087BE097BD7C65E07DEF266C8D9DC9,43731,3,12,9,34,47,1747
77135,77135,5C087BE097BD7C65E07DEF266C8D9DC9,42161,14,21,7,36,47,1847
77136,77136,5C087BE097BD7C65E07DEF266C8D9DC9,43731,22,23,1,34,47,1747
77140,77140,FC32FCDE5EA162E6A3931CE10EF22190,11021,0,6,6,36,49,1849
77141,77141,FC32FCDE5EA162E6A3931CE10EF22190,11231,7,9,2,37,49,1899
77142,77142,FC32FCDE5EA162E6A3931CE10EF22190,11021,12,23,11,36,49,1849
77143,77143,A6B86C51D1E851C8306B13F3333CE4AD,42401,0,14,14,36,47,1847
77144,77144,A6B86C51D1E851C8306B13F3333CE4AD,11231,16,17,1,37,49,1899
77145,77145,A6B86C51D1E851C8306B13F3333CE4AD,42301,18,22,4,36,47,1847
77150,77150,B1886EF8F5487F8E8F1A6E89D17F4DF6,12311,0,13,13,30,44,1544
77151,77151,B1886EF8F5487F8E8F1A6E89D17F4DF6,42531,17,19,2,31,45,1595
77152,77152,B1886EF8F5487F8E8F1A6E89D17F4DF6,12311,19,22,3,30,44,1544
77153,77153,33355741ED0AC97461CECC52FEC57FD4,13231,0,4,4,39,46,1996
77154,77154,33355741ED0AC97461CECC52FEC57FD4,42864,6,18,12,38,44,1944
77155,77155,33355741ED0AC97461CECC52FEC57FD4,11261,21,22,1,36,46,1846
77156,77156,842A1C1E3500FEFF04D25304E41263AF,13094,0,6,6,21,42,1092
77157,77157,842A1C1E3500FEFF04D25304E41263AF,13091,7,9,2,20,42,1042
77158,77158,842A1C1E3500FEFF04D25304E41263AF,12671,9,16,7,21,43,1093
77159,77159,842A1C1E3500FEFF04D25304E41263AF,13091,17,23,6,20,42,1042
77176,77176,10C025DE83AEC63388DB13DE6128ADC8,11381,8,12,4,30,47,1547
77177,77177,10C025DE83AEC63388DB13DE6128ADC8,12121,15,16,1,29,47,1497
77178,77178,10C025DE83AEC63388DB13DE6128ADC8,11381,17,21,4,30,47,1547
77179,77179,10C025DE83AEC63388DB13DE6128ADC8,12121,22,23,1,29,47,1497
77180,77180,F3EBB57DA3A54FEC2068629888C9AD19,42511,0,7,7,37,47,1897
77181,77181,F3EBB57DA3A54FEC2068629888C9AD19,11941,7,12,5,37,46,1896
77182,77182,F3EBB57DA3A54FEC2068629888C9AD19,13011,15,16,1,39,47,1997
77183,77183,F3EBB57DA3A54FEC2068629888C9AD19,12514,18,21,3,38,47,1947
77184,77184,9B3AB6525BB1FEA174CEC9732325E1F1,43761,0,8,8,32,47,1647
77185,77185,9B3AB6525BB1FEA174CEC9732325E1F1,11381,13,14,1,30,47,1547
77186,77186,9B3AB6525BB1FEA174CEC9732325E1F1,43761,18,21,3,32,47,1647
77187,77187,E2FC80C995A3EFA4B2AF01BAD4B24C1C,12083,0,14,14,36,49,1849
77188,77188,E2FC80C995A3EFA4B2AF01BAD4B24C1C,11231,17,18,1,37,49,1899
77189,77189,E2FC80C995A3EFA4B2AF01BAD4B24C1C,12083,21,23,2,36,49,1849
77204,77204,E28BD8ABB3C3184A8D1BC0022884AF60,42204,2,9,7,43,46,2196
77205,77205,E28BD8ABB3C3184A8D1BC0022884AF60,13111,9,14,5,42,46,2146
77206,77206,E28BD8ABB3C3184A8D1BC0022884AF60,13341,15,16,1,44,45,2245
77207,77207,E28BD8ABB3C3184A8D1BC0022884AF60,42204,22,23,1,43,46,2196
77208,77208,012D304B65BB1C01DC9FFE26FE6AEE56,10111,0,9,9,37,47,1897
77209,77209,012D304B65BB1C01DC9FFE26FE6AEE56,40637,10,11,1,36,47,1847
77210,77210,012D304B65BB1C01DC9FFE26FE6AEE56,11331,12,14,2,37,48,1898
77211,77211,012D304B65BB1C01DC9FFE26FE6AEE56,10111,18,23,5,37,47,1897
77216,77216,2898255842570985047C3D77FE88DD08,11541,0,6,6,35,49,1799
77217,77217,2898255842570985047C3D77FE88DD08,11021,8,14,6,36,49,1849
77218,77218,2898255842570985047C3D77FE88DD08,11541,17,21,4,35,49,1799
77219,77219,528421A4A4CF40E840301284E0AFB525,42161,0,10,10,36,47,1847
77220,77220,528421A4A4CF40E840301284E0AFB525,11461,12,13,1,37,49,1899
77221,77221,528421A4A4CF40E840301284E0AFB525,10841,14,18,4,37,47,1897
77222,77222,528421A4A4CF40E840301284E0AFB525,42161,19,22,3,36,47,1847
77227,77227,A21C93D72B5558DF6DC8038ACDBFD759,43061,1,8,7,43,46,2196
77228,77228,A21C93D72B5558DF6DC8038ACDBFD759,13341,10,11,1,44,45,2245
77229,77229,A21C93D72B5558DF6DC8038ACDBFD759,43061,14,16,2,43,46,2196
77230,77230,A21C93D72B5558DF6DC8038ACDBFD759,13341,19,21,2,44,45,2245
77231,77231,3BD6568A851F0862F8846C1E3EDE82AC,42021,0,14,14,33,47,1697
77232,77232,3BD6568A851F0862F8846C1E3EDE82AC,13601,15,16,1,34,47,1747
77233,77233,3BD6568A851F0862F8846C1E3EDE82AC,42021,17,22,5,33,47,1697
77234,77234,3BB34174639CFACBA924E1D5FF8062A5,42531,0,6,6,31,45,1595
77235,77235,3BB34174639CFACBA924E1D5FF8062A5,12661,8,16,8,32,45,1645
77236,77236,3BB34174639CFACBA924E1D5FF8062A5,42531,20,23,3,31,45,1595
77237,77237,2A299573B8ADE5EDDBBA5F82D87A0B34,42921,0,7,7,33,47,1697
77238,77238,2A299573B8ADE5EDDBBA5F82D87A0B34,13601,8,12,4,34,47,1747
77239,77239,2A299573B8ADE5EDDBBA5F82D87A0B34,42921,13,16,3,33,47,1697
77240,77240,2A299573B8ADE5EDDBBA5F82D87A0B34,13601,17,22,5,34,47,1747
77249,77249,0A06E26D4B63B311703019BBFB7FEF42,42191,0,8,8,38,49,1949
77250,77250,0A06E26D4B63B311703019BBFB7FEF42,11531,13,14,1,34,49,1749
77251,77251,0A06E26D4B63B311703019BBFB7FEF42,11541,16,18,2,35,49,1799
77255,77255,58B0725FA25DF85297C8BBDEAA0352D5,12521,0,1,1,35,41,1791
77256,77256,58B0725FA25DF85297C8BBDEAA0352D5,43451,2,3,1,37,40,1890
77257,77257,58B0725FA25DF85297C8BBDEAA0352D5,12521,4,23,19,35,41,1791
77277,77277,C1D79A070CFCF442F4B341637205D8DD,12211,8,10,2,41,44,2094
77278,77278,C1D79A070CFCF442F4B341637205D8DD,43011,10,12,2,40,42,2042
77279,77279,C1D79A070CFCF442F4B341637205D8DD,12211,16,22,6,41,44,2094
77285,77285,C81FC2E9808AA726781F412721963B0B,42141,3,7,4,32,47,1647
77286,77286,C81FC2E9808AA726781F412721963B0B,10295,8,11,3,30,47,1547
77287,77287,C81FC2E9808AA726781F412721963B0B,43761,15,22,7,32,47,1647
77288,77288,E528C1BCF7730647027A4A7EFB058975,42631,0,7,7,43,45,2195
77289,77289,E528C1BCF7730647027A4A7EFB058975,13341,8,18,10,44,45,2245
77290,77290,E528C1BCF7730647027A4A7EFB058975,42631,19,22,3,43,45,2195
77291,77291,46B3DE812748722328FAB277775E5F5A,12514,1,11,10,38,47,1947
77292,77292,46B3DE812748722328FAB277775E5F5A,42221,11,13,2,38,48,1948
77293,77293,46B3DE812748722328FAB277775E5F5A,13331,16,23,7,38,47,1947
77305,77305,F773C1002FB05391C5A6171DCD3E79EC,10151,0,7,7,34,47,1747
77306,77306,F773C1002FB05391C5A6171DCD3E79EC,42401,12,15,3,36,47,1847
77307,77307,F773C1002FB05391C5A6171DCD3E79EC,42523,18,19,1,31,47,1597
77308,77308,F773C1002FB05391C5A6171DCD3E79EC,42161,20,23,3,36,47,1847
77314,77314,5A8308F9DAAF40265186D4E63F2640C9,10721,0,7,7,31,48,1598
77315,77315,5A8308F9DAAF40265186D4E63F2640C9,13731,10,18,8,33,49,1699
77316,77316,5A8308F9DAAF40265186D4E63F2640C9,10721,20,23,3,31,48,1598
77317,77317,1277ACA424D6A91D4C363B632562549C,10501,0,3,3,22,46,1146
77318,77318,1277ACA424D6A91D4C363B632562549C,12601,3,14,11,25,47,1297
77319,77319,1277ACA424D6A91D4C363B632562549C,10501,14,20,6,22,46,1146
77320,77320,F49F5A0F1C44EBAB5BE16379854ACBEE,11061,8,10,2,29,48,1498
77321,77321,F49F5A0F1C44EBAB5BE16379854ACBEE,11381,13,15,2,30,47,1547
77322,77322,F49F5A0F1C44EBAB5BE16379854ACBEE,11061,15,22,7,29,48,1498
77343,77343,38BAD20AF3F1C2D76FC5AB52738907B1,10341,0,14,14,31,47,1597
77344,77344,38BAD20AF3F1C2D76FC5AB52738907B1,10281,14,15,1,33,48,1698
77345,77345,38BAD20AF3F1C2D76FC5AB52738907B1,10341,18,23,5,31,47,1597
77350,77350,1550936E77AB3F9D5F52AE840621A4EE,10431,0,6,6,33,49,1699
77351,77351,1550936E77AB3F9D5F52AE840621A4EE,43731,7,8,1,34,47,1747
77352,77352,1550936E77AB3F9D5F52AE840621A4EE,10431,11,23,12,33,49,1699
77372,77372,0A501EA010779C8F9EB8C2F8834C3F4F,10634,0,3,3,27,45,1395
77373,77373,0A501EA010779C8F9EB8C2F8834C3F4F,10351,7,14,7,28,45,1445
77374,77374,0A501EA010779C8F9EB8C2F8834C3F4F,10301,14,19,5,31,45,1595
77375,77375,0A501EA010779C8F9EB8C2F8834C3F4F,10351,22,23,1,28,45,1445
77376,77376,40DFEFDD084B7E6FA138B7FBB6CFBE81,13711,0,9,9,38,46,1946
77377,77377,40DFEFDD084B7E6FA138B7FBB6CFBE81,10271,12,13,1,37,46,1896
77378,77378,40DFEFDD084B7E6FA138B7FBB6CFBE81,13121,15,21,6,38,46,1946
77379,77379,7A89F90274317B23FC53152227A2C065,49201,0,2,2,7,41,391
77380,77380,7A89F90274317B23FC53152227A2C065,12921,5,7,2,9,41,491
77381,77381,7A89F90274317B23FC53152227A2C065,49201,7,22,15,7,41,391
77387,77387,26E97CCAAB10F50751FB25FC2D6D6457,11261,1,13,12,36,46,1846
77388,77388,26E97CCAAB10F50751FB25FC2D6D6457,42861,17,19,2,37,44,1894
77389,77389,26E97CCAAB10F50751FB25FC2D6D6457,10601,20,22,2,39,47,1997
77398,77398,189C54EA37D8896B78DBF80EEA026F2F,19931,4,7,3,7,43,393
77399,77399,189C54EA37D8896B78DBF80EEA026F2F,12641,11,12,1,10,43,543
77400,77400,189C54EA37D8896B78DBF80EEA026F2F,19931,16,22,6,7,43,393
77401,77401,5102B42C348B7F58F60DC6DAF5653AF2,11914,0,14,14,37,48,1898
77402,77402,5102B42C348B7F58F60DC6DAF5653AF2,42581,14,16,2,38,48,1948
77403,77403,5102B42C348B7F58F60DC6DAF5653AF2,11914,17,18,1,37,48,1898
77404,77404,5102B42C348B7F58F60DC6DAF5653AF2,40171,19,21,2,38,48,1948
77405,77405,69F62EC905965E951064324714771523,19114,0,8,8,7,43,393
77406,77406,69F62EC905965E951064324714771523,19744,9,11,2,6,43,343
77407,77407,69F62EC905965E951064324714771523,19114,21,23,2,7,43,393
77413,77413,5CBB3BFC4ED61841A41A893768B01036,13911,0,1,1,39,46,1996
77414,77414,5CBB3BFC4ED61841A41A893768B01036,12211,3,13,10,41,44,2094
77415,77415,5CBB3BFC4ED61841A41A893768B01036,13911,16,23,7,39,46,1996
77421,77421,C328510DD56545DE664741E7C050FF79,11001,0,13,13,42,47,2147
77422,77422,C328510DD56545DE664741E7C050FF79,13941,17,19,2,41,47,2097
77423,77423,C328510DD56545DE664741E7C050FF79,11001,21,23,2,42,47,2147
77444,77444,0277E6ABE6E23FB8B51E9078601CBBC1,42491,0,7,7,32,46,1646
77445,77445,0277E6ABE6E23FB8B51E9078601CBBC1,42523,8,17,9,31,47,1597
77446,77446,0277E6ABE6E23FB8B51E9078601CBBC1,42491,20,23,3,32,46,1646
77462,77462,8B15250505924ED8935A6E2820AF9A14,12921,0,14,14,9,41,491
77463,77463,8B15250505924ED8935A6E2820AF9A14,19181,14,15,1,8,40,440
77464,77464,8B15250505924ED8935A6E2820AF9A14,12921,17,20,3,9,41,491
77476,77476,C1FC141B35A6FDF2FC8F85E0E1339544,42161,0,18,18,36,47,1847
77477,77477,C1FC141B35A6FDF2FC8F85E0E1339544,11074,19,20,1,37,47,1897
77478,77478,C1FC141B35A6FDF2FC8F85E0E1339544,42161,21,23,2,36,47,1847
77479,77479,27D00A76D1F00346D7914B08DE57644D,10111,0,7,7,37,47,1897
77480,77480,27D00A76D1F00346D7914B08DE57644D,10107,9,20,11,38,49,1949
77481,77481,27D00A76D1F00346D7914B08DE57644D,10111,20,23,3,37,47,1897
77498,77498,359B9EE25E5F4F6D8F1DEACDAFD76D8C,19441,0,5,5,8,46,446
77499,77499,359B9EE25E5F4F6D8F1DEACDAFD76D8C,19114,8,11,3,7,43,393
77500,77500,359B9EE25E5F4F6D8F1DEACDAFD76D8C,42041,13,14,1,10,47,547
77501,77501,359B9EE25E5F4F6D8F1DEACDAFD76D8C,19621,15,18,3,5,46,296
77502,77502,76780BDA1CE8853E5C6D6B4A56C0AC5B,10951,6,8,2,29,48,1498
77503,77503,76780BDA1CE8853E5C6D6B4A56C0AC5B,11381,9,16,7,30,47,1547
77504,77504,76780BDA1CE8853E5C6D6B4A56C0AC5B,10951,18,21,3,29,48,1498
77505,77505,8E56A2D7B8313A9FB3CAF238A13A9C29,11541,0,11,11,35,49,1799
77506,77506,8E56A2D7B8313A9FB3CAF238A13A9C29,11021,12,13,1,36,49,1849
77507,77507,8E56A2D7B8313A9FB3CAF238A13A9C29,42471,14,22,8,35,49,1799
77508,77508,53FE5900C41EECA7D2F86F9ABD44CCE9,19904,0,5,5,9,44,494
77509,77509,53FE5900C41EECA7D2F86F9ABD44CCE9,19021,7,10,3,10,45,545
77510,77510,53FE5900C41EECA7D2F86F9ABD44CCE9,12641,10,23,13,10,43,543
77511,77511,7B63B781AF1E5C1909C9ECFED6946980,43761,4,6,2,32,47,1647
77512,77512,7B63B781AF1E5C1909C9ECFED6946980,42523,7,13,6,31,47,1597
77513,77513,7B63B781AF1E5C1909C9ECFED6946980,43761,16,19,3,32,47,1647
77522,77522,B4D70E7CDFA879C6A4BAE698CD44BB37,10271,0,9,9,37,46,1896
77523,77523,B4D70E7CDFA879C6A4BAE698CD44BB37,13711,9,10,1,38,46,1946
77524,77524,B4D70E7CDFA879C6A4BAE698CD44BB37,10271,13,23,10,37,46,1896
77545,77545,03D6FFA8E0742D0181BD0480CCE1246D,42511,0,7,7,37,47,1897
77546,77546,03D6FFA8E0742D0181BD0480CCE1246D,13911,8,9,1,39,46,1996
77547,77547,03D6FFA8E0742D0181BD0480CCE1246D,11021,10,16,6,36,49,1849
77548,77548,03D6FFA8E0742D0181BD0480CCE1246D,42511,19,23,4,37,47,1897
77562,77562,91128F0B7E1DD854B9F41D220D1F9DDF,13101,0,16,16,40,47,2047
77563,77563,91128F0B7E1DD854B9F41D220D1F9DDF,13841,19,21,2,40,46,2046
77564,77564,91128F0B7E1DD854B9F41D220D1F9DDF,13101,21,23,2,40,47,2047
77576,77576,8E9683EE7F6AAFA9B7B120960620DAA2,11701,0,6,6,43,48,2198
77577,77577,8E9683EE7F6AAFA9B7B120960620DAA2,42321,7,8,1,43,47,2197
77578,77578,8E9683EE7F6AAFA9B7B120960620DAA2,11701,10,23,13,43,48,2198
77613,77613,D272560C23D970FC6BFA92220AB01F25,10191,0,12,12,40,48,2048
77614,77614,D272560C23D970FC6BFA92220AB01F25,10821,14,15,1,40,47,2047
77615,77615,D272560C23D970FC6BFA92220AB01F25,10191,18,21,3,40,48,2048
77616,77616,D272560C23D970FC6BFA92220AB01F25,11551,22,23,1,39,49,1999
77625,77625,E859A0BF6FB37F9B42DF06EC7EE8FF9D,42461,0,6,6,45,47,2297
77626,77626,E859A0BF6FB37F9B42DF06EC7EE8FF9D,42321,7,8,1,43,47,2197
77627,77627,E859A0BF6FB37F9B42DF06EC7EE8FF9D,42461,12,23,11,45,47,2297
77633,77633,53650105F7F25F79263F92D3A7D439AB,42461,2,14,12,45,47,2297
77634,77634,53650105F7F25F79263F92D3A7D439AB,42111,16,18,2,44,46,2246
77635,77635,53650105F7F25F79263F92D3A7D439AB,13941,19,23,4,41,47,2097
77636,77636,292AD485DA7AE4FB3CFCA1190DC036DF,42351,0,5,5,38,45,1945
77637,77637,292AD485DA7AE4FB3CFCA1190DC036DF,42231,6,19,13,37,46,1896
77638,77638,292AD485DA7AE4FB3CFCA1190DC036DF,13911,22,23,1,39,46,1996
77644,77644,E16566CAC1D2263C830A92E3D7A4B3A9,42351,0,6,6,38,45,1945
77645,77645,E16566CAC1D2263C830A92E3D7A4B3A9,42231,9,19,10,37,46,1896
77646,77646,E16566CAC1D2263C830A92E3D7A4B3A9,42351,19,20,1,38,45,1945
77647,77647,7BB4139D2092F15150BB630D7EA7D139,11231,0,7,7,37,49,1899
77648,77648,7BB4139D2092F15150BB630D7EA7D139,10121,7,18,11,36,49,1849
77649,77649,7BB4139D2092F15150BB630D7EA7D139,11231,18,23,5,37,49,1899
77679,77679,A30C3A4D08AE45D5E2F0083CE1F142DF,13111,6,8,2,42,46,2146
77680,77680,A30C3A4D08AE45D5E2F0083CE1F142DF,42204,9,10,1,43,46,2196
77681,77681,A30C3A4D08AE45D5E2F0083CE1F142DF,13111,12,19,7,42,46,2146
77706,77706,346DC897D88CC642E017EB94EE877709,42161,0,12,12,36,47,1847
77707,77707,346DC897D88CC642E017EB94EE877709,42471,13,15,2,35,49,1799
77708,77708,346DC897D88CC642E017EB94EE877709,42161,19,23,4,36,47,1847
77716,77716,68DDCF4E5E82DB72287BDEDDF8F05C96,42471,0,3,3,35,49,1799
77717,77717,68DDCF4E5E82DB72287BDEDDF8F05C96,11911,6,18,12,37,48,1898
77718,77718,68DDCF4E5E82DB72287BDEDDF8F05C96,10161,21,23,2,35,49,1799
77724,77724,66EB51796A3F66EB609FF4750273B99B,10924,0,16,16,43,49,2199
77725,77725,66EB51796A3F66EB609FF4750273B99B,11901,17,19,2,42,49,2149
77726,77726,66EB51796A3F66EB609FF4750273B99B,10924,21,23,2,43,49,2199
77727,77727,697EB06F67653D08CFE9378AC3AAB5E4,11001,0,15,15,42,47,2147
77728,77728,697EB06F67653D08CFE9378AC3AAB5E4,13941,15,19,4,41,47,2097
77729,77729,697EB06F67653D08CFE9378AC3AAB5E4,11001,20,22,2,42,47,2147
77730,77730,1C6B014A9F7E5BF6538ED8D07E462CBD,11074,0,12,12,37,47,1897
77731,77731,1C6B014A9F7E5BF6538ED8D07E462CBD,42221,13,14,1,38,48,1948
77732,77732,1C6B014A9F7E5BF6538ED8D07E462CBD,11074,16,19,3,37,47,1897
77736,77736,AE931B79E80BF3CFA2F48EF7F9685CA5,11261,0,7,7,36,46,1846
77737,77737,AE931B79E80BF3CFA2F48EF7F9685CA5,12491,7,16,9,36,43,1843
77738,77738,AE931B79E80BF3CFA2F48EF7F9685CA5,13911,17,19,2,39,46,1996
77739,77739,AE931B79E80BF3CFA2F48EF7F9685CA5,11261,19,21,2,36,46,1846
77740,77740,591CCE415A313DA75BD12E0B79A776C1,10301,0,1,1,31,45,1595
77741,77741,591CCE415A313DA75BD12E0B79A776C1,12661,3,5,2,32,45,1645
77742,77742,591CCE415A313DA75BD12E0B79A776C1,10301,5,23,18,31,45,1595
77755,77755,9FC39451E6DCCE94D942B7AE2584CFA7,11701,0,13,13,43,48,2198
77756,77756,9FC39451E6DCCE94D942B7AE2584CFA7,42321,14,16,2,43,47,2197
77757,77757,9FC39451E6DCCE94D942B7AE2584CFA7,41392,18,21,3,43,48,2198
77758,77758,8D4403CD84975AE0D9A403E49725512D,10121,0,7,7,36,49,1849
77759,77759,8D4403CD84975AE0D9A403E49725512D,11231,7,8,1,37,49,1899
77760,77760,8D4403CD84975AE0D9A403E49725512D,10121,9,23,14,36,49,1849
77771,77771,6EF69708DD923556D4EF232AA0406F1C,11941,0,16,16,37,46,1896
77772,77772,6EF69708DD923556D4EF232AA0406F1C,10811,18,20,2,38,46,1946
77773,77773,6EF69708DD923556D4EF232AA0406F1C,11941,22,23,1,37,46,1896
77774,77774,43BBDA39EACA76AA0CE72077A69DBC77,43971,0,7,7,30,48,1548
77775,77775,43BBDA39EACA76AA0CE72077A69DBC77,11061,12,14,2,29,48,1498
77776,77776,43BBDA39EACA76AA0CE72077A69DBC77,42521,15,16,1,31,47,1597
77777,77777,43BBDA39EACA76AA0CE72077A69DBC77,40445,18,23,5,30,48,1548
77791,77791,508DF001F529FBF83DF8D4A342350BFA,42861,3,7,4,37,44,1894
77792,77792,508DF001F529FBF83DF8D4A342350BFA,11261,8,10,2,36,46,1846
77793,77793,508DF001F529FBF83DF8D4A342350BFA,42861,13,18,5,37,44,1894
77805,77805,350909571DAF40BC1326F0871B6F4AC2,42371,0,7,7,34,46,1746
77806,77806,350909571DAF40BC1326F0871B6F4AC2,42523,7,16,9,31,47,1597
77807,77807,350909571DAF40BC1326F0871B6F4AC2,42371,18,21,3,34,46,1746
77811,77811,8022990AE31C9584DEB8AC231685A64C,13651,0,1,1,30,47,1547
77812,77812,8022990AE31C9584DEB8AC231685A64C,10341,3,4,1,31,47,1597
77813,77813,8022990AE31C9584DEB8AC231685A64C,42491,7,9,2,32,46,1646
77814,77814,8022990AE31C9584DEB8AC231685A64C,10341,12,20,8,31,47,1597
77815,77815,6ADF15EBB67B7EDCDC07ECDA92E9AF04,42201,1,6,5,43,46,2196
77816,77816,6ADF15EBB67B7EDCDC07ECDA92E9AF04,13111,7,19,12,42,46,2146
77817,77817,6ADF15EBB67B7EDCDC07ECDA92E9AF04,42204,21,22,1,43,46,2196
77821,77821,0AC0AB31FAAAC7FD1C0524F4753D4E57,42231,0,17,17,37,46,1896
77822,77822,0AC0AB31FAAAC7FD1C0524F4753D4E57,11751,18,19,1,35,48,1798
77823,77823,0AC0AB31FAAAC7FD1C0524F4753D4E57,13711,21,22,1,38,46,1946
77824,77824,2CCD2660E589B7FF2F231B9957C903F7,11951,0,9,9,31,49,1599
77825,77825,2CCD2660E589B7FF2F231B9957C903F7,11561,9,18,9,32,49,1649
77826,77826,2CCD2660E589B7FF2F231B9957C903F7,11061,18,20,2,29,48,1498
77827,77827,2CCD2660E589B7FF2F231B9957C903F7,11951,21,22,1,31,49,1599
77828,77828,668B25EA27DB62433F6B97341A2F29D6,10251,0,8,8,35,47,1797
77829,77829,668B25EA27DB62433F6B97341A2F29D6,43731,9,11,2,34,47,1747
77830,77830,668B25EA27DB62433F6B97341A2F29D6,10251,14,23,9,35,47,1797
77831,77831,1FA60E09C55D97C48A7B166DD6B980ED,11701,2,7,5,43,48,2198
77832,77832,1FA60E09C55D97C48A7B166DD6B980ED,43621,14,16,2,46,48,2348
77833,77833,1FA60E09C55D97C48A7B166DD6B980ED,11701,19,22,3,43,48,2198
77837,77837,4326A99732F97B46651D6FE77C28BB70,40331,0,8,8,30,47,1547
77838,77838,4326A99732F97B46651D6FE77C28BB70,10951,8,10,2,29,48,1498
77839,77839,4326A99732F97B46651D6FE77C28BB70,11381,12,16,4,30,47,1547
77840,77840,4326A99732F97B46651D6FE77C28BB70,10951,16,18,2,29,48,1498
77845,77845,1CE5F4D10EE2FB173CB9F2BC0746661A,12311,0,9,9,30,44,1544
77846,77846,1CE5F4D10EE2FB173CB9F2BC0746661A,42531,9,13,4,31,45,1595
77847,77847,1CE5F4D10EE2FB173CB9F2BC0746661A,12311,17,19,2,30,44,1544
77848,77848,1CE5F4D10EE2FB173CB9F2BC0746661A,42531,22,23,1,31,45,1595
77860,77860,5B606639B0DDA81D89C67819EC5B7D64,13271,0,8,8,41,47,2097
77861,77861,5B606639B0DDA81D89C67819EC5B7D64,10841,9,15,6,37,47,1897
77862,77862,5B606639B0DDA81D89C67819EC5B7D64,40123,16,18,2,38,47,1947
77863,77863,5B606639B0DDA81D89C67819EC5B7D64,13271,22,23,1,41,47,2097
77867,77867,62DDFD12FD80957CA0268CDDC1A48DA2,11151,3,11,8,30,48,1548
77868,77868,62DDFD12FD80957CA0268CDDC1A48DA2,43391,14,18,4,29,48,1498
77869,77869,62DDFD12FD80957CA0268CDDC1A48DA2,11151,18,19,1,30,48,1548
77870,77870,62DDFD12FD80957CA0268CDDC1A48DA2,11061,19,23,4,29,48,1498
77876,77876,3F2FE95AB24E5E71D935604E5158C97B,11701,0,15,15,43,48,2198
77877,77877,3F2FE95AB24E5E71D935604E5158C97B,11901,16,17,1,42,49,2149
77878,77878,3F2FE95AB24E5E71D935604E5158C97B,11701,20,23,3,43,48,2198
77895,77895,BA285F01E6926591864F1F3184565800,42581,0,3,3,38,48,1948
77896,77896,BA285F01E6926591864F1F3184565800,11914,6,11,5,37,48,1898
77897,77897,BA285F01E6926591864F1F3184565800,42581,12,17,5,38,48,1948
77898,77898,BA285F01E6926591864F1F3184565800,11914,17,20,3,37,48,1898
77899,77899,E05F67959FE0060F5DAD596617CE48BB,12921,0,8,8,9,41,491
77900,77900,E05F67959FE0060F5DAD596617CE48BB,49201,8,16,8,7,41,391
77901,77901,E05F67959FE0060F5DAD596617CE48BB,12921,19,22,3,9,41,491
77923,77923,3F271425F5D5BA7FEC9D1C93CCBA4B72,13941,0,12,12,41,47,2097
77924,77924,3F271425F5D5BA7FEC9D1C93CCBA4B72,11001,14,15,1,42,47,2147
77925,77925,3F271425F5D5BA7FEC9D1C93CCBA4B72,13941,19,23,4,41,47,2097
77929,77929,2E8B764495F8C75B1A6E74CD6E6D7095,42921,1,6,5,33,47,1697
77930,77930,2E8B764495F8C75B1A6E74CD6E6D7095,10292,9,16,7,30,47,1547
77931,77931,2E8B764495F8C75B1A6E74CD6E6D7095,10731,18,23,5,33,47,1697
77932,77932,D533E9F641AE4FF4B5EBCE2D64AE67C9,43971,0,2,2,30,48,1548
77933,77933,D533E9F641AE4FF4B5EBCE2D64AE67C9,11061,2,12,10,29,48,1498
77934,77934,D533E9F641AE4FF4B5EBCE2D64AE67C9,10381,17,23,6,31,49,1599
77941,77941,D3BE1EF3900CEE989CB67F5F89D5A9A4,11911,0,9,9,37,48,1898
77942,77942,D3BE1EF3900CEE989CB67F5F89D5A9A4,42161,13,14,1,36,47,1847
77943,77943,D3BE1EF3900CEE989CB67F5F89D5A9A4,43731,15,16,1,34,47,1747
77944,77944,D3BE1EF3900CEE989CB67F5F89D5A9A4,11911,19,20,1,37,48,1898
77945,77945,B730A33E99587C5901F2126A9B1336FE,42351,1,5,4,38,45,1945
77946,77946,B730A33E99587C5901F2126A9B1336FE,11261,6,14,8,36,46,1846
77947,77947,B730A33E99587C5901F2126A9B1336FE,42861,17,18,1,37,44,1894
77948,77948,FED5EC14E212CB3BA7AA491F3063AC1F,10111,0,17,17,37,47,1897
77949,77949,FED5EC14E212CB3BA7AA491F3063AC1F,12021,18,20,2,37,49,1899
77950,77950,FED5EC14E212CB3BA7AA491F3063AC1F,10111,21,23,2,37,47,1897
77951,77951,60431017DB48728DD1D9AC55BBBFB348,11161,0,8,8,32,48,1648
77952,77952,60431017DB48728DD1D9AC55BBBFB348,10251,8,11,3,35,47,1797
77953,77953,60431017DB48728DD1D9AC55BBBFB348,11161,13,23,10,32,48,1648
77972,77972,72EE059838FC074BF0955787969E7967,11231,0,4,4,37,49,1899
77973,77973,72EE059838FC074BF0955787969E7967,11911,5,19,14,37,48,1898
77974,77974,72EE059838FC074BF0955787969E7967,11231,20,23,3,37,49,1899
77984,77984,77C3773B374C1BCE8F16244985E19C6C,10501,6,8,2,22,46,1146
77985,77985,77C3773B374C1BCE8F16244985E19C6C,12601,8,10,2,25,47,1297
77986,77986,77C3773B374C1BCE8F16244985E19C6C,10501,10,23,13,22,46,1146
77987,77987,DDF363C64B8F6ACF3450F0B1AA087EA1,19441,0,8,8,8,46,446
77988,77988,DDF363C64B8F6ACF3450F0B1AA087EA1,42041,8,11,3,10,47,547
77989,77989,DDF363C64B8F6ACF3450F0B1AA087EA1,19441,11,21,10,8,46,446
77996,77996,5566DF9556BCD612F8500FB496AD53B3,11861,6,8,2,32,47,1647
77997,77997,5566DF9556BCD612F8500FB496AD53B3,13651,9,10,1,30,47,1547
77998,77998,5566DF9556BCD612F8500FB496AD53B3,43731,12,14,2,34,47,1747
77999,77999,5566DF9556BCD612F8500FB496AD53B3,11861,15,23,8,32,47,1647
78000,78000,DE17516082F25E2D46D107AE8D072D0B,11161,0,18,18,32,48,1648
78001,78001,DE17516082F25E2D46D107AE8D072D0B,43731,18,19,1,34,47,1747
78002,78002,DE17516082F25E2D46D107AE8D072D0B,11161,21,23,2,32,48,1648
78019,78019,10B8A2D44211CACA01D59967B38E8576,42161,1,18,17,36,47,1847
78020,78020,10B8A2D44211CACA01D59967B38E8576,11201,19,20,1,35,49,1799
78021,78021,10B8A2D44211CACA01D59967B38E8576,42161,20,23,3,36,47,1847
78031,78031,B9F4C9D18F82BAF4FF50860E0E28B6F2,42401,1,9,8,36,47,1847
78032,78032,B9F4C9D18F82BAF4FF50860E0E28B6F2,11231,11,15,4,37,49,1899
78033,78033,B9F4C9D18F82BAF4FF50860E0E28B6F2,11021,16,20,4,36,49,1849
78034,78034,DA48F6EEC4784B4505CA1BBB58EA121A,10341,0,8,8,31,47,1597
78035,78035,DA48F6EEC4784B4505CA1BBB58EA121A,10292,9,17,8,30,47,1547
78036,78036,DA48F6EEC4784B4505CA1BBB58EA121A,10341,18,23,5,31,47,1597
78037,78037,81412EDBF21D783B9E4A866ACE793116,11381,0,8,8,30,47,1547
78038,78038,81412EDBF21D783B9E4A866ACE793116,12311,9,16,7,30,44,1544
78039,78039,81412EDBF21D783B9E4A866ACE793116,11431,18,20,2,29,47,1497
78040,78040,81412EDBF21D783B9E4A866ACE793116,11381,22,23,1,30,47,1547
78061,78061,D2E985719F24552C5FFF7476EA4D4B09,10111,0,10,10,37,47,1897
78062,78062,D2E985719F24552C5FFF7476EA4D4B09,10471,10,15,5,37,48,1898
78063,78063,D2E985719F24552C5FFF7476EA4D4B09,11781,18,19,1,38,49,1949
78064,78064,D2E985719F24552C5FFF7476EA4D4B09,10111,20,23,3,37,47,1897
78065,78065,97E4702F624CE098E267C7767A3602E0,10681,0,14,14,30,48,1548
78066,78066,97E4702F624CE098E267C7767A3602E0,11061,15,16,1,29,48,1498
78067,78067,97E4702F624CE098E267C7767A3602E0,10681,16,21,5,30,48,1548
78073,78073,25DF23F398DD0B4C6CED78808A57A933,11091,0,12,12,29,47,1497
78074,78074,25DF23F398DD0B4C6CED78808A57A933,10292,13,16,3,30,47,1547
78075,78075,25DF23F398DD0B4C6CED78808A57A933,42523,17,18,1,31,47,1597
78076,78076,25DF23F398DD0B4C6CED78808A57A933,10292,19,22,3,30,47,1547
78085,78085,A09953F67FED80A8C2308F84F83FE6DA,42011,3,5,2,36,46,1846
78086,78086,A09953F67FED80A8C2308F84F83FE6DA,13711,8,10,2,38,46,1946
78087,78087,A09953F67FED80A8C2308F84F83FE6DA,43241,15,18,3,36,46,1846
78088,78088,A09953F67FED80A8C2308F84F83FE6DA,13711,18,20,2,38,46,1946
78094,78094,E45E3AA86D4C7662B7021B0B55258130,40277,9,15,6,35,49,1799
78095,78095,E45E3AA86D4C7662B7021B0B55258130,11081,16,18,2,35,46,1796
78096,78096,E45E3AA86D4C7662B7021B0B55258130,11074,18,19,1,37,47,1897
78097,78097,E45E3AA86D4C7662B7021B0B55258130,11021,20,22,2,36,49,1849
78118,78118,5C81004482023832AD545CD8F1DA1576,42231,10,12,2,37,46,1896
78119,78119,5C81004482023832AD545CD8F1DA1576,13911,13,17,4,39,46,1996
78120,78120,5C81004482023832AD545CD8F1DA1576,11261,17,19,2,36,46,1846
78121,78121,5C81004482023832AD545CD8F1DA1576,13911,20,21,1,39,46,1996
78127,78127,91764B4567AC3A3991286EF06C97A20D,42161,0,7,7,36,47,1847
78128,78128,91764B4567AC3A3991286EF06C97A20D,10251,9,12,3,35,47,1797
78129,78129,91764B4567AC3A3991286EF06C97A20D,42161,15,23,8,36,47,1847
78130,78130,2FA830A3F4936C72A1774CB1227927A5,42161,0,7,7,36,47,1847
78131,78131,2FA830A3F4936C72A1774CB1227927A5,12131,8,17,9,32,47,1647
78132,78132,2FA830A3F4936C72A1774CB1227927A5,42161,18,23,5,36,47,1847
78133,78133,CEEEE12D961020D889C4958F8C670187,42151,0,6,6,35,45,1795
78134,78134,CEEEE12D961020D889C4958F8C670187,42861,6,17,11,37,44,1894
78135,78135,CEEEE12D961020D889C4958F8C670187,42151,17,21,4,35,45,1795
78136,78136,2EFEA3D9E50D1587D2C8297E61F47270,11091,0,13,13,29,47,1497
78137,78137,2EFEA3D9E50D1587D2C8297E61F47270,42523,14,16,2,31,47,1597
78138,78138,2EFEA3D9E50D1587D2C8297E61F47270,11091,17,23,6,29,47,1497
78139,78139,1C1BDEE72C59AB3D15F95F838C21E5AB,19441,0,5,5,8,46,446
78140,78140,1C1BDEE72C59AB3D15F95F838C21E5AB,12621,6,7,1,10,48,548
78141,78141,1C1BDEE72C59AB3D15F95F838C21E5AB,19441,11,23,12,8,46,446
78146,78146,6EBC343B289E845421579091E3F37018,42091,0,5,5,43,46,2196
78147,78147,6EBC343B289E845421579091E3F37018,13791,7,17,10,42,47,2147
78148,78148,6EBC343B289E845421579091E3F37018,42204,17,22,5,43,46,2196
78152,78152,0369BFD5F10C91495A6A2CBDCDE954D4,12311,1,3,2,30,44,1544
78153,78153,0369BFD5F10C91495A6A2CBDCDE954D4,42531,3,7,4,31,45,1595
78154,78154,0369BFD5F10C91495A6A2CBDCDE954D4,12311,8,23,15,30,44,1544
78155,78155,582FCEF67ED9C80E5B2E8667690F61FB,42221,0,9,9,38,48,1948
78156,78156,582FCEF67ED9C80E5B2E8667690F61FB,13101,10,13,3,40,47,2047
78157,78157,582FCEF67ED9C80E5B2E8667690F61FB,42401,14,20,6,36,47,1847
78162,78162,E06F248FC43DC08ED97FD0BB37D05DA2,12211,1,11,10,41,44,2094
78163,78163,E06F248FC43DC08ED97FD0BB37D05DA2,13341,11,12,1,44,45,2245
78164,78164,E06F248FC43DC08ED97FD0BB37D05DA2,12211,16,18,2,41,44,2094
78165,78165,E06F248FC43DC08ED97FD0BB37D05DA2,13341,19,23,4,44,45,2245
78171,78171,04218139C4137A884FE7935678F7D5B1,10471,0,8,8,37,48,1898
78172,78172,04218139C4137A884FE7935678F7D5B1,11231,11,13,2,37,49,1899
78173,78173,04218139C4137A884FE7935678F7D5B1,11021,15,18,3,36,49,1849
78174,78174,04218139C4137A884FE7935678F7D5B1,11231,21,23,2,37,49,1899
78186,78186,F6D89A5402580934C07E5409D66A5064,42231,1,7,6,37,46,1896
78187,78187,F6D89A5402580934C07E5409D66A5064,13911,7,8,1,39,46,1996
78188,78188,F6D89A5402580934C07E5409D66A5064,42231,11,20,9,37,46,1896
78189,78189,A349D8C83E1914464A7CDA23A563E70B,42523,0,8,8,31,47,1597
78190,78190,A349D8C83E1914464A7CDA23A563E70B,10281,11,13,2,33,48,1698
78191,78191,A349D8C83E1914464A7CDA23A563E70B,43761,14,15,1,32,47,1647
78192,78192,A349D8C83E1914464A7CDA23A563E70B,42523,16,18,2,31,47,1597
78193,78193,A10C736F8249F276140921A245047703,40421,0,4,4,37,48,1898
78194,78194,A10C736F8249F276140921A245047703,11074,5,18,13,37,47,1897
78195,78195,A10C736F8249F276140921A245047703,42161,20,21,1,36,47,1847
78196,78196,D604CE1D6F1A7F1409A082A5844B835D,10292,0,14,14,30,47,1547
78197,78197,D604CE1D6F1A7F1409A082A5844B835D,10351,15,17,2,28,45,1445
78198,78198,D604CE1D6F1A7F1409A082A5844B835D,10292,18,23,5,30,47,1547
78199,78199,35E834FED302DD4A84DAAA6164365161,11806,0,13,13,41,48,2098
78200,78200,35E834FED302DD4A84DAAA6164365161,42271,16,17,1,40,47,2047
78201,78201,35E834FED302DD4A84DAAA6164365161,11806,18,23,5,41,48,2098
78202,78202,5EF7E68928329842CB67D20FA9512ADE,11481,0,1,1,41,48,2098
78203,78203,5EF7E68928329842CB67D20FA9512ADE,43481,1,15,14,39,48,1998
78204,78204,5EF7E68928329842CB67D20FA9512ADE,42031,17,18,1,40,46,2046
78205,78205,5EF7E68928329842CB67D20FA9512ADE,43481,19,23,4,39,48,1998
78210,78210,CEB32655B14EC1DFD84B306B468AA0A6,10901,0,9,9,35,48,1798
78211,78211,CEB32655B14EC1DFD84B306B468AA0A6,12083,11,12,1,36,49,1849
78212,78212,CEB32655B14EC1DFD84B306B468AA0A6,10901,13,14,1,35,48,1798
78213,78213,CEB32655B14EC1DFD84B306B468AA0A6,12083,14,22,8,36,49,1849
78219,78219,DC9866094212A637CCAC17CF01FE4B5F,42861,0,5,5,37,44,1894
78220,78220,DC9866094212A637CCAC17CF01FE4B5F,11261,7,18,11,36,46,1846
78221,78221,DC9866094212A637CCAC17CF01FE4B5F,42861,18,22,4,37,44,1894
78244,78244,1D8BB04BA223F58C0F7219E50B383AFD,11061,0,8,8,29,48,1498
78245,78245,1D8BB04BA223F58C0F7219E50B383AFD,10681,8,10,2,30,48,1548
78246,78246,1D8BB04BA223F58C0F7219E50B383AFD,11061,10,22,12,29,48,1498
78247,78247,0BC1BC9FA127A76D4558FF0A0EC8FEFB,42921,0,15,15,33,47,1697
78248,78248,0BC1BC9FA127A76D4558FF0A0EC8FEFB,13601,16,17,1,34,47,1747
78249,78249,0BC1BC9FA127A76D4558FF0A0EC8FEFB,42921,17,23,6,33,47,1697
78267,78267,D9FB9F3F4820A4EF951566780A770C45,11261,5,6,1,36,46,1846
78268,78268,D9FB9F3F4820A4EF951566780A770C45,13911,6,8,2,39,46,1996
78269,78269,D9FB9F3F4820A4EF951566780A770C45,11261,8,22,14,36,46,1846
78270,78270,D9BB41A84CF921B48387DB07E0CD66FA,11074,2,15,13,37,47,1897
78271,78271,D9BB41A84CF921B48387DB07E0CD66FA,12514,16,17,1,38,47,1947
78272,78272,D9BB41A84CF921B48387DB07E0CD66FA,11074,21,23,2,37,47,1897
78278,78278,4E4FA3262DF5F7B6F1852C92067A0539,11875,0,13,13,30,46,1546
78279,78279,4E4FA3262DF5F7B6F1852C92067A0539,12311,14,16,2,30,44,1544
78280,78280,4E4FA3262DF5F7B6F1852C92067A0539,12661,16,17,1,32,45,1645
78281,78281,4E4FA3262DF5F7B6F1852C92067A0539,11875,18,22,4,30,46,1546
78282,78282,294FB4B8E5D6BF128BF9CA2E5243FA86,10161,0,6,6,35,49,1799
78283,78283,294FB4B8E5D6BF128BF9CA2E5243FA86,11021,7,16,9,36,49,1849
78284,78284,294FB4B8E5D6BF128BF9CA2E5243FA86,10161,19,23,4,35,49,1799
78285,78285,7681E0D68D024C184A5D43D46389C591,43761,0,1,1,32,47,1647
78286,78286,7681E0D68D024C184A5D43D46389C591,42921,3,13,10,33,47,1697
78287,78287,7681E0D68D024C184A5D43D46389C591,11861,13,23,10,32,47,1647
78301,78301,416649CF28FFA76815ECD578B989C86E,11061,0,4,4,29,48,1498
78302,78302,416649CF28FFA76815ECD578B989C86E,11381,7,10,3,30,47,1547
78303,78303,416649CF28FFA76815ECD578B989C86E,11061,10,21,11,29,48,1498
78309,78309,90B09B02D0DADF8E3A894A5D3E9F4905,11231,0,8,8,37,49,1899
78310,78310,90B09B02D0DADF8E3A894A5D3E9F4905,11541,9,14,5,35,49,1799
78311,78311,90B09B02D0DADF8E3A894A5D3E9F4905,12083,20,22,2,36,49,1849
78312,78312,11199AC9322CB1D62821B7265EEE1673,10251,0,2,2,35,47,1797
78313,78313,11199AC9322CB1D62821B7265EEE1673,11914,2,5,3,37,48,1898
78314,78314,11199AC9322CB1D62821B7265EEE1673,13731,17,18,1,33,49,1699
78315,78315,11199AC9322CB1D62821B7265EEE1673,11911,19,23,4,37,48,1898
78316,78316,C8A7DE9266164E78C28CA3FDC1FCBD35,12514,0,10,10,38,47,1947
78317,78317,C8A7DE9266164E78C28CA3FDC1FCBD35,42981,14,16,2,36,49,1849
78318,78318,C8A7DE9266164E78C28CA3FDC1FCBD35,42161,19,21,2,36,47,1847
78325,78325,CC1D3C2DA42F1EBED6688749C3DA1D87,11381,0,1,1,30,47,1547
78326,78326,CC1D3C2DA42F1EBED6688749C3DA1D87,43971,4,6,2,30,48,1548
78327,78327,CC1D3C2DA42F1EBED6688749C3DA1D87,11381,10,17,7,30,47,1547
78328,78328,CC1D3C2DA42F1EBED6688749C3DA1D87,43971,18,19,1,30,48,1548
78342,78342,2CB6953F391C73F166D02AC31E930A06,40171,0,5,5,38,48,1948
78343,78343,2CB6953F391C73F166D02AC31E930A06,11914,6,11,5,37,48,1898
78344,78344,2CB6953F391C73F166D02AC31E930A06,11921,12,13,1,38,48,1948
78345,78345,2CB6953F391C73F166D02AC31E930A06,11914,15,21,6,37,48,1898
78346,78346,2C8F3D11EF1554D46E77DD772B97CCCA,11861,0,2,2,32,47,1647
78347,78347,2C8F3D11EF1554D46E77DD772B97CCCA,10281,2,12,10,33,48,1698
78348,78348,2C8F3D11EF1554D46E77DD772B97CCCA,11861,13,15,2,32,47,1647
78349,78349,2C8F3D11EF1554D46E77DD772B97CCCA,10281,16,23,7,33,48,1698
78350,78350,6C5686894FB32FFE8BBC9C074B78072A,10471,0,15,15,37,48,1898
78351,78351,6C5686894FB32FFE8BBC9C074B78072A,11021,18,20,2,36,49,1849
78352,78352,6C5686894FB32FFE8BBC9C074B78072A,10471,20,23,3,37,48,1898
78353,78353,6EB73BC8964AD97D01165273A919D84A,11861,9,10,1,32,47,1647
78354,78354,6EB73BC8964AD97D01165273A919D84A,42021,11,13,2,33,47,1697
78355,78355,6EB73BC8964AD97D01165273A919D84A,11861,15,23,8,32,47,1647
78356,78356,9D7E28E179E5F5D009F8D277D0F434A8,11861,0,11,11,32,47,1647
78357,78357,9D7E28E179E5F5D009F8D277D0F434A8,10281,11,13,2,33,48,1698
78358,78358,9D7E28E179E5F5D009F8D277D0F434A8,11861,15,23,8,32,47,1647
78374,78374,56B5641ECD958384F4615E8368602153,13911,0,6,6,39,46,1996
78375,78375,56B5641ECD958384F4615E8368602153,42231,7,18,11,37,46,1896
78376,78376,56B5641ECD958384F4615E8368602153,13911,19,22,3,39,46,1996
78377,78377,BF1C25FEA2CAF96E8C013A91242C0773,43321,8,9,1,36,49,1849
78378,78378,BF1C25FEA2CAF96E8C013A91242C0773,11531,11,12,1,34,49,1749
78379,78379,BF1C25FEA2CAF96E8C013A91242C0773,10651,19,23,4,36,49,1849
78380,78380,ACD04627348D28EB014FAB46490D4B92,10634,0,9,9,27,45,1395
78381,78381,ACD04627348D28EB014FAB46490D4B92,12601,11,15,4,25,47,1297
78382,78382,ACD04627348D28EB014FAB46490D4B92,10634,15,20,5,27,45,1395
78383,78383,4B5C492CF16B079882322240829D6566,10661,0,9,9,37,49,1899
78384,78384,4B5C492CF16B079882322240829D6566,11271,10,12,2,37,48,1898
78385,78385,4B5C492CF16B079882322240829D6566,11231,17,23,6,37,49,1899
78386,78386,31C99BE35DAA7CC1D9A6D662CA3683F3,10841,0,8,8,37,47,1897
78387,78387,31C99BE35DAA7CC1D9A6D662CA3683F3,12514,12,14,2,38,47,1947
78388,78388,31C99BE35DAA7CC1D9A6D662CA3683F3,10841,15,17,2,37,47,1897
78389,78389,31C99BE35DAA7CC1D9A6D662CA3683F3,42331,18,22,4,39,46,1996
78390,78390,64812FF1B8835C5669BB93C0D5307414,11231,0,13,13,37,49,1899
78391,78391,64812FF1B8835C5669BB93C0D5307414,41271,14,16,2,38,48,1948
78392,78392,64812FF1B8835C5669BB93C0D5307414,11231,18,23,5,37,49,1899
78393,78393,558A6887C0D5899B43E75BBD844A7C64,42461,0,6,6,45,47,2297
78394,78394,558A6887C0D5899B43E75BBD844A7C64,42321,6,15,9,43,47,2197
78395,78395,558A6887C0D5899B43E75BBD844A7C64,43621,16,17,1,46,48,2348
78396,78396,558A6887C0D5899B43E75BBD844A7C64,42461,18,19,1,45,47,2297
78397,78397,6C0D0D23B3A531A983F30B3FF9DCFC44,11151,5,6,1,30,48,1548
78398,78398,6C0D0D23B3A531A983F30B3FF9DCFC44,11061,7,18,11,29,48,1498
78399,78399,6C0D0D23B3A531A983F30B3FF9DCFC44,11324,18,20,2,31,46,1596
78406,78406,D54F9F7B5ACE26D54228A669C839B9DF,42231,0,15,15,37,46,1896
78407,78407,D54F9F7B5ACE26D54228A669C839B9DF,42151,17,18,1,35,45,1795
78408,78408,D54F9F7B5ACE26D54228A669C839B9DF,42231,20,23,3,37,46,1896
78418,78418,D8B46FFCD15B641FB93B8219A29A7205,40673,2,7,5,36,48,1848
78419,78419,D8B46FFCD15B641FB93B8219A29A7205,10251,8,13,5,35,47,1797
78420,78420,D8B46FFCD15B641FB93B8219A29A7205,10111,13,20,7,37,47,1897
78421,78421,11D0C3BFA1EEA48E71CAB72BD84A5D2F,13671,1,7,6,27,43,1393
78422,78422,11D0C3BFA1EEA48E71CAB72BD84A5D2F,10351,10,11,1,28,45,1445
78423,78423,11D0C3BFA1EEA48E71CAB72BD84A5D2F,10634,11,20,9,27,45,1395
78424,78424,2DF528642956EE7F281EE1C987DEF31F,10271,0,14,14,37,46,1896
78425,78425,2DF528642956EE7F281EE1C987DEF31F,13711,14,15,1,38,46,1946
78426,78426,2DF528642956EE7F281EE1C987DEF31F,43241,20,22,2,36,46,1846
78427,78427,B6EDE923BA421C490CFB0E81830396F2,11231,0,12,12,37,49,1899
78428,78428,B6EDE923BA421C490CFB0E81830396F2,11271,13,14,1,37,48,1898
78429,78429,B6EDE923BA421C490CFB0E81830396F2,11231,17,23,6,37,49,1899
78430,78430,BC5F5A048F874E8EDED6AF765E340D8C,11914,10,17,7,37,48,1898
78431,78431,BC5F5A048F874E8EDED6AF765E340D8C,11811,19,20,1,38,49,1949
78432,78432,BC5F5A048F874E8EDED6AF765E340D8C,40171,21,22,1,38,48,1948
78438,78438,0C993A1B5BD23944DD153F92F92FAA1E,10634,0,4,4,27,45,1395
78439,78439,0C993A1B5BD23944DD153F92F92FAA1E,10351,7,10,3,28,45,1445
78440,78440,0C993A1B5BD23944DD153F92F92FAA1E,10634,11,14,3,27,45,1395
78441,78441,0C993A1B5BD23944DD153F92F92FAA1E,10351,15,19,4,28,45,1445
78445,78445,B93C16A242FE2C6BDA83A87AD4FAA434,10501,0,9,9,22,46,1146
78446,78446,B93C16A242FE2C6BDA83A87AD4FAA434,12601,11,19,8,25,47,1297
78447,78447,B93C16A242FE2C6BDA83A87AD4FAA434,10501,19,20,1,22,46,1146
78462,78462,EA51A406CE578A65A7187933536C9E6B,11431,10,16,6,29,47,1497
78463,78463,EA51A406CE578A65A7187933536C9E6B,11061,18,19,1,29,48,1498
78464,78464,EA51A406CE578A65A7187933536C9E6B,11151,19,21,2,30,48,1548
78468,78468,6D4D1F791C1D6B7FEF194CA06EF75A98,10401,0,10,10,33,49,1699
78469,78469,6D4D1F791C1D6B7FEF194CA06EF75A98,12161,10,11,1,32,46,1646
78470,78470,6D4D1F791C1D6B7FEF194CA06EF75A98,10161,14,16,2,35,49,1799
78471,78471,6D4D1F791C1D6B7FEF194CA06EF75A98,40203,17,23,6,33,49,1699
78472,78472,EBEC12643A85FF06102FB66738B5C413,10191,10,13,3,40,48,2048
78473,78473,EBEC12643A85FF06102FB66738B5C413,11271,14,15,1,37,48,1898
78474,78474,EBEC12643A85FF06102FB66738B5C413,40041,19,22,3,40,49,2049
78475,78475,DD11EC5E596BBBC5A00C9F6952DD9EC0,10281,0,11,11,33,48,1698
78476,78476,DD11EC5E596BBBC5A00C9F6952DD9EC0,43161,11,13,2,35,47,1797
78477,78477,DD11EC5E596BBBC5A00C9F6952DD9EC0,42301,16,19,3,36,47,1847
78478,78478,DD11EC5E596BBBC5A00C9F6952DD9EC0,10281,21,23,2,33,48,1698
78479,78479,BB5E96B7A1961F9190EBF4828BB4EFB2,12661,1,7,6,32,45,1645
78480,78480,BB5E96B7A1961F9190EBF4828BB4EFB2,42531,7,9,2,31,45,1595
78481,78481,BB5E96B7A1961F9190EBF4828BB4EFB2,12661,12,20,8,32,45,1645
78497,78497,1D237278953FBE8D18E4E279CA9C3A1D,43621,6,13,7,46,48,2348
78498,78498,1D237278953FBE8D18E4E279CA9C3A1D,12651,13,15,2,43,47,2197
78499,78499,1D237278953FBE8D18E4E279CA9C3A1D,43621,15,19,4,46,48,2348
78500,78500,1D237278953FBE8D18E4E279CA9C3A1D,12651,21,22,1,43,47,2197
78501,78501,A534FD7E51A551BE3196665029DD0400,19931,1,11,10,7,43,393
78502,78502,A534FD7E51A551BE3196665029DD0400,12641,11,12,1,10,43,543
78503,78503,A534FD7E51A551BE3196665029DD0400,19931,13,14,1,7,43,393
78504,78504,A534FD7E51A551BE3196665029DD0400,12641,17,20,3,10,43,543
78505,78505,59DD4D14E624C2B5E0CF9CBC57143681,10801,0,8,8,42,47,2147
78506,78506,59DD4D14E624C2B5E0CF9CBC57143681,42321,9,11,2,43,47,2197
78507,78507,59DD4D14E624C2B5E0CF9CBC57143681,10801,14,17,3,42,47,2147
78508,78508,59DD4D14E624C2B5E0CF9CBC57143681,42321,19,20,1,43,47,2197
78514,78514,6A27A29578B0AFBD4A9AFC8AAB4DB030,42191,0,8,8,38,49,1949
78515,78515,6A27A29578B0AFBD4A9AFC8AAB4DB030,10471,10,19,9,37,48,1898
78516,78516,6A27A29578B0AFBD4A9AFC8AAB4DB030,11231,20,23,3,37,49,1899
78517,78517,EADD516087B3C363EADF0097DECE8E48,12521,0,13,13,35,41,1791
78518,78518,EADD516087B3C363EADF0097DECE8E48,42151,14,15,1,35,45,1795
78519,78519,EADD516087B3C363EADF0097DECE8E48,12521,18,23,5,35,41,1791
78540,78540,A1B1493AD1E4959D25E397CB780FB65E,42531,0,13,13,31,45,1595
78541,78541,A1B1493AD1E4959D25E397CB780FB65E,12311,15,17,2,30,44,1544
78542,78542,A1B1493AD1E4959D25E397CB780FB65E,42531,18,23,5,31,45,1595
78546,78546,B8DA8001EB83D52016D2196A1A261553,10161,0,10,10,35,49,1799
78547,78547,B8DA8001EB83D52016D2196A1A261553,11914,11,13,2,37,48,1898
78548,78548,B8DA8001EB83D52016D2196A1A261553,10161,13,23,10,35,49,1799
78557,78557,9174106625D3239DC850CA622055B684,42941,0,6,6,37,47,1897
78558,78558,9174106625D3239DC850CA622055B684,42301,8,13,5,36,47,1847
78559,78559,9174106625D3239DC850CA622055B684,42941,18,23,5,37,47,1897
78560,78560,C1EC4195952AE598828B68B58D5C6801,11753,0,8,8,35,48,1798
78561,78561,C1EC4195952AE598828B68B58D5C6801,43731,12,14,2,34,47,1747
78562,78562,C1EC4195952AE598828B68B58D5C6801,10971,15,17,2,35,47,1797
78563,78563,C1EC4195952AE598828B68B58D5C6801,11541,18,22,4,35,49,1799
78564,78564,9C017418D67328D93FD696E6655B46ED,11211,0,7,7,34,49,1749
78565,78565,9C017418D67328D93FD696E6655B46ED,10107,8,11,3,38,49,1949
78566,78566,9C017418D67328D93FD696E6655B46ED,12971,13,17,4,32,48,1648
78567,78567,9C017418D67328D93FD696E6655B46ED,11211,19,23,4,34,49,1749
78571,78571,A6850F349AE5EB6D145368B7DBFF6B7A,13911,9,17,8,39,46,1996
78572,78572,A6850F349AE5EB6D145368B7DBFF6B7A,13121,19,21,2,38,46,1946
78573,78573,A6850F349AE5EB6D145368B7DBFF6B7A,42351,21,22,1,38,45,1945
78574,78574,9161AF2FBE00F6EB9CFD0E53A85277FE,11381,0,18,18,30,47,1547
78575,78575,9161AF2FBE00F6EB9CFD0E53A85277FE,10951,18,19,1,29,48,1498
78576,78576,9161AF2FBE00F6EB9CFD0E53A85277FE,11381,20,23,3,30,47,1547
78577,78577,6268A79D87E3CFA4E65FA8A748F9969C,13101,0,7,7,40,47,2047
78578,78578,6268A79D87E3CFA4E65FA8A748F9969C,13271,10,16,6,41,47,2097
78579,78579,6268A79D87E3CFA4E65FA8A748F9969C,11481,20,21,1,41,48,2098
78580,78580,6268A79D87E3CFA4E65FA8A748F9969C,13101,22,23,1,40,47,2047
78599,78599,A67F50337E2EC43D03A4976B44AE2823,13711,0,4,4,38,46,1946
78600,78600,A67F50337E2EC43D03A4976B44AE2823,11941,4,9,5,37,46,1896
78601,78601,A67F50337E2EC43D03A4976B44AE2823,13711,14,17,3,38,46,1946
78602,78602,A67F50337E2EC43D03A4976B44AE2823,11941,18,22,4,37,46,1896
78603,78603,780CF605B987CE4335E0B64DFA86ACBF,11921,0,1,1,38,48,1948
78604,78604,780CF605B987CE4335E0B64DFA86ACBF,12514,3,15,12,38,47,1947
78605,78605,780CF605B987CE4335E0B64DFA86ACBF,11921,19,20,1,38,48,1948
78606,78606,780CF605B987CE4335E0B64DFA86ACBF,12514,20,23,3,38,47,1947
78612,78612,CF7DA1891D00F069E0E0214450037183,11381,0,7,7,30,47,1547
78613,78613,CF7DA1891D00F069E0E0214450037183,11061,10,11,1,29,48,1498
78614,78614,CF7DA1891D00F069E0E0214450037183,11381,13,18,5,30,47,1547
78615,78615,CF7DA1891D00F069E0E0214450037183,11061,20,22,2,29,48,1498
78616,78616,0781E535CBB143640477269330BEC7EE,40411,2,11,9,34,48,1748
78617,78617,0781E535CBB143640477269330BEC7EE,42161,11,16,5,36,47,1847
78618,78618,0781E535CBB143640477269330BEC7EE,10881,16,20,4,34,48,1748
78623,78623,55213BD121E5DF3287C58B30F344CC9F,43761,0,6,6,32,47,1647
78624,78624,55213BD121E5DF3287C58B30F344CC9F,11061,8,17,9,29,48,1498
78625,78625,55213BD121E5DF3287C58B30F344CC9F,43761,21,22,1,32,47,1647
78626,78626,8D86E284D185DE22084CD86C6BFE1A08,11875,0,6,6,30,46,1546
78627,78627,8D86E284D185DE22084CD86C6BFE1A08,12311,6,16,10,30,44,1544
78628,78628,8D86E284D185DE22084CD86C6BFE1A08,11875,19,23,4,30,46,1546
78629,78629,D1E9822F110DBA0B15518AEF570762E3,11061,5,8,3,29,48,1498
78630,78630,D1E9822F110DBA0B15518AEF570762E3,10681,11,19,8,30,48,1548
78631,78631,D1E9822F110DBA0B15518AEF570762E3,11061,19,22,3,29,48,1498
78632,78632,F2ED260BEE0CFBD7C0D8D1BC36233DE2,12121,0,12,12,29,47,1497
78633,78633,F2ED260BEE0CFBD7C0D8D1BC36233DE2,11381,14,15,1,30,47,1547
78634,78634,F2ED260BEE0CFBD7C0D8D1BC36233DE2,12121,18,20,2,29,47,1497
78638,78638,01308B72F71E3AACC045F922DA6CAE4D,43761,1,7,6,32,47,1647
78639,78639,01308B72F71E3AACC045F922DA6CAE4D,10341,8,15,7,31,47,1597
78640,78640,01308B72F71E3AACC045F922DA6CAE4D,43761,16,19,3,32,47,1647
78656,78656,03C19F5F9D7D397AE6E9F2FD16BA994D,10251,0,13,13,35,47,1797
78657,78657,03C19F5F9D7D397AE6E9F2FD16BA994D,42401,13,20,7,36,47,1847
78658,78658,03C19F5F9D7D397AE6E9F2FD16BA994D,10251,20,23,3,35,47,1797
78674,78674,4013ED200A1DCD99C06EF9BAF61925C8,42511,8,10,2,37,47,1897
78675,78675,4013ED200A1DCD99C06EF9BAF61925C8,42401,11,20,9,36,47,1847
78676,78676,4013ED200A1DCD99C06EF9BAF61925C8,10841,20,23,3,37,47,1897
78681,78681,6F881E54FD8247C10253271465BFC769,10111,0,8,8,37,47,1897
78682,78682,6F881E54FD8247C10253271465BFC769,43161,8,10,2,35,47,1797
78683,78683,6F881E54FD8247C10253271465BFC769,10111,11,23,12,37,47,1897
78684,78684,84DDAB60D0DE384DC44B1CD74BF8AB83,42151,2,9,7,35,45,1795
78685,78685,84DDAB60D0DE384DC44B1CD74BF8AB83,42861,10,13,3,37,44,1894
78686,78686,84DDAB60D0DE384DC44B1CD74BF8AB83,42151,14,20,6,35,45,1795
78687,78687,8FFDEB2573593D2EBFD07303D94AB87F,42321,0,14,14,43,47,2197
78688,78688,8FFDEB2573593D2EBFD07303D94AB87F,10801,15,16,1,42,47,2147
78689,78689,8FFDEB2573593D2EBFD07303D94AB87F,42321,19,22,3,43,47,2197
78706,78706,394FCA5F3AB676CBAB996A49070239BB,10107,0,8,8,38,49,1949
78707,78707,394FCA5F3AB676CBAB996A49070239BB,11231,9,16,7,37,49,1899
78708,78708,394FCA5F3AB676CBAB996A49070239BB,10107,21,23,2,38,49,1949
78713,78713,91D7F1CF32E890EDD3961F448450E5FB,42401,0,7,7,36,47,1847
78714,78714,91D7F1CF32E890EDD3961F448450E5FB,10371,12,19,7,37,49,1899
78715,78715,91D7F1CF32E890EDD3961F448450E5FB,42401,22,23,1,36,47,1847
78721,78721,B2837B3AF3B95C01477BCBE3B9A87733,11021,10,13,3,36,49,1849
78722,78722,B2837B3AF3B95C01477BCBE3B9A87733,10371,13,15,2,37,49,1899
78723,78723,B2837B3AF3B95C01477BCBE3B9A87733,11021,19,21,2,36,49,1849
78724,78724,DA8EF7789DD15D64E4CB91A60A838933,43731,1,9,8,34,47,1747
78725,78725,DA8EF7789DD15D64E4CB91A60A838933,10691,10,12,2,33,48,1698
78726,78726,DA8EF7789DD15D64E4CB91A60A838933,43761,17,18,1,32,47,1647
78727,78727,578576FA7EC025C884C550F38A47EB4E,11381,0,11,11,30,47,1547
78728,78728,578576FA7EC025C884C550F38A47EB4E,11861,11,17,6,32,47,1647
78729,78729,578576FA7EC025C884C550F38A47EB4E,11381,21,23,2,30,47,1547
78730,78730,831CEF471029417D091D2BE9F78234DD,10801,3,5,2,42,47,2147
78731,78731,831CEF471029417D091D2BE9F78234DD,42321,9,10,1,43,47,2197
78732,78732,831CEF471029417D091D2BE9F78234DD,10801,13,17,4,42,47,2147
78733,78733,831CEF471029417D091D2BE9F78234DD,40365,19,21,2,42,48,2148
78738,78738,59AC88B90F4F8D1C4A09D50E66CE6DCB,10841,1,9,8,37,47,1897
78739,78739,59AC88B90F4F8D1C4A09D50E66CE6DCB,42301,17,18,1,36,47,1847
78740,78740,59AC88B90F4F8D1C4A09D50E66CE6DCB,10111,20,23,3,37,47,1897
78747,78747,AB64F2D1FFCE5AE98CBB9AEB03F40C42,42601,0,1,1,44,48,2248
78748,78748,AB64F2D1FFCE5AE98CBB9AEB03F40C42,13471,1,2,1,47,49,2399
78749,78749,AB64F2D1FFCE5AE98CBB9AEB03F40C42,42601,15,16,1,44,48,2248
78750,78750,AB64F2D1FFCE5AE98CBB9AEB03F40C42,13471,16,19,3,47,49,2399
78751,78751,F8AE25A825B76613544F3A38F89C1CB2,43101,7,9,2,46,40,2340
78752,78752,F8AE25A825B76613544F3A38F89C1CB2,12571,12,13,1,48,39,2439
78753,78753,F8AE25A825B76613544F3A38F89C1CB2,43101,17,19,2,46,40,2340
78757,78757,E3B088F7DEFCCE4BD4EB6ADB8F0E5950,10841,0,12,12,37,47,1897
78758,78758,E3B088F7DEFCCE4BD4EB6ADB8F0E5950,12514,13,14,1,38,47,1947
78759,78759,E3B088F7DEFCCE4BD4EB6ADB8F0E5950,10841,18,20,2,37,47,1897
78760,78760,656752102BA99654C7060CE5B2133D72,49201,1,15,14,7,41,391
78761,78761,656752102BA99654C7060CE5B2133D72,12921,18,19,1,9,41,491
78762,78762,656752102BA99654C7060CE5B2133D72,49201,21,23,2,7,41,391
78763,78763,C8EB41C6B7152CD714709DA811B3B245,10681,0,8,8,30,48,1548
78764,78764,C8EB41C6B7152CD714709DA811B3B245,11061,9,21,12,29,48,1498
78765,78765,C8EB41C6B7152CD714709DA811B3B245,10681,22,23,1,30,48,1548
78766,78766,F736C39F560B9A4948E68A46A6A6DDA8,41031,0,14,14,32,49,1649
78767,78767,F736C39F560B9A4948E68A46A6A6DDA8,10431,18,20,2,33,49,1699
78768,78768,F736C39F560B9A4948E68A46A6A6DDA8,41031,22,23,1,32,49,1649
78779,78779,8A35309960304DAF98A2649637AD86E1,10351,8,12,4,28,45,1445
78780,78780,8A35309960304DAF98A2649637AD86E1,10634,12,14,2,27,45,1395
78781,78781,8A35309960304DAF98A2649637AD86E1,10351,17,22,5,28,45,1445
78786,78786,055660D96102C90837257CF6FD6D548A,13911,0,7,7,39,46,1996
78787,78787,055660D96102C90837257CF6FD6D548A,11261,7,19,12,36,46,1846
78788,78788,055660D96102C90837257CF6FD6D548A,13911,21,23,2,39,46,1996
78789,78789,4061A29B6F505247E2DE99CAD14FA68F,41721,9,13,4,39,48,1998
78790,78790,4061A29B6F505247E2DE99CAD14FA68F,11801,14,15,1,42,48,2148
78791,78791,4061A29B6F505247E2DE99CAD14FA68F,10191,16,23,7,40,48,2048
78796,78796,45E2591DDB181830E886EA4FBDDB1E4F,11861,1,9,8,32,47,1647
78797,78797,45E2591DDB181830E886EA4FBDDB1E4F,10151,9,19,10,34,47,1747
78798,78798,45E2591DDB181830E886EA4FBDDB1E4F,10511,20,23,3,35,46,1796
78803,78803,6D0E4540E51269C1AC09F1ADCE12468A,42141,3,4,1,32,47,1647
78804,78804,6D0E4540E51269C1AC09F1ADCE12468A,11381,8,10,2,30,47,1547
78805,78805,6D0E4540E51269C1AC09F1ADCE12468A,42521,14,17,3,31,47,1597
78806,78806,6D0E4540E51269C1AC09F1ADCE12468A,13651,18,19,1,30,47,1547
78807,78807,5017DC5A15F28FB4E5C8B33E21578020,13711,0,8,8,38,46,1946
78808,78808,5017DC5A15F28FB4E5C8B33E21578020,42231,8,18,10,37,46,1896
78809,78809,5017DC5A15F28FB4E5C8B33E21578020,13711,20,23,3,38,46,1946
78810,78810,5B1C4E5A2FCBA29FCB22AA08852ED4B4,13651,0,9,9,30,47,1547
78811,78811,5B1C4E5A2FCBA29FCB22AA08852ED4B4,12121,9,13,4,29,47,1497
78812,78812,5B1C4E5A2FCBA29FCB22AA08852ED4B4,13651,17,20,3,30,47,1547
78813,78813,28C2D2FE4D28624F13409918B749F4EA,42231,0,10,10,37,46,1896
78814,78814,28C2D2FE4D28624F13409918B749F4EA,13711,13,15,2,38,46,1946
78815,78815,28C2D2FE4D28624F13409918B749F4EA,11941,16,18,2,37,46,1896
78816,78816,28C2D2FE4D28624F13409918B749F4EA,13711,20,23,3,38,46,1946
78817,78817,C8BB5B9ECE6D29A0D7A087B9918224BA,40454,0,17,17,35,49,1799
78818,78818,C8BB5B9ECE6D29A0D7A087B9918224BA,43241,17,19,2,36,46,1846
78819,78819,C8BB5B9ECE6D29A0D7A087B9918224BA,42511,22,23,1,37,47,1897
78823,78823,7B4E6126570CADEFC5C95EC455FF20E3,11914,0,5,5,37,48,1898
78824,78824,7B4E6126570CADEFC5C95EC455FF20E3,43361,7,9,2,38,48,1948
78825,78825,7B4E6126570CADEFC5C95EC455FF20E3,11914,10,23,13,37,48,1898
78829,78829,5DAE8FB10D3FBEF5B02F98DB4BFD46E9,42351,2,6,4,38,45,1945
78830,78830,5DAE8FB10D3FBEF5B02F98DB4BFD46E9,42231,8,16,8,37,46,1896
78831,78831,5DAE8FB10D3FBEF5B02F98DB4BFD46E9,13911,19,22,3,39,46,1996
78832,78832,BC3507BB18C0A44FC993D8B041281F6D,43731,0,8,8,34,47,1747
78833,78833,BC3507BB18C0A44FC993D8B041281F6D,10731,10,13,3,33,47,1697
78834,78834,BC3507BB18C0A44FC993D8B041281F6D,43731,14,15,1,34,47,1747
78835,78835,BC3507BB18C0A44FC993D8B041281F6D,10731,20,22,2,33,47,1697
78836,78836,21C21587890502DDD311AAE3E126DBBD,11381,9,11,2,30,47,1547
78837,78837,21C21587890502DDD311AAE3E126DBBD,11061,13,14,1,29,48,1498
78838,78838,21C21587890502DDD311AAE3E126DBBD,11381,17,18,1,30,47,1547
78846,78846,16B2F0D78BEB849442A93B3F29FB7F4E,42271,0,7,7,40,47,2047
78847,78847,16B2F0D78BEB849442A93B3F29FB7F4E,42321,8,16,8,43,47,2197
78848,78848,16B2F0D78BEB849442A93B3F29FB7F4E,42281,18,19,1,40,48,2048
78849,78849,16B2F0D78BEB849442A93B3F29FB7F4E,11806,20,23,3,41,48,2098
78850,78850,532174BB6C7E593BB5F059675D341CD9,12641,2,13,11,10,43,543
78851,78851,532174BB6C7E593BB5F059675D341CD9,19901,14,17,3,7,44,394
78852,78852,532174BB6C7E593BB5F059675D341CD9,12641,20,23,3,10,43,543
78853,78853,4C8E92DBB85921608C1C92929A7A8C92,42521,0,6,6,31,47,1597
78854,78854,4C8E92DBB85921608C1C92929A7A8C92,13651,7,9,2,30,47,1547
78855,78855,4C8E92DBB85921608C1C92929A7A8C92,42521,12,23,11,31,47,1597
78871,78871,4A62D8D87328C7F77A091AF01582F982,11941,0,14,14,37,46,1896
78872,78872,4A62D8D87328C7F77A091AF01582F982,42351,14,16,2,38,45,1945
78873,78873,4A62D8D87328C7F77A091AF01582F982,11261,16,19,3,36,46,1846
78874,78874,4A62D8D87328C7F77A091AF01582F982,42351,19,23,4,38,45,1945
78879,78879,28AC7800C8CFAF8003CE1A0E8DA4A091,11271,0,12,12,37,48,1898
78880,78880,28AC7800C8CFAF8003CE1A0E8DA4A091,42191,16,17,1,38,49,1949
78881,78881,28AC7800C8CFAF8003CE1A0E8DA4A091,10471,17,18,1,37,48,1898
78890,78890,C951EE328AF92C9D9A35C3F8B40B036A,11491,0,13,13,36,47,1847
78891,78891,C951EE328AF92C9D9A35C3F8B40B036A,11074,14,15,1,37,47,1897
78892,78892,C951EE328AF92C9D9A35C3F8B40B036A,11491,18,23,5,36,47,1847
78893,78893,6858BA386479F00AA69AF43EA92986A3,13941,5,13,8,41,47,2097
78894,78894,6858BA386479F00AA69AF43EA92986A3,11001,13,15,2,42,47,2147
78895,78895,6858BA386479F00AA69AF43EA92986A3,13941,19,21,2,41,47,2097
78906,78906,1E2BDCE897234CB8450E391543ADF518,42351,7,8,1,38,45,1945
78907,78907,1E2BDCE897234CB8450E391543ADF518,11261,9,11,2,36,46,1846
78908,78908,1E2BDCE897234CB8450E391543ADF518,42351,12,13,1,38,45,1945
78909,78909,1E2BDCE897234CB8450E391543ADF518,13911,15,18,3,39,46,1996
78915,78915,A2DBF97B6E842C7B164E9D0343E01498,10421,0,8,8,41,48,2098
78916,78916,A2DBF97B6E842C7B164E9D0343E01498,12514,10,11,1,38,47,1947
78917,78917,A2DBF97B6E842C7B164E9D0343E01498,10421,13,23,10,41,48,2098
78918,78918,7C66DF9B4CFCFA1F927E3E567C62A056,10911,0,7,7,39,46,1996
78919,78919,7C66DF9B4CFCFA1F927E3E567C62A056,13711,7,8,1,38,46,1946
78920,78920,7C66DF9B4CFCFA1F927E3E567C62A056,10911,13,15,2,39,46,1996
78921,78921,7C66DF9B4CFCFA1F927E3E567C62A056,13681,18,22,4,38,47,1947
78922,78922,CC04DF57CD476D56A9C2711AACC54374,42861,5,6,1,37,44,1894
78923,78923,CC04DF57CD476D56A9C2711AACC54374,11261,6,17,11,36,46,1846
78924,78924,CC04DF57CD476D56A9C2711AACC54374,42861,17,19,2,37,44,1894
78938,78938,E2F2F4143F844EB76521711717E3F1F1,12921,0,5,5,9,41,491
78939,78939,E2F2F4143F844EB76521711717E3F1F1,12641,6,7,1,10,43,543
78940,78940,E2F2F4143F844EB76521711717E3F1F1,12921,11,13,2,9,41,491
78941,78941,E2F2F4143F844EB76521711717E3F1F1,12641,17,19,2,10,43,543
78942,78942,1432315E02B72C61B42AD2B5294AED3D,42161,0,8,8,36,47,1847
78943,78943,1432315E02B72C61B42AD2B5294AED3D,10251,8,18,10,35,47,1797
78944,78944,1432315E02B72C61B42AD2B5294AED3D,11231,18,19,1,37,49,1899
78945,78945,1432315E02B72C61B42AD2B5294AED3D,10251,20,23,3,35,47,1797
78951,78951,D3F6CC79419CB8E677F2F17C3DF072CD,13711,6,11,5,38,46,1946
78952,78952,D3F6CC79419CB8E677F2F17C3DF072CD,11941,13,17,4,37,46,1896
78953,78953,D3F6CC79419CB8E677F2F17C3DF072CD,13121,18,23,5,38,46,1946
78954,78954,58FF60972C1637520443DC5766A2AB67,13411,0,3,3,49,42,2492
78955,78955,58FF60972C1637520443DC5766A2AB67,43951,6,9,3,49,41,2491
78956,78956,58FF60972C1637520443DC5766A2AB67,13411,11,21,10,49,42,2492
78962,78962,9951832C875ED15346443116F8C6A7D1,42331,0,7,7,39,46,1996
78963,78963,9951832C875ED15346443116F8C6A7D1,10191,12,14,2,40,48,2048
78964,78964,9951832C875ED15346443116F8C6A7D1,10811,18,21,3,38,46,1946
78965,78965,5F011E03EB30D52AF7652FE981140B35,11074,0,9,9,37,47,1897
78966,78966,5F011E03EB30D52AF7652FE981140B35,42221,11,13,2,38,48,1948
78967,78967,5F011E03EB30D52AF7652FE981140B35,11074,14,23,9,37,47,1897
78976,78976,AD5871AA9EAD75878C606AE9C3D0E3D8,43951,7,9,2,49,41,2491
78977,78977,AD5871AA9EAD75878C606AE9C3D0E3D8,13411,14,16,2,49,42,2492
78978,78978,AD5871AA9EAD75878C606AE9C3D0E3D8,43951,18,19,1,49,41,2491
78979,78979,14B2111C128816365EE7BB66D157EF00,10721,0,6,6,31,48,1598
78980,78980,14B2111C128816365EE7BB66D157EF00,11861,8,9,1,32,47,1647
78981,78981,14B2111C128816365EE7BB66D157EF00,10721,10,23,13,31,48,1598
78982,78982,9BCFE3A528684350BDB247E267E33F3E,42091,0,6,6,43,46,2196
78983,78983,9BCFE3A528684350BDB247E267E33F3E,12651,7,8,1,43,47,2197
78984,78984,9BCFE3A528684350BDB247E267E33F3E,42091,12,23,11,43,46,2196
78985,78985,3C11EF223CD10B38AE1580AC51B9D9F2,10731,0,1,1,33,47,1697
78986,78986,3C11EF223CD10B38AE1580AC51B9D9F2,43731,1,10,9,34,47,1747
78987,78987,3C11EF223CD10B38AE1580AC51B9D9F2,10731,11,21,10,33,47,1697
78988,78988,E478E2D9BCF7A4F7B498F875A46F0A1D,42321,2,6,4,43,47,2197
78989,78989,E478E2D9BCF7A4F7B498F875A46F0A1D,42461,10,17,7,45,47,2297
78990,78990,E478E2D9BCF7A4F7B498F875A46F0A1D,43061,22,23,1,43,46,2196
78991,78991,4F3F717E93BC5AFE00C4421DCBF0AA01,42301,1,9,8,36,47,1847
78992,78992,4F3F717E93BC5AFE00C4421DCBF0AA01,11261,11,19,8,36,46,1846
78993,78993,4F3F717E93BC5AFE00C4421DCBF0AA01,42301,21,23,2,36,47,1847
79006,79006,9C35C609BEEB7023F559DA7824DEFA84,11061,0,13,13,29,48,1498
79007,79007,9C35C609BEEB7023F559DA7824DEFA84,10681,14,15,1,30,48,1548
79008,79008,9C35C609BEEB7023F559DA7824DEFA84,11061,18,23,5,29,48,1498
79009,79009,4FA7E2AF35091649A8D61648BF92F5C0,42581,0,8,8,38,48,1948
79010,79010,4FA7E2AF35091649A8D61648BF92F5C0,11271,8,10,2,37,48,1898
79011,79011,4FA7E2AF35091649A8D61648BF92F5C0,42581,12,14,2,38,48,1948
79012,79012,4FA7E2AF35091649A8D61648BF92F5C0,10471,14,22,8,37,48,1898
79018,79018,744AB7DADF8BF013AE569AC359219521,11541,0,2,2,35,49,1799
79019,79019,744AB7DADF8BF013AE569AC359219521,11211,2,3,1,34,49,1749
79020,79020,744AB7DADF8BF013AE569AC359219521,11541,4,23,19,35,49,1799
79026,79026,CA4C02B9DB2D587FF148E8FB8B133305,10691,0,6,6,33,48,1698
79027,79027,CA4C02B9DB2D587FF148E8FB8B133305,11861,7,9,2,32,47,1647
79028,79028,CA4C02B9DB2D587FF148E8FB8B133305,43581,11,23,12,33,48,1698
79029,79029,DDD4A2411D3DDF8FF51DA78894EED629,12641,8,14,6,10,43,543
79030,79030,DDD4A2411D3DDF8FF51DA78894EED629,19114,14,17,3,7,43,393
79031,79031,DDD4A2411D3DDF8FF51DA78894EED629,19024,20,23,3,9,45,495
79035,79035,A6F4E0A14DDF72AB1602B3834CD2AC43,11914,0,4,4,37,48,1898
79036,79036,A6F4E0A14DDF72AB1602B3834CD2AC43,43361,5,9,4,38,48,1948
79037,79037,A6F4E0A14DDF72AB1602B3834CD2AC43,11914,12,20,8,37,48,1898
79038,79038,E9A3CD274E59D02E58C670C705BBAC42,42554,9,10,1,14,46,746
79039,79039,E9A3CD274E59D02E58C670C705BBAC42,11571,12,13,1,13,46,696
79040,79040,E9A3CD274E59D02E58C670C705BBAC42,42554,13,22,9,14,46,746
79051,79051,C54B7E894D1C5CD6E84B2182058F9208,42861,4,11,7,37,44,1894
79052,79052,C54B7E894D1C5CD6E84B2182058F9208,11261,13,14,1,36,46,1846
79053,79053,C54B7E894D1C5CD6E84B2182058F9208,42864,14,18,4,38,44,1944
79054,79054,C54B7E894D1C5CD6E84B2182058F9208,11261,20,21,1,36,46,1846
79055,79055,09E76C7E5F88F1AE9CA216C706232DAD,43761,2,7,5,32,47,1647
79056,79056,09E76C7E5F88F1AE9CA216C706232DAD,42523,8,14,6,31,47,1597
79057,79057,09E76C7E5F88F1AE9CA216C706232DAD,43761,17,22,5,32,47,1647
79061,79061,E28F4E9B3D6A2BC652897C2753B36E40,43311,0,7,7,31,48,1598
79062,79062,E28F4E9B3D6A2BC652897C2753B36E40,11061,12,13,1,29,48,1498
79063,79063,E28F4E9B3D6A2BC652897C2753B36E40,43311,16,18,2,31,48,1598
79068,79068,6216680D34B847E8ACE55A753AFFFE0C,10221,6,7,1,34,49,1749
79069,79069,6216680D34B847E8ACE55A753AFFFE0C,40951,8,17,9,36,49,1849
79070,79070,6216680D34B847E8ACE55A753AFFFE0C,10221,18,23,5,34,49,1749
79079,79079,03479A2941B5E0E5EB1A800C1A0028B8,11921,3,16,13,38,48,1948
79080,79080,03479A2941B5E0E5EB1A800C1A0028B8,10971,18,19,1,35,47,1797
79081,79081,03479A2941B5E0E5EB1A800C1A0028B8,11921,20,22,2,38,48,1948
79082,79082,723595B0078E82B6D42E3B2563991C87,42481,1,10,9,22,49,1149
79083,79083,723595B0078E82B6D42E3B2563991C87,42081,10,12,2,24,49,1249
79084,79084,723595B0078E82B6D42E3B2563991C87,11641,14,21,7,22,49,1149
79089,79089,3B0409DBAF33EAE6E983CBE096017943,11551,1,6,5,39,49,1999
79090,79090,3B0409DBAF33EAE6E983CBE096017943,10107,7,8,1,38,49,1949
79091,79091,3B0409DBAF33EAE6E983CBE096017943,10841,8,15,7,37,47,1897
79092,79092,3B0409DBAF33EAE6E983CBE096017943,11811,19,23,4,38,49,1949
79093,79093,F918E466A782C1E37D4CAE1EA64CE5CD,40051,0,9,9,32,49,1649
79094,79094,F918E466A782C1E37D4CAE1EA64CE5CD,10731,10,16,6,33,47,1697
79095,79095,F918E466A782C1E37D4CAE1EA64CE5CD,42961,18,23,5,35,49,1799
79101,79101,5286A29EF2DEDE42572B77FE3AFBCCAE,10161,0,10,10,35,49,1799
79102,79102,5286A29EF2DEDE42572B77FE3AFBCCAE,10221,12,13,1,34,49,1749
79103,79103,5286A29EF2DEDE42572B77FE3AFBCCAE,11541,15,21,6,35,49,1799
79104,79104,143002FC456C7213B10C89BDF8D4EC4A,12521,1,2,1,35,41,1791
79105,79105,143002FC456C7213B10C89BDF8D4EC4A,43451,2,5,3,37,40,1890
79106,79106,143002FC456C7213B10C89BDF8D4EC4A,12521,6,21,15,35,41,1791
79107,79107,2189EC8E24AECFC66AA25EB7EE05839E,11841,0,8,8,33,46,1696
79108,79108,2189EC8E24AECFC66AA25EB7EE05839E,10292,9,10,1,30,47,1547
79109,79109,2189EC8E24AECFC66AA25EB7EE05839E,10341,14,22,8,31,47,1597
79110,79110,DC7FAF072C0466482465CF89FB10D518,10901,0,12,12,35,48,1798
79111,79111,DC7FAF072C0466482465CF89FB10D518,12083,12,14,2,36,49,1849
79112,79112,DC7FAF072C0466482465CF89FB10D518,11751,14,16,2,35,48,1798
79113,79113,DC7FAF072C0466482465CF89FB10D518,40951,17,23,6,36,49,1849
79114,79114,B0CA59461CE535DA6C80DC6682EBEAFB,42271,0,9,9,40,47,2047
79115,79115,B0CA59461CE535DA6C80DC6682EBEAFB,11074,9,11,2,37,47,1897
79116,79116,B0CA59461CE535DA6C80DC6682EBEAFB,42271,16,18,2,40,47,2047
79117,79117,D4DD28DEB8C1EAB5E8CB11DCF963516A,10721,0,5,5,31,48,1598
79118,79118,D4DD28DEB8C1EAB5E8CB11DCF963516A,11861,6,8,2,32,47,1647
79119,79119,D4DD28DEB8C1EAB5E8CB11DCF963516A,10721,11,23,12,31,48,1598
79125,79125,26C2211A4521D64E1BD740DC9B2C895F,12511,0,8,8,39,47,1997
79126,79126,26C2211A4521D64E1BD740DC9B2C895F,13121,11,17,6,38,46,1946
79127,79127,26C2211A4521D64E1BD740DC9B2C895F,10601,20,23,3,39,47,1997
79133,79133,10530AA3545BA3AAA2634E512B3F731F,11261,0,2,2,36,46,1846
79134,79134,10530AA3545BA3AAA2634E512B3F731F,42864,7,17,10,38,44,1944
79135,79135,10530AA3545BA3AAA2634E512B3F731F,11261,18,20,2,36,46,1846
79136,79136,FEB10E9619CCB09DA2455DDE3043904C,41612,0,8,8,36,47,1847
79137,79137,FEB10E9619CCB09DA2455DDE3043904C,10161,8,17,9,35,49,1799
79138,79138,FEB10E9619CCB09DA2455DDE3043904C,12083,19,21,2,36,49,1849
79139,79139,F265ED4C1541833AE822CCDB15828D39,11901,0,11,11,42,49,2149
79140,79140,F265ED4C1541833AE822CCDB15828D39,43341,18,20,2,41,46,2096
79141,79141,F265ED4C1541833AE822CCDB15828D39,11481,20,21,1,41,48,2098
79142,79142,F265ED4C1541833AE822CCDB15828D39,42931,22,23,1,41,49,2099
79146,79146,63A1194DA67A916294F825B4249AD293,42351,1,3,2,38,45,1945
79147,79147,63A1194DA67A916294F825B4249AD293,42161,6,8,2,36,47,1847
79148,79148,63A1194DA67A916294F825B4249AD293,11261,10,17,7,36,46,1846
79149,79149,63A1194DA67A916294F825B4249AD293,42161,21,22,1,36,47,1847
79150,79150,CE46A02CA196948C3D07DA5CEEB7BE83,43101,0,5,5,46,40,2340
79151,79151,CE46A02CA196948C3D07DA5CEEB7BE83,13551,10,11,1,45,38,2288
79152,79152,CE46A02CA196948C3D07DA5CEEB7BE83,43101,12,18,6,46,40,2340
79153,79153,CE46A02CA196948C3D07DA5CEEB7BE83,13551,20,23,3,45,38,2288
79158,79158,AA541C733BB5F99408992FE5EC11F72D,13231,3,4,1,39,46,1996
79159,79159,AA541C733BB5F99408992FE5EC11F72D,42861,6,20,14,37,44,1894
79160,79160,AA541C733BB5F99408992FE5EC11F72D,11261,20,22,2,36,46,1846
79171,79171,E9B5EB38ABAD5346AF228CDEC81E2CE5,13791,0,14,14,42,47,2147
79172,79172,E9B5EB38ABAD5346AF228CDEC81E2CE5,43041,14,17,3,41,46,2096
79173,79173,E9B5EB38ABAD5346AF228CDEC81E2CE5,13791,19,21,2,42,47,2147
79174,79174,2B75D649D733D42AAC85CA634BF0D07B,11914,0,2,2,37,48,1898
79175,79175,2B75D649D733D42AAC85CA634BF0D07B,42581,2,13,11,38,48,1948
79176,79176,2B75D649D733D42AAC85CA634BF0D07B,11914,14,21,7,37,48,1898
79177,79177,249945D8BC225A84B9C0C3C523B07C14,42381,0,14,14,39,41,1991
79178,79178,249945D8BC225A84B9C0C3C523B07C14,43451,16,19,3,37,40,1890
79179,79179,249945D8BC225A84B9C0C3C523B07C14,42381,20,21,1,39,41,1991
79191,79191,F3D69D17D900427D0A05FF399134E46B,10381,0,6,6,31,49,1599
79192,79192,F3D69D17D900427D0A05FF399134E46B,11151,10,15,5,30,48,1548
79193,79193,F3D69D17D900427D0A05FF399134E46B,10381,15,23,8,31,49,1599
79198,79198,9E8454E3BE651FEBAAD2CFCFB76D7A82,42921,0,6,6,33,47,1697
79199,79199,9E8454E3BE651FEBAAD2CFCFB76D7A82,10221,8,10,2,34,49,1749
79200,79200,9E8454E3BE651FEBAAD2CFCFB76D7A82,11381,14,20,6,30,47,1547
79222,79222,5ED8949BAC5CDF05EDA1019FB7CA4B17,42401,0,14,14,36,47,1847
79223,79223,5ED8949BAC5CDF05EDA1019FB7CA4B17,10471,15,17,2,37,48,1898
79224,79224,5ED8949BAC5CDF05EDA1019FB7CA4B17,42301,20,23,3,36,47,1847
79225,79225,DD4D28FDBCFFE930AF28BD3956ED9308,11381,0,15,15,30,47,1547
79226,79226,DD4D28FDBCFFE930AF28BD3956ED9308,40381,17,19,2,32,46,1646
79227,79227,DD4D28FDBCFFE930AF28BD3956ED9308,11381,20,23,3,30,47,1547
79228,79228,41E2B2E2DEBDD2750C041DC3DB0DEE63,11331,0,8,8,37,48,1898
79229,79229,41E2B2E2DEBDD2750C041DC3DB0DEE63,11261,11,15,4,36,46,1846
79230,79230,41E2B2E2DEBDD2750C041DC3DB0DEE63,11914,20,21,1,37,48,1898
79231,79231,9BCD563089A1D0EF43A278605DE25081,42231,10,11,1,37,46,1896
79232,79232,9BCD563089A1D0EF43A278605DE25081,13911,13,18,5,39,46,1996
79233,79233,9BCD563089A1D0EF43A278605DE25081,42231,19,20,1,37,46,1896
79247,79247,CB95C15CFBE97DE3F69AA5EC564746C5,11281,0,1,1,27,40,1390
79248,79248,CB95C15CFBE97DE3F69AA5EC564746C5,13671,2,8,6,27,43,1393
79249,79249,CB95C15CFBE97DE3F69AA5EC564746C5,11281,12,19,7,27,40,1390
79250,79250,CB95C15CFBE97DE3F69AA5EC564746C5,13671,19,23,4,27,43,1393
79251,79251,57C74C8B353B2CFDA7D2B19E80500EFE,42221,9,10,1,38,48,1948
79252,79252,57C74C8B353B2CFDA7D2B19E80500EFE,11074,10,11,1,37,47,1897
79253,79253,57C74C8B353B2CFDA7D2B19E80500EFE,11331,14,23,9,37,48,1898
79260,79260,3CBEA125CF27D9127C46F5AF60732774,12571,0,8,8,48,39,2439
79261,79261,3CBEA125CF27D9127C46F5AF60732774,43101,9,20,11,46,40,2340
79262,79262,3CBEA125CF27D9127C46F5AF60732774,12571,20,22,2,48,39,2439
79263,79263,55536669E97AF41ACDE427113BB85731,10691,0,6,6,33,48,1698
79264,79264,55536669E97AF41ACDE427113BB85731,11861,9,10,1,32,47,1647
79265,79265,55536669E97AF41ACDE427113BB85731,10491,12,22,10,33,48,1698
79271,79271,B304D2AD98C7DE24CAE6DD0DA65095F0,10431,0,7,7,33,49,1699
79272,79272,B304D2AD98C7DE24CAE6DD0DA65095F0,43581,7,17,10,33,48,1698
79273,79273,B304D2AD98C7DE24CAE6DD0DA65095F0,10431,20,23,3,33,49,1699
79274,79274,4B2C5F1CB416544E575393F8DC112063,10281,0,8,8,33,48,1698
79275,79275,4B2C5F1CB416544E575393F8DC112063,11861,11,12,1,32,47,1647
79276,79276,4B2C5F1CB416544E575393F8DC112063,10281,13,23,10,33,48,1698
79277,79277,2EB3873FC04DE2FE7DCCB48F35926C6A,11021,0,7,7,36,49,1849
79278,79278,2EB3873FC04DE2FE7DCCB48F35926C6A,10107,11,15,4,38,49,1949
79279,79279,2EB3873FC04DE2FE7DCCB48F35926C6A,11021,21,23,2,36,49,1849
79285,79285,D65506EDDA59637632B53755416666C4,11914,0,14,14,37,48,1898
79286,79286,D65506EDDA59637632B53755416666C4,40171,14,15,1,38,48,1948
79287,79287,D65506EDDA59637632B53755416666C4,10471,16,19,3,37,48,1898
79288,79288,D65506EDDA59637632B53755416666C4,43181,20,22,2,39,48,1998
79292,79292,34FB5BF239A7B5016E3CA81F47968839,40961,0,12,12,35,47,1797
79293,79293,34FB5BF239A7B5016E3CA81F47968839,42161,14,15,1,36,47,1847
79294,79294,34FB5BF239A7B5016E3CA81F47968839,10251,18,20,2,35,47,1797
79304,79304,35DE934E09014E3A56964C528E95BB57,12121,1,8,7,29,47,1497
79305,79305,35DE934E09014E3A56964C528E95BB57,10731,11,13,2,33,47,1697
79306,79306,35DE934E09014E3A56964C528E95BB57,10951,14,15,1,29,48,1498
79307,79307,35DE934E09014E3A56964C528E95BB57,10731,17,19,2,33,47,1697
79308,79308,EF7FF0709933B50F4D00C87C477FCE93,43061,1,7,6,43,46,2196
79309,79309,EF7FF0709933B50F4D00C87C477FCE93,42271,9,16,7,40,47,2047
79310,79310,EF7FF0709933B50F4D00C87C477FCE93,11481,18,20,2,41,48,2098
79314,79314,835E4AB3BB8C4699720E70AB108BA996,42041,0,5,5,10,47,547
79315,79315,835E4AB3BB8C4699720E70AB108BA996,11851,6,10,4,13,47,697
79316,79316,835E4AB3BB8C4699720E70AB108BA996,42041,12,21,9,10,47,547
79317,79317,78122A81E97D9EFDD9D4C947A91615B6,40302,0,9,9,40,49,2049
79318,79318,78122A81E97D9EFDD9D4C947A91615B6,11551,12,15,3,39,49,1999
79319,79319,78122A81E97D9EFDD9D4C947A91615B6,40302,18,23,5,40,49,2049
79327,79327,E2D81C206764E3951071FC322019D398,12131,0,10,10,32,47,1647
79328,79328,E2D81C206764E3951071FC322019D398,11751,14,15,1,35,48,1798
79329,79329,E2D81C206764E3951071FC322019D398,12131,18,19,1,32,47,1647
79330,79330,70DFAD9CC535457B59206F2CD88E5D55,13711,0,12,12,38,46,1946
79331,79331,70DFAD9CC535457B59206F2CD88E5D55,10271,13,14,1,37,46,1896
79332,79332,70DFAD9CC535457B59206F2CD88E5D55,13121,14,18,4,38,46,1946
79340,79340,C55CD64DDAAD2837D1AA866EF86E4FF4,42861,0,11,11,37,44,1894
79341,79341,C55CD64DDAAD2837D1AA866EF86E4FF4,11261,13,17,4,36,46,1846
79342,79342,C55CD64DDAAD2837D1AA866EF86E4FF4,42861,20,22,2,37,44,1894
79347,79347,C7B7BC9315B26F0822B647A376C0B876,11591,0,6,6,36,49,1849
79348,79348,C7B7BC9315B26F0822B647A376C0B876,11531,6,8,2,34,49,1749
79349,79349,C7B7BC9315B26F0822B647A376C0B876,43321,8,23,15,36,49,1849
79353,79353,A8C8F80025B85535EF17FF46CAF9BC48,12661,0,6,6,32,45,1645
79354,79354,A8C8F80025B85535EF17FF46CAF9BC48,12311,8,9,1,30,44,1544
79355,79355,A8C8F80025B85535EF17FF46CAF9BC48,12661,9,23,14,32,45,1645
79356,79356,2FC430E1448F290A8E229F5C2301E320,49201,1,7,6,7,41,391
79357,79357,2FC430E1448F290A8E229F5C2301E320,12921,8,16,8,9,41,491
79358,79358,2FC430E1448F290A8E229F5C2301E320,49201,20,23,3,7,41,391
79359,79359,F7F6E311089E545E2ADE21E1CFF4D206,42523,3,9,6,31,47,1597
79360,79360,F7F6E311089E545E2ADE21E1CFF4D206,43761,10,17,7,32,47,1647
79361,79361,F7F6E311089E545E2ADE21E1CFF4D206,42523,17,19,2,31,47,1597
79362,79362,F7F6E311089E545E2ADE21E1CFF4D206,43761,19,23,4,32,47,1647
79378,79378,0DFD98C5BF618352145AEF64606DF221,40673,1,17,16,36,48,1848
79379,79379,0DFD98C5BF618352145AEF64606DF221,42161,18,20,2,36,47,1847
79380,79380,0DFD98C5BF618352145AEF64606DF221,10251,21,23,2,35,47,1797
79388,79388,88D3AECB79C42D19C5311DB0C1B36772,10271,0,7,7,37,46,1896
79389,79389,88D3AECB79C42D19C5311DB0C1B36772,42301,12,13,1,36,47,1847
79390,79390,88D3AECB79C42D19C5311DB0C1B36772,10271,18,21,3,37,46,1896
79398,79398,EED10CB844C83DEAB3F20FBC910D00CC,11541,0,12,12,35,49,1799
79399,79399,EED10CB844C83DEAB3F20FBC910D00CC,11021,14,16,2,36,49,1849
79400,79400,EED10CB844C83DEAB3F20FBC910D00CC,11541,20,23,3,35,49,1799
79401,79401,30C49EE7A31FEEE7EEC894E81C72E143,40673,10,11,1,36,48,1848
79402,79402,30C49EE7A31FEEE7EEC894E81C72E143,11911,14,21,7,37,48,1898
79403,79403,30C49EE7A31FEEE7EEC894E81C72E143,42581,21,23,2,38,48,1948
79404,79404,2937B23EEDB796179FFFF39113F778F2,42221,0,15,15,38,48,1948
79405,79405,2937B23EEDB796179FFFF39113F778F2,11794,16,17,1,38,49,1949
79406,79406,2937B23EEDB796179FFFF39113F778F2,42221,18,23,5,38,48,1948
79433,79433,E6AC57452A564977FA8F4CD52CD9B295,10281,0,7,7,33,48,1698
79434,79434,E6AC57452A564977FA8F4CD52CD9B295,11201,11,15,4,35,49,1799
79435,79435,E6AC57452A564977FA8F4CD52CD9B295,10281,17,22,5,33,48,1698
79436,79436,E6AC57452A564977FA8F4CD52CD9B295,11861,22,23,1,32,47,1647
79455,79455,66C0548F02598D44AE0CA78CDFFA7E48,10401,0,7,7,33,49,1699
79456,79456,66C0548F02598D44AE0CA78CDFFA7E48,11954,10,11,1,32,49,1649
79457,79457,66C0548F02598D44AE0CA78CDFFA7E48,10401,13,23,10,33,49,1699
79458,79458,63F0032DC427373C2FAEC549A8871599,13121,0,3,3,38,46,1946
79459,79459,63F0032DC427373C2FAEC549A8871599,42301,4,7,3,36,47,1847
79460,79460,63F0032DC427373C2FAEC549A8871599,13121,7,23,16,38,46,1946
79486,79486,D75839547F19BC6AA2555211CD306BBE,12514,0,12,12,38,47,1947
79487,79487,D75839547F19BC6AA2555211CD306BBE,42221,13,15,2,38,48,1948
79488,79488,D75839547F19BC6AA2555211CD306BBE,12514,17,23,6,38,47,1947
79489,79489,3ECDD76BC9EC36358981E2398D1B2692,43361,0,14,14,38,48,1948
79490,79490,3ECDD76BC9EC36358981E2398D1B2692,11914,14,15,1,37,48,1898
79491,79491,3ECDD76BC9EC36358981E2398D1B2692,43361,18,23,5,38,48,1948
79507,79507,B6E06BECFD200E305BD11D4E181199C8,11951,0,13,13,31,49,1599
79508,79508,B6E06BECFD200E305BD11D4E181199C8,10401,15,20,5,33,49,1699
79509,79509,B6E06BECFD200E305BD11D4E181199C8,11951,21,23,2,31,49,1599
79510,79510,2F1F7798F5E8889B4080CA59D71F0274,10271,6,12,6,37,46,1896
79511,79511,2F1F7798F5E8889B4080CA59D71F0274,11074,13,14,1,37,47,1897
79512,79512,2F1F7798F5E8889B4080CA59D71F0274,10271,15,23,8,37,46,1896
79523,79523,57B328CB2D89A1ADE1479C7CF9C033FB,10971,3,8,5,35,47,1797
79524,79524,57B328CB2D89A1ADE1479C7CF9C033FB,41081,9,12,3,36,49,1849
79525,79525,57B328CB2D89A1ADE1479C7CF9C033FB,43731,17,18,1,34,47,1747
79526,79526,4A1082E29116D07A4EA830C32D0BE5ED,12221,0,5,5,43,44,2194
79527,79527,4A1082E29116D07A4EA830C32D0BE5ED,13341,8,10,2,44,45,2245
79528,79528,4A1082E29116D07A4EA830C32D0BE5ED,12221,13,23,10,43,44,2194
79529,79529,2FE0F5D48F87D070533B94BE264A31A0,10111,2,12,10,37,47,1897
79530,79530,2FE0F5D48F87D070533B94BE264A31A0,42301,13,14,1,36,47,1847
79531,79531,2FE0F5D48F87D070533B94BE264A31A0,10111,18,20,2,37,47,1897
79543,79543,494C8AB69E296E45610A6593BDB7E6F5,11231,0,14,14,37,49,1899
79544,79544,494C8AB69E296E45610A6593BDB7E6F5,12083,16,17,1,36,49,1849
79545,79545,494C8AB69E296E45610A6593BDB7E6F5,11231,20,23,3,37,49,1899
79561,79561,C994B0BB00A5F5442EEA247C000D74C5,42531,0,13,13,31,45,1595
79562,79562,C994B0BB00A5F5442EEA247C000D74C5,12311,13,15,2,30,44,1544
79563,79563,C994B0BB00A5F5442EEA247C000D74C5,42531,16,23,7,31,45,1595
79564,79564,AEA05D79C334BD115A25E3762D31015E,10251,0,8,8,35,47,1797
79565,79565,AEA05D79C334BD115A25E3762D31015E,11074,12,13,1,37,47,1897
79566,79566,AEA05D79C334BD115A25E3762D31015E,10251,16,19,3,35,47,1797
79574,79574,33DCEB99733F5490EC3E4641096F98E9,13491,0,13,13,48,39,2439
79575,79575,33DCEB99733F5490EC3E4641096F98E9,43101,13,15,2,46,40,2340
79576,79576,33DCEB99733F5490EC3E4641096F98E9,13491,15,21,6,48,39,2439
79577,79577,D9026A3CE10A3841EFEE0C49DAE389C6,12641,0,5,5,10,43,543
79578,79578,D9026A3CE10A3841EFEE0C49DAE389C6,19114,6,19,13,7,43,393
79579,79579,D9026A3CE10A3841EFEE0C49DAE389C6,12641,19,20,1,10,43,543
79580,79580,692AC6DE13BF1FE0F43D1EA4E139D774,10841,0,8,8,37,47,1897
79581,79581,692AC6DE13BF1FE0F43D1EA4E139D774,13331,12,14,2,38,47,1947
79582,79582,692AC6DE13BF1FE0F43D1EA4E139D774,10841,18,20,2,37,47,1897
79583,79583,692AC6DE13BF1FE0F43D1EA4E139D774,13331,20,22,2,38,47,1947
79593,79593,80CE272820836DB5E94265F1766FEAE8,11271,0,13,13,37,48,1898
79594,79594,80CE272820836DB5E94265F1766FEAE8,11811,15,16,1,38,49,1949
79595,79595,80CE272820836DB5E94265F1766FEAE8,11271,21,22,1,37,48,1898
79596,79596,974F76AAA3E21167ABAC6BE6648ADEC3,11921,0,11,11,38,48,1948
79597,79597,974F76AAA3E21167ABAC6BE6648ADEC3,10411,13,15,2,36,48,1848
79598,79598,974F76AAA3E21167ABAC6BE6648ADEC3,40833,15,22,7,41,47,2097
79618,79618,FDEB991F197D09BEFBCB8EC007D54430,11551,0,9,9,39,49,1999
79619,79619,FDEB991F197D09BEFBCB8EC007D54430,11291,11,13,2,40,49,2049
79620,79620,FDEB991F197D09BEFBCB8EC007D54430,42511,18,19,1,37,47,1897
79621,79621,FDEB991F197D09BEFBCB8EC007D54430,11291,21,23,2,40,49,2049
79642,79642,CB569F11653BED8355DBB1B17AC5F222,42191,0,7,7,38,49,1949
79643,79643,CB569F11653BED8355DBB1B17AC5F222,11551,10,13,3,39,49,1999
79644,79644,CB569F11653BED8355DBB1B17AC5F222,10471,14,22,8,37,48,1898
79655,79655,4A1C48EA4BC7C62C111DD9BE1B1E2874,11061,0,6,6,29,48,1498
79656,79656,4A1C48EA4BC7C62C111DD9BE1B1E2874,40201,10,11,1,32,49,1649
79657,79657,4A1C48EA4BC7C62C111DD9BE1B1E2874,43971,13,15,2,30,48,1548
79658,79658,4A1C48EA4BC7C62C111DD9BE1B1E2874,11061,17,18,1,29,48,1498
79674,79674,C6869A64CA9EF97A25D7192A00726FC2,42401,0,9,9,36,47,1847
79675,79675,C6869A64CA9EF97A25D7192A00726FC2,10781,10,19,9,35,47,1797
79676,79676,C6869A64CA9EF97A25D7192A00726FC2,42161,20,23,3,36,47,1847
79677,79677,57068447BEEE4D7969FF166D57966ECA,42541,0,6,6,25,47,1297
79678,79678,57068447BEEE4D7969FF166D57966ECA,11361,6,15,9,22,48,1148
79679,79679,57068447BEEE4D7969FF166D57966ECA,12581,15,17,2,24,48,1248
79680,79680,57068447BEEE4D7969FF166D57966ECA,42541,21,23,2,25,47,1297
79685,79685,1EB1C74741BE7C0B5E86F19E48D30409,12311,2,9,7,30,44,1544
79686,79686,1EB1C74741BE7C0B5E86F19E48D30409,42531,11,18,7,31,45,1595
79687,79687,1EB1C74741BE7C0B5E86F19E48D30409,12311,20,21,1,30,44,1544
79696,79696,8558AA8212D739A0305B1C324522865B,11861,0,10,10,32,47,1647
79697,79697,8558AA8212D739A0305B1C324522865B,11381,14,17,3,30,47,1547
79698,79698,8558AA8212D739A0305B1C324522865B,11861,17,19,2,32,47,1647
79703,79703,D8963F7C81A647B0DB7A8BBF70036A0B,12514,1,6,5,38,47,1947
79704,79704,D8963F7C81A647B0DB7A8BBF70036A0B,10471,8,17,9,37,48,1898
79705,79705,D8963F7C81A647B0DB7A8BBF70036A0B,13331,20,23,3,38,47,1947
79706,79706,7561007C44C9B9B43A5E78AE0FF299F7,13341,0,7,7,44,45,2245
79707,79707,7561007C44C9B9B43A5E78AE0FF299F7,42201,9,11,2,43,46,2196
79708,79708,7561007C44C9B9B43A5E78AE0FF299F7,13341,16,18,2,44,45,2245
79709,79709,E311A49FD79CE1E67702DBA9B7887B92,12641,0,4,4,10,43,543
79710,79710,E311A49FD79CE1E67702DBA9B7887B92,19021,6,11,5,10,45,545
79711,79711,E311A49FD79CE1E67702DBA9B7887B92,12641,11,12,1,10,43,543
79712,79712,E311A49FD79CE1E67702DBA9B7887B92,19021,14,18,4,10,45,545
79719,79719,A25A833341BE3939DF5ACF6F00A1B542,10621,0,5,5,41,49,2099
79720,79720,A25A833341BE3939DF5ACF6F00A1B542,11741,6,7,1,42,49,2149
79721,79721,A25A833341BE3939DF5ACF6F00A1B542,10621,20,22,2,41,49,2099
79722,79722,55533B9612A041F560AB09E0A0C2A735,10251,0,8,8,35,47,1797
79723,79723,55533B9612A041F560AB09E0A0C2A735,43731,9,11,2,34,47,1747
79724,79724,55533B9612A041F560AB09E0A0C2A735,10251,13,23,10,35,47,1797
79729,79729,F725A3F859B25741A70E1B3AC0517A8A,10111,1,10,9,37,47,1897
79730,79730,F725A3F859B25741A70E1B3AC0517A8A,42301,12,13,1,36,47,1847
79731,79731,F725A3F859B25741A70E1B3AC0517A8A,10111,14,16,2,37,47,1897
79732,79732,F725A3F859B25741A70E1B3AC0517A8A,42301,17,19,2,36,47,1847
79739,79739,FC53708685C9A67B506C6CE674C91833,10821,1,7,6,40,47,2047
79740,79740,FC53708685C9A67B506C6CE674C91833,10041,18,21,3,39,49,1999
79741,79741,FC53708685C9A67B506C6CE674C91833,10771,22,23,1,41,46,2096
79747,79747,3EC01984A48FD14AA36045D09BE5811E,13711,0,9,9,38,46,1946
79748,79748,3EC01984A48FD14AA36045D09BE5811E,42231,10,17,7,37,46,1896
79749,79749,3EC01984A48FD14AA36045D09BE5811E,13711,21,23,2,38,46,1946
79753,79753,07371D92249265FE55F9673D8539D18E,42301,0,16,16,36,47,1847
79754,79754,07371D92249265FE55F9673D8539D18E,43731,18,19,1,34,47,1747
79755,79755,07371D92249265FE55F9673D8539D18E,42301,20,23,3,36,47,1847
79756,79756,16C2E43A00B37B1C1161B5674AF5103F,11151,0,14,14,30,48,1548
79757,79757,16C2E43A00B37B1C1161B5674AF5103F,42831,17,19,2,27,48,1398
79758,79758,16C2E43A00B37B1C1161B5674AF5103F,11151,21,23,2,30,48,1548
79762,79762,1F37C13C52F34E6056520CCE105A28F8,13121,3,4,1,38,46,1946
79763,79763,1F37C13C52F34E6056520CCE105A28F8,10271,9,18,9,37,46,1896
79764,79764,1F37C13C52F34E6056520CCE105A28F8,10841,21,22,1,37,47,1897
79772,79772,20538B8C1777892DA77867D1D04B5D49,43761,0,2,2,32,47,1647
79773,79773,20538B8C1777892DA77867D1D04B5D49,11161,3,8,5,32,48,1648
79774,79774,20538B8C1777892DA77867D1D04B5D49,43761,9,23,14,32,47,1647
79775,79775,6D62BE8B751688E1124EF442CD693D0D,12641,1,6,5,10,43,543
79776,79776,6D62BE8B751688E1124EF442CD693D0D,19021,7,9,2,10,45,545
79777,79777,6D62BE8B751688E1124EF442CD693D0D,12641,12,23,11,10,43,543
79800,79800,B330B6F87FA34F7466DC67C7BC5F8853,11914,1,8,7,37,48,1898
79801,79801,B330B6F87FA34F7466DC67C7BC5F8853,10841,12,13,1,37,47,1897
79802,79802,B330B6F87FA34F7466DC67C7BC5F8853,11921,17,22,5,38,48,1948
79818,79818,8E1B59B1D093F12DCE92DD7FCED5EC72,42511,1,6,5,37,47,1897
79819,79819,8E1B59B1D093F12DCE92DD7FCED5EC72,13331,9,10,1,38,47,1947
79820,79820,8E1B59B1D093F12DCE92DD7FCED5EC72,42511,13,20,7,37,47,1897
79821,79821,88182B8F0A08A7B6CD3790FE87C79F47,42351,0,3,3,38,45,1945
79822,79822,88182B8F0A08A7B6CD3790FE87C79F47,42231,5,6,1,37,46,1896
79823,79823,88182B8F0A08A7B6CD3790FE87C79F47,42351,6,13,7,38,45,1945
79824,79824,88182B8F0A08A7B6CD3790FE87C79F47,42231,15,22,7,37,46,1896
79825,79825,5C2B763013F3453FD43407A455CBD2B2,13651,0,16,16,30,47,1547
79826,79826,5C2B763013F3453FD43407A455CBD2B2,42523,17,18,1,31,47,1597
79827,79827,5C2B763013F3453FD43407A455CBD2B2,13651,18,19,1,30,47,1547
79828,79828,5C2B763013F3453FD43407A455CBD2B2,42523,20,21,1,31,47,1597
79844,79844,0B01795734CA986B36F023360E2D7588,42961,0,8,8,35,49,1799
79845,79845,0B01795734CA986B36F023360E2D7588,11231,8,20,12,37,49,1899
79846,79846,0B01795734CA986B36F023360E2D7588,12083,20,21,1,36,49,1849
79847,79847,0B01795734CA986B36F023360E2D7588,11231,21,22,1,37,49,1899
79861,79861,F25BE183CA9EE48D61C03B85D10E9DF5,42921,3,14,11,33,47,1697
79862,79862,F25BE183CA9EE48D61C03B85D10E9DF5,11351,16,17,1,36,48,1848
79863,79863,F25BE183CA9EE48D61C03B85D10E9DF5,42021,18,20,2,33,47,1697
79870,79870,CE29EB37C112E7F535813A697DFC251A,43751,0,6,6,19,48,998
79871,79871,CE29EB37C112E7F535813A697DFC251A,11361,7,8,1,22,48,1148
79872,79872,CE29EB37C112E7F535813A697DFC251A,43751,11,23,12,19,48,998
79878,79878,7FAF74A680E5BB19478DB9AF96C6BAA5,13111,10,11,1,42,46,2146
79879,79879,7FAF74A680E5BB19478DB9AF96C6BAA5,42204,12,14,2,43,46,2196
79880,79880,7FAF74A680E5BB19478DB9AF96C6BAA5,13111,15,23,8,42,46,2146
79913,79913,3717CE6F5FBC18B9A1CE5DBD5E4997A5,11061,0,17,17,29,48,1498
79914,79914,3717CE6F5FBC18B9A1CE5DBD5E4997A5,42521,19,21,2,31,47,1597
79915,79915,3717CE6F5FBC18B9A1CE5DBD5E4997A5,11061,21,23,2,29,48,1498
79916,79916,859846C23309918FCF7E37DF9FD45D9F,13911,2,7,5,39,46,1996
79917,79917,859846C23309918FCF7E37DF9FD45D9F,42351,7,10,3,38,45,1945
79918,79918,859846C23309918FCF7E37DF9FD45D9F,13911,13,17,4,39,46,1996
79919,79919,859846C23309918FCF7E37DF9FD45D9F,42231,17,23,6,37,46,1896
79940,79940,603663E8AC80D73ACE2881AEDB700F6A,13341,7,10,3,44,45,2245
79941,79941,603663E8AC80D73ACE2881AEDB700F6A,12141,11,13,2,42,45,2145
79942,79942,603663E8AC80D73ACE2881AEDB700F6A,12221,16,20,4,43,44,2194
79962,79962,B8AADB6FF102771D74EF7F7A32317AB0,10401,0,6,6,33,49,1699
79963,79963,B8AADB6FF102771D74EF7F7A32317AB0,11861,7,17,10,32,47,1647
79964,79964,B8AADB6FF102771D74EF7F7A32317AB0,10431,18,19,1,33,49,1699
79965,79965,B8AADB6FF102771D74EF7F7A32317AB0,11211,19,23,4,34,49,1749
79969,79969,CCF51F527C0699CB645C6D016C6FE2F5,42581,0,3,3,38,48,1948
79970,79970,CCF51F527C0699CB645C6D016C6FE2F5,10471,8,19,11,37,48,1898
79971,79971,CCF51F527C0699CB645C6D016C6FE2F5,42581,21,22,1,38,48,1948
79972,79972,18795395C853CBDF0640E06A471FA19D,11861,0,8,8,32,47,1647
79973,79973,18795395C853CBDF0640E06A471FA19D,42523,9,11,2,31,47,1597
79974,79974,18795395C853CBDF0640E06A471FA19D,11861,13,23,10,32,47,1647
79975,79975,4EE5C60035D807126AEE0DC0CD563832,42581,1,6,5,38,48,1948
79976,79976,4EE5C60035D807126AEE0DC0CD563832,11914,10,16,6,37,48,1898
79977,79977,4EE5C60035D807126AEE0DC0CD563832,42581,17,19,2,38,48,1948
79978,79978,4EE5C60035D807126AEE0DC0CD563832,11914,20,21,1,37,48,1898
79998,79998,2B978F14522F2408660E90AEA6143CDF,10381,2,4,2,31,49,1599
79999,79999,2B978F14522F2408660E90AEA6143CDF,10544,5,6,1,28,48,1448
80000,80000,2B978F14522F2408660E90AEA6143CDF,42071,8,21,13,31,49,1599
80001,80001,4FEDDE4724DDA61E19979F6B8E0B84B5,42511,0,6,6,37,47,1897
80002,80002,4FEDDE4724DDA61E19979F6B8E0B84B5,10271,8,18,10,37,46,1896
80003,80003,4FEDDE4724DDA61E19979F6B8E0B84B5,42511,19,22,3,37,47,1897
80015,80015,5E1BBAE6A1AB78C09E8201C8FF351A4E,13011,0,7,7,39,47,1997
80016,80016,5E1BBAE6A1AB78C09E8201C8FF351A4E,12514,8,18,10,38,47,1947
80017,80017,5E1BBAE6A1AB78C09E8201C8FF351A4E,10841,19,20,1,37,47,1897
80018,80018,FBEF0BF20C2F06C4C04CBD77FEB036E8,42461,0,7,7,45,47,2297
80019,80019,FBEF0BF20C2F06C4C04CBD77FEB036E8,42321,8,10,2,43,47,2197
80020,80020,FBEF0BF20C2F06C4C04CBD77FEB036E8,42461,12,20,8,45,47,2297
80021,80021,F12CF92D47DBBC28BDFFECBC31496C05,11061,0,15,15,29,48,1498
80022,80022,F12CF92D47DBBC28BDFFECBC31496C05,10681,15,16,1,30,48,1548
80023,80023,F12CF92D47DBBC28BDFFECBC31496C05,42521,18,20,2,31,47,1597
80024,80024,A15C0678EF39F4E1D2E8B3E08C176676,13911,1,4,3,39,46,1996
80025,80025,A15C0678EF39F4E1D2E8B3E08C176676,11261,6,12,6,36,46,1846
80026,80026,A15C0678EF39F4E1D2E8B3E08C176676,13911,13,19,6,39,46,1996
80039,80039,9ED06C73B88BB4839B692590DA94AEEC,42091,1,6,5,43,46,2196
80040,80040,9ED06C73B88BB4839B692590DA94AEEC,13791,9,11,2,42,47,2147
80041,80041,9ED06C73B88BB4839B692590DA94AEEC,13111,12,16,4,42,46,2146
80042,80042,9ED06C73B88BB4839B692590DA94AEEC,42091,21,23,2,43,46,2196
80051,80051,983842B60AEE8AF2D9A0F2BA47994634,11381,0,11,11,30,47,1547
80052,80052,983842B60AEE8AF2D9A0F2BA47994634,10951,11,16,5,29,48,1498
80053,80053,983842B60AEE8AF2D9A0F2BA47994634,11381,18,23,5,30,47,1547
80060,80060,AD235EE6A83CA7956AB86E8BC887D3C7,11541,1,6,5,35,49,1799
80061,80061,AD235EE6A83CA7956AB86E8BC887D3C7,11021,7,17,10,36,49,1849
80062,80062,AD235EE6A83CA7956AB86E8BC887D3C7,11541,19,23,4,35,49,1799
80073,80073,5C087BE097BD7C65E07DEF266C8D9DC9,43731,0,9,9,34,47,1747
80074,80074,5C087BE097BD7C65E07DEF266C8D9DC9,42161,10,11,1,36,47,1847
80075,80075,5C087BE097BD7C65E07DEF266C8D9DC9,43731,11,15,4,34,47,1747
80076,80076,5C087BE097BD7C65E07DEF266C8D9DC9,42161,16,18,2,36,47,1847
80098,80098,E4B5DAD5DBF929561D0AA11CCDF44627,10691,0,6,6,33,48,1698
80099,80099,E4B5DAD5DBF929561D0AA11CCDF44627,42491,7,8,1,32,46,1646
80100,80100,E4B5DAD5DBF929561D0AA11CCDF44627,10691,12,23,11,33,48,1698
80101,80101,F3EBB57DA3A54FEC2068629888C9AD19,42511,0,11,11,37,47,1897
80102,80102,F3EBB57DA3A54FEC2068629888C9AD19,11021,13,16,3,36,49,1849
80103,80103,F3EBB57DA3A54FEC2068629888C9AD19,11941,19,23,4,37,46,1896
80110,80110,FDF3A555382668B3FCFD730AFF8664D2,10411,0,7,7,36,48,1848
80111,80111,FDF3A555382668B3FCFD730AFF8664D2,11231,7,10,3,37,49,1899
80112,80112,FDF3A555382668B3FCFD730AFF8664D2,10471,10,18,8,37,48,1898
80113,80113,FDF3A555382668B3FCFD730AFF8664D2,10411,19,22,3,36,48,1848
80118,80118,A7B416305440E955A1FE8389FFDA2219,12651,0,15,15,43,47,2197
80119,80119,A7B416305440E955A1FE8389FFDA2219,11701,16,18,2,43,48,2198
80120,80120,A7B416305440E955A1FE8389FFDA2219,42321,21,23,2,43,47,2197
80129,80129,9398C8C66FCD9C9C571837501897C592,13651,0,12,12,30,47,1547
80130,80130,9398C8C66FCD9C9C571837501897C592,10951,15,16,1,29,48,1498
80131,80131,9398C8C66FCD9C9C571837501897C592,13651,17,20,3,30,47,1547
80132,80132,F587555054424F7ED0D63829AAEB0C06,11806,0,6,6,41,48,2098
80133,80133,F587555054424F7ED0D63829AAEB0C06,42271,8,12,4,40,47,2047
80134,80134,F587555054424F7ED0D63829AAEB0C06,11806,13,18,5,41,48,2098
80135,80135,F587555054424F7ED0D63829AAEB0C06,42271,22,23,1,40,47,2047
80136,80136,0E7262AB05FEE95538206F690BF1ED85,11381,1,8,7,30,47,1547
80137,80137,0E7262AB05FEE95538206F690BF1ED85,10951,9,16,7,29,48,1498
80138,80138,0E7262AB05FEE95538206F690BF1ED85,11381,17,20,3,30,47,1547
80139,80139,3577C85A730E9BA639A1091A13B08DEB,43761,1,12,11,32,47,1647
80140,80140,3577C85A730E9BA639A1091A13B08DEB,42523,15,17,2,31,47,1597
80141,80141,3577C85A730E9BA639A1091A13B08DEB,43761,19,20,1,32,47,1647
80147,80147,D366589B3E90DFE9BB97263FFFDAB40D,13911,0,7,7,39,46,1996
80148,80148,D366589B3E90DFE9BB97263FFFDAB40D,42231,7,10,3,37,46,1896
80149,80149,D366589B3E90DFE9BB97263FFFDAB40D,13911,12,22,10,39,46,1996
80155,80155,72B28316E77049B3B3D9EC9BDF710CF6,42523,0,13,13,31,47,1597
80156,80156,72B28316E77049B3B3D9EC9BDF710CF6,43761,13,16,3,32,47,1647
80157,80157,72B28316E77049B3B3D9EC9BDF710CF6,10341,17,19,2,31,47,1597
80158,80158,74C90A586CDE5D22B85B5C9D6662CF52,19114,0,6,6,7,43,393
80159,80159,74C90A586CDE5D22B85B5C9D6662CF52,12641,6,8,2,10,43,543
80160,80160,74C90A586CDE5D22B85B5C9D6662CF52,19114,12,22,10,7,43,393
80175,80175,1F6BCFEB56D245CBF5160F742055C8A2,43471,0,2,2,31,49,1599
80176,80176,1F6BCFEB56D245CBF5160F742055C8A2,11151,4,7,3,30,48,1548
80177,80177,1F6BCFEB56D245CBF5160F742055C8A2,11061,8,19,11,29,48,1498
80178,80178,50A8D48EEDC025C19A5AA5E39B3A8340,43761,0,16,16,32,47,1647
80179,80179,50A8D48EEDC025C19A5AA5E39B3A8340,43731,18,19,1,34,47,1747
80180,80180,50A8D48EEDC025C19A5AA5E39B3A8340,11861,20,23,3,32,47,1647
80191,80191,E7EC6E138D54F5092F2DB01DB4F64219,13111,1,19,18,42,46,2146
80192,80192,E7EC6E138D54F5092F2DB01DB4F64219,42201,21,22,1,43,46,2196
80193,80193,E7EC6E138D54F5092F2DB01DB4F64219,13111,22,23,1,42,46,2146
80194,80194,04C024AD6716C59AEF71765CE69E1D56,10781,0,14,14,35,47,1797
80195,80195,04C024AD6716C59AEF71765CE69E1D56,43731,15,16,1,34,47,1747
80196,80196,04C024AD6716C59AEF71765CE69E1D56,10781,18,23,5,35,47,1797
80222,80222,271B4D4F9BFB265367C27D7A696FE372,11381,0,10,10,30,47,1547
80223,80223,271B4D4F9BFB265367C27D7A696FE372,42291,11,14,3,29,48,1498
80224,80224,271B4D4F9BFB265367C27D7A696FE372,42021,18,23,5,33,47,1697
80225,80225,487C98C7DE328717BCF71305DD4C9248,42491,8,11,3,32,46,1646
80226,80226,487C98C7DE328717BCF71305DD4C9248,12131,16,17,1,32,47,1647
80227,80227,487C98C7DE328717BCF71305DD4C9248,42523,17,18,1,31,47,1597
80228,80228,DC2E529112942C5C83A202EA78227C0F,13651,0,7,7,30,47,1547
80229,80229,DC2E529112942C5C83A202EA78227C0F,11954,9,17,8,32,49,1649
80230,80230,DC2E529112942C5C83A202EA78227C0F,13651,19,22,3,30,47,1547
80231,80231,46B3DE812748722328FAB277775E5F5A,12514,0,1,1,38,47,1947
80232,80232,46B3DE812748722328FAB277775E5F5A,42221,4,11,7,38,48,1948
80233,80233,46B3DE812748722328FAB277775E5F5A,13011,14,15,1,39,47,1997
80234,80234,46B3DE812748722328FAB277775E5F5A,12514,15,20,5,38,47,1947
80235,80235,20A509B02D25A974055008C235F24563,11806,0,8,8,41,48,2098
80236,80236,20A509B02D25A974055008C235F24563,42271,10,19,9,40,47,2047
80237,80237,20A509B02D25A974055008C235F24563,11806,21,22,1,41,48,2098
80245,80245,FADD4BCA43ACFA4681BEB63D285BF584,11021,8,9,1,36,49,1849
80246,80246,FADD4BCA43ACFA4681BEB63D285BF584,40201,12,14,2,32,49,1649
80247,80247,FADD4BCA43ACFA4681BEB63D285BF584,40171,18,21,3,38,48,1948
80248,80248,4C0C7E2E98D34BFC05A247F4B04AD70C,13011,1,12,11,39,47,1997
80249,80249,4C0C7E2E98D34BFC05A247F4B04AD70C,11491,14,15,1,36,47,1847
80250,80250,4C0C7E2E98D34BFC05A247F4B04AD70C,11074,17,18,1,37,47,1897
80251,80251,4C0C7E2E98D34BFC05A247F4B04AD70C,13381,20,23,3,39,47,1997
80252,80252,4512C33A5D25C12FE88068CD1CBDBC46,11921,0,7,7,38,48,1948
80253,80253,4512C33A5D25C12FE88068CD1CBDBC46,11074,7,15,8,37,47,1897
80254,80254,4512C33A5D25C12FE88068CD1CBDBC46,11231,19,21,2,37,49,1899
80258,80258,BFC66AC44DE3D0C3983BFF60677905F1,13121,3,5,2,38,46,1946
80259,80259,BFC66AC44DE3D0C3983BFF60677905F1,13381,8,9,1,39,47,1997
80260,80260,BFC66AC44DE3D0C3983BFF60677905F1,13121,13,21,8,38,46,1946
80261,80261,320F0142A6A8D98142B47BD5D35CD593,43761,0,7,7,32,47,1647
80262,80262,320F0142A6A8D98142B47BD5D35CD593,43731,8,9,1,34,47,1747
80263,80263,320F0142A6A8D98142B47BD5D35CD593,42161,10,16,6,36,47,1847
80264,80264,320F0142A6A8D98142B47BD5D35CD593,43761,18,20,2,32,47,1647
80265,80265,ED57081FEDFCA9B3E2228C4E0C491121,10111,0,7,7,37,47,1897
80266,80266,ED57081FEDFCA9B3E2228C4E0C491121,42401,9,11,2,36,47,1847
80267,80267,ED57081FEDFCA9B3E2228C4E0C491121,10111,13,23,10,37,47,1897
80271,80271,FBC11E52B07B4E171A8F851408C7FBC4,10491,0,7,7,33,48,1698
80272,80272,FBC11E52B07B4E171A8F851408C7FBC4,12083,10,16,6,36,49,1849
80273,80273,FBC11E52B07B4E171A8F851408C7FBC4,10491,20,21,1,33,48,1698
80274,80274,007883C4896DAF2F56308DBC4E144D6F,42921,0,15,15,33,47,1697
80275,80275,007883C4896DAF2F56308DBC4E144D6F,12381,15,16,1,32,48,1648
80276,80276,007883C4896DAF2F56308DBC4E144D6F,42921,18,23,5,33,47,1697
80277,80277,0F18A9274445631256C7B0403CD7E0F0,42401,0,2,2,36,47,1847
80278,80278,0F18A9274445631256C7B0403CD7E0F0,10111,3,17,14,37,47,1897
80279,80279,0F18A9274445631256C7B0403CD7E0F0,42161,20,23,3,36,47,1847
80286,80286,0A501EA010779C8F9EB8C2F8834C3F4F,10351,0,7,7,28,45,1445
80287,80287,0A501EA010779C8F9EB8C2F8834C3F4F,10301,9,18,9,31,45,1595
80288,80288,0A501EA010779C8F9EB8C2F8834C3F4F,10351,20,23,3,28,45,1445
80293,80293,A26526FCE25758DA240C3B314B205E8A,19024,0,6,6,9,45,495
80294,80294,A26526FCE25758DA240C3B314B205E8A,12641,9,16,7,10,43,543
80295,80295,A26526FCE25758DA240C3B314B205E8A,19024,20,22,2,9,45,495
80308,80308,26E97CCAAB10F50751FB25FC2D6D6457,11261,0,14,14,36,46,1846
80309,80309,26E97CCAAB10F50751FB25FC2D6D6457,42861,14,18,4,37,44,1894
80310,80310,26E97CCAAB10F50751FB25FC2D6D6457,11261,22,23,1,36,46,1846
80344,80344,A53907219614BC9E0FC05C0EC4AF6DC2,13911,0,6,6,39,46,1996
80345,80345,A53907219614BC9E0FC05C0EC4AF6DC2,42231,9,18,9,37,46,1896
80346,80346,A53907219614BC9E0FC05C0EC4AF6DC2,13911,19,23,4,39,46,1996
80347,80347,D746519213A28242D49759FCE6B0BCB4,19441,1,13,12,8,46,446
80348,80348,D746519213A28242D49759FCE6B0BCB4,42041,16,19,3,10,47,547
80349,80349,D746519213A28242D49759FCE6B0BCB4,19441,22,23,1,8,46,446
80353,80353,E603C5CE99E3FE3BB5D201DC1F4B77FD,13111,1,18,17,42,46,2146
80354,80354,E603C5CE99E3FE3BB5D201DC1F4B77FD,42204,18,21,3,43,46,2196
80355,80355,E603C5CE99E3FE3BB5D201DC1F4B77FD,13791,22,23,1,42,47,2147
80361,80361,A584DB5FF6EE02AE16BAE873BBEDDAA1,12921,0,8,8,9,41,491
80362,80362,A584DB5FF6EE02AE16BAE873BBEDDAA1,12641,12,14,2,10,43,543
80363,80363,A584DB5FF6EE02AE16BAE873BBEDDAA1,12921,18,20,2,9,41,491
80364,80364,15BA009B68D87958E0A9656ADB01E7D6,10151,0,9,9,34,47,1747
80365,80365,15BA009B68D87958E0A9656ADB01E7D6,42371,11,15,4,34,46,1746
80366,80366,15BA009B68D87958E0A9656ADB01E7D6,10151,15,19,4,34,47,1747
80367,80367,15BA009B68D87958E0A9656ADB01E7D6,11541,20,22,2,35,49,1799
80373,80373,E063ED0B410DBCBEA7B106C50A20F760,43761,1,3,2,32,47,1647
80374,80374,E063ED0B410DBCBEA7B106C50A20F760,11491,3,17,14,36,47,1847
80375,80375,E063ED0B410DBCBEA7B106C50A20F760,43761,19,21,2,32,47,1647
80376,80376,FC3B8910035FE6AFFCEFAAF1A5BD46D7,10471,0,13,13,37,48,1898
80377,80377,FC3B8910035FE6AFFCEFAAF1A5BD46D7,42191,14,16,2,38,49,1949
80378,80378,FC3B8910035FE6AFFCEFAAF1A5BD46D7,10471,18,23,5,37,48,1898
80394,80394,1C1F6C68185E32864EF19C73864604BB,42581,0,8,8,38,48,1948
80395,80395,1C1F6C68185E32864EF19C73864604BB,11914,10,17,7,37,48,1898
80396,80396,1C1F6C68185E32864EF19C73864604BB,42581,19,23,4,38,48,1948
80397,80397,CEC2557E73B99D59943BE56AF1337C99,13121,0,7,7,38,46,1946
80398,80398,CEC2557E73B99D59943BE56AF1337C99,10271,7,10,3,37,46,1896
80399,80399,CEC2557E73B99D59943BE56AF1337C99,13121,11,13,2,38,46,1946
80400,80400,CEC2557E73B99D59943BE56AF1337C99,10271,14,19,5,37,46,1896
80401,80401,58160F8286644CCBCCC72FA14DAD9C05,19114,0,9,9,7,43,393
80402,80402,58160F8286644CCBCCC72FA14DAD9C05,12641,11,15,4,10,43,543
80403,80403,58160F8286644CCBCCC72FA14DAD9C05,19114,19,23,4,7,43,393
80411,80411,96B100113D40E22B39686C026F5DA397,42864,0,5,5,38,44,1944
80412,80412,96B100113D40E22B39686C026F5DA397,11261,9,14,5,36,46,1846
80413,80413,96B100113D40E22B39686C026F5DA397,12491,15,16,1,36,43,1843
80414,80414,96B100113D40E22B39686C026F5DA397,11261,18,19,1,36,46,1846
80415,80415,3C02B5838EDEAB0B15A337805B269A42,13011,0,5,5,39,47,1997
80416,80416,3C02B5838EDEAB0B15A337805B269A42,42321,6,17,11,43,47,2197
80417,80417,3C02B5838EDEAB0B15A337805B269A42,13011,17,23,6,39,47,1997
80418,80418,7B63B781AF1E5C1909C9ECFED6946980,43761,5,6,1,32,47,1647
80419,80419,7B63B781AF1E5C1909C9ECFED6946980,42523,9,18,9,31,47,1597
80420,80420,7B63B781AF1E5C1909C9ECFED6946980,43761,18,19,1,32,47,1647
80421,80421,7B63B781AF1E5C1909C9ECFED6946980,10281,20,22,2,33,48,1698
80427,80427,2663349895021D74B5F0C03E8A58DE84,11541,0,14,14,35,49,1799
80428,80428,2663349895021D74B5F0C03E8A58DE84,11531,17,18,1,34,49,1749
80429,80429,2663349895021D74B5F0C03E8A58DE84,11541,22,23,1,35,49,1799
80430,80430,B4D70E7CDFA879C6A4BAE698CD44BB37,10271,0,8,8,37,46,1896
80431,80431,B4D70E7CDFA879C6A4BAE698CD44BB37,13711,8,10,2,38,46,1946
80432,80432,B4D70E7CDFA879C6A4BAE698CD44BB37,10271,10,23,13,37,46,1896
80469,80469,8E9683EE7F6AAFA9B7B120960620DAA2,11701,0,7,7,43,48,2198
80470,80470,8E9683EE7F6AAFA9B7B120960620DAA2,42321,9,11,2,43,47,2197
80471,80471,8E9683EE7F6AAFA9B7B120960620DAA2,11701,11,23,12,43,48,2198
80476,80476,46D492BAB010922B2E00FA587B30756A,43951,0,14,14,49,41,2491
80477,80477,46D492BAB010922B2E00FA587B30756A,13411,19,20,1,49,42,2492
80478,80478,46D492BAB010922B2E00FA587B30756A,43951,21,23,2,49,41,2491
80482,80482,309C2EBD6881FB9505C9BCE9119A811B,42071,0,6,6,31,49,1599
80483,80483,309C2EBD6881FB9505C9BCE9119A811B,13731,8,9,1,33,49,1699
80484,80484,309C2EBD6881FB9505C9BCE9119A811B,11951,13,16,3,31,49,1599
80485,80485,309C2EBD6881FB9505C9BCE9119A811B,13731,16,18,2,33,49,1699
80486,80486,C619BC39ADD64D285F289B032026DA59,10841,0,7,7,37,47,1897
80487,80487,C619BC39ADD64D285F289B032026DA59,11941,11,16,5,37,46,1896
80488,80488,C619BC39ADD64D285F289B032026DA59,13711,17,18,1,38,46,1946
80489,80489,C619BC39ADD64D285F289B032026DA59,11074,21,22,1,37,47,1897
80511,80511,9C819019C9FBB04766CC6EE29C66CE0E,10411,1,9,8,36,48,1848
80512,80512,9C819019C9FBB04766CC6EE29C66CE0E,12514,11,16,5,38,47,1947
80513,80513,9C819019C9FBB04766CC6EE29C66CE0E,43731,18,20,2,34,47,1747
80523,80523,964156E683797EC321E31C806CD19178,11914,5,18,13,37,48,1898
80524,80524,964156E683797EC321E31C806CD19178,42581,19,20,1,38,48,1948
80525,80525,964156E683797EC321E31C806CD19178,11914,21,23,2,37,48,1898
80538,80538,29E682BF994B2ACA314777BEAEB90BB7,42231,8,10,2,37,46,1896
80539,80539,29E682BF994B2ACA314777BEAEB90BB7,42351,12,13,1,38,45,1945
80540,80540,29E682BF994B2ACA314777BEAEB90BB7,42231,14,16,2,37,46,1896
80541,80541,29E682BF994B2ACA314777BEAEB90BB7,42351,16,18,2,38,45,1945
80548,80548,7158BB5FE54F024DF86B9682428D7D80,42581,0,5,5,38,48,1948
80549,80549,7158BB5FE54F024DF86B9682428D7D80,10471,6,16,10,37,48,1898
80550,80550,7158BB5FE54F024DF86B9682428D7D80,12514,20,22,2,38,47,1947
80551,80551,751637010376FF10A15374FA98F99F38,11861,0,8,8,32,47,1647
80552,80552,751637010376FF10A15374FA98F99F38,10221,11,13,2,34,49,1749
80553,80553,751637010376FF10A15374FA98F99F38,10281,15,19,4,33,48,1698
80554,80554,751637010376FF10A15374FA98F99F38,11861,20,22,2,32,47,1647
80555,80555,B0895CC09AF6DDBFD1DAF6810DC05EB1,42301,3,11,8,36,47,1847
80556,80556,B0895CC09AF6DDBFD1DAF6810DC05EB1,12511,15,16,1,39,47,1997
80557,80557,B0895CC09AF6DDBFD1DAF6810DC05EB1,10841,17,19,2,37,47,1897
80558,80558,111CDDD5FA2E313735C2BD7B109AA3EE,42151,0,11,11,35,45,1795
80559,80559,111CDDD5FA2E313735C2BD7B109AA3EE,42861,12,13,1,37,44,1894
80560,80560,111CDDD5FA2E313735C2BD7B109AA3EE,42151,17,23,6,35,45,1795
80575,80575,A4B13605C78797589D9B98BC8787EDD0,19931,0,5,5,7,43,393
80576,80576,A4B13605C78797589D9B98BC8787EDD0,12641,6,8,2,10,43,543
80577,80577,A4B13605C78797589D9B98BC8787EDD0,12921,8,15,7,9,41,491
80578,80578,A4B13605C78797589D9B98BC8787EDD0,19114,18,23,5,7,43,393
80582,80582,440A5BC995406F5A39B97937FE6675EC,19744,0,4,4,6,43,343
80583,80583,440A5BC995406F5A39B97937FE6675EC,12641,4,10,6,10,43,543
80584,80584,440A5BC995406F5A39B97937FE6675EC,19744,10,14,4,6,43,343
80585,80585,440A5BC995406F5A39B97937FE6675EC,12641,15,21,6,10,43,543
80589,80589,3FBA130DE96D19DDB92B7C1710211CF0,10611,0,7,7,32,48,1648
80590,80590,3FBA130DE96D19DDB92B7C1710211CF0,10251,7,15,8,35,47,1797
80591,80591,3FBA130DE96D19DDB92B7C1710211CF0,10611,16,23,7,32,48,1648
80592,80592,E6D049947968658F47DDC695A59302A1,42204,0,13,13,43,46,2196
80593,80593,E6D049947968658F47DDC695A59302A1,42111,16,18,2,44,46,2246
80594,80594,E6D049947968658F47DDC695A59302A1,42204,20,22,2,43,46,2196
80595,80595,8901C834A10BBD863479FEA29CB07080,13911,0,6,6,39,46,1996
80596,80596,8901C834A10BBD863479FEA29CB07080,42351,7,15,8,38,45,1945
80597,80597,8901C834A10BBD863479FEA29CB07080,13911,20,23,3,39,46,1996
80601,80601,43DBC097DABD3DD07A95B28C32F20D40,13371,0,8,8,41,47,2097
80602,80602,43DBC097DABD3DD07A95B28C32F20D40,11805,9,11,2,41,48,2098
80603,80603,43DBC097DABD3DD07A95B28C32F20D40,13371,12,23,11,41,47,2097
80604,80604,5B38B567B1C7BA8CD66BEFDF9C575D7A,12083,0,11,11,36,49,1849
80605,80605,5B38B567B1C7BA8CD66BEFDF9C575D7A,13741,13,15,2,37,49,1899
80606,80606,5B38B567B1C7BA8CD66BEFDF9C575D7A,12083,16,20,4,36,49,1849
80610,80610,06F407FD461A4B0FFE40FBF8673BD071,10351,0,15,15,28,45,1445
80611,80611,06F407FD461A4B0FFE40FBF8673BD071,10634,18,19,1,27,45,1395
80612,80612,06F407FD461A4B0FFE40FBF8673BD071,10351,21,23,2,28,45,1445
80616,80616,6E198FFF8A0EEA3FE2F6EEE55F7012CE,19114,0,5,5,7,43,393
80617,80617,6E198FFF8A0EEA3FE2F6EEE55F7012CE,12641,5,16,11,10,43,543
80618,80618,6E198FFF8A0EEA3FE2F6EEE55F7012CE,19114,19,23,4,7,43,393
80619,80619,895085FE0B62D7BCDF8725B5DB48E546,42521,0,6,6,31,47,1597
80620,80620,895085FE0B62D7BCDF8725B5DB48E546,11061,6,14,8,29,48,1498
80621,80621,895085FE0B62D7BCDF8725B5DB48E546,42521,15,23,8,31,47,1597
80622,80622,394D700E14C58A7853C10805B183B24E,11061,6,9,3,29,48,1498
80623,80623,394D700E14C58A7853C10805B183B24E,11381,9,21,12,30,47,1547
80624,80624,394D700E14C58A7853C10805B183B24E,11061,22,23,1,29,48,1498
80629,80629,47F2C03C91E1D89BDD89B2581C85F965,42321,4,6,2,43,47,2197
80630,80630,47F2C03C91E1D89BDD89B2581C85F965,11701,6,18,12,43,48,2198
80631,80631,47F2C03C91E1D89BDD89B2581C85F965,42321,19,21,2,43,47,2197
80632,80632,C9F84D3604FFDDEC89D1908F58D5CF7B,11901,0,12,12,42,49,2149
80633,80633,C9F84D3604FFDDEC89D1908F58D5CF7B,11301,12,15,3,41,49,2099
80634,80634,C9F84D3604FFDDEC89D1908F58D5CF7B,11901,19,23,4,42,49,2149
80645,80645,A655C67D52402CE056E16AFA14815F89,13271,8,13,5,41,47,2097
80646,80646,A655C67D52402CE056E16AFA14815F89,11481,14,16,2,41,48,2098
80647,80647,A655C67D52402CE056E16AFA14815F89,40833,16,23,7,41,47,2097
80648,80648,A8491B4932A74BB29E61F0906E6D23DE,42461,0,7,7,45,47,2297
80649,80649,A8491B4932A74BB29E61F0906E6D23DE,42204,8,9,1,43,46,2196
80650,80650,A8491B4932A74BB29E61F0906E6D23DE,42461,11,23,12,45,47,2297
80651,80651,AE931B79E80BF3CFA2F48EF7F9685CA5,12491,4,5,1,36,43,1843
80652,80652,AE931B79E80BF3CFA2F48EF7F9685CA5,11261,5,14,9,36,46,1846
80653,80653,AE931B79E80BF3CFA2F48EF7F9685CA5,12491,16,18,2,36,43,1843
80665,80665,84BFDA5775B1A36CF113618F1669E73C,42521,0,13,13,31,47,1597
80666,80666,84BFDA5775B1A36CF113618F1669E73C,10295,15,17,2,30,47,1547
80667,80667,84BFDA5775B1A36CF113618F1669E73C,42521,18,23,5,31,47,1597
80668,80668,F4D1CACDA44EA0B56E4022B1E4015F81,42511,0,7,7,37,47,1897
80669,80669,F4D1CACDA44EA0B56E4022B1E4015F81,11261,9,18,9,36,46,1846
80670,80670,F4D1CACDA44EA0B56E4022B1E4015F81,42511,18,23,5,37,47,1897
80671,80671,669C34237215178780FBCDB7F5444D7E,42521,0,12,12,31,47,1597
80672,80672,669C34237215178780FBCDB7F5444D7E,11061,15,16,1,29,48,1498
80673,80673,669C34237215178780FBCDB7F5444D7E,42521,19,20,1,31,47,1597
80674,80674,669C34237215178780FBCDB7F5444D7E,11061,20,22,2,29,48,1498
80675,80675,BF5242715718EEF665EE93EC69F552EB,13271,1,6,5,41,47,2097
80676,80676,BF5242715718EEF665EE93EC69F552EB,13101,11,13,2,40,47,2047
80677,80677,BF5242715718EEF665EE93EC69F552EB,13271,17,18,1,41,47,2097
80678,80678,BF5242715718EEF665EE93EC69F552EB,11801,19,21,2,42,48,2148
80679,80679,6224797A94401F7316FE4DF239A66FE7,12221,1,7,6,43,44,2194
80680,80680,6224797A94401F7316FE4DF239A66FE7,42201,9,18,9,43,46,2196
80681,80681,6224797A94401F7316FE4DF239A66FE7,42321,21,23,2,43,47,2197
80720,80720,1CE5F4D10EE2FB173CB9F2BC0746661A,42531,0,9,9,31,45,1595
80721,80721,1CE5F4D10EE2FB173CB9F2BC0746661A,12311,12,19,7,30,44,1544
80722,80722,1CE5F4D10EE2FB173CB9F2BC0746661A,42531,20,22,2,31,45,1595
80723,80723,9018E334510830C940D94E13413D361F,13371,0,7,7,41,47,2097
80724,80724,9018E334510830C940D94E13413D361F,10787,7,15,8,38,46,1946
80725,80725,9018E334510830C940D94E13413D361F,13371,16,22,6,41,47,2097
80760,80760,BAAEF1F815128F9C42A2F609EF6E43D2,42921,0,14,14,33,47,1697
80761,80761,BAAEF1F815128F9C42A2F609EF6E43D2,43161,17,19,2,35,47,1797
80762,80762,BAAEF1F815128F9C42A2F609EF6E43D2,13601,20,22,2,34,47,1747
80766,80766,4E90415C9BB7CB146F4ED5E2D957B8E7,11481,0,8,8,41,48,2098
80767,80767,4E90415C9BB7CB146F4ED5E2D957B8E7,13101,9,10,1,40,47,2047
80768,80768,4E90415C9BB7CB146F4ED5E2D957B8E7,11481,11,23,12,41,48,2098
80782,80782,53D8E731DA65650E5B825C52CF592433,11201,0,13,13,35,49,1799
80783,80783,53D8E731DA65650E5B825C52CF592433,11261,14,18,4,36,46,1846
80784,80784,53D8E731DA65650E5B825C52CF592433,11751,20,22,2,35,48,1798
80785,80785,2E8B764495F8C75B1A6E74CD6E6D7095,42921,0,6,6,33,47,1697
80786,80786,2E8B764495F8C75B1A6E74CD6E6D7095,10292,8,18,10,30,47,1547
80787,80787,2E8B764495F8C75B1A6E74CD6E6D7095,10731,20,21,1,33,47,1697
80791,80791,31F415EB510CAC0A9E132B86FD3A4D18,42601,0,6,6,44,48,2248
80792,80792,31F415EB510CAC0A9E132B86FD3A4D18,42321,7,8,1,43,47,2197
80793,80793,31F415EB510CAC0A9E132B86FD3A4D18,42601,11,22,11,44,48,2248
80811,80811,72EE059838FC074BF0955787969E7967,11231,0,4,4,37,49,1899
80812,80812,72EE059838FC074BF0955787969E7967,11911,5,19,14,37,48,1898
80813,80813,72EE059838FC074BF0955787969E7967,11231,20,23,3,37,49,1899
80814,80814,00B181DD66423FB09C5417E3C6EB3025,13941,1,5,4,41,47,2097
80815,80815,00B181DD66423FB09C5417E3C6EB3025,11001,8,12,4,42,47,2147
80816,80816,00B181DD66423FB09C5417E3C6EB3025,13941,15,19,4,41,47,2097
80817,80817,0CB53170B0580516D256BCBB9691DC54,10901,7,10,3,35,48,1798
80818,80818,0CB53170B0580516D256BCBB9691DC54,10471,12,16,4,37,48,1898
80819,80819,0CB53170B0580516D256BCBB9691DC54,11731,17,18,1,36,48,1848
80820,80820,77C3773B374C1BCE8F16244985E19C6C,10501,0,15,15,22,46,1146
80821,80821,77C3773B374C1BCE8F16244985E19C6C,12601,15,17,2,25,47,1297
80822,80822,77C3773B374C1BCE8F16244985E19C6C,10501,17,22,5,22,46,1146
80831,80831,5566DF9556BCD612F8500FB496AD53B3,11861,0,7,7,32,47,1647
80832,80832,5566DF9556BCD612F8500FB496AD53B3,13651,7,10,3,30,47,1547
80833,80833,5566DF9556BCD612F8500FB496AD53B3,11861,12,16,4,32,47,1647
80834,80834,5566DF9556BCD612F8500FB496AD53B3,42021,17,23,6,33,47,1697
80835,80835,A6555ADD1FDD22671BB225447AB03AF9,12641,0,14,14,10,43,543
80836,80836,A6555ADD1FDD22671BB225447AB03AF9,19931,16,17,1,7,43,393
80837,80837,A6555ADD1FDD22671BB225447AB03AF9,12641,18,20,2,10,43,543
80850,80850,05A020FB3ED60AE565EDEADD6B0AE3FA,10691,0,7,7,33,48,1698
80851,80851,05A020FB3ED60AE565EDEADD6B0AE3FA,41591,13,14,1,34,49,1749
80852,80852,05A020FB3ED60AE565EDEADD6B0AE3FA,43581,18,21,3,33,48,1698
80853,80853,D59A7D67E6A2D306517724C5A50D5385,10351,0,6,6,28,45,1445
80854,80854,D59A7D67E6A2D306517724C5A50D5385,42531,8,9,1,31,45,1595
80855,80855,D59A7D67E6A2D306517724C5A50D5385,10351,12,23,11,28,45,1445
80856,80856,87FE93FC61504A55CCD1B2036178DC89,10801,0,5,5,42,47,2147
80857,80857,87FE93FC61504A55CCD1B2036178DC89,13341,6,15,9,44,45,2245
80858,80858,87FE93FC61504A55CCD1B2036178DC89,10801,16,23,7,42,47,2147
80859,80859,652A7BC7F38AFBE4C7A9DA23C79E734A,10292,0,17,17,30,47,1547
80860,80860,652A7BC7F38AFBE4C7A9DA23C79E734A,11861,18,20,2,32,47,1647
80861,80861,652A7BC7F38AFBE4C7A9DA23C79E734A,10292,21,23,2,30,47,1547
80862,80862,511248B31413344B77C12D74A5EE7CDF,43471,0,8,8,31,49,1599
80863,80863,511248B31413344B77C12D74A5EE7CDF,11151,8,17,9,30,48,1548
80864,80864,511248B31413344B77C12D74A5EE7CDF,43471,20,23,3,31,49,1599
80865,80865,A112A6201A9A582E1DF1B602A107D06B,10351,0,5,5,28,45,1445
80866,80866,A112A6201A9A582E1DF1B602A107D06B,10301,7,20,13,31,45,1595
80867,80867,A112A6201A9A582E1DF1B602A107D06B,10351,21,22,1,28,45,1445
80875,80875,D2E985719F24552C5FFF7476EA4D4B09,42401,0,8,8,36,47,1847
80876,80876,D2E985719F24552C5FFF7476EA4D4B09,10471,8,16,8,37,48,1898
80877,80877,D2E985719F24552C5FFF7476EA4D4B09,42161,18,19,1,36,47,1847
80878,80878,D2E985719F24552C5FFF7476EA4D4B09,10111,20,23,3,37,47,1897
80879,80879,97E4702F624CE098E267C7767A3602E0,10681,1,8,7,30,48,1548
80880,80880,97E4702F624CE098E267C7767A3602E0,12161,10,15,5,32,46,1646
80881,80881,97E4702F624CE098E267C7767A3602E0,12131,15,18,3,32,47,1647
80882,80882,97E4702F624CE098E267C7767A3602E0,10681,19,21,2,30,48,1548
80886,80886,BB2213F6CD0581F26FA9CDBA17E84BA3,42271,2,3,1,40,47,2047
80887,80887,BB2213F6CD0581F26FA9CDBA17E84BA3,42221,5,10,5,38,48,1948
80888,80888,BB2213F6CD0581F26FA9CDBA17E84BA3,42271,15,18,3,40,47,2047
80889,80889,BB2213F6CD0581F26FA9CDBA17E84BA3,42301,21,22,1,36,47,1847
80890,80890,E68938B769BE3082CBE1F99A60593DDB,13791,0,3,3,42,47,2147
80891,80891,E68938B769BE3082CBE1F99A60593DDB,13941,5,7,2,41,47,2097
80892,80892,E68938B769BE3082CBE1F99A60593DDB,13111,8,16,8,42,46,2146
80893,80893,E68938B769BE3082CBE1F99A60593DDB,13371,19,23,4,41,47,2097
80921,80921,15B4B2807EF132F03A4FFF7B638F630B,12731,0,5,5,22,40,1140
80922,80922,15B4B2807EF132F03A4FFF7B638F630B,13091,6,13,7,20,42,1042
80923,80923,15B4B2807EF132F03A4FFF7B638F630B,12731,14,16,2,22,40,1140
80924,80924,15B4B2807EF132F03A4FFF7B638F630B,13091,19,20,1,20,42,1042
80928,80928,4515D69DA9DF7C67BD58AB71BAA57E58,40171,4,7,3,38,48,1948
80929,80929,4515D69DA9DF7C67BD58AB71BAA57E58,10471,9,16,7,37,48,1898
80930,80930,4515D69DA9DF7C67BD58AB71BAA57E58,40171,20,21,1,38,48,1948
80931,80931,4515D69DA9DF7C67BD58AB71BAA57E58,11914,21,23,2,37,48,1898
80936,80936,12CD49247659842CCDEA8C017DBD960B,41393,0,1,1,43,49,2199
80937,80937,12CD49247659842CCDEA8C017DBD960B,42461,5,10,5,45,47,2297
80938,80938,12CD49247659842CCDEA8C017DBD960B,41393,12,15,3,43,49,2199
80939,80939,12CD49247659842CCDEA8C017DBD960B,42461,17,18,1,45,47,2297
80949,80949,582FCEF67ED9C80E5B2E8667690F61FB,42221,0,10,10,38,48,1948
80950,80950,582FCEF67ED9C80E5B2E8667690F61FB,10251,11,15,4,35,47,1797
80951,80951,582FCEF67ED9C80E5B2E8667690F61FB,42401,16,17,1,36,47,1847
80952,80952,582FCEF67ED9C80E5B2E8667690F61FB,42221,21,23,2,38,48,1948
80953,80953,E06F248FC43DC08ED97FD0BB37D05DA2,13341,2,8,6,44,45,2245
80954,80954,E06F248FC43DC08ED97FD0BB37D05DA2,12211,8,20,12,41,44,2094
80955,80955,E06F248FC43DC08ED97FD0BB37D05DA2,13341,22,23,1,44,45,2245
80965,80965,2CDBE560BCF3AE75FA6854256206C16F,42161,9,11,2,36,47,1847
80966,80966,2CDBE560BCF3AE75FA6854256206C16F,10111,12,14,2,37,47,1897
80967,80967,2CDBE560BCF3AE75FA6854256206C16F,10251,14,21,7,35,47,1797
80974,80974,6428FC1D2F17D8BB440D0F9FCA04C935,13911,0,7,7,39,46,1996
80975,80975,6428FC1D2F17D8BB440D0F9FCA04C935,11261,7,10,3,36,46,1846
80976,80976,6428FC1D2F17D8BB440D0F9FCA04C935,13911,11,22,11,39,46,1996
80977,80977,E01ED90AD50B751B77DE5D3D5EA35C57,11151,0,9,9,30,48,1548
80978,80978,E01ED90AD50B751B77DE5D3D5EA35C57,11061,9,20,11,29,48,1498
80979,80979,E01ED90AD50B751B77DE5D3D5EA35C57,11151,22,23,1,30,48,1548
80980,80980,78C0E1E992CFF9ECB9C6D46D3E929FD4,12121,0,6,6,29,47,1497
80981,80981,78C0E1E992CFF9ECB9C6D46D3E929FD4,11381,7,12,5,30,47,1547
80982,80982,78C0E1E992CFF9ECB9C6D46D3E929FD4,12121,14,16,2,29,47,1497
80983,80983,78C0E1E992CFF9ECB9C6D46D3E929FD4,11381,20,22,2,30,47,1547
80984,80984,3F9A6924C359E667023E00EF6A58C7A3,13651,0,17,17,30,47,1547
80985,80985,3F9A6924C359E667023E00EF6A58C7A3,42141,19,20,1,32,47,1647
80986,80986,3F9A6924C359E667023E00EF6A58C7A3,13651,20,21,1,30,47,1547
80987,80987,5D467CB7C3D63DF2F50205BF5091A01C,11151,0,7,7,30,48,1548
80988,80988,5D467CB7C3D63DF2F50205BF5091A01C,11061,8,12,4,29,48,1498
80989,80989,5D467CB7C3D63DF2F50205BF5091A01C,11151,13,14,1,30,48,1548
80990,80990,5D467CB7C3D63DF2F50205BF5091A01C,11061,18,19,1,29,48,1498
80991,80991,7C5210855A5DFB6ACF7A087ADA0E2F3D,13911,2,4,2,39,46,1996
80992,80992,7C5210855A5DFB6ACF7A087ADA0E2F3D,42231,6,10,4,37,46,1896
80993,80993,7C5210855A5DFB6ACF7A087ADA0E2F3D,13911,15,16,1,39,46,1996
80994,80994,7C5210855A5DFB6ACF7A087ADA0E2F3D,42231,16,23,7,37,46,1896
80995,80995,0BC1BC9FA127A76D4558FF0A0EC8FEFB,42921,0,6,6,33,47,1697
80996,80996,0BC1BC9FA127A76D4558FF0A0EC8FEFB,10281,7,10,3,33,48,1698
80997,80997,0BC1BC9FA127A76D4558FF0A0EC8FEFB,42021,11,23,12,33,47,1697
81011,81011,D9BB41A84CF921B48387DB07E0CD66FA,11074,0,15,15,37,47,1897
81012,81012,D9BB41A84CF921B48387DB07E0CD66FA,12514,19,20,1,38,47,1947
81013,81013,D9BB41A84CF921B48387DB07E0CD66FA,11074,20,23,3,37,47,1897
81014,81014,C3FB4EE105B7861A50BF03BC1584CA1D,42204,0,4,4,43,46,2196
81015,81015,C3FB4EE105B7861A50BF03BC1584CA1D,13111,5,13,8,42,46,2146
81016,81016,C3FB4EE105B7861A50BF03BC1584CA1D,42111,14,15,1,44,46,2246
81017,81017,C3FB4EE105B7861A50BF03BC1584CA1D,13111,18,23,5,42,46,2146
81018,81018,829F3CF969A99106A0CF5C6D0ED0FE14,42161,0,9,9,36,47,1847
81019,81019,829F3CF969A99106A0CF5C6D0ED0FE14,11751,9,16,7,35,48,1798
81020,81020,829F3CF969A99106A0CF5C6D0ED0FE14,42401,17,23,6,36,47,1847
81021,81021,120368F7CD3E20C4A5CFEF1F75B84608,11381,0,8,8,30,47,1547
81022,81022,120368F7CD3E20C4A5CFEF1F75B84608,41631,9,10,1,28,47,1447
81023,81023,120368F7CD3E20C4A5CFEF1F75B84608,11381,13,20,7,30,47,1547
81024,81024,00ED2280FB2BEC22D8FB36F8A7AFB1A5,42791,0,7,7,35,45,1795
81025,81025,00ED2280FB2BEC22D8FB36F8A7AFB1A5,13121,9,10,1,38,46,1946
81026,81026,00ED2280FB2BEC22D8FB36F8A7AFB1A5,10271,11,18,7,37,46,1896
81027,81027,90B09B02D0DADF8E3A894A5D3E9F4905,11231,0,13,13,37,49,1899
81028,81028,90B09B02D0DADF8E3A894A5D3E9F4905,12083,13,15,2,36,49,1849
81029,81029,90B09B02D0DADF8E3A894A5D3E9F4905,11231,19,23,4,37,49,1899
81042,81042,55B62CF97C3AEC62D987D2F1F6626FBA,43041,1,5,4,41,46,2096
81043,81043,55B62CF97C3AEC62D987D2F1F6626FBA,13711,9,17,8,38,46,1946
81044,81044,55B62CF97C3AEC62D987D2F1F6626FBA,43041,20,23,3,41,46,2096
81045,81045,A922D7161F816C1FD25F52BCCB616DFE,10251,0,9,9,35,47,1797
81046,81046,A922D7161F816C1FD25F52BCCB616DFE,40673,11,13,2,36,48,1848
81047,81047,A922D7161F816C1FD25F52BCCB616DFE,42161,13,15,2,36,47,1847
81048,81048,A922D7161F816C1FD25F52BCCB616DFE,10251,15,19,4,35,47,1797
81049,81049,47844E829FCB05D6E87386BF9A1380C3,13711,0,8,8,38,46,1946
81050,81050,47844E829FCB05D6E87386BF9A1380C3,10971,13,15,2,35,47,1797
81051,81051,47844E829FCB05D6E87386BF9A1380C3,13711,16,19,3,38,46,1946
81052,81052,47844E829FCB05D6E87386BF9A1380C3,10107,21,22,1,38,49,1949
81056,81056,EF2A8E0FFD311B3B4C1F464BDC44C657,40833,0,6,6,41,47,2097
81057,81057,EF2A8E0FFD311B3B4C1F464BDC44C657,40365,20,21,1,42,48,2148
81058,81058,EF2A8E0FFD311B3B4C1F464BDC44C657,40833,22,23,1,41,47,2097
81059,81059,863093DB11F1063670E11FFAF49890AF,43061,0,7,7,43,46,2196
81060,81060,863093DB11F1063670E11FFAF49890AF,42631,9,21,12,43,45,2195
81061,81061,863093DB11F1063670E11FFAF49890AF,43061,21,23,2,43,46,2196
81062,81062,8819837FD8CEEBF0A1A8389A5700C1ED,42601,0,11,11,44,48,2248
81063,81063,8819837FD8CEEBF0A1A8389A5700C1ED,42091,12,18,6,43,46,2196
81064,81064,8819837FD8CEEBF0A1A8389A5700C1ED,42601,19,22,3,44,48,2248
81073,81073,2CB6953F391C73F166D02AC31E930A06,11921,0,7,7,38,48,1948
81074,81074,2CB6953F391C73F166D02AC31E930A06,11914,16,20,4,37,48,1898
81075,81075,2CB6953F391C73F166D02AC31E930A06,11921,22,23,1,38,48,1948
81076,81076,E953104F54412ACC2177AEF0AAD4E500,42204,6,17,11,43,46,2196
81077,81077,E953104F54412ACC2177AEF0AAD4E500,13111,18,20,2,42,46,2146
81078,81078,E953104F54412ACC2177AEF0AAD4E500,42204,21,23,2,43,46,2196
81087,81087,4B5C492CF16B079882322240829D6566,43281,0,7,7,37,48,1898
81088,81088,4B5C492CF16B079882322240829D6566,11231,7,16,9,37,49,1899
81089,81089,4B5C492CF16B079882322240829D6566,10471,16,21,5,37,48,1898
81101,81101,558A6887C0D5899B43E75BBD844A7C64,42461,0,5,5,45,47,2297
81102,81102,558A6887C0D5899B43E75BBD844A7C64,42321,7,17,10,43,47,2197
81103,81103,558A6887C0D5899B43E75BBD844A7C64,42461,19,22,3,45,47,2297
81110,81110,B24DFEF6BEA91CB0AE942579D8124FCB,43161,0,15,15,35,47,1797
81111,81111,B24DFEF6BEA91CB0AE942579D8124FCB,10901,16,19,3,35,48,1798
81112,81112,B24DFEF6BEA91CB0AE942579D8124FCB,12083,21,23,2,36,49,1849
81113,81113,D54F9F7B5ACE26D54228A669C839B9DF,42231,0,4,4,37,46,1896
81114,81114,D54F9F7B5ACE26D54228A669C839B9DF,42351,4,6,2,38,45,1945
81115,81115,D54F9F7B5ACE26D54228A669C839B9DF,42231,7,23,16,37,46,1896
81140,81140,0C2B805EE888E91F034AB21F925F07C4,19901,1,12,11,7,44,394
81141,81141,0C2B805EE888E91F034AB21F925F07C4,12641,12,13,1,10,43,543
81142,81142,0C2B805EE888E91F034AB21F925F07C4,19901,14,15,1,7,44,394
81143,81143,0C2B805EE888E91F034AB21F925F07C4,12641,18,20,2,10,43,543
81157,81157,A32DF7F91BA5DF29E0CC0A23C60F35BC,42351,0,8,8,38,45,1945
81158,81158,A32DF7F91BA5DF29E0CC0A23C60F35BC,13911,10,13,3,39,46,1996
81159,81159,A32DF7F91BA5DF29E0CC0A23C60F35BC,42151,15,19,4,35,45,1795
81160,81160,A32DF7F91BA5DF29E0CC0A23C60F35BC,42351,20,23,3,38,45,1945
81166,81166,B93C16A242FE2C6BDA83A87AD4FAA434,10501,1,7,6,22,46,1146
81167,81167,B93C16A242FE2C6BDA83A87AD4FAA434,12601,9,10,1,25,47,1297
81168,81168,B93C16A242FE2C6BDA83A87AD4FAA434,10501,11,15,4,22,46,1146
81169,81169,B93C16A242FE2C6BDA83A87AD4FAA434,12601,15,22,7,25,47,1297
81170,81170,4D0ED6C01EC55D2BA8CCC5E44CD25B70,11941,0,3,3,37,46,1896
81171,81171,4D0ED6C01EC55D2BA8CCC5E44CD25B70,13121,3,5,2,38,46,1946
81172,81172,4D0ED6C01EC55D2BA8CCC5E44CD25B70,11941,6,23,17,37,46,1896
81176,81176,888D3867D3038878970E976C5AE9B1B6,13651,0,9,9,30,47,1547
81177,81177,888D3867D3038878970E976C5AE9B1B6,10351,13,15,2,28,45,1445
81178,81178,888D3867D3038878970E976C5AE9B1B6,13651,18,23,5,30,47,1547
81207,81207,CC6A63734928B4CD8F414AAB01241B9F,12381,0,7,7,32,48,1648
81208,81208,CC6A63734928B4CD8F414AAB01241B9F,43311,13,14,1,31,48,1598
81209,81209,CC6A63734928B4CD8F414AAB01241B9F,10611,21,23,2,32,48,1648
81214,81214,0AC9ACC82EDADEC2B3583D25F9FB3BD5,19441,2,7,5,8,46,446
81215,81215,0AC9ACC82EDADEC2B3583D25F9FB3BD5,42041,11,13,2,10,47,547
81216,81216,0AC9ACC82EDADEC2B3583D25F9FB3BD5,19441,13,15,2,8,46,446
81217,81217,0AC9ACC82EDADEC2B3583D25F9FB3BD5,42041,17,19,2,10,47,547
81218,81218,449E7811DCD6E8CD500501049B5A906E,13911,2,6,4,39,46,1996
81219,81219,449E7811DCD6E8CD500501049B5A906E,11261,6,9,3,36,46,1846
81220,81220,449E7811DCD6E8CD500501049B5A906E,13911,10,17,7,39,46,1996
81221,81221,449E7811DCD6E8CD500501049B5A906E,11261,18,19,1,36,46,1846
81229,81229,9174106625D3239DC850CA622055B684,42941,0,7,7,37,47,1897
81230,81230,9174106625D3239DC850CA622055B684,42301,9,13,4,36,47,1847
81231,81231,9174106625D3239DC850CA622055B684,11331,14,15,1,37,48,1898
81232,81232,9174106625D3239DC850CA622055B684,42301,18,23,5,36,47,1847
81233,81233,9508FAE0B774FCD97D7CFB3C4BD72215,10111,1,15,14,37,47,1897
81234,81234,9508FAE0B774FCD97D7CFB3C4BD72215,42401,17,18,1,36,47,1847
81235,81235,9508FAE0B774FCD97D7CFB3C4BD72215,10251,18,22,4,35,47,1797
81239,81239,9C017418D67328D93FD696E6655B46ED,11211,0,8,8,34,49,1749
81240,81240,9C017418D67328D93FD696E6655B46ED,10431,12,15,3,33,49,1699
81241,81241,9C017418D67328D93FD696E6655B46ED,11211,19,21,2,34,49,1749
81242,81242,9C017418D67328D93FD696E6655B46ED,11541,22,23,1,35,49,1799
81243,81243,0D8215A18C050E0BA3AE0B39B2A6FDFD,42511,0,8,8,37,47,1897
81244,81244,0D8215A18C050E0BA3AE0B39B2A6FDFD,42151,12,16,4,35,45,1795
81245,81245,0D8215A18C050E0BA3AE0B39B2A6FDFD,10151,20,23,3,34,47,1747
81249,81249,9161AF2FBE00F6EB9CFD0E53A85277FE,11381,0,16,16,30,47,1547
81250,81250,9161AF2FBE00F6EB9CFD0E53A85277FE,10951,16,21,5,29,48,1498
81251,81251,9161AF2FBE00F6EB9CFD0E53A85277FE,11381,22,23,1,30,47,1547
81255,81255,86902B52DC79D42F4776148283AF350B,42091,10,11,1,43,46,2196
81256,81256,86902B52DC79D42F4776148283AF350B,40691,12,14,2,42,48,2148
81257,81257,86902B52DC79D42F4776148283AF350B,11701,14,17,3,43,48,2198
81258,81258,86902B52DC79D42F4776148283AF350B,42091,18,23,5,43,46,2196
81259,81259,68D66AC2F31097852E1113FCAC38B096,42531,0,3,3,31,45,1595
81260,81260,68D66AC2F31097852E1113FCAC38B096,12121,5,6,1,29,47,1497
81261,81261,68D66AC2F31097852E1113FCAC38B096,42531,9,11,2,31,45,1595
81262,81262,68D66AC2F31097852E1113FCAC38B096,12311,11,21,10,30,44,1544
81273,81273,780CF605B987CE4335E0B64DFA86ACBF,12514,2,7,5,38,47,1947
81274,81274,780CF605B987CE4335E0B64DFA86ACBF,11921,7,8,1,38,48,1948
81275,81275,780CF605B987CE4335E0B64DFA86ACBF,12514,8,21,13,38,47,1947
81293,81293,0781E535CBB143640477269330BEC7EE,42161,0,8,8,36,47,1847
81294,81294,0781E535CBB143640477269330BEC7EE,10221,10,16,6,34,49,1749
81295,81295,0781E535CBB143640477269330BEC7EE,42471,17,18,1,35,49,1799
81296,81296,2E9ACB5217DEAC635E911A6AAEF6DCF5,11261,0,8,8,36,46,1846
81297,81297,2E9ACB5217DEAC635E911A6AAEF6DCF5,12021,9,11,2,37,49,1899
81298,81298,2E9ACB5217DEAC635E911A6AAEF6DCF5,11261,12,23,11,36,46,1846
81299,81299,0B1F81D50BCD55F78AD202EF0803FA05,41392,0,7,7,43,48,2198
81300,81300,0B1F81D50BCD55F78AD202EF0803FA05,42321,9,11,2,43,47,2197
81301,81301,0B1F81D50BCD55F78AD202EF0803FA05,10924,13,23,10,43,49,2199
81313,81313,D5746F30DC8775BC56CB551C6292738D,42471,0,8,8,35,49,1799
81314,81314,D5746F30DC8775BC56CB551C6292738D,10221,8,12,4,34,49,1749
81315,81315,D5746F30DC8775BC56CB551C6292738D,11541,12,21,9,35,49,1799
81316,81316,01308B72F71E3AACC045F922DA6CAE4D,43761,3,4,1,32,47,1647
81317,81317,01308B72F71E3AACC045F922DA6CAE4D,10341,8,15,7,31,47,1597
81318,81318,01308B72F71E3AACC045F922DA6CAE4D,43761,18,19,1,32,47,1647
81319,81319,01308B72F71E3AACC045F922DA6CAE4D,42521,20,21,1,31,47,1597
81334,81334,1A781977FAF109F9FB129E523F36ACF2,12311,2,4,2,30,44,1544
81335,81335,1A781977FAF109F9FB129E523F36ACF2,10301,6,9,3,31,45,1595
81336,81336,1A781977FAF109F9FB129E523F36ACF2,13671,12,22,10,27,43,1393
81345,81345,E5F35E9A8E7D375E3C2447F3147B8E3F,42523,0,14,14,31,47,1597
81346,81346,E5F35E9A8E7D375E3C2447F3147B8E3F,43761,15,16,1,32,47,1647
81347,81347,E5F35E9A8E7D375E3C2447F3147B8E3F,42523,16,18,2,31,47,1597
81371,81371,E8B3F689C349814BF5168A343AA9E985,43761,0,16,16,32,47,1647
81372,81372,E8B3F689C349814BF5168A343AA9E985,10281,17,18,1,33,48,1698
81373,81373,E8B3F689C349814BF5168A343AA9E985,43761,19,21,2,32,47,1647
81374,81374,A7CD79686A076BFDAD2F291D2D57B5D6,10251,0,13,13,35,47,1797
81375,81375,A7CD79686A076BFDAD2F291D2D57B5D6,11211,14,15,1,34,49,1749
81376,81376,A7CD79686A076BFDAD2F291D2D57B5D6,11651,16,23,7,33,47,1697
81399,81399,7C934DECF77A595DE63063184CF871A6,11381,0,18,18,30,47,1547
81400,81400,7C934DECF77A595DE63063184CF871A6,10951,19,20,1,29,48,1498
81401,81401,7C934DECF77A595DE63063184CF871A6,12121,21,23,2,29,47,1497
81407,81407,E5EFCE1214863F819E917C898BF95223,13601,1,10,9,34,47,1747
81408,81408,E5EFCE1214863F819E917C898BF95223,42231,13,14,1,37,46,1896
81409,81409,E5EFCE1214863F819E917C898BF95223,42921,14,15,1,33,47,1697
81410,81410,E5EFCE1214863F819E917C898BF95223,13601,16,23,7,34,47,1747
81426,81426,578576FA7EC025C884C550F38A47EB4E,11381,0,11,11,30,47,1547
81427,81427,578576FA7EC025C884C550F38A47EB4E,11861,13,16,3,32,47,1647
81428,81428,578576FA7EC025C884C550F38A47EB4E,11381,21,23,2,30,47,1547
81429,81429,39460D3B3D1D1C84C0C53DC37DE7FCAD,11861,0,2,2,32,47,1647
81430,81430,39460D3B3D1D1C84C0C53DC37DE7FCAD,42491,2,10,8,32,46,1646
81431,81431,39460D3B3D1D1C84C0C53DC37DE7FCAD,11861,10,23,13,32,47,1647
81444,81444,656752102BA99654C7060CE5B2133D72,49201,2,6,4,7,41,391
81445,81445,656752102BA99654C7060CE5B2133D72,12921,6,18,12,9,41,491
81446,81446,656752102BA99654C7060CE5B2133D72,19114,20,21,1,7,43,393
81452,81452,C2938F6FA2A943D6DFC754D5D6C219D6,11074,1,2,1,37,47,1897
81453,81453,C2938F6FA2A943D6DFC754D5D6C219D6,42221,5,7,2,38,48,1948
81454,81454,C2938F6FA2A943D6DFC754D5D6C219D6,11074,8,10,2,37,47,1897
81455,81455,C2938F6FA2A943D6DFC754D5D6C219D6,42221,14,22,8,38,48,1948
81466,81466,F736C39F560B9A4948E68A46A6A6DDA8,41031,0,11,11,32,49,1649
81467,81467,F736C39F560B9A4948E68A46A6A6DDA8,12381,15,16,1,32,48,1648
81468,81468,F736C39F560B9A4948E68A46A6A6DDA8,10431,17,20,3,33,49,1699
81469,81469,F736C39F560B9A4948E68A46A6A6DDA8,41031,20,23,3,32,49,1649
81473,81473,D44EDEFE20C6E53FAD2290D9CECCD593,19441,0,9,9,8,46,446
81474,81474,D44EDEFE20C6E53FAD2290D9CECCD593,42041,12,15,3,10,47,547
81475,81475,D44EDEFE20C6E53FAD2290D9CECCD593,19441,15,22,7,8,46,446
81476,81476,583602182C31C8E2D985404EA5592339,12921,9,10,1,9,41,491
81477,81477,583602182C31C8E2D985404EA5592339,12641,12,13,1,10,43,543
81478,81478,583602182C31C8E2D985404EA5592339,12921,15,18,3,9,41,491
81479,81479,EC5970EBB0B137E41374AE48E57C0F01,42151,0,17,17,35,45,1795
81480,81480,EC5970EBB0B137E41374AE48E57C0F01,12491,17,18,1,36,43,1843
81481,81481,EC5970EBB0B137E41374AE48E57C0F01,42151,18,20,2,35,45,1795
81486,81486,43DBEEA61839592A95FC32BC8064AB85,12921,0,7,7,9,41,491
81487,81487,43DBEEA61839592A95FC32BC8064AB85,12641,8,9,1,10,43,543
81488,81488,43DBEEA61839592A95FC32BC8064AB85,12921,10,23,13,9,41,491
81495,81495,4EABE655BE26B3EDCCD7B6B2C89F187F,10161,0,7,7,35,49,1799
81496,81496,4EABE655BE26B3EDCCD7B6B2C89F187F,42981,8,10,2,36,49,1849
81497,81497,4EABE655BE26B3EDCCD7B6B2C89F187F,11231,13,18,5,37,49,1899
81498,81498,4EABE655BE26B3EDCCD7B6B2C89F187F,42981,18,23,5,36,49,1849
81504,81504,04DA073551B2B36368829872415CFF4C,42041,2,3,1,10,47,547
81505,81505,04DA073551B2B36368829872415CFF4C,19441,5,6,1,8,46,446
81506,81506,04DA073551B2B36368829872415CFF4C,19111,10,14,4,9,45,495
81507,81507,04DA073551B2B36368829872415CFF4C,19441,18,20,2,8,46,446
81508,81508,37B4DBB76B7CB87E9660465ED13B1B84,11351,0,6,6,36,48,1848
81509,81509,37B4DBB76B7CB87E9660465ED13B1B84,11271,8,11,3,37,48,1898
81510,81510,37B4DBB76B7CB87E9660465ED13B1B84,40673,12,13,1,36,48,1848
81511,81511,37B4DBB76B7CB87E9660465ED13B1B84,10471,18,23,5,37,48,1898
81527,81527,2D8F7C2E000B799DCADCAEF4A15BB1AE,42471,0,6,6,35,49,1799
81528,81528,2D8F7C2E000B799DCADCAEF4A15BB1AE,42301,20,21,1,36,47,1847
81529,81529,2D8F7C2E000B799DCADCAEF4A15BB1AE,42471,21,23,2,35,49,1799
81539,81539,B20D4CCCBBF9B534BB9F26A35B371E4C,42351,8,10,2,38,45,1945
81540,81540,B20D4CCCBBF9B534BB9F26A35B371E4C,11261,12,14,2,36,46,1846
81541,81541,B20D4CCCBBF9B534BB9F26A35B371E4C,42351,14,21,7,38,45,1945
81542,81542,B20D4CCCBBF9B534BB9F26A35B371E4C,13911,22,23,1,39,46,1996
81543,81543,4C8E92DBB85921608C1C92929A7A8C92,42521,0,13,13,31,47,1597
81544,81544,4C8E92DBB85921608C1C92929A7A8C92,13651,14,17,3,30,47,1547
81545,81545,4C8E92DBB85921608C1C92929A7A8C92,42521,17,23,6,31,47,1597
81546,81546,4E8CF0BE1A57E085938ED2B5916A9E34,11381,0,4,4,30,47,1547
81547,81547,4E8CF0BE1A57E085938ED2B5916A9E34,11061,4,10,6,29,48,1498
81548,81548,4E8CF0BE1A57E085938ED2B5916A9E34,11381,10,19,9,30,47,1547
81553,81553,80138FAE3CC4EDD6A1DF29A745B18CFD,11061,0,10,10,29,48,1498
81554,81554,80138FAE3CC4EDD6A1DF29A745B18CFD,43971,10,20,10,30,48,1548
81555,81555,80138FAE3CC4EDD6A1DF29A745B18CFD,11061,21,23,2,29,48,1498
81560,81560,569FE1B0CCF701005479FDA64CAA96A2,11921,0,6,6,38,48,1948
81561,81561,569FE1B0CCF701005479FDA64CAA96A2,11074,6,8,2,37,47,1897
81562,81562,569FE1B0CCF701005479FDA64CAA96A2,11231,8,20,12,37,49,1899
81563,81563,569FE1B0CCF701005479FDA64CAA96A2,11074,22,23,1,37,47,1897
81577,81577,54C28B082733E33A64393D2DD39B9D4C,11331,2,12,10,37,48,1898
81578,81578,54C28B082733E33A64393D2DD39B9D4C,12511,14,15,1,39,47,1997
81579,81579,54C28B082733E33A64393D2DD39B9D4C,10841,16,22,6,37,47,1897
81591,81591,01ECD1CDD40C56FDD4C9E2DD4654EC59,12131,0,6,6,32,47,1647
81592,81592,01ECD1CDD40C56FDD4C9E2DD4654EC59,42491,7,9,2,32,46,1646
81593,81593,01ECD1CDD40C56FDD4C9E2DD4654EC59,42523,9,10,1,31,47,1597
81594,81594,01ECD1CDD40C56FDD4C9E2DD4654EC59,42491,10,19,9,32,46,1646
81611,81611,5D73BD5A7332EC90465F9B3A4E4A40FF,13911,0,8,8,39,46,1996
81612,81612,5D73BD5A7332EC90465F9B3A4E4A40FF,11261,8,10,2,36,46,1846
81613,81613,5D73BD5A7332EC90465F9B3A4E4A40FF,13911,12,23,11,39,46,1996
81619,81619,9951832C875ED15346443116F8C6A7D1,10811,4,8,4,38,46,1946
81620,81620,9951832C875ED15346443116F8C6A7D1,41601,12,13,1,39,49,1999
81621,81621,9951832C875ED15346443116F8C6A7D1,12511,15,16,1,39,47,1997
81622,81622,9951832C875ED15346443116F8C6A7D1,42331,18,23,5,39,46,1996
81623,81623,A573FF285872EC96818445928AD4461A,13671,1,11,10,27,43,1393
81624,81624,A573FF285872EC96818445928AD4461A,11281,12,17,5,27,40,1390
81625,81625,A573FF285872EC96818445928AD4461A,13671,20,22,2,27,43,1393
81626,81626,4395C6E2ABA59930045C5FB0134BA180,10711,0,6,6,29,46,1496
81627,81627,4395C6E2ABA59930045C5FB0134BA180,10301,7,16,9,31,45,1595
81628,81628,4395C6E2ABA59930045C5FB0134BA180,12311,16,17,1,30,44,1544
81629,81629,4395C6E2ABA59930045C5FB0134BA180,10711,18,23,5,29,46,1496
81630,81630,EE10AC6477FFD3D50107E111E624E05D,11171,0,5,5,33,48,1698
81631,81631,EE10AC6477FFD3D50107E111E624E05D,11161,7,12,5,32,48,1648
81632,81632,EE10AC6477FFD3D50107E111E624E05D,11911,14,17,3,37,48,1898
81633,81633,EE10AC6477FFD3D50107E111E624E05D,11751,21,22,1,35,48,1798
81638,81638,9421785C23DB2EEC47D688EC2758883C,11061,0,10,10,29,48,1498
81639,81639,9421785C23DB2EEC47D688EC2758883C,11151,11,15,4,30,48,1548
81640,81640,9421785C23DB2EEC47D688EC2758883C,11061,17,23,6,29,48,1498
81641,81641,A0C13743AF441FE8099AA940DA71C612,42581,0,5,5,38,48,1948
81642,81642,A0C13743AF441FE8099AA940DA71C612,11914,6,8,2,37,48,1898
81643,81643,A0C13743AF441FE8099AA940DA71C612,42581,8,22,14,38,48,1948
81649,81649,CA4C02B9DB2D587FF148E8FB8B133305,10691,0,6,6,33,48,1698
81650,81650,CA4C02B9DB2D587FF148E8FB8B133305,11861,8,16,8,32,47,1647
81651,81651,CA4C02B9DB2D587FF148E8FB8B133305,10691,19,23,4,33,48,1698
81656,81656,F118442650FD85FBD1BC14112D7133A6,43391,0,5,5,29,48,1498
81657,81657,F118442650FD85FBD1BC14112D7133A6,11151,9,10,1,30,48,1548
81658,81658,F118442650FD85FBD1BC14112D7133A6,43391,12,22,10,29,48,1498
81662,81662,424D0A20B5E3D2E48868270169C25711,13911,0,14,14,39,46,1996
81663,81663,424D0A20B5E3D2E48868270169C25711,11261,17,18,1,36,46,1846
81664,81664,424D0A20B5E3D2E48868270169C25711,13911,19,23,4,39,46,1996
81665,81665,5C961B34839ED84B6E047E07B59EEE35,12311,0,15,15,30,44,1544
81666,81666,5C961B34839ED84B6E047E07B59EEE35,42531,15,16,1,31,45,1595
81667,81667,5C961B34839ED84B6E047E07B59EEE35,12311,18,22,4,30,44,1544
81668,81668,62343CB5CF1337E48C53ADD9F743555A,10271,0,15,15,37,46,1896
81669,81669,62343CB5CF1337E48C53ADD9F743555A,42011,17,20,3,36,46,1846
81670,81670,62343CB5CF1337E48C53ADD9F743555A,13121,21,22,1,38,46,1946
81671,81671,549B8A34E419FBD57213E9641A5E14A7,10681,0,13,13,30,48,1548
81672,81672,549B8A34E419FBD57213E9641A5E14A7,11061,13,18,5,29,48,1498
81673,81673,549B8A34E419FBD57213E9641A5E14A7,10681,18,22,4,30,48,1548
81679,81679,209CBAFCECFCFAF5ADEC7A13A8F80FC5,12641,0,2,2,10,43,543
81680,81680,209CBAFCECFCFAF5ADEC7A13A8F80FC5,19931,5,8,3,7,43,393
81681,81681,209CBAFCECFCFAF5ADEC7A13A8F80FC5,12641,9,13,4,10,43,543
81682,81682,209CBAFCECFCFAF5ADEC7A13A8F80FC5,19114,16,23,7,7,43,393
81690,81690,3904BFA0DAEEBCA85365DF524DB867F2,12641,5,13,8,10,43,543
81691,81691,3904BFA0DAEEBCA85365DF524DB867F2,12921,13,17,4,9,41,491
81692,81692,3904BFA0DAEEBCA85365DF524DB867F2,12641,19,23,4,10,43,543
81701,81701,723595B0078E82B6D42E3B2563991C87,42481,0,1,1,22,49,1149
81702,81702,723595B0078E82B6D42E3B2563991C87,12051,1,2,1,20,47,1047
81703,81703,723595B0078E82B6D42E3B2563991C87,42481,3,23,20,22,49,1149
81704,81704,F7087CE4172294976486633513D283BE,10901,0,7,7,35,48,1798
81705,81705,F7087CE4172294976486633513D283BE,10221,8,18,10,34,49,1749
81706,81706,F7087CE4172294976486633513D283BE,10901,21,22,1,35,48,1798
81712,81712,EC91333AF84442F0E91224725B19E84F,12514,0,7,7,38,47,1947
81713,81713,EC91333AF84442F0E91224725B19E84F,10841,9,12,3,37,47,1897
81714,81714,EC91333AF84442F0E91224725B19E84F,12514,16,23,7,38,47,1947
81719,81719,5286A29EF2DEDE42572B77FE3AFBCCAE,43671,0,9,9,35,48,1798
81720,81720,5286A29EF2DEDE42572B77FE3AFBCCAE,10161,13,16,3,35,49,1799
81721,81721,5286A29EF2DEDE42572B77FE3AFBCCAE,42511,17,23,6,37,47,1897
81727,81727,790F7EEE0996417CBD85774614899657,42523,0,11,11,31,47,1597
81728,81728,790F7EEE0996417CBD85774614899657,43761,15,17,2,32,47,1647
81729,81729,790F7EEE0996417CBD85774614899657,42523,17,22,5,31,47,1597
81740,81740,E191A4A4FB39AEE62DAC5F9CA16A7F16,12381,0,8,8,32,48,1648
81741,81741,E191A4A4FB39AEE62DAC5F9CA16A7F16,10401,9,10,1,33,49,1699
81742,81742,E191A4A4FB39AEE62DAC5F9CA16A7F16,10721,12,20,8,31,48,1598
81743,81743,E191A4A4FB39AEE62DAC5F9CA16A7F16,10251,20,22,2,35,47,1797
81744,81744,989AAA1F82E78DB292023B4E64D313D5,43761,7,13,6,32,47,1647
81745,81745,989AAA1F82E78DB292023B4E64D313D5,11324,13,14,1,31,46,1596
81746,81746,989AAA1F82E78DB292023B4E64D313D5,43761,16,23,7,32,47,1647
81751,81751,787E2D15898542A785C91CF72E674285,11261,9,11,2,36,46,1846
81752,81752,787E2D15898542A785C91CF72E674285,13911,12,13,1,39,46,1996
81753,81753,787E2D15898542A785C91CF72E674285,11261,13,18,5,36,46,1846
81754,81754,787E2D15898542A785C91CF72E674285,42231,19,21,2,37,46,1896
81758,81758,ABA31A886DA5135F00BAFC3DAD048D98,41551,0,6,6,37,46,1896
81759,81759,ABA31A886DA5135F00BAFC3DAD048D98,11021,7,17,10,36,49,1849
81760,81760,ABA31A886DA5135F00BAFC3DAD048D98,41551,19,23,4,37,46,1896
81767,81767,7F73A642AA11134206C46BA15C785E40,13651,10,12,2,30,47,1547
81768,81768,7F73A642AA11134206C46BA15C785E40,42521,12,20,8,31,47,1597
81769,81769,7F73A642AA11134206C46BA15C785E40,10292,20,23,3,30,47,1547
81773,81773,D89FED8D48E76D779C5E605DC68EC18A,13101,0,16,16,40,47,2047
81774,81774,D89FED8D48E76D779C5E605DC68EC18A,11481,17,18,1,41,48,2098
81775,81775,D89FED8D48E76D779C5E605DC68EC18A,13101,18,21,3,40,47,2047
81784,81784,56380B9BCFA6857A7D3E4BBFC0E5BBBD,12514,1,12,11,38,47,1947
81785,81785,56380B9BCFA6857A7D3E4BBFC0E5BBBD,10107,14,16,2,38,49,1949
81786,81786,56380B9BCFA6857A7D3E4BBFC0E5BBBD,11074,20,22,2,37,47,1897
81796,81796,FACA7C472055342CB52356ECCA18D789,11261,2,10,8,36,46,1846
81797,81797,FACA7C472055342CB52356ECCA18D789,13841,13,18,5,40,46,2046
81798,81798,FACA7C472055342CB52356ECCA18D789,42864,18,23,5,38,44,1944
81808,81808,D1EDBC8A7CBCF315A3398D0F851335FF,42521,0,7,7,31,47,1597
81809,81809,D1EDBC8A7CBCF315A3398D0F851335FF,11381,9,12,3,30,47,1547
81810,81810,D1EDBC8A7CBCF315A3398D0F851335FF,42521,13,15,2,31,47,1597
81811,81811,D1EDBC8A7CBCF315A3398D0F851335FF,13651,17,23,6,30,47,1547
81812,81812,5ED8949BAC5CDF05EDA1019FB7CA4B17,42401,0,7,7,36,47,1847
81813,81813,5ED8949BAC5CDF05EDA1019FB7CA4B17,42941,8,12,4,37,47,1897
81814,81814,5ED8949BAC5CDF05EDA1019FB7CA4B17,10471,13,18,5,37,48,1898
81815,81815,5ED8949BAC5CDF05EDA1019FB7CA4B17,42401,21,23,2,36,47,1847
81826,81826,6ED433042C77F1E28C46EF69F3C807F1,11324,0,3,3,31,46,1596
81827,81827,6ED433042C77F1E28C46EF69F3C807F1,13651,3,6,3,30,47,1547
81828,81828,6ED433042C77F1E28C46EF69F3C807F1,42523,8,9,1,31,47,1597
81829,81829,6ED433042C77F1E28C46EF69F3C807F1,11324,11,23,12,31,46,1596
81833,81833,2CAEA5E29EC045ABED8FBD60EF3344BD,42051,0,14,14,42,48,2148
81834,81834,2CAEA5E29EC045ABED8FBD60EF3344BD,40302,19,20,1,40,49,2049
81835,81835,2CAEA5E29EC045ABED8FBD60EF3344BD,11301,20,23,3,41,49,2099
81839,81839,126162ECBF6FFF8221A9EA429962799B,42021,0,1,1,33,47,1697
81840,81840,126162ECBF6FFF8221A9EA429962799B,13601,1,6,5,34,47,1747
81841,81841,126162ECBF6FFF8221A9EA429962799B,10731,7,20,13,33,47,1697
81847,81847,3F7BC333AFC8445B1A1F538D40A9EDC8,41721,0,12,12,39,48,1998
81848,81848,3F7BC333AFC8445B1A1F538D40A9EDC8,12401,15,16,1,39,49,1999
81849,81849,3F7BC333AFC8445B1A1F538D40A9EDC8,41721,20,23,3,39,48,1998
81850,81850,55536669E97AF41ACDE427113BB85731,10691,0,6,6,33,48,1698
81851,81851,55536669E97AF41ACDE427113BB85731,42021,6,8,2,33,47,1697
81852,81852,55536669E97AF41ACDE427113BB85731,11861,8,17,9,32,47,1647
81853,81853,55536669E97AF41ACDE427113BB85731,10691,19,23,4,33,48,1698
81854,81854,B304D2AD98C7DE24CAE6DD0DA65095F0,10431,0,6,6,33,49,1699
81855,81855,B304D2AD98C7DE24CAE6DD0DA65095F0,43581,8,18,10,33,48,1698
81856,81856,B304D2AD98C7DE24CAE6DD0DA65095F0,10431,18,19,1,33,49,1699
81857,81857,D65506EDDA59637632B53755416666C4,11914,1,6,5,37,48,1898
81858,81858,D65506EDDA59637632B53755416666C4,40171,6,9,3,38,48,1948
81859,81859,D65506EDDA59637632B53755416666C4,10471,9,17,8,37,48,1898
81860,81860,D65506EDDA59637632B53755416666C4,43181,19,21,2,39,48,1998
81880,81880,8BB9A57F2CBAC67D578F604CA3E66E31,12641,0,10,10,10,43,543
81881,81881,8BB9A57F2CBAC67D578F604CA3E66E31,19931,14,15,1,7,43,393
81882,81882,8BB9A57F2CBAC67D578F604CA3E66E31,12641,16,23,7,10,43,543
81889,81889,97CABD5CA4B44BD80C3C863536728BE4,11061,1,9,8,29,48,1498
81890,81890,97CABD5CA4B44BD80C3C863536728BE4,11871,12,18,6,29,46,1496
81891,81891,97CABD5CA4B44BD80C3C863536728BE4,11161,19,20,1,32,48,1648
81892,81892,97CABD5CA4B44BD80C3C863536728BE4,11061,21,22,1,29,48,1498
81904,81904,3C5D029D57650D7A9CE83503042F1003,11261,3,10,7,36,46,1846
81905,81905,3C5D029D57650D7A9CE83503042F1003,42864,12,14,2,38,44,1944
81906,81906,3C5D029D57650D7A9CE83503042F1003,11261,16,19,3,36,46,1846
81922,81922,1788FF83230593384DFEF88881720D90,13551,0,14,14,45,38,2288
81923,81923,1788FF83230593384DFEF88881720D90,43101,15,17,2,46,40,2340
81924,81924,1788FF83230593384DFEF88881720D90,13551,19,23,4,45,38,2288
81925,81925,11C5ACA60B0246DE7069023057E8285F,11381,1,2,1,30,47,1547
81926,81926,11C5ACA60B0246DE7069023057E8285F,11061,5,7,2,29,48,1498
81927,81927,11C5ACA60B0246DE7069023057E8285F,11381,7,22,15,30,47,1547
81928,81928,A95D3C43846ED9E8AFEBF9E543D757C0,42261,3,5,2,25,49,1299
81929,81929,A95D3C43846ED9E8AFEBF9E543D757C0,42121,7,10,3,26,49,1349
81930,81930,A95D3C43846ED9E8AFEBF9E543D757C0,42623,16,17,1,22,49,1149
81931,81931,A95D3C43846ED9E8AFEBF9E543D757C0,42261,20,21,1,25,49,1299
81940,81940,0DFD98C5BF618352145AEF64606DF221,10251,0,1,1,35,47,1797
81941,81941,0DFD98C5BF618352145AEF64606DF221,40673,2,14,12,36,48,1848
81942,81942,0DFD98C5BF618352145AEF64606DF221,10251,18,20,2,35,47,1797
81943,81943,0DFD98C5BF618352145AEF64606DF221,42161,21,23,2,36,47,1847
81973,81973,0B0C484648E394F0957A2456A9D7D6EE,10471,0,18,18,37,48,1898
81974,81974,0B0C484648E394F0957A2456A9D7D6EE,12021,20,22,2,37,49,1899
81975,81975,0B0C484648E394F0957A2456A9D7D6EE,10471,22,23,1,37,48,1898
81979,81979,3717F18D88C40095DBADE8C95C390E6F,42151,1,7,6,35,45,1795
81980,81980,3717F18D88C40095DBADE8C95C390E6F,42861,9,16,7,37,44,1894
81981,81981,3717F18D88C40095DBADE8C95C390E6F,42151,17,19,2,35,45,1795
81982,81982,3717F18D88C40095DBADE8C95C390E6F,42861,19,21,2,37,44,1894
81983,81983,E6AC57452A564977FA8F4CD52CD9B295,10281,0,8,8,33,48,1698
81984,81984,E6AC57452A564977FA8F4CD52CD9B295,11861,9,13,4,32,47,1647
81985,81985,E6AC57452A564977FA8F4CD52CD9B295,11201,16,21,5,35,49,1799
81986,81986,E6AC57452A564977FA8F4CD52CD9B295,11861,22,23,1,32,47,1647
81995,81995,EA46C909D251A8107C806BAA047F877F,10471,0,20,20,37,48,1898
81996,81996,EA46C909D251A8107C806BAA047F877F,10107,20,22,2,38,49,1949
81997,81997,EA46C909D251A8107C806BAA047F877F,10471,22,23,1,37,48,1898
82005,82005,252F5474EB4D177E10B6FFBBE472E0CE,42491,3,7,4,32,46,1646
82006,82006,252F5474EB4D177E10B6FFBBE472E0CE,42523,10,11,1,31,47,1597
82007,82007,252F5474EB4D177E10B6FFBBE472E0CE,11861,14,18,4,32,47,1647
82008,82008,252F5474EB4D177E10B6FFBBE472E0CE,42523,19,21,2,31,47,1597
82014,82014,31D4ECBF6E20300058A6DBF4B1DCA2FB,42491,0,5,5,32,46,1646
82015,82015,31D4ECBF6E20300058A6DBF4B1DCA2FB,42523,5,6,1,31,47,1597
82016,82016,31D4ECBF6E20300058A6DBF4B1DCA2FB,42491,10,23,13,32,46,1646
82025,82025,20A7975366758E3C48A8CB4E3CD0626C,40343,0,3,3,24,49,1249
82026,82026,20A7975366758E3C48A8CB4E3CD0626C,42121,5,8,3,26,49,1349
82027,82027,20A7975366758E3C48A8CB4E3CD0626C,40343,9,23,14,24,49,1249
82028,82028,F6F2E45DD62CF36C9B7066251C572F8C,42331,6,7,1,39,46,1996
82029,82029,F6F2E45DD62CF36C9B7066251C572F8C,13121,8,15,7,38,46,1946
82030,82030,F6F2E45DD62CF36C9B7066251C572F8C,42331,19,23,4,39,46,1996
82031,82031,4A1082E29116D07A4EA830C32D0BE5ED,12221,3,8,5,43,44,2194
82032,82032,4A1082E29116D07A4EA830C32D0BE5ED,43061,9,11,2,43,46,2196
82033,82033,4A1082E29116D07A4EA830C32D0BE5ED,12221,11,18,7,43,44,2194
82038,82038,DFE0075BA441F09CC854C6FA18C2E9B5,11771,0,12,12,39,49,1999
82039,82039,DFE0075BA441F09CC854C6FA18C2E9B5,10107,13,16,3,38,49,1949
82040,82040,DFE0075BA441F09CC854C6FA18C2E9B5,11541,20,21,1,35,49,1799
82049,82049,B768DBD477008511AD969C6F4C6366B9,13711,0,8,8,38,46,1946
82050,82050,B768DBD477008511AD969C6F4C6366B9,10601,12,15,3,39,47,1997
82051,82051,B768DBD477008511AD969C6F4C6366B9,43241,16,18,2,36,46,1846
82052,82052,B768DBD477008511AD969C6F4C6366B9,10601,18,23,5,39,47,1997
82057,82057,092562E2CBCE611C68882CF0D9F5ED81,10471,0,7,7,37,48,1898
82058,82058,092562E2CBCE611C68882CF0D9F5ED81,40171,8,17,9,38,48,1948
82059,82059,092562E2CBCE611C68882CF0D9F5ED81,10471,20,23,3,37,48,1898
82065,82065,1522BDE7E05C3ADAA9D8391F632D7715,12051,0,1,1,20,47,1047
82066,82066,1522BDE7E05C3ADAA9D8391F632D7715,11361,2,14,12,22,48,1148
82067,82067,1522BDE7E05C3ADAA9D8391F632D7715,12051,15,21,6,20,47,1047
82068,82068,1522BDE7E05C3ADAA9D8391F632D7715,11361,21,23,2,22,48,1148
82087,82087,7EBD3BA762C40F1F8A712F803B7D8FD3,12491,2,8,6,36,43,1843
82088,82088,7EBD3BA762C40F1F8A712F803B7D8FD3,42151,12,13,1,35,45,1795
82089,82089,7EBD3BA762C40F1F8A712F803B7D8FD3,12491,18,20,2,36,43,1843
82090,82090,7EBD3BA762C40F1F8A712F803B7D8FD3,42151,20,22,2,35,45,1795
82091,82091,29643C32A0C3FBD67B93DF4C5B7A6C36,13561,1,5,4,37,49,1899
82092,82092,29643C32A0C3FBD67B93DF4C5B7A6C36,10221,8,15,7,34,49,1749
82093,82093,29643C32A0C3FBD67B93DF4C5B7A6C36,11751,18,20,2,35,48,1798
82094,82094,29643C32A0C3FBD67B93DF4C5B7A6C36,13561,21,22,1,37,49,1899
82095,82095,5E3291503FC27DAA0248AA453FC4D60A,19441,0,15,15,8,46,446
82096,82096,5E3291503FC27DAA0248AA453FC4D60A,19901,19,21,2,7,44,394
82097,82097,5E3291503FC27DAA0248AA453FC4D60A,19114,21,23,2,7,43,393
82105,82105,A160A99688F6A3E3A737C48C3841F6D3,43391,0,8,8,29,48,1498
82106,82106,A160A99688F6A3E3A737C48C3841F6D3,11151,9,14,5,30,48,1548
82107,82107,A160A99688F6A3E3A737C48C3841F6D3,43391,14,23,9,29,48,1498
82118,82118,545B57FE377B53DF15322A3E629D81E6,12921,0,13,13,9,41,491
82119,82119,545B57FE377B53DF15322A3E629D81E6,49201,15,19,4,7,41,391
82120,82120,545B57FE377B53DF15322A3E629D81E6,12921,21,22,1,9,41,491
82126,82126,C7DA09D84BB6D5A3ABEAD976C8C0731E,42861,0,13,13,37,44,1894
82127,82127,C7DA09D84BB6D5A3ABEAD976C8C0731E,11261,17,18,1,36,46,1846
82128,82128,C7DA09D84BB6D5A3ABEAD976C8C0731E,42861,19,23,4,37,44,1894
82140,82140,02E0F712E80A642B0486CBB8817B053B,40124,0,6,6,38,47,1947
82141,82141,02E0F712E80A642B0486CBB8817B053B,42301,7,9,2,36,47,1847
82142,82142,02E0F712E80A642B0486CBB8817B053B,40124,13,14,1,38,47,1947
82143,82143,02E0F712E80A642B0486CBB8817B053B,11074,17,19,2,37,47,1897
82148,82148,64A2E9501F429B6DEC66E8EE627CCABA,10341,0,1,1,31,47,1597
82149,82149,64A2E9501F429B6DEC66E8EE627CCABA,11061,2,7,5,29,48,1498
82150,82150,64A2E9501F429B6DEC66E8EE627CCABA,10301,8,18,10,31,45,1595
82151,82151,64A2E9501F429B6DEC66E8EE627CCABA,10341,20,23,3,31,47,1597
82156,82156,F2229754FABF7F398D6839D6208AC86F,10544,0,8,8,28,48,1448
82157,82157,F2229754FABF7F398D6839D6208AC86F,10381,9,10,1,31,49,1599
82158,82158,F2229754FABF7F398D6839D6208AC86F,10544,12,23,11,28,48,1448
82182,82182,BCC7CAF7B764321F1A86DF2CDDCB9F66,11861,0,1,1,32,47,1647
82183,82183,BCC7CAF7B764321F1A86DF2CDDCB9F66,42521,1,5,4,31,47,1597
82184,82184,BCC7CAF7B764321F1A86DF2CDDCB9F66,11861,6,22,16,32,47,1647
82185,82185,181B5103F0FBF120AFF5BEC3A26A3DB7,11161,4,6,2,32,48,1648
82186,82186,181B5103F0FBF120AFF5BEC3A26A3DB7,10281,7,22,15,33,48,1698
82187,82187,181B5103F0FBF120AFF5BEC3A26A3DB7,43761,22,23,1,32,47,1647
82188,82188,8D6D823064688A853913E29A2D4620F5,13331,0,6,6,38,47,1947
82189,82189,8D6D823064688A853913E29A2D4620F5,42511,8,9,1,37,47,1897
82190,82190,8D6D823064688A853913E29A2D4620F5,42161,16,18,2,36,47,1847
82191,82191,8D6D823064688A853913E29A2D4620F5,11231,18,20,2,37,49,1899
82192,82192,E1C859FD8CC74565ED07635B54DBAB6A,42021,1,4,3,33,47,1697
82193,82193,E1C859FD8CC74565ED07635B54DBAB6A,42141,8,13,5,32,47,1647
82194,82194,E1C859FD8CC74565ED07635B54DBAB6A,10281,18,20,2,33,48,1698
82195,82195,E1C859FD8CC74565ED07635B54DBAB6A,43761,20,21,1,32,47,1647
82207,82207,D8963F7C81A647B0DB7A8BBF70036A0B,12514,1,3,2,38,47,1947
82208,82208,D8963F7C81A647B0DB7A8BBF70036A0B,42221,6,7,1,38,48,1948
82209,82209,D8963F7C81A647B0DB7A8BBF70036A0B,10471,8,17,9,37,48,1898
82210,82210,D8963F7C81A647B0DB7A8BBF70036A0B,11231,20,22,2,37,49,1899
82211,82211,55533B9612A041F560AB09E0A0C2A735,10251,0,17,17,35,47,1797
82212,82212,55533B9612A041F560AB09E0A0C2A735,42161,19,21,2,36,47,1847
82213,82213,55533B9612A041F560AB09E0A0C2A735,10251,21,23,2,35,47,1797
82226,82226,E3364A6DFAAAA828191D53876E64EA24,11001,0,7,7,42,47,2147
82227,82227,E3364A6DFAAAA828191D53876E64EA24,13941,8,9,1,41,47,2097
82228,82228,E3364A6DFAAAA828191D53876E64EA24,11001,11,23,12,42,47,2147
82232,82232,ED14F75680A1780D0C6AF7290516296F,10281,0,7,7,33,48,1698
82233,82233,ED14F75680A1780D0C6AF7290516296F,43661,12,13,1,33,47,1697
82234,82234,ED14F75680A1780D0C6AF7290516296F,10971,15,16,1,35,47,1797
82235,82235,ED14F75680A1780D0C6AF7290516296F,10281,18,23,5,33,48,1698
82243,82243,E1E6D95163BDAF1716B81C1147ABBFDE,40637,0,7,7,36,47,1847
82244,82244,E1E6D95163BDAF1716B81C1147ABBFDE,10251,12,14,2,35,47,1797
82245,82245,E1E6D95163BDAF1716B81C1147ABBFDE,40463,16,21,5,38,49,1949
82249,82249,990529BE48C6A8DFFA6A404F72B17A5A,11261,0,9,9,36,46,1846
82250,82250,990529BE48C6A8DFFA6A404F72B17A5A,42151,11,13,2,35,45,1795
82251,82251,990529BE48C6A8DFFA6A404F72B17A5A,42861,15,20,5,37,44,1894
82252,82252,7D0B5FCD22D145BBE916FD977FC9A1B6,10111,0,14,14,37,47,1897
82253,82253,7D0B5FCD22D145BBE916FD977FC9A1B6,13221,15,16,1,40,47,2047
82254,82254,7D0B5FCD22D145BBE916FD977FC9A1B6,10111,16,23,7,37,47,1897
82258,82258,C172ECEA2F7AF9729D921F01FE2F1A6B,40171,1,18,17,38,48,1948
82259,82259,C172ECEA2F7AF9729D921F01FE2F1A6B,43171,19,20,1,39,49,1999
82260,82260,C172ECEA2F7AF9729D921F01FE2F1A6B,11921,21,23,2,38,48,1948
82261,82261,465F3F33695B045A4D5264F2EED2A7ED,43341,0,9,9,41,46,2096
82262,82262,465F3F33695B045A4D5264F2EED2A7ED,42204,9,16,7,43,46,2196
82263,82263,465F3F33695B045A4D5264F2EED2A7ED,43341,18,23,5,41,46,2096
82264,82264,194BE7C669F8B10039EECF2EE1F7AB5A,10681,0,10,10,30,48,1548
82265,82265,194BE7C669F8B10039EECF2EE1F7AB5A,10292,11,18,7,30,47,1547
82266,82266,194BE7C669F8B10039EECF2EE1F7AB5A,11861,18,20,2,32,47,1647
82267,82267,194BE7C669F8B10039EECF2EE1F7AB5A,10292,21,23,2,30,47,1547
82301,82301,F270E2429049EC12B817A3B7398AF53A,10111,0,13,13,37,47,1897
82302,82302,F270E2429049EC12B817A3B7398AF53A,42151,14,21,7,35,45,1795
82303,82303,F270E2429049EC12B817A3B7398AF53A,11074,21,22,1,37,47,1897
82313,82313,9EF2E337C6D77F71D8F5E64DA4E76CDC,42461,0,6,6,45,47,2297
82314,82314,9EF2E337C6D77F71D8F5E64DA4E76CDC,42321,6,8,2,43,47,2197
82315,82315,9EF2E337C6D77F71D8F5E64DA4E76CDC,42461,11,12,1,45,47,2297
82316,82316,9EF2E337C6D77F71D8F5E64DA4E76CDC,10801,21,23,2,42,47,2147
82317,82317,9C47145209ECFC40DF20CE0BFE35E37E,43761,0,6,6,32,47,1647
82318,82318,9C47145209ECFC40DF20CE0BFE35E37E,42523,6,8,2,31,47,1597
82319,82319,9C47145209ECFC40DF20CE0BFE35E37E,43761,9,23,14,32,47,1647
82326,82326,E0F1670DB5561200EEDBAB1833327673,11074,0,9,9,37,47,1897
82327,82327,E0F1670DB5561200EEDBAB1833327673,11921,10,12,2,38,48,1948
82328,82328,E0F1670DB5561200EEDBAB1833327673,10111,12,23,11,37,47,1897
82329,82329,B7783E40C231BF2A915C5200F2E2562A,12031,0,9,9,33,48,1698
82330,82330,B7783E40C231BF2A915C5200F2E2562A,10901,9,11,2,35,48,1798
82331,82331,B7783E40C231BF2A915C5200F2E2562A,40951,14,19,5,36,49,1849
82332,82332,B7783E40C231BF2A915C5200F2E2562A,10491,19,22,3,33,48,1698
82333,82333,88182B8F0A08A7B6CD3790FE87C79F47,42351,0,1,1,38,45,1945
82334,82334,88182B8F0A08A7B6CD3790FE87C79F47,42231,6,14,8,37,46,1896
82335,82335,88182B8F0A08A7B6CD3790FE87C79F47,42351,14,18,4,38,45,1945
82336,82336,88182B8F0A08A7B6CD3790FE87C79F47,42231,18,22,4,37,46,1896
82351,82351,8B6448FD7DB9F8E2F8F73AFDDD5BFD38,10634,0,10,10,27,45,1395
82352,82352,8B6448FD7DB9F8E2F8F73AFDDD5BFD38,11871,14,15,1,29,46,1496
82353,82353,8B6448FD7DB9F8E2F8F73AFDDD5BFD38,10634,15,22,7,27,45,1395
82354,82354,56547DCD12E76D718E2E60F15A40B9D5,42401,0,8,8,36,47,1847
82355,82355,56547DCD12E76D718E2E60F15A40B9D5,10781,9,18,9,35,47,1797
82356,82356,56547DCD12E76D718E2E60F15A40B9D5,42161,19,23,4,36,47,1847
82371,82371,94208362745F4CC8136A1624AA480486,10161,0,11,11,35,49,1799
82372,82372,94208362745F4CC8136A1624AA480486,40951,12,19,7,36,49,1849
82373,82373,94208362745F4CC8136A1624AA480486,10161,19,22,3,35,49,1799
82374,82374,7FAF74A680E5BB19478DB9AF96C6BAA5,13111,0,11,11,42,46,2146
82375,82375,7FAF74A680E5BB19478DB9AF96C6BAA5,42204,13,14,1,43,46,2196
82376,82376,7FAF74A680E5BB19478DB9AF96C6BAA5,13111,15,23,8,42,46,2146
82389,82389,E45BFF8A7B42DBE312092B84982F68A3,11861,0,8,8,32,47,1647
82390,82390,E45BFF8A7B42DBE312092B84982F68A3,11871,10,18,8,29,46,1496
82391,82391,E45BFF8A7B42DBE312092B84982F68A3,11861,19,23,4,32,47,1647
82392,82392,6166F4BC9B2530F6FDAD5A0233FBAAD6,42581,4,5,1,38,48,1948
82393,82393,6166F4BC9B2530F6FDAD5A0233FBAAD6,10471,6,18,12,37,48,1898
82394,82394,6166F4BC9B2530F6FDAD5A0233FBAAD6,42581,18,20,2,38,48,1948
82402,82402,3717CE6F5FBC18B9A1CE5DBD5E4997A5,11061,3,9,6,29,48,1498
82403,82403,3717CE6F5FBC18B9A1CE5DBD5E4997A5,10691,11,12,1,33,48,1698
82404,82404,3717CE6F5FBC18B9A1CE5DBD5E4997A5,43971,14,16,2,30,48,1548
82405,82405,3717CE6F5FBC18B9A1CE5DBD5E4997A5,11061,18,20,2,29,48,1498
82416,82416,035266CFE514B2CE8084B5CCD3E8A0F1,10841,4,14,10,37,47,1897
82417,82417,035266CFE514B2CE8084B5CCD3E8A0F1,11731,18,19,1,36,48,1848
82418,82418,035266CFE514B2CE8084B5CCD3E8A0F1,11074,20,21,1,37,47,1897
82419,82419,B9E52D07F5AA84B0FEC3B2146C780B6A,11231,0,2,2,37,49,1899
82420,82420,B9E52D07F5AA84B0FEC3B2146C780B6A,11271,2,6,4,37,48,1898
82421,82421,B9E52D07F5AA84B0FEC3B2146C780B6A,11231,7,23,16,37,49,1899
82436,82436,3C4F290E088B2251F5A11549B4DEDAFC,12514,0,14,14,38,47,1947
82437,82437,3C4F290E088B2251F5A11549B4DEDAFC,10841,16,20,4,37,47,1897
82438,82438,3C4F290E088B2251F5A11549B4DEDAFC,40123,21,23,2,38,47,1947
82439,82439,36E4D456967ADF7C503C23EAE8460AAD,42523,4,7,3,31,47,1597
82440,82440,36E4D456967ADF7C503C23EAE8460AAD,13651,9,14,5,30,47,1547
82441,82441,36E4D456967ADF7C503C23EAE8460AAD,42523,18,19,1,31,47,1597
82442,82442,88EEF011B39BD7B890A7EF6400B4EB8C,11074,3,10,7,37,47,1897
82443,82443,88EEF011B39BD7B890A7EF6400B4EB8C,42221,11,13,2,38,48,1948
82444,82444,88EEF011B39BD7B890A7EF6400B4EB8C,12514,15,17,2,38,47,1947
82445,82445,88EEF011B39BD7B890A7EF6400B4EB8C,11074,17,21,4,37,47,1897
82446,82446,3DABBE7AD4BBA6D6461EC91F04F7CCEC,42461,0,6,6,45,47,2297
82447,82447,3DABBE7AD4BBA6D6461EC91F04F7CCEC,42321,6,15,9,43,47,2197
82448,82448,3DABBE7AD4BBA6D6461EC91F04F7CCEC,43621,16,17,1,46,48,2348
82449,82449,3DABBE7AD4BBA6D6461EC91F04F7CCEC,42461,20,22,2,45,47,2297
82450,82450,2CF73DDA8C5E74B4300779F1FD471C57,12491,0,7,7,36,43,1843
82451,82451,2CF73DDA8C5E74B4300779F1FD471C57,11261,7,12,5,36,46,1846
82452,82452,2CF73DDA8C5E74B4300779F1FD471C57,12491,12,23,11,36,43,1843
82456,82456,F18C7871BFB82CA1A349E44A5DE6D0B7,11021,6,13,7,36,49,1849
82457,82457,F18C7871BFB82CA1A349E44A5DE6D0B7,10221,15,16,1,34,49,1749
82458,82458,F18C7871BFB82CA1A349E44A5DE6D0B7,11021,18,23,5,36,49,1849
82462,82462,2F1464FA3DE631911E14FF6E04C24354,10841,0,10,10,37,47,1897
82463,82463,2F1464FA3DE631911E14FF6E04C24354,10331,12,13,1,39,46,1996
82464,82464,2F1464FA3DE631911E14FF6E04C24354,10601,13,15,2,39,47,1997
82465,82465,2F1464FA3DE631911E14FF6E04C24354,10841,17,23,6,37,47,1897
82469,82469,ED7D6E0D6245554973BF1FC4EA5C6C28,11151,0,7,7,30,48,1548
82470,82470,ED7D6E0D6245554973BF1FC4EA5C6C28,11061,12,13,1,29,48,1498
82471,82471,ED7D6E0D6245554973BF1FC4EA5C6C28,11151,13,20,7,30,48,1548
82472,82472,ED7D6E0D6245554973BF1FC4EA5C6C28,11061,22,23,1,29,48,1498
82473,82473,CCF51F527C0699CB645C6D016C6FE2F5,42581,0,1,1,38,48,1948
82474,82474,CCF51F527C0699CB645C6D016C6FE2F5,11914,5,7,2,37,48,1898
82475,82475,CCF51F527C0699CB645C6D016C6FE2F5,42581,11,19,8,38,48,1948
82476,82476,210582EEAC6D1F2BB5FAA5A446D73BC0,10381,0,8,8,31,49,1599
82477,82477,210582EEAC6D1F2BB5FAA5A446D73BC0,12381,12,16,4,32,48,1648
82478,82478,210582EEAC6D1F2BB5FAA5A446D73BC0,10381,17,19,2,31,49,1599
82479,82479,210582EEAC6D1F2BB5FAA5A446D73BC0,11531,20,22,2,34,49,1749
82484,82484,4EE5C60035D807126AEE0DC0CD563832,11914,10,12,2,37,48,1898
82485,82485,4EE5C60035D807126AEE0DC0CD563832,42581,14,18,4,38,48,1948
82486,82486,4EE5C60035D807126AEE0DC0CD563832,11914,18,22,4,37,48,1898
82503,82503,482231C60E75752F61489BAC43B2B02B,10121,0,8,8,36,49,1849
82504,82504,482231C60E75752F61489BAC43B2B02B,11541,9,22,13,35,49,1799
82505,82505,482231C60E75752F61489BAC43B2B02B,10121,22,23,1,36,49,1849
82514,82514,5CBF1A96FBD01E1BC7D10DDBD646A0C6,10371,1,16,15,37,49,1899
82515,82515,5CBF1A96FBD01E1BC7D10DDBD646A0C6,11021,16,17,1,36,49,1849
82516,82516,5CBF1A96FBD01E1BC7D10DDBD646A0C6,11231,18,23,5,37,49,1899
82517,82517,5E1BBAE6A1AB78C09E8201C8FF351A4E,12514,1,9,8,38,47,1947
82518,82518,5E1BBAE6A1AB78C09E8201C8FF351A4E,11074,11,17,6,37,47,1897
82519,82519,5E1BBAE6A1AB78C09E8201C8FF351A4E,12514,22,23,1,38,47,1947
82520,82520,09C2A5500F5ABAEEAC932C07F5628EC4,42161,9,11,2,36,47,1847
82521,82521,09C2A5500F5ABAEEAC932C07F5628EC4,11021,12,14,2,36,49,1849
82522,82522,09C2A5500F5ABAEEAC932C07F5628EC4,43161,14,19,5,35,47,1797
82545,82545,424595F1C8846A1CBAEDBFB8FB93F25B,11061,0,4,4,29,48,1498
82546,82546,424595F1C8846A1CBAEDBFB8FB93F25B,12121,6,17,11,29,47,1497
82547,82547,424595F1C8846A1CBAEDBFB8FB93F25B,11061,18,23,5,29,48,1498
82548,82548,99969E144D1D45122ECEBFEFF9C91A08,11061,1,6,5,29,48,1498
82549,82549,99969E144D1D45122ECEBFEFF9C91A08,43971,6,10,4,30,48,1548
82550,82550,99969E144D1D45122ECEBFEFF9C91A08,11061,10,19,9,29,48,1498
82551,82551,D49ACB9D15E069F7B065182278AF10C3,13711,0,8,8,38,46,1946
82552,82552,D49ACB9D15E069F7B065182278AF10C3,42301,9,10,1,36,47,1847
82553,82553,D49ACB9D15E069F7B065182278AF10C3,13711,10,18,8,38,46,1946
82554,82554,D49ACB9D15E069F7B065182278AF10C3,42301,19,21,2,36,47,1847
82555,82555,1848FBFFA8B7C3D6029972F209D4BA98,42401,0,10,10,36,47,1847
82556,82556,1848FBFFA8B7C3D6029972F209D4BA98,12021,13,14,1,37,49,1899
82557,82557,1848FBFFA8B7C3D6029972F209D4BA98,42401,14,23,9,36,47,1847
82562,82562,FB000703F60DD8663DF557E4D74CC6D5,10401,0,17,17,33,49,1699
82563,82563,FB000703F60DD8663DF557E4D74CC6D5,11351,19,20,1,36,48,1848
82564,82564,FB000703F60DD8663DF557E4D74CC6D5,11231,21,23,2,37,49,1899
82574,82574,2E12B4DAB0BABD9D3D10C50E79DF9B0F,11321,0,12,12,31,46,1596
82575,82575,2E12B4DAB0BABD9D3D10C50E79DF9B0F,12311,13,15,2,30,44,1544
82576,82576,2E12B4DAB0BABD9D3D10C50E79DF9B0F,11321,18,23,5,31,46,1596
82591,82591,04F49F7E8D4D2D6E613CDB194B5DF8E7,13331,0,18,18,38,47,1947
82592,82592,04F49F7E8D4D2D6E613CDB194B5DF8E7,42511,18,19,1,37,47,1897
82593,82593,04F49F7E8D4D2D6E613CDB194B5DF8E7,13331,20,23,3,38,47,1947
82613,82613,D33D3D5CCF46B3E0EE0E888BEF0E411D,11541,0,7,7,35,49,1799
82614,82614,D33D3D5CCF46B3E0EE0E888BEF0E411D,10221,7,16,9,34,49,1749
82615,82615,D33D3D5CCF46B3E0EE0E888BEF0E411D,10491,18,20,2,33,48,1698
82616,82616,E1BB7B2CDA075A402737990C0757A672,40632,0,7,7,35,48,1798
82617,82617,E1BB7B2CDA075A402737990C0757A672,13561,8,10,2,37,49,1899
82618,82618,E1BB7B2CDA075A402737990C0757A672,40632,19,23,4,35,48,1798
82619,82619,F3EBB57DA3A54FEC2068629888C9AD19,11941,0,8,8,37,46,1896
82620,82620,F3EBB57DA3A54FEC2068629888C9AD19,10841,10,13,3,37,47,1897
82621,82621,F3EBB57DA3A54FEC2068629888C9AD19,12514,15,18,3,38,47,1947
82622,82622,F3EBB57DA3A54FEC2068629888C9AD19,11941,18,22,4,37,46,1896
82623,82623,66F421352C22D8571066F0AF8EA7BD0D,10251,1,13,12,35,47,1797
82624,82624,66F421352C22D8571066F0AF8EA7BD0D,10491,13,15,2,33,48,1698
82625,82625,66F421352C22D8571066F0AF8EA7BD0D,10251,15,19,4,35,47,1797
82626,82626,66F421352C22D8571066F0AF8EA7BD0D,11861,21,22,1,32,47,1647
82627,82627,FDF3A555382668B3FCFD730AFF8664D2,10411,0,7,7,36,48,1848
82628,82628,FDF3A555382668B3FCFD730AFF8664D2,11231,8,18,10,37,49,1899
82629,82629,FDF3A555382668B3FCFD730AFF8664D2,10411,19,23,4,36,48,1848
82635,82635,012D304B65BB1C01DC9FFE26FE6AEE56,10111,0,6,6,37,47,1897
82636,82636,012D304B65BB1C01DC9FFE26FE6AEE56,40636,8,9,1,35,48,1798
82637,82637,012D304B65BB1C01DC9FFE26FE6AEE56,11771,12,19,7,39,49,1999
82638,82638,012D304B65BB1C01DC9FFE26FE6AEE56,10111,21,23,2,37,47,1897
82639,82639,D0D24C7F1A65A68DAA38891FB1757B47,19441,0,6,6,8,46,446
82640,82640,D0D24C7F1A65A68DAA38891FB1757B47,19024,9,10,1,9,45,495
82641,82641,D0D24C7F1A65A68DAA38891FB1757B47,42041,13,22,9,10,47,547
82654,82654,F36A9C530F88290C9D611D428C0B8F3A,11021,0,8,8,36,49,1849
82655,82655,F36A9C530F88290C9D611D428C0B8F3A,11531,9,10,1,34,49,1749
82656,82656,F36A9C530F88290C9D611D428C0B8F3A,10651,12,19,7,36,49,1849
82657,82657,F36A9C530F88290C9D611D428C0B8F3A,11531,19,22,3,34,49,1749
82670,82670,30F8C36AA5137BBA2518C91121C2E6D3,11381,0,10,10,30,47,1547
82671,82671,30F8C36AA5137BBA2518C91121C2E6D3,10951,10,12,2,29,48,1498
82672,82672,30F8C36AA5137BBA2518C91121C2E6D3,11381,12,23,11,30,47,1547
82676,82676,446888977A8F72BEC7197E0F78FD7E2F,42851,0,7,7,35,41,1791
82677,82677,446888977A8F72BEC7197E0F78FD7E2F,43451,11,14,3,37,40,1890
82678,82678,446888977A8F72BEC7197E0F78FD7E2F,12521,15,16,1,35,41,1791
82679,82679,446888977A8F72BEC7197E0F78FD7E2F,42381,17,19,2,39,41,1991
82689,82689,672E0DC23EB222F6401A27D4A22CDA0E,10341,0,8,8,31,47,1597
82690,82690,672E0DC23EB222F6401A27D4A22CDA0E,42491,8,10,2,32,46,1646
82691,82691,672E0DC23EB222F6401A27D4A22CDA0E,11324,15,20,5,31,46,1596
82692,82692,672E0DC23EB222F6401A27D4A22CDA0E,10341,21,23,2,31,47,1597
82705,82705,E7EC6E138D54F5092F2DB01DB4F64219,42204,0,7,7,43,46,2196
82706,82706,E7EC6E138D54F5092F2DB01DB4F64219,13111,10,13,3,42,46,2146
82707,82707,E7EC6E138D54F5092F2DB01DB4F64219,42201,16,19,3,43,46,2196
82717,82717,B7D12100353E68ECEB33D9104EEA405C,42471,0,6,6,35,49,1799
82718,82718,B7D12100353E68ECEB33D9104EEA405C,10841,8,9,1,37,47,1897
82719,82719,B7D12100353E68ECEB33D9104EEA405C,42471,13,22,9,35,49,1799
82725,82725,F3B7C397DA870428A84CFF50541D9D51,42531,0,7,7,31,45,1595
82726,82726,F3B7C397DA870428A84CFF50541D9D51,42871,10,12,2,30,45,1545
82727,82727,F3B7C397DA870428A84CFF50541D9D51,42523,14,18,4,31,47,1597
82728,82728,F3B7C397DA870428A84CFF50541D9D51,10351,20,21,1,28,45,1445
82736,82736,EDCDD65DCE30FD6D52F4198F67AF3723,11941,1,2,1,37,46,1896
82737,82737,EDCDD65DCE30FD6D52F4198F67AF3723,13711,5,6,1,38,46,1946
82738,82738,EDCDD65DCE30FD6D52F4198F67AF3723,12391,10,11,1,36,49,1849
82739,82739,EDCDD65DCE30FD6D52F4198F67AF3723,11941,13,23,10,37,46,1896
82740,82740,61CC7CB5EA609C6320BD2A3529DD90CF,11911,0,6,6,37,48,1898
82741,82741,61CC7CB5EA609C6320BD2A3529DD90CF,10271,7,16,9,37,46,1896
82742,82742,61CC7CB5EA609C6320BD2A3529DD90CF,11911,18,23,5,37,48,1898
82753,82753,5A8308F9DAAF40265186D4E63F2640C9,10721,0,6,6,31,48,1598
82754,82754,5A8308F9DAAF40265186D4E63F2640C9,13731,7,17,10,33,49,1699
82755,82755,5A8308F9DAAF40265186D4E63F2640C9,12381,19,23,4,32,48,1648
82771,82771,9F99A72527E81B89BEB16DB21B613CC0,10281,0,7,7,33,48,1698
82772,82772,9F99A72527E81B89BEB16DB21B613CC0,11861,8,16,8,32,47,1647
82773,82773,9F99A72527E81B89BEB16DB21B613CC0,10281,17,23,6,33,48,1698
82797,82797,0F18A9274445631256C7B0403CD7E0F0,10111,0,12,12,37,47,1897
82798,82798,0F18A9274445631256C7B0403CD7E0F0,42161,12,19,7,36,47,1847
82799,82799,0F18A9274445631256C7B0403CD7E0F0,10111,19,23,4,37,47,1897
82800,82800,7FC90A7046789407FE1CCFF00DDA96C6,40347,0,8,8,25,49,1299
82801,82801,7FC90A7046789407FE1CCFF00DDA96C6,40343,12,15,3,24,49,1249
82802,82802,7FC90A7046789407FE1CCFF00DDA96C6,40347,17,23,6,25,49,1299
82803,82803,7A89F90274317B23FC53152227A2C065,49201,1,4,3,7,41,391
82804,82804,7A89F90274317B23FC53152227A2C065,12921,4,5,1,9,41,491
82805,82805,7A89F90274317B23FC53152227A2C065,49201,6,19,13,7,41,391
82806,82806,A26526FCE25758DA240C3B314B205E8A,19024,0,6,6,9,45,495
82807,82807,A26526FCE25758DA240C3B314B205E8A,19441,8,11,3,8,46,446
82808,82808,A26526FCE25758DA240C3B314B205E8A,19024,12,23,11,9,45,495
82812,82812,FD6F3D9CFB531FE01A1AEA9CDBE73454,42231,5,7,2,37,46,1896
82813,82813,FD6F3D9CFB531FE01A1AEA9CDBE73454,42351,7,18,11,38,45,1945
82814,82814,FD6F3D9CFB531FE01A1AEA9CDBE73454,42231,20,21,1,37,46,1896
82827,82827,F3D5307F6A43FA419BF127D81FF991ED,10371,1,10,9,37,49,1899
82828,82828,F3D5307F6A43FA419BF127D81FF991ED,42981,13,14,1,36,49,1849
82829,82829,F3D5307F6A43FA419BF127D81FF991ED,11231,16,21,5,37,49,1899
82833,82833,E603C5CE99E3FE3BB5D201DC1F4B77FD,13111,0,15,15,42,46,2146
82834,82834,E603C5CE99E3FE3BB5D201DC1F4B77FD,42204,16,19,3,43,46,2196
82835,82835,E603C5CE99E3FE3BB5D201DC1F4B77FD,13791,19,21,2,42,47,2147
82836,82836,E603C5CE99E3FE3BB5D201DC1F4B77FD,13111,21,23,2,42,46,2146
82854,82854,2C92D9A1E7726DE0B07E3A3E97221DE4,11491,0,8,8,36,47,1847
82855,82855,2C92D9A1E7726DE0B07E3A3E97221DE4,10971,12,15,3,35,47,1797
82856,82856,2C92D9A1E7726DE0B07E3A3E97221DE4,11491,18,23,5,36,47,1847
82857,82857,3CC60A62625BD17932540051B07BB63C,40445,1,15,14,30,48,1548
82858,82858,3CC60A62625BD17932540051B07BB63C,11061,18,19,1,29,48,1498
82859,82859,3CC60A62625BD17932540051B07BB63C,40445,22,23,1,30,48,1548
82863,82863,8B15250505924ED8935A6E2820AF9A14,12921,0,9,9,9,41,491
82864,82864,8B15250505924ED8935A6E2820AF9A14,19181,10,17,7,8,40,440
82865,82865,8B15250505924ED8935A6E2820AF9A14,12921,17,22,5,9,41,491
82866,82866,F5640B3ED25403D6D9CD74278C7FCA06,42161,3,4,1,36,47,1847
82867,82867,F5640B3ED25403D6D9CD74278C7FCA06,10971,5,17,12,35,47,1797
82868,82868,F5640B3ED25403D6D9CD74278C7FCA06,42161,18,20,2,36,47,1847
82869,82869,F5640B3ED25403D6D9CD74278C7FCA06,10971,20,22,2,35,47,1797
82878,82878,5832F798017EC944959971DE10E6C76B,13911,2,3,1,39,46,1996
82879,82879,5832F798017EC944959971DE10E6C76B,11261,7,13,6,36,46,1846
82880,82880,5832F798017EC944959971DE10E6C76B,13911,16,23,7,39,46,1996
82885,82885,49CB9CEC7E59D59356F4365E4B053CBC,11361,0,10,10,22,48,1148
82886,82886,49CB9CEC7E59D59356F4365E4B053CBC,12581,13,15,2,24,48,1248
82887,82887,49CB9CEC7E59D59356F4365E4B053CBC,11361,19,20,1,22,48,1148
82893,82893,D4DE28276D2C825AA4FE715AD291B466,13711,2,8,6,38,46,1946
82894,82894,D4DE28276D2C825AA4FE715AD291B466,42011,12,15,3,36,46,1846
82895,82895,D4DE28276D2C825AA4FE715AD291B466,42301,16,21,5,36,47,1847
82896,82896,58160F8286644CCBCCC72FA14DAD9C05,19114,0,10,10,7,43,393
82897,82897,58160F8286644CCBCCC72FA14DAD9C05,49201,12,14,2,7,41,391
82898,82898,58160F8286644CCBCCC72FA14DAD9C05,12641,15,16,1,10,43,543
82899,82899,58160F8286644CCBCCC72FA14DAD9C05,19114,16,23,7,7,43,393
82900,82900,3C02B5838EDEAB0B15A337805B269A42,13011,0,5,5,39,47,1997
82901,82901,3C02B5838EDEAB0B15A337805B269A42,42321,6,18,12,43,47,2197
82902,82902,3C02B5838EDEAB0B15A337805B269A42,13011,19,23,4,39,47,1997
82903,82903,76780BDA1CE8853E5C6D6B4A56C0AC5B,11381,0,15,15,30,47,1547
82904,82904,76780BDA1CE8853E5C6D6B4A56C0AC5B,12121,16,17,1,29,47,1497
82905,82905,76780BDA1CE8853E5C6D6B4A56C0AC5B,11381,18,22,4,30,47,1547
82917,82917,33E38F12F8713108E12BCC9991D28568,42461,1,5,4,45,47,2297
82918,82918,33E38F12F8713108E12BCC9991D28568,11001,7,10,3,42,47,2147
82919,82919,33E38F12F8713108E12BCC9991D28568,11701,13,19,6,43,48,2198
82934,82934,B8DCAC0FC6FA981D871032E55C240C8E,11914,0,1,1,37,48,1898
82935,82935,B8DCAC0FC6FA981D871032E55C240C8E,42581,4,5,1,38,48,1948
82936,82936,B8DCAC0FC6FA981D871032E55C240C8E,11914,9,21,12,37,48,1898
82952,82952,0906F154522D9A27514AC65F4E9460D6,10271,0,8,8,37,46,1896
82953,82953,0906F154522D9A27514AC65F4E9460D6,13711,10,17,7,38,46,1946
82954,82954,0906F154522D9A27514AC65F4E9460D6,43241,18,20,2,36,46,1846
82955,82955,0906F154522D9A27514AC65F4E9460D6,10271,21,23,2,37,46,1896
82961,82961,7D8E220E04EE68745CC45E58D581C32B,10471,0,2,2,37,48,1898
82962,82962,7D8E220E04EE68745CC45E58D581C32B,10107,3,7,4,38,49,1949
82963,82963,7D8E220E04EE68745CC45E58D581C32B,10371,9,18,9,37,49,1899
82964,82964,7D8E220E04EE68745CC45E58D581C32B,10471,20,23,3,37,48,1898
82980,82980,60C4906B9FADDE31AE603A5E02129DFF,40171,0,10,10,38,48,1948
82981,82981,60C4906B9FADDE31AE603A5E02129DFF,10471,11,13,2,37,48,1898
82982,82982,60C4906B9FADDE31AE603A5E02129DFF,40171,14,19,5,38,48,1948
82983,82983,60C4906B9FADDE31AE603A5E02129DFF,10471,20,22,2,37,48,1898
82992,82992,66185B68E33CC3920DCF084557286231,13121,0,5,5,38,46,1946
82993,82993,66185B68E33CC3920DCF084557286231,42301,6,19,13,36,47,1847
82994,82994,66185B68E33CC3920DCF084557286231,13121,19,23,4,38,46,1946
82995,82995,EFD29D584DEEA8B8A3F1E9E782654748,42231,7,14,7,37,46,1896
82996,82996,EFD29D584DEEA8B8A3F1E9E782654748,42351,15,17,2,38,45,1945
82997,82997,EFD29D584DEEA8B8A3F1E9E782654748,42231,17,19,2,37,46,1896
83005,83005,9C819019C9FBB04766CC6EE29C66CE0E,42401,0,7,7,36,47,1847
83006,83006,9C819019C9FBB04766CC6EE29C66CE0E,12514,12,13,1,38,47,1947
83007,83007,9C819019C9FBB04766CC6EE29C66CE0E,42401,18,19,1,36,47,1847
83011,83011,E859A0BF6FB37F9B42DF06EC7EE8FF9D,42461,0,6,6,45,47,2297
83012,83012,E859A0BF6FB37F9B42DF06EC7EE8FF9D,42321,7,18,11,43,47,2197
83013,83013,E859A0BF6FB37F9B42DF06EC7EE8FF9D,42461,19,22,3,45,47,2297
83019,83019,87E83B17518064E417741F00BFE7BE50,12641,0,16,16,10,43,543
83020,83020,87E83B17518064E417741F00BFE7BE50,19901,17,18,1,7,44,394
83021,83021,87E83B17518064E417741F00BFE7BE50,12641,20,21,1,10,43,543
83025,83025,964156E683797EC321E31C806CD19178,11914,0,3,3,37,48,1898
83026,83026,964156E683797EC321E31C806CD19178,42581,3,4,1,38,48,1948
83027,83027,964156E683797EC321E31C806CD19178,11331,6,18,12,37,48,1898
83028,83028,377BD5B9C037AF000CC29F45169CD1E4,11231,0,9,9,37,49,1899
83029,83029,377BD5B9C037AF000CC29F45169CD1E4,11201,9,18,9,35,49,1799
83030,83030,377BD5B9C037AF000CC29F45169CD1E4,11231,18,23,5,37,49,1899
83040,83040,9467C00340FDB6745E40F052A8816117,42461,0,9,9,45,47,2297
83041,83041,9467C00340FDB6745E40F052A8816117,13791,12,14,2,42,47,2147
83042,83042,9467C00340FDB6745E40F052A8816117,13941,20,23,3,41,47,2097
83053,83053,111CDDD5FA2E313735C2BD7B109AA3EE,42861,1,3,2,37,44,1894
83054,83054,111CDDD5FA2E313735C2BD7B109AA3EE,42151,7,11,4,35,45,1795
83055,83055,111CDDD5FA2E313735C2BD7B109AA3EE,42861,11,20,9,37,44,1894
83056,83056,111CDDD5FA2E313735C2BD7B109AA3EE,42151,20,22,2,35,45,1795
83057,83057,ACB823DB33D22CC4344D979C1DDF92F4,10811,0,1,1,38,46,1946
83058,83058,ACB823DB33D22CC4344D979C1DDF92F4,11261,3,7,4,36,46,1846
83059,83059,ACB823DB33D22CC4344D979C1DDF92F4,42861,7,19,12,37,44,1894
83060,83060,ACB823DB33D22CC4344D979C1DDF92F4,11261,21,22,1,36,46,1846
83066,83066,C8E1F9FF4BDCF5DC404825DE8B951E8C,43761,0,12,12,32,47,1647
83067,83067,C8E1F9FF4BDCF5DC404825DE8B951E8C,13651,15,16,1,30,47,1547
83068,83068,C8E1F9FF4BDCF5DC404825DE8B951E8C,43761,19,23,4,32,47,1647
83069,83069,19A29A27E6506D34C07A04E6E9F52A03,12491,0,5,5,36,43,1843
83070,83070,19A29A27E6506D34C07A04E6E9F52A03,42151,7,11,4,35,45,1795
83071,83071,19A29A27E6506D34C07A04E6E9F52A03,12491,14,15,1,36,43,1843
83072,83072,19A29A27E6506D34C07A04E6E9F52A03,42151,15,19,4,35,45,1795
83073,83073,990F89A555478F97C2E0E123BB133187,49201,0,5,5,7,41,391
83074,83074,990F89A555478F97C2E0E123BB133187,12921,6,7,1,9,41,491
83075,83075,990F89A555478F97C2E0E123BB133187,19181,8,18,10,8,40,440
83076,83076,A30C3A4D08AE45D5E2F0083CE1F142DF,13111,6,8,2,42,46,2146
83077,83077,A30C3A4D08AE45D5E2F0083CE1F142DF,42204,9,11,2,43,46,2196
83078,83078,A30C3A4D08AE45D5E2F0083CE1F142DF,13111,11,22,11,42,46,2146
83079,83079,5DBCCE2707F3371A3CC004A71C2FCFAE,11231,0,8,8,37,49,1899
83080,83080,5DBCCE2707F3371A3CC004A71C2FCFAE,42961,8,9,1,35,49,1799
83081,83081,5DBCCE2707F3371A3CC004A71C2FCFAE,11231,10,21,11,37,49,1899
83082,83082,5DBCCE2707F3371A3CC004A71C2FCFAE,42961,21,22,1,35,49,1799
83083,83083,E6D049947968658F47DDC695A59302A1,42321,0,5,5,43,47,2197
83084,83084,E6D049947968658F47DDC695A59302A1,42461,7,8,1,45,47,2297
83085,83085,E6D049947968658F47DDC695A59302A1,42201,8,23,15,43,46,2196
83086,83086,65C7C8026FEC3DFC5E224E421B68D386,11231,5,7,2,37,49,1899
83087,83087,65C7C8026FEC3DFC5E224E421B68D386,13331,7,17,10,38,47,1947
83088,83088,65C7C8026FEC3DFC5E224E421B68D386,11231,22,23,1,37,49,1899
83093,83093,75E9901E37B333931DA19D3D307663B3,40343,0,6,6,24,49,1249
83094,83094,75E9901E37B333931DA19D3D307663B3,42681,6,8,2,24,48,1248
83095,83095,75E9901E37B333931DA19D3D307663B3,40343,9,23,14,24,49,1249
83112,83112,895085FE0B62D7BCDF8725B5DB48E546,43971,0,13,13,30,48,1548
83113,83113,895085FE0B62D7BCDF8725B5DB48E546,11381,15,17,2,30,47,1547
83114,83114,895085FE0B62D7BCDF8725B5DB48E546,11061,17,18,1,29,48,1498
83115,83115,895085FE0B62D7BCDF8725B5DB48E546,11381,21,22,1,30,47,1547
83116,83116,B3D9D8E72FD92A77A76B6490766A3C36,19901,2,6,4,7,44,394
83117,83117,B3D9D8E72FD92A77A76B6490766A3C36,12641,6,8,2,10,43,543
83118,83118,B3D9D8E72FD92A77A76B6490766A3C36,19114,8,20,12,7,43,393
83119,83119,B3D9D8E72FD92A77A76B6490766A3C36,12641,21,22,1,10,43,543
83133,83133,E95AAC0F2ECBA2D27D816D9108E9562A,11091,0,8,8,29,47,1497
83134,83134,E95AAC0F2ECBA2D27D816D9108E9562A,12601,10,18,8,25,47,1297
83135,83135,E95AAC0F2ECBA2D27D816D9108E9562A,11091,19,23,4,29,47,1497
83136,83136,A8491B4932A74BB29E61F0906E6D23DE,42461,2,3,1,45,47,2297
83137,83137,A8491B4932A74BB29E61F0906E6D23DE,42201,3,5,2,43,46,2196
83138,83138,A8491B4932A74BB29E61F0906E6D23DE,42461,5,20,15,45,47,2297
83139,83139,80779C982E47128931C5479B9B9DAF80,11861,0,8,8,32,47,1647
83140,83140,80779C982E47128931C5479B9B9DAF80,10951,9,10,1,29,48,1498
83141,83141,80779C982E47128931C5479B9B9DAF80,12971,15,17,2,32,48,1648
83142,83142,80779C982E47128931C5479B9B9DAF80,11861,19,21,2,32,47,1647
83151,83151,AE931B79E80BF3CFA2F48EF7F9685CA5,11261,6,11,5,36,46,1846
83152,83152,AE931B79E80BF3CFA2F48EF7F9685CA5,12491,11,15,4,36,43,1843
83153,83153,AE931B79E80BF3CFA2F48EF7F9685CA5,11261,17,23,6,36,46,1846
83154,83154,9FC853D14B199D9AE09B3905110E90BD,12514,0,7,7,38,47,1947
83155,83155,9FC853D14B199D9AE09B3905110E90BD,42221,9,10,1,38,48,1948
83156,83156,9FC853D14B199D9AE09B3905110E90BD,12514,11,23,12,38,47,1947
83164,83164,84BFDA5775B1A36CF113618F1669E73C,42521,0,6,6,31,47,1597
83165,83165,84BFDA5775B1A36CF113618F1669E73C,11384,7,10,3,30,47,1547
83166,83166,84BFDA5775B1A36CF113618F1669E73C,42521,11,22,11,31,47,1597
83167,83167,8D4403CD84975AE0D9A403E49725512D,10121,0,17,17,36,49,1849
83168,83168,8D4403CD84975AE0D9A403E49725512D,42471,18,20,2,35,49,1799
83169,83169,8D4403CD84975AE0D9A403E49725512D,10121,20,23,3,36,49,1849
83179,83179,245DE714507382DDB0203A65927397CC,41021,0,13,13,38,47,1947
83180,83180,245DE714507382DDB0203A65927397CC,13121,14,17,3,38,46,1946
83181,83181,245DE714507382DDB0203A65927397CC,13681,17,23,6,38,47,1947
83192,83192,C0EC240E36490D1263D83D45770C29BF,42321,0,6,6,43,47,2197
83193,83193,C0EC240E36490D1263D83D45770C29BF,42091,8,16,8,43,46,2196
83194,83194,C0EC240E36490D1263D83D45770C29BF,42321,20,23,3,43,47,2197
83195,83195,91A2ACAB5641A9E694310054674EE64F,11431,1,7,6,29,47,1497
83196,83196,91A2ACAB5641A9E694310054674EE64F,12381,8,21,13,32,48,1648
83197,83197,91A2ACAB5641A9E694310054674EE64F,11061,22,23,1,29,48,1498
83202,83202,0AE1F060A9917578AF6CC39BEF4A5FD7,11074,1,6,5,37,47,1897
83203,83203,0AE1F060A9917578AF6CC39BEF4A5FD7,10371,9,18,9,37,49,1899
83204,83204,0AE1F060A9917578AF6CC39BEF4A5FD7,13101,18,19,1,40,47,2047
83205,83205,0AE1F060A9917578AF6CC39BEF4A5FD7,11074,20,22,2,37,47,1897
83206,83206,23F8F9B0AC0C62AC07DD5CA5BCEDE820,13551,2,3,1,45,38,2288
83207,83207,23F8F9B0AC0C62AC07DD5CA5BCEDE820,43101,4,10,6,46,40,2340
83208,83208,23F8F9B0AC0C62AC07DD5CA5BCEDE820,13551,11,18,7,45,38,2288
83209,83209,23F8F9B0AC0C62AC07DD5CA5BCEDE820,43101,18,21,3,46,40,2340
83229,83229,F339D5A56939F49607D7893085F62448,13371,1,2,1,41,47,2097
83230,83230,F339D5A56939F49607D7893085F62448,11001,2,12,10,42,47,2147
83231,83231,F339D5A56939F49607D7893085F62448,13941,13,15,2,41,47,2097
83232,83232,F339D5A56939F49607D7893085F62448,11001,16,21,5,42,47,2147
83240,83240,64BD805F6D9361B926D90DA2610BBB4F,49201,0,3,3,7,41,391
83241,83241,64BD805F6D9361B926D90DA2610BBB4F,12921,3,12,9,9,41,491
83242,83242,64BD805F6D9361B926D90DA2610BBB4F,49201,13,18,5,7,41,391
83243,83243,4326A99732F97B46651D6FE77C28BB70,13651,0,10,10,30,47,1547
83244,83244,4326A99732F97B46651D6FE77C28BB70,10951,12,15,3,29,48,1498
83245,83245,4326A99732F97B46651D6FE77C28BB70,11381,17,18,1,30,47,1547
83246,83246,4326A99732F97B46651D6FE77C28BB70,10951,21,22,1,29,48,1498
83250,83250,26DECA4A496D5594EA57F7546CECA764,10921,1,7,6,43,48,2198
83251,83251,26DECA4A496D5594EA57F7546CECA764,42601,9,10,1,44,48,2248
83252,83252,26DECA4A496D5594EA57F7546CECA764,11701,13,21,8,43,48,2198
83268,83268,CAF83309DC5164BDCFC4AF3B395E1D5C,10841,0,9,9,37,47,1897
83269,83269,CAF83309DC5164BDCFC4AF3B395E1D5C,11231,12,13,1,37,49,1899
83270,83270,CAF83309DC5164BDCFC4AF3B395E1D5C,10161,15,20,5,35,49,1799
83271,83271,CAF83309DC5164BDCFC4AF3B395E1D5C,11231,20,23,3,37,49,1899
83281,83281,DDBAE283B6068B46FD4E039DB47179A0,42204,0,17,17,43,46,2196
83282,83282,DDBAE283B6068B46FD4E039DB47179A0,40691,17,18,1,42,48,2148
83283,83283,DDBAE283B6068B46FD4E039DB47179A0,42204,20,21,1,43,46,2196
83290,83290,1F3309CCB4B7AEA7BC6FD5A40506F808,11914,0,12,12,37,48,1898
83291,83291,1F3309CCB4B7AEA7BC6FD5A40506F808,42581,13,19,6,38,48,1948
83292,83292,1F3309CCB4B7AEA7BC6FD5A40506F808,11231,21,23,2,37,49,1899
83293,83293,A1FF698AA884BDD16138C4A1CA694993,11061,0,10,10,29,48,1498
83294,83294,A1FF698AA884BDD16138C4A1CA694993,10351,12,15,3,28,45,1445
83295,83295,A1FF698AA884BDD16138C4A1CA694993,11061,19,23,4,29,48,1498
83296,83296,E05F67959FE0060F5DAD596617CE48BB,12921,0,9,9,9,41,491
83297,83297,E05F67959FE0060F5DAD596617CE48BB,49201,9,16,7,7,41,391
83298,83298,E05F67959FE0060F5DAD596617CE48BB,12921,18,20,2,9,41,491
83299,83299,EF24F74DDF741D0DEC0CB3B2510AE4FC,10351,0,15,15,28,45,1445
83300,83300,EF24F74DDF741D0DEC0CB3B2510AE4FC,10301,15,20,5,31,45,1595
83301,83301,EF24F74DDF741D0DEC0CB3B2510AE4FC,10351,21,22,1,28,45,1445
83306,83306,BA285F01E6926591864F1F3184565800,42581,1,15,14,38,48,1948
83307,83307,BA285F01E6926591864F1F3184565800,11914,15,17,2,37,48,1898
83308,83308,BA285F01E6926591864F1F3184565800,10107,19,20,1,38,49,1949
83309,83309,F4698EB961F72AD85D435B6008D2C2F0,10801,0,6,6,42,47,2147
83310,83310,F4698EB961F72AD85D435B6008D2C2F0,10924,13,17,4,43,49,2199
83311,83311,F4698EB961F72AD85D435B6008D2C2F0,42321,19,20,1,43,47,2197
83348,83348,13E5998B0F76CD481DB7EA79EFC80A0D,10881,0,10,10,34,48,1748
83349,83349,13E5998B0F76CD481DB7EA79EFC80A0D,10251,10,12,2,35,47,1797
83350,83350,13E5998B0F76CD481DB7EA79EFC80A0D,40411,13,15,2,34,48,1748
83351,83351,13E5998B0F76CD481DB7EA79EFC80A0D,10161,17,23,6,35,49,1799
83352,83352,6EA4CCEDBFDE801AE8D11614A06A0C5C,11281,0,4,4,27,40,1390
83353,83353,6EA4CCEDBFDE801AE8D11614A06A0C5C,13671,8,9,1,27,43,1393
83354,83354,6EA4CCEDBFDE801AE8D11614A06A0C5C,11281,14,23,9,27,40,1390
83355,83355,335FD8782D4F531D88DAC06C84870767,13411,2,6,4,49,42,2492
83356,83356,335FD8782D4F531D88DAC06C84870767,43951,6,18,12,49,41,2491
83357,83357,335FD8782D4F531D88DAC06C84870767,13411,20,21,1,49,42,2492
83358,83358,7FD9072832AAE29AE2915CDEF233B942,10801,2,13,11,42,47,2147
83359,83359,7FD9072832AAE29AE2915CDEF233B942,13221,15,16,1,40,47,2047
83360,83360,7FD9072832AAE29AE2915CDEF233B942,10801,20,23,3,42,47,2147
83361,83361,E6FCFD9CDC3EB1FC44E07435B75A2FF4,11921,1,8,7,38,48,1948
83362,83362,E6FCFD9CDC3EB1FC44E07435B75A2FF4,11074,9,10,1,37,47,1897
83363,83363,E6FCFD9CDC3EB1FC44E07435B75A2FF4,11921,12,13,1,38,48,1948
83364,83364,E6FCFD9CDC3EB1FC44E07435B75A2FF4,11074,16,23,7,37,47,1897
83365,83365,72EE059838FC074BF0955787969E7967,11231,0,4,4,37,49,1899
83366,83366,72EE059838FC074BF0955787969E7967,10411,5,13,8,36,48,1848
83367,83367,72EE059838FC074BF0955787969E7967,11531,16,17,1,34,49,1749
83368,83368,72EE059838FC074BF0955787969E7967,11911,18,23,5,37,48,1898
83369,83369,E5DFBD5EA9D387D72488BF506891617B,11491,0,7,7,36,47,1847
83370,83370,E5DFBD5EA9D387D72488BF506891617B,13101,8,9,1,40,47,2047
83371,83371,E5DFBD5EA9D387D72488BF506891617B,11491,12,23,11,36,47,1847
83380,83380,8167EF05D15F996A6B93D96BD3E78468,13371,1,11,10,41,47,2097
83381,83381,8167EF05D15F996A6B93D96BD3E78468,42271,16,18,2,40,47,2047
83382,83382,8167EF05D15F996A6B93D96BD3E78468,12514,18,19,1,38,47,1947
83396,83396,E940BE4D41CC0CB4C8FE35BF5D7A199F,42271,0,16,16,40,47,2047
83397,83397,E940BE4D41CC0CB4C8FE35BF5D7A199F,10107,18,20,2,38,49,1949
83398,83398,E940BE4D41CC0CB4C8FE35BF5D7A199F,13101,21,23,2,40,47,2047
83399,83399,9B8E3A84EF821A3E9564A6D6EAEA0FE5,42581,0,5,5,38,48,1948
83400,83400,9B8E3A84EF821A3E9564A6D6EAEA0FE5,11914,6,7,1,37,48,1898
83401,83401,9B8E3A84EF821A3E9564A6D6EAEA0FE5,42581,9,16,7,38,48,1948
83402,83402,9B8E3A84EF821A3E9564A6D6EAEA0FE5,11914,18,19,1,37,48,1898
83403,83403,5566DF9556BCD612F8500FB496AD53B3,11861,0,7,7,32,47,1647
83404,83404,5566DF9556BCD612F8500FB496AD53B3,13651,8,9,1,30,47,1547
83405,83405,5566DF9556BCD612F8500FB496AD53B3,10731,13,23,10,33,47,1697
83419,83419,6C6BC146AEBEF851AEEEDE2CDE87BAD0,12641,0,15,15,10,43,543
83420,83420,6C6BC146AEBEF851AEEEDE2CDE87BAD0,19114,17,19,2,7,43,393
83421,83421,6C6BC146AEBEF851AEEEDE2CDE87BAD0,12921,20,22,2,9,41,491
83425,83425,8990DBDE6A5F1D256288415FFE42D8D6,40171,0,7,7,38,48,1948
83426,83426,8990DBDE6A5F1D256288415FFE42D8D6,11811,12,14,2,38,49,1949
83427,83427,8990DBDE6A5F1D256288415FFE42D8D6,11921,15,17,2,38,48,1948
83428,83428,8990DBDE6A5F1D256288415FFE42D8D6,13911,19,20,1,39,46,1996
83429,83429,81412EDBF21D783B9E4A866ACE793116,11381,0,7,7,30,47,1547
83430,83430,81412EDBF21D783B9E4A866ACE793116,12311,11,16,5,30,44,1544
83431,83431,81412EDBF21D783B9E4A866ACE793116,11381,16,23,7,30,47,1547
83432,83432,5A1960B0A9A1E6AFC1FD047E564C752A,11261,3,7,4,36,46,1846
83433,83433,5A1960B0A9A1E6AFC1FD047E564C752A,42351,12,13,1,38,45,1945
83434,83434,5A1960B0A9A1E6AFC1FD047E564C752A,11261,13,20,7,36,46,1846
83447,83447,647D85F41DB91010F5EBA85FDA450BC1,12491,0,2,2,36,43,1843
83448,83448,647D85F41DB91010F5EBA85FDA450BC1,11261,6,16,10,36,46,1846
83449,83449,647D85F41DB91010F5EBA85FDA450BC1,42231,19,20,1,37,46,1896
83455,83455,76B33FB77AA592A5A2C6939C31FA9318,10411,0,17,17,36,48,1848
83456,83456,76B33FB77AA592A5A2C6939C31FA9318,12481,18,20,2,37,49,1899
83457,83457,76B33FB77AA592A5A2C6939C31FA9318,10411,21,23,2,36,48,1848
83458,83458,FD61B790F6EE08CF458251D2FC08953F,11271,3,8,5,37,48,1898
83459,83459,FD61B790F6EE08CF458251D2FC08953F,42581,13,15,2,38,48,1948
83460,83460,FD61B790F6EE08CF458251D2FC08953F,12401,18,20,2,39,49,1999
83464,83464,1417E4B0CBAD736F983D44C6FAD57E76,10107,0,9,9,38,49,1949
83465,83465,1417E4B0CBAD736F983D44C6FAD57E76,11021,18,20,2,36,49,1849
83466,83466,1417E4B0CBAD736F983D44C6FAD57E76,40081,20,22,2,40,49,2049
83472,83472,F63C10101641C137318D1F8A4442D330,10271,0,7,7,37,46,1896
83473,83473,F63C10101641C137318D1F8A4442D330,13711,10,12,2,38,46,1946
83474,83474,F63C10101641C137318D1F8A4442D330,10271,12,23,11,37,46,1896
83488,83488,C1E5BCC1C7F8ECB908A80076B478386E,10691,0,6,6,33,48,1698
83489,83489,C1E5BCC1C7F8ECB908A80076B478386E,42021,6,9,3,33,47,1697
83490,83490,C1E5BCC1C7F8ECB908A80076B478386E,11861,13,15,2,32,47,1647
83491,83491,C1E5BCC1C7F8ECB908A80076B478386E,10691,19,23,4,33,48,1698
83496,83496,91764B4567AC3A3991286EF06C97A20D,42161,0,8,8,36,47,1847
83497,83497,91764B4567AC3A3991286EF06C97A20D,10251,9,16,7,35,47,1797
83498,83498,91764B4567AC3A3991286EF06C97A20D,42161,16,23,7,36,47,1847
83505,83505,CF59BBFCFA36DB4C2F7A2E35C4549750,10811,3,17,14,38,46,1946
83506,83506,CF59BBFCFA36DB4C2F7A2E35C4549750,11261,17,20,3,36,46,1846
83507,83507,CF59BBFCFA36DB4C2F7A2E35C4549750,13711,20,23,3,38,46,1946
83526,83526,D4288167E0844E335FBC34F61FC98BB1,10301,6,12,6,31,45,1595
83527,83527,D4288167E0844E335FBC34F61FC98BB1,11324,12,13,1,31,46,1596
83528,83528,D4288167E0844E335FBC34F61FC98BB1,10301,15,18,3,31,45,1595
83529,83529,CEA501FA7BDE5D84B551C94F16C00DA1,10651,0,12,12,36,49,1849
83530,83530,CEA501FA7BDE5D84B551C94F16C00DA1,11541,13,18,5,35,49,1799
83531,83531,CEA501FA7BDE5D84B551C94F16C00DA1,10111,18,21,3,37,47,1897
83532,83532,CEA501FA7BDE5D84B551C94F16C00DA1,10901,22,23,1,35,48,1798
83533,83533,6EBC343B289E845421579091E3F37018,13941,6,7,1,41,47,2097
83534,83534,6EBC343B289E845421579091E3F37018,42204,9,13,4,43,46,2196
83535,83535,6EBC343B289E845421579091E3F37018,13791,15,16,1,42,47,2147
83536,83536,6EBC343B289E845421579091E3F37018,42204,19,23,4,43,46,2196
83537,83537,DD76118F003E0EB1A3681170705A7AA6,43101,6,9,3,46,40,2340
83538,83538,DD76118F003E0EB1A3681170705A7AA6,13491,10,11,1,48,39,2439
83539,83539,DD76118F003E0EB1A3681170705A7AA6,43101,16,18,2,46,40,2340
83551,83551,AB35C432DC3D59E7929F031635A675AA,12601,0,2,2,25,47,1297
83552,83552,AB35C432DC3D59E7929F031635A675AA,10501,3,6,3,22,46,1146
83553,83553,AB35C432DC3D59E7929F031635A675AA,12601,6,22,16,25,47,1297
83554,83554,6AE2FA19F90C6BBDAB69E2E1C7BD408D,11921,0,1,1,38,48,1948
83555,83555,6AE2FA19F90C6BBDAB69E2E1C7BD408D,11914,1,7,6,37,48,1898
83556,83556,6AE2FA19F90C6BBDAB69E2E1C7BD408D,42581,9,13,4,38,48,1948
83557,83557,6AE2FA19F90C6BBDAB69E2E1C7BD408D,12514,15,18,3,38,47,1947
83563,83563,B2B4DE2E50E1B903BBF7A15EFA702BA7,42871,1,10,9,30,45,1545
83564,83564,B2B4DE2E50E1B903BBF7A15EFA702BA7,11871,13,15,2,29,46,1496
83565,83565,B2B4DE2E50E1B903BBF7A15EFA702BA7,11875,17,22,5,30,46,1546
83572,83572,1444CF26498FCF95995CE1D21CF4BAA6,12121,0,7,7,29,47,1497
83573,83573,1444CF26498FCF95995CE1D21CF4BAA6,11381,9,10,1,30,47,1547
83574,83574,1444CF26498FCF95995CE1D21CF4BAA6,12121,11,23,12,29,47,1497
83580,83580,35E834FED302DD4A84DAAA6164365161,11806,0,6,6,41,48,2098
83581,83581,35E834FED302DD4A84DAAA6164365161,42271,7,11,4,40,47,2047
83582,83582,35E834FED302DD4A84DAAA6164365161,11806,12,23,11,41,48,2098
83587,83587,134576DA7F5F26F64278248434C8DEFD,42231,4,7,3,37,46,1896
83588,83588,134576DA7F5F26F64278248434C8DEFD,42351,8,13,5,38,45,1945
83589,83589,134576DA7F5F26F64278248434C8DEFD,42231,15,23,8,37,46,1896
83594,83594,535378523E09141D94880FBA59BB7297,42941,0,1,1,37,47,1897
83595,83595,535378523E09141D94880FBA59BB7297,42301,2,12,10,36,47,1847
83596,83596,535378523E09141D94880FBA59BB7297,10111,15,16,1,37,47,1897
83597,83597,535378523E09141D94880FBA59BB7297,42301,17,20,3,36,47,1847
83598,83598,DC9866094212A637CCAC17CF01FE4B5F,42861,0,5,5,37,44,1894
83599,83599,DC9866094212A637CCAC17CF01FE4B5F,11261,6,15,9,36,46,1846
83600,83600,DC9866094212A637CCAC17CF01FE4B5F,42861,19,23,4,37,44,1894
83612,83612,1D8BB04BA223F58C0F7219E50B383AFD,11061,0,10,10,29,48,1498
83613,83613,1D8BB04BA223F58C0F7219E50B383AFD,11161,12,14,2,32,48,1648
83614,83614,1D8BB04BA223F58C0F7219E50B383AFD,11061,15,23,8,29,48,1498
83627,83627,10513088CE778D8DABFD80BF0110E28A,11861,0,2,2,32,47,1647
83628,83628,10513088CE778D8DABFD80BF0110E28A,10281,2,7,5,33,48,1698
83629,83629,10513088CE778D8DABFD80BF0110E28A,11861,17,23,6,32,47,1647
83630,83630,6947BD8C9EBED5217B88529152FD3051,42151,0,3,3,35,45,1795
83631,83631,6947BD8C9EBED5217B88529152FD3051,12661,4,5,1,32,45,1645
83632,83632,6947BD8C9EBED5217B88529152FD3051,42151,7,22,15,35,45,1795
83633,83633,D9BB41A84CF921B48387DB07E0CD66FA,11074,0,1,1,37,47,1897
83634,83634,D9BB41A84CF921B48387DB07E0CD66FA,12514,2,3,1,38,47,1947
83635,83635,D9BB41A84CF921B48387DB07E0CD66FA,11074,6,22,16,37,47,1897
83642,83642,0A1386913DE713CBA72662A5149627A3,10331,0,13,13,39,46,1996
83643,83643,0A1386913DE713CBA72662A5149627A3,11941,15,18,3,37,46,1896
83644,83644,0A1386913DE713CBA72662A5149627A3,13711,19,20,1,38,46,1946
83649,83649,C3FB4EE105B7861A50BF03BC1584CA1D,13111,0,13,13,42,46,2146
83650,83650,C3FB4EE105B7861A50BF03BC1584CA1D,42201,13,15,2,43,46,2196
83651,83651,C3FB4EE105B7861A50BF03BC1584CA1D,13111,18,22,4,42,46,2146
83652,83652,829F3CF969A99106A0CF5C6D0ED0FE14,42401,0,12,12,36,47,1847
83653,83653,829F3CF969A99106A0CF5C6D0ED0FE14,10251,13,15,2,35,47,1797
83654,83654,829F3CF969A99106A0CF5C6D0ED0FE14,11751,15,22,7,35,48,1798
83655,83655,0FF23BFDB55A76F1FEA2FEA8A42CA80D,11381,0,3,3,30,47,1547
83656,83656,0FF23BFDB55A76F1FEA2FEA8A42CA80D,11061,5,6,1,29,48,1498
83657,83657,0FF23BFDB55A76F1FEA2FEA8A42CA80D,11381,11,21,10,30,47,1547
83667,83667,387C2BFABED9CD0C7C45EBAD5F5242F9,43731,1,2,1,34,47,1747
83668,83668,387C2BFABED9CD0C7C45EBAD5F5242F9,10251,4,6,2,35,47,1797
83669,83669,387C2BFABED9CD0C7C45EBAD5F5242F9,13511,11,20,9,34,48,1748
83670,83670,B89C35CA6F1DF63420A68A6AF4C6C7B4,42231,7,11,4,37,46,1896
83671,83671,B89C35CA6F1DF63420A68A6AF4C6C7B4,42351,11,13,2,38,45,1945
83672,83672,B89C35CA6F1DF63420A68A6AF4C6C7B4,42231,13,16,3,37,46,1896
83673,83673,B89C35CA6F1DF63420A68A6AF4C6C7B4,42351,16,18,2,38,45,1945
83674,83674,05934617D2337316C96FCF54CF8E0792,10111,0,7,7,37,47,1897
83675,83675,05934617D2337316C96FCF54CF8E0792,40925,9,12,3,35,49,1799
83676,83676,05934617D2337316C96FCF54CF8E0792,10111,13,23,10,37,47,1897
83677,83677,F43FEB2510465EE7C84B58A7ABE7BD0A,10251,0,10,10,35,47,1797
83678,83678,F43FEB2510465EE7C84B58A7ABE7BD0A,12131,12,16,4,32,47,1647
83679,83679,F43FEB2510465EE7C84B58A7ABE7BD0A,42021,16,20,4,33,47,1697
83680,83680,55B62CF97C3AEC62D987D2F1F6626FBA,42311,0,5,5,41,46,2096
83681,83681,55B62CF97C3AEC62D987D2F1F6626FBA,13711,8,15,7,38,46,1946
83682,83682,55B62CF97C3AEC62D987D2F1F6626FBA,42031,16,17,1,40,46,2046
83683,83683,55B62CF97C3AEC62D987D2F1F6626FBA,43041,18,23,5,41,46,2096
83684,83684,A922D7161F816C1FD25F52BCCB616DFE,40673,0,6,6,36,48,1848
83685,83685,A922D7161F816C1FD25F52BCCB616DFE,10251,7,20,13,35,47,1797
83686,83686,A922D7161F816C1FD25F52BCCB616DFE,40673,22,23,1,36,48,1848
83687,83687,5E269639C787C5D2BDF7F359B5257597,13381,0,8,8,39,47,1997
83688,83688,5E269639C787C5D2BDF7F359B5257597,11481,8,18,10,41,48,2098
83689,83689,5E269639C787C5D2BDF7F359B5257597,13381,22,23,1,39,47,1997
83715,83715,CDB099B491677D869C1DFE34BF030C9E,42351,0,1,1,38,45,1945
83716,83716,CDB099B491677D869C1DFE34BF030C9E,42231,3,7,4,37,46,1896
83717,83717,CDB099B491677D869C1DFE34BF030C9E,42351,11,19,8,38,45,1945
83718,83718,CDB099B491677D869C1DFE34BF030C9E,11261,21,23,2,36,46,1846
83725,83725,FCD4BFDC7E207C6BC86BD2099528C9B8,11861,0,4,4,32,47,1647
83726,83726,FCD4BFDC7E207C6BC86BD2099528C9B8,10281,4,19,15,33,48,1698
83727,83727,FCD4BFDC7E207C6BC86BD2099528C9B8,43761,20,21,1,32,47,1647
83731,83731,D9B0439F3B0C81F4C0A4571FAB2A3A71,42021,1,5,4,33,47,1697
83732,83732,D9B0439F3B0C81F4C0A4571FAB2A3A71,11861,6,12,6,32,47,1647
83733,83733,D9B0439F3B0C81F4C0A4571FAB2A3A71,42021,14,18,4,33,47,1697
83739,83739,4B5C492CF16B079882322240829D6566,11231,0,7,7,37,49,1899
83740,83740,4B5C492CF16B079882322240829D6566,40502,8,17,9,36,48,1848
83741,83741,4B5C492CF16B079882322240829D6566,11231,17,19,2,37,49,1899
83742,83742,4B5C492CF16B079882322240829D6566,43281,22,23,1,37,48,1898
83747,83747,D7B4DEFCB86C55D027A1210EEC02063B,11231,0,1,1,37,49,1899
83748,83748,D7B4DEFCB86C55D027A1210EEC02063B,11021,1,20,19,36,49,1849
83749,83749,D7B4DEFCB86C55D027A1210EEC02063B,11231,20,23,3,37,49,1899
83750,83750,BA82D8F6A8707F20D96FD8F810B92699,42861,0,7,7,37,44,1894
83751,83751,BA82D8F6A8707F20D96FD8F810B92699,11261,7,11,4,36,46,1846
83752,83752,BA82D8F6A8707F20D96FD8F810B92699,42861,12,23,11,37,44,1894
83753,83753,11D0C3BFA1EEA48E71CAB72BD84A5D2F,10634,0,6,6,27,45,1395
83754,83754,11D0C3BFA1EEA48E71CAB72BD84A5D2F,13671,6,7,1,27,43,1393
83755,83755,11D0C3BFA1EEA48E71CAB72BD84A5D2F,10351,10,13,3,28,45,1445
83756,83756,11D0C3BFA1EEA48E71CAB72BD84A5D2F,10634,13,23,10,27,45,1395
83762,83762,D8B46FFCD15B641FB93B8219A29A7205,10251,1,9,8,35,47,1797
83763,83763,D8B46FFCD15B641FB93B8219A29A7205,40637,10,12,2,36,47,1847
83764,83764,D8B46FFCD15B641FB93B8219A29A7205,10111,12,21,9,37,47,1897
83765,83765,D8B46FFCD15B641FB93B8219A29A7205,42301,22,23,1,36,47,1847
83766,83766,7F78752A70A41E260D80D552F245436B,10301,0,5,5,31,45,1595
83767,83767,7F78752A70A41E260D80D552F245436B,12311,9,17,8,30,44,1544
83768,83768,7F78752A70A41E260D80D552F245436B,11875,18,19,1,30,46,1546
83769,83769,722F93E6CE54FADD6A9BE8EB60306018,43161,0,10,10,35,47,1797
83770,83770,722F93E6CE54FADD6A9BE8EB60306018,10221,12,13,1,34,49,1749
83771,83771,722F93E6CE54FADD6A9BE8EB60306018,11491,18,20,2,36,47,1847
83772,83772,722F93E6CE54FADD6A9BE8EB60306018,10971,21,23,2,35,47,1797
83783,83783,1C184E544EE72EBCB4C6C69605221F85,42071,1,16,15,31,49,1599
83784,83784,1C184E544EE72EBCB4C6C69605221F85,11061,18,19,1,29,48,1498
83785,83785,1C184E544EE72EBCB4C6C69605221F85,11151,20,21,1,30,48,1548
83786,83786,0C2B805EE888E91F034AB21F925F07C4,19901,0,6,6,7,44,394
83787,83787,0C2B805EE888E91F034AB21F925F07C4,12641,7,8,1,10,43,543
83788,83788,0C2B805EE888E91F034AB21F925F07C4,19901,13,18,5,7,44,394
83789,83789,0C2B805EE888E91F034AB21F925F07C4,12641,20,22,2,10,43,543
83790,83790,F48A53EEDFFA8DE67536F9062139AC78,12211,0,6,6,41,44,2094
83791,83791,F48A53EEDFFA8DE67536F9062139AC78,13341,6,16,10,44,45,2245
83792,83792,F48A53EEDFFA8DE67536F9062139AC78,12211,19,23,4,41,44,2094
83793,83793,A32DF7F91BA5DF29E0CC0A23C60F35BC,42351,0,6,6,38,45,1945
83794,83794,A32DF7F91BA5DF29E0CC0A23C60F35BC,42151,11,13,2,35,45,1795
83795,83795,A32DF7F91BA5DF29E0CC0A23C60F35BC,13911,14,23,9,39,46,1996
83796,83796,A6EF3AA52D2C883DD4C8A6E9BED0EE14,19111,0,13,13,9,45,495
83797,83797,A6EF3AA52D2C883DD4C8A6E9BED0EE14,12921,13,18,5,9,41,491
83798,83798,A6EF3AA52D2C883DD4C8A6E9BED0EE14,19111,19,23,4,9,45,495
83817,83817,3C8A45B2A39299B87D30CF6AF1740216,42321,0,7,7,43,47,2197
83818,83818,3C8A45B2A39299B87D30CF6AF1740216,11701,10,11,1,43,48,2198
83819,83819,3C8A45B2A39299B87D30CF6AF1740216,42461,13,23,10,45,47,2297
83842,83842,034BF108F7447DC54755E0BD15E86728,42351,0,9,9,38,45,1945
83843,83843,034BF108F7447DC54755E0BD15E86728,11261,10,22,12,36,46,1846
83844,83844,034BF108F7447DC54755E0BD15E86728,42351,22,23,1,38,45,1945
83845,83845,60DB2F1E5C63BE640D47B87EE3CFB05B,42461,0,6,6,45,47,2297
83846,83846,60DB2F1E5C63BE640D47B87EE3CFB05B,42321,9,18,9,43,47,2197
83847,83847,60DB2F1E5C63BE640D47B87EE3CFB05B,42461,21,23,2,45,47,2297
83848,83848,9BBBC00C93BA6A3176E2B008E6F8A88E,13911,1,8,7,39,46,1996
83849,83849,9BBBC00C93BA6A3176E2B008E6F8A88E,11261,8,10,2,36,46,1846
83850,83850,9BBBC00C93BA6A3176E2B008E6F8A88E,13911,10,23,13,39,46,1996
83851,83851,01067BD464140B42D6F1D4D82F8B8EE7,43481,3,7,4,39,48,1998
83852,83852,01067BD464140B42D6F1D4D82F8B8EE7,11231,8,15,7,37,49,1899
83853,83853,01067BD464140B42D6F1D4D82F8B8EE7,43481,19,23,4,39,48,1998
83870,83870,8073345703B614CB6E971148A63B1D93,10471,2,10,8,37,48,1898
83871,83871,8073345703B614CB6E971148A63B1D93,11231,11,15,4,37,49,1899
83872,83872,8073345703B614CB6E971148A63B1D93,10471,15,18,3,37,48,1898
83873,83873,8073345703B614CB6E971148A63B1D93,11231,18,20,2,37,49,1899
83887,83887,BA4F4CAA9829C92A824ABAF2840F531D,13651,0,17,17,30,47,1547
83888,83888,BA4F4CAA9829C92A824ABAF2840F531D,12121,18,19,1,29,47,1497
83889,83889,BA4F4CAA9829C92A824ABAF2840F531D,13651,20,21,1,30,47,1547
83898,83898,DEAED68AE3C073AACA878B29D6C9BBC2,42231,0,8,8,37,46,1896
83899,83899,DEAED68AE3C073AACA878B29D6C9BBC2,42351,9,10,1,38,45,1945
83900,83900,DEAED68AE3C073AACA878B29D6C9BBC2,41551,11,18,7,37,46,1896
83916,83916,22300DEAB3F7A20A2F8DD7892A11C5B7,13271,0,6,6,41,47,2097
83917,83917,22300DEAB3F7A20A2F8DD7892A11C5B7,11806,8,9,1,41,48,2098
83918,83918,22300DEAB3F7A20A2F8DD7892A11C5B7,13271,9,18,9,41,47,2097
83945,83945,2913724A9957EDEB24A0554F9C389C52,43581,0,8,8,33,48,1698
83946,83946,2913724A9957EDEB24A0554F9C389C52,10881,12,17,5,34,48,1748
83947,83947,2913724A9957EDEB24A0554F9C389C52,10221,18,23,5,34,49,1749
83952,83952,61FE9E4ADC6B44DA1343098328798A15,42161,0,8,8,36,47,1847
83953,83953,61FE9E4ADC6B44DA1343098328798A15,10251,8,17,9,35,47,1797
83954,83954,61FE9E4ADC6B44DA1343098328798A15,42161,17,22,5,36,47,1847
83961,83961,B911D2D703AF66AE5C6EA0C9A01EAA38,43061,8,9,1,43,46,2196
83962,83962,B911D2D703AF66AE5C6EA0C9A01EAA38,42461,13,15,2,45,47,2297
83963,83963,B911D2D703AF66AE5C6EA0C9A01EAA38,40801,18,23,5,43,46,2196
83964,83964,35DD9916CEBCBDF33EB9616816B572A0,10841,0,15,15,37,47,1897
83965,83965,35DD9916CEBCBDF33EB9616816B572A0,12021,17,19,2,37,49,1899
83966,83966,35DD9916CEBCBDF33EB9616816B572A0,10841,20,21,1,37,47,1897
83967,83967,2F8FBE6FB38F00CB192B148FD4827906,40697,0,1,1,43,48,2198
83968,83968,2F8FBE6FB38F00CB192B148FD4827906,42601,4,6,2,44,48,2248
83969,83969,2F8FBE6FB38F00CB192B148FD4827906,42321,6,13,7,43,47,2197
83970,83970,2F8FBE6FB38F00CB192B148FD4827906,11701,13,23,10,43,48,2198
83986,83986,AB5381797B6ADC5A15B6453B748F1596,42231,0,6,6,37,46,1896
83987,83987,AB5381797B6ADC5A15B6453B748F1596,11261,10,11,1,36,46,1846
83988,83988,AB5381797B6ADC5A15B6453B748F1596,42301,15,23,8,36,47,1847
84019,84019,CC19EED9F2ABAC6ADFE16D259BF20765,13121,0,8,8,38,46,1946
84020,84020,CC19EED9F2ABAC6ADFE16D259BF20765,10601,11,13,2,39,47,1997
84021,84021,CC19EED9F2ABAC6ADFE16D259BF20765,10331,15,18,3,39,46,1996
84022,84022,CC19EED9F2ABAC6ADFE16D259BF20765,10601,18,22,4,39,47,1997
84023,84023,13E192A41573EE21B0A86028C0154874,42471,0,3,3,35,49,1799
84024,84024,13E192A41573EE21B0A86028C0154874,11021,10,12,2,36,49,1849
84025,84025,13E192A41573EE21B0A86028C0154874,42471,21,23,2,35,49,1799
84039,84039,21D029E4FB71F3A5DA880019FDFB9BC1,12491,0,13,13,36,43,1843
84040,84040,21D029E4FB71F3A5DA880019FDFB9BC1,42151,13,15,2,35,45,1795
84041,84041,21D029E4FB71F3A5DA880019FDFB9BC1,12491,17,23,6,36,43,1843
84049,84049,B2012EE6BD195EC80673B0F2B5EC1C5E,12921,5,8,3,9,41,491
84050,84050,B2012EE6BD195EC80673B0F2B5EC1C5E,12641,13,20,7,10,43,543
84051,84051,B2012EE6BD195EC80673B0F2B5EC1C5E,12921,21,22,1,9,41,491
84060,84060,352096E3991181C67844F4354A15AB8E,10501,10,11,1,22,46,1146
84061,84061,352096E3991181C67844F4354A15AB8E,11361,16,17,1,22,48,1148
84062,84062,352096E3991181C67844F4354A15AB8E,10501,20,23,3,22,46,1146
84063,84063,656752102BA99654C7060CE5B2133D72,49201,0,6,6,7,41,391
84064,84064,656752102BA99654C7060CE5B2133D72,12921,6,8,2,9,41,491
84065,84065,656752102BA99654C7060CE5B2133D72,49201,11,22,11,7,41,391
84080,84080,D44EDEFE20C6E53FAD2290D9CECCD593,42041,0,7,7,10,47,547
84081,84081,D44EDEFE20C6E53FAD2290D9CECCD593,19441,9,10,1,8,46,446
84082,84082,D44EDEFE20C6E53FAD2290D9CECCD593,42041,12,22,10,10,47,547
84088,84088,583602182C31C8E2D985404EA5592339,12921,6,9,3,9,41,491
84089,84089,583602182C31C8E2D985404EA5592339,12641,11,15,4,10,43,543
84090,84090,583602182C31C8E2D985404EA5592339,12921,20,22,2,9,41,491
84099,84099,51A2536DC5AFC4EEB93CC591C326CF9C,42523,0,13,13,31,47,1597
84100,84100,51A2536DC5AFC4EEB93CC591C326CF9C,43761,16,17,1,32,47,1647
84101,84101,51A2536DC5AFC4EEB93CC591C326CF9C,42523,20,23,3,31,47,1597
84102,84102,B36C8579A2DBF718933C4838B2421A42,40124,1,8,7,38,47,1947
84103,84103,B36C8579A2DBF718933C4838B2421A42,10841,8,10,2,37,47,1897
84104,84104,B36C8579A2DBF718933C4838B2421A42,13121,13,20,7,38,46,1946
84105,84105,D07D1F07E63AF50292E2B99934F4BC91,12311,0,6,6,30,44,1544
84106,84106,D07D1F07E63AF50292E2B99934F4BC91,10292,10,13,3,30,47,1547
84107,84107,D07D1F07E63AF50292E2B99934F4BC91,12311,13,19,6,30,44,1544
84108,84108,BD517E29BD7069EA61B2CA0844AA760E,10731,0,6,6,33,47,1697
84109,84109,BD517E29BD7069EA61B2CA0844AA760E,43761,9,12,3,32,47,1647
84110,84110,BD517E29BD7069EA61B2CA0844AA760E,42523,13,15,2,31,47,1597
84111,84111,BD517E29BD7069EA61B2CA0844AA760E,43761,16,18,2,32,47,1647
84116,84116,B669243E54B52E3D637E736D2859715A,13601,1,8,7,34,47,1747
84117,84117,B669243E54B52E3D637E736D2859715A,10281,9,16,7,33,48,1698
84118,84118,B669243E54B52E3D637E736D2859715A,43731,18,20,2,34,47,1747
84119,84119,2E4C574DAC7F69C7F1AAE96C8E1B2CBB,11061,0,8,8,29,48,1498
84120,84120,2E4C574DAC7F69C7F1AAE96C8E1B2CBB,43311,10,11,1,31,48,1598
84121,84121,2E4C574DAC7F69C7F1AAE96C8E1B2CBB,11061,13,23,10,29,48,1498
84122,84122,04DA073551B2B36368829872415CFF4C,42041,1,2,1,10,47,547
84123,84123,04DA073551B2B36368829872415CFF4C,19441,4,5,1,8,46,446
84124,84124,04DA073551B2B36368829872415CFF4C,42041,6,7,1,10,47,547
84125,84125,04DA073551B2B36368829872415CFF4C,12641,9,19,10,10,43,543
84129,84129,8868A050B2675F1D16135ACF47FD7E3C,12641,0,15,15,10,43,543
84130,84130,8868A050B2675F1D16135ACF47FD7E3C,19114,19,20,1,7,43,393
84131,84131,8868A050B2675F1D16135ACF47FD7E3C,12641,20,21,1,10,43,543
84132,84132,C57E69593CB95494477C252AABEFF884,10811,1,8,7,38,46,1946
84133,84133,C57E69593CB95494477C252AABEFF884,10841,11,18,7,37,47,1897
84134,84134,C57E69593CB95494477C252AABEFF884,10251,19,20,1,35,47,1797
84135,84135,C57E69593CB95494477C252AABEFF884,10841,20,22,2,37,47,1897
84136,84136,21C21587890502DDD311AAE3E126DBBD,11061,0,6,6,29,48,1498
84137,84137,21C21587890502DDD311AAE3E126DBBD,11381,11,13,2,30,47,1547
84138,84138,21C21587890502DDD311AAE3E126DBBD,11061,13,15,2,29,48,1498
84139,84139,21C21587890502DDD311AAE3E126DBBD,11381,15,21,6,30,47,1547
84146,84146,C919A8058ECB429BE0036BE26BF6A160,10251,1,14,13,35,47,1797
84147,84147,C919A8058ECB429BE0036BE26BF6A160,11201,15,16,1,35,49,1799
84148,84148,C919A8058ECB429BE0036BE26BF6A160,10251,18,22,4,35,47,1797
84157,84157,51CA45CA2AACCC83748D6918E9F511C1,12661,1,13,12,32,45,1645
84158,84158,51CA45CA2AACCC83748D6918E9F511C1,42151,14,17,3,35,45,1795
84159,84159,51CA45CA2AACCC83748D6918E9F511C1,12661,21,22,1,32,45,1645
84160,84160,9991D46EB0277AEB31EF086223A18992,42301,0,12,12,36,47,1847
84161,84161,9991D46EB0277AEB31EF086223A18992,10111,17,18,1,37,47,1897
84162,84162,9991D46EB0277AEB31EF086223A18992,10121,19,21,2,36,49,1849
84168,84168,EEB50D1120B866DC7DA221859E2210CE,19114,0,5,5,7,43,393
84169,84169,EEB50D1120B866DC7DA221859E2210CE,12641,6,8,2,10,43,543
84170,84170,EEB50D1120B866DC7DA221859E2210CE,19114,9,11,2,7,43,393
84171,84171,EEB50D1120B866DC7DA221859E2210CE,12641,11,20,9,10,43,543
84176,84176,9ED625402B3991AE30ACC095EEDE57BB,42111,0,5,5,44,46,2246
84177,84177,9ED625402B3991AE30ACC095EEDE57BB,42461,5,15,10,45,47,2297
84178,84178,9ED625402B3991AE30ACC095EEDE57BB,42111,16,18,2,44,46,2246
84179,84179,80138FAE3CC4EDD6A1DF29A745B18CFD,11061,0,8,8,29,48,1498
84180,84180,80138FAE3CC4EDD6A1DF29A745B18CFD,43971,10,19,9,30,48,1548
84181,84181,80138FAE3CC4EDD6A1DF29A745B18CFD,11061,19,21,2,29,48,1498
84204,84204,D429753EEB35077FBB0F7FD7B24671DA,42381,0,5,5,39,41,1991
84205,84205,D429753EEB35077FBB0F7FD7B24671DA,43451,6,17,11,37,40,1890
84206,84206,D429753EEB35077FBB0F7FD7B24671DA,13071,18,20,2,41,41,2091
84207,84207,08EDF1CCFF32686DD950EC26EF30E233,11381,0,19,19,30,47,1547
84208,84208,08EDF1CCFF32686DD950EC26EF30E233,10681,19,22,3,30,48,1548
84209,84209,08EDF1CCFF32686DD950EC26EF30E233,11381,22,23,1,30,47,1547
84210,84210,669E63F80CBEED069AFAAE55F568C87D,13221,0,12,12,40,47,2047
84211,84211,669E63F80CBEED069AFAAE55F568C87D,40833,13,16,3,41,47,2097
84212,84212,669E63F80CBEED069AFAAE55F568C87D,13331,18,22,4,38,47,1947
84219,84219,2C992222ACB93CD1B2234E4466A7A38C,41392,0,9,9,43,48,2198
84220,84220,2C992222ACB93CD1B2234E4466A7A38C,13371,17,19,2,41,47,2097
84221,84221,2C992222ACB93CD1B2234E4466A7A38C,12651,20,21,1,43,47,2197
84234,84234,56480C35E588FCD439D890E8FE82E1FF,19114,0,6,6,7,43,393
84235,84235,56480C35E588FCD439D890E8FE82E1FF,12641,8,9,1,10,43,543
84236,84236,56480C35E588FCD439D890E8FE82E1FF,19114,10,23,13,7,43,393
84246,84246,1432315E02B72C61B42AD2B5294AED3D,42161,0,8,8,36,47,1847
84247,84247,1432315E02B72C61B42AD2B5294AED3D,13511,12,14,2,34,48,1748
84248,84248,1432315E02B72C61B42AD2B5294AED3D,10251,15,23,8,35,47,1797
84249,84249,4A7EF801268FA87DD49AA705DCA560E1,42581,0,17,17,38,48,1948
84250,84250,4A7EF801268FA87DD49AA705DCA560E1,10107,18,19,1,38,49,1949
84251,84251,4A7EF801268FA87DD49AA705DCA560E1,42581,21,23,2,38,48,1948
84256,84256,D3F6CC79419CB8E677F2F17C3DF072CD,13121,4,11,7,38,46,1946
84257,84257,D3F6CC79419CB8E677F2F17C3DF072CD,10271,13,15,2,37,46,1896
84258,84258,D3F6CC79419CB8E677F2F17C3DF072CD,13711,15,23,8,38,46,1946
84259,84259,58FF60972C1637520443DC5766A2AB67,13411,0,2,2,49,42,2492
84260,84260,58FF60972C1637520443DC5766A2AB67,43951,6,18,12,49,41,2491
84261,84261,58FF60972C1637520443DC5766A2AB67,13411,18,23,5,49,42,2492
84262,84262,7011DE96B440B54BDA505351983BAF85,11021,0,15,15,36,49,1849
84263,84263,7011DE96B440B54BDA505351983BAF85,10107,16,18,2,38,49,1949
84264,84264,7011DE96B440B54BDA505351983BAF85,13741,21,23,2,37,49,1899
84265,84265,9951832C875ED15346443116F8C6A7D1,42331,0,7,7,39,46,1996
84266,84266,9951832C875ED15346443116F8C6A7D1,11921,12,13,1,38,48,1948
84267,84267,9951832C875ED15346443116F8C6A7D1,10811,18,23,5,38,46,1946
84268,84268,8D4B76C00151174BC318A19D72794912,12661,0,12,12,32,45,1645
84269,84269,8D4B76C00151174BC318A19D72794912,12311,16,18,2,30,44,1544
84270,84270,8D4B76C00151174BC318A19D72794912,42531,19,20,1,31,45,1595
84288,84288,17BFCEDD973B29E8302E2E7670AFE303,10471,0,15,15,37,48,1898
84289,84289,17BFCEDD973B29E8302E2E7670AFE303,40171,15,16,1,38,48,1948
84290,84290,17BFCEDD973B29E8302E2E7670AFE303,10471,18,23,5,37,48,1898
84296,84296,32C575ECC215F1FC586DD757E9E8F843,13121,0,13,13,38,46,1946
84297,84297,32C575ECC215F1FC586DD757E9E8F843,12841,15,18,3,37,47,1897
84298,84298,32C575ECC215F1FC586DD757E9E8F843,42231,18,23,5,37,46,1896
84299,84299,9BCFE3A528684350BDB247E267E33F3E,42091,0,8,8,43,46,2196
84300,84300,9BCFE3A528684350BDB247E267E33F3E,42461,9,10,1,45,47,2297
84301,84301,9BCFE3A528684350BDB247E267E33F3E,42091,10,23,13,43,46,2196
84302,84302,1A7D05525786038BC8ECE102BFC8462D,10111,0,9,9,37,47,1897
84303,84303,1A7D05525786038BC8ECE102BFC8462D,10251,9,11,2,35,47,1797
84304,84304,1A7D05525786038BC8ECE102BFC8462D,42401,11,13,2,36,47,1847
84305,84305,1A7D05525786038BC8ECE102BFC8462D,10111,14,23,9,37,47,1897
84306,84306,CAC95EFB43F5E49190A4EAC08FB5B4EF,40637,0,3,3,36,47,1847
84307,84307,CAC95EFB43F5E49190A4EAC08FB5B4EF,10251,5,16,11,35,47,1797
84308,84308,CAC95EFB43F5E49190A4EAC08FB5B4EF,40637,19,21,2,36,47,1847
84322,84322,057935907C2B481CA4E4D08E6E9B9029,11841,0,9,9,33,46,1696
84323,84323,057935907C2B481CA4E4D08E6E9B9029,42021,11,16,5,33,47,1697
84324,84324,057935907C2B481CA4E4D08E6E9B9029,11831,16,17,1,32,45,1645
84325,84325,057935907C2B481CA4E4D08E6E9B9029,10531,22,23,1,34,46,1746
84326,84326,4F3F717E93BC5AFE00C4421DCBF0AA01,42301,0,9,9,36,47,1847
84327,84327,4F3F717E93BC5AFE00C4421DCBF0AA01,11261,10,14,4,36,46,1846
84328,84328,4F3F717E93BC5AFE00C4421DCBF0AA01,10821,16,18,2,40,47,2047
84329,84329,4F3F717E93BC5AFE00C4421DCBF0AA01,13711,20,22,2,38,46,1946
84334,84334,F0BADC1DB10F78BE87B4AA8A7F62B3BC,12641,0,11,11,10,43,543
84335,84335,F0BADC1DB10F78BE87B4AA8A7F62B3BC,12921,11,12,1,9,41,491
84336,84336,F0BADC1DB10F78BE87B4AA8A7F62B3BC,12641,14,21,7,10,43,543
84349,84349,DDD4A2411D3DDF8FF51DA78894EED629,12641,7,8,1,10,43,543
84350,84350,DDD4A2411D3DDF8FF51DA78894EED629,19114,8,10,2,7,43,393
84351,84351,DDD4A2411D3DDF8FF51DA78894EED629,12641,12,16,4,10,43,543
84352,84352,DDD4A2411D3DDF8FF51DA78894EED629,19024,17,23,6,9,45,495
84358,84358,6F3F0614427F6E0615C071A6AD947088,10691,0,5,5,33,48,1698
84359,84359,6F3F0614427F6E0615C071A6AD947088,11561,10,11,1,32,49,1649
84360,84360,6F3F0614427F6E0615C071A6AD947088,11324,14,15,1,31,46,1596
84361,84361,6F3F0614427F6E0615C071A6AD947088,10491,19,22,3,33,48,1698
84362,84362,F118442650FD85FBD1BC14112D7133A6,43391,0,18,18,29,48,1498
84363,84363,F118442650FD85FBD1BC14112D7133A6,11151,19,21,2,30,48,1548
84364,84364,F118442650FD85FBD1BC14112D7133A6,43391,21,22,1,29,48,1498
84369,84369,AD225C446E75BA0A979646870A2011B0,42221,0,1,1,38,48,1948
84370,84370,AD225C446E75BA0A979646870A2011B0,11914,2,10,8,37,48,1898
84371,84371,AD225C446E75BA0A979646870A2011B0,42221,12,15,3,38,48,1948
84372,84372,AD225C446E75BA0A979646870A2011B0,11331,15,18,3,37,48,1898
84373,84373,5A3DFD82E1FA00FA267419BADF9C897C,12311,2,11,9,30,44,1544
84374,84374,5A3DFD82E1FA00FA267419BADF9C897C,12661,15,17,2,32,45,1645
84375,84375,5A3DFD82E1FA00FA267419BADF9C897C,12311,19,23,4,30,44,1544
84387,84387,B570A71613653BD3890D6EDB8B29EBC3,11261,0,8,8,36,46,1846
84388,84388,B570A71613653BD3890D6EDB8B29EBC3,42861,8,16,8,37,44,1894
84389,84389,B570A71613653BD3890D6EDB8B29EBC3,11261,19,21,2,36,46,1846
84393,84393,CF6A7AF612D2CFA2B8383868CF93735B,42921,0,13,13,33,47,1697
84394,84394,CF6A7AF612D2CFA2B8383868CF93735B,42523,15,16,1,31,47,1597
84395,84395,CF6A7AF612D2CFA2B8383868CF93735B,42921,18,21,3,33,47,1697
84396,84396,CF6A7AF612D2CFA2B8383868CF93735B,11861,21,23,2,32,47,1647
84397,84397,5B985E49A96AC1F29BC71E54AB886B64,10634,2,4,2,27,45,1395
84398,84398,5B985E49A96AC1F29BC71E54AB886B64,10351,4,12,8,28,45,1445
84399,84399,5B985E49A96AC1F29BC71E54AB886B64,10634,13,21,8,27,45,1395
84400,84400,A4CBFA774BBCB1E081978588796288CA,10901,0,4,4,35,48,1798
84401,84401,A4CBFA774BBCB1E081978588796288CA,12083,4,5,1,36,49,1849
84402,84402,A4CBFA774BBCB1E081978588796288CA,11231,8,17,9,37,49,1899
84403,84403,A4CBFA774BBCB1E081978588796288CA,10901,18,23,5,35,48,1798
84404,84404,5B7D20533455968081F1917AE3C512DE,13711,1,5,4,38,46,1946
84405,84405,5B7D20533455968081F1917AE3C512DE,10841,8,15,7,37,47,1897
84406,84406,5B7D20533455968081F1917AE3C512DE,13121,19,21,2,38,46,1946
84411,84411,AF3BB2EB266D8BDC31553ED7C05B56FE,13671,0,13,13,27,43,1393
84412,84412,AF3BB2EB266D8BDC31553ED7C05B56FE,12311,17,19,2,30,44,1544
84413,84413,AF3BB2EB266D8BDC31553ED7C05B56FE,13671,19,21,2,27,43,1393
84414,84414,D6C1A33FBB24E6DE2C4ABB76F66F2681,10681,0,6,6,30,48,1548
84415,84415,D6C1A33FBB24E6DE2C4ABB76F66F2681,11061,6,7,1,29,48,1498
84416,84416,D6C1A33FBB24E6DE2C4ABB76F66F2681,10681,9,23,14,30,48,1548
84417,84417,F918E466A782C1E37D4CAE1EA64CE5CD,42961,0,9,9,35,49,1799
84418,84418,F918E466A782C1E37D4CAE1EA64CE5CD,13511,10,11,1,34,48,1748
84419,84419,F918E466A782C1E37D4CAE1EA64CE5CD,12971,15,17,2,32,48,1648
84420,84420,F918E466A782C1E37D4CAE1EA64CE5CD,42961,17,23,6,35,49,1799
84421,84421,FCF6425DA3F542476DF1F93935C075D8,42581,0,10,10,38,48,1948
84422,84422,FCF6425DA3F542476DF1F93935C075D8,11914,10,12,2,37,48,1898
84423,84423,FCF6425DA3F542476DF1F93935C075D8,42581,12,23,11,38,48,1948
84424,84424,1A64F5A3A265770889AAFFB5978121E9,42581,4,6,2,38,48,1948
84425,84425,1A64F5A3A265770889AAFFB5978121E9,11914,10,15,5,37,48,1898
84426,84426,1A64F5A3A265770889AAFFB5978121E9,42581,17,20,3,38,48,1948
84427,84427,1A64F5A3A265770889AAFFB5978121E9,11914,20,22,2,37,48,1898
84428,84428,FAEDDD1B29EBE8271DF7B0EAB61C34DD,41401,0,9,9,37,46,1896
84429,84429,FAEDDD1B29EBE8271DF7B0EAB61C34DD,11491,12,13,1,36,47,1847
84430,84430,FAEDDD1B29EBE8271DF7B0EAB61C34DD,41401,18,19,1,37,46,1896
84431,84431,49C79AB3305EA0BDD0BE79CDFA7582CD,42221,4,5,1,38,48,1948
84432,84432,49C79AB3305EA0BDD0BE79CDFA7582CD,11074,8,16,8,37,47,1897
84433,84433,49C79AB3305EA0BDD0BE79CDFA7582CD,11291,16,18,2,40,49,2049
84434,84434,49C79AB3305EA0BDD0BE79CDFA7582CD,42221,20,21,1,38,48,1948
84444,84444,B1C87A4CAAE0481F567B41D78D33032A,11941,0,11,11,37,46,1896
84445,84445,B1C87A4CAAE0481F567B41D78D33032A,11074,13,15,2,37,47,1897
84446,84446,B1C87A4CAAE0481F567B41D78D33032A,10471,20,23,3,37,48,1898
84458,84458,312060B326A149D1F0009EDC937831B5,42161,0,7,7,36,47,1847
84459,84459,312060B326A149D1F0009EDC937831B5,11271,9,12,3,37,48,1898
84460,84460,312060B326A149D1F0009EDC937831B5,42401,15,23,8,36,47,1847
84466,84466,5E2A058AE896AE135BA0B62389F16C16,10295,0,14,14,30,47,1547
84467,84467,5E2A058AE896AE135BA0B62389F16C16,42523,15,17,2,31,47,1597
84468,84468,5E2A058AE896AE135BA0B62389F16C16,10292,19,21,2,30,47,1547
84469,84469,787E2D15898542A785C91CF72E674285,13911,0,13,13,39,46,1996
84470,84470,787E2D15898542A785C91CF72E674285,11261,13,16,3,36,46,1846
84471,84471,787E2D15898542A785C91CF72E674285,42231,20,22,2,37,46,1896
84472,84472,ABA31A886DA5135F00BAFC3DAD048D98,41551,0,6,6,37,46,1896
84473,84473,ABA31A886DA5135F00BAFC3DAD048D98,12083,7,19,12,36,49,1849
84474,84474,ABA31A886DA5135F00BAFC3DAD048D98,11231,20,23,3,37,49,1899
84475,84475,2B75D649D733D42AAC85CA634BF0D07B,11914,0,13,13,37,48,1898
84476,84476,2B75D649D733D42AAC85CA634BF0D07B,42581,13,15,2,38,48,1948
84477,84477,2B75D649D733D42AAC85CA634BF0D07B,11914,17,19,2,37,48,1898
84478,84478,77EA23FEBF1AF98A4F6293E826F27BD4,42271,1,16,15,40,47,2047
84479,84479,77EA23FEBF1AF98A4F6293E826F27BD4,10601,19,20,1,39,47,1997
84480,84480,77EA23FEBF1AF98A4F6293E826F27BD4,11806,22,23,1,41,48,2098
84481,84481,61FCFAF6CF96194170CA47541D5EEB94,10271,0,6,6,37,46,1896
84482,84482,61FCFAF6CF96194170CA47541D5EEB94,40124,11,15,4,38,47,1947
84483,84483,61FCFAF6CF96194170CA47541D5EEB94,10841,16,19,3,37,47,1897
84484,84484,99E092074374943B9AF88B78AA0A024F,11531,9,11,2,34,49,1749
84485,84485,99E092074374943B9AF88B78AA0A024F,42021,13,16,3,33,47,1697
84486,84486,99E092074374943B9AF88B78AA0A024F,13601,16,19,3,34,47,1747
84487,84487,1ECB7758304FB0B6302614AF93330553,12311,0,5,5,30,44,1544
84488,84488,1ECB7758304FB0B6302614AF93330553,12661,8,10,2,32,45,1645
84489,84489,1ECB7758304FB0B6302614AF93330553,12311,12,20,8,30,44,1544
84501,84501,9BCD563089A1D0EF43A278605DE25081,42351,1,2,1,38,45,1945
84502,84502,9BCD563089A1D0EF43A278605DE25081,13911,6,8,2,39,46,1996
84503,84503,9BCD563089A1D0EF43A278605DE25081,42231,9,17,8,37,46,1896
84504,84504,9BCD563089A1D0EF43A278605DE25081,13911,20,23,3,39,46,1996
84505,84505,AF59272BD38B2004FD68A8422AAADDEB,10621,0,8,8,41,49,2099
84506,84506,AF59272BD38B2004FD68A8422AAADDEB,13111,9,10,1,42,46,2146
84507,84507,AF59272BD38B2004FD68A8422AAADDEB,10621,13,23,10,41,49,2099
84511,84511,EDB788D4E7F89E0576F30050E5A3B908,12601,2,9,7,25,47,1297
84512,84512,EDB788D4E7F89E0576F30050E5A3B908,10501,13,15,2,22,46,1146
84513,84513,EDB788D4E7F89E0576F30050E5A3B908,12601,18,23,5,25,47,1297
84526,84526,4487C805393F33B74D5C555A744300BD,42521,0,6,6,31,47,1597
84527,84527,4487C805393F33B74D5C555A744300BD,11381,9,11,2,30,47,1547
84528,84528,4487C805393F33B74D5C555A744300BD,42521,13,18,5,31,47,1597
84529,84529,A71AF189763CBF3E45D468B893870CE7,10901,1,8,7,35,48,1798
84530,84530,A71AF189763CBF3E45D468B893870CE7,40951,8,13,5,36,49,1849
84531,84531,A71AF189763CBF3E45D468B893870CE7,10901,14,23,9,35,48,1798
84538,84538,2EB3873FC04DE2FE7DCCB48F35926C6A,11021,0,12,12,36,49,1849
84539,84539,2EB3873FC04DE2FE7DCCB48F35926C6A,40637,12,16,4,36,47,1847
84540,84540,2EB3873FC04DE2FE7DCCB48F35926C6A,11021,18,23,5,36,49,1849
84572,84572,6F947024A8B73B97F8430A4C48FA1DF6,12083,0,13,13,36,49,1849
84573,84573,6F947024A8B73B97F8430A4C48FA1DF6,13741,13,16,3,37,49,1899
84574,84574,6F947024A8B73B97F8430A4C48FA1DF6,10107,17,18,1,38,49,1949
84575,84575,6F947024A8B73B97F8430A4C48FA1DF6,13561,18,20,2,37,49,1899
84580,84580,DDA0748B2338452391EBA627D104CDA8,40611,0,7,7,35,47,1797
84581,84581,DDA0748B2338452391EBA627D104CDA8,40951,12,14,2,36,49,1849
84582,84582,DDA0748B2338452391EBA627D104CDA8,42471,15,18,3,35,49,1799
84583,84583,DDA0748B2338452391EBA627D104CDA8,40611,21,23,2,35,47,1797
84587,84587,AEE701715FEFA9408B3EA20922F57230,11731,0,15,15,36,48,1848
84588,84588,AEE701715FEFA9408B3EA20922F57230,10251,18,22,4,35,47,1797
84589,84589,AEE701715FEFA9408B3EA20922F57230,11731,22,23,1,36,48,1848
84590,84590,2415E2465DF6D046DC5E15AEEDDF590D,42221,2,16,14,38,48,1948
84591,84591,2415E2465DF6D046DC5E15AEEDDF590D,10841,18,19,1,37,47,1897
84592,84592,2415E2465DF6D046DC5E15AEEDDF590D,42221,20,22,2,38,48,1948
84603,84603,E75D1208CCB6584D626AF19262583C8D,10331,2,10,8,39,46,1996
84604,84604,E75D1208CCB6584D626AF19262583C8D,13121,11,13,2,38,46,1946
84605,84605,E75D1208CCB6584D626AF19262583C8D,13111,18,20,2,42,46,2146
84606,84606,2CA8B4497443A989B915999C140B8389,19441,0,10,10,8,46,446
84607,84607,2CA8B4497443A989B915999C140B8389,42041,13,16,3,10,47,547
84608,84608,2CA8B4497443A989B915999C140B8389,19441,20,23,3,8,46,446
84609,84609,80E9873206E5F40B6B76F9F9775BD886,11941,1,13,12,37,46,1896
84610,84610,80E9873206E5F40B6B76F9F9775BD886,11841,18,19,1,33,46,1696
84611,84611,80E9873206E5F40B6B76F9F9775BD886,12514,19,22,3,38,47,1947
84612,84612,84DA01F112661472BCB344139BA68924,43061,0,16,16,43,46,2196
84613,84613,84DA01F112661472BCB344139BA68924,13341,17,18,1,44,45,2245
84614,84614,84DA01F112661472BCB344139BA68924,43061,21,23,2,43,46,2196
84620,84620,1788FF83230593384DFEF88881720D90,13551,0,2,2,45,38,2288
84621,84621,1788FF83230593384DFEF88881720D90,43101,7,12,5,46,40,2340
84622,84622,1788FF83230593384DFEF88881720D90,13551,12,15,3,45,38,2288
84623,84623,1788FF83230593384DFEF88881720D90,43101,16,19,3,46,40,2340
84624,84624,F7F6E311089E545E2ADE21E1CFF4D206,42921,0,1,1,33,47,1697
84625,84625,F7F6E311089E545E2ADE21E1CFF4D206,42523,3,15,12,31,47,1597
84626,84626,F7F6E311089E545E2ADE21E1CFF4D206,40636,20,23,3,35,48,1798
84627,84627,B95B29D5CA64F1AA4B456B964A6F0CEA,12641,0,5,5,10,43,543
84628,84628,B95B29D5CA64F1AA4B456B964A6F0CEA,19114,7,8,1,7,43,393
84629,84629,B95B29D5CA64F1AA4B456B964A6F0CEA,12641,12,22,10,10,43,543
84640,84640,0DFD98C5BF618352145AEF64606DF221,10251,0,1,1,35,47,1797
84641,84641,0DFD98C5BF618352145AEF64606DF221,40673,5,15,10,36,48,1848
84642,84642,0DFD98C5BF618352145AEF64606DF221,10251,15,18,3,35,47,1797
84643,84643,0DFD98C5BF618352145AEF64606DF221,42401,20,23,3,36,47,1847
84654,84654,88D3AECB79C42D19C5311DB0C1B36772,42301,0,6,6,36,47,1847
84655,84655,88D3AECB79C42D19C5311DB0C1B36772,10271,7,11,4,37,46,1896
84656,84656,88D3AECB79C42D19C5311DB0C1B36772,42301,12,13,1,36,47,1847
84657,84657,88D3AECB79C42D19C5311DB0C1B36772,10271,15,22,7,37,46,1896
84669,84669,02EE2A9621F66BD6F8785DE528B34698,11061,3,9,6,29,48,1498
84670,84670,02EE2A9621F66BD6F8785DE528B34698,10681,9,11,2,30,48,1548
84671,84671,02EE2A9621F66BD6F8785DE528B34698,11061,11,20,9,29,48,1498
84680,84680,9AF6F4C6C4937C91C918EC9853CABA28,42861,9,15,6,37,44,1894
84681,84681,9AF6F4C6C4937C91C918EC9853CABA28,11261,16,17,1,36,46,1846
84682,84682,9AF6F4C6C4937C91C918EC9853CABA28,42861,18,21,3,37,44,1894
84690,84690,21709F7FFA433548AE3C0AA8A76FE0E7,11151,0,4,4,30,48,1548
84691,84691,21709F7FFA433548AE3C0AA8A76FE0E7,10381,5,10,5,31,49,1599
84692,84692,21709F7FFA433548AE3C0AA8A76FE0E7,11151,11,23,12,30,48,1548
84693,84693,3717F18D88C40095DBADE8C95C390E6F,42861,2,3,1,37,44,1894
84694,84694,3717F18D88C40095DBADE8C95C390E6F,42151,6,7,1,35,45,1795
84695,84695,3717F18D88C40095DBADE8C95C390E6F,42861,8,13,5,37,44,1894
84696,84696,3717F18D88C40095DBADE8C95C390E6F,42151,15,23,8,35,45,1795
84707,84707,1D9B3BEAA73444A543D0673D1FBABCFF,42161,0,13,13,36,47,1847
84708,84708,1D9B3BEAA73444A543D0673D1FBABCFF,42511,15,18,3,37,47,1897
84709,84709,1D9B3BEAA73444A543D0673D1FBABCFF,42161,18,23,5,36,47,1847
84717,84717,8DBACFB5D036C4C4C672479DCBBEC229,10471,0,19,19,37,48,1898
84718,84718,8DBACFB5D036C4C4C672479DCBBEC229,10107,19,21,2,38,49,1949
84719,84719,8DBACFB5D036C4C4C672479DCBBEC229,10471,22,23,1,37,48,1898
84720,84720,92C829C196D69D1F6785C73B9B016B15,11875,0,20,20,30,46,1546
84721,84721,92C829C196D69D1F6785C73B9B016B15,11381,20,21,1,30,47,1547
84722,84722,92C829C196D69D1F6785C73B9B016B15,11875,22,23,1,30,46,1546
84727,84727,D75839547F19BC6AA2555211CD306BBE,12514,0,10,10,38,47,1947
84728,84728,D75839547F19BC6AA2555211CD306BBE,42161,11,13,2,36,47,1847
84729,84729,D75839547F19BC6AA2555211CD306BBE,11074,13,18,5,37,47,1897
84730,84730,D75839547F19BC6AA2555211CD306BBE,12514,19,23,4,38,47,1947
84731,84731,399F7F15C7463CF14BF46D2F4065875E,10471,5,18,13,37,48,1898
84732,84732,399F7F15C7463CF14BF46D2F4065875E,43731,18,19,1,34,47,1747
84733,84733,399F7F15C7463CF14BF46D2F4065875E,10471,22,23,1,37,48,1898
84734,84734,1A5BED51D45595E1322F7C9DAB1FCF2D,13341,0,7,7,44,45,2245
84735,84735,1A5BED51D45595E1322F7C9DAB1FCF2D,43051,7,9,2,46,45,2345
84736,84736,1A5BED51D45595E1322F7C9DAB1FCF2D,13341,19,23,4,44,45,2245
84762,84762,10D100E56D8E505C358E7A0F36D0F9CD,10691,0,6,6,33,48,1698
84763,84763,10D100E56D8E505C358E7A0F36D0F9CD,11561,10,12,2,32,49,1649
84764,84764,10D100E56D8E505C358E7A0F36D0F9CD,11861,13,15,2,32,47,1647
84765,84765,10D100E56D8E505C358E7A0F36D0F9CD,10691,19,23,4,33,48,1698
84771,84771,4DA57F9F33C37E2CA21407DE781C18AF,13911,0,4,4,39,46,1996
84772,84772,4DA57F9F33C37E2CA21407DE781C18AF,11261,5,6,1,36,46,1846
84773,84773,4DA57F9F33C37E2CA21407DE781C18AF,13911,6,8,2,39,46,1996
84774,84774,4DA57F9F33C37E2CA21407DE781C18AF,11261,8,19,11,36,46,1846
84775,84775,A2DFDB4F0C6E67DA3B02A082B81B0C31,11061,0,2,2,29,48,1498
84776,84776,A2DFDB4F0C6E67DA3B02A082B81B0C31,11381,3,11,8,30,47,1547
84777,84777,A2DFDB4F0C6E67DA3B02A082B81B0C31,11061,12,23,11,29,48,1498
84788,84788,CEDE33B1516DA1FDFA461E824873495E,10971,10,12,2,35,47,1797
84789,84789,CEDE33B1516DA1FDFA461E824873495E,13331,15,17,2,38,47,1947
84790,84790,CEDE33B1516DA1FDFA461E824873495E,10251,18,22,4,35,47,1797
84791,84791,7EBD3BA762C40F1F8A712F803B7D8FD3,42151,0,12,12,35,45,1795
84792,84792,7EBD3BA762C40F1F8A712F803B7D8FD3,12491,12,16,4,36,43,1843
84793,84793,7EBD3BA762C40F1F8A712F803B7D8FD3,42151,19,22,3,35,45,1795
84794,84794,181802B57A29F4FAE1E7EF60B334A9D5,13911,0,11,11,39,46,1996
84795,84795,181802B57A29F4FAE1E7EF60B334A9D5,11261,12,14,2,36,46,1846
84796,84796,181802B57A29F4FAE1E7EF60B334A9D5,13911,15,16,1,39,46,1996
84797,84797,181802B57A29F4FAE1E7EF60B334A9D5,42351,19,21,2,38,45,1945
84803,84803,2317EEF942E511029895E416C1875CE5,10281,0,8,8,33,48,1698
84804,84804,2317EEF942E511029895E416C1875CE5,42641,18,20,2,33,49,1699
84805,84805,2317EEF942E511029895E416C1875CE5,10281,21,22,1,33,48,1698
84816,84816,44B392D88AA7F1B21F1FF6A57BADBD84,42231,0,11,11,37,46,1896
84817,84817,44B392D88AA7F1B21F1FF6A57BADBD84,13711,11,14,3,38,46,1946
84818,84818,44B392D88AA7F1B21F1FF6A57BADBD84,42231,17,21,4,37,46,1896
84819,84819,18CC713B80CCF9AB1A7B146FB6B3AAAC,10271,0,13,13,37,46,1896
84820,84820,18CC713B80CCF9AB1A7B146FB6B3AAAC,13711,13,15,2,38,46,1946
84821,84821,18CC713B80CCF9AB1A7B146FB6B3AAAC,10271,16,22,6,37,46,1896
84822,84822,2AF89DEED75DB8851AE7FFBF60B05447,41591,0,11,11,34,49,1749
84823,84823,2AF89DEED75DB8851AE7FFBF60B05447,10531,15,16,1,34,46,1746
84824,84824,2AF89DEED75DB8851AE7FFBF60B05447,10511,18,20,2,35,46,1796
84825,84825,DFB39D9C16979A7A210D773BBB4B6305,42351,0,11,11,38,45,1945
84826,84826,DFB39D9C16979A7A210D773BBB4B6305,11261,12,17,5,36,46,1846
84827,84827,DFB39D9C16979A7A210D773BBB4B6305,42351,17,23,6,38,45,1945
84838,84838,AB45C6D4DFF8370476E2476D3FA63031,19441,1,5,4,8,46,446
84839,84839,AB45C6D4DFF8370476E2476D3FA63031,42041,6,8,2,10,47,547
84840,84840,AB45C6D4DFF8370476E2476D3FA63031,19441,12,20,8,8,46,446
84841,84841,AB45C6D4DFF8370476E2476D3FA63031,42041,20,21,1,10,47,547
84847,84847,545B57FE377B53DF15322A3E629D81E6,12921,0,5,5,9,41,491
84848,84848,545B57FE377B53DF15322A3E629D81E6,49201,10,12,2,7,41,391
84849,84849,545B57FE377B53DF15322A3E629D81E6,12921,12,23,11,9,41,491
84861,84861,826B40817E61853148AFBFECB1C48C70,11261,1,8,7,36,46,1846
84862,84862,826B40817E61853148AFBFECB1C48C70,42864,9,11,2,38,44,1944
84863,84863,826B40817E61853148AFBFECB1C48C70,11261,11,12,1,36,46,1846
84864,84864,826B40817E61853148AFBFECB1C48C70,42861,13,19,6,37,44,1894
84870,84870,81E9C3858C44D7DA57E9FCCB87C1B34F,10251,4,8,4,35,47,1797
84871,84871,81E9C3858C44D7DA57E9FCCB87C1B34F,11231,11,13,2,37,49,1899
84872,84872,81E9C3858C44D7DA57E9FCCB87C1B34F,10691,15,19,4,33,48,1698
84873,84873,81E9C3858C44D7DA57E9FCCB87C1B34F,10251,20,23,3,35,47,1797
84874,84874,92E340B82C56A45F91D53CD2B709557E,42581,6,9,3,38,48,1948
84875,84875,92E340B82C56A45F91D53CD2B709557E,11911,9,11,2,37,48,1898
84876,84876,92E340B82C56A45F91D53CD2B709557E,42581,11,13,2,38,48,1948
84877,84877,92E340B82C56A45F91D53CD2B709557E,11914,17,18,1,37,48,1898
84882,84882,2A8CA6F11C450B23235B353369F9B4CE,11914,2,7,5,37,48,1898
84883,84883,2A8CA6F11C450B23235B353369F9B4CE,12514,11,12,1,38,47,1947
84884,84884,2A8CA6F11C450B23235B353369F9B4CE,42221,15,16,1,38,48,1948
84885,84885,2A8CA6F11C450B23235B353369F9B4CE,12514,20,21,1,38,47,1947
84886,84886,44EC2B0D5EE5BD6B35ABC292F1B0BE4A,19114,0,8,8,7,43,393
84887,84887,44EC2B0D5EE5BD6B35ABC292F1B0BE4A,12921,9,11,2,9,41,491
84888,84888,44EC2B0D5EE5BD6B35ABC292F1B0BE4A,19114,15,23,8,7,43,393
84893,84893,2F587428DDB862E4E59F38660C68BB9E,10901,0,8,8,35,48,1798
84894,84894,2F587428DDB862E4E59F38660C68BB9E,11231,8,18,10,37,49,1899
84895,84895,2F587428DDB862E4E59F38660C68BB9E,10901,18,23,5,35,48,1798
84914,84914,C6869A64CA9EF97A25D7192A00726FC2,42401,0,9,9,36,47,1847
84915,84915,C6869A64CA9EF97A25D7192A00726FC2,10781,10,18,8,35,47,1797
84916,84916,C6869A64CA9EF97A25D7192A00726FC2,42401,19,23,4,36,47,1847
84917,84917,57068447BEEE4D7969FF166D57966ECA,42541,0,6,6,25,47,1297
84918,84918,57068447BEEE4D7969FF166D57966ECA,11361,6,7,1,22,48,1148
84919,84919,57068447BEEE4D7969FF166D57966ECA,12581,8,10,2,24,48,1248
84920,84920,57068447BEEE4D7969FF166D57966ECA,42541,10,23,13,25,47,1297
84924,84924,1EB1C74741BE7C0B5E86F19E48D30409,12311,1,10,9,30,44,1544
84925,84925,1EB1C74741BE7C0B5E86F19E48D30409,42531,10,12,2,31,45,1595
84926,84926,1EB1C74741BE7C0B5E86F19E48D30409,12311,15,20,5,30,44,1544
84927,84927,1EB1C74741BE7C0B5E86F19E48D30409,42531,20,23,3,31,45,1595
84928,84928,FE5EF0C2F4B69A84D6BDB6109B4735F8,42161,0,2,2,36,47,1847
84929,84929,FE5EF0C2F4B69A84D6BDB6109B4735F8,10111,3,11,8,37,47,1897
84930,84930,FE5EF0C2F4B69A84D6BDB6109B4735F8,42301,12,18,6,36,47,1847
84941,84941,5156CFDCDD6D06B9C439BBE6A3CABC0D,10251,0,1,1,35,47,1797
84942,84942,5156CFDCDD6D06B9C439BBE6A3CABC0D,10111,2,12,10,37,47,1897
84943,84943,5156CFDCDD6D06B9C439BBE6A3CABC0D,42161,16,23,7,36,47,1847
84949,84949,E311A49FD79CE1E67702DBA9B7887B92,12641,0,5,5,10,43,543
84950,84950,E311A49FD79CE1E67702DBA9B7887B92,19021,6,20,14,10,45,545
84951,84951,E311A49FD79CE1E67702DBA9B7887B92,12641,20,22,2,10,43,543
84957,84957,6E71207F40ABEC46B7131A267F90969E,19114,0,17,17,7,43,393
84958,84958,6E71207F40ABEC46B7131A267F90969E,12921,18,19,1,9,41,491
84959,84959,6E71207F40ABEC46B7131A267F90969E,19114,20,21,1,7,43,393
84968,84968,E2204D6E32AC09E78AF98F20C9465FA5,10121,0,8,8,36,49,1849
84969,84969,E2204D6E32AC09E78AF98F20C9465FA5,10901,9,10,1,35,48,1798
84970,84970,E2204D6E32AC09E78AF98F20C9465FA5,10121,10,23,13,36,49,1849
84974,84974,177791B1BD9F9F1A23D0B9EF068F9A10,10281,0,5,5,33,48,1698
84975,84975,177791B1BD9F9F1A23D0B9EF068F9A10,11161,6,13,7,32,48,1648
84976,84976,177791B1BD9F9F1A23D0B9EF068F9A10,11861,16,20,4,32,47,1647
84977,84977,177791B1BD9F9F1A23D0B9EF068F9A10,10281,21,23,2,33,48,1698
84981,84981,3601FDEFB6D75DF133571064E56ECAF1,10711,0,8,8,29,46,1496
84982,84982,3601FDEFB6D75DF133571064E56ECAF1,10301,12,13,1,31,45,1595
84983,84983,3601FDEFB6D75DF133571064E56ECAF1,10711,15,20,5,29,46,1496
84987,84987,1F9F1C83F1B526750C2575DE062BE373,43761,1,8,7,32,47,1647
84988,84988,1F9F1C83F1B526750C2575DE062BE373,10295,12,18,6,30,47,1547
84989,84989,1F9F1C83F1B526750C2575DE062BE373,42523,21,23,2,31,47,1597
84990,84990,F66D7CA3D190DB256B66CDB9FF422557,10121,0,9,9,36,49,1849
84991,84991,F66D7CA3D190DB256B66CDB9FF422557,42961,9,12,3,35,49,1799
84992,84992,F66D7CA3D190DB256B66CDB9FF422557,10121,16,23,7,36,49,1849
84993,84993,03FE0D0BD52A528C1B4DF1F3C44F085B,11941,3,10,7,37,46,1896
84994,84994,03FE0D0BD52A528C1B4DF1F3C44F085B,11261,15,17,2,36,46,1846
84995,84995,03FE0D0BD52A528C1B4DF1F3C44F085B,42351,19,23,4,38,45,1945
85000,85000,20538B8C1777892DA77867D1D04B5D49,43761,0,2,2,32,47,1647
85001,85001,20538B8C1777892DA77867D1D04B5D49,11161,3,8,5,32,48,1648
85002,85002,20538B8C1777892DA77867D1D04B5D49,43761,11,20,9,32,47,1647
85003,85003,95F5650709CACF923AC8764BA8D78995,12311,1,3,2,30,44,1544
85004,85004,95F5650709CACF923AC8764BA8D78995,42531,4,11,7,31,45,1595
85005,85005,95F5650709CACF923AC8764BA8D78995,12311,11,13,2,30,44,1544
85006,85006,95F5650709CACF923AC8764BA8D78995,42531,13,20,7,31,45,1595
85013,85013,F270E2429049EC12B817A3B7398AF53A,10111,0,12,12,37,47,1897
85014,85014,F270E2429049EC12B817A3B7398AF53A,42151,13,19,6,35,45,1795
85015,85015,F270E2429049EC12B817A3B7398AF53A,10111,20,23,3,37,47,1897
85019,85019,479BB88DD9C776BA69F274C628C53893,13121,0,7,7,38,46,1946
85020,85020,479BB88DD9C776BA69F274C628C53893,42301,7,11,4,36,47,1847
85021,85021,479BB88DD9C776BA69F274C628C53893,13711,13,23,10,38,46,1946
85032,85032,9C47145209ECFC40DF20CE0BFE35E37E,43761,0,19,19,32,47,1647
85033,85033,9C47145209ECFC40DF20CE0BFE35E37E,42523,19,21,2,31,47,1597
85034,85034,9C47145209ECFC40DF20CE0BFE35E37E,43761,21,23,2,32,47,1647
85035,85035,A60E51B2BB36D63F6E34260285BCBDB6,12661,3,6,3,32,45,1645
85036,85036,A60E51B2BB36D63F6E34260285BCBDB6,42531,9,10,1,31,45,1595
85037,85037,A60E51B2BB36D63F6E34260285BCBDB6,12661,12,13,1,32,45,1645
85038,85038,A60E51B2BB36D63F6E34260285BCBDB6,12311,15,23,8,30,44,1544
85039,85039,E0F1670DB5561200EEDBAB1833327673,11921,0,9,9,38,48,1948
85040,85040,E0F1670DB5561200EEDBAB1833327673,10111,10,20,10,37,47,1897
85041,85041,E0F1670DB5561200EEDBAB1833327673,11921,20,23,3,38,48,1948
85047,85047,2963DF7A578CB40D3B563AE1F82E4E79,19741,0,5,5,5,44,294
85048,85048,2963DF7A578CB40D3B563AE1F82E4E79,19744,6,8,2,6,43,343
85049,85049,2963DF7A578CB40D3B563AE1F82E4E79,19741,10,23,13,5,44,294
85059,85059,E3EF3D7EF93CC9E529BB5EE547514ED6,10971,9,10,1,35,47,1797
85060,85060,E3EF3D7EF93CC9E529BB5EE547514ED6,13601,10,13,3,34,47,1747
85061,85061,E3EF3D7EF93CC9E529BB5EE547514ED6,10971,14,16,2,35,47,1797
85062,85062,E3EF3D7EF93CC9E529BB5EE547514ED6,13601,18,20,2,34,47,1747
85066,85066,3C395260D74040E21557F119C015B734,11481,0,13,13,41,48,2098
85067,85067,3C395260D74040E21557F119C015B734,13371,18,19,1,41,47,2097
85068,85068,3C395260D74040E21557F119C015B734,11481,20,22,2,41,48,2098
85078,85078,C5BE39F043AAB34786E4C31AB48CACA0,12051,0,2,2,20,47,1047
85079,85079,C5BE39F043AAB34786E4C31AB48CACA0,43751,4,5,1,19,48,998
85080,85080,C5BE39F043AAB34786E4C31AB48CACA0,12051,5,22,17,20,47,1047
85089,85089,200194CA33DD57C0E0CC791C5F2E51EB,40123,0,8,8,38,47,1947
85090,85090,200194CA33DD57C0E0CC791C5F2E51EB,10841,13,16,3,37,47,1897
85091,85091,200194CA33DD57C0E0CC791C5F2E51EB,11491,16,18,2,36,47,1847
85092,85092,200194CA33DD57C0E0CC791C5F2E51EB,40123,18,23,5,38,47,1947
85106,85106,94208362745F4CC8136A1624AA480486,10161,0,8,8,35,49,1799
85107,85107,94208362745F4CC8136A1624AA480486,10901,9,12,3,35,48,1798
85108,85108,94208362745F4CC8136A1624AA480486,42961,12,22,10,35,49,1799
85109,85109,4FCDABC610742EB61D313FDD101D8C81,42091,0,7,7,43,46,2196
85110,85110,4FCDABC610742EB61D313FDD101D8C81,13111,7,9,2,42,46,2146
85111,85111,4FCDABC610742EB61D313FDD101D8C81,42204,10,21,11,43,46,2196
85112,85112,6008ACD9FE609AC96038F2FC4863B492,13711,8,11,3,38,46,1946
85113,85113,6008ACD9FE609AC96038F2FC4863B492,10821,13,16,3,40,47,2047
85114,85114,6008ACD9FE609AC96038F2FC4863B492,13711,17,20,3,38,46,1946
85128,85128,A5F413FCE6894377153792EBFD44CC7E,11914,0,5,5,37,48,1898
85129,85129,A5F413FCE6894377153792EBFD44CC7E,11921,6,7,1,38,48,1948
85130,85130,A5F413FCE6894377153792EBFD44CC7E,42191,20,23,3,38,49,1949
85131,85131,45FF6546889433BB4D788DCD046F94EE,11561,0,10,10,32,49,1649
85132,85132,45FF6546889433BB4D788DCD046F94EE,40951,12,13,1,36,49,1849
85133,85133,45FF6546889433BB4D788DCD046F94EE,43471,15,16,1,31,49,1599
85134,85134,45FF6546889433BB4D788DCD046F94EE,11061,19,21,2,29,48,1498
85135,85135,4F717808305424D6529B2687FA7E5A49,11951,0,7,7,31,49,1599
85136,85136,4F717808305424D6529B2687FA7E5A49,11954,8,13,5,32,49,1649
85137,85137,4F717808305424D6529B2687FA7E5A49,13731,14,22,8,33,49,1699
85138,85138,F3B16B9F2FE5D66DD896BE8E61C1FA80,10351,1,6,5,28,45,1445
85139,85139,F3B16B9F2FE5D66DD896BE8E61C1FA80,10301,7,17,10,31,45,1595
85140,85140,F3B16B9F2FE5D66DD896BE8E61C1FA80,10351,17,21,4,28,45,1445
85141,85141,7F39CFD81893EF00CED4C98A6CC13D33,12121,1,2,1,29,47,1497
85142,85142,7F39CFD81893EF00CED4C98A6CC13D33,43761,4,5,1,32,47,1647
85143,85143,7F39CFD81893EF00CED4C98A6CC13D33,12121,9,18,9,29,47,1497
85148,85148,36E4D456967ADF7C503C23EAE8460AAD,13651,2,4,2,30,47,1547
85149,85149,36E4D456967ADF7C503C23EAE8460AAD,42523,6,13,7,31,47,1597
85150,85150,36E4D456967ADF7C503C23EAE8460AAD,13651,15,20,5,30,47,1547
85181,85181,ED7D6E0D6245554973BF1FC4EA5C6C28,11061,10,15,5,29,48,1498
85182,85182,ED7D6E0D6245554973BF1FC4EA5C6C28,11151,16,17,1,30,48,1548
85183,85183,ED7D6E0D6245554973BF1FC4EA5C6C28,11061,21,23,2,29,48,1498
85184,85184,ACD7D06D699A88B2E7BB7970CE635C80,13651,1,19,18,30,47,1547
85185,85185,ACD7D06D699A88B2E7BB7970CE635C80,42291,20,21,1,29,48,1498
85186,85186,ACD7D06D699A88B2E7BB7970CE635C80,11381,22,23,1,30,47,1547
85187,85187,0A700EA99E1EE358196568D4A017516D,10681,0,10,10,30,48,1548
85188,85188,0A700EA99E1EE358196568D4A017516D,13651,12,14,2,30,47,1547
85189,85189,0A700EA99E1EE358196568D4A017516D,10301,16,23,7,31,45,1595
85190,85190,CCF51F527C0699CB645C6D016C6FE2F5,11914,5,13,8,37,48,1898
85191,85191,CCF51F527C0699CB645C6D016C6FE2F5,42581,18,19,1,38,48,1948
85192,85192,CCF51F527C0699CB645C6D016C6FE2F5,11914,19,20,1,37,48,1898
85193,85193,CCF51F527C0699CB645C6D016C6FE2F5,42581,21,22,1,38,48,1948
85206,85206,4EE5C60035D807126AEE0DC0CD563832,42581,6,13,7,38,48,1948
85207,85207,4EE5C60035D807126AEE0DC0CD563832,11914,18,19,1,37,48,1898
85208,85208,4EE5C60035D807126AEE0DC0CD563832,42581,19,23,4,38,48,1948
85209,85209,3E7942CC71D03F103F23ED151D419DA7,49201,0,1,1,7,41,391
85210,85210,3E7942CC71D03F103F23ED151D419DA7,12921,4,6,2,9,41,491
85211,85211,3E7942CC71D03F103F23ED151D419DA7,49201,8,21,13,7,41,391
85222,85222,4FEDDE4724DDA61E19979F6B8E0B84B5,42511,0,5,5,37,47,1897
85223,85223,4FEDDE4724DDA61E19979F6B8E0B84B5,10271,9,19,10,37,46,1896
85224,85224,4FEDDE4724DDA61E19979F6B8E0B84B5,42511,20,21,1,37,47,1897
85225,85225,C46CDF3840B783157CCBA7C0D999F0A9,10292,0,15,15,30,47,1547
85226,85226,C46CDF3840B783157CCBA7C0D999F0A9,10544,16,17,1,28,48,1448
85227,85227,C46CDF3840B783157CCBA7C0D999F0A9,10292,18,23,5,30,47,1547
85236,85236,5E1BBAE6A1AB78C09E8201C8FF351A4E,42583,1,2,1,40,48,2048
85237,85237,5E1BBAE6A1AB78C09E8201C8FF351A4E,12514,7,15,8,38,47,1947
85238,85238,5E1BBAE6A1AB78C09E8201C8FF351A4E,13101,20,22,2,40,47,2047
85248,85248,A15C0678EF39F4E1D2E8B3E08C176676,13911,0,6,6,39,46,1996
85249,85249,A15C0678EF39F4E1D2E8B3E08C176676,42351,8,16,8,38,45,1945
85250,85250,A15C0678EF39F4E1D2E8B3E08C176676,10811,18,20,2,38,46,1946
85261,85261,F12CF92D47DBBC28BDFFECBC31496C05,11061,0,17,17,29,48,1498
85262,85262,F12CF92D47DBBC28BDFFECBC31496C05,43761,17,19,2,32,47,1647
85263,85263,F12CF92D47DBBC28BDFFECBC31496C05,11151,22,23,1,30,48,1548
85280,85280,D49ACB9D15E069F7B065182278AF10C3,40322,2,6,4,38,46,1946
85281,85281,D49ACB9D15E069F7B065182278AF10C3,42301,8,15,7,36,47,1847
85282,85282,D49ACB9D15E069F7B065182278AF10C3,13711,19,21,2,38,46,1946
85283,85283,69DBD6A3455850DFA512FC2017D972E4,42271,0,1,1,40,47,2047
85284,85284,69DBD6A3455850DFA512FC2017D972E4,11074,2,7,5,37,47,1897
85285,85285,69DBD6A3455850DFA512FC2017D972E4,42271,9,23,14,40,47,2047
85286,85286,F047C14D10AD9FBC70288E89E0E137C9,43761,0,10,10,32,47,1647
85287,85287,F047C14D10AD9FBC70288E89E0E137C9,42491,13,15,2,32,46,1646
85288,85288,F047C14D10AD9FBC70288E89E0E137C9,11861,19,21,2,32,47,1647
85289,85289,0F63EB0E2A76702961055628B34A5DB2,43241,0,15,15,36,46,1846
85290,85290,0F63EB0E2A76702961055628B34A5DB2,10841,19,20,1,37,47,1897
85291,85291,0F63EB0E2A76702961055628B34A5DB2,11461,22,23,1,37,49,1899
85292,85292,520C7CBC821664A98A49926C91FE5529,13911,2,4,2,39,46,1996
85293,85293,520C7CBC821664A98A49926C91FE5529,42231,6,18,12,37,46,1896
85294,85294,520C7CBC821664A98A49926C91FE5529,13911,19,22,3,39,46,1996
85301,85301,D1161F75E2083066372593043FD61104,40123,0,7,7,38,47,1947
85302,85302,D1161F75E2083066372593043FD61104,41382,11,13,2,38,49,1949
85303,85303,D1161F75E2083066372593043FD61104,13331,15,23,8,38,47,1947
85304,85304,5B005239AD91B224060A740123F8C94E,13231,1,5,4,39,46,1996
85305,85305,5B005239AD91B224060A740123F8C94E,42231,9,11,2,37,46,1896
85306,85306,5B005239AD91B224060A740123F8C94E,42351,13,23,10,38,45,1945
85307,85307,48FBA343B11AAC9C43C215CDDC9D78D2,11914,7,8,1,37,48,1898
85308,85308,48FBA343B11AAC9C43C215CDDC9D78D2,42581,8,9,1,38,48,1948
85309,85309,48FBA343B11AAC9C43C215CDDC9D78D2,11271,13,18,5,37,48,1898
85310,85310,52DE1B5B29EB088C4F7CC0D4865B38F5,42861,4,6,2,37,44,1894
85311,85311,52DE1B5B29EB088C4F7CC0D4865B38F5,42151,7,8,1,35,45,1795
85312,85312,52DE1B5B29EB088C4F7CC0D4865B38F5,42861,13,20,7,37,44,1894
85313,85313,132BAF41704DD845C2F70543C3732C4E,42231,0,17,17,37,46,1896
85314,85314,132BAF41704DD845C2F70543C3732C4E,13711,17,19,2,38,46,1946
85315,85315,132BAF41704DD845C2F70543C3732C4E,42231,19,23,4,37,46,1896
85316,85316,04F49F7E8D4D2D6E613CDB194B5DF8E7,42511,1,2,1,37,47,1897
85317,85317,04F49F7E8D4D2D6E613CDB194B5DF8E7,13331,4,17,13,38,47,1947
85318,85318,04F49F7E8D4D2D6E613CDB194B5DF8E7,42511,18,22,4,37,47,1897
85330,85330,81C7B7CEB06954770CA2C889DCC58FC5,10295,0,12,12,30,47,1547
85331,85331,81C7B7CEB06954770CA2C889DCC58FC5,43761,13,18,5,32,47,1647
85332,85332,81C7B7CEB06954770CA2C889DCC58FC5,10295,21,23,2,30,47,1547
85333,85333,E1BB7B2CDA075A402737990C0757A672,40632,0,8,8,35,48,1798
85334,85334,E1BB7B2CDA075A402737990C0757A672,10151,11,12,1,34,47,1747
85335,85335,E1BB7B2CDA075A402737990C0757A672,40632,13,14,1,35,48,1798
85336,85336,E1BB7B2CDA075A402737990C0757A672,42981,16,23,7,36,49,1849
85340,85340,907D9C07105AF9242C4278C0160DDD57,13711,0,11,11,38,46,1946
85341,85341,907D9C07105AF9242C4278C0160DDD57,10271,13,16,3,37,46,1896
85342,85342,907D9C07105AF9242C4278C0160DDD57,13711,20,22,2,38,46,1946
85354,85354,301DA8630F1711ABAA30DB6E5BAD6095,12521,4,10,6,35,41,1791
85355,85355,301DA8630F1711ABAA30DB6E5BAD6095,43451,10,11,1,37,40,1890
85356,85356,301DA8630F1711ABAA30DB6E5BAD6095,12521,11,22,11,35,41,1791
85357,85357,E28BD8ABB3C3184A8D1BC0022884AF60,13111,2,9,7,42,46,2146
85358,85358,E28BD8ABB3C3184A8D1BC0022884AF60,13791,9,11,2,42,47,2147
85359,85359,E28BD8ABB3C3184A8D1BC0022884AF60,13341,12,20,8,44,45,2245
85360,85360,E28BD8ABB3C3184A8D1BC0022884AF60,13111,21,23,2,42,46,2146
85361,85361,FF9330E5059604931F470E5264FACDF7,42491,0,12,12,32,46,1646
85362,85362,FF9330E5059604931F470E5264FACDF7,11861,15,18,3,32,47,1647
85363,85363,FF9330E5059604931F470E5264FACDF7,42491,19,20,1,32,46,1646
85364,85364,FF9330E5059604931F470E5264FACDF7,11861,22,23,1,32,47,1647
85365,85365,D0D24C7F1A65A68DAA38891FB1757B47,19441,0,7,7,8,46,446
85366,85366,D0D24C7F1A65A68DAA38891FB1757B47,42041,7,18,11,10,47,547
85367,85367,D0D24C7F1A65A68DAA38891FB1757B47,19441,22,23,1,8,46,446
85368,85368,012D304B65BB1C01DC9FFE26FE6AEE56,10111,0,17,17,37,47,1897
85369,85369,012D304B65BB1C01DC9FFE26FE6AEE56,11021,17,20,3,36,49,1849
85370,85370,012D304B65BB1C01DC9FFE26FE6AEE56,10111,20,23,3,37,47,1897
85371,85371,60E47AB33736AC41E2674A67294A03D4,12491,0,5,5,36,43,1843
85372,85372,60E47AB33736AC41E2674A67294A03D4,11261,10,12,2,36,46,1846
85373,85373,60E47AB33736AC41E2674A67294A03D4,12491,12,23,11,36,43,1843
85390,85390,72B28316E77049B3B3D9EC9BDF710CF6,42523,0,5,5,31,47,1597
85391,85391,72B28316E77049B3B3D9EC9BDF710CF6,43761,6,7,1,32,47,1647
85392,85392,72B28316E77049B3B3D9EC9BDF710CF6,42523,10,22,12,31,47,1597
85411,85411,B8E7E289F9430AF8CDDF4777B090A6CC,42161,0,7,7,36,47,1847
85412,85412,B8E7E289F9430AF8CDDF4777B090A6CC,13561,9,13,4,37,49,1899
85413,85413,B8E7E289F9430AF8CDDF4777B090A6CC,10251,13,18,5,35,47,1797
85414,85414,B8E7E289F9430AF8CDDF4777B090A6CC,42161,18,21,3,36,47,1847
85415,85415,257BF4C677D186CA9927857F5C748DC1,43751,0,13,13,19,48,998
85416,85416,257BF4C677D186CA9927857F5C748DC1,42481,15,17,2,22,49,1149
85417,85417,257BF4C677D186CA9927857F5C748DC1,43751,18,23,5,19,48,998
85418,85418,E7EC6E138D54F5092F2DB01DB4F64219,43061,2,17,15,43,46,2196
85419,85419,E7EC6E138D54F5092F2DB01DB4F64219,13111,18,20,2,42,46,2146
85420,85420,E7EC6E138D54F5092F2DB01DB4F64219,42204,21,23,2,43,46,2196
85442,85442,A383341D78EFA87F857B50ECF68ED16F,11381,1,8,7,30,47,1547
85443,85443,A383341D78EFA87F857B50ECF68ED16F,42291,18,19,1,29,48,1498
85444,85444,A383341D78EFA87F857B50ECF68ED16F,43471,22,23,1,31,49,1599
85455,85455,7A880FE847C48EF3051E04A866E8ED9A,11031,1,15,14,42,49,2149
85456,85456,7A880FE847C48EF3051E04A866E8ED9A,13221,16,18,2,40,47,2047
85457,85457,7A880FE847C48EF3051E04A866E8ED9A,11551,19,21,2,39,49,1999
85462,85462,46B3DE812748722328FAB277775E5F5A,12514,0,3,3,38,47,1947
85463,85463,46B3DE812748722328FAB277775E5F5A,42221,7,10,3,38,48,1948
85464,85464,46B3DE812748722328FAB277775E5F5A,11074,11,12,1,37,47,1897
85465,85465,46B3DE812748722328FAB277775E5F5A,13331,15,19,4,38,47,1947
85481,85481,0A3AEB60A6106F02C32A3904CC28A141,15181,1,7,6,26,24,1324
85482,85482,0A3AEB60A6106F02C32A3904CC28A141,43121,9,15,6,25,27,1277
85483,85483,0A3AEB60A6106F02C32A3904CC28A141,15181,16,21,5,26,24,1324
85487,85487,5A8308F9DAAF40265186D4E63F2640C9,10721,0,6,6,31,48,1598
85488,85488,5A8308F9DAAF40265186D4E63F2640C9,13731,7,17,10,33,49,1699
85489,85489,5A8308F9DAAF40265186D4E63F2640C9,12381,20,23,3,32,48,1648
85523,85523,079E309E76444CFA74DEE7817C8EB0DE,10521,0,18,18,41,47,2097
85524,85524,079E309E76444CFA74DEE7817C8EB0DE,11001,20,21,1,42,47,2147
85525,85525,079E309E76444CFA74DEE7817C8EB0DE,10521,22,23,1,41,47,2097
85529,85529,584E7A34E1DD8C6772CA907E44069D0A,42871,0,7,7,30,45,1545
85530,85530,584E7A34E1DD8C6772CA907E44069D0A,10292,8,9,1,30,47,1547
85531,85531,584E7A34E1DD8C6772CA907E44069D0A,42871,11,23,12,30,45,1545
85532,85532,EAEFCB977DEDF23C1346736B36A6F67B,13911,0,5,5,39,46,1996
85533,85533,EAEFCB977DEDF23C1346736B36A6F67B,11261,6,17,11,36,46,1846
85534,85534,EAEFCB977DEDF23C1346736B36A6F67B,42231,18,22,4,37,46,1896
85535,85535,DFDD3FE0C2251404AC997151A5933E97,42141,0,16,16,32,47,1647
85536,85536,DFDD3FE0C2251404AC997151A5933E97,10281,17,18,1,33,48,1698
85537,85537,DFDD3FE0C2251404AC997151A5933E97,43761,18,19,1,32,47,1647
85542,85542,5ADA9660158083BA681D3EABE7C6BBBF,42864,4,7,3,38,44,1944
85543,85543,5ADA9660158083BA681D3EABE7C6BBBF,11261,11,12,1,36,46,1846
85544,85544,5ADA9660158083BA681D3EABE7C6BBBF,42861,15,16,1,37,44,1894
85545,85545,5ADA9660158083BA681D3EABE7C6BBBF,11261,17,18,1,36,46,1846
85546,85546,70C284A4562E570FDFF8494853267FB8,42011,0,8,8,36,46,1846
85547,85547,70C284A4562E570FDFF8494853267FB8,10471,13,18,5,37,48,1898
85548,85548,70C284A4562E570FDFF8494853267FB8,12021,18,19,1,37,49,1899
85549,85549,70C284A4562E570FDFF8494853267FB8,10471,19,23,4,37,48,1898
85550,85550,0A501EA010779C8F9EB8C2F8834C3F4F,10351,0,9,9,28,45,1445
85551,85551,0A501EA010779C8F9EB8C2F8834C3F4F,10301,11,16,5,31,45,1595
85552,85552,0A501EA010779C8F9EB8C2F8834C3F4F,10351,16,21,5,28,45,1445
85553,85553,0A501EA010779C8F9EB8C2F8834C3F4F,10634,22,23,1,27,45,1395
85554,85554,D92E0354220FC50EEC1FD87010105B23,11381,0,7,7,30,47,1547
85555,85555,D92E0354220FC50EEC1FD87010105B23,42501,8,18,10,28,47,1447
85556,85556,D92E0354220FC50EEC1FD87010105B23,11381,21,23,2,30,47,1547
85557,85557,FD6F3D9CFB531FE01A1AEA9CDBE73454,42351,5,8,3,38,45,1945
85558,85558,FD6F3D9CFB531FE01A1AEA9CDBE73454,11261,10,11,1,36,46,1846
85559,85559,FD6F3D9CFB531FE01A1AEA9CDBE73454,42351,11,19,8,38,45,1945
85570,85570,966EF37DD81DE2F009202B5BDDCFCE29,42861,3,4,1,37,44,1894
85571,85571,966EF37DD81DE2F009202B5BDDCFCE29,42231,7,13,6,37,46,1896
85572,85572,966EF37DD81DE2F009202B5BDDCFCE29,13911,13,14,1,39,46,1996
85573,85573,966EF37DD81DE2F009202B5BDDCFCE29,42231,15,20,5,37,46,1896
85581,85581,CC9D6055E50B8BEAE50E7B56B0FCD1E7,10471,0,10,10,37,48,1898
85582,85582,CC9D6055E50B8BEAE50E7B56B0FCD1E7,12021,15,17,2,37,49,1899
85583,85583,CC9D6055E50B8BEAE50E7B56B0FCD1E7,10471,17,23,6,37,48,1898
85584,85584,C21989F99D3B120EE23386DE2361CA67,42231,2,9,7,37,46,1896
85585,85585,C21989F99D3B120EE23386DE2361CA67,42771,9,11,2,36,47,1847
85586,85586,C21989F99D3B120EE23386DE2361CA67,10841,11,18,7,37,47,1897
85590,85590,A584DB5FF6EE02AE16BAE873BBEDDAA1,12921,0,18,18,9,41,491
85591,85591,A584DB5FF6EE02AE16BAE873BBEDDAA1,49201,20,21,1,7,41,391
85592,85592,A584DB5FF6EE02AE16BAE873BBEDDAA1,12921,21,22,1,9,41,491
85593,85593,2808B465D0CA5BE626B66BA705E41B68,42351,2,3,1,38,45,1945
85594,85594,2808B465D0CA5BE626B66BA705E41B68,42864,7,8,1,38,44,1944
85595,85595,2808B465D0CA5BE626B66BA705E41B68,11261,10,19,9,36,46,1846
85596,85596,14C205DF57BD0AA586E26BE4ED695846,42581,1,14,13,38,48,1948
85597,85597,14C205DF57BD0AA586E26BE4ED695846,11914,14,15,1,37,48,1898
85598,85598,14C205DF57BD0AA586E26BE4ED695846,40171,16,19,3,38,48,1948
85608,85608,F2B58BA76451E1E5570E86361AE3B646,10251,2,14,12,35,47,1797
85609,85609,F2B58BA76451E1E5570E86361AE3B646,42401,15,16,1,36,47,1847
85610,85610,F2B58BA76451E1E5570E86361AE3B646,10251,19,21,2,35,47,1797
85611,85611,15BA009B68D87958E0A9656ADB01E7D6,42371,1,2,1,34,46,1746
85612,85612,15BA009B68D87958E0A9656ADB01E7D6,10511,3,4,1,35,46,1796
85613,85613,15BA009B68D87958E0A9656ADB01E7D6,42371,5,8,3,34,46,1746
85614,85614,15BA009B68D87958E0A9656ADB01E7D6,10511,8,20,12,35,46,1796
85615,85615,FC3B8910035FE6AFFCEFAAF1A5BD46D7,10471,0,11,11,37,48,1898
85616,85616,FC3B8910035FE6AFFCEFAAF1A5BD46D7,42191,13,16,3,38,49,1949
85617,85617,FC3B8910035FE6AFFCEFAAF1A5BD46D7,11271,16,23,7,37,48,1898
85618,85618,FF54487E0B5C80FA4088AB1638FB8194,42581,0,5,5,38,48,1948
85619,85619,FF54487E0B5C80FA4088AB1638FB8194,11914,6,11,5,37,48,1898
85620,85620,FF54487E0B5C80FA4088AB1638FB8194,42581,13,23,10,38,48,1948
85621,85621,5832F798017EC944959971DE10E6C76B,11261,3,7,4,36,46,1846
85622,85622,5832F798017EC944959971DE10E6C76B,13911,8,15,7,39,46,1996
85623,85623,5832F798017EC944959971DE10E6C76B,11261,17,21,4,36,46,1846
85624,85624,93536AE22F6F60E357E97FFF9D2D24BA,11641,0,6,6,22,49,1149
85625,85625,93536AE22F6F60E357E97FFF9D2D24BA,12051,8,10,2,20,47,1047
85626,85626,93536AE22F6F60E357E97FFF9D2D24BA,11641,12,14,2,22,49,1149
85627,85627,93536AE22F6F60E357E97FFF9D2D24BA,43751,18,22,4,19,48,998
85628,85628,CC026B1D95E317BEF1558C266B728FC7,42864,5,6,1,38,44,1944
85629,85629,CC026B1D95E317BEF1558C266B728FC7,11261,6,8,2,36,46,1846
85630,85630,CC026B1D95E317BEF1558C266B728FC7,42864,12,21,9,38,44,1944
85631,85631,773944E2D8A30A57865F92844A6B0FFC,10901,0,10,10,35,48,1798
85632,85632,773944E2D8A30A57865F92844A6B0FFC,11861,11,14,3,32,47,1647
85633,85633,773944E2D8A30A57865F92844A6B0FFC,42021,17,21,4,33,47,1697
85634,85634,1C1F6C68185E32864EF19C73864604BB,42581,0,2,2,38,48,1948
85635,85635,1C1F6C68185E32864EF19C73864604BB,11271,5,19,14,37,48,1898
85636,85636,1C1F6C68185E32864EF19C73864604BB,42581,22,23,1,38,48,1948
85642,85642,CEC2557E73B99D59943BE56AF1337C99,13121,6,8,2,38,46,1946
85643,85643,CEC2557E73B99D59943BE56AF1337C99,10271,8,10,2,37,46,1896
85644,85644,CEC2557E73B99D59943BE56AF1337C99,13121,12,20,8,38,46,1946
85645,85645,CEC2557E73B99D59943BE56AF1337C99,10271,20,22,2,37,46,1896
85646,85646,4A97E701DB890F0A36533DCC33203AA3,11074,0,3,3,37,47,1897
85647,85647,4A97E701DB890F0A36533DCC33203AA3,42221,5,12,7,38,48,1948
85648,85648,4A97E701DB890F0A36533DCC33203AA3,11074,14,20,6,37,47,1897
85649,85649,4A97E701DB890F0A36533DCC33203AA3,42221,22,23,1,38,48,1948
85661,85661,3C02B5838EDEAB0B15A337805B269A42,13011,0,5,5,39,47,1997
85662,85662,3C02B5838EDEAB0B15A337805B269A42,13911,6,8,2,39,46,1996
85663,85663,3C02B5838EDEAB0B15A337805B269A42,11261,9,12,3,36,46,1846
85664,85664,3C02B5838EDEAB0B15A337805B269A42,13011,12,23,11,39,47,1997
85678,85678,7B63B781AF1E5C1909C9ECFED6946980,42523,2,3,1,31,47,1597
85679,85679,7B63B781AF1E5C1909C9ECFED6946980,43761,4,5,1,32,47,1647
85680,85680,7B63B781AF1E5C1909C9ECFED6946980,42523,7,10,3,31,47,1597
85681,85681,7B63B781AF1E5C1909C9ECFED6946980,43761,11,23,12,32,47,1647
85682,85682,988754F4ACB1FFB14F8ADCC3660BA4EF,11261,6,13,7,36,46,1846
85683,85683,988754F4ACB1FFB14F8ADCC3660BA4EF,10811,16,17,1,38,46,1946
85684,85684,988754F4ACB1FFB14F8ADCC3660BA4EF,11261,17,20,3,36,46,1846
85690,85690,355DD3402A8AAEE3806536A3C0C3E0F1,42583,0,6,6,40,48,2048
85691,85691,355DD3402A8AAEE3806536A3C0C3E0F1,11074,7,8,1,37,47,1897
85692,85692,355DD3402A8AAEE3806536A3C0C3E0F1,42583,9,23,14,40,48,2048
85693,85693,EA7259828C59286A0C8476F89AAE54B8,11261,0,2,2,36,46,1846
85694,85694,EA7259828C59286A0C8476F89AAE54B8,42151,4,6,2,35,45,1795
85695,85695,EA7259828C59286A0C8476F89AAE54B8,11261,7,20,13,36,46,1846
85696,85696,B8DCAC0FC6FA981D871032E55C240C8E,10471,6,18,12,37,48,1898
85697,85697,B8DCAC0FC6FA981D871032E55C240C8E,42581,18,19,1,38,48,1948
85698,85698,B8DCAC0FC6FA981D871032E55C240C8E,11914,21,22,1,37,48,1898
85704,85704,884C9210F61ADBFD1EDE89A3EAB05C30,11481,1,12,11,41,48,2098
85705,85705,884C9210F61ADBFD1EDE89A3EAB05C30,13101,12,13,1,40,47,2047
85706,85706,884C9210F61ADBFD1EDE89A3EAB05C30,40833,13,15,2,41,47,2097
85707,85707,884C9210F61ADBFD1EDE89A3EAB05C30,13101,15,23,8,40,47,2047
85708,85708,D7A59B36ABB20A6DAED677E99CE67716,10724,0,7,7,32,48,1648
85709,85709,D7A59B36ABB20A6DAED677E99CE67716,10901,9,10,1,35,48,1798
85710,85710,D7A59B36ABB20A6DAED677E99CE67716,10724,11,20,9,32,48,1648
85711,85711,D7A59B36ABB20A6DAED677E99CE67716,10721,21,23,2,31,48,1598
85727,85727,CC3A6C9D1F6C7788CAEAFEE7A927CD34,10511,9,11,2,35,46,1796
85728,85728,CC3A6C9D1F6C7788CAEAFEE7A927CD34,10411,12,14,2,36,48,1848
85729,85729,CC3A6C9D1F6C7788CAEAFEE7A927CD34,11261,17,19,2,36,46,1846
85735,85735,12915B7CE801D56C12C57B7092EB877D,42581,0,8,8,38,48,1948
85736,85736,12915B7CE801D56C12C57B7092EB877D,11914,10,12,2,37,48,1898
85737,85737,12915B7CE801D56C12C57B7092EB877D,42581,13,21,8,38,48,1948
85738,85738,23ABF703203C13FF4E7D4138F071B5BC,11914,0,1,1,37,48,1898
85739,85739,23ABF703203C13FF4E7D4138F071B5BC,42581,1,5,4,38,48,1948
85740,85740,23ABF703203C13FF4E7D4138F071B5BC,11914,5,23,18,37,48,1898
85741,85741,0E002027D741B8AED4EE58E469659344,12601,0,11,11,25,47,1297
85742,85742,0E002027D741B8AED4EE58E469659344,10501,12,14,2,22,46,1146
85743,85743,0E002027D741B8AED4EE58E469659344,12601,15,20,5,25,47,1297
85752,85752,C10A062A2E87C521BC7FE101323C323B,11861,1,9,8,32,47,1647
85753,85753,C10A062A2E87C521BC7FE101323C323B,13601,10,16,6,34,47,1747
85754,85754,C10A062A2E87C521BC7FE101323C323B,11861,19,21,2,32,47,1647
85759,85759,D9803D3FD2338A5AC0B4965C5175094E,10121,0,7,7,36,49,1849
85760,85760,D9803D3FD2338A5AC0B4965C5175094E,12514,10,17,7,38,47,1947
85761,85761,D9803D3FD2338A5AC0B4965C5175094E,10121,19,22,3,36,49,1849
85774,85774,176F4E967E986DAF00C74DDD3BF2A8FE,11806,1,9,8,41,48,2098
85775,85775,176F4E967E986DAF00C74DDD3BF2A8FE,12514,12,15,3,38,47,1947
85776,85776,176F4E967E986DAF00C74DDD3BF2A8FE,11806,17,18,1,41,48,2098
85790,85790,D74F313B83AF8BEC15D2F645FB6EDD43,11161,0,6,6,32,48,1648
85791,85791,D74F313B83AF8BEC15D2F645FB6EDD43,43761,8,18,10,32,47,1647
85792,85792,D74F313B83AF8BEC15D2F645FB6EDD43,11161,20,21,1,32,48,1648
85800,85800,FB5A872D0FAE7AA0035523EB5DBD36C2,11324,0,6,6,31,46,1596
85801,85801,FB5A872D0FAE7AA0035523EB5DBD36C2,10281,8,10,2,33,48,1698
85802,85802,FB5A872D0FAE7AA0035523EB5DBD36C2,43761,11,16,5,32,47,1647
85803,85803,FB5A872D0FAE7AA0035523EB5DBD36C2,11324,20,23,3,31,46,1596
85804,85804,9C819019C9FBB04766CC6EE29C66CE0E,10111,0,8,8,37,47,1897
85805,85805,9C819019C9FBB04766CC6EE29C66CE0E,40673,9,19,10,36,48,1848
85806,85806,9C819019C9FBB04766CC6EE29C66CE0E,10111,19,20,1,37,47,1897
85807,85807,246B9DA3EFDA0E64D291387D5A19302A,19114,1,2,1,7,43,393
85808,85808,246B9DA3EFDA0E64D291387D5A19302A,12641,3,5,2,10,43,543
85809,85809,246B9DA3EFDA0E64D291387D5A19302A,19114,10,17,7,7,43,393
85810,85810,246B9DA3EFDA0E64D291387D5A19302A,12641,18,23,5,10,43,543
85818,85818,D3B77B24DF5EC6CEA013C69B5AA71FE2,13911,0,6,6,39,46,1996
85819,85819,D3B77B24DF5EC6CEA013C69B5AA71FE2,42351,6,9,3,38,45,1945
85820,85820,D3B77B24DF5EC6CEA013C69B5AA71FE2,13911,11,23,12,39,46,1996
85821,85821,377BD5B9C037AF000CC29F45169CD1E4,11231,0,9,9,37,49,1899
85822,85822,377BD5B9C037AF000CC29F45169CD1E4,11201,10,18,8,35,49,1799
85823,85823,377BD5B9C037AF000CC29F45169CD1E4,12083,18,23,5,36,49,1849
85829,85829,C1896697E8F9082F3C179E6CB902F84B,49181,0,11,11,21,31,1081
85830,85830,C1896697E8F9082F3C179E6CB902F84B,13141,12,13,1,23,30,1180
85831,85831,C1896697E8F9082F3C179E6CB902F84B,49181,14,19,5,21,31,1081
85841,85841,FC0936587C74EF8144A5D7B54D78302D,19021,1,9,8,10,45,545
85842,85842,FC0936587C74EF8144A5D7B54D78302D,19024,11,18,7,9,45,495
85843,85843,FC0936587C74EF8144A5D7B54D78302D,19021,20,21,1,10,45,545
85851,85851,8721A90F0F0902926D0D708FD844AAE9,11921,0,15,15,38,48,1948
85852,85852,8721A90F0F0902926D0D708FD844AAE9,11914,15,16,1,37,48,1898
85853,85853,8721A90F0F0902926D0D708FD844AAE9,11921,17,23,6,38,48,1948
85860,85860,C8E87AF8532CEAD2E0037D4C1FBEDF52,13911,1,6,5,39,46,1996
85861,85861,C8E87AF8532CEAD2E0037D4C1FBEDF52,42351,7,11,4,38,45,1945
85862,85862,C8E87AF8532CEAD2E0037D4C1FBEDF52,42231,14,18,4,37,46,1896
85863,85863,E16566CAC1D2263C830A92E3D7A4B3A9,42351,2,5,3,38,45,1945
85864,85864,E16566CAC1D2263C830A92E3D7A4B3A9,42231,8,20,12,37,46,1896
85865,85865,E16566CAC1D2263C830A92E3D7A4B3A9,13231,21,23,2,39,46,1996
85871,85871,7BB4139D2092F15150BB630D7EA7D139,10121,0,11,11,36,49,1849
85872,85872,7BB4139D2092F15150BB630D7EA7D139,11231,11,13,2,37,49,1899
85873,85873,7BB4139D2092F15150BB630D7EA7D139,10121,13,17,4,36,49,1849
85874,85874,7BB4139D2092F15150BB630D7EA7D139,11231,19,23,4,37,49,1899
85879,85879,ACB823DB33D22CC4344D979C1DDF92F4,11261,0,2,2,36,46,1846
85880,85880,ACB823DB33D22CC4344D979C1DDF92F4,42861,6,11,5,37,44,1894
85881,85881,ACB823DB33D22CC4344D979C1DDF92F4,11261,13,22,9,36,46,1846
85882,85882,755A1FA6C962DCA1F0C6C27EDC12A160,13371,9,15,6,41,47,2097
85883,85883,755A1FA6C962DCA1F0C6C27EDC12A160,12511,16,17,1,39,47,1997
85884,85884,755A1FA6C962DCA1F0C6C27EDC12A160,13371,18,23,5,41,47,2097
85885,85885,FA7212404B2A3575C86D1A2235BCB99F,42971,0,12,12,43,49,2199
85886,85886,FA7212404B2A3575C86D1A2235BCB99F,10621,14,16,2,41,49,2099
85887,85887,FA7212404B2A3575C86D1A2235BCB99F,42971,17,19,2,43,49,2199
85888,85888,FA7212404B2A3575C86D1A2235BCB99F,10621,21,23,2,41,49,2099
85912,85912,7393E6DBA6E356A386BC13A743DC52DC,13511,0,8,8,34,48,1748
85913,85913,7393E6DBA6E356A386BC13A743DC52DC,11231,10,13,3,37,49,1899
85914,85914,7393E6DBA6E356A386BC13A743DC52DC,13511,14,21,7,34,48,1748
85915,85915,8420BC80E057341A3D646D0572754A34,12921,0,16,16,9,41,491
85916,85916,8420BC80E057341A3D646D0572754A34,49201,17,19,2,7,41,391
85917,85917,8420BC80E057341A3D646D0572754A34,12921,19,21,2,9,41,491
85918,85918,895085FE0B62D7BCDF8725B5DB48E546,43971,0,6,6,30,48,1548
85919,85919,895085FE0B62D7BCDF8725B5DB48E546,11061,10,14,4,29,48,1498
85920,85920,895085FE0B62D7BCDF8725B5DB48E546,42521,15,23,8,31,47,1597
85939,85939,389DA3D4B9F28E4FB981C4DEAEAE78AC,10271,0,10,10,37,46,1896
85940,85940,389DA3D4B9F28E4FB981C4DEAEAE78AC,42161,15,16,1,36,47,1847
85941,85941,389DA3D4B9F28E4FB981C4DEAEAE78AC,10271,19,23,4,37,46,1896
85945,85945,A3BFED7EBC8273A150663075EB9361B2,12391,0,1,1,36,49,1849
85946,85946,A3BFED7EBC8273A150663075EB9361B2,11271,5,7,2,37,48,1898
85947,85947,A3BFED7EBC8273A150663075EB9361B2,12391,7,9,2,36,49,1849
85948,85948,A3BFED7EBC8273A150663075EB9361B2,11271,13,23,10,37,48,1898
85949,85949,26D70945C43960D97DB289F7CCF774D8,19114,0,6,6,7,43,393
85950,85950,26D70945C43960D97DB289F7CCF774D8,12921,9,18,9,9,41,491
85951,85951,26D70945C43960D97DB289F7CCF774D8,19114,19,23,4,7,43,393
85968,85968,5296F713DD9560055A49E8945F831D28,10811,3,10,7,38,46,1946
85969,85969,5296F713DD9560055A49E8945F831D28,10107,11,14,3,38,49,1949
85970,85970,5296F713DD9560055A49E8945F831D28,13121,18,20,2,38,46,1946
85971,85971,5296F713DD9560055A49E8945F831D28,13561,21,23,2,37,49,1899
85972,85972,8D4403CD84975AE0D9A403E49725512D,10121,0,10,10,36,49,1849
85973,85973,8D4403CD84975AE0D9A403E49725512D,10107,10,13,3,38,49,1949
85974,85974,8D4403CD84975AE0D9A403E49725512D,10121,15,23,8,36,49,1849
85984,85984,F7AAD8355D0FB48A1E8C914954424109,10731,0,6,6,33,47,1697
85985,85985,F7AAD8355D0FB48A1E8C914954424109,11834,7,9,2,32,45,1645
85986,85986,F7AAD8355D0FB48A1E8C914954424109,11861,14,17,3,32,47,1647
85987,85987,F7AAD8355D0FB48A1E8C914954424109,11834,19,22,3,32,45,1645
86009,86009,981A108DF07EE24FA84EC23588DA45B3,12491,0,7,7,36,43,1843
86010,86010,981A108DF07EE24FA84EC23588DA45B3,11261,11,13,2,36,46,1846
86011,86011,981A108DF07EE24FA84EC23588DA45B3,12491,13,14,1,36,43,1843
86012,86012,981A108DF07EE24FA84EC23588DA45B3,11261,15,19,4,36,46,1846
86029,86029,2BEF2F1DF9F53E26FBA10E115C641BD7,12661,6,15,9,32,45,1645
86030,86030,2BEF2F1DF9F53E26FBA10E115C641BD7,42151,15,17,2,35,45,1795
86031,86031,2BEF2F1DF9F53E26FBA10E115C641BD7,12661,17,19,2,32,45,1645
86038,86038,66CEED91201F308AB6358E0F0FF58EE0,40322,0,9,9,38,46,1946
86039,86039,66CEED91201F308AB6358E0F0FF58EE0,42301,9,19,10,36,47,1847
86040,86040,66CEED91201F308AB6358E0F0FF58EE0,40322,21,23,2,38,46,1946
86041,86041,1DA79481C6B6D1D9223A378A0D81757A,10111,0,13,13,37,47,1897
86042,86042,1DA79481C6B6D1D9223A378A0D81757A,40637,17,19,2,36,47,1847
86043,86043,1DA79481C6B6D1D9223A378A0D81757A,10111,20,23,3,37,47,1897
86049,86049,D6553FC98A27307181CDBCB3E58A1E0C,42331,0,7,7,39,46,1996
86050,86050,D6553FC98A27307181CDBCB3E58A1E0C,10811,10,16,6,38,46,1946
86051,86051,D6553FC98A27307181CDBCB3E58A1E0C,10331,20,23,3,39,46,1996
86061,86061,7F8FEC3F30CB3DD9FA8B49EBAA16E6AE,10111,0,7,7,37,47,1897
86062,86062,7F8FEC3F30CB3DD9FA8B49EBAA16E6AE,42271,8,10,2,40,47,2047
86063,86063,7F8FEC3F30CB3DD9FA8B49EBAA16E6AE,10111,10,23,13,37,47,1897
86064,86064,4326A99732F97B46651D6FE77C28BB70,11381,2,9,7,30,47,1547
86065,86065,4326A99732F97B46651D6FE77C28BB70,10951,9,17,8,29,48,1498
86066,86066,4326A99732F97B46651D6FE77C28BB70,11381,18,19,1,30,47,1547
86067,86067,4326A99732F97B46651D6FE77C28BB70,10951,20,21,1,29,48,1498
86071,86071,581E72A8FA6DD89C033B1582E57E82BB,42461,0,14,14,45,47,2297
86072,86072,581E72A8FA6DD89C033B1582E57E82BB,42321,15,17,2,43,47,2197
86073,86073,581E72A8FA6DD89C033B1582E57E82BB,13341,20,23,3,44,45,2245
86078,86078,394B81CC36B31D897120A6153D7C1457,11061,0,4,4,29,48,1498
86079,86079,394B81CC36B31D897120A6153D7C1457,12121,6,14,8,29,47,1497
86080,86080,394B81CC36B31D897120A6153D7C1457,11061,17,23,6,29,48,1498
86081,86081,62DDFD12FD80957CA0268CDDC1A48DA2,11151,7,9,2,30,48,1548
86082,86082,62DDFD12FD80957CA0268CDDC1A48DA2,43391,11,16,5,29,48,1498
86083,86083,62DDFD12FD80957CA0268CDDC1A48DA2,11151,17,20,3,30,48,1548
86084,86084,D12006FABC7B5308E7F05575C74349CD,11021,0,12,12,36,49,1849
86085,86085,D12006FABC7B5308E7F05575C74349CD,42641,16,17,1,33,49,1699
86086,86086,D12006FABC7B5308E7F05575C74349CD,11021,19,23,4,36,49,1849
86096,86096,642C5FCC730BC5A54E2036C81E432BC6,19114,0,5,5,7,43,393
86097,86097,642C5FCC730BC5A54E2036C81E432BC6,12641,10,12,2,10,43,543
86098,86098,642C5FCC730BC5A54E2036C81E432BC6,19114,15,23,8,7,43,393
86099,86099,EF24F74DDF741D0DEC0CB3B2510AE4FC,10351,0,7,7,28,45,1445
86100,86100,EF24F74DDF741D0DEC0CB3B2510AE4FC,10301,11,18,7,31,45,1595
86101,86101,EF24F74DDF741D0DEC0CB3B2510AE4FC,10351,20,22,2,28,45,1445
86112,86112,F4698EB961F72AD85D435B6008D2C2F0,10801,0,12,12,42,47,2147
86113,86113,F4698EB961F72AD85D435B6008D2C2F0,13371,16,18,2,41,47,2097
86114,86114,F4698EB961F72AD85D435B6008D2C2F0,42321,20,21,1,43,47,2197
86120,86120,A43D5D4A5B684572DED832EF1C15CC22,42031,0,5,5,40,46,2046
86121,86121,A43D5D4A5B684572DED832EF1C15CC22,11261,6,8,2,36,46,1846
86122,86122,A43D5D4A5B684572DED832EF1C15CC22,13231,8,9,1,39,46,1996
86123,86123,A43D5D4A5B684572DED832EF1C15CC22,11261,10,20,10,36,46,1846
86148,86148,3F271425F5D5BA7FEC9D1C93CCBA4B72,40833,0,10,10,41,47,2097
86149,86149,3F271425F5D5BA7FEC9D1C93CCBA4B72,13221,12,14,2,40,47,2047
86150,86150,3F271425F5D5BA7FEC9D1C93CCBA4B72,11001,15,22,7,42,47,2147
86155,86155,E969EC1FA6E19F3F5A602F2FE47F2E7D,11261,2,4,2,36,46,1846
86156,86156,E969EC1FA6E19F3F5A602F2FE47F2E7D,13911,6,16,10,39,46,1996
86157,86157,E969EC1FA6E19F3F5A602F2FE47F2E7D,11261,18,20,2,36,46,1846
86161,86161,15AF53FBA0C13FBD61024895398ED2FD,42041,0,3,3,10,47,547
86162,86162,15AF53FBA0C13FBD61024895398ED2FD,11471,3,6,3,12,48,648
86163,86163,15AF53FBA0C13FBD61024895398ED2FD,42041,7,8,1,10,47,547
86164,86164,15AF53FBA0C13FBD61024895398ED2FD,19441,12,19,7,8,46,446
86165,86165,BD5BDD49E22E3E7F939786616084C4C6,10251,0,9,9,35,47,1797
86166,86166,BD5BDD49E22E3E7F939786616084C4C6,10731,10,16,6,33,47,1697
86167,86167,BD5BDD49E22E3E7F939786616084C4C6,40381,17,19,2,32,46,1646
86168,86168,BD5BDD49E22E3E7F939786616084C4C6,42161,21,23,2,36,47,1847
86169,86169,4E5128B32C8A7DB28BB62593B70F7496,43581,0,8,8,33,48,1698
86170,86170,4E5128B32C8A7DB28BB62593B70F7496,10401,9,11,2,33,49,1699
86171,86171,4E5128B32C8A7DB28BB62593B70F7496,43581,12,14,2,33,48,1698
86172,86172,4E5128B32C8A7DB28BB62593B70F7496,11061,16,20,4,29,48,1498
86173,86173,13E5998B0F76CD481DB7EA79EFC80A0D,40411,1,14,13,34,48,1748
86174,86174,13E5998B0F76CD481DB7EA79EFC80A0D,11201,17,18,1,35,49,1799
86175,86175,13E5998B0F76CD481DB7EA79EFC80A0D,40411,19,22,3,34,48,1748
86176,86176,B2405C351D1CAE2B4272A490DD149C7F,42531,0,13,13,31,45,1595
86177,86177,B2405C351D1CAE2B4272A490DD149C7F,10351,16,19,3,28,45,1445
86178,86178,B2405C351D1CAE2B4272A490DD149C7F,42531,21,22,1,31,45,1595
86179,86179,FCD017DA96D35849C76561036D34B0CB,42481,0,2,2,22,49,1149
86180,86180,FCD017DA96D35849C76561036D34B0CB,42691,7,16,9,24,48,1248
86181,86181,FCD017DA96D35849C76561036D34B0CB,42481,21,22,1,22,49,1149
86182,86182,FED5EC14E212CB3BA7AA491F3063AC1F,10111,0,1,1,37,47,1897
86183,86183,FED5EC14E212CB3BA7AA491F3063AC1F,42161,3,5,2,36,47,1847
86184,86184,FED5EC14E212CB3BA7AA491F3063AC1F,10111,7,23,16,37,47,1897
86188,86188,7F683BD350227B09C7ECC1328A0C4739,42011,0,7,7,36,46,1846
86189,86189,7F683BD350227B09C7ECC1328A0C4739,11941,9,20,11,37,46,1896
86190,86190,7F683BD350227B09C7ECC1328A0C4739,42011,22,23,1,36,46,1846
86191,86191,7FD9072832AAE29AE2915CDEF233B942,10801,0,5,5,42,47,2147
86192,86192,7FD9072832AAE29AE2915CDEF233B942,13111,6,9,3,42,46,2146
86193,86193,7FD9072832AAE29AE2915CDEF233B942,10801,11,20,9,42,47,2147
86203,86203,91284BBE72A4661BF1E53E3FAFD2E3D8,13651,1,9,8,30,47,1547
86204,86204,91284BBE72A4661BF1E53E3FAFD2E3D8,42523,9,13,4,31,47,1597
86205,86205,91284BBE72A4661BF1E53E3FAFD2E3D8,13651,14,18,4,30,47,1547
86206,86206,91284BBE72A4661BF1E53E3FAFD2E3D8,42523,20,23,3,31,47,1597
86215,86215,813AD3246425C184A34F687274AB8E9F,11781,3,10,7,38,49,1949
86216,86216,813AD3246425C184A34F687274AB8E9F,42471,12,13,1,35,49,1799
86217,86217,813AD3246425C184A34F687274AB8E9F,10107,16,20,4,38,49,1949
86218,86218,813AD3246425C184A34F687274AB8E9F,11731,20,22,2,36,48,1848
86219,86219,DDF363C64B8F6ACF3450F0B1AA087EA1,19441,0,14,14,8,46,446
86220,86220,DDF363C64B8F6ACF3450F0B1AA087EA1,42041,14,16,2,10,47,547
86221,86221,DDF363C64B8F6ACF3450F0B1AA087EA1,19441,16,23,7,8,46,446
86231,86231,5D3AB87CDE152EA5E956E4DDC06AC59B,40171,1,2,1,38,48,1948
86232,86232,5D3AB87CDE152EA5E956E4DDC06AC59B,11811,5,6,1,38,49,1949
86233,86233,5D3AB87CDE152EA5E956E4DDC06AC59B,10471,7,19,12,37,48,1898
86234,86234,A25BD81EC9134E523B096ACC3062CFB1,40833,0,8,8,41,47,2097
86235,86235,A25BD81EC9134E523B096ACC3062CFB1,40171,12,17,5,38,48,1948
86236,86236,A25BD81EC9134E523B096ACC3062CFB1,40833,18,20,2,41,47,2097
86237,86237,10B8A2D44211CACA01D59967B38E8576,40637,0,2,2,36,47,1847
86238,86238,10B8A2D44211CACA01D59967B38E8576,10251,2,15,13,35,47,1797
86239,86239,10B8A2D44211CACA01D59967B38E8576,10111,17,23,6,37,47,1897
86240,86240,21F728B24C4414C5861D442FE178C9FC,11381,0,13,13,30,47,1547
86241,86241,21F728B24C4414C5861D442FE178C9FC,10951,14,16,2,29,48,1498
86242,86242,21F728B24C4414C5861D442FE178C9FC,12131,17,20,3,32,47,1647
86243,86243,21F728B24C4414C5861D442FE178C9FC,11381,21,23,2,30,47,1547
86244,86244,71406CAB7DAA1D3016D1EDF130C6F573,10491,0,6,6,33,48,1698
86245,86245,71406CAB7DAA1D3016D1EDF130C6F573,42021,7,8,1,33,47,1697
86246,86246,71406CAB7DAA1D3016D1EDF130C6F573,10431,11,17,6,33,49,1699
86247,86247,71406CAB7DAA1D3016D1EDF130C6F573,10491,19,23,4,33,48,1698
86248,86248,D59A7D67E6A2D306517724C5A50D5385,10351,2,6,4,28,45,1445
86249,86249,D59A7D67E6A2D306517724C5A50D5385,42531,7,9,2,31,45,1595
86250,86250,D59A7D67E6A2D306517724C5A50D5385,10351,12,23,11,28,45,1445
86255,86255,325B301C16FB3DB9C4CED544F7B2E787,10471,0,6,6,37,48,1898
86256,86256,325B301C16FB3DB9C4CED544F7B2E787,42191,9,16,7,38,49,1949
86257,86257,325B301C16FB3DB9C4CED544F7B2E787,40171,16,19,3,38,48,1948
86262,86262,5A1960B0A9A1E6AFC1FD047E564C752A,11261,4,5,1,36,46,1846
86263,86263,5A1960B0A9A1E6AFC1FD047E564C752A,42351,10,11,1,38,45,1945
86264,86264,5A1960B0A9A1E6AFC1FD047E564C752A,11261,11,23,12,36,46,1846
86269,86269,28E7600978A73DF1C43046BE94DEFB78,42461,0,9,9,45,47,2297
86270,86270,28E7600978A73DF1C43046BE94DEFB78,42091,11,12,1,43,46,2196
86271,86271,28E7600978A73DF1C43046BE94DEFB78,42321,14,16,2,43,47,2197
86272,86272,28E7600978A73DF1C43046BE94DEFB78,42461,18,22,4,45,47,2297
86279,86279,25DF23F398DD0B4C6CED78808A57A933,11091,0,8,8,29,47,1497
86280,86280,25DF23F398DD0B4C6CED78808A57A933,10292,10,18,8,30,47,1547
86281,86281,25DF23F398DD0B4C6CED78808A57A933,11091,19,23,4,29,47,1497
86293,86293,05519C1D2715565E4FD870F9AF7CE9D8,19024,0,7,7,9,45,495
86294,86294,05519C1D2715565E4FD870F9AF7CE9D8,12641,9,11,2,10,43,543
86295,86295,05519C1D2715565E4FD870F9AF7CE9D8,19024,12,19,7,9,45,495
86301,86301,0933B06061F8F3536F06AEF0D300106F,13711,0,6,6,38,46,1946
86302,86302,0933B06061F8F3536F06AEF0D300106F,11941,8,14,6,37,46,1896
86303,86303,0933B06061F8F3536F06AEF0D300106F,13711,14,18,4,38,46,1946
86304,86304,4A7E0C26D094908459DFDB4A502F3938,42161,0,16,16,36,47,1847
86305,86305,4A7E0C26D094908459DFDB4A502F3938,10111,18,19,1,37,47,1897
86306,86306,4A7E0C26D094908459DFDB4A502F3938,42161,21,23,2,36,47,1847
86307,86307,6D82EC1BA07797B5D3B41166ADAAEC3E,42031,1,9,8,40,46,2046
86308,86308,6D82EC1BA07797B5D3B41166ADAAEC3E,42221,13,14,1,38,48,1948
86309,86309,6D82EC1BA07797B5D3B41166ADAAEC3E,42031,19,21,2,40,46,2046
86310,86310,027C3A3C09B88FB3AEF492C3DD4629B7,42531,1,6,5,31,45,1595
86311,86311,027C3A3C09B88FB3AEF492C3DD4629B7,12311,6,8,2,30,44,1544
86312,86312,027C3A3C09B88FB3AEF492C3DD4629B7,12661,8,10,2,32,45,1645
86313,86313,027C3A3C09B88FB3AEF492C3DD4629B7,12311,10,18,8,30,44,1544
86319,86319,C1E5BCC1C7F8ECB908A80076B478386E,11171,0,5,5,33,48,1698
86320,86320,C1E5BCC1C7F8ECB908A80076B478386E,42021,7,8,1,33,47,1697
86321,86321,C1E5BCC1C7F8ECB908A80076B478386E,11861,10,18,8,32,47,1647
86322,86322,C1E5BCC1C7F8ECB908A80076B478386E,10691,19,23,4,33,48,1698
86335,86335,E57D73395E67AF7D215D19A57C58EA52,12391,8,11,3,36,49,1849
86336,86336,E57D73395E67AF7D215D19A57C58EA52,11231,12,17,5,37,49,1899
86337,86337,E57D73395E67AF7D215D19A57C58EA52,12391,17,19,2,36,49,1849
86341,86341,6EBC343B289E845421579091E3F37018,42461,1,4,3,45,47,2297
86342,86342,6EBC343B289E845421579091E3F37018,42204,4,10,6,43,46,2196
86343,86343,6EBC343B289E845421579091E3F37018,13791,12,14,2,42,47,2147
86344,86344,6EBC343B289E845421579091E3F37018,42091,17,23,6,43,46,2196
86345,86345,7300FFB733BFFEA187DB110E4D4DC3D2,49201,0,1,1,7,41,391
86346,86346,7300FFB733BFFEA187DB110E4D4DC3D2,19181,1,6,5,8,40,440
86347,86347,7300FFB733BFFEA187DB110E4D4DC3D2,12921,8,10,2,9,41,491
86348,86348,7300FFB733BFFEA187DB110E4D4DC3D2,49201,12,23,11,7,41,391
86357,86357,582FCEF67ED9C80E5B2E8667690F61FB,42221,1,6,5,38,48,1948
86358,86358,582FCEF67ED9C80E5B2E8667690F61FB,42401,7,12,5,36,47,1847
86359,86359,582FCEF67ED9C80E5B2E8667690F61FB,42221,12,16,4,38,48,1948
86360,86360,582FCEF67ED9C80E5B2E8667690F61FB,42401,17,22,5,36,47,1847
86364,86364,504467700DDD1C036193CD82D6D3619F,43761,7,12,5,32,47,1647
86365,86365,504467700DDD1C036193CD82D6D3619F,42521,18,20,2,31,47,1597
86366,86366,504467700DDD1C036193CD82D6D3619F,43761,21,23,2,32,47,1647
86367,86367,AB35C432DC3D59E7929F031635A675AA,12601,2,3,1,25,47,1297
86368,86368,AB35C432DC3D59E7929F031635A675AA,10501,4,9,5,22,46,1146
86369,86369,AB35C432DC3D59E7929F031635A675AA,12601,10,21,11,25,47,1297
86370,86370,2CDBE560BCF3AE75FA6854256206C16F,11331,9,12,3,37,48,1898
86371,86371,2CDBE560BCF3AE75FA6854256206C16F,42161,12,18,6,36,47,1847
86372,86372,2CDBE560BCF3AE75FA6854256206C16F,10111,19,20,1,37,47,1897
86373,86373,92DD33C6491127575B3FBFFA6C4FC2F7,13111,0,5,5,42,46,2146
86374,86374,92DD33C6491127575B3FBFFA6C4FC2F7,13911,6,8,2,39,46,1996
86375,86375,92DD33C6491127575B3FBFFA6C4FC2F7,13111,12,23,11,42,46,2146
86391,86391,6428FC1D2F17D8BB440D0F9FCA04C935,13911,0,7,7,39,46,1996
86392,86392,6428FC1D2F17D8BB440D0F9FCA04C935,42231,8,17,9,37,46,1896
86393,86393,6428FC1D2F17D8BB440D0F9FCA04C935,11261,18,19,1,36,46,1846
86394,86394,6428FC1D2F17D8BB440D0F9FCA04C935,13911,20,21,1,39,46,1996
86404,86404,1444CF26498FCF95995CE1D21CF4BAA6,12121,0,17,17,29,47,1497
86405,86405,1444CF26498FCF95995CE1D21CF4BAA6,11381,19,20,1,30,47,1547
86406,86406,1444CF26498FCF95995CE1D21CF4BAA6,12121,21,22,1,29,47,1497
86407,86407,6FD90BBCA41A13F318953E2375C6300B,13911,0,5,5,39,46,1996
86408,86408,6FD90BBCA41A13F318953E2375C6300B,42231,8,11,3,37,46,1896
86409,86409,6FD90BBCA41A13F318953E2375C6300B,13911,13,18,5,39,46,1996
86423,86423,7C5210855A5DFB6ACF7A087ADA0E2F3D,13911,2,13,11,39,46,1996
86424,86424,7C5210855A5DFB6ACF7A087ADA0E2F3D,42351,17,18,1,38,45,1945
86425,86425,7C5210855A5DFB6ACF7A087ADA0E2F3D,13911,19,20,1,39,46,1996
86426,86426,0BC1BC9FA127A76D4558FF0A0EC8FEFB,42921,0,6,6,33,47,1697
86427,86427,0BC1BC9FA127A76D4558FF0A0EC8FEFB,10281,7,9,2,33,48,1698
86428,86428,0BC1BC9FA127A76D4558FF0A0EC8FEFB,42921,12,23,11,33,47,1697
86429,86429,446AC7E279C6659F3E40FC9C0B9B7F45,42631,3,4,1,43,45,2195
86430,86430,446AC7E279C6659F3E40FC9C0B9B7F45,43061,4,13,9,43,46,2196
86431,86431,446AC7E279C6659F3E40FC9C0B9B7F45,42631,15,17,2,43,45,2195
86432,86432,446AC7E279C6659F3E40FC9C0B9B7F45,13341,17,21,4,44,45,2245
86433,86433,D9FB9F3F4820A4EF951566780A770C45,11261,5,8,3,36,46,1846
86434,86434,D9FB9F3F4820A4EF951566780A770C45,13911,9,10,1,39,46,1996
86435,86435,D9FB9F3F4820A4EF951566780A770C45,11261,10,19,9,36,46,1846
86439,86439,64EA873D359181A561255128009EB239,42581,0,5,5,38,48,1948
86440,86440,64EA873D359181A561255128009EB239,11914,6,18,12,37,48,1898
86441,86441,64EA873D359181A561255128009EB239,42581,21,23,2,38,48,1948
86445,86445,0A1386913DE713CBA72662A5149627A3,13711,0,19,19,38,46,1946
86446,86446,0A1386913DE713CBA72662A5149627A3,11941,19,20,1,37,46,1896
86447,86447,0A1386913DE713CBA72662A5149627A3,13711,21,23,2,38,46,1946
86448,86448,829F3CF969A99106A0CF5C6D0ED0FE14,10111,0,8,8,37,47,1897
86449,86449,829F3CF969A99106A0CF5C6D0ED0FE14,11751,9,16,7,35,48,1798
86450,86450,829F3CF969A99106A0CF5C6D0ED0FE14,42401,17,23,6,36,47,1847
86451,86451,7C98BDF484E2B085C51A4945E804FC0C,12491,0,1,1,36,43,1843
86452,86452,7C98BDF484E2B085C51A4945E804FC0C,42151,1,2,1,35,45,1795
86453,86453,7C98BDF484E2B085C51A4945E804FC0C,12491,2,4,2,36,43,1843
86454,86454,7C98BDF484E2B085C51A4945E804FC0C,42151,4,22,18,35,45,1795
86455,86455,620A0D1EA3EF14FD25FBF0EFC8FC8A56,42633,0,5,5,42,46,2146
86456,86456,620A0D1EA3EF14FD25FBF0EFC8FC8A56,13711,9,12,3,38,46,1946
86457,86457,620A0D1EA3EF14FD25FBF0EFC8FC8A56,42633,13,23,10,42,46,2146
86458,86458,00ED2280FB2BEC22D8FB36F8A7AFB1A5,42791,0,8,8,35,45,1795
86459,86459,00ED2280FB2BEC22D8FB36F8A7AFB1A5,13121,8,10,2,38,46,1946
86460,86460,00ED2280FB2BEC22D8FB36F8A7AFB1A5,10271,10,20,10,37,46,1896
86461,86461,00ED2280FB2BEC22D8FB36F8A7AFB1A5,42791,20,23,3,35,45,1795
86462,86462,DD41D87E2F7ADBECC7B7764C6A211AF5,10151,0,9,9,34,47,1747
86463,86463,DD41D87E2F7ADBECC7B7764C6A211AF5,10531,12,14,2,34,46,1746
86464,86464,DD41D87E2F7ADBECC7B7764C6A211AF5,42921,17,18,1,33,47,1697
86465,86465,DD41D87E2F7ADBECC7B7764C6A211AF5,12131,20,21,1,32,47,1647
86471,86471,F207D9B162A098FDFC93EFBDF48E66D8,10111,0,2,2,37,47,1897
86472,86472,F207D9B162A098FDFC93EFBDF48E66D8,42161,4,6,2,36,47,1847
86473,86473,F207D9B162A098FDFC93EFBDF48E66D8,10111,6,15,9,37,47,1897
86474,86474,F207D9B162A098FDFC93EFBDF48E66D8,42301,18,19,1,36,47,1847
86478,86478,81A0A832750D87F13BE469519DF7D944,12311,0,13,13,30,44,1544
86479,86479,81A0A832750D87F13BE469519DF7D944,10301,15,16,1,31,45,1595
86480,86480,81A0A832750D87F13BE469519DF7D944,12311,20,21,1,30,44,1544
86481,86481,46FBB102C6B8DD3727737A749B2D8106,42921,0,7,7,33,47,1697
86482,86482,46FBB102C6B8DD3727737A749B2D8106,12131,7,14,7,32,47,1647
86483,86483,46FBB102C6B8DD3727737A749B2D8106,42371,15,21,6,34,46,1746
86484,86484,46FBB102C6B8DD3727737A749B2D8106,10731,21,23,2,33,47,1697
86485,86485,D250726CC6DF8F38BB74AC069705CC99,10107,0,6,6,38,49,1949
86486,86486,D250726CC6DF8F38BB74AC069705CC99,11481,7,15,8,41,48,2098
86487,86487,D250726CC6DF8F38BB74AC069705CC99,11351,19,20,1,36,48,1848
86488,86488,D250726CC6DF8F38BB74AC069705CC99,43321,21,23,2,36,49,1849
86489,86489,779A5912B4A6F6D2F940BBF5EC5AAE58,12601,0,11,11,25,47,1297
86490,86490,779A5912B4A6F6D2F940BBF5EC5AAE58,10171,14,18,4,26,47,1347
86491,86491,779A5912B4A6F6D2F940BBF5EC5AAE58,12601,20,21,1,25,47,1297
86492,86492,863093DB11F1063670E11FFAF49890AF,43061,0,7,7,43,46,2196
86493,86493,863093DB11F1063670E11FFAF49890AF,13341,10,11,1,44,45,2245
86494,86494,863093DB11F1063670E11FFAF49890AF,43061,15,20,5,43,46,2196
86495,86495,863093DB11F1063670E11FFAF49890AF,42631,20,21,1,43,45,2195
86499,86499,6038070BD421514F5285D3C87D9CA7E1,13601,8,10,2,34,47,1747
86500,86500,6038070BD421514F5285D3C87D9CA7E1,10731,10,12,2,33,47,1697
86501,86501,6038070BD421514F5285D3C87D9CA7E1,13601,15,18,3,34,47,1747
86515,86515,58098C95EBB5313B1B7006269C40D97A,10121,3,8,5,36,49,1849
86516,86516,58098C95EBB5313B1B7006269C40D97A,11231,9,10,1,37,49,1899
86517,86517,58098C95EBB5313B1B7006269C40D97A,10121,13,23,10,36,49,1849
86518,86518,3D4D278B3D58167073B4ACCB11432DB2,12671,0,7,7,21,43,1093
86519,86519,3D4D278B3D58167073B4ACCB11432DB2,13094,7,9,2,21,42,1092
86520,86520,3D4D278B3D58167073B4ACCB11432DB2,12671,12,23,11,21,43,1093
86524,86524,02520C980C83C228272F82E550C0374E,11381,2,3,1,30,47,1547
86525,86525,02520C980C83C228272F82E550C0374E,11061,4,5,1,29,48,1498
86526,86526,02520C980C83C228272F82E550C0374E,11151,8,22,14,30,48,1548
86527,86527,FCD4BFDC7E207C6BC86BD2099528C9B8,42021,1,9,8,33,47,1697
86528,86528,FCD4BFDC7E207C6BC86BD2099528C9B8,11211,9,11,2,34,49,1749
86529,86529,FCD4BFDC7E207C6BC86BD2099528C9B8,11861,14,22,8,32,47,1647
86530,86530,FCD4BFDC7E207C6BC86BD2099528C9B8,42021,22,23,1,33,47,1697
86531,86531,D9B0439F3B0C81F4C0A4571FAB2A3A71,42021,0,7,7,33,47,1697
86532,86532,D9B0439F3B0C81F4C0A4571FAB2A3A71,11861,7,13,6,32,47,1647
86533,86533,D9B0439F3B0C81F4C0A4571FAB2A3A71,42921,16,22,6,33,47,1697
86534,86534,56B5641ECD958384F4615E8368602153,13911,0,7,7,39,46,1996
86535,86535,56B5641ECD958384F4615E8368602153,42231,10,16,6,37,46,1896
86536,86536,56B5641ECD958384F4615E8368602153,12514,18,19,1,38,47,1947
86537,86537,56B5641ECD958384F4615E8368602153,11074,20,22,2,37,47,1897
86538,86538,3DF776BE348E3512AD7BA8032B525BFF,12511,0,7,7,39,47,1997
86539,86539,3DF776BE348E3512AD7BA8032B525BFF,42271,9,10,1,40,47,2047
86540,86540,3DF776BE348E3512AD7BA8032B525BFF,12511,10,23,13,39,47,1997
86546,86546,4B5C492CF16B079882322240829D6566,11231,0,7,7,37,49,1899
86547,86547,4B5C492CF16B079882322240829D6566,40502,8,9,1,36,48,1848
86548,86548,4B5C492CF16B079882322240829D6566,11231,10,14,4,37,49,1899
86549,86549,4B5C492CF16B079882322240829D6566,11271,16,21,5,37,48,1898
86554,86554,31C99BE35DAA7CC1D9A6D662CA3683F3,10841,0,7,7,37,47,1897
86555,86555,31C99BE35DAA7CC1D9A6D662CA3683F3,42331,9,10,1,39,46,1996
86556,86556,31C99BE35DAA7CC1D9A6D662CA3683F3,42511,10,15,5,37,47,1897
86557,86557,31C99BE35DAA7CC1D9A6D662CA3683F3,42331,16,20,4,39,46,1996
86558,86558,D7B4DEFCB86C55D027A1210EEC02063B,11231,0,2,2,37,49,1899
86559,86559,D7B4DEFCB86C55D027A1210EEC02063B,11021,3,19,16,36,49,1849
86560,86560,D7B4DEFCB86C55D027A1210EEC02063B,11231,19,23,4,37,49,1899
86561,86561,558A6887C0D5899B43E75BBD844A7C64,42461,1,6,5,45,47,2297
86562,86562,558A6887C0D5899B43E75BBD844A7C64,42321,9,13,4,43,47,2197
86563,86563,558A6887C0D5899B43E75BBD844A7C64,42461,17,19,2,45,47,2297
86578,86578,89680CECB0A0CAAB751B383429847A2B,12871,0,5,5,22,33,1133
86579,86579,89680CECB0A0CAAB751B383429847A2B,49181,10,21,11,21,31,1081
86580,86580,89680CECB0A0CAAB751B383429847A2B,12871,22,23,1,22,33,1133
86587,86587,4E9D6148560142FFC3549F2650187D86,10491,0,5,5,33,48,1698
86588,86588,4E9D6148560142FFC3549F2650187D86,11861,6,18,12,32,47,1647
86589,86589,4E9D6148560142FFC3549F2650187D86,10431,18,19,1,33,49,1699
86590,86590,4E9D6148560142FFC3549F2650187D86,10491,22,23,1,33,48,1698
86596,86596,2FC977AAECB05F28AE0C53353C4DD1FC,13711,3,7,4,38,46,1946
86597,86597,2FC977AAECB05F28AE0C53353C4DD1FC,10271,8,10,2,37,46,1896
86598,86598,2FC977AAECB05F28AE0C53353C4DD1FC,13711,13,22,9,38,46,1946
86609,86609,0A38726AFAF5C6270A000784329F6FB8,42231,8,9,1,37,46,1896
86610,86610,0A38726AFAF5C6270A000784329F6FB8,11261,10,12,2,36,46,1846
86611,86611,0A38726AFAF5C6270A000784329F6FB8,42351,12,18,6,38,45,1945
86612,86612,0A38726AFAF5C6270A000784329F6FB8,13911,19,23,4,39,46,1996
86613,86613,D3F18133881188A01FA675132E824AEA,42481,2,10,8,22,49,1149
86614,86614,D3F18133881188A01FA675132E824AEA,11361,14,15,1,22,48,1148
86615,86615,D3F18133881188A01FA675132E824AEA,42481,17,18,1,22,49,1149
86616,86616,4D154C9C8398ECE6697BF31BE875D9EF,10111,0,1,1,37,47,1897
86617,86617,4D154C9C8398ECE6697BF31BE875D9EF,11911,2,4,2,37,48,1898
86618,86618,4D154C9C8398ECE6697BF31BE875D9EF,11074,5,23,18,37,47,1897
86619,86619,376DDDFE24216F652E9CDE9E324BF6F4,10544,0,14,14,28,48,1448
86620,86620,376DDDFE24216F652E9CDE9E324BF6F4,42521,18,19,1,31,47,1597
86621,86621,376DDDFE24216F652E9CDE9E324BF6F4,10544,20,23,3,28,48,1448
86625,86625,9080DF503ACF0ABF3EAE58FF37C4563F,10681,0,6,6,30,48,1548
86626,86626,9080DF503ACF0ABF3EAE58FF37C4563F,11061,9,15,6,29,48,1498
86627,86627,9080DF503ACF0ABF3EAE58FF37C4563F,11151,16,18,2,30,48,1548
86628,86628,9080DF503ACF0ABF3EAE58FF37C4563F,43391,21,22,1,29,48,1498
86636,86636,7E33ECC0F103E120460A8A411D580301,12521,0,14,14,35,41,1791
86637,86637,7E33ECC0F103E120460A8A411D580301,42151,19,20,1,35,45,1795
86638,86638,7E33ECC0F103E120460A8A411D580301,12521,20,23,3,35,41,1791
86639,86639,3E43E3619134D3BEB3FF85568E512AF6,11231,10,13,3,37,49,1899
86640,86640,3E43E3619134D3BEB3FF85568E512AF6,10471,13,17,4,37,48,1898
86641,86641,3E43E3619134D3BEB3FF85568E512AF6,11231,17,21,4,37,49,1899
86647,86647,0C993A1B5BD23944DD153F92F92FAA1E,10634,0,4,4,27,45,1395
86648,86648,0C993A1B5BD23944DD153F92F92FAA1E,10351,7,16,9,28,45,1445
86649,86649,0C993A1B5BD23944DD153F92F92FAA1E,10634,16,17,1,27,45,1395
86650,86650,0C993A1B5BD23944DD153F92F92FAA1E,10351,19,20,1,28,45,1445
86651,86651,47E88EEB0ACD8A050A018340BD482B6B,11074,3,11,8,37,47,1897
86652,86652,47E88EEB0ACD8A050A018340BD482B6B,13381,15,16,1,39,47,1997
86653,86653,47E88EEB0ACD8A050A018340BD482B6B,11074,17,19,2,37,47,1897
86654,86654,47E88EEB0ACD8A050A018340BD482B6B,11921,19,21,2,38,48,1948
86659,86659,1C342138E4F3A267558D83898ED1706A,10121,2,3,1,36,49,1849
86660,86660,1C342138E4F3A267558D83898ED1706A,40271,3,7,4,35,49,1799
86661,86661,1C342138E4F3A267558D83898ED1706A,10121,11,12,1,36,49,1849
86662,86662,1C342138E4F3A267558D83898ED1706A,40271,14,23,9,35,49,1799
86679,86679,9B96DAA509FD397123C045520455AB11,13111,4,6,2,42,46,2146
86680,86680,9B96DAA509FD397123C045520455AB11,13371,7,13,6,41,47,2097
86681,86681,9B96DAA509FD397123C045520455AB11,13111,15,16,1,42,46,2146
86682,86682,9B96DAA509FD397123C045520455AB11,13371,20,22,2,41,47,2097
86683,86683,BECB17E0AD4F06C8390C173C333FCA7C,13791,3,8,5,42,47,2147
86684,86684,BECB17E0AD4F06C8390C173C333FCA7C,42204,12,14,2,43,46,2196
86685,86685,BECB17E0AD4F06C8390C173C333FCA7C,13791,15,20,5,42,47,2147
86698,86698,EEAD4C1A5C3C3CA3E08C3BA4BC80CCB9,12641,8,10,2,10,43,543
86699,86699,EEAD4C1A5C3C3CA3E08C3BA4BC80CCB9,12921,12,17,5,9,41,491
86700,86700,EEAD4C1A5C3C3CA3E08C3BA4BC80CCB9,12641,17,18,1,10,43,543
86708,86708,888D3867D3038878970E976C5AE9B1B6,13651,0,10,10,30,47,1547
86709,86709,888D3867D3038878970E976C5AE9B1B6,10351,11,14,3,28,45,1445
86710,86710,888D3867D3038878970E976C5AE9B1B6,13651,18,23,5,30,47,1547
86711,86711,6ECD9F332B70EE62CE67343F1CBAED1D,10691,0,15,15,33,48,1698
86712,86712,6ECD9F332B70EE62CE67343F1CBAED1D,10381,19,20,1,31,49,1599
86713,86713,6ECD9F332B70EE62CE67343F1CBAED1D,10691,21,23,2,33,48,1698
86714,86714,660D0729A871FB18966DF6415A58AEF7,11381,7,9,2,30,47,1547
86715,86715,660D0729A871FB18966DF6415A58AEF7,11861,11,13,2,32,47,1647
86716,86716,660D0729A871FB18966DF6415A58AEF7,11381,15,16,1,30,47,1547
86717,86717,660D0729A871FB18966DF6415A58AEF7,11061,19,20,1,29,48,1498
86725,86725,034BF108F7447DC54755E0BD15E86728,13911,0,10,10,39,46,1996
86726,86726,034BF108F7447DC54755E0BD15E86728,42351,11,14,3,38,45,1945
86727,86727,034BF108F7447DC54755E0BD15E86728,11261,18,21,3,36,46,1846
86728,86728,9C853A4D5C7B5210EB733E5032A36376,11021,0,14,14,36,49,1849
86729,86729,9C853A4D5C7B5210EB733E5032A36376,12401,15,17,2,39,49,1999
86730,86730,9C853A4D5C7B5210EB733E5032A36376,11021,21,23,2,36,49,1849
86731,86731,5A2C5389EA17DE44E6FF07D83053D2D6,42921,0,7,7,33,47,1697
86732,86732,5A2C5389EA17DE44E6FF07D83053D2D6,10221,10,11,1,34,49,1749
86733,86733,5A2C5389EA17DE44E6FF07D83053D2D6,42921,14,18,4,33,47,1697
86746,86746,A1B1493AD1E4959D25E397CB780FB65E,42531,0,4,4,31,45,1595
86747,86747,A1B1493AD1E4959D25E397CB780FB65E,12311,7,9,2,30,44,1544
86748,86748,A1B1493AD1E4959D25E397CB780FB65E,42531,12,23,11,31,45,1595
86754,86754,0AC9ACC82EDADEC2B3583D25F9FB3BD5,19441,0,1,1,8,46,446
86755,86755,0AC9ACC82EDADEC2B3583D25F9FB3BD5,42041,4,7,3,10,47,547
86756,86756,0AC9ACC82EDADEC2B3583D25F9FB3BD5,19441,10,15,5,8,46,446
86757,86757,0AC9ACC82EDADEC2B3583D25F9FB3BD5,42041,18,21,3,10,47,547
86758,86758,7E6ABF38A691D9304A64197B5968007E,42461,0,5,5,45,47,2297
86759,86759,7E6ABF38A691D9304A64197B5968007E,42321,9,16,7,43,47,2197
86760,86760,7E6ABF38A691D9304A64197B5968007E,42461,18,21,3,45,47,2297
86775,86775,D7632671362A1093E82856ECF4918B64,13561,3,6,3,37,49,1899
86776,86776,D7632671362A1093E82856ECF4918B64,11021,16,19,3,36,49,1849
86777,86777,D7632671362A1093E82856ECF4918B64,13561,21,23,2,37,49,1899
86784,86784,5A663421832DBF7D39E75BC4CBC2CCB7,10491,0,14,14,33,48,1698
86785,86785,5A663421832DBF7D39E75BC4CBC2CCB7,11061,14,16,2,29,48,1498
86786,86786,5A663421832DBF7D39E75BC4CBC2CCB7,10491,20,23,3,33,48,1698
86792,86792,6268A79D87E3CFA4E65FA8A748F9969C,13101,0,8,8,40,47,2047
86793,86793,6268A79D87E3CFA4E65FA8A748F9969C,13271,10,15,5,41,47,2097
86794,86794,6268A79D87E3CFA4E65FA8A748F9969C,10231,17,20,3,39,49,1999
86795,86795,9161AF2FBE00F6EB9CFD0E53A85277FE,10951,0,1,1,29,48,1498
86796,86796,9161AF2FBE00F6EB9CFD0E53A85277FE,11381,1,8,7,30,47,1547
86797,86797,9161AF2FBE00F6EB9CFD0E53A85277FE,10951,8,10,2,29,48,1498
86798,86798,9161AF2FBE00F6EB9CFD0E53A85277FE,11381,13,23,10,30,47,1547
86805,86805,86902B52DC79D42F4776148283AF350B,42091,7,9,2,43,46,2196
86806,86806,86902B52DC79D42F4776148283AF350B,11701,10,15,5,43,48,2198
86807,86807,86902B52DC79D42F4776148283AF350B,42091,17,19,2,43,46,2196
86808,86808,86902B52DC79D42F4776148283AF350B,42461,22,23,1,45,47,2297
86818,86818,0781E535CBB143640477269330BEC7EE,10881,1,12,11,34,48,1748
86819,86819,0781E535CBB143640477269330BEC7EE,10221,14,15,1,34,49,1749
86820,86820,0781E535CBB143640477269330BEC7EE,11201,15,17,2,35,49,1799
86821,86821,0781E535CBB143640477269330BEC7EE,10221,19,21,2,34,49,1749
86826,86826,40F471DD86450F7E02A9160B1DB5571E,11701,2,8,6,43,48,2198
86827,86827,40F471DD86450F7E02A9160B1DB5571E,42321,13,17,4,43,47,2197
86828,86828,40F471DD86450F7E02A9160B1DB5571E,42461,20,21,1,45,47,2297
86829,86829,40F471DD86450F7E02A9160B1DB5571E,11701,22,23,1,43,48,2198
86833,86833,01308B72F71E3AACC045F922DA6CAE4D,43761,3,8,5,32,47,1647
86834,86834,01308B72F71E3AACC045F922DA6CAE4D,42523,8,9,1,31,47,1597
86835,86835,01308B72F71E3AACC045F922DA6CAE4D,43761,9,21,12,32,47,1647
86839,86839,633685412625A817939B6845B087EB3D,43451,2,4,2,37,40,1890
86840,86840,633685412625A817939B6845B087EB3D,12521,5,9,4,35,41,1791
86841,86841,633685412625A817939B6845B087EB3D,43451,9,11,2,37,40,1890
86842,86842,633685412625A817939B6845B087EB3D,12521,12,23,11,35,41,1791
86849,86849,FB6D357AE6E744B7566081ADA8598AEB,13601,0,13,13,34,47,1747
86850,86850,FB6D357AE6E744B7566081ADA8598AEB,10881,13,15,2,34,48,1748
86851,86851,FB6D357AE6E744B7566081ADA8598AEB,43731,19,20,1,34,47,1747
86858,86858,9C95D6292421E6B801C911060D75482F,12921,0,2,2,9,41,491
86859,86859,9C95D6292421E6B801C911060D75482F,12641,3,4,1,10,43,543
86860,86860,9C95D6292421E6B801C911060D75482F,12921,6,23,17,9,41,491
86864,86864,2D914C2EB253165A5763D18FAE5FB6D2,11801,1,5,4,42,48,2148
86865,86865,2D914C2EB253165A5763D18FAE5FB6D2,13111,7,12,5,42,46,2146
86866,86866,2D914C2EB253165A5763D18FAE5FB6D2,43061,14,18,4,43,46,2196
86872,86872,E5F35E9A8E7D375E3C2447F3147B8E3F,42523,3,10,7,31,47,1597
86873,86873,E5F35E9A8E7D375E3C2447F3147B8E3F,43761,10,11,1,32,47,1647
86874,86874,E5F35E9A8E7D375E3C2447F3147B8E3F,42523,13,16,3,31,47,1597
86875,86875,E5F35E9A8E7D375E3C2447F3147B8E3F,10711,20,22,2,29,46,1496
86876,86876,2DF55C2584719A60978A4B87BCCC14A1,42523,0,4,4,31,47,1597
86877,86877,2DF55C2584719A60978A4B87BCCC14A1,10292,7,15,8,30,47,1547
86878,86878,2DF55C2584719A60978A4B87BCCC14A1,42521,16,18,2,31,47,1597
86879,86879,2DF55C2584719A60978A4B87BCCC14A1,43761,18,19,1,32,47,1647
86880,86880,FCA3C665B5BF337F331669EDB597A6AC,42791,0,7,7,35,45,1795
86881,86881,FCA3C665B5BF337F331669EDB597A6AC,13121,8,11,3,38,46,1946
86882,86882,FCA3C665B5BF337F331669EDB597A6AC,10271,11,18,7,37,46,1896
86883,86883,FCA3C665B5BF337F331669EDB597A6AC,42791,20,23,3,35,45,1795
86887,86887,01766EF3CBCA4165E365CA6048DDBCDC,10971,0,7,7,35,47,1797
86888,86888,01766EF3CBCA4165E365CA6048DDBCDC,43731,9,14,5,34,47,1747
86889,86889,01766EF3CBCA4165E365CA6048DDBCDC,42161,19,21,2,36,47,1847
86890,86890,01766EF3CBCA4165E365CA6048DDBCDC,43731,21,23,2,34,47,1747
86891,86891,6897948AE713267F243E250D453383B2,10292,0,8,8,30,47,1547
86892,86892,6897948AE713267F243E250D453383B2,42523,9,10,1,31,47,1597
86893,86893,6897948AE713267F243E250D453383B2,10292,11,13,2,30,47,1547
86894,86894,6897948AE713267F243E250D453383B2,42523,17,18,1,31,47,1597
86895,86895,C029826C5BB7E45FB7F0BA61E1CA759A,12381,0,8,8,32,48,1648
86896,86896,C029826C5BB7E45FB7F0BA61E1CA759A,10721,8,10,2,31,48,1598
86897,86897,C029826C5BB7E45FB7F0BA61E1CA759A,12381,15,23,8,32,48,1648
86910,86910,36A5DA74A38B0FD57799D67573348D49,10841,0,10,10,37,47,1897
86911,86911,36A5DA74A38B0FD57799D67573348D49,12514,12,15,3,38,47,1947
86912,86912,36A5DA74A38B0FD57799D67573348D49,11491,15,18,3,36,47,1847
86913,86913,36A5DA74A38B0FD57799D67573348D49,10841,21,23,2,37,47,1897
86930,86930,3CFF352FC0F760E9B7CC6021501C3AD4,11061,0,12,12,29,48,1498
86931,86931,3CFF352FC0F760E9B7CC6021501C3AD4,11151,14,15,1,30,48,1548
86932,86932,3CFF352FC0F760E9B7CC6021501C3AD4,10544,15,17,2,28,48,1448
86933,86933,3CFF352FC0F760E9B7CC6021501C3AD4,43391,18,19,1,29,48,1498
86934,86934,221907A0B5FBDE67A1B2826B991290F1,11381,4,15,11,30,47,1547
86935,86935,221907A0B5FBDE67A1B2826B991290F1,12121,16,19,3,29,47,1497
86936,86936,221907A0B5FBDE67A1B2826B991290F1,11381,19,22,3,30,47,1547
86937,86937,B0E1B0D26C40402293513B661D1B71BA,12083,2,10,8,36,49,1849
86938,86938,B0E1B0D26C40402293513B661D1B71BA,11231,15,16,1,37,49,1899
86939,86939,B0E1B0D26C40402293513B661D1B71BA,42961,17,20,3,35,49,1799
86940,86940,B0E1B0D26C40402293513B661D1B71BA,12391,22,23,1,36,49,1849
86941,86941,21D029E4FB71F3A5DA880019FDFB9BC1,12491,0,5,5,36,43,1843
86942,86942,21D029E4FB71F3A5DA880019FDFB9BC1,42151,7,9,2,35,45,1795
86943,86943,21D029E4FB71F3A5DA880019FDFB9BC1,12491,11,22,11,36,43,1843
86951,86951,B2012EE6BD195EC80673B0F2B5EC1C5E,12921,0,19,19,9,41,491
86952,86952,B2012EE6BD195EC80673B0F2B5EC1C5E,12641,19,21,2,10,43,543
86953,86953,B2012EE6BD195EC80673B0F2B5EC1C5E,12921,21,22,1,9,41,491
86954,86954,E3B088F7DEFCCE4BD4EB6ADB8F0E5950,10591,0,4,4,39,48,1998
86955,86955,E3B088F7DEFCCE4BD4EB6ADB8F0E5950,12514,9,10,1,38,47,1947
86956,86956,E3B088F7DEFCCE4BD4EB6ADB8F0E5950,10841,13,19,6,37,47,1897
86957,86957,656752102BA99654C7060CE5B2133D72,49201,0,12,12,7,41,391
86958,86958,656752102BA99654C7060CE5B2133D72,12921,16,18,2,9,41,491
86959,86959,656752102BA99654C7060CE5B2133D72,49201,21,23,2,7,41,391
86960,86960,99165E654E4A5840EA37FC83361CE61B,11914,8,11,3,37,48,1898
86961,86961,99165E654E4A5840EA37FC83361CE61B,42581,13,14,1,38,48,1948
86962,86962,99165E654E4A5840EA37FC83361CE61B,11914,16,18,2,37,48,1898
86981,86981,5DB82E605B1FB0DDC2A0B5A637F4F0AF,42231,6,10,4,37,46,1896
86982,86982,5DB82E605B1FB0DDC2A0B5A637F4F0AF,42351,14,16,2,38,45,1945
86983,86983,5DB82E605B1FB0DDC2A0B5A637F4F0AF,42231,18,21,3,37,46,1896
86987,86987,EB7EB6074C1F2A07A41462E31EDA6629,42161,0,6,6,36,47,1847
86988,86988,EB7EB6074C1F2A07A41462E31EDA6629,11074,9,10,1,37,47,1897
86989,86989,EB7EB6074C1F2A07A41462E31EDA6629,42161,13,16,3,36,47,1847
86990,86990,EB7EB6074C1F2A07A41462E31EDA6629,11074,20,21,1,37,47,1897
86997,86997,B324CCFCD3F5330D2BA1EBE28CA2A657,13101,1,8,7,40,47,2047
86998,86998,B324CCFCD3F5330D2BA1EBE28CA2A657,13271,9,12,3,41,47,2097
86999,86999,B324CCFCD3F5330D2BA1EBE28CA2A657,13101,12,22,10,40,47,2047
87004,87004,7A6C1F91C08B692A643E0B4791AE2CE6,12521,0,17,17,35,41,1791
87005,87005,7A6C1F91C08B692A643E0B4791AE2CE6,43451,17,19,2,37,40,1890
87006,87006,7A6C1F91C08B692A643E0B4791AE2CE6,12521,20,23,3,35,41,1791
87025,87025,43DBEEA61839592A95FC32BC8064AB85,12921,0,15,15,9,41,491
87026,87026,43DBEEA61839592A95FC32BC8064AB85,12641,16,18,2,10,43,543
87027,87027,43DBEEA61839592A95FC32BC8064AB85,19114,19,20,1,7,43,393
87028,87028,43DBEEA61839592A95FC32BC8064AB85,12921,21,23,2,9,41,491
87029,87029,61A392CF78768B731CF2C85C2D95BACB,43581,0,8,8,33,48,1698
87030,87030,61A392CF78768B731CF2C85C2D95BACB,10401,8,9,1,33,49,1699
87031,87031,61A392CF78768B731CF2C85C2D95BACB,40234,10,11,1,35,49,1799
87032,87032,61A392CF78768B731CF2C85C2D95BACB,10401,12,21,9,33,49,1699
87033,87033,5017DC5A15F28FB4E5C8B33E21578020,42231,9,11,2,37,46,1896
87034,87034,5017DC5A15F28FB4E5C8B33E21578020,13711,13,16,3,38,46,1946
87035,87035,5017DC5A15F28FB4E5C8B33E21578020,42231,16,22,6,37,46,1896
87051,87051,2037976F03472170FD25B1B08877DABB,11001,0,11,11,42,47,2147
87052,87052,2037976F03472170FD25B1B08877DABB,13941,13,14,1,41,47,2097
87053,87053,2037976F03472170FD25B1B08877DABB,11001,18,23,5,42,47,2147
87063,87063,4B14A6BE44CBF5DD1F1A77E6F1D6D99B,10731,1,8,7,33,47,1697
87064,87064,4B14A6BE44CBF5DD1F1A77E6F1D6D99B,13601,11,13,2,34,47,1747
87065,87065,4B14A6BE44CBF5DD1F1A77E6F1D6D99B,42021,15,23,8,33,47,1697
87066,87066,CAACA858123D57B1053C320BC0D4ADE1,42204,8,10,2,43,46,2196
87067,87067,CAACA858123D57B1053C320BC0D4ADE1,42601,10,11,1,44,48,2248
87068,87068,CAACA858123D57B1053C320BC0D4ADE1,42631,13,18,5,43,45,2195
87069,87069,CAACA858123D57B1053C320BC0D4ADE1,43061,18,21,3,43,46,2196
87076,87076,3582950BA90FF3FBFD95BD8C97C90A9C,10151,0,6,6,34,47,1747
87077,87077,3582950BA90FF3FBFD95BD8C97C90A9C,41591,14,15,1,34,49,1749
87078,87078,3582950BA90FF3FBFD95BD8C97C90A9C,10151,16,23,7,34,47,1747
87079,87079,F10DCA77B208C0B385CF6E7BEA5199DF,42141,4,12,8,32,47,1647
87080,87080,F10DCA77B208C0B385CF6E7BEA5199DF,10281,17,20,3,33,48,1698
87081,87081,F10DCA77B208C0B385CF6E7BEA5199DF,42141,21,23,2,32,47,1647
87099,87099,27261F5B8D9848C7A4B5BCEE2F08E8A6,10292,0,6,6,30,47,1547
87100,87100,27261F5B8D9848C7A4B5BCEE2F08E8A6,11831,7,12,5,32,45,1645
87101,87101,27261F5B8D9848C7A4B5BCEE2F08E8A6,13651,17,18,1,30,47,1547
87102,87102,27261F5B8D9848C7A4B5BCEE2F08E8A6,42523,20,21,1,31,47,1597
87103,87103,C919A8058ECB429BE0036BE26BF6A160,10251,0,16,16,35,47,1797
87104,87104,C919A8058ECB429BE0036BE26BF6A160,11751,17,18,1,35,48,1798
87105,87105,C919A8058ECB429BE0036BE26BF6A160,10251,20,23,3,35,47,1797
87125,87125,4C8E92DBB85921608C1C92929A7A8C92,42521,0,14,14,31,47,1597
87126,87126,4C8E92DBB85921608C1C92929A7A8C92,13651,14,17,3,30,47,1547
87127,87127,4C8E92DBB85921608C1C92929A7A8C92,42521,19,23,4,31,47,1597
87136,87136,96F0E524C752F5D8CB4CEA95332B4FE9,11151,0,14,14,30,48,1548
87137,87137,96F0E524C752F5D8CB4CEA95332B4FE9,43391,14,16,2,29,48,1498
87138,87138,96F0E524C752F5D8CB4CEA95332B4FE9,11151,16,17,1,30,48,1548
87139,87139,96F0E524C752F5D8CB4CEA95332B4FE9,43391,19,22,3,29,48,1498
87140,87140,3F458F6ABA1F2A91C8D3DACF4A48895B,11061,4,8,4,29,48,1498
87141,87141,3F458F6ABA1F2A91C8D3DACF4A48895B,11381,8,10,2,30,47,1547
87142,87142,3F458F6ABA1F2A91C8D3DACF4A48895B,11061,15,20,5,29,48,1498
87151,87151,54C28B082733E33A64393D2DD39B9D4C,10841,1,12,11,37,47,1897
87152,87152,54C28B082733E33A64393D2DD39B9D4C,42221,12,13,1,38,48,1948
87153,87153,54C28B082733E33A64393D2DD39B9D4C,10841,18,19,1,37,47,1897
87164,87164,1E2BDCE897234CB8450E391543ADF518,42351,7,8,1,38,45,1945
87165,87165,1E2BDCE897234CB8450E391543ADF518,11261,9,11,2,36,46,1846
87166,87166,1E2BDCE897234CB8450E391543ADF518,42351,11,19,8,38,45,1945
87167,87167,08EDF1CCFF32686DD950EC26EF30E233,11381,0,17,17,30,47,1547
87168,87168,08EDF1CCFF32686DD950EC26EF30E233,10681,17,20,3,30,48,1548
87169,87169,08EDF1CCFF32686DD950EC26EF30E233,11381,21,23,2,30,47,1547
87170,87170,9637A49CA49F0EFD37F0D0143383C518,42231,6,7,1,37,46,1896
87171,87171,9637A49CA49F0EFD37F0D0143383C518,42271,7,9,2,40,47,2047
87172,87172,9637A49CA49F0EFD37F0D0143383C518,42231,10,22,12,37,46,1896
87173,87173,CC04DF57CD476D56A9C2711AACC54374,42861,1,13,12,37,44,1894
87174,87174,CC04DF57CD476D56A9C2711AACC54374,11261,17,21,4,36,46,1846
87175,87175,CC04DF57CD476D56A9C2711AACC54374,42861,21,23,2,37,44,1894
87176,87176,9A08BD2AB3CB3916B002B02D5A4A595E,10901,0,10,10,35,48,1798
87177,87177,9A08BD2AB3CB3916B002B02D5A4A595E,11861,10,14,4,32,47,1647
87178,87178,9A08BD2AB3CB3916B002B02D5A4A595E,10731,15,20,5,33,47,1697
87183,87183,503C825874017B94AAE9067BE859DEB7,49201,6,15,9,7,41,391
87184,87184,503C825874017B94AAE9067BE859DEB7,12921,15,17,2,9,41,491
87185,87185,503C825874017B94AAE9067BE859DEB7,49201,17,19,2,7,41,391
87186,87186,503C825874017B94AAE9067BE859DEB7,12921,19,21,2,9,41,491
87196,87196,039720C5318D39E34BBB18DF8027F133,42581,0,4,4,38,48,1948
87197,87197,039720C5318D39E34BBB18DF8027F133,11271,6,18,12,37,48,1898
87198,87198,039720C5318D39E34BBB18DF8027F133,42581,18,19,1,38,48,1948
87199,87199,039720C5318D39E34BBB18DF8027F133,11914,20,21,1,37,48,1898
87200,87200,05286C4B5017A260B39768783F7D4555,42581,0,12,12,38,48,1948
87201,87201,05286C4B5017A260B39768783F7D4555,11914,13,17,4,37,48,1898
87202,87202,05286C4B5017A260B39768783F7D4555,11811,19,20,1,38,49,1949
87203,87203,05286C4B5017A260B39768783F7D4555,42581,20,21,1,38,48,1948
87204,87204,8A2B6A3BBB67F4CA1B157F83176E3E9B,43471,1,2,1,31,49,1599
87205,87205,8A2B6A3BBB67F4CA1B157F83176E3E9B,11151,3,19,16,30,48,1548
87206,87206,8A2B6A3BBB67F4CA1B157F83176E3E9B,10381,21,23,2,31,49,1599
87207,87207,99B3AC71EBDFEF963525FD23270BF9C3,11231,0,8,8,37,49,1899
87208,87208,99B3AC71EBDFEF963525FD23270BF9C3,11021,9,10,1,36,49,1849
87209,87209,99B3AC71EBDFEF963525FD23270BF9C3,10661,10,18,8,37,49,1899
87227,87227,A249659AA4285866F354A5650B26A07F,42161,0,7,7,36,47,1847
87228,87228,A249659AA4285866F354A5650B26A07F,10111,8,12,4,37,47,1897
87229,87229,A249659AA4285866F354A5650B26A07F,42161,13,20,7,36,47,1847
87230,87230,A249659AA4285866F354A5650B26A07F,10111,21,23,2,37,47,1897
87231,87231,3B28F0257C334F0CB1C45997FF1A55FD,42921,0,11,11,33,47,1697
87232,87232,3B28F0257C334F0CB1C45997FF1A55FD,10281,16,20,4,33,48,1698
87233,87233,3B28F0257C334F0CB1C45997FF1A55FD,42921,21,23,2,33,47,1697
87251,87251,2267A6F43D82FD9160A39965307DF9F2,12491,0,7,7,36,43,1843
87252,87252,2267A6F43D82FD9160A39965307DF9F2,42151,7,19,12,35,45,1795
87253,87253,2267A6F43D82FD9160A39965307DF9F2,12491,20,21,1,36,43,1843
87254,87254,7A99FDC902CB131C92CA7F5FAF0DCFEF,11381,0,4,4,30,47,1547
87255,87255,7A99FDC902CB131C92CA7F5FAF0DCFEF,11061,8,13,5,29,48,1498
87256,87256,7A99FDC902CB131C92CA7F5FAF0DCFEF,11381,17,23,6,30,47,1547
87273,87273,C587B8BBA49D2BF4E222CE1A0182D385,42583,1,9,8,40,48,2048
87274,87274,C587B8BBA49D2BF4E222CE1A0182D385,10771,14,15,1,41,46,2096
87275,87275,C587B8BBA49D2BF4E222CE1A0182D385,42583,18,21,3,40,48,2048
87276,87276,C587B8BBA49D2BF4E222CE1A0182D385,10931,22,23,1,41,48,2098
87277,87277,E478E2D9BCF7A4F7B498F875A46F0A1D,40801,0,7,7,43,46,2196
87278,87278,E478E2D9BCF7A4F7B498F875A46F0A1D,42461,9,11,2,45,47,2297
87279,87279,E478E2D9BCF7A4F7B498F875A46F0A1D,42204,13,20,7,43,46,2196
87285,87285,4F3F717E93BC5AFE00C4421DCBF0AA01,40322,0,1,1,38,46,1946
87286,87286,4F3F717E93BC5AFE00C4421DCBF0AA01,42301,2,8,6,36,47,1847
87287,87287,4F3F717E93BC5AFE00C4421DCBF0AA01,11261,10,21,11,36,46,1846
87291,87291,778AB2266E31CA80BF57681CFC352E18,42071,6,8,2,31,49,1599
87292,87292,778AB2266E31CA80BF57681CFC352E18,11061,8,10,2,29,48,1498
87293,87293,778AB2266E31CA80BF57681CFC352E18,42071,14,23,9,31,49,1599
87303,87303,DDD4A2411D3DDF8FF51DA78894EED629,19024,0,6,6,9,45,495
87304,87304,DDD4A2411D3DDF8FF51DA78894EED629,12641,8,10,2,10,43,543
87305,87305,DDD4A2411D3DDF8FF51DA78894EED629,19024,12,23,11,9,45,495
87306,87306,94A66B099C3B286235DEE73BAE7FEB6C,11861,0,19,19,32,47,1647
87307,87307,94A66B099C3B286235DEE73BAE7FEB6C,10281,19,20,1,33,48,1698
87308,87308,94A66B099C3B286235DEE73BAE7FEB6C,11861,20,22,2,32,47,1647
87320,87320,549B8A34E419FBD57213E9641A5E14A7,11061,0,3,3,29,48,1498
87321,87321,549B8A34E419FBD57213E9641A5E14A7,10681,3,6,3,30,48,1548
87322,87322,549B8A34E419FBD57213E9641A5E14A7,11061,7,8,1,29,48,1498
87323,87323,549B8A34E419FBD57213E9641A5E14A7,10681,11,23,12,30,48,1548
87329,87329,E88F39A65DCBFC647F6F44FF9039942F,12601,0,3,3,25,47,1297
87330,87330,E88F39A65DCBFC647F6F44FF9039942F,10634,6,9,3,27,45,1395
87331,87331,E88F39A65DCBFC647F6F44FF9039942F,12601,12,19,7,25,47,1297
87332,87332,B570A71613653BD3890D6EDB8B29EBC3,11261,0,13,13,36,46,1846
87333,87333,B570A71613653BD3890D6EDB8B29EBC3,42861,16,21,5,37,44,1894
87334,87334,B570A71613653BD3890D6EDB8B29EBC3,11261,21,23,2,36,46,1846
87343,87343,CF6A7AF612D2CFA2B8383868CF93735B,42921,0,9,9,33,47,1697
87344,87344,CF6A7AF612D2CFA2B8383868CF93735B,42523,10,15,5,31,47,1597
87345,87345,CF6A7AF612D2CFA2B8383868CF93735B,42921,15,23,8,33,47,1697
87346,87346,F241E466F470C5B457084A31C3CEECE3,42161,0,13,13,36,47,1847
87347,87347,F241E466F470C5B457084A31C3CEECE3,12514,17,19,2,38,47,1947
87348,87348,F241E466F470C5B457084A31C3CEECE3,42161,21,23,2,36,47,1847
87349,87349,3904BFA0DAEEBCA85365DF524DB867F2,12641,0,5,5,10,43,543
87350,87350,3904BFA0DAEEBCA85365DF524DB867F2,12921,8,9,1,9,41,491
87351,87351,3904BFA0DAEEBCA85365DF524DB867F2,12641,9,22,13,10,43,543
87352,87352,0760067EA204421AC12ED2100EDD32E4,40123,0,8,8,38,47,1947
87353,87353,0760067EA204421AC12ED2100EDD32E4,10841,12,15,3,37,47,1897
87354,87354,0760067EA204421AC12ED2100EDD32E4,43161,16,17,1,35,47,1797
87355,87355,0760067EA204421AC12ED2100EDD32E4,10841,21,23,2,37,47,1897
87360,87360,FCF6425DA3F542476DF1F93935C075D8,42581,0,8,8,38,48,1948
87361,87361,FCF6425DA3F542476DF1F93935C075D8,11914,8,11,3,37,48,1898
87362,87362,FCF6425DA3F542476DF1F93935C075D8,42581,12,18,6,38,48,1948
87363,87363,FCF6425DA3F542476DF1F93935C075D8,13221,19,21,2,40,47,2047
87379,87379,64125BF70ADD2A9D2C91BE766AA2E78E,42861,1,9,8,37,44,1894
87380,87380,64125BF70ADD2A9D2C91BE766AA2E78E,11261,10,12,2,36,46,1846
87381,87381,64125BF70ADD2A9D2C91BE766AA2E78E,13911,12,16,4,39,46,1996
87382,87382,64125BF70ADD2A9D2C91BE766AA2E78E,11261,17,18,1,36,46,1846
87387,87387,DEB632549C00DBE1E148C1A64F029789,11161,0,8,8,32,48,1648
87388,87388,DEB632549C00DBE1E148C1A64F029789,11954,9,11,2,32,49,1649
87389,87389,DEB632549C00DBE1E148C1A64F029789,11161,12,15,3,32,48,1648
87390,87390,DEB632549C00DBE1E148C1A64F029789,10251,17,20,3,35,47,1797
87391,87391,C11958CA68DCC24D143388B1E6ECEAA7,11151,0,12,12,30,48,1548
87392,87392,C11958CA68DCC24D143388B1E6ECEAA7,40094,12,20,8,29,48,1498
87393,87393,C11958CA68DCC24D143388B1E6ECEAA7,11151,20,23,3,30,48,1548
87400,87400,5F7E950259CDC0501C557FA5949D23BE,43761,1,10,9,32,47,1647
87401,87401,5F7E950259CDC0501C557FA5949D23BE,11081,12,13,1,35,46,1796
87402,87402,5F7E950259CDC0501C557FA5949D23BE,43761,14,21,7,32,47,1647
87407,87407,48335C8716313F33854E399EDBC1FB66,12311,0,4,4,30,44,1544
87408,87408,48335C8716313F33854E399EDBC1FB66,12661,6,18,12,32,45,1645
87409,87409,48335C8716313F33854E399EDBC1FB66,12311,18,23,5,30,44,1544
87415,87415,39C82D096AEA76978FDBEDFE5C6B1FC3,11951,0,8,8,31,49,1599
87416,87416,39C82D096AEA76978FDBEDFE5C6B1FC3,11381,11,13,2,30,47,1547
87417,87417,39C82D096AEA76978FDBEDFE5C6B1FC3,42961,17,22,5,35,49,1799
87426,87426,CF6018A335A607ED2642F0E4EFED8477,10251,0,8,8,35,47,1797
87427,87427,CF6018A335A607ED2642F0E4EFED8477,42471,12,13,1,35,49,1799
87428,87428,CF6018A335A607ED2642F0E4EFED8477,10841,20,21,1,37,47,1897
87429,87429,CF6018A335A607ED2642F0E4EFED8477,40637,22,23,1,36,47,1847
87430,87430,312060B326A149D1F0009EDC937831B5,42161,0,7,7,36,47,1847
87431,87431,312060B326A149D1F0009EDC937831B5,10111,9,18,9,37,47,1897
87432,87432,312060B326A149D1F0009EDC937831B5,10531,19,23,4,34,46,1746
87449,87449,63BE306B14928A55954312CC95ACAACF,12511,0,12,12,39,47,1997
87450,87450,63BE306B14928A55954312CC95ACAACF,11074,13,14,1,37,47,1897
87451,87451,63BE306B14928A55954312CC95ACAACF,12511,16,23,7,39,47,1997
87452,87452,6C2244D79333FB126D7C044044FC52BA,12491,0,6,6,36,43,1843
87453,87453,6C2244D79333FB126D7C044044FC52BA,43451,6,7,1,37,40,1890
87454,87454,6C2244D79333FB126D7C044044FC52BA,12491,12,23,11,36,43,1843
87474,87474,BD2E300B9C24161B103FADC662539751,11211,0,9,9,34,49,1749
87475,87475,BD2E300B9C24161B103FADC662539751,10107,10,11,1,38,49,1949
87476,87476,BD2E300B9C24161B103FADC662539751,10401,12,15,3,33,49,1699
87477,87477,BD2E300B9C24161B103FADC662539751,10661,19,22,3,37,49,1899
87478,87478,C6B20AF59FCE7811AD359D515A06A5AA,42161,1,18,17,36,47,1847
87479,87479,C6B20AF59FCE7811AD359D515A06A5AA,10151,19,20,1,34,47,1747
87480,87480,C6B20AF59FCE7811AD359D515A06A5AA,42161,21,23,2,36,47,1847
87491,87491,402CC333EAD0CDC45B32CFBF32B762E9,43661,0,5,5,33,47,1697
87492,87492,402CC333EAD0CDC45B32CFBF32B762E9,11861,6,12,6,32,47,1647
87493,87493,402CC333EAD0CDC45B32CFBF32B762E9,43661,13,15,2,33,47,1697
87494,87494,402CC333EAD0CDC45B32CFBF32B762E9,11861,17,22,5,32,47,1647
87495,87495,2AEA8CD7C7441A2139369CE4AFCCE79A,40964,0,11,11,35,48,1798
87496,87496,2AEA8CD7C7441A2139369CE4AFCCE79A,42981,15,16,1,36,49,1849
87497,87497,2AEA8CD7C7441A2139369CE4AFCCE79A,40964,19,23,4,35,48,1798
87498,87498,9FBE4F8990A8CD363759928CDC6080CC,13911,1,5,4,39,46,1996
87499,87499,9FBE4F8990A8CD363759928CDC6080CC,11261,6,12,6,36,46,1846
87500,87500,9FBE4F8990A8CD363759928CDC6080CC,13911,14,19,5,39,46,1996
87501,87501,99F5BEE34C277EC7BBBEB92C558829F6,13711,0,8,8,38,46,1946
87502,87502,99F5BEE34C277EC7BBBEB92C558829F6,42231,10,19,9,37,46,1896
87503,87503,99F5BEE34C277EC7BBBEB92C558829F6,13711,21,23,2,38,46,1946
87507,87507,302E13281DC08AB4B0CB613D73ADA12A,11381,0,14,14,30,47,1547
87508,87508,302E13281DC08AB4B0CB613D73ADA12A,42501,16,18,2,28,47,1447
87509,87509,302E13281DC08AB4B0CB613D73ADA12A,11381,20,23,3,30,47,1547
87518,87518,1BCA8F195CED1A69C9ABE190E0303E0A,19111,1,10,9,9,45,495
87519,87519,1BCA8F195CED1A69C9ABE190E0303E0A,19114,13,15,2,7,43,393
87520,87520,1BCA8F195CED1A69C9ABE190E0303E0A,19441,19,21,2,8,46,446
87521,87521,1BCA8F195CED1A69C9ABE190E0303E0A,19111,21,23,2,9,45,495
87522,87522,08A52BC8363090C351FBB56D380273C7,42141,1,2,1,32,47,1647
87523,87523,08A52BC8363090C351FBB56D380273C7,10281,2,6,4,33,48,1698
87524,87524,08A52BC8363090C351FBB56D380273C7,42141,8,23,15,32,47,1647
87530,87530,000D77C2A9F62BEDA00737D781A7BB24,10151,0,16,16,34,47,1747
87531,87531,000D77C2A9F62BEDA00737D781A7BB24,11861,17,18,1,32,47,1647
87532,87532,000D77C2A9F62BEDA00737D781A7BB24,10841,19,20,1,37,47,1897
87533,87533,000D77C2A9F62BEDA00737D781A7BB24,11861,22,23,1,32,47,1647
87534,87534,1B550A18B0397F926248F9A2C7B0A9DE,42341,0,9,9,43,49,2199
87535,87535,1B550A18B0397F926248F9A2C7B0A9DE,10621,12,13,1,41,49,2099
87536,87536,1B550A18B0397F926248F9A2C7B0A9DE,11661,17,19,2,40,49,2049
87537,87537,1B550A18B0397F926248F9A2C7B0A9DE,42341,22,23,1,43,49,2199
87538,87538,12CF5F0E019282F2BF2076B3C77B6607,19441,0,7,7,8,46,446
87539,87539,12CF5F0E019282F2BF2076B3C77B6607,42041,11,12,1,10,47,547
87540,87540,12CF5F0E019282F2BF2076B3C77B6607,19441,12,23,11,8,46,446
87576,87576,E368078C59121EE7A89865E85A806516,11541,2,7,5,35,49,1799
87577,87577,E368078C59121EE7A89865E85A806516,42641,8,11,3,33,49,1699
87578,87578,E368078C59121EE7A89865E85A806516,41061,16,17,1,34,49,1749
87579,87579,E368078C59121EE7A89865E85A806516,11541,18,23,5,35,49,1799
87580,87580,D65506EDDA59637632B53755416666C4,11914,0,10,10,37,48,1898
87581,87581,D65506EDDA59637632B53755416666C4,40171,14,15,1,38,48,1948
87582,87582,D65506EDDA59637632B53755416666C4,10471,16,23,7,37,48,1898
87591,87591,7E52A5B7447DF4E0B028AE7D4242B41E,42341,0,17,17,43,49,2199
87592,87592,7E52A5B7447DF4E0B028AE7D4242B41E,13471,18,19,1,47,49,2399
87593,87593,7E52A5B7447DF4E0B028AE7D4242B41E,42341,20,23,3,43,49,2199
87594,87594,8D8E9039F0B9A1657D1F9D7D1E057C89,10901,0,10,10,35,48,1798
87595,87595,8D8E9039F0B9A1657D1F9D7D1E057C89,43761,11,15,4,32,47,1647
87596,87596,8D8E9039F0B9A1657D1F9D7D1E057C89,11731,17,23,6,36,48,1848
87597,87597,2EB3873FC04DE2FE7DCCB48F35926C6A,11021,0,8,8,36,49,1849
87598,87598,2EB3873FC04DE2FE7DCCB48F35926C6A,10841,8,10,2,37,47,1897
87599,87599,2EB3873FC04DE2FE7DCCB48F35926C6A,11021,10,23,13,36,49,1849
87600,87600,3FD20D651A2685B6781307B6EE69BD8B,13351,0,2,2,48,48,2448
87601,87601,3FD20D651A2685B6781307B6EE69BD8B,13471,3,19,16,47,49,2399
87602,87602,3FD20D651A2685B6781307B6EE69BD8B,42601,20,21,1,44,48,2248
87607,87607,464DF91C83D752715121CBA55775E029,11381,0,15,15,30,47,1547
87608,87608,464DF91C83D752715121CBA55775E029,11061,15,17,2,29,48,1498
87609,87609,464DF91C83D752715121CBA55775E029,11381,17,23,6,30,47,1547
87610,87610,DDA0748B2338452391EBA627D104CDA8,40611,0,6,6,35,47,1797
87611,87611,DDA0748B2338452391EBA627D104CDA8,12083,9,10,1,36,49,1849
87612,87612,DDA0748B2338452391EBA627D104CDA8,40611,22,23,1,35,47,1797
87613,87613,2415E2465DF6D046DC5E15AEEDDF590D,42221,2,9,7,38,48,1948
87614,87614,2415E2465DF6D046DC5E15AEEDDF590D,11074,9,10,1,37,47,1897
87615,87615,2415E2465DF6D046DC5E15AEEDDF590D,42221,11,14,3,38,48,1948
87616,87616,2415E2465DF6D046DC5E15AEEDDF590D,11074,19,20,1,37,47,1897
87617,87617,82C2AAA304DDEBA254F62F054F59E7E2,11061,3,11,8,29,48,1498
87618,87618,82C2AAA304DDEBA254F62F054F59E7E2,10681,13,15,2,30,48,1548
87619,87619,82C2AAA304DDEBA254F62F054F59E7E2,11061,19,21,2,29,48,1498
87620,87620,5ACA36B7BC92185878126AEADBDDC3E6,11651,0,8,8,33,47,1697
87621,87621,5ACA36B7BC92185878126AEADBDDC3E6,13601,9,11,2,34,47,1747
87622,87622,5ACA36B7BC92185878126AEADBDDC3E6,42921,12,21,9,33,47,1697
87626,87626,86877F32D6D32D1728C272FD8E7855F4,11861,0,11,11,32,47,1647
87627,87627,86877F32D6D32D1728C272FD8E7855F4,10281,11,13,2,33,48,1698
87628,87628,86877F32D6D32D1728C272FD8E7855F4,11861,14,23,9,32,47,1647
87635,87635,84DA01F112661472BCB344139BA68924,43061,0,13,13,43,46,2196
87636,87636,84DA01F112661472BCB344139BA68924,13341,17,18,1,44,45,2245
87637,87637,84DA01F112661472BCB344139BA68924,43061,18,20,2,43,46,2196
87638,87638,84DA01F112661472BCB344139BA68924,13341,20,22,2,44,45,2245
87644,87644,1788FF83230593384DFEF88881720D90,13551,0,5,5,45,38,2288
87645,87645,1788FF83230593384DFEF88881720D90,43101,8,12,4,46,40,2340
87646,87646,1788FF83230593384DFEF88881720D90,13551,16,23,7,45,38,2288
87651,87651,11C5ACA60B0246DE7069023057E8285F,10681,0,2,2,30,48,1548
87652,87652,11C5ACA60B0246DE7069023057E8285F,11381,2,4,2,30,47,1547
87653,87653,11C5ACA60B0246DE7069023057E8285F,11061,4,11,7,29,48,1498
87654,87654,11C5ACA60B0246DE7069023057E8285F,11381,14,19,5,30,47,1547
87659,87659,36391605FB1091601145BE09BDC65544,11231,0,3,3,37,49,1899
87660,87660,36391605FB1091601145BE09BDC65544,11271,4,14,10,37,48,1898
87661,87661,36391605FB1091601145BE09BDC65544,11231,18,21,3,37,49,1899
87673,87673,0DFD98C5BF618352145AEF64606DF221,42401,0,1,1,36,47,1847
87674,87674,0DFD98C5BF618352145AEF64606DF221,40673,6,18,12,36,48,1848
87675,87675,0DFD98C5BF618352145AEF64606DF221,10251,18,20,2,35,47,1797
87676,87676,0DFD98C5BF618352145AEF64606DF221,42401,20,23,3,36,47,1847
87677,87677,30AB6C7EC58CB8CC888BCCCFBED2EBEF,10881,0,8,8,34,48,1748
87678,87678,30AB6C7EC58CB8CC888BCCCFBED2EBEF,12131,18,20,2,32,47,1647
87679,87679,30AB6C7EC58CB8CC888BCCCFBED2EBEF,10881,21,23,2,34,48,1748
87680,87680,6343BF60CCF3D70B5AB02F8245B426EB,10271,0,8,8,37,46,1896
87681,87681,6343BF60CCF3D70B5AB02F8245B426EB,13121,11,13,2,38,46,1946
87682,87682,6343BF60CCF3D70B5AB02F8245B426EB,42301,16,17,1,36,47,1847
87683,87683,6343BF60CCF3D70B5AB02F8245B426EB,10271,20,23,3,37,46,1896
87695,87695,67BCB76F611F63115F44CBB7619B7D68,42161,0,17,17,36,47,1847
87696,87696,67BCB76F611F63115F44CBB7619B7D68,43161,18,20,2,35,47,1797
87697,87697,67BCB76F611F63115F44CBB7619B7D68,42161,21,23,2,36,47,1847
87698,87698,DB5F58C0BF92D33E406DDC1B3C9B82ED,10161,0,15,15,35,49,1799
87699,87699,DB5F58C0BF92D33E406DDC1B3C9B82ED,11491,17,20,3,36,47,1847
87700,87700,DB5F58C0BF92D33E406DDC1B3C9B82ED,10161,22,23,1,35,49,1799
87701,87701,57C16FC7FD122F7979F6D505350315B6,13601,0,2,2,34,47,1747
87702,87702,57C16FC7FD122F7979F6D505350315B6,42021,2,13,11,33,47,1697
87703,87703,57C16FC7FD122F7979F6D505350315B6,13601,13,23,10,34,47,1747
87707,87707,DF5678A2D82F170D018446CB4502486B,12083,0,9,9,36,49,1849
87708,87708,DF5678A2D82F170D018446CB4502486B,11231,10,14,4,37,49,1899
87709,87709,DF5678A2D82F170D018446CB4502486B,11351,16,21,5,36,48,1848
87713,87713,68D5553872A94DDAC491FB747742F965,11806,0,9,9,41,48,2098
87714,87714,68D5553872A94DDAC491FB747742F965,42321,14,17,3,43,47,2197
87715,87715,68D5553872A94DDAC491FB747742F965,11806,20,23,3,41,48,2098
87730,87730,99EE4A73E608F7C26ACE18786D34F32E,19441,0,2,2,8,46,446
87731,87731,99EE4A73E608F7C26ACE18786D34F32E,12621,2,3,1,10,48,548
87732,87732,99EE4A73E608F7C26ACE18786D34F32E,19441,6,23,17,8,46,446
87738,87738,72DBDA8603B4E9714EB6F87BB7715606,11381,0,7,7,30,47,1547
87739,87739,72DBDA8603B4E9714EB6F87BB7715606,12121,7,9,2,29,47,1497
87740,87740,72DBDA8603B4E9714EB6F87BB7715606,11381,13,23,10,30,47,1547
87741,87741,E851663A4AFDBBD685EADA85BD388CFB,11021,0,6,6,36,49,1849
87742,87742,E851663A4AFDBBD685EADA85BD388CFB,40271,8,11,3,35,49,1799
87743,87743,E851663A4AFDBBD685EADA85BD388CFB,40124,15,17,2,38,47,1947
87744,87744,E851663A4AFDBBD685EADA85BD388CFB,11021,20,23,3,36,49,1849
87766,87766,561E784EC2E47BBEC7B0DEA237920F52,13711,5,6,1,38,46,1946
87767,87767,561E784EC2E47BBEC7B0DEA237920F52,11491,9,19,10,36,47,1847
87768,87768,561E784EC2E47BBEC7B0DEA237920F52,13711,22,23,1,38,46,1946
87795,87795,2F1F7798F5E8889B4080CA59D71F0274,10271,0,11,11,37,46,1896
87796,87796,2F1F7798F5E8889B4080CA59D71F0274,13711,12,17,5,38,46,1946
87797,87797,2F1F7798F5E8889B4080CA59D71F0274,11911,21,23,2,37,48,1898
87798,87798,20A7975366758E3C48A8CB4E3CD0626C,40343,1,3,2,24,49,1249
87799,87799,20A7975366758E3C48A8CB4E3CD0626C,42121,3,9,6,26,49,1349
87800,87800,20A7975366758E3C48A8CB4E3CD0626C,40343,9,22,13,24,49,1249
87812,87812,FEA371B99B04FC8CCEB8F07D4D5C7BA2,10471,1,3,2,37,48,1898
87813,87813,FEA371B99B04FC8CCEB8F07D4D5C7BA2,10151,3,20,17,34,47,1747
87814,87814,FEA371B99B04FC8CCEB8F07D4D5C7BA2,11491,20,22,2,36,47,1847
87820,87820,4DA57F9F33C37E2CA21407DE781C18AF,13911,2,9,7,39,46,1996
87821,87821,4DA57F9F33C37E2CA21407DE781C18AF,11261,10,11,1,36,46,1846
87822,87822,4DA57F9F33C37E2CA21407DE781C18AF,42351,12,13,1,38,45,1945
87823,87823,4DA57F9F33C37E2CA21407DE781C18AF,13911,14,23,9,39,46,1996
87824,87824,B855E84BF722A366F6E79AEB62045285,10271,1,7,6,37,46,1896
87825,87825,B855E84BF722A366F6E79AEB62045285,13711,8,10,2,38,46,1946
87826,87826,B855E84BF722A366F6E79AEB62045285,10271,15,23,8,37,46,1896
87840,87840,72ADC0DFCAD703602A2CA791141275B4,13511,0,8,8,34,48,1748
87841,87841,72ADC0DFCAD703602A2CA791141275B4,11231,10,13,3,37,49,1899
87842,87842,72ADC0DFCAD703602A2CA791141275B4,13511,14,19,5,34,48,1748
87843,87843,7EBD3BA762C40F1F8A712F803B7D8FD3,42151,3,5,2,35,45,1795
87844,87844,7EBD3BA762C40F1F8A712F803B7D8FD3,12491,8,19,11,36,43,1843
87845,87845,7EBD3BA762C40F1F8A712F803B7D8FD3,42151,19,20,1,35,45,1795
87846,87846,7EBD3BA762C40F1F8A712F803B7D8FD3,12491,22,23,1,36,43,1843
87856,87856,B7A892EA73B2F2CFDA936AAF2E2290C5,12921,0,8,8,9,41,491
87857,87857,B7A892EA73B2F2CFDA936AAF2E2290C5,19181,9,10,1,8,40,440
87858,87858,B7A892EA73B2F2CFDA936AAF2E2290C5,12921,10,17,7,9,41,491
87859,87859,B7A892EA73B2F2CFDA936AAF2E2290C5,19181,20,22,2,8,40,440
87871,87871,44B392D88AA7F1B21F1FF6A57BADBD84,13711,0,6,6,38,46,1946
87872,87872,44B392D88AA7F1B21F1FF6A57BADBD84,42231,11,13,2,37,46,1896
87873,87873,44B392D88AA7F1B21F1FF6A57BADBD84,13911,13,14,1,39,46,1996
87874,87874,44B392D88AA7F1B21F1FF6A57BADBD84,42231,15,22,7,37,46,1896
87883,87883,DFB39D9C16979A7A210D773BBB4B6305,42351,0,8,8,38,45,1945
87884,87884,DFB39D9C16979A7A210D773BBB4B6305,11261,12,15,3,36,46,1846
87885,87885,DFB39D9C16979A7A210D773BBB4B6305,42351,17,22,5,38,45,1945
87886,87886,9BCBBEDBEDD27474017DEF91D76DE205,13461,0,6,6,39,44,1994
87887,87887,9BCBBEDBEDD27474017DEF91D76DE205,12221,8,9,1,43,44,2194
87888,87888,9BCBBEDBEDD27474017DEF91D76DE205,13461,12,23,11,39,44,1994
87889,87889,53B9F7992DB29A9E3000FDBC39A3F0DF,11074,0,13,13,37,47,1897
87890,87890,53B9F7992DB29A9E3000FDBC39A3F0DF,12514,14,16,2,38,47,1947
87891,87891,53B9F7992DB29A9E3000FDBC39A3F0DF,11074,17,18,1,37,47,1897
87892,87892,64C0160C1BE92982C639D15A6F2AE02B,11921,1,8,7,38,48,1948
87893,87893,64C0160C1BE92982C639D15A6F2AE02B,11074,11,12,1,37,47,1897
87894,87894,64C0160C1BE92982C639D15A6F2AE02B,11921,17,21,4,38,48,1948
87900,87900,545B57FE377B53DF15322A3E629D81E6,12921,0,12,12,9,41,491
87901,87901,545B57FE377B53DF15322A3E629D81E6,49201,15,16,1,7,41,391
87902,87902,545B57FE377B53DF15322A3E629D81E6,19181,21,22,1,8,40,440
87920,87920,B8DB030E6F574F75DC469AA0B11A44D5,10531,0,7,7,34,46,1746
87921,87921,B8DB030E6F574F75DC469AA0B11A44D5,43731,12,13,1,34,47,1747
87922,87922,B8DB030E6F574F75DC469AA0B11A44D5,40637,16,17,1,36,47,1847
87923,87923,B8DB030E6F574F75DC469AA0B11A44D5,10151,19,23,4,34,47,1747
87924,87924,280A825D237E9CE7CB403628403E758B,11261,1,7,6,36,46,1846
87925,87925,280A825D237E9CE7CB403628403E758B,42351,8,9,1,38,45,1945
87926,87926,280A825D237E9CE7CB403628403E758B,11261,10,19,9,36,46,1846
87930,87930,DD5CE6DD8E417DEB4686A2B15261DEA7,11271,0,4,4,37,48,1898
87931,87931,DD5CE6DD8E417DEB4686A2B15261DEA7,42401,6,14,8,36,47,1847
87932,87932,DD5CE6DD8E417DEB4686A2B15261DEA7,10901,18,19,1,35,48,1798
87933,87933,325F6E45B1DFC860919AE71795AA4212,11861,0,12,12,32,47,1647
87934,87934,325F6E45B1DFC860919AE71795AA4212,10301,12,13,1,31,45,1595
87935,87935,325F6E45B1DFC860919AE71795AA4212,11861,14,23,9,32,47,1647
87936,87936,BAB574E671490AD78EBF4163C7916FA6,13711,0,10,10,38,46,1946
87937,87937,BAB574E671490AD78EBF4163C7916FA6,42351,11,12,1,38,45,1945
87938,87938,BAB574E671490AD78EBF4163C7916FA6,13711,14,17,3,38,46,1946
87939,87939,BAB574E671490AD78EBF4163C7916FA6,42351,20,21,1,38,45,1945
87944,87944,AEFE66901F8D1843F747168E1F2C69AE,10107,8,11,3,38,49,1949
87945,87945,AEFE66901F8D1843F747168E1F2C69AE,42581,11,16,5,38,48,1948
87946,87946,AEFE66901F8D1843F747168E1F2C69AE,43181,18,19,1,39,48,1998
87947,87947,B4D705B6FACBCC009AB169FE5F38F21F,19441,1,7,6,8,46,446
87948,87948,B4D705B6FACBCC009AB169FE5F38F21F,42041,7,10,3,10,47,547
87949,87949,B4D705B6FACBCC009AB169FE5F38F21F,19441,12,15,3,8,46,446
87950,87950,B4D705B6FACBCC009AB169FE5F38F21F,42041,15,21,6,10,47,547
87957,87957,C6869A64CA9EF97A25D7192A00726FC2,42401,0,14,14,36,47,1847
87958,87958,C6869A64CA9EF97A25D7192A00726FC2,10111,15,19,4,37,47,1897
87959,87959,C6869A64CA9EF97A25D7192A00726FC2,42401,19,22,3,36,47,1847
87960,87960,6F1D4167899B8FACCDA59C8500D9A0E5,10841,2,14,12,37,47,1897
87961,87961,6F1D4167899B8FACCDA59C8500D9A0E5,41021,15,16,1,38,47,1947
87962,87962,6F1D4167899B8FACCDA59C8500D9A0E5,10111,16,17,1,37,47,1897
87963,87963,6F1D4167899B8FACCDA59C8500D9A0E5,10901,19,20,1,35,48,1798
87976,87976,17B467982DBE02EE2EDDF7462F3AE5CF,11351,2,12,10,36,48,1848
87977,87977,17B467982DBE02EE2EDDF7462F3AE5CF,40951,14,16,2,36,49,1849
87978,87978,17B467982DBE02EE2EDDF7462F3AE5CF,11351,16,19,3,36,48,1848
87979,87979,17B467982DBE02EE2EDDF7462F3AE5CF,10161,20,23,3,35,49,1799
87984,87984,A2EA2AB82A45207E1BCB502B97AEA982,40872,0,2,2,30,49,1549
87985,87985,A2EA2AB82A45207E1BCB502B97AEA982,10381,2,13,11,31,49,1599
87986,87986,A2EA2AB82A45207E1BCB502B97AEA982,11211,15,16,1,34,49,1749
87987,87987,A2EA2AB82A45207E1BCB502B97AEA982,10381,20,23,3,31,49,1599
87991,87991,5156CFDCDD6D06B9C439BBE6A3CABC0D,10251,0,4,4,35,47,1797
87992,87992,5156CFDCDD6D06B9C439BBE6A3CABC0D,10111,4,15,11,37,47,1897
87993,87993,5156CFDCDD6D06B9C439BBE6A3CABC0D,42161,15,22,7,36,47,1847
87994,87994,8D49C82F9DC138F9CA3DE2C5C7A08552,11061,1,2,1,29,48,1498
87995,87995,8D49C82F9DC138F9CA3DE2C5C7A08552,11381,3,20,17,30,47,1547
87996,87996,8D49C82F9DC138F9CA3DE2C5C7A08552,11061,21,22,1,29,48,1498
88013,88013,33F80FB1B3682C2C3CDF17BAD155C351,42151,0,18,18,35,45,1795
88014,88014,33F80FB1B3682C2C3CDF17BAD155C351,42861,18,19,1,37,44,1894
88015,88015,33F80FB1B3682C2C3CDF17BAD155C351,42151,20,23,3,35,45,1795
88016,88016,F8E5692DC64F594EE622EF21A4844BEB,19114,0,5,5,7,43,393
88017,88017,F8E5692DC64F594EE622EF21A4844BEB,12921,6,7,1,9,41,491
88018,88018,F8E5692DC64F594EE622EF21A4844BEB,12641,8,16,8,10,43,543
88019,88019,F8E5692DC64F594EE622EF21A4844BEB,19114,21,23,2,7,43,393
88020,88020,E3364A6DFAAAA828191D53876E64EA24,11001,0,15,15,42,47,2147
88021,88021,E3364A6DFAAAA828191D53876E64EA24,42601,15,17,2,44,48,2248
88022,88022,E3364A6DFAAAA828191D53876E64EA24,11001,21,23,2,42,47,2147
88027,88027,C23C395E1758AD19CFCD20328E385B2B,40637,0,9,9,36,47,1847
88028,88028,C23C395E1758AD19CFCD20328E385B2B,11074,15,17,2,37,47,1897
88029,88029,C23C395E1758AD19CFCD20328E385B2B,10251,17,23,6,35,47,1797
88043,88043,990529BE48C6A8DFFA6A404F72B17A5A,42151,0,4,4,35,45,1795
88044,88044,990529BE48C6A8DFFA6A404F72B17A5A,42861,5,19,14,37,44,1894
88045,88045,990529BE48C6A8DFFA6A404F72B17A5A,11261,20,21,1,36,46,1846
88046,88046,C049B170495375BB5253D6DC1568AF09,40411,0,9,9,34,48,1748
88047,88047,C049B170495375BB5253D6DC1568AF09,12131,12,20,8,32,47,1647
88048,88048,C049B170495375BB5253D6DC1568AF09,10881,22,23,1,34,48,1748
88072,88072,85755C05F2E2982F3178CEFF0B0642F8,42221,0,12,12,38,48,1948
88073,88073,85755C05F2E2982F3178CEFF0B0642F8,11074,15,17,2,37,47,1897
88074,88074,85755C05F2E2982F3178CEFF0B0642F8,42221,19,23,4,38,48,1948
88083,88083,95F5650709CACF923AC8764BA8D78995,42531,0,19,19,31,45,1595
88084,88084,95F5650709CACF923AC8764BA8D78995,12311,20,21,1,30,44,1544
88085,88085,95F5650709CACF923AC8764BA8D78995,42531,22,23,1,31,45,1595
88086,88086,D0724F7222F2A68CBB3AF39147C3459E,41393,0,13,13,43,49,2199
88087,88087,D0724F7222F2A68CBB3AF39147C3459E,41392,14,16,2,43,48,2198
88088,88088,D0724F7222F2A68CBB3AF39147C3459E,41393,16,23,7,43,49,2199
88093,88093,682555996D9B4C03E6ED55BA265598EF,10471,0,9,9,37,48,1898
88094,88094,682555996D9B4C03E6ED55BA265598EF,40171,13,20,7,38,48,1948
88095,88095,682555996D9B4C03E6ED55BA265598EF,10471,20,23,3,37,48,1898
88096,88096,BAF8CBAEABDF4063FF5ED369E100E588,12083,6,13,7,36,49,1849
88097,88097,BAF8CBAEABDF4063FF5ED369E100E588,13331,13,16,3,38,47,1947
88098,88098,BAF8CBAEABDF4063FF5ED369E100E588,11231,18,23,5,37,49,1899
88099,88099,479BB88DD9C776BA69F274C628C53893,13121,0,13,13,38,46,1946
88100,88100,479BB88DD9C776BA69F274C628C53893,10331,13,16,3,39,46,1996
88101,88101,479BB88DD9C776BA69F274C628C53893,13121,17,22,5,38,46,1946
88113,88113,03CC5102FB306C3254027D35E65D966E,42581,0,7,7,38,48,1948
88114,88114,03CC5102FB306C3254027D35E65D966E,11914,11,12,1,37,48,1898
88115,88115,03CC5102FB306C3254027D35E65D966E,42581,15,16,1,38,48,1948
88116,88116,03CC5102FB306C3254027D35E65D966E,11914,21,22,1,37,48,1898
88117,88117,0BA677AEFA1FE879EC9FCA98466C3A1A,11641,0,11,11,22,49,1149
88118,88118,0BA677AEFA1FE879EC9FCA98466C3A1A,12051,11,14,3,20,47,1047
88119,88119,0BA677AEFA1FE879EC9FCA98466C3A1A,11361,17,18,1,22,48,1148
88120,88120,0BA677AEFA1FE879EC9FCA98466C3A1A,11641,19,23,4,22,49,1149
88136,88136,1CD741282378ACECE229BFA3E57C9431,19441,0,13,13,8,46,446
88137,88137,1CD741282378ACECE229BFA3E57C9431,42041,17,18,1,10,47,547
88138,88138,1CD741282378ACECE229BFA3E57C9431,19441,19,23,4,8,46,446
88139,88139,F40AC1EDE9EB783E2CA294E73A950959,13911,0,6,6,39,46,1996
88140,88140,F40AC1EDE9EB783E2CA294E73A950959,42231,8,9,1,37,46,1896
88141,88141,F40AC1EDE9EB783E2CA294E73A950959,13911,10,13,3,39,46,1996
88142,88142,F40AC1EDE9EB783E2CA294E73A950959,42231,13,22,9,37,46,1896
88176,88176,BC53AC2AD605C4C7ADADBBDB96B20E92,12381,0,2,2,32,48,1648
88177,88177,BC53AC2AD605C4C7ADADBBDB96B20E92,10154,3,18,15,33,47,1697
88178,88178,BC53AC2AD605C4C7ADADBBDB96B20E92,13651,18,19,1,30,47,1547
88187,88187,AA94328A21E669C14B53998CC009A981,43951,0,12,12,49,41,2491
88188,88188,AA94328A21E669C14B53998CC009A981,13411,17,18,1,49,42,2492
88189,88189,AA94328A21E669C14B53998CC009A981,43951,19,21,2,49,41,2491
88200,88200,1DD1A250791E8DE9D0B949B1DAE230C8,11861,0,13,13,32,47,1647
88201,88201,1DD1A250791E8DE9D0B949B1DAE230C8,13601,14,17,3,34,47,1747
88202,88202,1DD1A250791E8DE9D0B949B1DAE230C8,11861,18,23,5,32,47,1647
88206,88206,4BBAD16A135802D4BB9D5E2CD81E4FF9,11481,9,10,1,41,48,2098
88207,88207,4BBAD16A135802D4BB9D5E2CD81E4FF9,13101,11,12,1,40,47,2047
88208,88208,4BBAD16A135802D4BB9D5E2CD81E4FF9,40833,14,15,1,41,47,2097
88209,88209,4BBAD16A135802D4BB9D5E2CD81E4FF9,13101,17,19,2,40,47,2047
88219,88219,48C6CED6D5D771D9E927DED543777518,42301,9,13,4,36,47,1847
88220,88220,48C6CED6D5D771D9E927DED543777518,11074,14,17,3,37,47,1897
88221,88221,48C6CED6D5D771D9E927DED543777518,42301,19,22,3,36,47,1847
88225,88225,C60F12F63C2D7D6CCCE36F55A7BBAF31,11061,0,8,8,29,48,1498
88226,88226,C60F12F63C2D7D6CCCE36F55A7BBAF31,11151,12,15,3,30,48,1548
88227,88227,C60F12F63C2D7D6CCCE36F55A7BBAF31,10951,17,23,6,29,48,1498
88232,88232,F3B16B9F2FE5D66DD896BE8E61C1FA80,10351,0,5,5,28,45,1445
88233,88233,F3B16B9F2FE5D66DD896BE8E61C1FA80,10301,8,14,6,31,45,1595
88234,88234,F3B16B9F2FE5D66DD896BE8E61C1FA80,10351,14,19,5,28,45,1445
88235,88235,F3B16B9F2FE5D66DD896BE8E61C1FA80,10301,19,23,4,31,45,1595
88239,88239,83BCB3D6D92EB667850E0A1E99304C91,10381,0,15,15,31,49,1599
88240,88240,83BCB3D6D92EB667850E0A1E99304C91,11151,15,16,1,30,48,1548
88241,88241,83BCB3D6D92EB667850E0A1E99304C91,11061,19,21,2,29,48,1498
88246,88246,EE90AC07F32E2A1C202B40D69F71501C,12491,0,14,14,36,43,1843
88247,88247,EE90AC07F32E2A1C202B40D69F71501C,42151,14,15,1,35,45,1795
88248,88248,EE90AC07F32E2A1C202B40D69F71501C,12491,18,23,5,36,43,1843
88267,88267,12ADB141CA14BE5E4E819B1A4FBA459C,11941,0,3,3,37,46,1896
88268,88268,12ADB141CA14BE5E4E819B1A4FBA459C,13711,5,6,1,38,46,1946
88269,88269,12ADB141CA14BE5E4E819B1A4FBA459C,11941,7,23,16,37,46,1896
88270,88270,E9B15F0012DDBC29F3BEEC3DADD82A3B,13371,0,13,13,41,47,2097
88271,88271,E9B15F0012DDBC29F3BEEC3DADD82A3B,10111,14,17,3,37,47,1897
88272,88272,E9B15F0012DDBC29F3BEEC3DADD82A3B,10771,22,23,1,41,46,2096
88273,88273,ED7D6E0D6245554973BF1FC4EA5C6C28,11151,0,11,11,30,48,1548
88274,88274,ED7D6E0D6245554973BF1FC4EA5C6C28,11061,12,18,6,29,48,1498
88275,88275,ED7D6E0D6245554973BF1FC4EA5C6C28,11151,21,23,2,30,48,1548
88279,88279,A87355FC482A6477E21AFAEC97025171,10811,0,5,5,38,46,1946
88280,88280,A87355FC482A6477E21AFAEC97025171,13101,6,19,13,40,47,2047
88281,88281,A87355FC482A6477E21AFAEC97025171,13231,20,21,1,39,46,1996
88282,88282,A87355FC482A6477E21AFAEC97025171,13711,22,23,1,38,46,1946
88286,88286,84D5DD5743261CBA6220A6F1E627F47F,11061,0,18,18,29,48,1498
88287,88287,84D5DD5743261CBA6220A6F1E627F47F,12971,19,21,2,32,48,1648
88288,88288,84D5DD5743261CBA6220A6F1E627F47F,40094,22,23,1,29,48,1498
88293,88293,4EE5C60035D807126AEE0DC0CD563832,42581,1,7,6,38,48,1948
88294,88294,4EE5C60035D807126AEE0DC0CD563832,11074,9,11,2,37,47,1897
88295,88295,4EE5C60035D807126AEE0DC0CD563832,42581,12,14,2,38,48,1948
88296,88296,4EE5C60035D807126AEE0DC0CD563832,11914,19,21,2,37,48,1898
88302,88302,24576DC2C63BF30A46BA06C33A71F868,12491,1,6,5,36,43,1843
88303,88303,24576DC2C63BF30A46BA06C33A71F868,11261,6,8,2,36,46,1846
88304,88304,24576DC2C63BF30A46BA06C33A71F868,12491,12,13,1,36,43,1843
88305,88305,24576DC2C63BF30A46BA06C33A71F868,11261,15,21,6,36,46,1846
88306,88306,0450CE4A9EA5097186EEF727418CD364,42231,0,7,7,37,46,1896
88307,88307,0450CE4A9EA5097186EEF727418CD364,42151,11,16,5,35,45,1795
88308,88308,0450CE4A9EA5097186EEF727418CD364,13711,20,23,3,38,46,1946
88312,88312,FFD84391FCD810EDFCF9E1B100BB0A91,11201,3,10,7,35,49,1799
88313,88313,FFD84391FCD810EDFCF9E1B100BB0A91,40951,11,14,3,36,49,1849
88314,88314,FFD84391FCD810EDFCF9E1B100BB0A91,10221,14,16,2,34,49,1749
88315,88315,FFD84391FCD810EDFCF9E1B100BB0A91,40951,18,22,4,36,49,1849
88316,88316,2B978F14522F2408660E90AEA6143CDF,42071,0,10,10,31,49,1599
88317,88317,2B978F14522F2408660E90AEA6143CDF,42141,14,15,1,32,47,1647
88318,88318,2B978F14522F2408660E90AEA6143CDF,42071,17,18,1,31,49,1599
88319,88319,2B978F14522F2408660E90AEA6143CDF,11151,18,19,1,30,48,1548
88345,88345,F12CF92D47DBBC28BDFFECBC31496C05,11151,0,1,1,30,48,1548
88346,88346,F12CF92D47DBBC28BDFFECBC31496C05,11061,2,13,11,29,48,1498
88347,88347,F12CF92D47DBBC28BDFFECBC31496C05,10681,16,20,4,30,48,1548
88348,88348,F12CF92D47DBBC28BDFFECBC31496C05,11061,20,23,3,29,48,1498
88368,88368,9ED06C73B88BB4839B692590DA94AEEC,13111,0,6,6,42,46,2146
88369,88369,9ED06C73B88BB4839B692590DA94AEEC,42091,6,14,8,43,46,2196
88370,88370,9ED06C73B88BB4839B692590DA94AEEC,13111,15,19,4,42,46,2146
88371,88371,9ED06C73B88BB4839B692590DA94AEEC,42091,20,21,1,43,46,2196
88378,88378,B8A307DC401D07931A2F403AC35943A6,42351,0,10,10,38,45,1945
88379,88379,B8A307DC401D07931A2F403AC35943A6,13911,12,14,2,39,46,1996
88380,88380,B8A307DC401D07931A2F403AC35943A6,42351,18,19,1,38,45,1945
88381,88381,B8A307DC401D07931A2F403AC35943A6,13911,19,23,4,39,46,1996
88382,88382,424595F1C8846A1CBAEDBFB8FB93F25B,11061,0,4,4,29,48,1498
88383,88383,424595F1C8846A1CBAEDBFB8FB93F25B,13651,6,9,3,30,47,1547
88384,88384,424595F1C8846A1CBAEDBFB8FB93F25B,12121,9,14,5,29,47,1497
88385,88385,424595F1C8846A1CBAEDBFB8FB93F25B,11061,15,22,7,29,48,1498
88386,88386,8123312A9D40FCE9F32767A0B3A11F65,11901,0,1,1,42,49,2149
88387,88387,8123312A9D40FCE9F32767A0B3A11F65,11301,1,9,8,41,49,2099
88388,88388,8123312A9D40FCE9F32767A0B3A11F65,11901,12,19,7,42,49,2149
88389,88389,8123312A9D40FCE9F32767A0B3A11F65,11301,20,23,3,41,49,2099
88393,88393,980A8E313B61C1D9E89EB2322A3E97EF,43731,1,3,2,34,47,1747
88394,88394,980A8E313B61C1D9E89EB2322A3E97EF,10251,4,12,8,35,47,1797
88395,88395,980A8E313B61C1D9E89EB2322A3E97EF,43731,12,13,1,34,47,1747
88396,88396,980A8E313B61C1D9E89EB2322A3E97EF,10251,13,23,10,35,47,1797
88397,88397,7593D7AED856FF2FC2E20D8E8570438A,10471,4,14,10,37,48,1898
88398,88398,7593D7AED856FF2FC2E20D8E8570438A,42581,16,17,1,38,48,1948
88399,88399,7593D7AED856FF2FC2E20D8E8570438A,10471,17,18,1,37,48,1898
88400,88400,FB8D61C5B787C9BFA24064ED9A74F466,13101,0,8,8,40,47,2047
88401,88401,FB8D61C5B787C9BFA24064ED9A74F466,13271,8,14,6,41,47,2097
88402,88402,FB8D61C5B787C9BFA24064ED9A74F466,13101,14,17,3,40,47,2047
88403,88403,FB8D61C5B787C9BFA24064ED9A74F466,13271,19,23,4,41,47,2097
88409,88409,983842B60AEE8AF2D9A0F2BA47994634,11381,0,7,7,30,47,1547
88410,88410,983842B60AEE8AF2D9A0F2BA47994634,12121,8,13,5,29,47,1497
88411,88411,983842B60AEE8AF2D9A0F2BA47994634,11381,13,23,10,30,47,1547
88412,88412,E429D5687CEEDF3C035534BDDBC8B9F3,13271,0,6,6,41,47,2097
88413,88413,E429D5687CEEDF3C035534BDDBC8B9F3,11481,6,19,13,41,48,2098
88414,88414,E429D5687CEEDF3C035534BDDBC8B9F3,13271,21,22,1,41,47,2097
88436,88436,2E12B4DAB0BABD9D3D10C50E79DF9B0F,11321,0,13,13,31,46,1596
88437,88437,2E12B4DAB0BABD9D3D10C50E79DF9B0F,10301,15,16,1,31,45,1595
88438,88438,2E12B4DAB0BABD9D3D10C50E79DF9B0F,11321,18,23,5,31,46,1596
88439,88439,A6B86C51D1E851C8306B13F3333CE4AD,11491,0,10,10,36,47,1847
88440,88440,A6B86C51D1E851C8306B13F3333CE4AD,11074,10,11,1,37,47,1897
88441,88441,A6B86C51D1E851C8306B13F3333CE4AD,11491,13,19,6,36,47,1847
88445,88445,0186D96F0CF794D7320BB2351142C16A,12521,0,13,13,35,41,1791
88446,88446,0186D96F0CF794D7320BB2351142C16A,42151,14,17,3,35,45,1795
88447,88447,0186D96F0CF794D7320BB2351142C16A,12521,18,23,5,35,41,1791
88448,88448,132BAF41704DD845C2F70543C3732C4E,13711,0,10,10,38,46,1946
88449,88449,132BAF41704DD845C2F70543C3732C4E,42231,11,16,5,37,46,1896
88450,88450,132BAF41704DD845C2F70543C3732C4E,13711,16,21,5,38,46,1946
88458,88458,D48C648C1D8E99D79DDC90BDE949351A,11261,0,12,12,36,46,1846
88459,88459,D48C648C1D8E99D79DDC90BDE949351A,13911,15,16,1,39,46,1996
88460,88460,D48C648C1D8E99D79DDC90BDE949351A,11261,17,23,6,36,46,1846
88461,88461,C09E96F7C45F01994015E2FB1036A8EF,40833,2,12,10,41,47,2097
88462,88462,C09E96F7C45F01994015E2FB1036A8EF,40691,15,18,3,42,48,2148
88463,88463,C09E96F7C45F01994015E2FB1036A8EF,40697,19,21,2,43,48,2198
88467,88467,EAAB672210C677BA2879CCE67BDB7DF5,11151,0,13,13,30,48,1548
88468,88468,EAAB672210C677BA2879CCE67BDB7DF5,10381,14,18,4,31,49,1599
88469,88469,EAAB672210C677BA2879CCE67BDB7DF5,11151,20,23,3,30,48,1548
88474,88474,F49ED0A4CC36A173117E91CDA96EDE5B,11914,0,7,7,37,48,1898
88475,88475,F49ED0A4CC36A173117E91CDA96EDE5B,42581,9,10,1,38,48,1948
88476,88476,F49ED0A4CC36A173117E91CDA96EDE5B,11914,11,23,12,37,48,1898
88501,88501,7AEC9C7CCBAB2805F6D8B21C69CF29C4,10681,0,6,6,30,48,1548
88502,88502,7AEC9C7CCBAB2805F6D8B21C69CF29C4,10381,6,15,9,31,49,1599
88503,88503,7AEC9C7CCBAB2805F6D8B21C69CF29C4,10681,19,23,4,30,48,1548
88504,88504,528421A4A4CF40E840301284E0AFB525,42161,0,7,7,36,47,1847
88505,88505,528421A4A4CF40E840301284E0AFB525,10841,12,14,2,37,47,1897
88506,88506,528421A4A4CF40E840301284E0AFB525,42161,17,21,4,36,47,1847
88520,88520,1A250079CB7773B5EF41A4819B5FE42C,40051,0,15,15,32,49,1649
88521,88521,1A250079CB7773B5EF41A4819B5FE42C,11151,19,20,1,30,48,1548
88522,88522,1A250079CB7773B5EF41A4819B5FE42C,40051,21,23,2,32,49,1649
88523,88523,9E74C4204DF0368A301BB287E42AE5CC,13371,0,9,9,41,47,2097
88524,88524,9E74C4204DF0368A301BB287E42AE5CC,10231,12,14,2,39,49,1999
88525,88525,9E74C4204DF0368A301BB287E42AE5CC,10821,18,20,2,40,47,2047
88526,88526,9E74C4204DF0368A301BB287E42AE5CC,42031,20,23,3,40,46,2046
88551,88551,1AAA21044A088724F55D52327AA438E4,11861,10,14,4,32,47,1647
88552,88552,1AAA21044A088724F55D52327AA438E4,10785,15,16,1,35,47,1797
88553,88553,1AAA21044A088724F55D52327AA438E4,11861,17,19,2,32,47,1647
88554,88554,25F4CEC81BA444B06FD2F2182E64503F,12781,0,12,12,46,24,2324
88555,88555,25F4CEC81BA444B06FD2F2182E64503F,15311,12,14,2,43,25,2175
88556,88556,25F4CEC81BA444B06FD2F2182E64503F,12781,16,18,2,46,24,2324
88557,88557,25F4CEC81BA444B06FD2F2182E64503F,15311,19,21,2,43,25,2175
88563,88563,04C024AD6716C59AEF71765CE69E1D56,10781,0,13,13,35,47,1797
88564,88564,04C024AD6716C59AEF71765CE69E1D56,43731,14,16,2,34,47,1747
88565,88565,04C024AD6716C59AEF71765CE69E1D56,10781,18,23,5,35,47,1797
88571,88571,E99176074424BF1CA2C083C0DBF3C62C,12514,0,4,4,38,47,1947
88572,88572,E99176074424BF1CA2C083C0DBF3C62C,42221,7,8,1,38,48,1948
88573,88573,E99176074424BF1CA2C083C0DBF3C62C,12514,18,19,1,38,47,1947
88574,88574,E99176074424BF1CA2C083C0DBF3C62C,42511,21,22,1,37,47,1897
88579,88579,A11021665283D6C62A5E3EE561A2FB8C,42351,1,3,2,38,45,1945
88580,88580,A11021665283D6C62A5E3EE561A2FB8C,11261,3,4,1,36,46,1846
88581,88581,A11021665283D6C62A5E3EE561A2FB8C,42351,7,12,5,38,45,1945
88582,88582,A11021665283D6C62A5E3EE561A2FB8C,13911,14,20,6,39,46,1996
88597,88597,86C78F4FBCCFAB1B64902DADB23A714E,10111,1,19,18,37,47,1897
88598,88598,86C78F4FBCCFAB1B64902DADB23A714E,11231,20,21,1,37,49,1899
88599,88599,86C78F4FBCCFAB1B64902DADB23A714E,40951,21,22,1,36,49,1849
88614,88614,9BAE48FA2AAB8072FAE7756482A9D25C,11074,1,14,13,37,47,1897
88615,88615,9BAE48FA2AAB8072FAE7756482A9D25C,12514,15,16,1,38,47,1947
88616,88616,9BAE48FA2AAB8072FAE7756482A9D25C,11074,19,23,4,37,47,1897
88621,88621,C0A424EE6BA5512990F2A0EDAE308C20,42231,0,5,5,37,46,1896
88622,88622,C0A424EE6BA5512990F2A0EDAE308C20,11021,8,15,7,36,49,1849
88623,88623,C0A424EE6BA5512990F2A0EDAE308C20,11231,16,17,1,37,49,1899
88624,88624,C0A424EE6BA5512990F2A0EDAE308C20,42231,18,23,5,37,46,1896
88628,88628,E528C1BCF7730647027A4A7EFB058975,42631,0,5,5,43,45,2195
88629,88629,E528C1BCF7730647027A4A7EFB058975,13341,7,16,9,44,45,2245
88630,88630,E528C1BCF7730647027A4A7EFB058975,42631,20,21,1,43,45,2195
88631,88631,46B3DE812748722328FAB277775E5F5A,13331,0,4,4,38,47,1947
88632,88632,46B3DE812748722328FAB277775E5F5A,42221,6,13,7,38,48,1948
88633,88633,46B3DE812748722328FAB277775E5F5A,12514,14,20,6,38,47,1947
88634,88634,46B3DE812748722328FAB277775E5F5A,42221,22,23,1,38,48,1948
88635,88635,61CC7CB5EA609C6320BD2A3529DD90CF,11911,0,6,6,37,48,1898
88636,88636,61CC7CB5EA609C6320BD2A3529DD90CF,13121,6,16,10,38,46,1946
88637,88637,61CC7CB5EA609C6320BD2A3529DD90CF,10271,16,17,1,37,46,1896
88638,88638,61CC7CB5EA609C6320BD2A3529DD90CF,11911,18,23,5,37,48,1898
88652,88652,BFC66AC44DE3D0C3983BFF60677905F1,42511,0,1,1,37,47,1897
88653,88653,BFC66AC44DE3D0C3983BFF60677905F1,13121,3,14,11,38,46,1946
88654,88654,BFC66AC44DE3D0C3983BFF60677905F1,11074,14,16,2,37,47,1897
88655,88655,BFC66AC44DE3D0C3983BFF60677905F1,13121,20,22,2,38,46,1946
88673,88673,9A46CF7192115A07E973A201EDCECB42,11261,2,12,10,36,46,1846
88674,88674,9A46CF7192115A07E973A201EDCECB42,42861,14,17,3,37,44,1894
88675,88675,9A46CF7192115A07E973A201EDCECB42,42864,20,21,1,38,44,1944
88694,88694,8BAC4C4845738058C4E3B7FCF6FAE6B7,42523,0,1,1,31,47,1597
88695,88695,8BAC4C4845738058C4E3B7FCF6FAE6B7,10292,3,21,18,30,47,1547
88696,88696,8BAC4C4845738058C4E3B7FCF6FAE6B7,42523,21,23,2,31,47,1597
88700,88700,EAEFCB977DEDF23C1346736B36A6F67B,13911,2,5,3,39,46,1996
88701,88701,EAEFCB977DEDF23C1346736B36A6F67B,42231,6,16,10,37,46,1896
88702,88702,EAEFCB977DEDF23C1346736B36A6F67B,11261,17,18,1,36,46,1846
88709,88709,4D65EBFD2B3953E941636181E1165840,11001,0,9,9,42,47,2147
88710,88710,4D65EBFD2B3953E941636181E1165840,10521,9,10,1,41,47,2097
88711,88711,4D65EBFD2B3953E941636181E1165840,11001,14,16,2,42,47,2147
88712,88712,4D65EBFD2B3953E941636181E1165840,13941,17,19,2,41,47,2097
88718,88718,0A501EA010779C8F9EB8C2F8834C3F4F,10634,0,6,6,27,45,1395
88719,88719,0A501EA010779C8F9EB8C2F8834C3F4F,10301,9,15,6,31,45,1595
88720,88720,0A501EA010779C8F9EB8C2F8834C3F4F,10351,18,23,5,28,45,1445
88727,88727,7A673E045AAB5F8AA5D69D1BBFEAFEBE,13731,8,9,1,33,49,1699
88728,88728,7A673E045AAB5F8AA5D69D1BBFEAFEBE,42071,13,15,2,31,49,1599
88729,88729,7A673E045AAB5F8AA5D69D1BBFEAFEBE,13731,18,19,1,33,49,1699
88730,88730,FD6F3D9CFB531FE01A1AEA9CDBE73454,42351,6,11,5,38,45,1945
88731,88731,FD6F3D9CFB531FE01A1AEA9CDBE73454,42231,14,15,1,37,46,1896
88732,88732,FD6F3D9CFB531FE01A1AEA9CDBE73454,42351,15,18,3,38,45,1945
88733,88733,FD6F3D9CFB531FE01A1AEA9CDBE73454,42231,20,21,1,37,46,1896
88747,88747,292C54710FB21A50B273EFB2F0804791,42623,0,1,1,22,49,1149
88748,88748,292C54710FB21A50B273EFB2F0804791,42081,2,6,4,24,49,1249
88749,88749,292C54710FB21A50B273EFB2F0804791,42623,11,12,1,22,49,1149
88750,88750,292C54710FB21A50B273EFB2F0804791,42081,15,21,6,24,49,1249
88751,88751,737EEA850139715BDA79A2EDECCDCA7A,42861,0,7,7,37,44,1894
88752,88752,737EEA850139715BDA79A2EDECCDCA7A,42864,8,15,7,38,44,1944
88753,88753,737EEA850139715BDA79A2EDECCDCA7A,11261,16,17,1,36,46,1846
88754,88754,737EEA850139715BDA79A2EDECCDCA7A,42864,18,19,1,38,44,1944
88763,88763,966EF37DD81DE2F009202B5BDDCFCE29,13911,0,6,6,39,46,1996
88764,88764,966EF37DD81DE2F009202B5BDDCFCE29,42231,8,10,2,37,46,1896
88765,88765,966EF37DD81DE2F009202B5BDDCFCE29,42351,14,15,1,38,45,1945
88766,88766,966EF37DD81DE2F009202B5BDDCFCE29,42231,19,21,2,37,46,1896
88774,88774,4BD2D720B1C94D9CBECB412FDF6799B4,11261,0,6,6,36,46,1846
88775,88775,4BD2D720B1C94D9CBECB412FDF6799B4,42151,7,18,11,35,45,1795
88776,88776,4BD2D720B1C94D9CBECB412FDF6799B4,11261,19,23,4,36,46,1846
88792,88792,BAE9E6598B6B150C35C40B2B48021E32,10111,0,11,11,37,47,1897
88793,88793,BAE9E6598B6B150C35C40B2B48021E32,11461,13,14,1,37,49,1899
88794,88794,BAE9E6598B6B150C35C40B2B48021E32,10111,14,23,9,37,47,1897
88795,88795,2089CCBC2F855C8416A68A67F03D7345,10401,1,8,7,33,49,1699
88796,88796,2089CCBC2F855C8416A68A67F03D7345,11561,13,15,2,32,49,1649
88797,88797,2089CCBC2F855C8416A68A67F03D7345,11231,17,18,1,37,49,1899
88798,88798,E603C5CE99E3FE3BB5D201DC1F4B77FD,13111,0,17,17,42,46,2146
88799,88799,E603C5CE99E3FE3BB5D201DC1F4B77FD,13791,17,21,4,42,47,2147
88800,88800,E603C5CE99E3FE3BB5D201DC1F4B77FD,42204,21,23,2,43,46,2196
88805,88805,9B129FCBEA8529490CE89EDC7C55231E,42161,0,10,10,36,47,1847
88806,88806,9B129FCBEA8529490CE89EDC7C55231E,10251,10,13,3,35,47,1797
88807,88807,9B129FCBEA8529490CE89EDC7C55231E,42161,18,22,4,36,47,1847
88818,88818,14C205DF57BD0AA586E26BE4ED695846,42581,0,14,14,38,48,1948
88819,88819,14C205DF57BD0AA586E26BE4ED695846,11914,16,18,2,37,48,1898
88820,88820,14C205DF57BD0AA586E26BE4ED695846,12511,19,20,1,39,47,1997
88821,88821,2C92D9A1E7726DE0B07E3A3E97221DE4,11491,0,14,14,36,47,1847
88822,88822,2C92D9A1E7726DE0B07E3A3E97221DE4,10787,15,16,1,38,46,1946
88823,88823,2C92D9A1E7726DE0B07E3A3E97221DE4,11491,17,18,1,36,47,1847
88824,88824,2C92D9A1E7726DE0B07E3A3E97221DE4,13381,20,23,3,39,47,1997
88825,88825,CFEAB1C9674CBEABBC88FF4B300B52A9,11261,0,1,1,36,46,1846
88826,88826,CFEAB1C9674CBEABBC88FF4B300B52A9,42351,1,10,9,38,45,1945
88827,88827,CFEAB1C9674CBEABBC88FF4B300B52A9,11261,15,21,6,36,46,1846
88828,88828,15BA009B68D87958E0A9656ADB01E7D6,10511,0,7,7,35,46,1796
88829,88829,15BA009B68D87958E0A9656ADB01E7D6,10971,12,14,2,35,47,1797
88830,88830,15BA009B68D87958E0A9656ADB01E7D6,10511,17,23,6,35,46,1796
88836,88836,DAFE070AC8164EB683B9455E05DD84E1,11481,7,12,5,41,48,2098
88837,88837,DAFE070AC8164EB683B9455E05DD84E1,13271,15,16,1,41,47,2097
88838,88838,DAFE070AC8164EB683B9455E05DD84E1,11481,18,21,3,41,48,2098
88839,88839,DAFE070AC8164EB683B9455E05DD84E1,13101,22,23,1,40,47,2047
88848,88848,6E1487869B5E12737EA94495C079C41B,42231,0,7,7,37,46,1896
88849,88849,6E1487869B5E12737EA94495C079C41B,13911,8,11,3,39,46,1996
88850,88850,6E1487869B5E12737EA94495C079C41B,42231,12,23,11,37,46,1896
88851,88851,CEC2557E73B99D59943BE56AF1337C99,10271,0,4,4,37,46,1896
88852,88852,CEC2557E73B99D59943BE56AF1337C99,13121,7,9,2,38,46,1946
88853,88853,CEC2557E73B99D59943BE56AF1337C99,10271,10,18,8,37,46,1896
88854,88854,CEC2557E73B99D59943BE56AF1337C99,13121,18,20,2,38,46,1946
88860,88860,58160F8286644CCBCCC72FA14DAD9C05,19114,0,8,8,7,43,393
88861,88861,58160F8286644CCBCCC72FA14DAD9C05,12641,11,13,2,10,43,543
88862,88862,58160F8286644CCBCCC72FA14DAD9C05,19114,14,23,9,7,43,393
88868,88868,ACFB892F60074737B9E0F9A496FA6823,42861,6,9,3,37,44,1894
88869,88869,ACFB892F60074737B9E0F9A496FA6823,12211,10,12,2,41,44,2094
88870,88870,ACFB892F60074737B9E0F9A496FA6823,42151,14,16,2,35,45,1795
88871,88871,ACFB892F60074737B9E0F9A496FA6823,12211,20,21,1,41,44,2094
88891,88891,EA7259828C59286A0C8476F89AAE54B8,11261,0,14,14,36,46,1846
88892,88892,EA7259828C59286A0C8476F89AAE54B8,42351,14,15,1,38,45,1945
88893,88893,EA7259828C59286A0C8476F89AAE54B8,11261,16,22,6,36,46,1846
88894,88894,946768BFA72752D5660750415178C67F,43731,0,7,7,34,47,1747
88895,88895,946768BFA72752D5660750415178C67F,10511,9,16,7,35,46,1796
88896,88896,946768BFA72752D5660750415178C67F,13601,17,20,3,34,47,1747
88897,88897,946768BFA72752D5660750415178C67F,42161,22,23,1,36,47,1847
88898,88898,1DC3A3A4FE9D63C37AD1D2C313E3354F,42191,0,8,8,38,49,1949
88899,88899,1DC3A3A4FE9D63C37AD1D2C313E3354F,10471,9,17,8,37,48,1898
88900,88900,1DC3A3A4FE9D63C37AD1D2C313E3354F,11461,17,19,2,37,49,1899
88913,88913,098D732E3EBF6403141AA2A02CAC7F6D,43281,0,9,9,37,48,1898
88914,88914,098D732E3EBF6403141AA2A02CAC7F6D,10251,11,17,6,35,47,1797
88915,88915,098D732E3EBF6403141AA2A02CAC7F6D,11231,19,22,3,37,49,1899
88944,88944,60C4906B9FADDE31AE603A5E02129DFF,10471,0,8,8,37,48,1898
88945,88945,60C4906B9FADDE31AE603A5E02129DFF,40171,12,18,6,38,48,1948
88946,88946,60C4906B9FADDE31AE603A5E02129DFF,10471,19,21,2,37,48,1898
88947,88947,60C4906B9FADDE31AE603A5E02129DFF,40171,21,23,2,38,48,1948
88952,88952,6FFB38A7847E74CB0B9DE7B0D6B73E25,12121,2,10,8,29,47,1497
88953,88953,6FFB38A7847E74CB0B9DE7B0D6B73E25,42291,13,14,1,29,48,1498
88954,88954,6FFB38A7847E74CB0B9DE7B0D6B73E25,11381,15,23,8,30,47,1547
88970,88970,9F2BAB521AAFFBE7CC97AED22DC2FAF1,11261,0,4,4,36,46,1846
88971,88971,9F2BAB521AAFFBE7CC97AED22DC2FAF1,42861,8,9,1,37,44,1894
88972,88972,9F2BAB521AAFFBE7CC97AED22DC2FAF1,11261,13,23,10,36,46,1846
88992,88992,29E682BF994B2ACA314777BEAEB90BB7,42231,7,12,5,37,46,1896
88993,88993,29E682BF994B2ACA314777BEAEB90BB7,42351,13,15,2,38,45,1945
88994,88994,29E682BF994B2ACA314777BEAEB90BB7,10901,19,22,3,35,48,1798
88995,88995,3B9989389C2FB72384F3330F9A990AB0,42351,0,6,6,38,45,1945
88996,88996,3B9989389C2FB72384F3330F9A990AB0,42231,9,10,1,37,46,1896
88997,88997,3B9989389C2FB72384F3330F9A990AB0,42351,13,14,1,38,45,1945
88998,88998,3B9989389C2FB72384F3330F9A990AB0,13911,19,21,2,39,46,1996
89004,89004,F1089F554EDD989C3763AB8DD5D7CDEF,19114,1,4,3,7,43,393
89005,89005,F1089F554EDD989C3763AB8DD5D7CDEF,12641,6,9,3,10,43,543
89006,89006,F1089F554EDD989C3763AB8DD5D7CDEF,19114,11,13,2,7,43,393
89007,89007,F1089F554EDD989C3763AB8DD5D7CDEF,12641,13,18,5,10,43,543
89011,89011,5B1C0BC031C302008BE737E10A20E45F,11481,0,7,7,41,48,2098
89012,89012,5B1C0BC031C302008BE737E10A20E45F,40361,9,18,9,42,48,2148
89013,89013,5B1C0BC031C302008BE737E10A20E45F,10421,20,22,2,41,48,2098
89014,89014,A910A64B88EF93AE4B4F67D39EA167CE,40171,0,6,6,38,48,1948
89015,89015,A910A64B88EF93AE4B4F67D39EA167CE,11806,9,10,1,41,48,2098
89016,89016,A910A64B88EF93AE4B4F67D39EA167CE,11914,13,15,2,37,48,1898
89017,89017,A910A64B88EF93AE4B4F67D39EA167CE,40171,18,23,5,38,48,1948
89023,89023,81B4C14967EA43BF189CB1A15BDEF674,42021,0,2,2,33,47,1697
89024,89024,81B4C14967EA43BF189CB1A15BDEF674,43161,2,8,6,35,47,1797
89025,89025,81B4C14967EA43BF189CB1A15BDEF674,42921,9,19,10,33,47,1697
89052,89052,EE842BE055BF90EB6BC190087576F62D,10451,0,6,6,25,48,1298
89053,89053,EE842BE055BF90EB6BC190087576F62D,11641,7,8,1,22,49,1149
89054,89054,EE842BE055BF90EB6BC190087576F62D,43391,11,13,2,29,48,1498
89055,89055,EE842BE055BF90EB6BC190087576F62D,12584,16,23,7,24,48,1248
89056,89056,8901C834A10BBD863479FEA29CB07080,13911,0,13,13,39,46,1996
89057,89057,8901C834A10BBD863479FEA29CB07080,42231,15,17,2,37,46,1896
89058,89058,8901C834A10BBD863479FEA29CB07080,13911,21,23,2,39,46,1996
89078,89078,ED6E335A01A9415740706B079F2407EA,10471,0,10,10,37,48,1898
89079,89079,ED6E335A01A9415740706B079F2407EA,11231,14,21,7,37,49,1899
89080,89080,ED6E335A01A9415740706B079F2407EA,10471,21,23,2,37,48,1898
89081,89081,71C7D3BEB879651EE771977BC4EF34E5,10341,0,6,6,31,47,1597
89082,89082,71C7D3BEB879651EE771977BC4EF34E5,12311,7,9,2,30,44,1544
89083,89083,71C7D3BEB879651EE771977BC4EF34E5,10631,10,17,7,28,46,1446
89084,89084,71C7D3BEB879651EE771977BC4EF34E5,10341,20,23,3,31,47,1597
89092,89092,A3BFED7EBC8273A150663075EB9361B2,40181,0,5,5,37,49,1899
89093,89093,A3BFED7EBC8273A150663075EB9361B2,12391,7,15,8,36,49,1849
89094,89094,A3BFED7EBC8273A150663075EB9361B2,11271,16,21,5,37,48,1898
89106,89106,ED765AC07D21387339B2A29ECDD013E0,10251,0,7,7,35,47,1797
89107,89107,ED765AC07D21387339B2A29ECDD013E0,11531,8,19,11,34,49,1749
89108,89108,ED765AC07D21387339B2A29ECDD013E0,10251,19,23,4,35,47,1797
89114,89114,F8F503C17105B4EBC0DD055A09C40A28,11231,0,15,15,37,49,1899
89115,89115,F8F503C17105B4EBC0DD055A09C40A28,11531,16,18,2,34,49,1749
89116,89116,F8F503C17105B4EBC0DD055A09C40A28,11231,18,21,3,37,49,1899
89117,89117,6EF69708DD923556D4EF232AA0406F1C,11941,0,12,12,37,46,1896
89118,89118,6EF69708DD923556D4EF232AA0406F1C,13911,16,19,3,39,46,1996
89119,89119,6EF69708DD923556D4EF232AA0406F1C,11941,20,21,1,37,46,1896
89120,89120,A0E829F4319BFCF37BA7414AFCB09FF1,11074,1,2,1,37,47,1897
89121,89121,A0E829F4319BFCF37BA7414AFCB09FF1,12514,3,5,2,38,47,1947
89122,89122,A0E829F4319BFCF37BA7414AFCB09FF1,11074,8,18,10,37,47,1897
89123,89123,A0E829F4319BFCF37BA7414AFCB09FF1,42221,21,22,1,38,48,1948
89128,89128,700A8469B8648E235281334EF5CC8DA1,11231,0,14,14,37,49,1899
89129,89129,700A8469B8648E235281334EF5CC8DA1,10471,15,19,4,37,48,1898
89130,89130,700A8469B8648E235281334EF5CC8DA1,10371,20,23,3,37,49,1899
89131,89131,2F3FBE39EE4E3AB748593134D6A2A772,42231,0,7,7,37,46,1896
89132,89132,2F3FBE39EE4E3AB748593134D6A2A772,42351,9,11,2,38,45,1945
89133,89133,2F3FBE39EE4E3AB748593134D6A2A772,42231,14,20,6,37,46,1896
89142,89142,981A108DF07EE24FA84EC23588DA45B3,12491,1,6,5,36,43,1843
89143,89143,981A108DF07EE24FA84EC23588DA45B3,11941,8,18,10,37,46,1896
89144,89144,981A108DF07EE24FA84EC23588DA45B3,11261,19,21,2,36,46,1846
89161,89161,6ADF15EBB67B7EDCDC07ECDA92E9AF04,13111,0,13,13,42,46,2146
89162,89162,6ADF15EBB67B7EDCDC07ECDA92E9AF04,42631,13,17,4,43,45,2195
89163,89163,6ADF15EBB67B7EDCDC07ECDA92E9AF04,42204,20,22,2,43,46,2196
89164,89164,6ADF15EBB67B7EDCDC07ECDA92E9AF04,42631,22,23,1,43,45,2195
89182,89182,561B2BCCF9F22B1D923068968F46BF8A,11781,0,9,9,38,49,1949
89183,89183,561B2BCCF9F22B1D923068968F46BF8A,11481,15,17,2,41,48,2098
89184,89184,561B2BCCF9F22B1D923068968F46BF8A,10107,18,22,4,38,49,1949
89213,89213,0EEF00D524FC221E0814F0ECEF97AD09,10544,0,7,7,28,48,1448
89214,89214,0EEF00D524FC221E0814F0ECEF97AD09,43501,12,15,3,27,48,1398
89215,89215,0EEF00D524FC221E0814F0ECEF97AD09,10951,19,21,2,29,48,1498
89222,89222,FEE5ACDB24DFF6E9A25C550C618C43AE,10251,0,2,2,35,47,1797
89223,89223,FEE5ACDB24DFF6E9A25C550C618C43AE,40673,5,11,6,36,48,1848
89224,89224,FEE5ACDB24DFF6E9A25C550C618C43AE,10251,11,22,11,35,47,1797
89225,89225,FEE5ACDB24DFF6E9A25C550C618C43AE,42161,22,23,1,36,47,1847
89226,89226,50AD8ACDABF8BBC007C0D64420D91B51,11861,0,15,15,32,47,1647
89227,89227,50AD8ACDABF8BBC007C0D64420D91B51,12381,15,16,1,32,48,1648
89228,89228,50AD8ACDABF8BBC007C0D64420D91B51,11861,18,21,3,32,47,1647
89236,89236,642C5FCC730BC5A54E2036C81E432BC6,19114,0,13,13,7,43,393
89237,89237,642C5FCC730BC5A54E2036C81E432BC6,12641,13,16,3,10,43,543
89238,89238,642C5FCC730BC5A54E2036C81E432BC6,19114,20,23,3,7,43,393
89244,89244,BA285F01E6926591864F1F3184565800,42581,0,12,12,38,48,1948
89245,89245,BA285F01E6926591864F1F3184565800,11914,14,20,6,37,48,1898
89246,89246,BA285F01E6926591864F1F3184565800,42581,20,22,2,38,48,1948
89252,89252,4A63BD8790639E943B30CD82E5123621,11061,0,4,4,29,48,1498
89253,89253,4A63BD8790639E943B30CD82E5123621,11151,4,14,10,30,48,1548
89254,89254,4A63BD8790639E943B30CD82E5123621,40094,21,23,2,29,48,1498
89259,89259,F8A2EC8C9348BFB1362087B807B825C5,43971,1,9,8,30,48,1548
89260,89260,F8A2EC8C9348BFB1362087B807B825C5,43761,9,10,1,32,47,1647
89261,89261,F8A2EC8C9348BFB1362087B807B825C5,43971,12,13,1,30,48,1548
89262,89262,F8A2EC8C9348BFB1362087B807B825C5,11381,17,19,2,30,47,1547
89268,89268,1423477319519C8C4C3DD471D7D20EEA,11261,0,9,9,36,46,1846
89269,89269,1423477319519C8C4C3DD471D7D20EEA,42351,14,16,2,38,45,1945
89270,89270,1423477319519C8C4C3DD471D7D20EEA,11261,18,19,1,36,46,1846
89279,89279,812B994B840F852F77DFCCF7ECFAF172,49201,7,8,1,7,41,391
89280,89280,812B994B840F852F77DFCCF7ECFAF172,19181,9,12,3,8,40,440
89281,89281,812B994B840F852F77DFCCF7ECFAF172,49201,13,19,6,7,41,391
89282,89282,2E8B764495F8C75B1A6E74CD6E6D7095,42921,0,7,7,33,47,1697
89283,89283,2E8B764495F8C75B1A6E74CD6E6D7095,10292,8,14,6,30,47,1547
89284,89284,2E8B764495F8C75B1A6E74CD6E6D7095,10731,17,18,1,33,47,1697
89288,89288,13820227A57673498165413FA7C07344,42411,0,10,10,40,49,2049
89289,89289,13820227A57673498165413FA7C07344,40951,13,15,2,36,49,1849
89290,89290,13820227A57673498165413FA7C07344,42411,17,23,6,40,49,2049
89294,89294,500C89B21EF791B4C9764355033111FA,42981,0,3,3,36,49,1849
89295,89295,500C89B21EF791B4C9764355033111FA,40421,5,7,2,37,48,1898
89296,89296,500C89B21EF791B4C9764355033111FA,11074,11,21,10,37,47,1897
89297,89297,09457531FDDE57FFE7AB3C7F21A0C1A1,10471,0,19,19,37,48,1898
89298,89298,09457531FDDE57FFE7AB3C7F21A0C1A1,10107,19,21,2,38,49,1949
89299,89299,09457531FDDE57FFE7AB3C7F21A0C1A1,10471,21,23,2,37,48,1898
89300,89300,BC2C7ED50793849953B206E080DFFB52,42531,0,11,11,31,45,1595
89301,89301,BC2C7ED50793849953B206E080DFFB52,12311,13,14,1,30,44,1544
89302,89302,BC2C7ED50793849953B206E080DFFB52,42531,18,19,1,31,45,1595
89321,89321,8671664FCEA72D44791A077CF27C82B3,12921,5,8,3,9,41,491
89322,89322,8671664FCEA72D44791A077CF27C82B3,12641,8,11,3,10,43,543
89323,89323,8671664FCEA72D44791A077CF27C82B3,12921,14,16,2,9,41,491
89324,89324,8671664FCEA72D44791A077CF27C82B3,12641,16,18,2,10,43,543
89325,89325,9B8E3A84EF821A3E9564A6D6EAEA0FE5,42581,1,11,10,38,48,1948
89326,89326,9B8E3A84EF821A3E9564A6D6EAEA0FE5,11914,12,19,7,37,48,1898
89327,89327,9B8E3A84EF821A3E9564A6D6EAEA0FE5,40491,20,21,1,39,49,1999
89328,89328,8E0D20320C5276BDD797BA6D65B9C51D,11074,0,7,7,37,47,1897
89329,89329,8E0D20320C5276BDD797BA6D65B9C51D,11231,8,18,10,37,49,1899
89330,89330,8E0D20320C5276BDD797BA6D65B9C51D,11074,19,23,4,37,47,1897
89335,89335,A6555ADD1FDD22671BB225447AB03AF9,12641,0,14,14,10,43,543
89336,89336,A6555ADD1FDD22671BB225447AB03AF9,19744,14,16,2,6,43,343
89337,89337,A6555ADD1FDD22671BB225447AB03AF9,12641,17,18,1,10,43,543
89338,89338,A6555ADD1FDD22671BB225447AB03AF9,19744,18,23,5,6,43,343
89344,89344,5D3AB87CDE152EA5E956E4DDC06AC59B,40171,2,6,4,38,48,1948
89345,89345,5D3AB87CDE152EA5E956E4DDC06AC59B,10471,7,17,10,37,48,1898
89346,89346,5D3AB87CDE152EA5E956E4DDC06AC59B,40171,21,23,2,38,48,1948
89347,89347,21F728B24C4414C5861D442FE178C9FC,11381,0,14,14,30,47,1547
89348,89348,21F728B24C4414C5861D442FE178C9FC,12131,18,20,2,32,47,1647
89349,89349,21F728B24C4414C5861D442FE178C9FC,11381,20,23,3,30,47,1547
89363,89363,D59A7D67E6A2D306517724C5A50D5385,10351,0,1,1,28,45,1445
89364,89364,D59A7D67E6A2D306517724C5A50D5385,10301,2,5,3,31,45,1595
89365,89365,D59A7D67E6A2D306517724C5A50D5385,10351,5,6,1,28,45,1445
89366,89366,D59A7D67E6A2D306517724C5A50D5385,42531,7,19,12,31,45,1595
89380,89380,325B301C16FB3DB9C4CED544F7B2E787,42191,0,15,15,38,49,1949
89381,89381,325B301C16FB3DB9C4CED544F7B2E787,11271,18,19,1,37,48,1898
89382,89382,325B301C16FB3DB9C4CED544F7B2E787,10107,20,22,2,38,49,1949
89387,89387,7169FA01502782C069FB888C1FC19962,10351,0,3,3,28,45,1445
89388,89388,7169FA01502782C069FB888C1FC19962,10634,5,6,1,27,45,1395
89389,89389,7169FA01502782C069FB888C1FC19962,10351,6,22,16,28,45,1445
89390,89390,A6CA5B99D8C725550A46CC7557902A23,11381,10,19,9,30,47,1547
89391,89391,A6CA5B99D8C725550A46CC7557902A23,11061,19,20,1,29,48,1498
89392,89392,A6CA5B99D8C725550A46CC7557902A23,11381,20,23,3,30,47,1547
89413,89413,4A7E0C26D094908459DFDB4A502F3938,10111,0,9,9,37,47,1897
89414,89414,4A7E0C26D094908459DFDB4A502F3938,41612,10,14,4,36,47,1847
89415,89415,4A7E0C26D094908459DFDB4A502F3938,10111,19,21,2,37,47,1897
89416,89416,585BA7D242E8C732F58235B756BA8D16,42031,0,8,8,40,46,2046
89417,89417,585BA7D242E8C732F58235B756BA8D16,13231,12,13,1,39,46,1996
89418,89418,585BA7D242E8C732F58235B756BA8D16,10801,14,16,2,42,47,2147
89419,89419,585BA7D242E8C732F58235B756BA8D16,10331,20,22,2,39,46,1996
89420,89420,DAE197CEBF1E1EC8C00EDC17E5E96BDF,10221,0,3,3,34,49,1749
89421,89421,DAE197CEBF1E1EC8C00EDC17E5E96BDF,10381,4,18,14,31,49,1599
89422,89422,DAE197CEBF1E1EC8C00EDC17E5E96BDF,10221,21,23,2,34,49,1749
89428,89428,CA269BAD556781918B5BA94C8942431A,13911,2,14,12,39,46,1996
89429,89429,CA269BAD556781918B5BA94C8942431A,11261,16,17,1,36,46,1846
89430,89430,CA269BAD556781918B5BA94C8942431A,13911,17,18,1,39,46,1996
89431,89431,CA269BAD556781918B5BA94C8942431A,42231,21,22,1,37,46,1896
89432,89432,E46021F2EBB1FF86CE07D74A4E5B9C9F,12921,7,9,2,9,41,491
89433,89433,E46021F2EBB1FF86CE07D74A4E5B9C9F,19181,13,16,3,8,40,440
89434,89434,E46021F2EBB1FF86CE07D74A4E5B9C9F,12921,17,19,2,9,41,491
89435,89435,E46021F2EBB1FF86CE07D74A4E5B9C9F,49201,20,21,1,7,41,391
89436,89436,91764B4567AC3A3991286EF06C97A20D,42161,0,7,7,36,47,1847
89437,89437,91764B4567AC3A3991286EF06C97A20D,10251,9,15,6,35,47,1797
89438,89438,91764B4567AC3A3991286EF06C97A20D,42161,16,23,7,36,47,1847
89439,89439,C4892C44EF96187C0233038F8975DE20,42491,0,6,6,32,46,1646
89440,89440,C4892C44EF96187C0233038F8975DE20,12311,7,10,3,30,44,1544
89441,89441,C4892C44EF96187C0233038F8975DE20,12161,12,23,11,32,46,1646
89448,89448,2FA830A3F4936C72A1774CB1227927A5,42161,0,7,7,36,47,1847
89449,89449,2FA830A3F4936C72A1774CB1227927A5,12131,8,15,7,32,47,1647
89450,89450,2FA830A3F4936C72A1774CB1227927A5,42161,18,23,5,36,47,1847
89475,89475,64A89438CD119CD382369D48AC47BC20,10811,2,8,6,38,46,1946
89476,89476,64A89438CD119CD382369D48AC47BC20,11261,8,9,1,36,46,1846
89477,89477,64A89438CD119CD382369D48AC47BC20,42351,13,16,3,38,45,1945
89478,89478,64A89438CD119CD382369D48AC47BC20,10107,18,21,3,38,49,1949
89479,89479,5C6E53E118C549BF3CD453A35E6BA378,11231,0,4,4,37,49,1899
89480,89480,5C6E53E118C549BF3CD453A35E6BA378,10471,8,11,3,37,48,1898
89481,89481,5C6E53E118C549BF3CD453A35E6BA378,11231,18,23,5,37,49,1899
89482,89482,C6CE1BC9B69267948B78869F2B1A69E1,10731,0,16,16,33,47,1697
89483,89483,C6CE1BC9B69267948B78869F2B1A69E1,11831,20,21,1,32,45,1645
89484,89484,C6CE1BC9B69267948B78869F2B1A69E1,10731,21,23,2,33,47,1697
89495,89495,BB84F849A5F794F98ED9E8F635142ED5,11914,3,8,5,37,48,1898
89496,89496,BB84F849A5F794F98ED9E8F635142ED5,42191,10,11,1,38,49,1949
89497,89497,BB84F849A5F794F98ED9E8F635142ED5,10471,16,18,2,37,48,1898
89498,89498,04218139C4137A884FE7935678F7D5B1,11231,1,14,13,37,49,1899
89499,89499,04218139C4137A884FE7935678F7D5B1,11541,15,21,6,35,49,1799
89500,89500,04218139C4137A884FE7935678F7D5B1,11231,21,22,1,37,49,1899
89527,89527,35E834FED302DD4A84DAAA6164365161,11806,0,13,13,41,48,2098
89528,89528,35E834FED302DD4A84DAAA6164365161,42271,14,16,2,40,47,2047
89529,89529,35E834FED302DD4A84DAAA6164365161,11806,18,20,2,41,48,2098
89534,89534,78C0E1E992CFF9ECB9C6D46D3E929FD4,12121,0,12,12,29,47,1497
89535,89535,78C0E1E992CFF9ECB9C6D46D3E929FD4,11381,13,14,1,30,47,1547
89536,89536,78C0E1E992CFF9ECB9C6D46D3E929FD4,12121,15,20,5,29,47,1497
89537,89537,A9FCDC66B7D345B509A8A419E2F04E20,13381,0,7,7,39,47,1997
89538,89538,A9FCDC66B7D345B509A8A419E2F04E20,13121,7,10,3,38,46,1946
89539,89539,A9FCDC66B7D345B509A8A419E2F04E20,10601,13,16,3,39,47,1997
89540,89540,A9FCDC66B7D345B509A8A419E2F04E20,11491,20,21,1,36,47,1847
89545,89545,A06465C33822DBAACCFCA67CF792360D,10295,0,6,6,30,47,1547
89546,89546,A06465C33822DBAACCFCA67CF792360D,42523,7,8,1,31,47,1597
89547,89547,A06465C33822DBAACCFCA67CF792360D,10295,12,19,7,30,47,1547
89548,89548,A06465C33822DBAACCFCA67CF792360D,42523,21,22,1,31,47,1597
89549,89549,B3D330CB8F1681F4BBCB951D5F414D22,42921,0,6,6,33,47,1697
89550,89550,B3D330CB8F1681F4BBCB951D5F414D22,10111,7,18,11,37,47,1897
89551,89551,B3D330CB8F1681F4BBCB951D5F414D22,10731,19,21,2,33,47,1697
89552,89552,7C5210855A5DFB6ACF7A087ADA0E2F3D,13911,1,6,5,39,46,1996
89553,89553,7C5210855A5DFB6ACF7A087ADA0E2F3D,42231,6,16,10,37,46,1896
89554,89554,7C5210855A5DFB6ACF7A087ADA0E2F3D,42351,16,18,2,38,45,1945
89555,89555,7C5210855A5DFB6ACF7A087ADA0E2F3D,13911,20,21,1,39,46,1996
89559,89559,0BC1BC9FA127A76D4558FF0A0EC8FEFB,42921,0,7,7,33,47,1697
89560,89560,0BC1BC9FA127A76D4558FF0A0EC8FEFB,10281,8,9,1,33,48,1698
89561,89561,0BC1BC9FA127A76D4558FF0A0EC8FEFB,42921,14,20,6,33,47,1697
89562,89562,0BC1BC9FA127A76D4558FF0A0EC8FEFB,12131,21,23,2,32,47,1647
89572,89572,66A1757BF5A4116BA4BCC483D90F56EF,42351,0,8,8,38,45,1945
89573,89573,66A1757BF5A4116BA4BCC483D90F56EF,11261,8,10,2,36,46,1846
89574,89574,66A1757BF5A4116BA4BCC483D90F56EF,42351,14,23,9,38,45,1945
89575,89575,00ED2280FB2BEC22D8FB36F8A7AFB1A5,42791,0,7,7,35,45,1795
89576,89576,00ED2280FB2BEC22D8FB36F8A7AFB1A5,10271,8,13,5,37,46,1896
89577,89577,00ED2280FB2BEC22D8FB36F8A7AFB1A5,13121,14,16,2,38,46,1946
89578,89578,00ED2280FB2BEC22D8FB36F8A7AFB1A5,42151,20,23,3,35,45,1795
89584,89584,C70FF977FA3BD2286D57535D98EFE336,10111,0,8,8,37,47,1897
89585,89585,C70FF977FA3BD2286D57535D98EFE336,41612,8,18,10,36,47,1847
89586,89586,C70FF977FA3BD2286D57535D98EFE336,10111,18,20,2,37,47,1897
89587,89587,C70FF977FA3BD2286D57535D98EFE336,42301,20,21,1,36,47,1847
89603,89603,A922D7161F816C1FD25F52BCCB616DFE,43731,0,6,6,34,47,1747
89604,89604,A922D7161F816C1FD25F52BCCB616DFE,10251,6,10,4,35,47,1797
89605,89605,A922D7161F816C1FD25F52BCCB616DFE,42161,12,14,2,36,47,1847
89606,89606,A922D7161F816C1FD25F52BCCB616DFE,10251,16,21,5,35,47,1797
89622,89622,5AF85D9ED958D0E5348613692DAC5B4D,11201,0,1,1,35,49,1799
89623,89623,5AF85D9ED958D0E5348613692DAC5B4D,11231,1,15,14,37,49,1899
89624,89624,5AF85D9ED958D0E5348613692DAC5B4D,11201,16,17,1,35,49,1799
89625,89625,5AF85D9ED958D0E5348613692DAC5B4D,11751,19,21,2,35,48,1798
89629,89629,6C841C7D2D2B53A8BCAAFC5972E77D1F,42623,0,10,10,22,49,1149
89630,89630,6C841C7D2D2B53A8BCAAFC5972E77D1F,42081,11,17,6,24,49,1249
89631,89631,6C841C7D2D2B53A8BCAAFC5972E77D1F,42623,21,23,2,22,49,1149
89632,89632,3F610288646E91F0293396CEFA65A672,10491,1,8,7,33,48,1698
89633,89633,3F610288646E91F0293396CEFA65A672,11914,8,20,12,37,48,1898
89634,89634,3F610288646E91F0293396CEFA65A672,42161,21,23,2,36,47,1847
89644,89644,4B3046DDC3BB9689596CDD5399FB5267,12661,0,6,6,32,45,1645
89645,89645,4B3046DDC3BB9689596CDD5399FB5267,12311,7,14,7,30,44,1544
89646,89646,4B3046DDC3BB9689596CDD5399FB5267,12661,19,22,3,32,45,1645
89647,89647,31C99BE35DAA7CC1D9A6D662CA3683F3,42331,4,6,2,39,46,1996
89648,89648,31C99BE35DAA7CC1D9A6D662CA3683F3,10841,7,20,13,37,47,1897
89649,89649,31C99BE35DAA7CC1D9A6D662CA3683F3,42331,20,23,3,39,46,1996
89657,89657,E45B0EC44E00842EDD865C65A561543D,11791,0,7,7,38,49,1949
89658,89658,E45B0EC44E00842EDD865C65A561543D,10471,7,14,7,37,48,1898
89659,89659,E45B0EC44E00842EDD865C65A561543D,11231,18,23,5,37,49,1899
89664,89664,D8B46FFCD15B641FB93B8219A29A7205,40673,5,6,1,36,48,1848
89665,89665,D8B46FFCD15B641FB93B8219A29A7205,10111,11,14,3,37,47,1897
89666,89666,D8B46FFCD15B641FB93B8219A29A7205,42301,18,20,2,36,47,1847
89667,89667,3B86E1CB99F9A063FEA255A004EE193F,11261,0,15,15,36,46,1846
89668,89668,3B86E1CB99F9A063FEA255A004EE193F,42864,16,17,1,38,44,1944
89669,89669,3B86E1CB99F9A063FEA255A004EE193F,11261,18,20,2,36,46,1846
89674,89674,F004825C5EEC7F8B7A184D4985895C55,13341,0,14,14,44,45,2245
89675,89675,F004825C5EEC7F8B7A184D4985895C55,42631,15,22,7,43,45,2195
89676,89676,F004825C5EEC7F8B7A184D4985895C55,13341,22,23,1,44,45,2245
89677,89677,036263CBDA31B512A5DDC93914C4536A,13911,2,6,4,39,46,1996
89678,89678,036263CBDA31B512A5DDC93914C4536A,12211,7,9,2,41,44,2094
89679,89679,036263CBDA31B512A5DDC93914C4536A,11261,11,22,11,36,46,1846
89684,89684,5B7CA3A3B8568D19F1FF7908AEEC1A02,42531,0,5,5,31,45,1595
89685,89685,5B7CA3A3B8568D19F1FF7908AEEC1A02,11875,8,11,3,30,46,1546
89686,89686,5B7CA3A3B8568D19F1FF7908AEEC1A02,12311,14,18,4,30,44,1544
89690,89690,830067E97972F27E1AE4923131398E88,10295,0,10,10,30,47,1547
89691,89691,830067E97972F27E1AE4923131398E88,42523,13,14,1,31,47,1597
89692,89692,830067E97972F27E1AE4923131398E88,42491,15,17,2,32,46,1646
89693,89693,830067E97972F27E1AE4923131398E88,42523,19,22,3,31,47,1597
89705,89705,DFD67893B33D33FDAA92DC71D5732DAF,42161,9,10,1,36,47,1847
89706,89706,DFD67893B33D33FDAA92DC71D5732DAF,42941,10,14,4,37,47,1897
89707,89707,DFD67893B33D33FDAA92DC71D5732DAF,42161,14,23,9,36,47,1847
89708,89708,392F2B932A839BB0C6F602E5FA556570,11074,0,16,16,37,47,1897
89709,89709,392F2B932A839BB0C6F602E5FA556570,13911,17,18,1,39,46,1996
89710,89710,392F2B932A839BB0C6F602E5FA556570,11074,19,23,4,37,47,1897
89711,89711,BC5F5A048F874E8EDED6AF765E340D8C,11914,1,17,16,37,48,1898
89712,89712,BC5F5A048F874E8EDED6AF765E340D8C,42581,18,20,2,38,48,1948
89713,89713,BC5F5A048F874E8EDED6AF765E340D8C,11914,21,23,2,37,48,1898
89723,89723,83DF2DC67F792D97F66715470F9922B2,43761,0,9,9,32,47,1647
89724,89724,83DF2DC67F792D97F66715470F9922B2,42521,13,18,5,31,47,1597
89725,89725,83DF2DC67F792D97F66715470F9922B2,43761,19,20,1,32,47,1647
89735,89735,3E43E3619134D3BEB3FF85568E512AF6,11231,10,13,3,37,49,1899
89736,89736,3E43E3619134D3BEB3FF85568E512AF6,10471,17,18,1,37,48,1898
89737,89737,3E43E3619134D3BEB3FF85568E512AF6,11231,19,20,1,37,49,1899
89743,89743,B93C16A242FE2C6BDA83A87AD4FAA434,12601,0,1,1,25,47,1297
89744,89744,B93C16A242FE2C6BDA83A87AD4FAA434,10501,1,8,7,22,46,1146
89745,89745,B93C16A242FE2C6BDA83A87AD4FAA434,12601,13,14,1,25,47,1297
89746,89746,B93C16A242FE2C6BDA83A87AD4FAA434,10501,15,23,8,22,46,1146
89766,89766,F7003CB52BE98A6E92FBE1DD442A4C9C,12514,0,15,15,38,47,1947
89767,89767,F7003CB52BE98A6E92FBE1DD442A4C9C,10841,16,19,3,37,47,1897
89768,89768,F7003CB52BE98A6E92FBE1DD442A4C9C,12514,20,23,3,38,47,1947
89780,89780,A534FD7E51A551BE3196665029DD0400,19931,1,7,6,7,43,393
89781,89781,A534FD7E51A551BE3196665029DD0400,12641,11,12,1,10,43,543
89782,89782,A534FD7E51A551BE3196665029DD0400,19931,13,14,1,7,43,393
89783,89783,A534FD7E51A551BE3196665029DD0400,12641,14,21,7,10,43,543
89795,89795,29D9341B608455DE9B9E73F11B263135,43971,2,10,8,30,48,1548
89796,89796,29D9341B608455DE9B9E73F11B263135,42521,14,15,1,31,47,1597
89797,89797,29D9341B608455DE9B9E73F11B263135,43761,18,22,4,32,47,1647
89805,89805,A1B1493AD1E4959D25E397CB780FB65E,42531,0,7,7,31,45,1595
89806,89806,A1B1493AD1E4959D25E397CB780FB65E,12311,8,18,10,30,44,1544
89807,89807,A1B1493AD1E4959D25E397CB780FB65E,42531,18,23,5,31,45,1595
89811,89811,5DC656AE1F755A21D4CE0049D29039D4,11261,2,7,5,36,46,1846
89812,89812,5DC656AE1F755A21D4CE0049D29039D4,12491,9,16,7,36,43,1843
89813,89813,5DC656AE1F755A21D4CE0049D29039D4,11261,17,18,1,36,46,1846
89814,89814,5DC656AE1F755A21D4CE0049D29039D4,12491,20,22,2,36,43,1843
89815,89815,0AC9ACC82EDADEC2B3583D25F9FB3BD5,19441,5,7,2,8,46,446
89816,89816,0AC9ACC82EDADEC2B3583D25F9FB3BD5,42041,11,15,4,10,47,547
89817,89817,0AC9ACC82EDADEC2B3583D25F9FB3BD5,19441,20,21,1,8,46,446
89831,89831,40270C58456E934DCEEAFD8B8A2F4206,19931,7,8,1,7,43,393
89832,89832,40270C58456E934DCEEAFD8B8A2F4206,12921,10,11,1,9,41,491
89833,89833,40270C58456E934DCEEAFD8B8A2F4206,19931,15,16,1,7,43,393
89834,89834,40270C58456E934DCEEAFD8B8A2F4206,49201,20,21,1,7,41,391
89840,89840,E08A998E96875BC2FB605F71696F898C,11061,1,8,7,29,48,1498
89841,89841,E08A998E96875BC2FB605F71696F898C,11381,8,12,4,30,47,1547
89842,89842,E08A998E96875BC2FB605F71696F898C,11061,15,23,8,29,48,1498
89853,89853,C404F60AD0A2D6862A45A9C320EEAB5F,11261,8,9,1,36,46,1846
89854,89854,C404F60AD0A2D6862A45A9C320EEAB5F,13911,13,14,1,39,46,1996
89855,89855,C404F60AD0A2D6862A45A9C320EEAB5F,11261,17,19,2,36,46,1846
89856,89856,C404F60AD0A2D6862A45A9C320EEAB5F,42351,20,21,1,38,45,1945
89857,89857,8C3A91CDF86DC8912FBAEFD41DFBE939,42411,0,12,12,40,49,2049
89858,89858,8C3A91CDF86DC8912FBAEFD41DFBE939,10191,15,17,2,40,48,2048
89859,89859,8C3A91CDF86DC8912FBAEFD41DFBE939,42411,19,23,4,40,49,2049
89875,89875,11644F1AC47F305D43A6A2C9763997F5,13711,0,13,13,38,46,1946
89876,89876,11644F1AC47F305D43A6A2C9763997F5,10841,14,16,2,37,47,1897
89877,89877,11644F1AC47F305D43A6A2C9763997F5,12514,19,20,1,38,47,1947
89878,89878,11644F1AC47F305D43A6A2C9763997F5,13711,20,22,2,38,46,1946
89879,89879,0781E535CBB143640477269330BEC7EE,42161,3,4,1,36,47,1847
89880,89880,0781E535CBB143640477269330BEC7EE,40411,4,7,3,34,48,1748
89881,89881,0781E535CBB143640477269330BEC7EE,11081,10,16,6,35,46,1796
89882,89882,0781E535CBB143640477269330BEC7EE,10161,19,23,4,35,49,1799
89892,89892,A800B85E69AEF40DD30E7A0CD7B3E8FA,42864,2,16,14,38,44,1944
89893,89893,A800B85E69AEF40DD30E7A0CD7B3E8FA,11261,16,17,1,36,46,1846
89894,89894,A800B85E69AEF40DD30E7A0CD7B3E8FA,42864,22,23,1,38,44,1944
89895,89895,0C2847EFE5F93E92ACEB4EA16E4104D9,13411,2,13,11,49,42,2492
89896,89896,0C2847EFE5F93E92ACEB4EA16E4104D9,43951,14,15,1,49,41,2491
89897,89897,0C2847EFE5F93E92ACEB4EA16E4104D9,13411,18,20,2,49,42,2492
89898,89898,0C2847EFE5F93E92ACEB4EA16E4104D9,43951,20,22,2,49,41,2491
89911,89911,1A781977FAF109F9FB129E523F36ACF2,10351,2,4,2,28,45,1445
89912,89912,1A781977FAF109F9FB129E523F36ACF2,10301,8,10,2,31,45,1595
89913,89913,1A781977FAF109F9FB129E523F36ACF2,13671,11,22,11,27,43,1393
89914,89914,FCA3C665B5BF337F331669EDB597A6AC,42791,0,7,7,35,45,1795
89915,89915,FCA3C665B5BF337F331669EDB597A6AC,10271,8,16,8,37,46,1896
89916,89916,FCA3C665B5BF337F331669EDB597A6AC,42791,21,23,2,35,45,1795
89927,89927,AC9A35D001464E087369411DD671E08D,42161,0,18,18,36,47,1847
89928,89928,AC9A35D001464E087369411DD671E08D,42941,19,20,1,37,47,1897
89929,89929,AC9A35D001464E087369411DD671E08D,42301,21,23,2,36,47,1847
89930,89930,8FFDEB2573593D2EBFD07303D94AB87F,42321,0,15,15,43,47,2197
89931,89931,8FFDEB2573593D2EBFD07303D94AB87F,10801,17,18,1,42,47,2147
89932,89932,8FFDEB2573593D2EBFD07303D94AB87F,42321,19,23,4,43,47,2197
89942,89942,36A5DA74A38B0FD57799D67573348D49,10841,0,7,7,37,47,1897
89943,89943,36A5DA74A38B0FD57799D67573348D49,10411,11,14,3,36,48,1848
89944,89944,36A5DA74A38B0FD57799D67573348D49,10841,18,22,4,37,47,1897
89955,89955,DB2A7AF4E3CE5306702B394040D91F34,42231,0,2,2,37,46,1896
89956,89956,DB2A7AF4E3CE5306702B394040D91F34,42351,3,4,1,38,45,1945
89957,89957,DB2A7AF4E3CE5306702B394040D91F34,42231,5,22,17,37,46,1896
89965,89965,C6ECE5EEB3C55F11FF8684D918998C95,11571,0,6,6,13,46,696
89966,89966,C6ECE5EEB3C55F11FF8684D918998C95,19021,6,11,5,10,45,545
89967,89967,C6ECE5EEB3C55F11FF8684D918998C95,11571,12,13,1,13,46,696
89968,89968,C6ECE5EEB3C55F11FF8684D918998C95,19021,14,18,4,10,45,545
89972,89972,2E7CC4EF44F5328D020B21B2138E3C1D,11061,0,9,9,29,48,1498
89973,89973,2E7CC4EF44F5328D020B21B2138E3C1D,10716,13,15,2,30,46,1546
89974,89974,2E7CC4EF44F5328D020B21B2138E3C1D,11061,20,22,2,29,48,1498
89975,89975,D44EDEFE20C6E53FAD2290D9CECCD593,42041,0,3,3,10,47,547
89976,89976,D44EDEFE20C6E53FAD2290D9CECCD593,19441,7,11,4,8,46,446
89977,89977,D44EDEFE20C6E53FAD2290D9CECCD593,42041,14,18,4,10,47,547
89978,89978,D44EDEFE20C6E53FAD2290D9CECCD593,19441,18,22,4,8,46,446
89984,89984,EB7EB6074C1F2A07A41462E31EDA6629,42401,0,15,15,36,47,1847
89985,89985,EB7EB6074C1F2A07A41462E31EDA6629,10161,15,19,4,35,49,1799
89986,89986,EB7EB6074C1F2A07A41462E31EDA6629,42161,20,23,3,36,47,1847
89998,89998,45E2591DDB181830E886EA4FBDDB1E4F,42021,0,8,8,33,47,1697
89999,89999,45E2591DDB181830E886EA4FBDDB1E4F,10151,9,17,8,34,47,1747
90000,90000,45E2591DDB181830E886EA4FBDDB1E4F,42021,17,19,2,33,47,1697
90001,90001,43DBEEA61839592A95FC32BC8064AB85,12921,0,7,7,9,41,491
90002,90002,43DBEEA61839592A95FC32BC8064AB85,12641,7,8,1,10,43,543
90003,90003,43DBEEA61839592A95FC32BC8064AB85,12921,11,23,12,9,41,491
90009,90009,CC3FA096FA296BC301B8FB82BD507846,42471,0,7,7,35,49,1799
90010,90010,CC3FA096FA296BC301B8FB82BD507846,11531,8,15,7,34,49,1749
90011,90011,CC3FA096FA296BC301B8FB82BD507846,42471,17,18,1,35,49,1799
90012,90012,CC3FA096FA296BC301B8FB82BD507846,11021,20,22,2,36,49,1849
90027,90027,F10DCA77B208C0B385CF6E7BEA5199DF,42141,0,5,5,32,47,1647
90028,90028,F10DCA77B208C0B385CF6E7BEA5199DF,42523,7,18,11,31,47,1597
90029,90029,F10DCA77B208C0B385CF6E7BEA5199DF,42141,19,22,3,32,47,1647
90044,90044,7A784F63DA542325785D1949B0ED9A3A,12311,1,5,4,30,44,1544
90045,90045,7A784F63DA542325785D1949B0ED9A3A,10301,8,16,8,31,45,1595
90046,90046,7A784F63DA542325785D1949B0ED9A3A,12311,20,21,1,30,44,1544
90047,90047,0E40901167898EDFDA9B65FF7D65C295,19021,3,5,2,10,45,545
90048,90048,0E40901167898EDFDA9B65FF7D65C295,42041,7,8,1,10,47,547
90049,90049,0E40901167898EDFDA9B65FF7D65C295,19441,11,19,8,8,46,446
90050,90050,576B01C43A9F86D222730FAFCEED6223,12581,9,11,2,24,48,1248
90051,90051,576B01C43A9F86D222730FAFCEED6223,11361,13,14,1,22,48,1148
90052,90052,576B01C43A9F86D222730FAFCEED6223,11641,15,18,3,22,49,1149
90053,90053,B20D4CCCBBF9B534BB9F26A35B371E4C,42351,0,9,9,38,45,1945
90054,90054,B20D4CCCBBF9B534BB9F26A35B371E4C,11261,10,16,6,36,46,1846
90055,90055,B20D4CCCBBF9B534BB9F26A35B371E4C,13911,16,23,7,39,46,1996
90060,90060,4C8E92DBB85921608C1C92929A7A8C92,42521,0,8,8,31,47,1597
90061,90061,4C8E92DBB85921608C1C92929A7A8C92,13651,8,12,4,30,47,1547
90062,90062,4C8E92DBB85921608C1C92929A7A8C92,42521,12,13,1,31,47,1597
90063,90063,4C8E92DBB85921608C1C92929A7A8C92,13651,16,22,6,30,47,1547
90064,90064,1F49E26C341B3738FA1E54F232E557D3,11074,0,7,7,37,47,1897
90065,90065,1F49E26C341B3738FA1E54F232E557D3,12511,11,15,4,39,47,1997
90066,90066,1F49E26C341B3738FA1E54F232E557D3,40833,16,19,3,41,47,2097
90067,90067,1F49E26C341B3738FA1E54F232E557D3,12514,22,23,1,38,47,1947
90071,90071,D429753EEB35077FBB0F7FD7B24671DA,42381,1,5,4,39,41,1991
90072,90072,D429753EEB35077FBB0F7FD7B24671DA,43451,7,9,2,37,40,1890
90073,90073,D429753EEB35077FBB0F7FD7B24671DA,42381,13,21,8,39,41,1991
90074,90074,08EDF1CCFF32686DD950EC26EF30E233,11381,0,9,9,30,47,1547
90075,90075,08EDF1CCFF32686DD950EC26EF30E233,10681,9,11,2,30,48,1548
90076,90076,08EDF1CCFF32686DD950EC26EF30E233,11381,12,23,11,30,47,1547
90077,90077,9637A49CA49F0EFD37F0D0143383C518,13911,0,4,4,39,46,1996
90078,90078,9637A49CA49F0EFD37F0D0143383C518,42231,8,14,6,37,46,1896
90079,90079,9637A49CA49F0EFD37F0D0143383C518,13911,18,23,5,39,46,1996
90080,90080,CC04DF57CD476D56A9C2711AACC54374,11261,2,4,2,36,46,1846
90081,90081,CC04DF57CD476D56A9C2711AACC54374,42861,8,14,6,37,44,1894
90082,90082,CC04DF57CD476D56A9C2711AACC54374,11261,17,19,2,36,46,1846
90083,90083,CC04DF57CD476D56A9C2711AACC54374,42861,21,22,1,37,44,1894
90102,90102,56480C35E588FCD439D890E8FE82E1FF,19114,1,13,12,7,43,393
90103,90103,56480C35E588FCD439D890E8FE82E1FF,12641,15,17,2,10,43,543
90104,90104,56480C35E588FCD439D890E8FE82E1FF,19114,21,23,2,7,43,393
90105,90105,3624837A8CEE8FA380EBBA166C2E7021,42091,0,12,12,43,46,2196
90106,90106,3624837A8CEE8FA380EBBA166C2E7021,13101,14,15,1,40,47,2047
90107,90107,3624837A8CEE8FA380EBBA166C2E7021,42091,17,23,6,43,46,2196
90108,90108,039720C5318D39E34BBB18DF8027F133,42581,1,3,2,38,48,1948
90109,90109,039720C5318D39E34BBB18DF8027F133,11271,7,17,10,37,48,1898
90110,90110,039720C5318D39E34BBB18DF8027F133,42581,18,19,1,38,48,1948
90129,90129,4395C6E2ABA59930045C5FB0134BA180,10711,0,7,7,29,46,1496
90130,90130,4395C6E2ABA59930045C5FB0134BA180,10301,7,19,12,31,45,1595
90131,90131,4395C6E2ABA59930045C5FB0134BA180,10711,21,23,2,29,46,1496
90132,90132,28AE6FF44E8686DC354D2E3DF7700FCC,42461,0,6,6,45,47,2297
90133,90133,28AE6FF44E8686DC354D2E3DF7700FCC,42321,6,10,4,43,47,2197
90134,90134,28AE6FF44E8686DC354D2E3DF7700FCC,42461,12,22,10,45,47,2297
90135,90135,751B7CB9C035034746EB082217066F97,10351,0,1,1,28,45,1445
90136,90136,751B7CB9C035034746EB082217066F97,10301,2,4,2,31,45,1595
90137,90137,751B7CB9C035034746EB082217066F97,10351,4,21,17,28,45,1445
90147,90147,17E50CF48AD5982A5D80F473E9B91696,10901,0,9,9,35,48,1798
90148,90148,17E50CF48AD5982A5D80F473E9B91696,12083,11,16,5,36,49,1849
90149,90149,17E50CF48AD5982A5D80F473E9B91696,10901,17,23,6,35,48,1798
90168,90168,6EAB0BAC66AA45D41BB631DA8C9C8DA3,42521,0,10,10,31,47,1597
90169,90169,6EAB0BAC66AA45D41BB631DA8C9C8DA3,43971,14,15,1,30,48,1548
90170,90170,6EAB0BAC66AA45D41BB631DA8C9C8DA3,42521,17,19,2,31,47,1597
90171,90171,6EAB0BAC66AA45D41BB631DA8C9C8DA3,11381,21,23,2,30,47,1547
90172,90172,94A66B099C3B286235DEE73BAE7FEB6C,11861,0,8,8,32,47,1647
90173,90173,94A66B099C3B286235DEE73BAE7FEB6C,10281,9,10,1,33,48,1698
90174,90174,94A66B099C3B286235DEE73BAE7FEB6C,11861,14,23,9,32,47,1647
90178,90178,071CE09F855A64AE0576C7544BB94C70,42401,0,10,10,36,47,1847
90179,90179,071CE09F855A64AE0576C7544BB94C70,10531,12,14,2,34,46,1746
90180,90180,071CE09F855A64AE0576C7544BB94C70,42161,15,23,8,36,47,1847
90181,90181,62343CB5CF1337E48C53ADD9F743555A,10271,0,7,7,37,46,1896
90182,90182,62343CB5CF1337E48C53ADD9F743555A,13711,10,11,1,38,46,1946
90183,90183,62343CB5CF1337E48C53ADD9F743555A,10271,12,19,7,37,46,1896
90184,90184,62343CB5CF1337E48C53ADD9F743555A,43241,20,22,2,36,46,1846
90198,90198,872EA7042E221A40D168D3255557BABA,43761,0,5,5,32,47,1647
90199,90199,872EA7042E221A40D168D3255557BABA,11381,8,10,2,30,47,1547
90200,90200,872EA7042E221A40D168D3255557BABA,43761,10,22,12,32,47,1647
90201,90201,FCF6425DA3F542476DF1F93935C075D8,43181,0,5,5,39,48,1998
90202,90202,FCF6425DA3F542476DF1F93935C075D8,42581,5,12,7,38,48,1948
90203,90203,FCF6425DA3F542476DF1F93935C075D8,11914,13,19,6,37,48,1898
90204,90204,FCF6425DA3F542476DF1F93935C075D8,43181,21,23,2,39,48,1998
90205,90205,F3DCE8C3C3FF003CDF3D27C94852CCE1,13731,2,18,16,33,49,1699
90206,90206,F3DCE8C3C3FF003CDF3D27C94852CCE1,11951,18,20,2,31,49,1599
90207,90207,F3DCE8C3C3FF003CDF3D27C94852CCE1,13731,21,23,2,33,49,1699
90208,90208,5286A29EF2DEDE42572B77FE3AFBCCAE,11201,0,10,10,35,49,1799
90209,90209,5286A29EF2DEDE42572B77FE3AFBCCAE,11531,13,20,7,34,49,1749
90210,90210,5286A29EF2DEDE42572B77FE3AFBCCAE,10471,20,21,1,37,48,1898
90211,90211,BA68D19087DD7682E8C396165511A278,11381,0,14,14,30,47,1547
90212,90212,BA68D19087DD7682E8C396165511A278,11061,17,19,2,29,48,1498
90213,90213,BA68D19087DD7682E8C396165511A278,11381,19,23,4,30,47,1547
90219,90219,10530AA3545BA3AAA2634E512B3F731F,11261,0,18,18,36,46,1846
90220,90220,10530AA3545BA3AAA2634E512B3F731F,13231,19,21,2,39,46,1996
90221,90221,10530AA3545BA3AAA2634E512B3F731F,11261,21,23,2,36,46,1846
90222,90222,E191A4A4FB39AEE62DAC5F9CA16A7F16,12971,0,9,9,32,48,1648
90223,90223,E191A4A4FB39AEE62DAC5F9CA16A7F16,11211,13,17,4,34,49,1749
90224,90224,E191A4A4FB39AEE62DAC5F9CA16A7F16,10721,18,19,1,31,48,1598
90225,90225,E191A4A4FB39AEE62DAC5F9CA16A7F16,10251,20,23,3,35,47,1797
90226,90226,63A1194DA67A916294F825B4249AD293,42161,6,8,2,36,47,1847
90227,90227,63A1194DA67A916294F825B4249AD293,11261,9,17,8,36,46,1846
90228,90228,63A1194DA67A916294F825B4249AD293,10841,20,22,2,37,47,1897
90229,90229,F9EB273A6B6A04FD25F57CF00B7C5645,12561,0,6,6,45,43,2293
90230,90230,F9EB273A6B6A04FD25F57CF00B7C5645,12221,8,17,9,43,44,2194
90231,90231,F9EB273A6B6A04FD25F57CF00B7C5645,12561,20,21,1,45,43,2293
90252,90252,198F13224A4C889E12ED1D538BD7168E,15391,0,12,12,35,26,1776
90253,90253,198F13224A4C889E12ED1D538BD7168E,15191,13,15,2,36,27,1827
90254,90254,198F13224A4C889E12ED1D538BD7168E,15391,16,22,6,35,26,1776
90258,90258,7F73A642AA11134206C46BA15C785E40,10295,9,10,1,30,47,1547
90259,90259,7F73A642AA11134206C46BA15C785E40,42491,11,15,4,32,46,1646
90260,90260,7F73A642AA11134206C46BA15C785E40,42521,17,19,2,31,47,1597
90261,90261,61FCFAF6CF96194170CA47541D5EEB94,40124,0,15,15,38,47,1947
90262,90262,61FCFAF6CF96194170CA47541D5EEB94,42511,17,20,3,37,47,1897
90263,90263,61FCFAF6CF96194170CA47541D5EEB94,40124,21,23,2,38,47,1947
90273,90273,FC707C73D6614611D82A13C2F325D332,11074,0,13,13,37,47,1897
90274,90274,FC707C73D6614611D82A13C2F325D332,41081,17,20,3,36,49,1849
90275,90275,FC707C73D6614611D82A13C2F325D332,11074,21,23,2,37,47,1897
90281,90281,D950A9D3ACBEF7AFBBFB96859587E38D,42523,0,4,4,31,47,1597
90282,90282,D950A9D3ACBEF7AFBBFB96859587E38D,10292,4,8,4,30,47,1547
90283,90283,D950A9D3ACBEF7AFBBFB96859587E38D,42523,9,21,12,31,47,1597
90288,90288,5ED8949BAC5CDF05EDA1019FB7CA4B17,42161,0,14,14,36,47,1847
90289,90289,5ED8949BAC5CDF05EDA1019FB7CA4B17,10471,15,17,2,37,48,1898
90290,90290,5ED8949BAC5CDF05EDA1019FB7CA4B17,42191,19,21,2,38,49,1949
90291,90291,5ED8949BAC5CDF05EDA1019FB7CA4B17,42401,21,23,2,36,47,1847
90292,90292,DD4D28FDBCFFE930AF28BD3956ED9308,11381,0,16,16,30,47,1547
90293,90293,DD4D28FDBCFFE930AF28BD3956ED9308,11831,17,19,2,32,45,1645
90294,90294,DD4D28FDBCFFE930AF28BD3956ED9308,11381,20,23,3,30,47,1547
90303,90303,A6FB8806348882E3287150AAB70E5425,42141,0,2,2,32,47,1647
90304,90304,A6FB8806348882E3287150AAB70E5425,11161,3,5,2,32,48,1648
90305,90305,A6FB8806348882E3287150AAB70E5425,43761,6,23,17,32,47,1647
90306,90306,14032B8270EF22C1D4A35716559793F7,42131,0,10,10,44,48,2248
90307,90307,14032B8270EF22C1D4A35716559793F7,11701,13,17,4,43,48,2198
90308,90308,14032B8270EF22C1D4A35716559793F7,42341,21,22,1,43,49,2199
90309,90309,9BCD563089A1D0EF43A278605DE25081,13911,0,12,12,39,46,1996
90310,90310,9BCD563089A1D0EF43A278605DE25081,42231,13,15,2,37,46,1896
90311,90311,9BCD563089A1D0EF43A278605DE25081,13911,18,23,5,39,46,1996
90315,90315,C1A7300447E52CCDF2CB85950BBC3F11,42523,0,3,3,31,47,1597
90316,90316,C1A7300447E52CCDF2CB85950BBC3F11,13601,8,12,4,34,47,1747
90317,90317,C1A7300447E52CCDF2CB85950BBC3F11,11861,13,14,1,32,47,1647
90318,90318,C1A7300447E52CCDF2CB85950BBC3F11,13601,17,18,1,34,47,1747
90323,90323,1BCA8F195CED1A69C9ABE190E0303E0A,19111,0,15,15,9,45,495
90324,90324,1BCA8F195CED1A69C9ABE190E0303E0A,42041,16,17,1,10,47,547
90325,90325,1BCA8F195CED1A69C9ABE190E0303E0A,19441,18,20,2,8,46,446
90346,90346,34FB5BF239A7B5016E3CA81F47968839,40961,0,8,8,35,47,1797
90347,90347,34FB5BF239A7B5016E3CA81F47968839,42161,10,11,1,36,47,1847
90348,90348,34FB5BF239A7B5016E3CA81F47968839,43161,11,21,10,35,47,1797
90349,90349,1C66970D4F8227F60EB8E0346F0E3CB4,19621,0,6,6,5,46,296
90350,90350,1C66970D4F8227F60EB8E0346F0E3CB4,19744,14,16,2,6,43,343
90351,90351,1C66970D4F8227F60EB8E0346F0E3CB4,19621,18,23,5,5,46,296
90356,90356,A5D415978739B41EFC3F5E5B4F4B1903,42521,0,3,3,31,47,1597
90357,90357,A5D415978739B41EFC3F5E5B4F4B1903,43761,4,12,8,32,47,1647
90358,90358,A5D415978739B41EFC3F5E5B4F4B1903,11381,14,17,3,30,47,1547
90359,90359,A5D415978739B41EFC3F5E5B4F4B1903,43761,17,22,5,32,47,1647
90388,90388,602E25FF9BA20622C351E364EAC2AB76,13711,0,8,8,38,46,1946
90389,90389,602E25FF9BA20622C351E364EAC2AB76,42861,11,12,1,37,44,1894
90390,90390,602E25FF9BA20622C351E364EAC2AB76,13711,14,23,9,38,46,1946
90391,90391,F4C8F856DD638BBA75F52C720E10C05D,12641,0,5,5,10,43,543
90392,90392,F4C8F856DD638BBA75F52C720E10C05D,12921,7,8,1,9,41,491
90393,90393,F4C8F856DD638BBA75F52C720E10C05D,12641,13,21,8,10,43,543
90394,90394,AA3D7E1DC0C99DC660096C9CD53B9E64,11074,0,11,11,37,47,1897
90395,90395,AA3D7E1DC0C99DC660096C9CD53B9E64,11914,16,17,1,37,48,1898
90396,90396,AA3D7E1DC0C99DC660096C9CD53B9E64,11074,22,23,1,37,47,1897
90402,90402,F6699F53BB2828087D5BCD84E9F71F0D,11914,0,7,7,37,48,1898
90403,90403,F6699F53BB2828087D5BCD84E9F71F0D,13121,9,17,8,38,46,1946
90404,90404,F6699F53BB2828087D5BCD84E9F71F0D,11914,19,22,3,37,48,1898
90409,90409,F7F6E311089E545E2ADE21E1CFF4D206,11861,1,4,3,32,47,1647
90410,90410,F7F6E311089E545E2ADE21E1CFF4D206,42921,4,11,7,33,47,1697
90411,90411,F7F6E311089E545E2ADE21E1CFF4D206,43761,14,19,5,32,47,1647
90424,90424,0DFD98C5BF618352145AEF64606DF221,40673,1,10,9,36,48,1848
90425,90425,0DFD98C5BF618352145AEF64606DF221,10251,12,13,1,35,47,1797
90426,90426,0DFD98C5BF618352145AEF64606DF221,42161,16,19,3,36,47,1847
90427,90427,0DFD98C5BF618352145AEF64606DF221,40673,21,22,1,36,48,1848
90428,90428,734912AAE07BFE6A8CDF7B2AFD01F8FC,10811,2,8,6,38,46,1946
90429,90429,734912AAE07BFE6A8CDF7B2AFD01F8FC,11261,8,15,7,36,46,1846
90430,90430,734912AAE07BFE6A8CDF7B2AFD01F8FC,11794,18,21,3,38,49,1949
90431,90431,67BCB76F611F63115F44CBB7619B7D68,43161,0,14,14,35,47,1797
90432,90432,67BCB76F611F63115F44CBB7619B7D68,42771,15,16,1,36,47,1847
90433,90433,67BCB76F611F63115F44CBB7619B7D68,43161,17,22,5,35,47,1797
90434,90434,5A01C71B961419973DCC97128EEA852C,13711,3,13,10,38,46,1946
90435,90435,5A01C71B961419973DCC97128EEA852C,42011,15,21,6,36,46,1846
90436,90436,5A01C71B961419973DCC97128EEA852C,13711,22,23,1,38,46,1946
90437,90437,A0402DF5761F5D0D062E6DE56AF93C04,40801,0,8,8,43,46,2196
90438,90438,A0402DF5761F5D0D062E6DE56AF93C04,13111,20,21,1,42,46,2146
90439,90439,A0402DF5761F5D0D062E6DE56AF93C04,40801,21,23,2,43,46,2196
90440,90440,94659C4C1B1A469E566B81B441E10C1D,11074,0,9,9,37,47,1897
90441,90441,94659C4C1B1A469E566B81B441E10C1D,42301,11,12,1,36,47,1847
90442,90442,94659C4C1B1A469E566B81B441E10C1D,11074,15,23,8,37,47,1897
90449,90449,3717F18D88C40095DBADE8C95C390E6F,42861,3,9,6,37,44,1894
90450,90450,3717F18D88C40095DBADE8C95C390E6F,42151,9,14,5,35,45,1795
90451,90451,3717F18D88C40095DBADE8C95C390E6F,42861,14,19,5,37,44,1894
90452,90452,0C2CF9978A89A8B9BB3C76FFDC24D8D6,13911,0,5,5,39,46,1996
90453,90453,0C2CF9978A89A8B9BB3C76FFDC24D8D6,42231,10,11,1,37,46,1896
90454,90454,0C2CF9978A89A8B9BB3C76FFDC24D8D6,13911,12,19,7,39,46,1996
90455,90455,72DBDA8603B4E9714EB6F87BB7715606,11381,0,6,6,30,47,1547
90456,90456,72DBDA8603B4E9714EB6F87BB7715606,12121,7,8,1,29,47,1497
90457,90457,72DBDA8603B4E9714EB6F87BB7715606,11381,10,20,10,30,47,1547
90476,90476,C137AB634D50D98774754E2133099507,41382,0,7,7,38,49,1949
90477,90477,C137AB634D50D98774754E2133099507,10191,14,15,1,40,48,2048
90478,90478,C137AB634D50D98774754E2133099507,11794,19,22,3,38,49,1949
90479,90479,BFB5F99311B260572E316DE64B3EB913,11131,0,8,8,33,48,1698
90480,90480,BFB5F99311B260572E316DE64B3EB913,10901,9,18,9,35,48,1798
90481,90481,BFB5F99311B260572E316DE64B3EB913,11131,21,23,2,33,48,1698
90497,90497,A61D0F5D6E4730E77483BB5A83F54B2C,42771,0,8,8,36,47,1847
90498,90498,A61D0F5D6E4730E77483BB5A83F54B2C,10841,8,10,2,37,47,1897
90499,90499,A61D0F5D6E4730E77483BB5A83F54B2C,10221,11,14,3,34,49,1749
90500,90500,A61D0F5D6E4730E77483BB5A83F54B2C,42401,19,23,4,36,47,1847
90513,90513,F6F2E45DD62CF36C9B7066251C572F8C,42331,0,7,7,39,46,1996
90514,90514,F6F2E45DD62CF36C9B7066251C572F8C,13121,8,17,9,38,46,1946
90515,90515,F6F2E45DD62CF36C9B7066251C572F8C,10911,19,23,4,39,46,1996
90520,90520,B92E89796812211C5B5F4FA9439F7E3F,11061,9,12,3,29,48,1498
90521,90521,B92E89796812211C5B5F4FA9439F7E3F,43971,12,14,2,30,48,1548
90522,90522,B92E89796812211C5B5F4FA9439F7E3F,11061,17,21,4,29,48,1498
90555,90555,5E3291503FC27DAA0248AA453FC4D60A,19441,0,16,16,8,46,446
90556,90556,5E3291503FC27DAA0248AA453FC4D60A,42041,17,18,1,10,47,547
90557,90557,5E3291503FC27DAA0248AA453FC4D60A,19441,18,22,4,8,46,446
90569,90569,4EC1E2855C615E615A781D55DF62BA15,42041,2,15,13,10,47,547
90570,90570,4EC1E2855C615E615A781D55DF62BA15,19441,17,19,2,8,46,446
90571,90571,4EC1E2855C615E615A781D55DF62BA15,11851,20,22,2,13,47,697
90575,90575,D66D8E0D9CC909200339B3DF5FBFC3B5,42031,1,3,2,40,46,2046
90576,90576,D66D8E0D9CC909200339B3DF5FBFC3B5,10821,4,8,4,40,47,2047
90577,90577,D66D8E0D9CC909200339B3DF5FBFC3B5,11261,12,15,3,36,46,1846
90578,90578,D66D8E0D9CC909200339B3DF5FBFC3B5,42031,20,22,2,40,46,2046
90585,90585,F6093F62DDE89BBEABF40CB8185E1EE5,10801,0,8,8,42,47,2147
90586,90586,F6093F62DDE89BBEABF40CB8185E1EE5,42321,11,17,6,43,47,2197
90587,90587,F6093F62DDE89BBEABF40CB8185E1EE5,10801,18,20,2,42,47,2147
90596,90596,0BC2807A95147EDBE8FE5310BDE7E404,12641,0,5,5,10,43,543
90597,90597,0BC2807A95147EDBE8FE5310BDE7E404,12921,6,8,2,9,41,491
90598,90598,0BC2807A95147EDBE8FE5310BDE7E404,12641,9,21,12,10,43,543
90602,90602,AC0F9A0DA655EB0858F47B6C2577B3DE,13671,4,8,4,27,43,1393
90603,90603,AC0F9A0DA655EB0858F47B6C2577B3DE,11281,12,14,2,27,40,1390
90604,90604,AC0F9A0DA655EB0858F47B6C2577B3DE,13671,17,18,1,27,43,1393
90605,90605,AC0F9A0DA655EB0858F47B6C2577B3DE,11281,20,21,1,27,40,1390
90611,90611,B8DB030E6F574F75DC469AA0B11A44D5,10151,0,7,7,34,47,1747
90612,90612,B8DB030E6F574F75DC469AA0B11A44D5,42921,10,16,6,33,47,1697
90613,90613,B8DB030E6F574F75DC469AA0B11A44D5,10151,19,23,4,34,47,1747
90617,90617,DD5CE6DD8E417DEB4686A2B15261DEA7,10411,1,4,3,36,48,1848
90618,90618,DD5CE6DD8E417DEB4686A2B15261DEA7,11271,6,11,5,37,48,1898
90619,90619,DD5CE6DD8E417DEB4686A2B15261DEA7,12083,12,17,5,36,49,1849
90620,90620,DD5CE6DD8E417DEB4686A2B15261DEA7,10161,18,19,1,35,49,1799
90624,90624,F2229754FABF7F398D6839D6208AC86F,10544,0,14,14,28,48,1448
90625,90625,F2229754FABF7F398D6839D6208AC86F,10381,15,17,2,31,49,1599
90626,90626,F2229754FABF7F398D6839D6208AC86F,10544,18,23,5,28,48,1448
90632,90632,0F11B5CA889ADAC68664648A25492433,42523,0,6,6,31,47,1597
90633,90633,0F11B5CA889ADAC68664648A25492433,43761,6,7,1,32,47,1647
90634,90634,0F11B5CA889ADAC68664648A25492433,42523,7,18,11,31,47,1597
90635,90635,0F11B5CA889ADAC68664648A25492433,10295,19,21,2,30,47,1547
90636,90636,E5492E07A4862AD700B0EAC8DC132879,42071,1,11,10,31,49,1599
90637,90637,E5492E07A4862AD700B0EAC8DC132879,43391,14,17,3,29,48,1498
90638,90638,E5492E07A4862AD700B0EAC8DC132879,11381,20,22,2,30,47,1547
90644,90644,6C96EE989846ABECA961FEB7DAD4E3B3,10471,6,12,6,37,48,1898
90645,90645,6C96EE989846ABECA961FEB7DAD4E3B3,40171,12,15,3,38,48,1948
90646,90646,6C96EE989846ABECA961FEB7DAD4E3B3,10471,15,17,2,37,48,1898
90647,90647,6C96EE989846ABECA961FEB7DAD4E3B3,40171,21,22,1,38,48,1948
90648,90648,57068447BEEE4D7969FF166D57966ECA,42541,0,6,6,25,47,1297
90649,90649,57068447BEEE4D7969FF166D57966ECA,11361,6,15,9,22,48,1148
90650,90650,57068447BEEE4D7969FF166D57966ECA,42541,19,23,4,25,47,1297
90651,90651,39837F9B51A6347266C2EC9E35447064,42321,6,7,1,43,47,2197
90652,90652,39837F9B51A6347266C2EC9E35447064,42461,7,16,9,45,47,2297
90653,90653,39837F9B51A6347266C2EC9E35447064,42321,18,20,2,43,47,2197
90654,90654,39837F9B51A6347266C2EC9E35447064,42461,21,23,2,45,47,2297
90655,90655,D618A6C3100C9BD1930907167F1B2D2D,10921,0,6,6,43,48,2198
90656,90656,D618A6C3100C9BD1930907167F1B2D2D,43181,8,9,1,39,48,1998
90657,90657,D618A6C3100C9BD1930907167F1B2D2D,13961,12,14,2,42,48,2148
90658,90658,D618A6C3100C9BD1930907167F1B2D2D,10921,18,22,4,43,48,2198
90685,90685,55533B9612A041F560AB09E0A0C2A735,10251,0,8,8,35,47,1797
90686,90686,55533B9612A041F560AB09E0A0C2A735,41007,11,12,1,37,47,1897
90687,90687,55533B9612A041F560AB09E0A0C2A735,43731,14,19,5,34,47,1747
90688,90688,55533B9612A041F560AB09E0A0C2A735,10251,19,23,4,35,47,1797
90694,90694,F8E5692DC64F594EE622EF21A4844BEB,19114,0,8,8,7,43,393
90695,90695,F8E5692DC64F594EE622EF21A4844BEB,12641,12,15,3,10,43,543
90696,90696,F8E5692DC64F594EE622EF21A4844BEB,19114,19,23,4,7,43,393
90704,90704,ECEEBC7D1C7EF43BA1494D7AF924B9B0,12311,0,9,9,30,44,1544
90705,90705,ECEEBC7D1C7EF43BA1494D7AF924B9B0,12661,9,12,3,32,45,1645
90706,90706,ECEEBC7D1C7EF43BA1494D7AF924B9B0,12311,12,20,8,30,44,1544
90728,90728,990529BE48C6A8DFFA6A404F72B17A5A,42861,1,9,8,37,44,1894
90729,90729,990529BE48C6A8DFFA6A404F72B17A5A,11261,10,13,3,36,46,1846
90730,90730,990529BE48C6A8DFFA6A404F72B17A5A,42861,14,18,4,37,44,1894
90768,90768,617CDCBB763C8E42460705E2218A65BF,43761,0,6,6,32,47,1647
90769,90769,617CDCBB763C8E42460705E2218A65BF,42521,8,10,2,31,47,1597
90770,90770,617CDCBB763C8E42460705E2218A65BF,43761,13,21,8,32,47,1647
90782,90782,7A3CCBEE1EF7E270B4B301C75856D62F,11861,0,8,8,32,47,1647
90783,90783,7A3CCBEE1EF7E270B4B301C75856D62F,10281,11,15,4,33,48,1698
90784,90784,7A3CCBEE1EF7E270B4B301C75856D62F,11861,18,23,5,32,47,1647
90791,90791,74AB6CFD67956B56632339242F1AAEEC,10251,7,13,6,35,47,1797
90792,90792,74AB6CFD67956B56632339242F1AAEEC,42161,13,16,3,36,47,1847
90793,90793,74AB6CFD67956B56632339242F1AAEEC,10251,16,18,2,35,47,1797
90794,90794,B7783E40C231BF2A915C5200F2E2562A,12031,0,12,12,33,48,1698
90795,90795,B7783E40C231BF2A915C5200F2E2562A,10161,17,18,1,35,49,1799
90796,90796,B7783E40C231BF2A915C5200F2E2562A,40951,20,22,2,36,49,1849
90797,90797,E0F1670DB5561200EEDBAB1833327673,11921,0,9,9,38,48,1948
90798,90798,E0F1670DB5561200EEDBAB1833327673,10111,10,21,11,37,47,1897
90799,90799,E0F1670DB5561200EEDBAB1833327673,11921,21,23,2,38,48,1948
90800,90800,3E17C9F881E8F571652BFE5E841845EF,11861,0,16,16,32,47,1647
90801,90801,3E17C9F881E8F571652BFE5E841845EF,10281,18,19,1,33,48,1698
90802,90802,3E17C9F881E8F571652BFE5E841845EF,11861,19,23,4,32,47,1647
90803,90803,F40AC1EDE9EB783E2CA294E73A950959,42351,2,6,4,38,45,1945
90804,90804,F40AC1EDE9EB783E2CA294E73A950959,13911,8,10,2,39,46,1996
90805,90805,F40AC1EDE9EB783E2CA294E73A950959,42231,14,20,6,37,46,1896
90806,90806,F40AC1EDE9EB783E2CA294E73A950959,13911,21,22,1,39,46,1996
90807,90807,88B9ED484BFC88A3E18D812526B753D0,42861,6,11,5,37,44,1894
90808,90808,88B9ED484BFC88A3E18D812526B753D0,42864,13,15,2,38,44,1944
90809,90809,88B9ED484BFC88A3E18D812526B753D0,42351,18,20,2,38,45,1945
90810,90810,494D4CE05480984DBEB3A2073E0D7F93,42411,0,7,7,40,49,2049
90811,90811,494D4CE05480984DBEB3A2073E0D7F93,42581,12,15,3,38,48,1948
90812,90812,494D4CE05480984DBEB3A2073E0D7F93,41601,18,19,1,39,49,1999
90813,90813,494D4CE05480984DBEB3A2073E0D7F93,11021,21,22,1,36,49,1849
90824,90824,46B205639A93AA74E4BB822E776E5FC6,13911,0,9,9,39,46,1996
90825,90825,46B205639A93AA74E4BB822E776E5FC6,42231,10,12,2,37,46,1896
90826,90826,46B205639A93AA74E4BB822E776E5FC6,13911,14,19,5,39,46,1996
90827,90827,D1CD491A1E74AABCE3373BF8DA9FFB07,42481,0,5,5,22,49,1149
90828,90828,D1CD491A1E74AABCE3373BF8DA9FFB07,12581,6,8,2,24,48,1248
90829,90829,D1CD491A1E74AABCE3373BF8DA9FFB07,11641,13,23,10,22,49,1149
90830,90830,8B6448FD7DB9F8E2F8F73AFDDD5BFD38,10634,1,2,1,27,45,1395
90831,90831,8B6448FD7DB9F8E2F8F73AFDDD5BFD38,11871,4,10,6,29,46,1496
90832,90832,8B6448FD7DB9F8E2F8F73AFDDD5BFD38,10634,12,23,11,27,45,1395
90838,90838,D02780A8FEF3D73FE91372998CAFA6D1,10521,1,10,9,41,47,2097
90839,90839,D02780A8FEF3D73FE91372998CAFA6D1,11001,11,14,3,42,47,2147
90840,90840,D02780A8FEF3D73FE91372998CAFA6D1,10521,18,21,3,41,47,2097
90841,90841,357055D7C361FB2A115AC0CEB6B7D2D1,42523,2,12,10,31,47,1597
90842,90842,357055D7C361FB2A115AC0CEB6B7D2D1,13651,16,18,2,30,47,1547
90843,90843,357055D7C361FB2A115AC0CEB6B7D2D1,42523,21,23,2,31,47,1597
90847,90847,8E52A4ADA559B0024C6F9E3FF3817E47,13381,0,14,14,39,47,1997
90848,90848,8E52A4ADA559B0024C6F9E3FF3817E47,43481,17,18,1,39,48,1998
90849,90849,8E52A4ADA559B0024C6F9E3FF3817E47,13381,21,23,2,39,47,1997
90854,90854,694AE58BB8FA7D73732050F947690888,11261,5,10,5,36,46,1846
90855,90855,694AE58BB8FA7D73732050F947690888,13231,12,13,1,39,46,1996
90856,90856,694AE58BB8FA7D73732050F947690888,11261,13,20,7,36,46,1846
90857,90857,694AE58BB8FA7D73732050F947690888,42864,21,23,2,38,44,1944
90858,90858,859846C23309918FCF7E37DF9FD45D9F,13911,0,1,1,39,46,1996
90859,90859,859846C23309918FCF7E37DF9FD45D9F,42351,1,3,2,38,45,1945
90860,90860,859846C23309918FCF7E37DF9FD45D9F,13911,4,23,19,39,46,1996
90861,90861,48DCE60D429B0B1E7F2F1B7A462BF9BF,13651,2,7,5,30,47,1547
90862,90862,48DCE60D429B0B1E7F2F1B7A462BF9BF,42523,11,12,1,31,47,1597
90863,90863,48DCE60D429B0B1E7F2F1B7A462BF9BF,10301,15,20,5,31,45,1595
90864,90864,B9E52D07F5AA84B0FEC3B2146C780B6A,11911,0,2,2,37,48,1898
90865,90865,B9E52D07F5AA84B0FEC3B2146C780B6A,11231,3,19,16,37,49,1899
90866,90866,B9E52D07F5AA84B0FEC3B2146C780B6A,11271,20,22,2,37,48,1898
90867,90867,B9E52D07F5AA84B0FEC3B2146C780B6A,11231,22,23,1,37,49,1899
90875,90875,3C4F290E088B2251F5A11549B4DEDAFC,42511,0,6,6,37,47,1897
90876,90876,3C4F290E088B2251F5A11549B4DEDAFC,12514,7,19,12,38,47,1947
90877,90877,3C4F290E088B2251F5A11549B4DEDAFC,42511,21,22,1,37,47,1897
90882,90882,36E4D456967ADF7C503C23EAE8460AAD,13651,2,3,1,30,47,1547
90883,90883,36E4D456967ADF7C503C23EAE8460AAD,42523,6,15,9,31,47,1597
90884,90884,36E4D456967ADF7C503C23EAE8460AAD,10295,15,20,5,30,47,1547
90885,90885,36E4D456967ADF7C503C23EAE8460AAD,42523,20,23,3,31,47,1597
90894,90894,75C6BB9627D7BAB6A0EBDE6560297E24,10111,2,14,12,37,47,1897
90895,90895,75C6BB9627D7BAB6A0EBDE6560297E24,42301,15,16,1,36,47,1847
90896,90896,75C6BB9627D7BAB6A0EBDE6560297E24,10111,16,22,6,37,47,1897
90908,90908,BEF31F045A546CF30A63CFBCD60FD3FA,13911,1,9,8,39,46,1996
90909,90909,BEF31F045A546CF30A63CFBCD60FD3FA,43041,14,15,1,41,46,2096
90910,90910,BEF31F045A546CF30A63CFBCD60FD3FA,42231,16,19,3,37,46,1896
90911,90911,BEF31F045A546CF30A63CFBCD60FD3FA,42351,19,21,2,38,45,1945
90915,90915,CCF51F527C0699CB645C6D016C6FE2F5,40171,8,11,3,38,48,1948
90916,90916,CCF51F527C0699CB645C6D016C6FE2F5,11914,12,13,1,37,48,1898
90917,90917,CCF51F527C0699CB645C6D016C6FE2F5,40171,13,16,3,38,48,1948
90918,90918,CCF51F527C0699CB645C6D016C6FE2F5,11914,16,21,5,37,48,1898
90919,90919,24576DC2C63BF30A46BA06C33A71F868,12491,0,5,5,36,43,1843
90920,90920,24576DC2C63BF30A46BA06C33A71F868,11261,6,10,4,36,46,1846
90921,90921,24576DC2C63BF30A46BA06C33A71F868,12491,12,13,1,36,43,1843
90922,90922,24576DC2C63BF30A46BA06C33A71F868,11261,15,19,4,36,46,1846
90923,90923,0450CE4A9EA5097186EEF727418CD364,11941,2,6,4,37,46,1896
90924,90924,0450CE4A9EA5097186EEF727418CD364,42151,8,17,9,35,45,1795
90925,90925,0450CE4A9EA5097186EEF727418CD364,11941,19,23,4,37,46,1896
90926,90926,6A6B5E81D1573652A3361A0C1E5C2EED,11061,2,8,6,29,48,1498
90927,90927,6A6B5E81D1573652A3361A0C1E5C2EED,11381,12,13,1,30,47,1547
90928,90928,6A6B5E81D1573652A3361A0C1E5C2EED,11061,14,15,1,29,48,1498
90929,90929,6A6B5E81D1573652A3361A0C1E5C2EED,11381,15,23,8,30,47,1547
90935,90935,9CD569BA090337AF1B04AA1563C2E6CA,10491,0,9,9,33,48,1698
90936,90936,9CD569BA090337AF1B04AA1563C2E6CA,11021,10,12,2,36,49,1849
90937,90937,9CD569BA090337AF1B04AA1563C2E6CA,11861,14,16,2,32,47,1647
90938,90938,9CD569BA090337AF1B04AA1563C2E6CA,10491,17,19,2,33,48,1698
90942,90942,597064D826C3E01F204980F028CA1A17,42861,0,5,5,37,44,1894
90943,90943,597064D826C3E01F204980F028CA1A17,11261,6,8,2,36,46,1846
90944,90944,597064D826C3E01F204980F028CA1A17,42864,10,12,2,38,44,1944
90945,90945,597064D826C3E01F204980F028CA1A17,42861,12,23,11,37,44,1894
90962,90962,58248472739B462ECE2ED62B9B35F4B0,42921,0,9,9,33,47,1697
90963,90963,58248472739B462ECE2ED62B9B35F4B0,42161,13,16,3,36,47,1847
90964,90964,58248472739B462ECE2ED62B9B35F4B0,12131,17,18,1,32,47,1647
90965,90965,58248472739B462ECE2ED62B9B35F4B0,42921,21,23,2,33,47,1697
90966,90966,686D4F0D299962ED76BF11C36F11CE9B,42511,0,8,8,37,47,1897
90967,90967,686D4F0D299962ED76BF11C36F11CE9B,13331,11,16,5,38,47,1947
90968,90968,686D4F0D299962ED76BF11C36F11CE9B,42511,17,20,3,37,47,1897
90979,90979,FA26EB40CC50A501674A323D183D356F,11231,0,8,8,37,49,1899
90980,90980,FA26EB40CC50A501674A323D183D356F,10107,9,11,2,38,49,1949
90981,90981,FA26EB40CC50A501674A323D183D356F,11231,11,23,12,37,49,1899
90982,90982,7593D7AED856FF2FC2E20D8E8570438A,11271,2,7,5,37,48,1898
90983,90983,7593D7AED856FF2FC2E20D8E8570438A,40171,8,9,1,38,48,1948
90984,90984,7593D7AED856FF2FC2E20D8E8570438A,11914,10,21,11,37,48,1898
90990,90990,29996ED69B9ED83DE66401B38685CA40,13731,2,3,1,33,49,1699
90991,90991,29996ED69B9ED83DE66401B38685CA40,11954,4,6,2,32,49,1649
90992,90992,29996ED69B9ED83DE66401B38685CA40,13731,9,19,10,33,49,1699
91000,91000,FC32FCDE5EA162E6A3931CE10EF22190,11231,7,9,2,37,49,1899
91001,91001,FC32FCDE5EA162E6A3931CE10EF22190,11021,13,14,1,36,49,1849
91002,91002,FC32FCDE5EA162E6A3931CE10EF22190,11231,15,17,2,37,49,1899
91003,91003,FC32FCDE5EA162E6A3931CE10EF22190,11021,21,22,1,36,49,1849
91013,91013,CA289CAF0439526DA7CB8130E1D0037C,11381,0,9,9,30,47,1547
91014,91014,CA289CAF0439526DA7CB8130E1D0037C,11061,11,13,2,29,48,1498
91015,91015,CA289CAF0439526DA7CB8130E1D0037C,11381,13,23,10,30,47,1547
91028,91028,B11E0F08F3C95344106AADD8DE3FBD88,42151,0,7,7,35,45,1795
91029,91029,B11E0F08F3C95344106AADD8DE3FBD88,10841,10,11,1,37,47,1897
91030,91030,B11E0F08F3C95344106AADD8DE3FBD88,42151,13,23,10,35,45,1795
91031,91031,8BD43FE3EF56810BD38245AFA40DF622,42871,0,12,12,30,45,1545
91032,91032,8BD43FE3EF56810BD38245AFA40DF622,43761,13,16,3,32,47,1647
91033,91033,8BD43FE3EF56810BD38245AFA40DF622,42871,18,21,3,30,45,1545
91037,91037,3EEA719324F26AC72664E6F0F99088AB,42071,0,7,7,31,49,1599
91038,91038,3EEA719324F26AC72664E6F0F99088AB,12121,8,10,2,29,47,1497
91039,91039,3EEA719324F26AC72664E6F0F99088AB,43391,11,15,4,29,48,1498
91040,91040,3EEA719324F26AC72664E6F0F99088AB,42071,18,23,5,31,49,1599
91066,91066,9E74C4204DF0368A301BB287E42AE5CC,13371,1,13,12,41,47,2097
91067,91067,9E74C4204DF0368A301BB287E42AE5CC,10231,14,15,1,39,49,1999
91068,91068,9E74C4204DF0368A301BB287E42AE5CC,13371,19,21,2,41,47,2097
91069,91069,37BA34BEA77527704C48255F83C87B37,12514,0,4,4,38,47,1947
91070,91070,37BA34BEA77527704C48255F83C87B37,11914,6,7,1,37,48,1898
91071,91071,37BA34BEA77527704C48255F83C87B37,42581,10,18,8,38,48,1948
91072,91072,37BA34BEA77527704C48255F83C87B37,11914,19,21,2,37,48,1898
91073,91073,085A54B112E93B58F53705ABE7F444E7,13471,5,14,9,47,49,2399
91074,91074,085A54B112E93B58F53705ABE7F444E7,43621,14,16,2,46,48,2348
91075,91075,085A54B112E93B58F53705ABE7F444E7,13471,19,21,2,47,49,2399
91087,91087,72B28316E77049B3B3D9EC9BDF710CF6,42523,0,6,6,31,47,1597
91088,91088,72B28316E77049B3B3D9EC9BDF710CF6,43761,6,17,11,32,47,1647
91089,91089,72B28316E77049B3B3D9EC9BDF710CF6,10341,18,20,2,31,47,1597
91099,91099,1F6BCFEB56D245CBF5160F742055C8A2,43471,0,1,1,31,49,1599
91100,91100,1F6BCFEB56D245CBF5160F742055C8A2,43391,1,12,11,29,48,1498
91101,91101,1F6BCFEB56D245CBF5160F742055C8A2,11151,15,16,1,30,48,1548
91102,91102,1F6BCFEB56D245CBF5160F742055C8A2,43391,20,21,1,29,48,1498
91103,91103,50A8D48EEDC025C19A5AA5E39B3A8340,43761,0,10,10,32,47,1647
91104,91104,50A8D48EEDC025C19A5AA5E39B3A8340,10731,10,20,10,33,47,1697
91105,91105,50A8D48EEDC025C19A5AA5E39B3A8340,43761,20,22,2,32,47,1647
91112,91112,E981F2C79FBFC538C4EFE3DE0BDED04E,42221,0,7,7,38,48,1948
91113,91113,E981F2C79FBFC538C4EFE3DE0BDED04E,41021,11,12,1,38,47,1947
91114,91114,E981F2C79FBFC538C4EFE3DE0BDED04E,42221,13,20,7,38,48,1948
91120,91120,852BB5540E2D1D044093F0A403D4011D,19441,0,18,18,8,46,446
91121,91121,852BB5540E2D1D044093F0A403D4011D,12621,19,20,1,10,48,548
91122,91122,852BB5540E2D1D044093F0A403D4011D,19441,21,23,2,8,46,446
91126,91126,20A509B02D25A974055008C235F24563,11806,1,7,6,41,48,2098
91127,91127,20A509B02D25A974055008C235F24563,42271,11,12,1,40,47,2047
91128,91128,20A509B02D25A974055008C235F24563,11806,13,20,7,41,48,2098
91129,91129,5ABFABF55A302AC65CDD1BFE0186727A,11921,1,8,7,38,48,1948
91130,91130,5ABFABF55A302AC65CDD1BFE0186727A,10971,10,16,6,35,47,1797
91131,91131,5ABFABF55A302AC65CDD1BFE0186727A,11074,20,21,1,37,47,1897
91140,91140,9A46CF7192115A07E973A201EDCECB42,11261,1,17,16,36,46,1846
91141,91141,9A46CF7192115A07E973A201EDCECB42,13231,19,20,1,39,46,1996
91142,91142,9A46CF7192115A07E973A201EDCECB42,11261,21,22,1,36,46,1846
91143,91143,9F99A72527E81B89BEB16DB21B613CC0,10281,0,7,7,33,48,1698
91144,91144,9F99A72527E81B89BEB16DB21B613CC0,11861,8,16,8,32,47,1647
91145,91145,9F99A72527E81B89BEB16DB21B613CC0,10281,17,23,6,33,48,1698
91159,91159,EAEFCB977DEDF23C1346736B36A6F67B,13911,2,3,1,39,46,1996
91160,91160,EAEFCB977DEDF23C1346736B36A6F67B,11261,6,10,4,36,46,1846
91161,91161,EAEFCB977DEDF23C1346736B36A6F67B,13911,12,14,2,39,46,1996
91162,91162,EAEFCB977DEDF23C1346736B36A6F67B,42231,18,19,1,37,46,1896
91167,91167,B885E78265DACA8F21D2357388930CCE,40123,0,14,14,38,47,1947
91168,91168,B885E78265DACA8F21D2357388930CCE,42511,16,17,1,37,47,1897
91169,91169,B885E78265DACA8F21D2357388930CCE,12514,21,23,2,38,47,1947
91170,91170,D92E0354220FC50EEC1FD87010105B23,11381,0,8,8,30,47,1547
91171,91171,D92E0354220FC50EEC1FD87010105B23,42501,8,18,10,28,47,1447
91172,91172,D92E0354220FC50EEC1FD87010105B23,11381,20,23,3,30,47,1547
91177,91177,59BD035622C1D294E1790B16458D6881,19441,0,9,9,8,46,446
91178,91178,59BD035622C1D294E1790B16458D6881,12621,10,12,2,10,48,548
91179,91179,59BD035622C1D294E1790B16458D6881,19441,14,23,9,8,46,446
91190,91190,189C54EA37D8896B78DBF80EEA026F2F,19931,2,9,7,7,43,393
91191,91191,189C54EA37D8896B78DBF80EEA026F2F,12641,11,16,5,10,43,543
91192,91192,189C54EA37D8896B78DBF80EEA026F2F,19901,20,22,2,7,44,394
91193,91193,2EFE2CC5C90B5BAC1EEDBA0A51560C5C,13911,1,14,13,39,46,1996
91194,91194,2EFE2CC5C90B5BAC1EEDBA0A51560C5C,42231,16,17,1,37,46,1896
91195,91195,2EFE2CC5C90B5BAC1EEDBA0A51560C5C,13911,18,22,4,39,46,1996
91200,91200,A53907219614BC9E0FC05C0EC4AF6DC2,13911,0,5,5,39,46,1996
91201,91201,A53907219614BC9E0FC05C0EC4AF6DC2,42231,5,11,6,37,46,1896
91202,91202,A53907219614BC9E0FC05C0EC4AF6DC2,13911,12,23,11,39,46,1996
91207,91207,E603C5CE99E3FE3BB5D201DC1F4B77FD,42204,0,1,1,43,46,2196
91208,91208,E603C5CE99E3FE3BB5D201DC1F4B77FD,13111,1,15,14,42,46,2146
